GameDate_2018,FMRTEVersion_2018,Name_2018,UID_2018,NationID_2018,Born_2018,Age_2018,IntCaps_2018,IntGoals_2018,U21Caps_2018,U21Goals_2018,WorldReputation_2018,HomeReputation_2018,CurrentReputation_2018,PA_2018,CA_2018,Price_2018,Height_2018,Weight_2018,PositionsString_2018,GK.AerialAbility_2018,GK.CommandOfArea_2018,GK.Communication_2018,GK.Eccentricity_2018,GK.Handling_2018,GK.Kicking_2018,GK.OneOnOnes_2018,GK.Reflexes_2018,GK.RushingOut_2018,GK.TendencyToPunch_2018,GK.Throwing_2018,Tech.Corners_2018,Tech.Crossing_2018,Tech.Dribbling_2018,Tech.Finishing_2018,Tech.FirstTouch_2018,Tech.Freekicks_2018,Tech.Heading_2018,Tech.LongShots_2018,Tech.Longthrows_2018,Tech.Marking_2018,Tech.Passing_2018,Tech.PenaltyTaking_2018,Tech.Tackling_2018,Tech.Technique_2018,Mental.Aggression_2018,Mental.Anticipation_2018,Mental.Bravery_2018,Mental.Composure_2018,Mental.Concentration_2018,Mental.Vision_2018,Mental.Decisions_2018,Mental.Determination_2018,Mental.Flair_2018,Mental.Leadership_2018,Mental.OffTheBall_2018,Mental.Positioning_2018,Mental.Teamwork_2018,Mental.Workrate_2018,Phy.Acceleration_2018,Phy.Agility_2018,Phy.Balance_2018,Phy.Jumping_2018,Phy.LeftFoot_2018,Phy.NaturalFitness_2018,Phy.Pace_2018,Phy.RightFoot_2018,Phy.Stamina_2018,Phy.Strength_2018,Hidden.Consistency_2018,Hidden.Dirtiness_2018,Hidden.ImportantMatches_2018,Hidden.InjuryProness_2018,Hidden.Versatility_2018,Personality.Adaptability_2018,Personality.Ambition_2018,Personality.Loyalty_2018,Personality.Pressure_2018,Personality.Professional_2018,Personality.Sportsmanship_2018,Personality.Temperament_2018,Personality.Controversy_2018,Positions.Defender_2018,Positions.WingBack_2018,Positions.Midfielder_2018,Positions.AttackingMidfielder_2018,Positions.Right_2018,Positions.Left_2018,Positions.Centre_2018,Positions.PositionsDesc_2018,Positions.PositionsDescVal_2018,Positions.Goalkeeper_2018,Positions.Sweeper_2018,Positions.Striker_2018,Positions.AttackingMidCentral_2018,Positions.AttackingMidLeft_2018,Positions.AttackingMidRight_2018,Positions.DefenderCentral_2018,Positions.DefenderLeft_2018,Positions.DefenderRight_2018,Positions.DefensiveMidfielder_2018,Positions.MidfielderCentral_2018,Positions.MidfielderLeft_2018,Positions.MidfielderRight_2018,Positions.WingBackLeft_2018,Positions.WingBackRight_2018,PPMVal_2018,PPM0_2018,PPM1_2018,PPM2_2018,PPM3_2018,PPM4_2018,PPM5_2018,PPM6_2018,PPM7_2018,PPM8_2018,PPM9_2018,PPM10_2018,PPM11_2018,PPM12_2018,PPM13_2018,PPM14_2018,PPM15_2018,PPM16_2018,PPM17_2018,PPM18_2018,PPM19_2018,PPM20_2018,PPM21_2018,PPM22_2018,PPM23_2018,PPM24_2018,PPM25_2018,PPM26_2018,PPM27_2018,PPM28_2018,PPM29_2018,PPM30_2018,PPM31_2018,PPM32_2018,PPM33_2018,PPM34_2018,PPM35_2018,PPM36_2018,PPM37_2018,PPM38_2018,PPM39_2018,PPM40_2018,PPM41_2018,PPM42_2018,PPM43_2018,PPM44_2018,PPM45_2018,PPM46_2018,PPM47_2018,name_2018,Market Value_2018,age_2018,height_2018,position_2018,foot_2018,current club_2018,16/17 games_2018,16/17 goals/conceded_2018,16/17 assists/clean_2018,16/17 minutes_2018,17/18 games_2018,17/18 goals/conceded_2018,17/18 assists/clean_2018,17/18 minutes_2018,18/19 games_2018,18/19 goals/conceded_2018,18/19 assists/clean_2018,18/19 minutes_2018,19/20 games_2018,19/20 goals/conceded_2018,19/20 assists/clean_2018,19/20 minutes_2018,20/21 games_2018,20/21 goals/conceded_2018,20/21 assists/clean_2018,20/21 minutes_2018,current league_2018,GameDate_2017,FMRTEVersion_2017,Name_2017,UID_2017,NationID_2017,Born_2017,Age_2017,IntCaps_2017,IntGoals_2017,U21Caps_2017,U21Goals_2017,WorldReputation_2017,HomeReputation_2017,CurrentReputation_2017,PA_2017,CA_2017,Price_2017,Height_2017,Weight_2017,PositionsString_2017,GK.AerialAbility_2017,GK.CommandOfArea_2017,GK.Communication_2017,GK.Eccentricity_2017,GK.Handling_2017,GK.Kicking_2017,GK.OneOnOnes_2017,GK.Reflexes_2017,GK.RushingOut_2017,GK.TendencyToPunch_2017,GK.Throwing_2017,Tech.Corners_2017,Tech.Crossing_2017,Tech.Dribbling_2017,Tech.Finishing_2017,Tech.FirstTouch_2017,Tech.Freekicks_2017,Tech.Heading_2017,Tech.LongShots_2017,Tech.Longthrows_2017,Tech.Marking_2017,Tech.Passing_2017,Tech.PenaltyTaking_2017,Tech.Tackling_2017,Tech.Technique_2017,Mental.Aggression_2017,Mental.Anticipation_2017,Mental.Bravery_2017,Mental.Composure_2017,Mental.Concentration_2017,Mental.Vision_2017,Mental.Decisions_2017,Mental.Determination_2017,Mental.Flair_2017,Mental.Leadership_2017,Mental.OffTheBall_2017,Mental.Positioning_2017,Mental.Teamwork_2017,Mental.Workrate_2017,Phy.Acceleration_2017,Phy.Agility_2017,Phy.Balance_2017,Phy.Jumping_2017,Phy.LeftFoot_2017,Phy.NaturalFitness_2017,Phy.Pace_2017,Phy.RightFoot_2017,Phy.Stamina_2017,Phy.Strength_2017,Hidden.Consistency_2017,Hidden.Dirtiness_2017,Hidden.ImportantMatches_2017,Hidden.InjuryProness_2017,Hidden.Versatility_2017,Personality.Adaptability_2017,Personality.Ambition_2017,Personality.Loyalty_2017,Personality.Pressure_2017,Personality.Professional_2017,Personality.Sportsmanship_2017,Personality.Temperament_2017,Personality.Controversy_2017,name_2017,Market Value_2017,current league_2017
19-06-17,18.3.4.28,Ramadan Sobhi,12066084,16,23-Jan-97,20,16,1,23,7,5250,7000,6500,151,134,46925125,183,0,AM RLC,1,1,2,1,3,1,1,3,2,1,1,11,12,14,10,13,9,11,10,4,5,12,13,9,14,14,16,18,12,10,15,11,19,17,6,15,9,15,15,12,15,10,13,13,15,14,20,13,11,12,8,17,7,16,15,20,19,13,10,10,12,12,1,14,15,20,18,18,20,AM RLC,506,1,1,1,20,18,18,1,1,1,1,14,12,15,1,14,70368900000000.0,0,0,0,0,0,0,0,1,0,0,0,0,0,0,0,0,0,1,0,0,0,0,0,0,1,0,0,1,0,0,0,0,0,0,0,0,0,0,0,0,0,0,0,0,0,0,1,0,Ramadan Sobhi,Â£6.30m ,23.0,183.0,Forward - Left Winger,right,Pyramids FC,20.0,0.0,2.0,1057.0,28.0,4.0,1.0,1594.0,31.0,2.0,5.0,2246.0,9.0,5.0,1.0,707.0,nan,nan,nan,nan,Premier League,15-07-16,17.3.2.23,Ramadan Sobhi,12066084,16,23-Jan-97,19,1,0,23,7,4971,6960,6500,150,120,38705452,183,80,AM RLC,2,1,1,1,2,3,3,3,2,2,3,9,10,17,8,13,7,9,8,2,3,13,11,7,14,14,16,17,10,8,13,9,19,17,5,13,7,13,13,10,14,8,11,13,15,13,20,12,15,12,8,17,7,16,15,20,19,13,10,10,12,12,Ramadan Sobhi,Â£4.50m ,Premier League
19-06-17,18.3.4.28,Erik Lamela,14005628,1649,04-Mar-92,25,23,3,0,0,6150,7500,7250,150,137,31461153,181,80,AM RLC,1,1,2,2,4,3,2,2,2,2,2,14,14,15,11,14,14,9,13,4,8,16,14,10,17,13,13,11,17,11,16,11,14,17,5,13,9,15,16,13,15,13,9,20,13,12,7,15,11,10,13,12,13,15,4,12,11,11,13,10,10,7,1,1,13,20,20,15,17,AM RLC,506,1,1,13,17,15,20,1,1,1,1,1,13,12,1,1,2251960000000000.0,0,0,0,0,0,0,0,0,0,0,0,0,0,0,0,0,0,0,0,0,0,0,0,0,0,0,0,0,0,0,1,0,0,0,1,0,0,1,0,0,0,0,0,0,0,0,0,0,Erik Lamela,Â£18.00m ,28.0,184.0,Forward - Right Winger,left,Tottenham Hotspur,14.0,2.0,7.0,944.0,34.0,4.0,7.0,1380.0,33.0,6.0,3.0,1550.0,35.0,4.0,6.0,1659.0,7.0,2.0,0.0,347.0,Premier League,15-07-16,17.3.2.23,Erik Lamela,14005628,1649,04-Mar-92,24,22,3,0,0,6150,7750,7400,160,148,104097957,183,79,AM RLC,2,1,1,2,2,2,1,2,3,1,3,15,12,14,13,15,14,6,13,4,4,14,13,10,17,15,14,11,14,10,14,12,14,16,5,15,9,10,16,16,15,14,10,20,17,14,9,16,11,13,13,12,10,16,4,14,12,11,14,9,11,7,Erik Lamela,Â£22.50m ,Premier League
19-06-17,18.3.4.28,Manuel Lanzini,14025513,1649,15-Feb-93,24,2,0,0,0,5600,7000,7100,160,138,49231264,167,0,M/AM RLC,2,1,1,1,3,2,1,2,4,2,1,13,12,16,13,16,14,8,13,2,6,14,10,5,16,12,11,10,13,10,14,11,12,15,10,14,5,13,12,15,15,13,8,12,13,15,20,13,8,12,8,14,10,12,14,13,13,8,13,7,13,8,1,1,16,20,15,17,20,M/AM RLC,526,1,1,10,20,17,15,1,1,1,1,16,14,11,1,1,2251800000000000.0,0,0,0,0,0,0,0,1,0,0,0,0,0,0,0,0,0,0,0,0,1,0,0,0,0,0,0,0,0,0,0,0,0,0,0,0,0,0,0,0,0,0,0,0,0,0,0,0,Manuel Lanzini,Â£18.00m ,27.0,167.0,Midfielder - Attacking Midfield,right,West Ham United,39.0,8.0,2.0,2927.0,29.0,5.0,9.0,2255.0,10.0,1.0,2.0,688.0,25.0,0.0,3.0,1467.0,4.0,1.0,2.0,283.0,Premier League,15-07-16,17.3.2.23,Manuel Lanzini,14025513,1649,15-Feb-93,23,0,0,0,0,5347,6947,6747,160,142,35936652,167,63,M/AM RLC,3,2,3,3,2,2,2,1,3,1,1,13,13,16,12,16,15,8,13,2,6,15,10,5,16,12,10,10,13,10,14,11,13,15,10,15,5,12,10,16,16,12,8,13,13,15,20,12,8,12,8,12,10,12,15,13,12,8,12,7,13,8,Manuel Lanzini,Â£13.50m ,Premier League
19-06-17,18.3.4.28,Pedro,1510305,796,28-Jul-87,29,63,17,2,0,7500,8000,8000,164,158,187451605,169,66,AM RLC,3,1,4,1,2,2,1,2,1,3,3,12,11,13,15,16,10,9,15,5,4,12,11,8,14,14,16,10,12,13,11,13,16,15,8,17,6,12,16,16,18,14,6,19,13,15,20,14,7,13,7,17,10,16,10,14,17,14,17,12,17,5,1,1,13,20,20,19,18,AM RLC,506,1,1,14,18,19,20,1,1,1,1,1,12,13,1,1,2252350000000000.0,0,0,0,0,0,0,0,0,0,0,1,0,0,0,0,0,0,0,0,0,1,0,0,0,0,0,0,0,0,0,0,0,0,0,0,0,0,0,0,1,0,0,0,0,0,0,0,0,Pedro,Â£22.50m ,33.0,167.0,Forward - Right Winger,both,AS Roma,43.0,13.0,12.0,2723.0,48.0,7.0,5.0,2509.0,52.0,13.0,5.0,3099.0,23.0,2.0,3.0,1273.0,6.0,2.0,1.0,490.0,Premier League,15-07-16,17.3.2.23,Pedro,1510305,796,28-Jul-87,28,59,17,2,0,7500,8000,8000,164,155,101426319,169,65,AM RLC,3,2,3,2,2,3,1,2,3,2,4,12,11,13,15,16,10,9,12,5,4,12,11,8,14,14,15,10,12,13,11,13,16,15,8,17,6,12,15,16,18,14,6,19,13,15,20,14,7,13,7,17,10,16,11,14,17,14,17,12,17,5,Pedro,Â£25.20m ,Premier League
19-06-17,18.3.4.28,Matt Ritchie,151741,793,10-Sep-89,27,14,3,0,0,5200,6600,7000,147,140,44183944,173,71,M/AM RL,3,2,1,4,3,1,2,1,1,3,3,14,15,13,14,14,15,6,15,5,7,15,16,11,13,15,13,14,14,12,14,14,14,13,13,13,10,15,18,13,12,15,6,20,16,13,8,15,13,15,8,14,7,13,13,13,13,10,12,11,10,5,1,1,18,20,20,17,13,M/AM RL,525,1,1,1,13,17,20,1,1,1,1,1,15,18,1,1,549756000000.0,0,0,0,0,0,0,0,0,1,1,0,0,0,0,0,0,0,0,0,0,0,0,0,0,0,0,0,0,0,0,0,0,0,0,0,0,0,0,0,1,0,0,0,0,0,0,0,0,Matt Ritchie,Â£10.80m ,31.0,173.0,Defender - Left-Back,left,Newcastle United,48.0,16.0,10.0,3913.0,38.0,3.0,6.0,3035.0,39.0,3.0,9.0,3212.0,23.0,2.0,2.0,1664.0,3.0,0.0,1.0,239.0,Premier League
19-06-17,18.3.4.28,Eden Hazard,18004418,757,07-Jan-91,26,77,17,0,0,8750,9000,8750,185,179,186143682,173,76,AM RLC,1,3,3,3,2,2,3,3,3,2,3,12,12,20,13,17,13,7,13,5,3,15,19,4,18,8,12,17,15,13,16,16,16,18,6,14,7,11,13,17,20,16,8,16,16,16,20,17,11,15,8,15,3,10,15,18,14,15,14,17,14,9,1,1,11,20,16,20,19,AM RLC,506,1,1,10,19,20,16,1,1,1,1,10,11,11,1,1,2462940000000000.0,0,0,0,0,0,0,0,0,0,0,0,0,0,0,0,0,0,0,0,1,1,0,0,0,1,0,1,0,0,0,0,0,0,0,0,1,0,0,0,0,0,0,0,0,0,0,1,1,Eden Hazard,Â£99.00m ,29.0,175.0,Forward - Left Winger,both,Real Madrid,43.0,17.0,7.0,3373.0,52.0,17.0,13.0,3804.0,52.0,21.0,17.0,3878.0,22.0,1.0,7.0,1545.0,nan,nan,nan,nan,Premier League,15-07-16,17.3.2.23,Eden Hazard,18004418,757,07-Jan-91,25,70,14,0,0,8750,9000,8750,185,175,212977903,173,76,M/AM RLC,3,2,4,4,3,1,2,3,3,1,2,13,12,20,13,17,13,7,13,5,3,15,19,4,18,8,12,17,15,13,16,13,16,18,6,14,7,11,13,17,20,16,8,16,16,16,20,17,9,15,8,15,3,8,15,18,14,15,14,17,14,9,Eden Hazard,Â£67.50m ,Premier League
19-06-17,18.3.4.28,Kevin De Bruyne,18004457,757,28-Jun-91,25,52,13,2,0,9000,9000,9150,184,183,232186002,181,68,M/AM RLC,2,1,2,3,1,2,2,3,2,2,1,15,17,15,15,18,15,6,16,8,7,18,12,8,17,12,14,9,15,13,19,17,15,16,11,15,9,13,14,14,13,14,8,17,16,14,20,17,13,16,8,15,4,14,13,18,14,11,18,15,13,13,1,1,20,20,15,15,20,M/AM RLC,416,1,1,14,20,15,15,1,1,1,12,20,15,15,1,1,141287000000000.0,0,0,0,0,0,0,0,0,0,0,0,1,0,0,0,0,0,0,0,1,0,0,0,0,0,0,0,0,0,0,0,0,0,0,0,0,0,0,0,1,0,0,0,0,0,0,0,1,Kevin De Bruyne,Â£135.00m ,29.0,181.0,Midfielder - Attacking Midfield,right,Manchester City,49.0,7.0,21.0,3909.0,52.0,12.0,21.0,4189.0,32.0,6.0,11.0,1828.0,48.0,16.0,23.0,3826.0,6.0,1.0,1.0,385.0,Premier League,15-07-16,17.3.2.23,Kevin De Bruyne,18004457,757,28-Jun-91,25,45,12,2,0,8250,9101,8900,180,174,232086864,181,76,M/AM RLC,1,1,1,2,2,4,2,3,2,1,1,15,17,15,16,17,15,7,16,8,7,17,12,8,17,12,14,9,14,12,17,15,15,16,11,16,10,12,15,13,13,13,8,16,16,13,20,17,12,14,8,15,4,14,12,18,10,11,17,10,12,13,Kevin De Bruyne,Â£58.50m ,Premier League
19-06-17,18.3.4.28,Roberto Firmino,19068857,1651,02-Oct-91,25,15,5,0,0,7000,8000,8000,172,168,96357191,181,76,AM/S RLC,3,1,3,1,3,3,1,1,1,2,3,11,13,16,15,17,9,12,13,4,12,15,12,14,18,12,17,12,16,16,15,15,14,16,5,17,12,17,17,14,15,15,11,10,16,13,20,16,14,15,5,15,8,12,15,15,13,14,14,11,16,8,1,1,1,18,15,17,18,AM/S RLC,626,1,1,20,18,17,15,1,1,1,1,1,1,1,1,1,550024000000.0,0,0,0,0,1,0,0,0,0,0,1,0,0,0,0,0,0,0,0,0,0,0,0,0,0,0,0,0,1,0,0,0,0,0,0,0,0,0,0,1,0,0,0,0,0,0,0,0,Roberto Firmino,Â£72.00m ,29.0,181.0,Forward - Centre-Forward,right,Liverpool FC,41.0,12.0,11.0,3463.0,54.0,27.0,17.0,4188.0,48.0,16.0,8.0,3406.0,52.0,12.0,13.0,3921.0,8.0,1.0,2.0,638.0,Premier League,15-07-16,17.3.2.23,Roberto Firmino,19068857,1651,02-Oct-91,24,11,4,0,0,7000,8000,8000,168,159,126890572,181,76,AM/S RLC,1,1,1,1,3,2,2,3,2,3,1,11,13,16,15,16,11,11,14,4,8,14,11,11,17,12,15,10,15,14,15,13,14,16,7,17,11,16,16,14,15,15,10,11,16,13,20,15,13,13,5,14,8,12,15,15,13,14,14,11,13,12,Roberto Firmino,Â£34.20m ,Premier League
19-06-17,18.3.4.28,Kenedy,19192323,1651,08-Feb-96,21,0,0,7,1,5500,6500,6500,151,130,37831683,182,81,WB/AM RL,4,1,2,1,4,4,1,3,1,1,1,11,11,13,14,14,12,10,15,4,7,12,11,7,13,12,11,11,13,11,12,13,13,15,10,13,7,12,12,14,12,13,13,20,14,13,11,13,15,12,11,11,6,13,18,13,12,12,9,12,12,7,11,16,12,20,17,20,10,WB/AM RL,525,1,1,12,10,20,17,1,11,10,1,1,10,12,16,12,768.0,0,0,0,0,0,0,0,0,1,1,0,0,0,0,0,0,0,0,0,0,0,0,0,0,0,0,0,0,0,0,0,0,0,0,0,0,0,0,0,0,0,0,0,0,0,0,0,0,Kenedy,Â£9.00m ,24.0,182.0,Forward - Left Winger,left,Granada CF,3.0,0.0,0.0,109.0,19.0,3.0,5.0,1555.0,28.0,1.0,1.0,1613.0,27.0,3.0,5.0,946.0,9.0,1.0,2.0,441.0,Premier League,15-07-16,17.3.2.23,Kenedy,19192323,1651,08-Feb-96,20,0,0,7,1,5500,6500,6500,140,130,35127164,182,80,AM/S RL,2,2,1,3,2,1,2,2,2,2,1,11,11,13,14,14,12,10,15,4,7,12,11,7,13,12,11,11,13,11,12,13,13,15,10,13,7,12,12,14,12,13,13,20,14,13,11,13,15,12,11,11,6,13,11,13,12,12,9,12,12,7,Kenedy,Â£6.30m ,Premier League
19-06-17,18.3.4.28,Gabriel Jesus,19220266,1651,03-Apr-97,20,7,4,10,2,7000,8000,7850,169,153,201076240,175,73,AM/S RL,1,3,1,3,3,4,2,2,1,4,1,11,10,14,16,15,10,11,11,6,8,13,12,10,16,12,13,12,14,12,13,13,13,15,7,14,7,12,15,16,17,14,8,13,14,15,20,13,10,13,14,13,6,12,15,13,12,12,10,8,9,10,1,1,1,18,18,15,12,AM/S RL,625,1,1,20,12,15,18,1,1,1,1,1,1,1,1,1,18141900000000.0,0,0,0,0,0,0,0,0,0,0,0,0,0,0,0,0,0,0,0,0,0,1,0,0,0,0,0,0,0,0,0,0,0,0,0,0,0,0,0,1,0,0,0,0,1,0,0,0,Gabriel Jesus,Â£72.00m ,23.0,175.0,Forward - Centre-Forward,right,Manchester City,11.0,7.0,5.0,741.0,42.0,17.0,5.0,2594.0,47.0,21.0,6.0,2253.0,53.0,23.0,14.0,3304.0,1.0,1.0,0.0,90.0,Premier League,15-07-16,17.3.2.23,Gabriel Jesus,19220266,1651,03-Apr-97,19,6,5,10,2,6000,8000,7500,190,149,146898458,178,73,AM/S RL,3,2,2,3,3,3,2,2,1,3,3,11,12,14,15,14,10,10,10,6,8,12,12,10,15,12,13,11,13,12,13,13,13,15,7,14,7,12,13,16,16,14,8,13,14,15,20,13,10,13,14,11,6,12,15,13,12,12,10,8,9,10,Gabriel Jesus,Â£27.00m ,Premier League
19-06-17,18.3.4.28,Richarlison,19265858,1651,10-May-97,20,0,0,10,3,5800,6800,7250,160,145,60129057,181,71,AM RL,1,1,1,3,3,2,3,2,1,2,3,10,10,16,13,12,9,13,11,8,6,12,12,8,15,10,12,13,12,12,10,11,14,12,11,12,7,10,14,15,14,12,11,18,15,14,20,15,15,13,6,11,13,12,17,13,14,13,12,7,13,8,1,1,1,20,19,20,1,AM RL,505,1,1,15,1,20,19,1,1,1,1,1,1,1,1,1,2251800000000000.0,1,0,0,0,0,0,0,0,0,0,0,0,0,0,0,0,0,0,0,0,0,0,0,0,0,0,0,1,0,0,0,0,0,0,0,0,0,0,0,0,0,0,0,0,0,0,0,0,Richarlison,Â£22.50m ,23.0,184.0,Forward - Centre-Forward,right,Everton FC,18.0,7.0,6.0,1591.0,41.0,5.0,5.0,3028.0,38.0,14.0,2.0,2809.0,41.0,15.0,4.0,3501.0,7.0,4.0,2.0,522.0,Premier League
19-06-17,18.3.4.28,Nikola Vlasic,24039948,761,04-Oct-97,19,0,0,4,0,4750,6350,6250,142,128,32737484,178,80,AM RLC,2,1,3,2,2,2,3,4,1,4,3,12,11,15,11,13,11,8,11,6,5,12,12,8,14,13,11,10,11,9,13,8,16,14,12,13,8,13,12,15,16,15,10,8,17,14,20,13,13,12,10,13,6,10,13,15,14,14,14,10,14,5,1,1,14,20,18,18,20,AM RLC,506,1,1,14,20,18,18,1,1,1,8,10,14,14,1,1,2251800000000000.0,0,0,0,0,0,0,0,0,0,0,0,0,0,0,0,0,0,0,0,0,0,0,0,0,0,0,0,0,0,0,0,0,0,0,0,0,0,0,0,0,0,0,0,0,0,0,0,0,Nikola Vlasic,Â£7.20m ,23.0,178.0,Midfielder - Attacking Midfield,right,CSKA Moscow,37.0,4.0,9.0,3034.0,32.0,5.0,2.0,2050.0,31.0,8.0,7.0,2730.0,38.0,13.0,7.0,3310.0,11.0,6.0,5.0,953.0,Premier League
19-06-17,18.3.4.28,Christian Eriksen,27010680,764,14-Feb-92,25,69,14,3,1,7000,8750,8250,170,165,219413774,182,76,M/AM LC,2,3,2,1,1,2,3,2,1,1,2,13,14,13,15,16,16,8,16,3,7,17,11,9,16,5,15,6,15,12,16,16,14,13,8,16,7,17,18,13,15,11,9,16,15,13,20,17,11,12,4,13,4,15,18,14,18,14,18,18,19,4,1,1,18,20,12,16,20,M/AM LC,524,1,1,8,20,16,12,1,1,1,10,18,13,12,1,1,1049744.0,0,0,0,0,1,0,0,1,0,0,1,0,0,0,0,0,0,0,0,0,1,0,0,0,0,0,0,0,0,0,0,0,0,0,0,0,0,0,0,0,0,0,0,0,0,0,0,0,Christian Eriksen,Â£72.00m ,28.0,182.0,Midfielder - Attacking Midfield,both,Inter Milan,48.0,12.0,23.0,4038.0,47.0,14.0,13.0,3979.0,51.0,10.0,17.0,4129.0,54.0,7.0,6.0,2666.0,5.0,0.0,0.0,232.0,Premier League,15-07-16,17.3.2.23,Christian Eriksen,27010680,764,14-Feb-92,24,61,9,3,1,7000,8500,8100,162,157,130341924,177,71,M/AM LC,3,1,2,3,1,4,2,3,3,3,4,13,15,13,13,16,17,7,12,3,4,16,11,3,18,5,14,7,15,12,17,16,14,13,8,16,4,13,16,14,16,12,7,16,15,13,20,15,11,15,4,12,6,15,17,17,18,16,15,18,17,4,Christian Eriksen,Â£36.00m ,Premier League
19-06-17,18.3.4.28,Gylfi SigurÄsson,28004396,774,08-Sep-89,27,50,15,14,6,6650,7500,7300,152,146,63448618,186,79,M/AM LC,3,2,2,4,2,1,2,1,3,4,2,14,16,13,14,14,18,5,16,3,7,15,18,8,15,15,12,12,13,13,16,12,16,16,11,14,12,15,17,10,11,13,11,16,18,12,20,17,12,14,8,14,4,8,16,15,12,17,17,14,13,5,1,1,18,20,11,18,20,M/AM LC,524,1,1,14,20,18,11,1,1,1,7,18,11,10,1,1,17867100000000.0,0,0,0,0,0,0,0,0,0,0,0,1,0,0,0,0,0,0,0,0,0,0,0,0,0,0,0,0,0,0,0,0,0,0,0,0,0,0,1,0,0,0,0,0,1,0,0,0,Gylfi Sigurdsson,Â£27.00m ,31.0,186.0,Midfielder - Attacking Midfield,right,Everton FC,40.0,10.0,13.0,3446.0,33.0,6.0,5.0,2745.0,41.0,14.0,7.0,3370.0,38.0,3.0,3.0,2730.0,9.0,1.0,3.0,497.0,Premier League,15-07-16,17.3.2.23,Gylfi SigurÄsson,28004396,774,08-Sep-89,26,30,9,14,6,6595,7495,7245,151,145,49531407,186,79,M/AM LC,1,1,2,4,2,1,1,3,2,4,2,13,16,11,14,13,17,5,16,3,7,14,18,8,15,15,12,11,12,13,16,12,16,16,10,14,12,14,18,11,11,13,11,16,18,12,20,17,12,14,8,14,4,8,16,15,11,17,17,14,13,5,Gylfi Sigurdsson,Â£22.50m ,Premier League
19-06-17,18.3.4.28,Andros Townsend,28005834,765,16-Jul-91,25,13,3,3,0,5600,6800,6800,144,136,36615098,178,75,M/AM RL,1,3,1,1,3,3,1,3,1,2,4,11,12,16,9,11,11,7,15,5,5,10,6,6,13,8,8,10,7,12,10,11,13,16,10,11,9,11,13,16,13,13,8,20,12,16,16,15,11,9,4,10,7,9,12,10,13,12,13,10,14,6,1,1,18,20,20,19,10,M/AM RL,525,1,1,8,10,19,20,1,1,1,1,1,17,18,1,1,550427000000.0,0,0,0,0,0,0,0,0,1,0,0,0,0,0,0,0,0,0,0,0,0,0,0,0,0,0,0,1,0,1,0,0,0,0,0,0,0,0,0,1,0,0,0,0,0,0,0,0,Andros Townsend,Â£13.50m ,29.0,181.0,Forward - Right Winger,left,Crystal Palace,40.0,3.0,7.0,2820.0,39.0,2.0,9.0,3297.0,45.0,9.0,6.0,3569.0,25.0,1.0,1.0,1379.0,7.0,1.0,2.0,560.0,Premier League,15-07-16,17.3.2.23,Andros Townsend,28005834,765,16-Jul-91,25,11,3,3,0,5500,6800,6800,150,136,27147126,178,75,M/AM RL,1,1,1,3,1,1,2,1,1,2,3,11,12,16,9,11,11,7,15,5,5,10,6,6,13,8,8,10,7,12,10,11,13,16,10,11,9,11,13,16,13,13,8,20,12,16,16,15,11,9,4,10,7,9,12,10,13,12,13,10,14,6,Andros Townsend,Â£10.80m ,Premier League
19-06-17,18.3.4.28,Junior Stanislas,28006277,765,26-Nov-89,27,0,0,2,0,4500,6250,6400,146,135,16822564,183,77,M/AM RL,2,1,1,1,1,2,2,3,1,3,1,16,11,12,13,13,15,8,13,7,7,14,10,9,13,7,14,4,12,10,12,13,13,12,5,14,9,14,16,15,13,13,9,9,15,15,20,14,12,15,6,11,7,14,13,14,13,10,16,8,9,3,1,1,17,20,20,20,13,M/AM RL,525,1,1,1,13,20,20,1,1,1,1,1,17,17,1,1,0.0,0,0,0,0,0,0,0,0,0,0,0,0,0,0,0,0,0,0,0,0,0,0,0,0,0,0,0,0,0,0,0,0,0,0,0,0,0,0,0,0,0,0,0,0,0,0,0,0,Junior Stanislas,Â£4.05m ,30.0,183.0,Forward - Left Winger,right,AFC Bournemouth,22.0,7.0,5.0,1536.0,20.0,5.0,2.0,1356.0,27.0,4.0,3.0,1269.0,16.0,3.0,0.0,776.0,4.0,0.0,1.0,206.0,Premier League,15-07-16,17.3.2.23,Junior Stanislas,28006277,765,26-Nov-89,26,0,0,2,0,4500,6250,6250,136,130,8134871,183,77,M/AM RL,2,2,1,1,2,2,1,1,3,3,1,16,11,12,13,13,12,8,13,7,7,14,10,9,13,7,11,4,11,10,12,12,13,12,5,14,9,12,16,15,13,13,9,9,15,15,20,14,12,14,6,11,7,14,7,14,13,10,16,8,9,3,Junior Stanislas,Â£4.05m ,Premier League
19-06-17,18.3.4.28,Danny Welbeck,28010491,765,26-Nov-90,26,34,14,14,5,6500,7200,7200,160,144,47553672,185,73,AM/S RL,1,3,2,1,3,1,1,3,1,3,2,5,9,14,14,13,4,13,8,3,6,12,10,6,14,11,13,14,12,12,12,14,14,15,4,14,8,15,16,17,15,15,14,9,15,15,20,15,14,12,5,12,12,11,10,15,16,13,15,11,15,4,1,1,1,20,17,20,10,AM/S RL,515,1,1,19,10,20,17,1,1,1,1,1,1,1,1,1,34360795152.0,0,0,0,0,1,0,0,0,0,0,0,0,0,1,0,0,0,0,0,0,1,0,0,0,0,0,0,0,0,0,0,0,0,0,0,1,0,0,0,0,0,0,0,0,0,0,0,0,Danny Welbeck,Â£13.50m ,29.0,185.0,Forward - Centre-Forward,right,Brighton & Hove Albion,22.0,5.0,4.0,1094.0,43.0,10.0,2.0,2325.0,14.0,5.0,1.0,604.0,20.0,3.0,1.0,997.0,0.0,0.0,0.0,0.0,Premier League,15-07-16,17.3.2.23,Danny Welbeck,28010491,765,26-Nov-90,25,34,14,14,5,6650,7500,7500,165,154,60074050,185,73,AM/S RL,1,3,1,2,2,2,3,2,3,1,3,5,9,14,15,13,4,13,8,3,6,12,10,6,14,11,13,14,12,12,10,14,14,17,4,14,8,16,17,17,15,16,14,12,15,17,20,15,14,14,5,12,12,12,17,15,16,14,15,11,15,4,Danny Welbeck,Â£13.50m ,Premier League
19-06-17,18.3.4.28,Ashley Barnes,28016057,765,30-Oct-89,27,0,0,0,0,4800,6600,6700,136,136,33381501,186,77,S L,3,1,3,2,2,1,2,3,2,2,4,6,9,8,12,14,7,15,11,5,8,12,13,9,13,18,13,17,12,15,9,12,16,7,10,13,11,16,17,14,12,11,15,13,16,13,20,16,16,13,15,15,7,14,7,9,12,9,12,5,5,12,1,1,1,15,14,15,12,S L,603,1,1,20,12,15,14,1,1,1,1,1,1,1,1,1,137439000000.0,0,0,0,0,0,0,0,0,0,0,0,0,0,0,0,0,1,1,0,0,0,0,0,0,0,0,0,0,0,0,0,0,0,0,0,0,0,1,0,0,0,0,0,0,0,0,0,0,Ashley Barnes,Â£7.20m ,30.0,186.0,Forward - Centre-Forward,right,Burnley FC,31.0,6.0,3.0,1831.0,39.0,10.0,0.0,2457.0,43.0,13.0,2.0,2832.0,19.0,6.0,0.0,1361.0,5.0,2.0,0.0,373.0,Premier League,15-07-16,17.3.2.23,Ashley Barnes,28016057,765,30-Oct-89,26,0,0,0,0,4400,6550,6550,133,131,22706466,186,77,S L,2,2,2,4,1,1,2,3,2,1,1,6,8,8,12,13,7,15,9,5,8,12,13,9,12,18,13,17,13,15,8,12,16,5,10,12,11,15,16,13,12,10,14,13,15,13,20,16,16,13,15,15,7,14,7,9,12,9,12,5,5,12,Ashley Barnes,Â£2.25m ,Premier League
19-06-17,18.3.4.28,Robbie Brady,28019284,789,14-Jan-92,25,34,7,12,7,5350,6850,7000,145,142,44699462,176,65,D/WB/M/AM L,2,4,1,3,3,2,3,2,3,3,2,14,16,13,11,13,14,7,13,6,10,12,13,11,13,14,12,13,13,12,12,11,16,12,9,12,12,14,16,14,13,13,8,20,13,14,10,14,12,8,13,12,10,12,15,13,13,10,11,12,9,9,16,19,20,20,14,20,10,D/WB/M/AM L,443,1,1,1,10,20,12,1,16,1,1,10,20,14,19,10,2251940000000000.0,0,0,0,0,0,1,0,0,1,0,0,0,0,0,0,0,0,0,0,0,0,0,0,0,0,0,0,0,0,0,0,0,0,0,0,0,0,1,0,0,0,0,0,0,0,0,0,0,Robbie Brady,Â£9.00m ,28.0,176.0,Midfielder - Left Midfield,left,Burnley FC,40.0,5.0,8.0,2865.0,17.0,3.0,3.0,1405.0,17.0,0.0,1.0,760.0,18.0,1.0,2.0,526.0,3.0,0.0,0.0,151.0,Premier League,15-07-16,17.3.2.23,Robbie Brady,28019284,789,14-Jan-92,24,27,6,12,7,5000,6850,6850,143,137,28063931,176,65,D/WB/M/AM L,3,2,2,1,4,2,2,2,1,1,2,13,14,13,11,13,14,7,13,6,10,13,13,10,13,14,13,13,14,12,13,13,16,14,9,12,12,13,13,13,14,13,8,20,13,14,10,13,12,12,13,12,10,13,15,13,13,10,11,12,9,9,Robbie Brady,Â£9.00m ,Premier League
19-06-17,18.3.4.28,Tom Ince,28027646,765,30-Jan-92,25,0,0,18,3,4500,6250,6400,144,125,22012794,178,66,AM RLC,3,1,3,2,2,2,2,2,1,2,1,11,14,16,15,12,12,5,15,2,6,14,11,8,14,7,12,8,14,11,10,9,14,14,8,14,9,5,9,14,15,13,9,20,15,13,11,14,9,10,3,9,3,11,8,14,15,9,15,13,7,5,1,1,14,20,20,20,16,AM RLC,506,1,1,5,16,20,20,1,1,1,1,1,14,14,1,1,2324920000000000.0,0,0,0,0,0,0,0,0,0,0,1,0,0,0,0,0,0,0,0,0,0,0,0,0,0,0,0,0,0,0,0,0,0,0,0,0,0,0,0,1,0,1,0,0,0,0,1,0,Tom Ince,Â£7.20m ,28.0,178.0,Forward - Right Winger,left,Stoke City,50.0,15.0,8.0,3934.0,37.0,3.0,0.0,2745.0,41.0,6.0,9.0,3314.0,40.0,3.0,2.0,2869.0,2.0,0.0,0.0,103.0,Premier League
19-06-17,18.3.4.28,Connor Wickham,28030306,765,31-Mar-93,24,0,0,17,6,5050,6500,6400,140,129,24912386,191,90,S RLC,1,2,2,1,3,1,1,2,1,1,3,3,11,14,15,12,11,16,10,16,5,12,13,7,11,12,9,11,10,10,10,10,10,7,8,13,9,12,14,11,12,12,16,13,9,13,20,10,15,11,3,16,16,9,16,11,14,9,11,11,13,6,1,1,1,15,15,15,15,S RLC,606,1,1,20,15,15,15,1,1,1,1,1,1,1,1,1,1125900000000000.0,0,0,1,0,0,0,0,0,0,1,0,0,0,0,0,0,0,0,0,0,0,0,0,0,0,0,0,0,0,0,0,0,0,0,0,0,0,0,0,0,0,0,0,0,0,0,0,0,Connor Wickham,Â£4.50m ,27.0,189.0,Forward - Centre-Forward,right,Crystal Palace,10.0,3.0,0.0,545.0,nan,nan,nan,nan,8.0,1.0,1.0,159.0,21.0,3.0,1.0,1135.0,nan,nan,nan,nan,Premier League,15-07-16,17.3.2.23,Connor Wickham,28030306,765,31-Mar-93,23,0,0,17,6,5150,6500,6500,140,130,24610048,191,90,S RLC,1,1,3,3,1,2,1,1,1,2,1,3,11,14,15,12,11,16,10,16,5,12,13,7,11,12,9,11,10,10,10,10,10,7,8,13,9,12,14,11,12,12,16,13,9,13,20,10,17,11,3,16,16,9,14,11,14,9,11,11,13,6,Connor Wickham,Â£5.40m ,Premier League
19-06-17,18.3.4.28,Alex Oxlade-Chamberlain,28046572,765,15-Aug-93,23,27,6,8,4,6350,7250,7250,160,150,77968089,181,72,AM RLC,4,1,3,4,1,1,2,2,2,2,1,13,13,16,12,13,10,7,12,4,7,13,9,7,16,9,12,12,12,13,14,12,15,17,7,13,8,13,14,17,14,14,8,11,15,16,20,13,13,13,6,13,12,16,16,17,14,13,15,14,15,3,1,14,15,20,20,18,15,AM RLC,506,1,1,10,14,18,20,1,1,1,8,15,14,14,10,14,2322170000000000.0,0,0,0,0,0,0,0,0,0,0,0,0,0,0,0,0,0,0,0,0,0,0,0,0,0,0,0,1,0,0,0,0,0,0,0,0,0,0,0,0,0,0,0,0,0,0,1,0,Alex Oxlade-Chamberlain,Â£36.00m ,27.0,175.0,Midfielder - Central Midfield,right,Liverpool FC,45.0,6.0,11.0,2568.0,46.0,5.0,8.0,2410.0,4.0,0.0,0.0,105.0,43.0,8.0,2.0,2225.0,nan,nan,nan,nan,Premier League,15-07-16,17.3.2.23,Alex Oxlade-Chamberlain,28046572,765,15-Aug-93,22,24,5,8,4,6400,7250,7250,160,148,74691323,181,72,AM RL,3,1,1,3,3,3,2,3,3,3,2,10,12,16,11,13,8,7,12,4,5,13,9,7,16,8,12,13,12,13,14,12,15,17,7,13,8,13,14,17,14,13,7,13,15,16,20,13,12,13,6,13,13,16,9,17,14,16,15,14,15,3,Alex Oxlade-Chamberlain,Â£19.80m ,Premier League
19-06-17,18.3.4.28,Jesse Lingard,28047560,765,15-Dec-92,24,4,0,11,2,5850,7500,7600,156,148,89045882,175,62,M/AM RLC,2,3,2,1,3,3,3,1,2,2,1,10,13,14,14,14,8,6,11,4,6,13,11,6,14,15,12,13,13,12,13,12,16,16,5,16,9,16,18,15,15,13,5,10,16,15,20,17,9,11,4,15,3,9,20,14,17,15,18,9,12,7,1,1,17,20,18,18,20,M/AM RLC,526,1,1,12,20,18,18,1,1,1,1,14,17,15,1,1,549757000000.0,0,0,0,0,0,0,0,0,0,0,0,0,0,0,0,0,0,0,0,0,1,0,0,0,0,0,0,0,0,0,0,0,0,0,0,0,0,0,0,1,0,0,0,0,0,0,0,0,Jesse Lingard,Â£31.50m ,27.0,174.0,Midfielder - Attacking Midfield,right,Manchester United,42.0,5.0,3.0,2208.0,48.0,13.0,7.0,2652.0,36.0,5.0,4.0,2201.0,40.0,4.0,2.0,1888.0,2.0,0.0,0.0,99.0,Premier League,15-07-16,17.3.2.23,Jesse Lingard,28047560,765,15-Dec-92,23,0,0,11,2,5850,7500,7750,150,143,86969118,168,65,M/AM RLC,1,3,2,4,2,4,2,4,3,2,3,11,13,13,13,14,8,6,10,4,6,14,11,6,14,15,13,13,10,12,12,11,14,16,5,16,9,16,17,15,15,13,5,10,16,15,20,16,9,12,4,7,3,9,10,14,11,15,18,7,12,7,Jesse Lingard,Â£10.80m ,Premier League
19-06-17,18.3.4.28,Alex Pritchard,28049318,765,03-May-93,24,0,0,9,0,3700,6500,6650,140,133,31216778,171,62,AM RLC,2,1,3,4,2,1,3,2,2,3,3,14,14,14,11,15,16,7,14,5,7,15,11,9,14,11,12,5,13,11,14,14,13,14,7,15,11,12,13,13,15,13,6,10,14,13,20,13,10,13,9,12,10,12,10,14,10,11,11,8,14,11,1,1,13,20,20,15,17,AM RLC,506,1,1,1,17,15,20,1,1,1,1,11,10,13,1,1,2251900000000000.0,0,0,0,0,0,0,0,1,0,0,1,0,0,0,0,0,0,0,0,0,0,0,0,0,0,0,0,0,0,0,0,0,0,0,0,1,1,0,0,0,0,0,0,0,0,0,0,0,Alex Pritchard,Â£9.00m ,27.0,168.0,Midfielder - Attacking Midfield,right,Huddersfield Town,35.0,7.0,12.0,2194.0,24.0,2.0,4.0,1607.0,32.0,2.0,0.0,2179.0,18.0,0.0,1.0,964.0,4.0,0.0,0.0,360.0,Premier League
19-06-17,18.3.4.28,Wilfried Zaha,28051378,24,10-Nov-92,24,7,2,0,0,6200,7200,7400,149,148,70197805,181,67,AM RL,3,2,1,1,1,1,3,1,1,1,3,8,13,16,14,15,10,4,7,7,4,12,9,3,14,15,11,13,10,9,14,14,12,16,4,12,7,11,14,16,16,14,11,12,13,17,20,15,13,10,11,11,3,15,12,13,12,13,11,11,8,4,1,1,13,20,20,20,1,AM RL,505,1,1,10,1,20,20,1,1,1,1,1,12,13,1,1,2324950000000000.0,0,0,0,0,0,0,0,0,0,0,0,0,0,0,0,0,0,0,0,0,0,0,0,0,0,0,0,0,0,0,0,0,0,0,0,1,0,0,0,1,0,1,0,0,0,0,1,0,Wilfried Zaha,Â£27.00m ,27.0,180.0,Forward - Left Winger,right,Crystal Palace,37.0,7.0,11.0,3131.0,29.0,9.0,5.0,2550.0,36.0,10.0,10.0,3223.0,39.0,4.0,5.0,3307.0,6.0,5.0,1.0,540.0,Premier League,15-07-16,17.3.2.23,Wilfried Zaha,28051378,24,10-Nov-92,23,0,0,0,0,5650,6550,6750,139,137,26546141,181,67,AM RL,1,2,4,2,3,1,2,2,2,3,1,9,13,16,9,11,10,4,7,7,4,12,9,3,12,15,9,10,10,9,14,10,12,16,4,12,7,11,14,16,16,14,11,12,13,17,20,15,11,10,11,11,3,15,18,13,12,13,11,11,8,4,Wilfried Zaha,Â£16.20m ,Premier League
19-06-17,18.3.4.28,Nathan Redmond,28053447,765,06-Mar-94,23,1,0,38,10,5400,7150,7000,150,135,42921012,173,75,M/AM RL,1,4,2,3,1,3,2,1,2,1,3,8,13,14,10,13,10,3,13,3,7,12,6,8,13,10,11,9,10,10,12,9,15,14,4,13,11,11,11,17,14,15,6,7,14,17,20,11,9,11,7,12,5,9,8,13,15,12,13,15,14,5,1,1,18,20,18,20,14,M/AM RL,525,1,1,15,14,20,18,1,1,1,1,1,18,18,1,1,1.44115e+17,0,0,0,0,0,0,0,0,0,0,0,0,0,0,0,0,0,1,0,0,0,0,0,0,0,0,0,0,0,0,0,0,0,0,0,1,0,0,0,0,0,0,0,0,0,0,0,0,Nathan Redmond,Â£16.20m ,26.0,173.0,Forward - Left Winger,right,Southampton FC,50.0,8.0,1.0,3648.0,36.0,1.0,4.0,2106.0,43.0,9.0,6.0,3629.0,37.0,5.0,6.0,3065.0,5.0,0.0,0.0,363.0,Premier League,15-07-16,17.3.2.23,Nathan Redmond,28053447,765,06-Mar-94,22,0,0,29,10,5400,7000,7000,155,140,47331869,173,75,M/AM RL,2,1,3,1,1,2,2,4,3,1,1,8,13,15,10,15,12,3,13,3,7,12,6,8,13,10,10,9,12,12,12,11,15,14,4,14,11,13,11,17,14,15,6,7,14,17,20,12,10,11,5,12,5,9,8,13,15,12,13,15,14,5,Nathan Redmond,Â£13.50m ,Premier League
19-06-17,18.3.4.28,Raheem Sterling,28054109,765,08-Dec-94,22,32,2,8,3,6600,7650,7650,160,154,136106043,170,69,M/AM RLC,1,3,2,3,3,3,2,1,3,1,2,10,12,16,13,14,10,5,9,9,7,13,7,11,15,13,15,13,13,12,12,13,13,15,4,14,8,14,13,17,16,14,4,9,15,17,20,14,9,14,4,13,5,18,11,16,8,8,15,10,14,8,1,1,16,20,20,17,18,M/AM RLC,526,1,1,14,18,17,20,1,1,1,1,1,15,16,1,1,2252350000000000.0,0,0,0,1,0,0,0,0,0,0,0,0,0,0,0,0,0,0,0,0,0,0,0,0,0,0,0,0,0,0,0,0,0,0,0,0,0,0,0,1,0,0,0,0,0,0,0,0,Raheem Sterling,Â£81.00m ,25.0,170.0,Forward - Left Winger,right,Manchester City,47.0,10.0,20.0,3627.0,46.0,23.0,17.0,3568.0,51.0,25.0,18.0,4097.0,52.0,31.0,10.0,4017.0,8.0,4.0,3.0,644.0,Premier League,15-07-16,17.3.2.23,Raheem Sterling,28054109,765,08-Dec-94,21,26,2,8,3,6750,7550,7550,162,147,104413926,171,69,M/AM RLC,2,2,1,1,1,4,1,1,2,2,2,10,11,15,12,13,10,5,9,9,9,12,7,9,13,13,13,13,11,10,12,10,13,15,4,13,10,14,13,17,16,13,4,9,15,16,20,14,10,13,4,11,5,18,11,16,7,8,15,10,14,8,Raheem Sterling,Â£40.50m ,Premier League
19-06-17,18.3.4.28,Charlie Taylor,28059140,765,18-Sep-93,23,0,0,0,0,3750,6350,6350,144,128,12721053,181,70,D/WB L,3,1,1,3,2,2,1,3,1,2,1,14,16,13,9,13,12,11,9,10,11,12,5,16,13,10,13,12,11,14,7,12,14,11,8,13,13,14,14,14,13,13,11,20,17,13,7,15,12,15,4,13,7,16,15,15,11,15,12,17,10,6,20,17,15,10,1,20,11,D/WB L,113,1,1,1,1,10,1,11,20,1,1,1,15,1,17,1,2081.0,1,0,0,0,0,1,0,0,0,0,0,1,0,0,0,0,0,0,0,0,0,0,0,0,0,0,0,0,0,0,0,0,0,0,0,0,0,0,0,0,0,0,0,0,0,0,0,0,Charlie Taylor,Â£4.50m ,27.0,176.0,Defender - Left-Back,left,Burnley FC,32.0,0.0,4.0,2679.0,14.0,0.0,0.0,1249.0,45.0,0.0,2.0,3839.0,26.0,0.0,1.0,2079.0,7.0,0.0,0.0,630.0,Premier League
19-06-17,18.3.4.28,Alex Iwobi,28084930,38,03-May-96,21,4,0,0,0,6250,7250,7250,158,143,100011809,183,75,AM RLC,3,2,1,3,2,1,2,3,3,2,3,9,12,15,12,13,9,11,11,4,7,14,11,7,15,12,13,13,12,12,14,13,15,15,8,14,5,15,15,14,15,14,12,11,14,15,20,15,13,13,8,13,7,15,14,13,12,13,15,14,15,7,1,1,14,20,18,20,16,AM RLC,506,1,1,10,16,20,18,1,1,1,1,14,14,14,1,1,2252380000000000.0,0,0,0,0,0,0,0,0,0,0,0,0,0,0,0,0,0,0,0,0,0,0,0,0,0,0,0,0,0,0,0,0,0,0,0,1,0,0,0,1,0,0,0,0,0,0,0,0,Alex Iwobi,Â£13.50m ,24.0,183.0,Forward - Left Winger,right,Everton FC,39.0,4.0,8.0,2354.0,39.0,3.0,7.0,2645.0,51.0,6.0,9.0,2839.0,29.0,2.0,1.0,1941.0,7.0,1.0,2.0,264.0,Premier League,15-07-16,17.3.2.23,Alex Iwobi,28084930,38,03-May-96,20,4,0,0,0,6000,6750,6750,164,141,43627484,183,75,AM RLC,4,2,3,3,2,3,3,3,3,2,2,7,11,15,12,13,7,11,11,4,7,13,12,8,15,12,12,13,12,11,13,12,16,15,9,14,5,16,15,14,14,14,12,11,14,15,20,15,13,12,8,13,7,15,14,13,12,13,15,14,15,7,Alex Iwobi,Â£9.00m ,Premier League
19-06-17,18.3.4.28,Harvey Barnes,28100207,765,09-Dec-97,19,0,0,0,0,4250,5850,5850,152,119,10605245,178,0,AM RLC,1,1,1,1,4,2,2,2,1,1,2,9,11,13,12,12,11,8,14,8,6,11,10,7,13,9,10,11,14,9,12,11,15,12,7,12,7,12,11,13,14,12,10,11,13,14,20,13,9,10,2,11,11,12,15,9,12,12,14,12,14,1,1,1,12,20,19,20,18,AM RLC,506,1,1,14,18,20,19,1,1,1,1,1,12,12,1,1,1.44115e+17,0,0,0,0,0,0,0,0,1,0,0,1,0,0,0,0,0,0,0,0,0,0,0,0,0,0,0,0,0,0,0,0,0,0,0,0,0,0,0,0,0,0,0,0,0,0,0,0,Harvey Barnes,Â£225Th. ,22.0,182.0,Midfielder - Left Midfield,right,Leicester City,44.0,13.0,5.0,3550.0,38.0,10.0,7.0,2413.0,44.0,10.0,10.0,3335.0,42.0,7.0,9.0,2478.0,7.0,2.0,1.0,615.0,Premier League
19-06-17,18.3.4.28,Marcus Rashford,28100266,765,31-Oct-97,19,9,1,1,3,5900,7650,7750,171,146,197736436,184,0,AM/S L,3,2,2,1,4,3,2,3,2,2,3,10,8,14,14,13,13,8,10,3,2,11,13,5,14,14,11,8,13,11,9,12,14,17,4,14,4,12,15,18,15,13,8,12,16,17,20,14,11,14,4,14,4,10,18,11,12,17,14,13,18,4,1,1,14,18,14,18,14,AM/S L,623,1,1,20,14,18,14,1,1,1,1,12,14,14,1,1,34493964304.0,0,0,0,0,1,0,0,0,0,0,0,0,0,1,0,0,0,0,0,0,0,0,0,0,0,0,0,1,0,0,0,0,0,0,0,1,0,0,0,0,0,0,0,0,0,0,0,0,Marcus Rashford,Â£58.50m ,22.0,185.0,Forward - Left Winger,right,Manchester United,53.0,11.0,7.0,3068.0,52.0,13.0,10.0,2676.0,47.0,13.0,9.0,3291.0,44.0,22.0,11.0,3473.0,8.0,4.0,2.0,572.0,Premier League,15-07-16,17.3.2.23,Marcus Rashford,28100266,765,31-Oct-97,18,3,1,0,0,5899,7749,7749,162,144,148802785,181,73,AM/S L,2,1,3,1,3,3,1,2,1,1,2,5,8,14,14,13,11,8,11,3,2,11,13,5,14,14,12,8,13,11,9,12,14,17,4,14,4,12,15,18,16,13,8,12,16,17,20,14,11,12,5,12,4,10,13,10,11,17,12,13,18,4,Marcus Rashford,Â£16.20m ,Premier League
19-06-17,18.3.4.28,Reiss Nelson,28107919,765,10-Dec-99,17,0,0,0,0,4750,6000,6000,169,119,19762858,176,66,AM RL,2,4,3,3,3,1,2,4,3,2,1,12,12,14,12,12,10,6,9,7,8,12,12,10,13,8,11,10,12,11,12,11,14,15,5,13,9,12,13,14,14,8,6,9,14,14,20,12,8,13,6,13,6,13,16,12,12,10,13,14,13,5,1,14,14,20,19,20,14,AM RL,505,1,1,12,14,20,19,1,1,1,1,1,14,14,14,14,2251800000000000.0,0,0,0,0,1,0,0,0,0,0,0,0,0,0,0,0,0,0,0,0,0,0,0,0,0,0,0,0,0,0,0,0,0,0,0,0,0,0,0,0,0,0,0,0,0,0,0,0,Reiss Nelson, ,20.0,175.0,Forward - Right Winger,right,Arsenal FC,27.0,12.0,6.0,2236.0,27.0,9.0,3.0,1750.0,31.0,8.0,1.0,953.0,24.0,3.0,3.0,1131.0,4.0,1.0,0.0,170.0,Premier League
19-06-17,18.3.4.28,Ben Woodburn,28109701,801,15-Oct-99,17,0,0,0,0,3500,5750,5750,175,125,12428967,180,0,AM/S LC,2,2,3,2,2,1,3,2,3,4,4,8,13,14,14,14,9,8,11,3,8,14,12,8,15,11,13,11,14,13,14,13,15,14,7,14,8,13,13,14,13,12,7,7,12,13,20,10,10,12,7,13,7,12,14,14,15,17,17,10,17,6,1,1,14,19,14,19,18,AM/S LC,624,1,1,20,18,19,14,1,1,1,1,14,1,1,1,1,17592200000000.0,0,0,0,0,0,0,0,0,0,0,0,0,0,0,0,0,0,0,0,0,0,0,0,0,0,0,0,0,0,0,0,0,0,0,0,0,0,0,0,0,0,0,0,0,1,0,0,0,Ben Woodburn,Â£4.50m ,21.0,174.0,Midfielder - Attacking Midfield,right,Blackpool FC,24.0,9.0,6.0,1608.0,19.0,4.0,4.0,1524.0,15.0,2.0,3.0,848.0,16.0,1.0,5.0,948.0,7.0,1.0,0.0,571.0,Premier League
19-06-17,18.3.4.28,Victor FernÃ¡ndez,28118049,796,02-May-98,19,0,0,0,0,2250,4000,4650,128,88,1002059,179,0,M/AM L,2,1,1,2,1,1,1,1,3,3,3,9,14,14,6,14,7,8,8,7,6,8,1,4,11,8,6,7,6,7,9,10,9,14,13,5,7,8,9,14,11,9,10,20,11,11,7,13,6,7,7,9,4,9,11,12,13,12,10,12,13,7,1,1,17,20,1,20,1,M/AM L,523,1,1,14,1,20,1,1,1,1,1,1,17,1,1,1,0.0,0,0,0,0,0,0,0,0,0,0,0,0,0,0,0,0,0,0,0,0,0,0,0,0,0,0,0,0,0,0,0,0,0,0,0,0,0,0,0,0,0,0,0,0,0,0,0,0,HÃ©ctor HernÃ¡ndez,Â£270Th. ,29.0,170.0,Defender - Left-Back,left,Deportivo de La CoruÃ±a,17.0,0.0,2.0,1163.0,1.0,0.0,0.0,15.0,16.0,0.0,0.0,1361.0,31.0,0.0,0.0,2582.0,nan,nan,nan,nan,LaLiga
19-06-17,18.3.4.28,Marc Albrighton,29010506,765,18-Nov-89,27,0,0,8,1,5100,6900,6900,142,137,27458989,174,68,WB/M/AM RL,2,1,1,3,3,3,2,2,3,2,4,15,15,12,11,13,12,5,10,7,8,13,10,12,12,14,12,14,12,16,14,10,13,12,7,13,14,17,18,14,13,11,6,8,15,13,20,15,9,10,10,13,5,11,11,12,15,10,16,16,17,3,11,17,20,17,19,20,4,WB/M/AM RL,435,1,1,5,4,17,17,1,10,11,1,1,20,19,15,17,150633000000000.0,0,1,0,0,0,0,0,1,0,0,0,0,0,0,0,0,0,0,0,0,0,0,0,0,0,0,0,0,0,0,0,0,0,0,0,0,0,0,0,0,1,0,0,1,0,0,0,1,Marc Albrighton,Â£9.00m ,30.0,175.0,Midfielder - Right Midfield,right,Leicester City,47.0,4.0,9.0,3522.0,42.0,2.0,7.0,2968.0,32.0,3.0,4.0,1936.0,28.0,0.0,5.0,1439.0,4.0,0.0,0.0,125.0,Premier League,15-07-16,17.3.2.23,Marc Albrighton,29010506,765,18-Nov-89,26,0,0,8,1,5100,6900,6900,142,137,24485546,174,68,WB/M/AM RL,3,2,3,2,1,3,1,2,2,4,1,15,15,12,11,13,12,5,10,7,8,13,10,12,12,14,12,14,12,16,14,10,13,12,7,13,14,17,18,14,13,11,6,8,15,13,20,15,9,10,10,13,5,11,16,12,15,10,16,16,17,3,Marc Albrighton,Â£5.40m ,Premier League
19-06-17,18.3.4.28,Matt Phillips,29020283,793,13-Mar-91,26,4,0,0,0,5600,6900,6850,145,137,38454287,183,75,M/AM RL,1,1,3,3,1,3,1,1,4,1,2,14,16,14,12,12,8,11,14,1,7,12,7,6,13,4,10,9,12,12,13,12,12,15,7,13,6,12,13,14,13,13,12,13,14,16,20,14,13,13,2,13,12,12,13,14,10,11,13,10,9,7,9,13,20,20,20,18,8,M/AM RL,415,1,1,8,8,18,20,1,1,9,1,1,14,20,1,13,1.44115e+17,0,1,0,0,0,0,0,0,0,0,0,0,0,0,0,0,0,0,0,0,0,0,0,0,0,0,0,0,1,0,0,0,0,0,0,0,0,0,0,0,0,0,0,0,0,0,0,0,Matt Phillips,Â£8.10m ,29.0,183.0,Forward - Right Winger,right,West Bromwich Albion,29.0,5.0,9.0,2404.0,34.0,3.0,3.0,2354.0,33.0,5.0,6.0,2278.0,41.0,8.0,5.0,2579.0,6.0,0.0,0.0,149.0,Premier League,15-07-16,17.3.2.23,Matt Phillips,29020283,793,13-Mar-91,25,4,0,0,0,4500,6600,6600,145,138,24410629,183,75,M/AM RL,3,3,2,3,1,2,2,3,2,1,3,12,16,15,14,12,8,11,15,1,8,13,7,7,13,4,10,9,12,12,13,12,12,15,7,13,7,12,13,14,13,14,12,10,14,16,20,14,14,13,2,15,8,12,13,14,10,12,13,10,9,7,Matt Phillips,Â£8.10m ,Premier League
19-06-17,18.3.4.28,Jack Wilshere,29024338,765,01-Jan-92,25,34,2,7,0,6500,7500,7500,157,150,51292983,174,65,M/AM RLC,1,2,1,2,1,2,1,2,4,1,1,12,12,15,11,16,11,6,12,3,8,16,12,13,16,16,15,17,14,14,16,15,12,16,13,16,11,17,15,14,14,16,6,20,13,13,8,14,13,13,13,15,15,15,17,15,17,13,12,10,10,14,1,1,20,19,16,16,20,M/AM RLC,416,1,1,1,19,16,16,1,1,1,12,20,12,12,1,1,22012756000.0,0,0,0,0,0,1,0,0,0,0,0,0,0,0,0,0,0,0,0,0,1,0,0,0,0,0,0,0,0,1,0,0,1,0,1,0,0,0,0,0,0,0,0,0,0,0,0,0,Jack Wilshere,Â£18.00m ,28.0,172.0,Midfielder - Central Midfield,left,Without Club,29.0,0.0,2.0,1950.0,40.0,2.0,7.0,2795.0,9.0,0.0,1.0,456.0,10.0,1.0,0.0,358.0,1.0,0.0,0.0,90.0,Premier League,15-07-16,17.3.2.23,Jack Wilshere,29024338,765,01-Jan-92,24,34,2,7,0,6397,7347,7247,164,147,50256372,174,65,M/AM C,2,1,3,2,3,1,3,2,2,2,1,12,12,15,11,16,11,6,12,3,8,15,12,12,16,15,15,17,14,14,16,15,13,16,13,16,11,17,15,14,14,16,6,20,13,13,8,14,11,14,13,15,15,15,15,15,17,14,12,10,10,14,Jack Wilshere,Â£16.20m ,Premier League
19-06-17,18.3.4.28,Jeffrey Schlupp,29045055,21,23-Dec-92,24,15,1,0,0,5400,6500,6400,137,126,17191085,178,73,D/WB/M/AM L,1,3,1,3,4,2,3,2,3,2,1,9,11,14,11,12,8,10,10,12,11,12,9,11,10,10,13,12,12,9,12,8,15,14,7,11,11,12,15,16,12,12,6,20,15,17,4,14,13,7,8,10,9,13,14,13,14,10,13,12,15,3,18,17,20,16,1,20,1,D/WB/M/AM L,443,1,1,14,1,16,1,1,18,1,1,1,20,1,17,1,2251820000000000.0,0,0,0,0,0,0,0,0,0,0,0,0,0,0,0,0,0,0,0,0,0,0,0,0,0,0,0,1,0,1,0,0,0,0,1,0,0,0,0,0,0,0,0,0,0,0,0,0,Jeffrey Schlupp,Â£8.10m ,27.0,178.0,Midfielder - Left Midfield,left,Crystal Palace,27.0,1.0,1.0,1661.0,27.0,0.0,2.0,1896.0,37.0,5.0,3.0,2267.0,17.0,3.0,2.0,1035.0,5.0,0.0,1.0,380.0,Premier League,15-07-16,17.3.2.23,Jeffrey Schlupp,29045055,21,23-Dec-92,23,12,1,0,0,5500,6500,6550,137,132,15646600,178,73,D/WB/M/AM/S L,1,2,4,1,3,2,3,2,1,1,1,9,11,11,10,11,8,10,10,12,11,12,9,11,10,10,13,12,12,9,12,8,15,14,7,11,11,12,15,16,12,12,6,20,15,17,4,14,13,7,8,10,9,10,14,13,14,10,13,12,15,3,Jeffrey Schlupp,Â£7.20m ,Premier League
19-06-17,18.3.4.28,Sam Clucas,29057738,765,25-Sep-90,26,0,0,0,0,4900,6450,6450,135,129,20545990,188,74,DM/M/AM LC,1,3,1,2,3,2,4,3,1,3,1,13,13,13,12,11,13,12,14,11,11,13,9,12,11,8,12,10,12,11,11,12,14,13,7,13,13,14,16,12,14,11,12,20,15,12,8,15,9,14,4,12,3,15,10,11,9,10,11,10,10,3,12,14,20,16,12,20,19,DM/M/AM LC,434,1,1,1,14,16,12,1,12,1,17,19,20,12,14,1,2251800000000000.0,0,0,0,0,0,0,0,0,0,0,0,0,0,0,0,0,0,0,0,1,0,0,0,0,0,0,0,0,0,0,0,0,0,0,0,0,0,0,0,0,0,0,0,0,0,0,0,0,Sam Clucas,Â£7.20m ,30.0,178.0,Midfielder - Central Midfield,left,Stoke City,41.0,3.0,1.0,3550.0,39.0,3.0,2.0,2659.0,29.0,3.0,4.0,2306.0,46.0,11.0,5.0,4069.0,6.0,0.0,0.0,540.0,Premier League,15-07-16,17.3.2.23,Sam Clucas,29057738,765,25-Sep-90,25,0,0,0,0,4500,6300,6300,132,126,14853526,188,74,DM/M/AM L,3,1,1,1,2,1,3,1,2,3,1,13,14,13,13,11,13,12,13,11,8,13,9,12,12,8,10,8,12,10,11,11,13,13,7,13,12,14,17,12,14,11,12,20,15,12,8,15,7,15,4,13,3,15,10,11,9,9,9,10,10,3,Sam Clucas,Â£2.25m ,Premier League
19-06-17,18.3.4.28,Jacob Murphy,29079830,765,24-Feb-95,22,0,0,6,1,4350,6250,6450,140,125,31583457,176,71,AM RL,3,3,2,2,1,2,1,1,2,1,1,5,13,14,13,12,10,4,14,5,7,12,5,8,12,9,11,9,12,12,11,10,12,11,4,14,10,11,11,16,13,13,7,20,13,15,12,10,11,11,3,7,5,10,8,11,12,11,12,11,15,1,1,1,15,20,20,17,13,AM RL,505,1,1,10,13,17,20,1,1,1,1,1,8,15,1,1,70368700000000.0,0,0,0,0,0,0,0,0,0,0,0,0,0,0,0,0,0,0,0,0,0,0,0,0,0,0,0,0,0,0,0,0,0,0,0,0,0,0,0,0,0,0,0,0,0,0,1,0,Jacob Murphy,Â£6.30m ,25.0,173.0,Forward - Right Winger,right,Newcastle United,40.0,9.0,8.0,2724.0,28.0,1.0,1.0,1367.0,28.0,2.0,3.0,1411.0,44.0,9.0,6.0,2650.0,5.0,2.0,1.0,318.0,Premier League
19-06-17,18.3.4.28,Jordon Ibe,29081734,765,08-Dec-95,21,0,0,4,0,5500,6750,6550,152,136,28531105,176,70,AM RL,1,1,3,3,2,3,1,2,3,3,1,9,12,15,11,12,5,6,10,3,8,12,8,8,14,9,12,5,13,9,13,11,12,14,4,13,9,12,12,17,15,12,8,11,13,16,20,12,12,10,4,13,7,13,13,15,10,13,14,13,10,7,1,12,15,20,20,18,14,AM RL,505,1,1,12,14,18,20,1,1,1,1,1,14,15,1,12,549756000000.0,0,0,0,0,0,0,0,0,0,0,0,0,0,0,0,0,0,0,0,0,0,0,0,0,0,0,0,0,0,0,0,0,0,0,0,0,0,0,0,1,0,0,0,0,0,0,0,0,Jordon Ibe,Â£8.10m ,24.0,176.0,Forward - Right Winger,right,Derby County,26.0,0.0,0.0,1145.0,38.0,2.0,8.0,2277.0,24.0,3.0,1.0,1195.0,4.0,0.0,0.0,227.0,nan,nan,nan,nan,Premier League,15-07-16,17.3.2.23,Jordon Ibe,29081734,765,08-Dec-95,20,0,0,4,0,5500,6750,6750,141,135,26239986,176,70,AM RL,3,1,2,4,3,2,3,1,1,3,2,9,12,15,11,12,5,6,10,3,8,12,8,8,14,9,12,5,13,9,13,11,12,14,4,13,9,12,12,17,15,12,8,11,13,16,20,12,12,10,4,13,7,13,13,15,10,13,14,13,10,7,Jordon Ibe,Â£7.20m ,Premier League
19-06-17,18.3.4.28,Sam McQueen,29084504,765,06-Feb-95,22,0,0,1,0,3750,6150,6150,141,123,15634719,181,0,D L,1,2,3,3,1,2,2,1,3,2,2,10,14,12,11,13,9,13,10,9,12,13,7,9,13,8,10,13,11,11,12,12,11,13,9,11,12,12,11,13,12,14,12,20,11,14,11,14,12,11,4,9,10,15,13,9,11,12,11,12,12,7,20,12,15,15,14,20,14,D L,103,1,1,14,14,15,14,1,20,1,1,1,15,1,12,1,0.0,0,0,0,0,0,0,0,0,0,0,0,0,0,0,0,0,0,0,0,0,0,0,0,0,0,0,0,0,0,0,0,0,0,0,0,0,0,0,0,0,0,0,0,0,0,0,0,0,Sam McQueen,Â£900Th. ,25.0,181.0,Defender - Left-Back,left,Southampton FC,32.0,2.0,2.0,2318.0,16.0,6.0,0.0,952.0,8.0,0.0,1.0,344.0,nan,nan,nan,nan,nan,nan,nan,nan,Premier League
19-06-17,18.3.4.28,Dele Alli,29085579,765,11-Apr-96,21,19,2,2,0,6750,7900,7900,173,156,171528159,188,80,M/AM RLC,1,1,3,2,1,2,3,1,1,3,1,8,12,15,16,13,10,14,14,9,10,15,14,10,16,13,16,12,15,11,15,11,14,17,7,17,11,14,17,12,15,13,12,13,17,11,20,19,13,10,14,12,4,16,11,17,13,12,15,7,8,6,1,1,18,20,17,16,20,M/AM RLC,526,1,1,14,20,16,17,1,1,1,12,18,10,14,1,1,2251840000000000.0,0,0,0,0,0,0,0,0,0,0,0,0,0,0,0,0,1,0,0,0,0,0,0,0,0,0,0,0,0,0,0,1,0,0,0,1,0,0,0,0,0,0,0,0,0,0,0,0,Dele Alli,Â£90.00m ,24.0,188.0,Midfielder - Attacking Midfield,right,Tottenham Hotspur,50.0,22.0,13.0,4014.0,50.0,14.0,17.0,3790.0,38.0,7.0,8.0,2963.0,38.0,9.0,6.0,2772.0,5.0,1.0,0.0,198.0,Premier League,15-07-16,17.3.2.23,Dele Alli,29085579,765,11-Apr-96,20,12,1,2,0,6400,7650,7650,170,150,186189180,185,77,M/AM C,2,2,3,1,2,3,1,3,1,2,2,8,12,15,16,14,8,14,14,9,12,16,12,12,15,14,13,15,15,14,15,13,14,16,7,14,13,14,16,15,15,14,13,8,14,14,20,15,13,15,12,12,4,15,13,17,13,12,15,10,9,2,Dele Alli,Â£40.50m ,Premier League
19-06-17,18.3.4.28,Solly March,29090530,765,20-Jul-94,22,0,0,3,1,3750,6500,6500,141,130,26056258,181,73,M/AM RLC,1,3,3,3,1,1,2,1,2,4,3,13,13,14,9,13,13,8,14,5,7,13,8,9,14,10,9,9,12,10,13,10,14,14,5,12,11,13,13,14,13,13,10,20,12,14,12,14,7,13,6,15,12,15,19,10,12,15,14,12,13,5,1,1,19,20,20,19,19,M/AM RLC,526,1,1,1,19,19,20,1,1,1,1,14,19,19,1,1,2.90482e+17,0,0,0,0,0,0,0,0,0,0,0,0,0,0,0,0,0,0,0,0,0,0,0,0,0,0,0,1,0,0,0,0,0,0,0,0,0,0,0,0,0,0,0,0,0,0,0,0,Solly March,Â£4.50m ,26.0,180.0,Midfielder - Left Midfield,left,Brighton & Hove Albion,34.0,4.0,4.0,1751.0,40.0,1.0,3.0,2105.0,37.0,2.0,6.0,2542.0,20.0,0.0,1.0,1188.0,6.0,1.0,1.0,508.0,Premier League
19-06-17,18.3.4.28,Demarai Gray,29114887,765,28-Jun-96,20,0,0,11,4,5500,6900,6900,152,141,29582615,178,78,M/AM RL,2,1,2,4,3,4,3,2,3,1,2,13,14,16,11,15,12,6,10,6,7,11,9,5,14,9,9,7,12,9,13,8,9,15,7,12,8,9,12,17,14,12,9,12,15,17,20,13,9,12,5,11,5,6,10,14,11,11,15,9,11,5,1,1,19,20,19,20,14,M/AM RL,525,1,1,12,14,20,19,1,1,1,1,1,19,19,1,1,34493956096.0,0,0,0,0,0,0,0,0,0,0,0,0,0,0,0,0,0,0,0,0,0,0,0,0,0,0,0,1,0,0,0,0,0,0,0,1,0,0,0,0,0,0,0,0,0,0,0,0,Demarai Gray,Â£18.00m ,24.0,180.0,Forward - Left Winger,right,Leicester City,43.0,3.0,6.0,1848.0,44.0,4.0,4.0,2375.0,39.0,4.0,1.0,2271.0,29.0,3.0,5.0,1060.0,1.0,0.0,0.0,90.0,Premier League,15-07-16,17.3.2.23,Demarai Gray,29114887,765,28-Jun-96,20,0,0,1,0,4750,6650,6650,150,133,40678917,178,78,M/AM RL,3,1,1,2,3,1,1,2,1,1,4,11,14,16,12,13,12,6,10,6,7,11,9,5,14,9,9,7,12,9,13,10,9,15,7,12,8,11,12,16,13,11,9,12,15,16,20,12,8,12,5,11,5,6,10,14,11,11,15,9,11,5,Demarai Gray,Â£8.10m ,Premier League
19-06-17,18.3.4.28,Oliver Burke,29122255,793,07-Apr-97,20,5,0,0,0,5400,6400,6400,150,128,39413923,188,75,M/AM RL,1,3,1,1,4,1,1,2,3,1,1,9,11,14,13,12,9,10,11,10,6,11,10,6,12,14,10,15,12,11,10,8,14,15,8,12,5,10,14,14,12,18,15,10,16,18,20,12,14,12,5,13,6,11,8,16,10,12,13,15,15,4,1,8,20,20,20,15,10,M/AM RL,415,1,1,12,10,15,20,1,1,1,1,1,15,20,1,8,2.8823e+17,0,0,0,0,0,0,0,0,0,0,0,0,0,0,0,0,0,0,0,0,0,0,0,0,0,0,0,1,0,0,0,0,0,0,0,0,0,0,0,0,0,0,0,0,0,0,0,0,Oliver Burke,Â£9.00m ,23.0,188.0,Forward - Right Winger,right,Sheffield United,32.0,5.0,4.0,1108.0,22.0,1.0,2.0,668.0,30.0,8.0,6.0,1825.0,35.0,1.0,2.0,1564.0,5.0,0.0,0.0,318.0,Premier League,15-07-16,17.3.2.23,Oliver Burke,29122255,793,07-Apr-97,19,2,0,0,0,4500,6500,6500,154,125,3359630,188,74,M/AM RL,1,1,3,2,1,3,1,3,3,3,2,9,11,14,13,12,8,10,11,10,6,12,10,6,12,12,10,14,11,11,10,8,14,13,9,12,6,10,12,14,12,17,15,9,16,18,20,12,14,12,5,11,6,11,11,16,10,12,13,15,15,4,Oliver Burke,Â£6.30m ,Bundesliga
19-06-17,18.3.4.28,Dominic Calvert-Lewin,29123128,765,16-Mar-97,20,0,0,0,0,4750,6250,6450,155,129,40231535,186,64,AM/S RL,3,3,1,2,2,2,3,1,1,2,1,9,11,11,13,12,7,12,9,2,6,11,7,5,13,11,11,12,11,10,7,11,14,14,5,12,6,12,15,16,14,11,13,9,14,15,20,15,14,11,6,10,3,14,12,13,11,10,13,12,11,5,5,1,10,18,18,18,13,AM/S RL,625,1,1,20,13,18,18,5,1,1,1,10,10,10,1,1,1099650000000.0,0,0,0,0,0,0,0,0,0,0,0,0,0,0,0,0,0,0,0,0,0,0,0,0,0,0,0,1,0,0,0,0,0,0,0,0,0,0,0,0,1,0,0,0,0,0,0,0,Dominic Calvert-Lewin,Â£13.50m ,23.0,187.0,Forward - Centre-Forward,right,Everton FC,21.0,5.0,2.0,1134.0,44.0,8.0,7.0,2458.0,38.0,8.0,3.0,1974.0,41.0,15.0,1.0,2996.0,8.0,10.0,0.0,655.0,Premier League
19-06-17,18.3.4.28,Izzy Brown,29125187,765,07-Jan-97,20,0,0,0,0,4600,6300,6300,145,126,30326607,184,77,AM/S RLC,3,4,1,3,3,1,3,1,3,1,3,5,10,14,12,12,10,9,11,6,8,11,11,8,12,13,11,12,12,9,13,12,8,13,10,13,7,12,11,14,12,12,13,12,11,14,20,12,13,13,9,12,10,8,20,12,10,11,11,11,13,6,1,1,15,20,17,15,20,AM/S RLC,516,1,1,17,20,15,17,1,1,1,1,10,15,15,1,1,0.0,0,0,0,0,0,0,0,0,0,0,0,0,0,0,0,0,0,0,0,0,0,0,0,0,0,0,0,0,0,0,0,0,0,0,0,0,0,0,0,0,0,0,0,0,0,0,0,0,Izzy Brown,Â£4.50m ,23.0,182.0,Midfielder - Attacking Midfield,right,Sheffield Wednesday,41.0,8.0,6.0,2972.0,15.0,0.0,1.0,402.0,2.0,0.0,0.0,11.0,28.0,1.0,8.0,1644.0,4.0,0.0,1.0,338.0,Premier League
19-06-17,18.3.4.28,Josh Sims,29125433,765,23-Mar-97,20,0,0,0,0,3400,5800,5800,148,120,8297115,168,0,AM LC,3,2,3,2,2,1,1,3,2,4,3,9,11,15,9,14,9,6,11,4,5,14,7,8,14,5,14,8,14,8,14,13,6,13,7,10,6,12,12,15,12,13,5,20,10,15,9,10,6,11,3,11,4,11,20,12,10,11,12,10,20,6,1,1,15,20,14,20,15,AM LC,504,1,1,1,15,20,14,1,1,1,1,1,15,1,1,1,0.0,0,0,0,0,0,0,0,0,0,0,0,0,0,0,0,0,0,0,0,0,0,0,0,0,0,0,0,0,0,0,0,0,0,0,0,0,0,0,0,0,0,0,0,0,0,0,0,0,Josh Sims,Â£675Th. ,23.0,174.0,Forward - Right Winger,left,Doncaster Rovers,30.0,6.0,6.0,2079.0,12.0,0.0,3.0,565.0,34.0,1.0,5.0,1434.0,2.0,0.0,0.0,45.0,7.0,4.0,5.0,554.0,Premier League
19-06-17,18.3.4.28,Bakary Sako,34000670,31,26-Apr-88,29,19,9,13,2,5400,6400,6500,130,130,19468702,180,76,AM RLC,1,3,3,2,1,2,3,3,1,1,1,10,13,14,13,12,14,8,15,5,3,10,14,6,12,9,12,10,10,9,11,11,10,15,7,14,8,11,10,16,13,12,9,20,14,15,10,13,15,10,8,13,9,9,9,11,13,9,14,15,15,5,1,1,15,20,16,20,15,AM RLC,506,1,1,1,15,20,16,1,1,1,1,1,15,15,1,1,2357390000000000.0,0,0,0,0,0,0,0,0,0,1,0,0,0,0,0,0,0,0,0,0,0,0,0,0,0,0,0,0,0,0,0,0,0,0,0,1,0,0,0,0,0,0,0,0,0,1,1,0,Bakary Sako,Â£4.50m ,32.0,183.0,Forward - Left Winger,left,Without Club,8.0,0.0,0.0,200.0,19.0,6.0,0.0,718.0,10.0,1.0,0.0,275.0,6.0,1.0,0.0,505.0,nan,nan,nan,nan,Premier League,15-07-16,17.3.2.23,Bakary Sako,34000670,31,26-Apr-88,28,17,9,13,2,5250,6400,6450,130,129,11043766,180,76,AM RLC,3,3,3,1,3,3,3,2,3,1,3,10,13,14,10,12,14,8,15,5,3,10,14,6,12,9,12,11,11,9,11,11,10,15,7,12,8,11,10,16,13,12,9,20,14,15,10,13,15,10,8,13,9,9,20,11,13,9,14,15,15,5,Bakary Sako,Â£5.40m ,Premier League
19-06-17,18.3.4.28,Mesut Ãzil,35002219,771,15-Oct-88,28,84,21,16,5,7750,8500,8250,180,162,215628997,183,72,AM RLC,3,3,2,1,4,3,2,3,2,1,4,14,15,17,11,19,12,7,11,1,6,19,11,9,19,6,18,7,18,12,19,16,8,19,6,19,6,16,11,14,16,14,9,20,15,13,8,15,9,11,5,13,6,10,16,13,9,14,15,14,16,12,1,1,12,20,17,16,20,AM RLC,506,1,1,1,20,16,17,1,1,1,1,12,12,10,1,1,18350224.0,0,0,0,0,1,0,0,1,0,0,0,0,0,0,0,0,0,0,0,1,1,0,0,0,1,0,0,0,0,0,0,0,0,0,0,0,0,0,0,0,0,0,0,0,0,0,0,0,Mesut Ãzil,Â£45.00m ,32.0,180.0,Midfielder - Attacking Midfield,left,Arsenal FC,44.0,12.0,14.0,3746.0,35.0,5.0,14.0,2953.0,35.0,6.0,3.0,2420.0,23.0,1.0,3.0,1812.0,nan,nan,nan,nan,Premier League,15-07-16,17.3.2.23,Mesut Ãzil,35002219,771,15-Oct-88,27,79,20,16,5,8500,8750,8750,180,176,130619977,183,72,AM RLC,2,2,1,2,3,1,1,1,3,3,2,15,16,17,12,19,13,7,11,4,6,19,13,9,19,7,18,9,19,15,20,18,14,19,8,20,6,19,12,14,16,14,9,20,15,13,10,15,9,13,5,16,6,10,16,16,12,17,15,14,16,10,Mesut Ãzil,Â£45.00m ,Premier League
19-06-17,18.3.4.28,JosÃ© Holebas,35007230,772,27-Jun-84,32,38,1,0,0,5500,6000,6600,145,135,10623775,185,81,D/WB/M L,3,3,1,2,3,3,1,2,1,3,2,14,15,13,10,10,13,10,14,16,10,12,14,14,12,15,11,13,10,8,11,10,15,11,6,10,11,14,16,15,13,13,13,20,18,15,9,16,15,12,9,12,6,12,16,16,14,12,8,8,6,15,20,19,18,8,1,20,1,D/WB/M L,123,1,1,1,1,8,1,1,20,1,1,1,18,1,19,1,131361.0,1,0,0,0,0,1,0,0,1,0,0,0,0,0,0,0,0,1,0,0,0,0,0,0,0,0,0,0,0,0,0,0,0,0,0,0,0,0,0,0,0,0,0,0,0,0,0,0,nan,nan,nan,nan,nan,nan,nan,nan,nan,nan,nan,nan,nan,nan,nan,nan,nan,nan,nan,nan,nan,nan,nan,nan,nan,nan,nan,nan,15-07-16,17.3.2.23,JosÃ© Holebas,35007230,772,27-Jun-84,32,38,1,0,0,5000,6750,6600,145,134,232186002,184,79,D/WB/M L,2,3,2,1,1,1,3,2,3,3,1,14,13,13,10,10,13,10,14,12,10,12,14,14,12,15,11,13,10,8,11,10,15,11,6,10,11,14,16,15,13,13,13,20,18,15,9,16,15,12,9,12,6,12,16,16,14,12,8,10,6,15,nan,nan,nan
19-06-17,18.3.4.28,Maxim Choupo-Moting,35015916,11,23-Mar-89,28,44,13,0,0,5600,7100,6950,143,139,42193307,189,82,M/AM/S L,3,1,4,1,2,2,2,1,2,1,1,9,12,15,12,16,8,13,10,7,2,13,14,7,15,10,11,9,11,11,13,10,8,15,6,13,4,10,9,13,14,10,14,15,11,16,20,12,14,8,5,10,12,14,9,11,13,10,14,12,14,9,1,1,20,20,14,20,12,M/AM/S L,423,1,1,18,12,20,14,1,1,1,1,1,20,14,1,1,18142000000000.0,0,0,0,0,0,0,0,0,0,0,0,0,0,0,0,0,0,0,0,0,0,0,0,0,1,0,0,0,0,0,0,0,0,0,0,0,0,0,0,1,0,0,0,0,1,0,0,0,Eric Maxim Choupo-Moting,Â£7.20m ,31.0,191.0,Forward - Centre-Forward,right,Bayern Munich,30.0,3.0,7.0,2072.0,32.0,5.0,5.0,2356.0,31.0,3.0,2.0,1295.0,20.0,6.0,1.0,823.0,4.0,2.0,1.0,110.0,Premier League,15-07-16,17.3.2.23,Maxim Choupo-Moting,35015916,11,23-Mar-89,27,43,13,0,0,5100,7100,7100,143,142,19433157,189,82,M/AM/S RL,3,3,3,3,1,2,2,2,1,3,3,9,12,16,12,16,8,13,10,7,5,13,14,6,15,12,12,9,10,11,13,10,8,15,6,13,7,10,9,13,14,10,14,15,11,16,20,12,13,10,5,10,15,14,9,10,13,11,12,12,14,9,Eric Maxim Choupo-Moting,Â£5.40m ,Bundesliga
19-06-17,18.3.4.28,Chris LÃ¶we,35022877,771,16-Apr-89,28,0,0,0,0,5100,6300,6800,140,136,31122834,175,68,D/WB L,2,3,2,1,2,3,1,3,4,1,1,13,14,12,10,11,13,8,11,12,11,12,13,14,11,14,11,10,13,13,12,12,12,11,10,13,12,14,16,16,15,10,9,20,14,14,8,14,11,16,8,14,5,10,11,13,12,9,15,14,16,6,20,18,15,15,1,20,1,D/WB L,113,1,1,1,1,15,1,1,20,1,1,1,15,1,18,1,0.0,0,0,0,0,0,0,0,0,0,0,0,0,0,0,0,0,0,0,0,0,0,0,0,0,0,0,0,0,0,0,0,0,0,0,0,0,0,0,0,0,0,0,0,0,0,0,0,0,Chris LÃ¶we,Â£1.35m ,31.0,173.0,Defender - Left-Back,left,SG Dynamo Dresden,45.0,2.0,3.0,3918.0,25.0,0.0,0.0,1702.0,31.0,0.0,2.0,2159.0,22.0,1.0,3.0,1603.0,6.0,0.0,0.0,464.0,Premier League
19-06-17,18.3.4.28,Steve MouniÃ©,36514846,7,29-Sep-94,22,7,1,0,0,4900,6400,6550,141,130,27555301,190,83,AM/S L,2,2,4,3,2,2,1,4,1,2,3,8,11,14,14,12,6,16,11,5,8,12,12,7,13,9,14,11,11,12,12,10,11,11,8,13,15,9,12,13,12,14,16,8,12,14,20,14,15,12,8,10,8,8,7,15,14,11,14,13,12,7,1,1,1,17,1,17,1,AM/S L,623,1,1,20,1,17,1,1,1,1,1,1,1,1,1,1,0.0,0,0,0,0,0,0,0,0,0,0,0,0,0,0,0,0,0,0,0,0,0,0,0,0,0,0,0,0,0,0,0,0,0,0,0,0,0,0,0,0,0,0,0,0,0,0,0,0,Steve MouniÃ©,Â£9.00m ,26.0,190.0,Forward - Centre-Forward,right,Stade Brest 29,38.0,15.0,3.0,3036.0,31.0,9.0,2.0,2157.0,32.0,2.0,3.0,1820.0,32.0,8.0,2.0,1454.0,6.0,2.0,0.0,515.0,Premier League,15-07-16,17.3.2.23,Steve MouniÃ©,36514846,7,29-Sep-94,21,3,1,0,0,3800,5600,6200,142,124,9951577,190,83,S ,2,1,2,3,2,1,1,3,2,2,2,8,11,13,14,12,6,17,11,5,8,12,12,7,12,10,8,11,12,12,10,11,11,11,9,12,13,8,12,13,13,12,16,9,12,12,20,13,15,12,8,10,8,8,8,12,13,10,10,11,14,8,Steve MouniÃ©,Â£4.95m ,Ligue 1
19-06-17,18.3.4.28,Erik Pieters,37000517,784,07-Aug-88,28,18,0,19,1,5700,6650,6550,134,129,20823549,186,82,D/WB LC,2,1,2,2,1,2,1,1,3,3,3,8,9,12,7,12,6,13,5,10,14,13,8,15,12,10,14,14,11,14,12,12,16,6,13,14,14,14,15,11,13,13,12,20,16,11,10,15,12,15,10,15,15,12,13,15,16,12,14,7,7,14,20,18,15,1,1,20,16,D/WB LC,114,1,1,1,1,1,1,16,20,1,1,1,15,1,18,1,0.0,0,0,0,0,0,0,0,0,0,0,0,0,0,0,0,0,0,0,0,0,0,0,0,0,0,0,0,0,0,0,0,0,0,0,0,0,0,0,0,0,0,0,0,0,0,0,0,0,Erik Pieters,Â£5.40m ,32.0,183.0,Defender - Left-Back,left,Burnley FC,39.0,0.0,1.0,3346.0,32.0,0.0,3.0,2790.0,38.0,3.0,3.0,3275.0,26.0,2.0,4.0,2058.0,5.0,0.0,0.0,395.0,Premier League,15-07-16,17.3.2.23,Erik Pieters,37000517,784,07-Aug-88,27,18,0,19,1,5700,6650,6700,134,134,16996484,186,82,D/WB LC,2,2,3,2,1,4,3,1,2,3,2,8,9,12,7,12,6,13,5,10,14,13,8,15,12,10,14,14,14,14,12,14,16,6,13,14,14,14,15,12,13,13,12,20,16,12,10,15,12,15,10,15,15,12,13,15,16,12,14,7,7,14,Erik Pieters,Â£6.30m ,Premier League
19-06-17,18.3.4.28,Rajiv van La Parra,37001854,784,04-Jun-91,26,0,0,6,0,4500,6150,6350,133,123,20159589,181,72,AM RL,1,2,3,1,2,3,2,3,3,2,2,12,12,14,7,12,12,9,11,6,3,12,8,6,14,6,10,9,10,9,13,11,13,15,6,13,10,8,10,16,13,12,10,10,12,15,20,12,12,11,6,11,8,12,12,13,12,10,14,14,14,8,1,1,14,20,20,18,12,AM RL,505,1,1,14,12,18,20,1,1,1,1,7,14,14,1,1,1134010000000.0,0,1,0,0,0,0,0,0,0,0,0,0,0,0,0,0,0,0,0,0,0,0,0,0,0,0,0,1,0,0,0,0,0,0,0,1,0,0,0,0,1,0,0,0,0,0,0,0,Rajiv van La Parra,Â£3.60m ,29.0,181.0,Forward - Left Winger,right,Without Club,46.0,2.0,4.0,3510.0,38.0,5.0,1.0,2490.0,10.0,0.0,0.0,565.0,16.0,1.0,2.0,957.0,nan,nan,nan,nan,Premier League
19-06-17,18.3.4.28,Marko Arnautovic,37003555,755,19-Apr-89,28,62,15,5,3,6250,7250,7350,147,145,66034305,192,83,M/AM/S RL,3,2,1,2,1,1,2,2,1,3,2,6,13,16,9,17,13,7,11,8,2,12,9,4,17,18,6,15,10,9,12,7,12,18,4,13,6,5,9,12,15,15,13,18,12,14,20,13,13,12,14,13,8,13,14,18,6,12,17,8,8,15,1,1,20,20,19,20,1,M/AM/S RL,425,1,1,19,1,20,19,1,1,1,1,1,20,19,1,1,1.44186e+17,0,0,0,0,0,0,0,0,0,0,0,1,0,0,0,0,0,1,0,0,0,0,0,0,0,0,0,0,0,0,0,0,0,0,0,1,0,0,0,0,0,0,0,0,0,0,1,0,Marko Arnautovic,Â£22.50m ,31.0,189.0,Forward - Centre-Forward,both,Shanghai SIPG,35.0,7.0,6.0,2966.0,35.0,11.0,8.0,2472.0,45.0,20.0,7.0,3079.0,17.0,8.0,1.0,1208.0,nan,nan,nan,nan,Premier League,15-07-16,17.3.2.23,Marko Arnautovic,37003555,755,19-Apr-89,27,55,11,4,2,6250,6950,7250,147,147,50476956,192,83,M/AM RL,1,3,3,1,1,3,3,2,2,3,4,8,14,17,9,19,14,8,12,12,3,14,10,6,18,14,7,15,11,10,13,8,14,19,4,14,7,6,8,13,16,18,14,18,12,15,20,14,15,12,14,13,8,13,14,18,3,7,14,8,6,15,Marko Arnautovic,Â£13.50m ,Premier League
19-06-17,18.3.4.28,Marvin Zeegelaar,37005651,784,12-Aug-90,26,0,0,0,0,4250,6500,6400,137,128,17025523,186,81,D/M/AM L,1,1,2,2,2,4,1,3,2,3,3,11,13,14,7,12,9,10,9,11,9,12,4,12,15,12,13,12,11,13,9,11,13,13,5,14,10,12,13,15,15,12,13,20,12,15,5,14,14,13,7,11,6,12,10,13,10,12,8,11,6,8,20,13,18,17,1,20,1,D/M/AM L,123,1,1,7,1,17,1,1,20,1,1,1,18,1,13,1,4.61169e+18,1,0,0,0,0,1,0,0,0,0,0,0,0,0,0,0,0,0,0,0,0,0,0,0,0,0,0,1,0,0,0,0,0,0,0,0,0,0,0,0,0,0,0,0,0,0,0,0,Marvin Zeegelaar,Â£2.70m ,30.0,186.0,Defender - Left-Back,left,Udinese Calcio,26.0,0.0,3.0,2036.0,13.0,0.0,2.0,1085.0,12.0,0.0,0.0,955.0,13.0,0.0,1.0,591.0,2.0,0.0,0.0,126.0,Premier League,15-07-16,17.3.2.23,Marvin Zeegelaar,37005651,784,12-Aug-90,25,0,0,0,0,3750,6500,6400,137,128,945832,186,81,D/M/AM L,3,1,2,2,4,1,2,3,2,2,2,11,13,14,7,12,9,10,9,11,9,12,6,12,15,9,13,12,11,13,9,12,13,13,5,14,10,12,13,15,15,12,13,20,12,15,5,13,12,13,7,11,6,12,10,13,10,12,8,11,6,8,Marvin Zeegelaar,Â£3.15m ,Liga NOS
19-06-17,18.3.4.28,Luciano Narsingh,37006629,784,13-Sep-90,26,19,4,10,1,5750,6550,6650,133,133,31216778,175,75,AM RL,3,2,2,3,1,3,1,2,2,3,3,15,15,17,9,15,9,4,10,9,5,14,10,5,13,11,13,8,11,10,9,10,12,16,3,14,5,13,13,17,15,11,7,8,8,16,20,11,7,9,10,12,13,8,18,13,14,13,15,7,11,4,1,1,14,20,20,18,10,AM RL,505,1,1,7,10,18,20,1,1,1,1,10,14,14,1,1,0.0,0,0,0,0,0,0,0,0,0,0,0,0,0,0,0,0,0,0,0,0,0,0,0,0,0,0,0,0,0,0,0,0,0,0,0,0,0,0,0,0,0,0,0,0,0,0,0,0,Luciano Narsingh,Â£4.50m ,30.0,175.0,Forward - Right Winger,right,Feyenoord Rotterdam,36.0,3.0,4.0,1582.0,26.0,3.0,4.0,1155.0,4.0,0.0,0.0,178.0,32.0,7.0,1.0,1636.0,4.0,1.0,0.0,122.0,Premier League,15-07-16,17.3.2.23,Luciano Narsingh,37006629,784,13-Sep-90,25,18,4,10,1,5750,6550,6550,133,131,20304821,175,75,AM RL,4,3,3,3,2,1,3,2,1,3,2,15,15,17,9,15,9,4,10,9,5,14,11,5,14,11,12,8,10,10,9,10,12,16,3,15,5,13,14,17,15,11,7,8,8,16,20,10,7,9,10,12,13,8,17,13,14,13,15,7,11,5,Luciano Narsingh,Â£4.50m ,Premier League
19-06-17,18.3.4.28,JÃ¼rgen Locadia,37019516,784,07-Nov-93,23,0,0,7,1,5650,6550,6550,138,131,27715586,185,87,AM/S L,3,1,1,3,2,3,3,2,3,4,3,11,7,13,13,13,15,13,11,12,4,10,14,4,12,13,14,12,11,9,13,12,11,14,7,14,5,10,11,12,14,13,14,14,12,13,20,13,15,12,5,8,14,14,13,14,7,12,8,13,11,8,1,1,14,19,12,19,14,AM/S L,623,1,1,20,14,19,12,1,1,1,1,10,14,10,1,1,35184400000000.0,0,0,0,0,0,0,0,0,0,0,0,1,0,0,0,0,0,0,0,0,0,0,0,0,0,0,0,0,0,0,0,0,0,0,0,0,0,0,0,0,0,0,0,0,0,1,0,0,JÃ¼rgen Locadia,Â£13.50m ,26.0,185.0,Forward - Centre-Forward,right,FC Cincinnati,17.0,4.0,4.0,1036.0,26.0,11.0,8.0,1885.0,34.0,4.0,1.0,1730.0,29.0,6.0,1.0,1799.0,nan,nan,nan,nan,Premier League
19-06-17,18.3.4.28,JÃ³hann Berg GuÄmundsson,39007034,774,27-Oct-90,26,52,5,14,6,5850,7100,7100,144,142,50386782,178,79,M/AM RL,2,3,3,3,3,3,2,2,2,2,1,12,17,14,12,13,14,11,13,5,7,14,14,7,15,12,14,10,14,12,14,13,14,13,5,12,11,15,15,14,13,13,13,20,15,13,11,15,9,11,4,11,11,10,12,16,12,13,16,14,13,4,1,1,19,20,20,16,13,M/AM RL,525,1,1,12,13,16,20,1,1,1,1,9,15,19,1,1,2.88371e+17,1,0,0,0,0,0,0,0,1,0,0,0,0,0,0,0,0,0,0,0,0,0,0,0,0,0,0,0,0,0,0,1,0,0,0,0,0,0,0,0,0,0,0,0,0,0,0,1,JÃ³hann Berg Gudmundsson,Â£9.00m ,29.0,186.0,Forward - Right Winger,left,Burnley FC,24.0,1.0,3.0,1297.0,38.0,2.0,8.0,3047.0,36.0,3.0,7.0,2279.0,13.0,1.0,1.0,665.0,3.0,0.0,0.0,106.0,Premier League,15-07-16,17.3.2.23,JÃ³hann Berg GuÄmundsson,39007034,774,27-Oct-90,25,52,5,14,6,5350,6650,6650,140,133,24454378,178,79,M/AM RL,1,3,3,1,1,1,2,2,1,4,2,11,14,14,11,13,14,9,13,5,7,14,14,7,15,12,14,10,12,12,13,13,14,13,5,12,11,15,15,13,13,13,13,20,15,13,11,15,9,11,4,11,11,10,12,16,12,13,16,14,13,4,JÃ³hann Berg Gudmundsson,Â£2.25m ,Premier League
19-06-17,18.3.4.28,Hal Robson-Kanu,4002231,801,21-May-89,28,40,4,4,2,5450,6700,6350,130,123,12212058,186,84,AM/S RLC,1,2,3,2,2,3,1,3,2,2,3,11,12,14,12,13,10,10,13,10,6,10,14,7,11,9,9,8,10,10,9,8,15,14,8,12,8,12,12,14,11,16,12,20,15,15,10,11,14,10,3,15,7,14,8,14,16,12,15,16,13,4,1,1,14,20,18,20,15,AM/S RLC,516,1,1,19,15,20,18,1,1,1,1,1,14,13,1,1,34359740672.0,0,0,0,0,0,0,0,0,1,0,0,1,0,0,0,0,0,0,0,0,0,0,0,0,0,0,0,0,0,0,0,0,0,0,0,1,0,0,0,0,0,0,0,0,0,0,0,0,Hal Robson-Kanu,Â£2.25m ,31.0,183.0,Forward - Centre-Forward,left,West Bromwich Albion,32.0,3.0,1.0,805.0,24.0,2.0,0.0,1027.0,41.0,5.0,1.0,1974.0,40.0,12.0,1.0,2405.0,5.0,3.0,0.0,230.0,Premier League,15-07-16,17.3.2.23,Hal Robson-Kanu,4002231,801,21-May-89,27,35,4,4,2,5250,6500,6050,130,123,5069384,186,84,AM/S RLC,3,2,1,3,2,2,2,3,1,2,1,11,12,14,12,13,10,10,13,10,6,10,14,7,11,9,9,8,10,10,9,8,15,14,8,12,8,12,12,14,11,16,12,20,15,15,10,11,14,10,3,15,7,14,8,14,16,12,15,16,13,4,Hal Robson-Kanu,Â£2.25m ,Premier League
19-06-17,18.3.4.28,Manolo Gabbiadini,43050841,776,26-Nov-91,25,8,2,24,12,5900,7100,7200,151,138,54901561,186,81,AM/S RL,1,1,3,1,2,3,3,3,3,2,3,9,9,13,15,15,13,14,17,8,5,13,15,7,13,11,13,8,13,14,14,13,13,14,8,15,9,12,12,13,14,14,12,20,12,13,9,14,13,14,10,14,6,12,14,18,13,11,17,15,11,6,1,1,1,18,18,15,12,AM/S RL,625,1,1,20,12,15,18,1,1,1,1,1,1,1,1,1,2.8823e+17,0,0,0,0,0,0,0,0,1,1,0,0,0,0,0,0,0,0,0,0,0,0,0,0,0,0,0,0,0,0,0,0,0,0,0,0,1,0,0,0,0,0,0,0,0,0,0,0,Manolo Gabbiadini,Â£10.80m ,28.0,186.0,Forward - Centre-Forward,left,UC Sampdoria,31.0,11.0,0.0,1588.0,33.0,5.0,0.0,1206.0,33.0,5.0,2.0,1430.0,35.0,12.0,2.0,2047.0,1.0,0.0,0.0,6.0,Premier League,15-07-16,17.3.2.23,Manolo Gabbiadini,43050841,776,26-Nov-91,24,6,1,24,12,5800,7000,7200,151,144,45993271,186,81,AM/S RL,1,1,1,3,3,1,2,2,1,2,2,13,14,13,15,15,15,14,17,8,5,13,15,7,14,11,13,8,13,14,14,13,13,14,8,15,9,12,12,13,14,14,12,20,12,14,10,14,13,14,10,14,6,12,14,18,13,11,17,15,11,6,Manolo Gabbiadini,Â£13.50m ,Premier League
19-06-17,18.3.4.28,Sean Scannell,5007475,789,17-Sep-90,26,0,0,10,0,3000,5850,5850,130,117,2109370,175,73,AM RL,3,3,1,3,3,2,3,3,4,2,3,6,11,14,11,13,5,11,9,5,5,10,9,7,12,9,9,9,10,7,8,9,9,13,5,12,7,12,13,16,13,14,8,15,11,16,20,8,8,10,4,12,4,14,9,12,12,9,11,13,12,3,1,12,13,20,20,17,14,AM RL,505,1,1,14,14,17,20,1,1,1,1,1,10,13,10,12,17592300000000.0,0,0,0,0,1,0,0,0,0,0,0,0,0,0,0,0,0,0,0,0,0,0,0,0,0,0,0,1,0,0,0,0,0,0,0,0,0,0,0,0,0,0,0,0,1,0,0,0,Sean Scannell,Â£450Th. ,30.0,176.0,Forward - Right Winger,right,Grimsby Town,16.0,0.0,1.0,749.0,20.0,0.0,1.0,1126.0,18.0,0.0,1.0,1438.0,18.0,2.0,0.0,930.0,3.0,0.0,0.0,194.0,Premier League
19-06-17,18.3.4.28,James Milner,5106363,765,04-Jan-86,31,61,1,46,9,6500,7600,7500,157,150,232186002,176,70,D/WB/DM/M/AM RLC,2,3,2,3,3,1,1,3,2,2,2,12,14,12,9,14,7,8,7,7,12,13,14,13,13,14,14,16,14,14,12,13,17,12,14,13,14,17,18,12,13,13,8,8,17,12,20,16,14,14,9,15,6,19,17,15,14,15,18,12,15,8,16,18,20,16,18,18,20,D/WB/DM/M/AM RLC,456,1,1,10,10,16,16,1,16,13,16,20,18,18,18,14,1236950000000.0,0,0,0,0,0,1,0,0,0,0,0,0,0,0,0,0,0,0,0,0,0,0,0,0,0,0,0,0,0,0,0,0,0,0,0,0,0,1,0,0,1,0,0,0,0,0,0,0,James Milner,Â£13.50m ,34.0,175.0,Midfielder - Central Midfield,right,Liverpool FC,40.0,7.0,4.0,3437.0,47.0,1.0,11.0,2787.0,45.0,7.0,7.0,2836.0,37.0,4.0,4.0,1708.0,7.0,0.0,0.0,305.0,Premier League,15-07-16,17.3.2.23,James Milner,5106363,765,04-Jan-86,30,61,1,46,9,6500,7600,7500,157,153,232186002,176,70,WB/DM/M/AM RLC,3,3,3,2,2,2,1,1,1,2,1,11,14,13,10,14,7,8,9,7,12,13,15,14,13,14,14,16,14,14,13,13,17,12,15,13,14,17,18,12,13,13,8,10,17,12,20,16,14,15,8,15,6,19,14,15,15,14,18,12,14,6,James Milner,Â£10.80m ,Premier League
19-06-17,18.3.4.28,Aaron Lennon,5109664,765,16-Apr-87,30,21,0,5,0,5600,6550,6500,155,127,23046121,165,63,M/AM RL,2,3,2,3,3,3,3,1,3,1,2,7,12,14,9,14,7,7,4,5,7,14,9,10,14,5,14,9,10,12,10,12,11,10,4,15,11,17,17,15,14,11,5,10,12,13,20,15,8,10,6,11,5,14,13,15,14,11,13,10,14,4,1,1,20,20,20,15,13,M/AM RL,415,1,1,1,13,15,20,1,1,1,1,1,10,20,1,1,2.0,0,1,0,0,0,0,0,0,0,0,0,0,0,0,0,0,0,0,0,0,0,0,0,0,0,0,0,0,0,0,0,0,0,0,0,0,0,0,0,0,0,0,0,0,0,0,0,0,Aaron Lennon,Â£4.50m ,33.0,165.0,Forward - Right Winger,right,Kayserispor,13.0,1.0,1.0,667.0,33.0,0.0,4.0,2113.0,22.0,1.0,1.0,1563.0,19.0,0.0,1.0,734.0,3.0,0.0,0.0,112.0,Premier League,15-07-16,17.3.2.23,Aaron Lennon,5109664,765,16-Apr-87,29,21,0,5,0,5800,6850,6850,155,133,12651208,165,63,M/AM RL,1,3,3,2,2,1,2,3,2,2,1,7,13,14,9,14,7,7,4,5,7,14,9,10,15,5,14,9,10,13,10,12,11,10,4,15,10,17,17,16,14,12,5,10,12,14,20,15,8,10,6,11,5,14,18,15,14,11,13,10,14,4,Aaron Lennon,Â£4.50m ,Premier League
19-06-17,18.3.4.28,Wayne Routledge,5109888,765,07-Jan-85,32,0,0,12,1,5350,6500,6500,138,130,12192764,170,76,AM/S RL,2,2,1,1,3,2,3,2,1,1,2,11,9,14,9,12,11,6,9,4,6,9,9,5,16,11,13,9,12,9,11,13,12,13,6,15,10,13,14,15,16,13,5,10,16,14,20,12,9,12,10,10,2,14,5,12,13,15,14,10,13,10,1,1,14,20,17,20,14,AM/S RL,515,1,1,16,14,20,17,1,1,1,1,1,14,14,1,1,1040.0,0,0,0,0,1,0,0,0,0,0,1,0,0,0,0,0,0,0,0,0,0,0,0,0,0,0,0,0,0,0,0,0,0,0,0,0,0,0,0,0,0,0,0,0,0,0,0,0,Wayne Routledge,Â£1.35m ,35.0,170.0,Forward - Left Winger,right,Swansea City,29.0,3.0,1.0,2045.0,22.0,1.0,1.0,892.0,26.0,5.0,4.0,2027.0,24.0,5.0,4.0,1156.0,2.0,0.0,0.0,83.0,Premier League,15-07-16,17.3.2.23,Wayne Routledge,5109888,765,07-Jan-85,31,0,0,12,1,5548,6648,6648,138,134,6753020,170,76,AM/S RL,1,1,2,1,1,3,3,2,1,2,2,11,9,14,9,12,11,6,9,4,6,9,9,5,17,11,14,9,12,10,11,13,12,13,5,15,10,12,14,15,16,13,5,10,16,15,20,12,9,11,10,10,2,14,5,12,13,15,14,10,13,10,Wayne Routledge,Â£2.25m ,Premier League
19-06-17,18.3.4.28,Jonathan Walters,5110963,789,20-Sep-83,33,49,14,1,2,4500,6550,6600,133,125,7439222,183,79,M/AM/S RLC,2,2,2,3,2,3,3,1,1,2,3,7,10,12,11,9,7,13,10,12,8,10,9,10,11,16,12,17,11,19,13,14,18,11,12,12,4,17,20,11,10,14,13,4,18,12,20,19,14,18,8,12,8,13,12,11,15,13,19,14,16,5,1,1,19,20,20,15,15,M/AM/S RLC,536,1,1,18,15,15,20,1,1,1,1,1,15,19,1,1,549756000000.0,0,0,0,0,0,0,0,0,0,0,0,0,0,0,0,0,1,0,0,1,0,0,0,0,0,0,0,0,0,0,0,0,0,0,0,0,0,0,0,1,0,0,0,0,0,0,0,0,Jonathan Walters,Â£1.80m ,37.0,183.0,Forward - Right Winger,right,Retired,24.0,4.0,4.0,1386.0,5.0,0.0,0.0,94.0,4.0,0.0,1.0,277.0,nan,nan,nan,nan,nan,nan,nan,nan,Premier League,15-07-16,17.3.2.23,Jonathan Walters,5110963,789,20-Sep-83,32,41,10,1,2,4500,6550,6900,133,125,1163291,183,79,M/AM/S RLC,2,1,2,2,2,1,4,2,3,1,1,7,10,12,11,9,7,13,10,12,8,10,9,10,10,16,12,17,11,19,13,14,18,11,12,12,4,17,20,11,10,14,13,4,18,11,20,19,14,18,8,12,6,13,12,11,15,13,19,14,16,5,Jonathan Walters,Â£2.25m ,Premier League
19-06-17,18.3.4.28,Ashley Young,5113149,765,09-Jul-85,31,30,7,10,0,6100,6750,6750,155,143,232186002,175,65,D/M RL,2,3,2,1,2,2,1,3,1,2,2,14,15,12,10,14,14,5,13,3,9,12,12,11,13,7,11,6,10,14,9,13,12,14,10,13,12,15,16,14,15,12,7,9,15,15,20,15,10,12,8,15,5,13,18,12,8,12,13,4,14,4,20,15,18,15,18,20,14,D/M RL,115,1,1,12,14,15,13,1,20,18,1,1,18,14,15,15,70918500000000.0,1,0,0,0,0,0,0,0,0,0,1,1,0,0,0,0,0,0,0,0,0,0,0,0,0,0,0,0,0,0,0,0,0,0,0,0,0,0,0,1,0,0,0,0,0,0,1,0,Ashley Young,Â£6.30m ,35.0,175.0,Midfielder - Left Midfield,both,Inter Milan,23.0,0.0,1.0,1469.0,39.0,2.0,7.0,3156.0,41.0,2.0,3.0,3509.0,43.0,5.0,6.0,3005.0,3.0,0.0,1.0,152.0,Premier League,15-07-16,17.3.2.23,Ashley Young,5113149,765,09-Jul-85,31,30,7,10,0,6100,6750,6750,155,138,2684630,175,65,M/AM RL,3,3,4,2,1,1,3,3,2,3,2,14,14,12,10,14,12,5,13,3,9,12,12,10,13,7,11,6,9,14,9,13,12,14,5,13,12,13,16,15,15,12,7,9,15,15,20,14,10,12,8,15,5,13,18,12,8,12,13,4,14,4,Ashley Young,Â£4.50m ,Premier League
19-06-17,18.3.4.28,Chris Brunt,5113355,785,14-Dec-84,32,59,2,5,1,5400,7250,7000,142,140,18833309,187,86,D/M/AM RLC,3,3,3,4,1,3,1,2,2,3,2,14,16,11,11,12,14,12,15,8,10,15,14,8,14,10,12,11,12,10,14,13,14,12,10,12,12,16,14,9,12,14,14,20,14,10,12,13,13,14,9,15,5,17,15,14,14,11,16,14,10,3,17,15,20,20,17,20,18,D/M/AM RLC,436,1,1,4,14,20,17,1,17,1,14,18,20,17,15,1,44530200000000.0,0,0,0,0,0,0,0,0,1,1,0,0,0,0,0,0,0,0,0,0,0,0,0,0,0,0,0,0,0,0,0,0,0,0,0,0,0,0,0,1,0,0,0,1,0,1,0,0,Chris Brunt,Â£2.70m ,35.0,187.0,Midfielder - Central Midfield,left,Bristol City,33.0,4.0,4.0,2616.0,29.0,0.0,8.0,2120.0,36.0,2.0,7.0,2291.0,16.0,0.0,0.0,849.0,5.0,0.0,0.0,213.0,Premier League,15-07-16,17.3.2.23,Chris Brunt,5113355,785,14-Dec-84,31,54,1,5,1,5400,7250,6800,141,141,8222991,187,86,D/M/AM RLC,2,4,3,2,3,2,4,3,3,2,3,11,16,11,11,12,14,12,16,8,10,15,14,8,14,10,12,11,12,10,14,13,14,12,10,12,12,16,14,10,12,14,14,20,14,10,12,14,13,14,9,15,5,17,15,14,14,11,16,14,10,3,Chris Brunt,Â£3.60m ,Premier League
19-06-17,18.3.4.28,Marc Pugh,5113470,765,02-Apr-87,30,0,0,0,0,4800,6300,6500,135,132,232186002,180,73,M/AM RL,2,1,1,1,1,1,1,3,1,2,3,9,13,13,14,15,9,11,11,5,7,14,12,8,12,10,13,5,14,12,12,13,12,14,6,12,8,14,17,12,14,14,9,12,13,13,20,15,13,14,5,13,7,14,12,14,15,12,16,12,12,5,1,1,20,17,20,20,13,M/AM RL,415,1,1,1,13,17,17,1,1,1,1,1,20,20,1,1,2322750000000000.0,0,0,0,0,0,0,0,0,0,0,0,0,0,0,0,0,0,1,0,0,0,0,0,0,0,0,0,0,0,0,0,0,0,0,0,1,0,0,0,1,0,0,0,0,0,0,1,0,Marc Pugh,Â£1.35m ,33.0,180.0,Forward - Left Winger,right,Without Club,23.0,2.0,3.0,1451.0,25.0,1.0,2.0,1352.0,17.0,4.0,2.0,1020.0,31.0,2.0,4.0,1477.0,nan,nan,nan,nan,Premier League,15-07-16,17.3.2.23,Marc Pugh,5113470,765,02-Apr-87,29,0,0,0,0,4600,6300,6500,132,130,15668923,180,73,M/AM RL,2,4,3,2,2,2,2,1,3,1,3,9,12,13,14,15,9,11,11,5,7,14,12,8,12,10,13,5,13,12,12,12,11,14,6,12,8,14,17,12,14,14,9,12,13,13,20,15,13,13,5,13,7,14,12,13,14,12,11,12,12,5,Marc Pugh,Â£1.80m ,Premier League
19-06-17,18.3.4.28,Adam Lallana,5125012,765,10-May-88,29,33,3,1,0,6750,7600,7950,162,159,181424464,173,73,M/AM RLC,1,1,3,2,2,2,3,3,3,2,2,10,13,16,13,16,10,6,11,2,10,15,7,10,18,9,16,11,16,13,15,14,17,17,12,16,12,15,17,13,15,15,6,15,15,11,20,17,10,15,7,14,12,12,13,14,15,15,18,13,14,8,1,1,17,20,18,17,20,M/AM RLC,526,1,1,1,20,17,18,1,1,1,1,17,15,15,1,1,18141900000000.0,0,0,0,1,0,0,0,0,0,0,0,0,0,0,0,0,0,0,0,0,1,0,0,0,0,0,0,0,0,0,0,0,0,0,0,0,0,0,0,1,0,0,0,0,1,0,0,0,Adam Lallana,Â£22.50m ,32.0,172.0,Midfielder - Attacking Midfield,both,Brighton & Hove Albion,35.0,8.0,7.0,2607.0,16.0,0.0,1.0,519.0,16.0,0.0,0.0,568.0,22.0,1.0,2.0,899.0,6.0,0.0,0.0,295.0,Premier League,15-07-16,17.3.2.23,Adam Lallana,5125012,765,10-May-88,28,26,0,1,0,6400,7600,7650,164,159,102707651,173,73,M/AM RLC,1,2,3,3,1,3,1,3,1,3,1,11,13,17,13,17,10,6,11,2,10,15,9,10,18,9,15,11,15,12,15,14,15,17,12,16,13,15,17,13,16,15,6,16,15,10,20,15,10,15,7,14,11,12,13,14,16,13,15,12,13,9,Adam Lallana,Â£22.50m ,Premier League
19-06-17,18.3.4.28,Jay Rodriguez,5128651,765,29-Jul-89,27,1,0,1,0,5550,6650,6650,145,133,31216778,186,70,M/AM/S RL,1,2,2,2,3,2,2,3,2,4,4,3,8,13,14,13,6,14,13,2,10,12,11,10,13,13,12,14,13,11,13,11,14,14,7,14,8,14,14,14,12,11,13,9,15,14,20,12,13,14,10,13,15,14,12,15,13,12,16,16,14,8,1,1,18,18,17,18,14,M/AM/S RL,635,1,1,20,14,18,17,1,1,1,1,1,18,17,1,1,8196.0,0,0,1,0,0,0,0,0,0,0,0,0,0,1,0,0,0,0,0,0,0,0,0,0,0,0,0,0,0,0,0,0,0,0,0,0,0,0,0,0,0,0,0,0,0,0,0,0,Jay RodrÃ­guez,Â£10.80m ,31.0,185.0,Forward - Centre-Forward,right,Burnley FC,35.0,6.0,3.0,1426.0,42.0,11.0,2.0,3207.0,48.0,22.0,6.0,4180.0,39.0,11.0,2.0,2277.0,4.0,0.0,1.0,181.0,Premier League,15-07-16,17.3.2.23,Jay Rodriguez,5128651,765,29-Jul-89,26,1,0,1,0,5550,6950,7100,145,140,37878257,186,70,M/AM/S RL,2,2,1,3,1,3,2,3,3,2,3,3,8,15,13,13,6,14,13,2,10,12,11,10,13,13,12,14,14,11,13,12,14,14,7,14,8,14,15,15,12,11,13,9,15,15,20,12,14,14,10,13,15,14,12,15,13,12,16,16,14,8,Jay RodrÃ­guez,Â£9.00m ,Premier League
19-06-17,18.3.4.28,Danny Rose,5134489,765,02-Jul-90,26,12,0,29,3,6100,7400,7400,152,145,49053687,174,76,D/WB L,3,1,1,1,1,1,2,3,2,2,1,9,12,12,11,14,8,13,12,5,13,13,10,15,13,16,13,15,13,13,12,14,15,9,6,16,13,14,15,15,13,14,8,20,14,14,7,17,14,14,12,14,14,13,8,16,11,13,14,11,11,14,20,18,15,12,1,20,6,D/WB L,113,1,1,1,1,12,1,1,20,1,1,6,15,1,18,1,4294967328.0,0,0,0,0,0,1,0,0,0,0,0,0,0,0,0,0,0,0,0,0,0,0,0,0,0,0,0,0,0,0,0,0,1,0,0,0,0,0,0,0,0,0,0,0,0,0,0,0,Danny Rose,Â£27.00m ,30.0,173.0,Defender - Left-Back,left,Tottenham Hotspur,21.0,2.0,4.0,1803.0,17.0,0.0,1.0,1319.0,37.0,0.0,5.0,2564.0,29.0,0.0,2.0,2284.0,nan,nan,nan,nan,Premier League,15-07-16,17.3.2.23,Danny Rose,5134489,765,02-Jul-90,26,7,0,29,3,5950,7400,7400,155,150,69054923,172,73,D/WB L,1,1,1,4,2,3,1,1,2,1,1,6,14,14,11,14,8,12,10,5,13,13,10,14,13,17,14,15,13,14,13,13,12,9,6,13,13,14,15,18,13,14,5,20,14,16,7,15,14,15,8,14,14,10,8,14,10,13,10,13,14,6,Danny Rose,Â£25.20m ,Premier League
19-06-17,18.3.4.28,Jason Puncheon,5200783,765,26-Jun-86,30,0,0,0,0,5150,6100,6250,138,125,12527383,173,71,AM RLC,1,3,2,2,3,1,4,1,2,3,2,11,11,12,8,11,16,6,10,5,11,12,9,11,13,11,13,10,15,12,13,12,15,13,14,16,10,14,13,13,14,16,9,20,12,11,12,14,13,8,2,12,9,12,16,14,12,12,8,12,9,9,1,1,15,20,15,15,20,AM RLC,506,1,1,10,20,15,15,1,1,1,1,5,10,15,1,1,70919000000000.0,0,0,0,0,0,1,0,0,0,0,0,0,0,0,0,0,0,0,0,0,0,0,0,0,0,0,0,0,0,1,0,0,0,0,0,0,0,0,0,1,0,0,0,0,0,0,1,0,Jason Puncheon,Â£4.50m ,34.0,173.0,Midfielder - Attacking Midfield,left,Pafos FC,39.0,0.0,6.0,3234.0,12.0,0.0,0.0,750.0,15.0,0.0,0.0,745.0,16.0,0.0,1.0,1267.0,7.0,1.0,1.0,630.0,Premier League,15-07-16,17.3.2.23,Jason Puncheon,5200783,765,26-Jun-86,30,0,0,0,0,5178,6137,6650,138,137,232186002,173,71,AM RLC,2,2,1,1,1,2,1,3,2,3,2,11,13,13,13,13,16,6,14,5,11,12,9,11,13,11,15,10,15,12,13,12,15,17,14,16,10,14,13,13,14,16,9,20,12,13,12,14,13,8,2,13,9,12,19,14,12,12,8,12,9,9,Jason Puncheon,Â£4.95m ,Premier League
19-06-17,18.3.4.28,James McClean,52014383,789,22-Apr-89,28,52,9,0,0,5350,6550,6500,131,129,7809034,175,70,M/AM RL,2,2,1,3,2,1,4,3,3,3,2,12,12,13,11,11,12,11,12,6,5,11,10,6,11,17,11,14,11,11,11,10,13,14,5,13,8,12,15,15,12,15,9,20,14,16,9,15,13,12,18,10,5,5,13,14,11,12,10,11,6,17,1,1,20,19,15,20,10,M/AM RL,415,1,1,13,10,19,15,1,1,1,1,1,20,15,1,1,154619000000.0,0,0,0,1,0,0,0,0,0,0,0,0,0,0,0,0,0,1,0,0,0,0,0,0,0,0,0,0,0,0,0,0,0,0,1,0,0,1,0,0,0,0,0,0,0,0,0,0,James McClean,Â£2.70m ,31.0,180.0,Midfielder - Left Midfield,left,Stoke City,36.0,2.0,3.0,1616.0,34.0,1.0,0.0,1675.0,45.0,3.0,7.0,3131.0,37.0,7.0,9.0,3078.0,6.0,1.0,1.0,434.0,Premier League,15-07-16,17.3.2.23,James McClean,52014383,789,22-Apr-89,27,42,5,0,0,4850,6550,6350,131,130,10047704,175,70,M/AM RL,3,3,3,3,2,2,2,3,2,2,1,12,11,13,11,11,12,11,12,6,5,12,10,9,11,17,11,14,11,11,12,11,13,14,5,13,8,12,15,15,12,14,9,20,14,16,9,15,13,12,16,10,5,5,13,14,11,12,10,11,6,17,James McClean,Â£2.70m ,Premier League
19-06-17,18.3.4.28,Scott Arfield,5209516,364,01-Nov-88,28,3,0,0,0,4650,6600,6600,133,132,23381935,178,70,M RLC,1,1,1,3,2,3,2,1,1,3,1,12,11,12,14,13,9,8,12,5,10,13,13,11,14,9,12,13,14,14,12,12,17,11,8,14,14,19,17,11,13,14,9,10,17,12,20,17,11,12,6,12,4,14,10,14,16,11,18,18,15,2,8,1,20,15,20,20,15,M RLC,406,1,1,1,13,15,15,1,1,8,10,15,20,20,1,1,18141900000000.0,0,0,0,0,0,1,0,0,0,0,0,0,0,0,0,0,0,0,0,0,0,0,0,0,0,0,0,0,0,0,0,0,0,0,0,0,0,0,0,1,0,0,0,0,1,0,0,0,Scott Arfield,Â£2.70m ,31.0,178.0,Midfielder - Central Midfield,left,Rangers FC,35.0,1.0,1.0,2366.0,20.0,2.0,1.0,1497.0,46.0,12.0,7.0,3605.0,49.0,9.0,5.0,3481.0,16.0,3.0,3.0,901.0,Premier League,15-07-16,17.3.2.23,Scott Arfield,5209516,364,01-Nov-88,27,3,0,0,0,4246,6446,6446,132,129,19133690,178,70,M RLC,1,2,1,2,3,3,2,2,2,2,1,12,11,12,14,13,9,8,12,5,10,13,13,11,12,9,12,13,12,14,12,12,15,10,8,14,14,17,17,11,13,14,9,10,16,12,20,17,12,12,6,12,4,14,10,14,16,11,18,18,15,2,Scott Arfield,Â£2.70m ,Premier League
19-06-17,18.3.4.28,Mame Diouf,53016763,41,01-Dec-87,29,37,10,18,7,6400,6500,6750,151,133,34394597,185,77,D/WB/M/AM RLC,1,2,3,1,2,3,3,2,1,3,3,6,8,10,10,11,6,12,9,5,6,8,10,7,12,16,14,17,11,12,8,10,15,12,6,16,6,13,15,14,15,12,14,14,18,14,20,15,13,13,15,13,10,10,14,17,7,13,14,7,10,12,16,17,17,20,20,15,17,D/WB/M/AM RLC,546,1,1,14,17,15,20,1,1,16,1,1,14,17,1,17,8392704.0,0,0,0,0,0,0,0,0,0,0,0,0,1,0,0,0,0,0,0,0,0,0,0,1,0,0,0,0,0,0,0,0,0,0,0,0,0,0,0,0,0,0,0,0,0,0,0,0,Mame Diouf,Â£6.30m ,32.0,185.0,Forward - Centre-Forward,right,Hatayspor,29.0,1.0,2.0,1493.0,37.0,6.0,3.0,2701.0,18.0,2.0,2.0,878.0,11.0,2.0,0.0,292.0,4.0,1.0,1.0,283.0,Premier League,15-07-16,17.3.2.23,Mame Diouf,53016763,41,01-Dec-87,28,36,9,18,7,6750,6500,7250,151,139,42748992,185,77,M/AM/S RLC,1,1,3,1,2,1,2,2,3,1,2,6,8,10,10,11,6,12,9,5,6,8,10,7,12,16,14,17,11,12,8,10,15,12,6,16,6,13,15,15,15,12,14,14,18,16,20,15,14,13,15,13,10,10,14,17,7,13,14,7,10,12,Mame Diouf,Â£6.30m ,Premier League
19-06-17,18.3.4.28,Joshua King,53020695,786,15-Jan-92,25,28,7,8,1,5550,7000,6850,145,137,38454287,180,74,AM/S RLC,1,2,3,1,1,3,2,3,2,2,3,8,9,12,14,10,8,9,11,6,4,13,13,4,13,5,12,10,13,14,7,9,13,15,5,13,8,13,15,19,15,10,13,7,16,18,20,14,16,13,4,14,13,12,12,13,8,10,7,6,14,7,1,1,1,16,16,16,15,AM/S RLC,626,1,1,20,15,16,16,1,1,1,1,1,1,1,1,1,34493964304.0,0,0,0,0,1,0,0,0,0,0,0,0,0,1,0,0,0,0,0,0,0,0,0,0,0,0,0,1,0,0,0,0,0,0,0,1,0,0,0,0,0,0,0,0,0,0,0,0,Joshua King,Â£9.00m ,28.0,189.0,Forward - Second Striker,right,AFC Bournemouth,36.0,16.0,2.0,2720.0,34.0,9.0,3.0,2497.0,38.0,12.0,4.0,3037.0,27.0,6.0,4.0,2050.0,2.0,0.0,0.0,113.0,Premier League,15-07-16,17.3.2.23,Joshua King,53020695,786,15-Jan-92,24,22,5,8,1,4750,6400,6550,134,131,22706466,180,74,AM/S RLC,4,1,3,3,3,3,3,2,1,3,2,8,9,12,12,10,8,9,9,6,4,12,8,4,13,5,12,9,9,10,7,9,4,15,5,13,8,10,14,19,15,10,13,7,16,18,20,14,16,11,4,14,14,12,12,13,8,8,5,6,14,7,Joshua King,Â£7.20m ,Premier League
19-06-17,18.3.4.28,Christian Atsu,55038591,21,10-Jan-92,25,45,9,0,0,5500,6900,6600,140,132,26340930,172,68,AM RL,1,1,2,2,1,2,3,3,3,3,2,11,12,16,12,12,13,7,13,7,5,10,11,3,15,5,10,10,12,12,11,12,13,16,7,14,5,12,12,17,15,12,5,20,12,16,8,12,10,12,6,12,8,10,16,17,5,14,16,16,16,4,1,1,13,20,18,20,1,AM RL,505,1,1,1,1,20,18,1,1,1,1,1,13,13,1,1,2251830000000000.0,0,0,0,0,0,0,0,0,0,0,0,0,0,0,0,0,0,0,0,0,0,0,0,0,0,0,0,0,0,0,0,0,0,0,0,1,0,0,0,0,0,0,0,0,0,0,0,0,Christian Atsu,Â£5.40m ,28.0,165.0,Forward - Left Winger,left,Newcastle United,35.0,5.0,3.0,1711.0,29.0,2.0,2.0,1789.0,32.0,1.0,0.0,1620.0,24.0,0.0,5.0,992.0,1.0,0.0,0.0,10.0,Premier League
19-06-17,18.3.4.28,Bernardo Silva,55041632,788,10-Aug-94,22,15,2,14,6,7550,7950,7750,175,159,133766784,173,64,M/AM RLC,1,1,1,3,2,2,1,1,4,1,1,14,14,17,14,17,14,9,12,2,6,16,14,6,17,12,14,15,15,14,16,15,17,17,12,14,9,14,17,15,17,13,7,20,14,14,9,14,9,15,7,16,6,14,15,17,15,16,17,16,15,4,1,1,16,20,20,15,19,M/AM RLC,526,1,1,10,19,15,20,1,1,1,1,14,13,16,1,1,2252350000000000.0,0,0,0,1,0,0,0,0,0,0,0,0,0,0,1,0,0,0,0,0,0,0,1,0,0,0,0,0,0,0,0,0,0,0,0,0,0,0,0,1,0,0,0,0,0,0,0,0,Bernardo Silva,Â£45.00m ,26.0,173.0,Forward - Right Winger,left,Manchester City,58.0,11.0,12.0,4296.0,53.0,9.0,11.0,2795.0,51.0,13.0,14.0,4025.0,52.0,8.0,10.0,3329.0,5.0,0.0,0.0,299.0,Premier League,15-07-16,17.3.2.23,Bernardo Silva,55041632,788,10-Aug-94,21,7,0,14,6,7200,7600,7850,175,157,105972724,173,64,M/AM RLC,3,1,3,1,2,2,3,4,2,3,2,14,14,18,14,17,14,7,11,2,6,15,14,6,18,12,14,14,15,13,16,14,17,17,12,13,9,13,17,15,17,13,7,20,14,14,9,14,9,15,7,16,7,14,15,17,15,16,17,16,15,4,Bernardo Silva,Â£36.00m ,Ligue 1
19-06-17,18.3.4.28,Christian Fuchs,5603918,755,07-Apr-86,31,78,1,10,3,5350,7000,6600,145,132,19333520,186,82,D/WB L,3,1,2,1,3,3,3,3,2,2,4,15,15,11,8,12,15,14,14,18,13,14,9,15,12,14,11,11,13,15,13,14,13,11,18,13,13,16,16,10,10,13,12,20,15,10,8,14,14,14,11,12,1,13,10,17,6,12,17,15,13,8,20,20,15,15,1,20,8,D/WB L,113,1,1,1,1,15,1,8,20,1,1,1,15,1,20,1,68719478784.0,0,0,0,0,0,0,0,0,0,0,0,1,0,0,0,0,0,0,0,0,0,0,0,0,0,0,0,0,0,0,0,0,0,0,0,0,1,0,0,0,0,0,0,0,0,0,0,0,Christian Fuchs,Â£4.50m ,34.0,187.0,Defender - Left-Back,left,Leicester City,48.0,2.0,5.0,4081.0,29.0,0.0,2.0,2337.0,8.0,1.0,1.0,656.0,17.0,0.0,0.0,1243.0,4.0,0.0,0.0,280.0,Premier League,15-07-16,17.3.2.23,Christian Fuchs,5603918,755,07-Apr-86,30,78,1,10,3,5350,7000,7000,145,140,232186002,186,82,D/WB L,1,2,1,1,3,2,1,1,2,2,3,15,15,11,8,12,16,14,14,18,13,14,9,15,12,14,11,11,13,15,13,14,13,11,18,13,13,16,17,11,12,13,12,20,15,10,8,16,14,14,11,12,1,13,12,17,6,12,17,15,13,8,Christian Fuchs,Â£5.40m ,Premier League
19-06-17,18.3.4.28,Henrikh Mkhitaryan,59006269,754,21-Jan-89,28,63,22,13,9,6800,8150,7900,165,156,171528159,178,72,M/AM RLC,1,4,2,1,3,3,1,2,1,3,3,11,12,16,14,15,12,6,10,6,4,14,11,9,15,17,15,10,13,9,14,12,12,14,7,17,6,16,16,16,16,12,8,14,18,15,20,16,8,11,6,12,3,17,15,17,6,8,18,12,14,10,1,1,17,20,19,16,20,M/AM RLC,526,1,1,10,20,16,19,1,1,1,10,14,15,17,1,1,549893000000.0,0,0,0,0,0,0,0,0,0,0,1,0,0,0,0,0,0,0,0,0,1,1,0,0,0,0,0,1,0,0,0,0,0,0,0,0,0,0,0,1,0,0,0,0,0,0,0,0,Henrikh Mkhitaryan,Â£31.50m ,31.0,177.0,Midfielder - Attacking Midfield,both,AS Roma,41.0,11.0,5.0,2544.0,39.0,5.0,12.0,2582.0,39.0,6.0,7.0,2522.0,30.0,9.0,6.0,1942.0,6.0,0.0,4.0,462.0,Premier League,15-07-16,17.3.2.23,Henrikh Mkhitaryan,59006269,754,21-Jan-89,27,59,19,13,9,6800,8150,7900,163,163,126070777,178,72,M/AM RLC,2,3,1,1,1,1,2,3,1,2,2,15,12,14,13,15,10,10,13,6,7,13,11,11,14,17,16,10,11,10,14,12,12,14,9,17,10,16,17,16,16,12,8,16,18,15,20,17,8,13,6,12,3,17,15,17,6,8,18,12,14,10,Henrikh Mkhitaryan,Â£31.50m ,Premier League
19-06-17,18.3.4.28,Ryan Fraser,61036775,793,24-Feb-94,23,1,0,10,3,4900,6450,6500,148,130,26056258,163,64,M/AM RL,3,2,1,3,2,3,1,3,1,2,1,13,12,13,12,12,11,2,5,2,7,12,6,7,12,7,12,13,11,11,11,12,10,13,10,13,10,13,14,16,13,12,3,9,12,17,20,12,11,11,5,9,13,11,9,12,9,9,11,12,8,3,1,1,20,20,20,20,1,M/AM RL,415,1,1,1,1,20,20,1,1,1,1,1,18,20,1,1,0.0,0,0,0,0,0,0,0,0,0,0,0,0,0,0,0,0,0,0,0,0,0,0,0,0,0,0,0,0,0,0,0,0,0,0,0,0,0,0,0,0,0,0,0,0,0,0,0,0,Ryan Fraser,Â£5.40m ,26.0,163.0,Forward - Left Winger,right,Newcastle United,29.0,3.0,8.0,1856.0,32.0,6.0,4.0,2543.0,42.0,8.0,15.0,3384.0,32.0,1.0,4.0,2351.0,7.0,1.0,1.0,362.0,Premier League,15-07-16,17.3.2.23,Ryan Fraser,61036775,793,24-Feb-94,22,0,0,9,3,4500,6450,6450,138,129,20256644,163,64,M/AM RL,4,1,2,1,2,1,2,2,3,1,1,13,12,13,11,12,11,2,5,2,7,12,6,7,12,7,12,13,11,10,11,12,10,13,10,13,10,13,14,16,13,12,3,9,12,17,20,12,10,11,5,9,13,10,9,12,9,9,11,12,8,3,Ryan Fraser,Â£4.50m ,Premier League
19-06-17,18.3.4.28,Kiko FemenÃ­a,67063051,796,02-Feb-91,26,0,0,1,0,5508,6260,7000,141,140,20698920,173,71,D/WB/M/AM RL,2,4,1,2,1,3,2,1,3,3,3,10,11,12,9,11,9,7,9,14,8,12,11,11,13,9,12,14,10,12,10,10,9,13,9,12,10,12,13,17,12,10,7,10,14,17,20,13,9,13,6,11,6,16,12,12,13,8,14,16,7,11,20,19,18,18,20,16,1,D/WB/M/AM RL,135,1,1,1,1,16,18,1,6,20,1,1,12,18,9,19,2.0,0,1,0,0,0,0,0,0,0,0,0,0,0,0,0,0,0,0,0,0,0,0,0,0,0,0,0,0,0,0,0,0,0,0,0,0,0,0,0,0,0,0,0,0,0,0,0,0,Kiko FemenÃ­a,Â£4.50m ,29.0,171.0,Defender - Right-Back,right,Watford FC,37.0,0.0,2.0,2986.0,23.0,1.0,0.0,1716.0,34.0,1.0,2.0,2491.0,29.0,0.0,1.0,2331.0,4.0,0.0,1.0,305.0,Premier League,15-07-16,17.3.2.23,Kiko FemenÃ­a,67063051,796,02-Feb-91,25,0,0,1,0,4200,6250,6250,131,126,3545045,173,71,D/WB/M/AM RL,2,1,3,1,1,3,1,1,2,2,2,10,12,13,9,11,9,7,10,14,8,13,11,11,13,9,12,13,11,12,11,12,9,13,9,13,10,13,13,14,12,10,7,10,14,14,20,13,8,13,6,11,6,16,16,12,13,8,14,16,7,11,Kiko FemenÃ­a,Â£3.60m ,LaLiga
19-06-17,18.3.4.28,Marcos Alonso,67080310,796,28-Dec-90,26,0,0,0,0,5250,6750,7250,151,146,48063215,188,87,D/WB/M L,3,1,3,2,1,2,3,2,1,3,2,14,12,12,11,13,15,15,14,12,13,14,12,14,13,12,14,12,14,12,13,14,13,12,9,14,13,14,15,12,12,15,13,20,14,13,9,16,15,14,9,13,7,13,13,14,12,13,14,13,12,10,20,20,19,1,1,20,12,D/WB/M L,123,1,1,1,1,1,1,12,20,1,1,1,19,1,20,1,33056.0,0,0,0,0,0,1,0,0,1,0,0,0,0,0,0,1,0,0,0,0,0,0,0,0,0,0,0,0,0,0,0,0,0,0,0,0,0,0,0,0,0,0,0,0,0,0,0,0,Marcos Alonso,Â£36.00m ,29.0,188.0,Defender - Left-Back,left,Chelsea FC,37.0,6.0,3.0,3264.0,46.0,8.0,4.0,4017.0,39.0,4.0,7.0,3486.0,29.0,4.0,4.0,2344.0,3.0,0.0,0.0,225.0,Premier League,15-07-16,17.3.2.23,Marcos Alonso,67080310,796,28-Dec-90,25,0,0,0,0,5250,6750,7250,151,145,39651979,188,81,D/WB/M L,1,3,3,1,1,1,2,2,1,3,1,14,15,12,10,13,15,12,14,12,13,14,12,14,13,12,14,12,14,12,13,13,13,12,9,14,13,13,14,12,12,15,13,20,14,13,9,16,15,14,9,13,7,13,13,14,12,13,14,13,12,10,Marcos Alonso,Â£22.50m ,Premier League
19-06-17,18.3.4.28,Gerard Deulofeu,67107391,796,13-Mar-94,23,3,1,26,14,6550,7400,7400,161,148,33243076,177,73,AM RL,1,1,3,3,1,3,3,3,1,2,1,14,15,18,12,17,14,8,14,3,5,15,11,5,17,7,14,10,10,11,14,9,12,18,8,15,7,11,10,17,16,12,7,12,12,15,20,11,9,10,8,12,8,9,13,16,9,9,8,7,10,12,1,1,14,20,20,18,5,AM RL,505,1,1,10,5,18,20,1,1,1,1,1,12,14,1,1,2324400000000000.0,0,0,0,0,0,0,0,0,0,0,0,0,0,0,0,0,0,0,0,0,0,0,0,0,0,0,0,0,0,0,0,0,0,0,0,1,0,0,0,0,0,1,0,0,0,0,1,0,Gerard Deulofeu,Â£12.60m ,26.0,177.0,Forward - Left Winger,right,Udinese Calcio,31.0,4.0,4.0,2041.0,24.0,3.0,3.0,1330.0,33.0,12.0,5.0,2283.0,30.0,4.0,5.0,2142.0,2.0,0.0,0.0,32.0,Premier League,15-07-16,17.3.2.23,Gerard Deulofeu,67107391,796,13-Mar-94,22,1,0,26,14,6250,7000,6900,152,138,42649464,171,68,M/AM RL,2,3,3,2,1,3,2,1,3,4,3,14,16,18,13,17,15,8,14,4,5,15,11,5,17,7,13,10,14,11,14,9,11,19,7,15,5,9,7,17,14,11,6,13,12,15,20,6,9,9,8,12,8,9,14,16,10,10,8,7,10,9,Gerard Deulofeu,Â£10.80m ,Premier League
19-06-17,18.3.4.28,JesÃ©,67117361,796,26-Feb-93,24,0,0,5,2,5500,6950,6700,147,134,11151449,178,73,M/AM/S RLC,3,2,1,2,3,1,2,2,2,1,1,13,9,15,14,16,12,8,12,5,4,12,13,5,16,13,13,11,11,7,12,9,14,16,8,14,7,10,8,14,16,14,9,10,9,14,20,12,11,7,10,11,12,14,6,9,13,10,7,4,6,10,1,1,18,19,17,19,15,M/AM/S RLC,636,1,1,20,15,19,17,1,1,1,1,1,18,16,1,1,2252350000000000.0,0,0,0,0,1,0,0,0,0,0,0,0,0,0,0,0,0,0,0,0,0,0,0,0,0,0,0,0,0,0,0,0,0,0,0,0,0,0,0,1,0,0,0,0,0,0,0,0,JesÃ©,Â£6.75m ,27.0,178.0,Forward - Left Winger,right,Paris Saint-Germain,30.0,5.0,1.0,1531.0,14.0,1.0,2.0,705.0,19.0,2.0,1.0,969.0,18.0,1.0,0.0,745.0,2.0,0.0,0.0,22.0,Premier League,15-07-16,17.3.2.23,JesÃ©,67117361,796,26-Feb-93,23,0,0,5,2,6450,7050,7050,154,141,17099598,178,73,M/AM/S RLC,1,1,1,1,1,1,2,3,3,1,3,13,9,15,14,16,12,8,12,5,4,13,13,5,17,13,13,11,12,8,12,9,14,16,8,16,7,10,9,15,16,14,9,10,9,15,20,12,11,7,10,11,12,14,6,9,13,10,8,4,6,10,JesÃ©,Â£6.75m ,LaLiga
19-06-17,18.3.4.28,Olexandr Zinchenko,71081391,800,15-Dec-96,20,11,1,0,0,4750,6000,5750,143,119,8603638,175,64,M/AM RLC,2,3,3,2,1,1,2,1,2,1,3,13,11,12,8,14,13,12,11,5,8,13,9,8,15,9,14,9,10,13,13,10,3,13,6,13,8,15,13,13,14,12,9,20,14,12,13,12,7,15,5,5,11,16,10,11,13,11,10,3,18,8,14,13,17,20,20,17,16,M/AM RLC,526,1,1,7,16,17,20,1,14,1,10,13,15,17,13,7,2.88239e+17,0,0,0,0,0,0,0,0,0,0,0,0,0,0,0,0,0,0,0,0,0,0,0,0,0,0,0,0,0,0,0,0,0,0,0,0,0,0,0,0,0,0,0,1,0,0,0,0,Oleksandr Zinchenko,Â£6.30m ,23.0,175.0,Defender - Left-Back,left,Manchester City,24.0,0.0,13.0,1291.0,14.0,0.0,0.0,1104.0,29.0,1.0,5.0,2339.0,25.0,1.0,0.0,1776.0,1.0,0.0,0.0,12.0,Premier League
19-06-17,18.3.4.28,Santi Cazorla,7456688,796,13-Dec-84,32,77,14,7,0,7000,7250,7250,165,150,232186002,168,66,M/AM RLC,3,2,1,2,1,1,1,1,3,3,4,13,12,16,12,17,15,4,14,4,8,17,16,10,18,9,16,11,15,12,17,14,14,17,11,15,9,14,14,12,14,12,5,16,11,10,20,12,7,16,9,16,15,16,17,14,16,14,16,15,15,5,1,1,20,17,16,16,20,M/AM RLC,416,1,1,1,17,16,16,1,1,1,10,20,14,14,1,1,148.0,0,0,1,0,1,0,0,1,0,0,0,0,0,0,0,0,0,0,0,0,0,0,0,0,0,0,0,0,0,0,0,0,0,0,0,0,0,0,0,0,0,0,0,0,0,0,0,0,Santi Cazorla,Â£2.25m ,35.0,168.0,Midfielder - Central Midfield,both,Al-Sadd SC,11.0,2.0,3.0,856.0,nan,nan,nan,nan,46.0,7.0,11.0,3117.0,45.0,17.0,13.0,3265.0,4.0,3.0,3.0,360.0,Premier League,15-07-16,17.3.2.23,Santi Cazorla,7456688,796,13-Dec-84,31,77,14,7,0,7250,7500,8000,165,160,232186002,168,66,M/AM RLC,3,1,1,2,3,2,3,1,1,3,1,13,12,16,12,17,15,4,14,4,8,18,16,11,18,9,16,11,15,12,17,14,15,17,11,15,9,14,14,14,15,12,5,17,13,11,20,13,7,16,9,16,9,16,17,14,16,16,16,15,15,5,Santi Cazorla,Â£10.80m ,Premier League
19-06-17,18.3.4.28,David Silva,7458280,796,08-Jan-86,31,113,32,9,7,8100,8500,8650,178,178,232186002,173,67,M/AM RLC,3,2,2,3,4,2,2,2,1,1,1,13,13,18,12,19,12,7,12,7,5,19,12,9,19,10,14,11,17,15,19,18,15,19,10,18,8,15,14,13,17,19,5,20,13,13,13,13,8,16,9,13,12,13,13,16,13,15,11,12,13,7,1,1,20,20,15,15,20,M/AM RLC,416,1,1,9,20,15,15,1,1,1,4,20,15,15,1,1,2251820000000000.0,0,0,0,0,1,0,0,1,0,0,0,0,0,0,0,0,0,0,0,0,0,0,0,0,0,0,0,0,0,0,0,0,0,0,1,0,0,0,0,0,0,0,0,0,0,0,0,0,David Silva,Â£27.00m ,34.0,170.0,Midfielder - Attacking Midfield,left,Real Sociedad,45.0,8.0,11.0,3646.0,40.0,10.0,14.0,3198.0,50.0,10.0,14.0,3727.0,40.0,6.0,11.0,2602.0,7.0,0.0,2.0,505.0,Premier League,15-07-16,17.3.2.23,David Silva,7458280,796,08-Jan-86,30,103,24,9,7,8100,8500,8650,173,171,232186002,170,67,M/AM RLC,3,1,2,3,1,1,4,1,2,1,2,13,12,18,11,19,11,7,12,7,5,19,12,5,19,10,13,11,16,15,19,16,15,19,10,18,8,14,13,15,17,17,5,20,11,11,13,13,8,15,9,13,13,13,13,16,13,15,11,12,13,7,David Silva,Â£27.00m ,Premier League
19-06-17,18.3.4.28,Alexis SÃ¡nchez,75000261,1652,19-Dec-88,28,91,31,12,2,8250,8600,8600,182,172,232186002,169,70,AM/S RLC,2,2,1,1,1,2,3,3,4,1,3,12,13,17,15,14,14,14,14,2,7,15,12,10,17,16,14,17,14,14,16,14,16,18,11,17,7,12,16,17,18,16,10,8,16,15,20,16,11,14,8,15,10,14,18,14,8,17,15,14,15,6,1,1,12,20,17,20,15,AM/S RLC,516,1,1,18,15,20,17,1,1,1,1,1,12,12,1,1,1.46437e+17,0,0,0,0,1,0,0,0,0,0,0,0,0,0,0,0,0,0,0,0,0,0,0,0,0,0,0,0,0,0,0,0,0,0,1,0,0,0,0,0,0,0,0,0,0,0,1,0,Alexis SÃ¡nchez,Â£63.00m ,31.0,168.0,Forward - Centre-Forward,right,Inter Milan,51.0,30.0,18.0,4229.0,40.0,11.0,9.0,3252.0,27.0,2.0,4.0,1240.0,32.0,4.0,10.0,1392.0,5.0,0.0,2.0,165.0,Premier League,15-07-16,17.3.2.23,Alexis SÃ¡nchez,75000261,1652,19-Dec-88,27,91,31,12,2,8500,8750,8750,182,175,129864574,169,70,AM/S RLC,2,1,2,2,2,3,2,2,3,3,1,12,13,17,16,14,14,14,14,2,7,15,12,11,17,16,14,19,14,14,16,14,19,18,10,17,7,15,19,17,16,16,9,8,16,16,20,16,11,16,8,15,10,14,18,14,14,17,17,15,18,4,Alexis SÃ¡nchez,Â£58.50m ,Premier League
19-06-17,18.3.4.28,JosÃ© Izquierdo,76017362,1653,07-Jul-92,24,2,0,2,0,5000,6750,6700,137,134,32996512,171,75,M/AM/S LC,3,1,3,1,3,1,2,3,3,1,3,12,13,15,12,12,13,7,15,10,5,12,6,6,13,12,11,15,12,13,10,11,13,16,10,12,12,12,12,16,12,9,5,7,15,17,20,12,11,13,10,14,5,12,7,13,13,11,10,11,11,11,1,1,17,20,1,20,15,M/AM/S LC,534,1,1,17,15,20,1,1,1,1,1,1,17,1,1,1,1.44115e+17,0,0,0,0,0,0,0,0,1,1,0,0,0,0,0,0,0,0,0,0,0,0,0,0,0,0,0,0,0,0,0,0,0,0,0,0,0,0,0,0,0,0,0,0,0,0,0,0,JosÃ© Izquierdo,Â£12.60m ,28.0,171.0,Forward - Left Winger,right,Brighton & Hove Albion,34.0,16.0,3.0,2572.0,38.0,5.0,4.0,2278.0,18.0,0.0,2.0,906.0,nan,nan,nan,nan,2.0,1.0,0.0,74.0,Premier League
19-06-17,18.3.4.28,AndrÃ© Carrillo,77012583,1656,14-Jun-91,26,35,3,9,2,5500,6550,6550,140,134,1756515,180,73,AM RL,1,1,4,1,1,1,1,4,2,2,3,11,14,15,12,14,10,8,14,10,6,14,13,7,15,8,11,10,14,11,12,12,11,16,6,13,8,8,9,15,14,13,8,10,12,15,20,12,12,12,5,11,7,12,13,18,5,12,13,11,10,7,1,1,12,20,20,18,8,AM RL,505,1,1,5,8,18,20,1,1,1,1,1,8,12,1,1,70368700000000.0,0,1,0,0,0,0,0,0,0,0,0,0,0,0,0,0,0,0,0,0,0,0,0,0,0,0,0,0,0,0,0,0,0,0,0,0,0,0,0,0,0,0,0,0,0,0,1,0,AndrÃ© Carrillo,Â£5.40m ,29.0,180.0,Forward - Right Winger,right,Al-Hilal Riyadh,32.0,3.0,3.0,1250.0,30.0,2.0,2.0,1662.0,33.0,6.0,8.0,2787.0,35.0,6.0,7.0,2432.0,1.0,1.0,0.0,90.0,Premier League,15-07-16,17.3.2.23,AndrÃ© Carrillo,77012583,1656,14-Jun-91,25,29,2,9,2,6500,6900,7000,158,140,12740882,180,73,AM RL,1,1,3,3,3,3,2,1,3,3,2,11,13,15,12,14,10,8,14,10,6,14,13,7,15,8,11,10,14,11,13,12,11,16,6,13,8,10,9,15,15,13,8,10,12,16,20,14,12,12,5,11,7,12,13,18,5,12,13,11,10,7,AndrÃ© Carrillo,Â£5.40m ,Liga NOS
19-06-17,18.3.4.28,Shinji Okazaki,788545,116,16-Apr-86,31,109,49,0,0,5600,7150,6850,143,138,232186002,174,76,AM/S RLC,1,1,2,3,3,2,4,1,2,1,1,5,8,12,11,14,7,13,12,8,8,11,12,10,13,17,13,17,11,16,10,8,14,12,10,15,10,12,18,12,17,13,10,17,16,12,20,17,7,10,9,15,5,12,12,15,13,14,17,8,9,4,1,1,10,19,16,16,19,AM/S RLC,626,1,1,20,19,16,16,1,1,1,1,1,10,10,1,1,1.4412e+17,0,0,0,0,0,0,0,0,0,1,0,0,0,0,0,0,0,0,0,0,0,0,0,0,0,0,0,0,0,0,0,0,0,0,0,0,0,0,0,0,0,0,1,0,0,0,0,0,Shinji Okazaki,Â£5.40m ,34.0,175.0,Forward - Centre-Forward,both,SD Huesca,41.0,6.0,1.0,2211.0,32.0,7.0,4.0,1578.0,26.0,1.0,1.0,584.0,38.0,12.0,0.0,2474.0,5.0,0.0,0.0,370.0,Premier League,15-07-16,17.3.2.23,Shinji Okazaki,788545,116,16-Apr-86,30,102,49,0,0,5597,7147,6847,143,137,14071939,174,76,M/AM/S LC,1,1,3,1,2,2,3,2,2,2,2,5,8,12,11,14,7,13,12,8,8,9,12,10,13,17,13,17,11,16,10,8,14,12,10,15,10,12,18,12,17,16,10,16,16,12,20,17,7,10,9,15,5,12,12,15,13,14,17,8,9,4,Shinji Okazaki,Â£6.30m ,Premier League
19-06-17,18.3.4.28,Martin Olsson,8117260,797,17-May-88,29,40,5,23,1,5500,7000,6500,136,130,19805262,178,82,D/WB L,1,2,3,3,2,3,3,4,1,4,1,8,13,12,9,12,9,9,9,9,13,13,8,13,13,10,12,14,12,11,11,11,14,11,7,12,12,14,13,15,13,14,8,20,16,16,7,14,13,10,8,14,11,12,15,17,12,14,15,4,14,14,20,17,15,14,1,20,1,D/WB L,113,1,1,1,1,14,1,1,20,1,1,1,15,1,17,1,34502344992.0,0,0,0,0,0,1,0,0,1,0,0,0,0,0,0,0,0,0,0,0,0,0,0,1,0,0,0,1,0,0,0,0,0,0,0,1,0,0,0,0,0,0,0,0,0,0,0,0,Martin Olsson,Â£4.50m ,32.0,178.0,Defender - Left-Back,left,Helsingborgs IF,35.0,3.0,0.0,2716.0,43.0,0.0,1.0,3676.0,17.0,0.0,1.0,1104.0,21.0,0.0,5.0,1746.0,nan,nan,nan,nan,Premier League,15-07-16,17.3.2.23,Martin Olsson,8117260,797,17-May-88,28,38,5,23,1,5250,7000,6600,142,128,13904112,178,82,D/WB L,2,3,1,3,2,1,2,2,3,2,2,8,13,12,9,12,9,9,9,9,13,13,8,13,13,10,12,14,12,11,11,11,14,11,7,12,12,14,13,15,13,14,8,20,16,16,7,14,13,10,8,14,11,12,15,17,12,14,15,4,14,14,Martin Olsson,Â£4.50m ,Premier League
19-06-17,18.3.4.28,Nacer Chadli,8169289,757,02-Aug-89,27,37,5,0,0,6250,7000,7250,153,148,61184457,187,80,AM RLC,2,1,1,3,3,1,2,3,2,1,2,12,13,15,14,15,12,10,13,5,4,15,12,9,15,10,12,12,14,12,15,12,15,14,6,14,10,12,13,13,14,13,14,15,14,15,20,14,14,10,4,12,8,12,8,14,13,13,17,15,15,6,1,1,15,20,16,20,16,AM RLC,506,1,1,1,16,20,16,1,1,1,1,15,15,13,1,1,0.0,0,0,0,0,0,0,0,0,0,0,0,0,0,0,0,0,0,0,0,0,0,0,0,0,0,0,0,0,0,0,0,0,0,0,0,0,0,0,0,0,0,0,0,0,0,0,0,0,Nacer Chadli,Â£9.00m ,31.0,187.0,Forward - Left Winger,right,Istanbul Basaksehir FK,32.0,5.0,5.0,2161.0,8.0,1.0,0.0,410.0,22.0,0.0,0.0,1058.0,19.0,8.0,5.0,1404.0,nan,nan,nan,nan,Premier League,15-07-16,17.3.2.23,Nacer Chadli,8169289,757,02-Aug-89,26,31,3,0,0,6250,6750,7250,153,148,50770573,187,80,AM RLC,3,3,1,3,1,2,1,1,2,1,3,12,13,15,14,15,12,13,13,5,4,15,12,9,15,10,12,12,14,12,15,12,15,14,6,14,10,12,13,13,14,13,14,15,10,15,20,14,14,10,4,12,8,12,8,14,13,13,17,15,15,1,Nacer Chadli,Â£13.50m ,Premier League
19-06-17,18.3.4.28,Yannick Bolasie,83000374,53,24-May-89,28,27,7,0,0,5834,8751,7250,147,141,58750119,185,84,AM RL,3,1,1,2,1,1,4,3,2,1,2,9,14,17,11,12,7,7,13,5,5,12,10,7,14,10,10,12,10,9,11,11,16,17,5,14,7,10,14,15,16,9,11,13,13,16,20,14,14,10,2,13,9,13,16,16,9,11,9,10,12,5,1,1,15,20,20,20,10,AM RL,505,1,1,10,10,20,20,1,1,1,1,1,15,15,1,1,2251840000000000.0,0,0,0,0,0,1,0,0,0,0,0,0,0,0,0,0,0,0,0,0,0,0,0,0,0,0,0,0,0,0,1,0,0,0,0,1,0,0,0,0,0,0,0,0,0,0,0,0,Yannick Bolasie,Â£16.20m ,31.0,185.0,Forward - Left Winger,right,Everton FC,16.0,1.0,4.0,1164.0,18.0,1.0,0.0,973.0,38.0,8.0,8.0,2371.0,25.0,2.0,5.0,1843.0,nan,nan,nan,nan,Premier League,15-07-16,17.3.2.23,Yannick Bolasie,83000374,53,24-May-89,27,27,7,0,0,5863,8795,7250,147,145,49894805,185,84,AM RL,3,1,3,3,2,1,3,1,2,1,3,9,14,16,11,12,7,7,13,5,5,12,10,7,14,10,10,12,10,10,11,11,14,17,5,14,7,12,15,15,16,9,11,13,13,17,20,15,14,10,2,13,9,13,19,16,9,11,9,10,12,5,Yannick Bolasie,Â£18.00m ,Premier League
19-06-17,18.3.4.28,AndrÃ© Ayew,8442448,21,17-Dec-89,27,75,14,12,4,6250,6900,6650,143,133,31216778,176,72,M/AM RLC,2,1,2,3,3,1,1,2,2,2,2,9,11,14,15,13,10,15,10,5,8,11,13,11,15,14,14,15,12,11,11,12,14,14,14,14,11,14,14,13,14,15,11,20,15,12,5,15,13,12,13,13,7,15,17,16,11,14,15,12,13,12,1,8,18,20,17,20,16,M/AM RLC,526,1,1,15,16,20,17,1,1,1,11,14,18,17,8,1,17179869192.0,0,0,0,1,0,0,0,0,0,0,0,0,0,0,0,0,0,0,0,0,0,0,0,0,0,0,0,0,0,0,0,0,0,0,1,0,0,0,0,0,0,0,0,0,0,0,0,0,AndrÃ© Ayew,Â£13.50m ,30.0,176.0,Forward - Left Winger,left,Swansea City,26.0,6.0,3.0,1453.0,36.0,6.0,5.0,2361.0,38.0,5.0,2.0,2620.0,47.0,18.0,7.0,4116.0,8.0,3.0,1.0,720.0,Premier League,15-07-16,17.3.2.23,AndrÃ© Ayew,8442448,21,17-Dec-89,26,65,11,12,4,6500,7350,7250,143,140,48468636,176,72,M/AM RLC,2,3,2,1,2,4,2,1,3,3,2,9,13,15,15,13,10,16,10,5,8,12,16,11,15,14,14,15,14,11,12,12,16,15,15,15,11,14,14,13,14,16,11,20,15,12,5,15,14,12,13,14,7,15,17,16,11,14,15,12,13,12,AndrÃ© Ayew,Â£16.20m ,Premier League
19-06-17,18.3.4.28,Arthur Masuaku,85074537,769,07-Nov-93,23,0,0,0,0,5000,6500,6750,150,132,32699624,179,70,D/WB/M L,3,2,2,3,1,3,2,2,1,3,3,12,13,14,7,13,10,9,13,13,11,12,9,12,14,9,12,10,12,11,12,11,12,14,8,13,12,11,14,16,15,13,9,20,16,15,5,15,11,12,10,14,6,14,16,16,12,16,13,12,13,9,20,19,16,10,1,20,10,D/WB/M L,123,1,1,1,7,10,1,1,20,1,1,10,16,1,19,1,70403100000000.0,1,0,0,0,0,1,0,0,0,0,0,0,0,0,0,0,0,0,0,0,0,0,0,0,0,0,0,0,0,0,0,0,0,0,0,1,0,0,0,0,0,0,0,0,0,0,1,0,Arthur Masuaku,Â£6.30m ,26.0,179.0,Defender - Left-Back,left,West Ham United,18.0,0.0,1.0,1247.0,33.0,1.0,3.0,2401.0,27.0,0.0,2.0,2025.0,18.0,0.0,1.0,1022.0,6.0,0.0,1.0,540.0,Premier League,15-07-16,17.3.2.23,Arthur Masuaku,85074537,769,07-Nov-93,22,0,0,0,0,5044,5802,6500,150,131,22055737,179,70,D/WB/M L,1,3,3,3,1,1,3,1,3,3,3,12,13,14,7,13,10,9,13,13,11,12,9,11,14,9,12,10,12,10,12,12,12,13,8,13,12,10,14,16,15,13,9,20,16,15,5,15,11,11,10,14,6,14,16,16,12,16,13,12,13,9,Arthur Masuaku,Â£6.30m ,Premier League
19-06-17,18.3.4.28,Riyad Mahrez,85078058,5,21-Feb-91,26,32,8,0,0,6850,8400,7800,163,155,106773882,179,62,M/AM RLC,1,3,1,2,3,3,1,2,3,2,2,14,15,17,15,17,14,6,14,4,5,16,14,8,17,8,14,5,15,12,17,12,13,17,5,15,5,8,8,16,17,15,9,20,12,14,10,13,9,8,7,14,7,13,10,15,12,11,9,9,14,8,1,1,19,20,20,17,17,M/AM RLC,526,1,1,13,17,17,20,1,1,1,1,1,17,19,1,1,2322750000000000.0,0,0,0,0,0,0,0,0,0,0,1,0,0,0,0,0,0,0,0,0,0,0,0,0,0,0,0,0,0,0,0,0,0,0,0,1,0,0,0,1,0,0,0,0,0,0,1,0,Riyad Mahrez,Â£45.00m ,29.0,179.0,Forward - Right Winger,left,Manchester City,48.0,10.0,7.0,3766.0,41.0,13.0,13.0,3339.0,44.0,12.0,12.0,2581.0,50.0,13.0,16.0,3149.0,7.0,1.0,1.0,617.0,Premier League,15-07-16,17.3.2.23,Riyad Mahrez,85078058,5,21-Feb-91,25,24,4,0,0,6018,8040,7598,156,149,71991572,179,62,M/AM RLC,2,3,2,2,2,1,3,1,2,3,2,14,15,17,14,17,14,6,12,4,5,15,14,8,17,8,14,6,15,12,17,10,13,17,5,15,5,10,13,15,16,15,9,20,12,15,7,13,9,10,7,14,7,13,7,15,12,11,9,9,14,8,Riyad Mahrez,Â£27.00m ,Premier League
19-06-17,18.3.4.28,Anthony Martial,85086702,769,05-Dec-95,21,15,1,12,4,6900,7300,7500,164,153,132261838,181,76,AM/S L,3,3,1,1,1,1,1,2,1,4,2,5,9,19,15,15,7,8,8,2,2,13,16,3,15,8,12,11,14,12,10,11,13,18,4,14,5,13,13,18,16,14,9,11,14,17,20,13,12,11,8,13,8,11,7,18,12,15,16,15,18,12,1,1,14,20,14,20,1,AM/S L,513,1,1,19,1,20,14,1,1,1,1,1,14,12,1,1,1.44115e+17,0,0,0,1,1,0,0,0,0,0,1,0,0,0,0,0,0,0,0,0,1,0,0,0,0,0,0,0,0,0,0,0,0,0,0,0,0,0,0,0,0,0,0,0,0,0,0,0,Anthony Martial,Â£58.50m ,24.0,181.0,Forward - Centre-Forward,right,Manchester United,42.0,8.0,8.0,2517.0,45.0,11.0,9.0,2337.0,38.0,12.0,3.0,2327.0,48.0,23.0,12.0,3566.0,4.0,0.0,2.0,296.0,Premier League,15-07-16,17.3.2.23,Anthony Martial,85086702,769,05-Dec-95,20,12,0,12,4,6900,7300,7600,183,154,140471902,181,76,AM/S RL,1,1,3,3,2,1,3,4,3,1,1,5,10,17,15,15,7,10,11,2,2,12,14,3,15,8,12,12,13,11,10,12,15,14,5,15,5,12,14,18,16,14,10,11,14,17,20,14,14,12,8,13,8,11,9,18,12,15,16,15,18,7,Anthony Martial,Â£27.00m ,Premier League
19-06-17,18.3.4.28,Sadio ManÃ©,85100467,41,10-Apr-92,25,45,13,6,1,6800,8100,8100,172,163,202417962,175,69,AM/S RL,3,2,2,2,2,1,1,2,2,3,2,7,14,16,15,15,7,5,12,4,8,12,8,9,15,10,12,11,14,12,13,13,15,16,4,15,8,13,13,18,16,15,6,12,14,17,20,14,12,13,6,14,8,9,16,16,11,13,15,12,15,7,1,1,1,20,20,17,14,AM/S RL,515,1,1,16,14,17,20,1,1,1,1,1,1,1,1,1,2269940000000000.0,0,0,0,1,1,0,0,0,0,0,0,0,0,0,0,0,0,0,0,0,0,0,0,0,0,0,0,0,0,0,0,0,0,0,0,0,0,0,0,1,0,0,0,0,1,0,0,0,Sadio ManÃ©,Â£63.00m ,28.0,174.0,Forward - Left Winger,right,Liverpool FC,29.0,13.0,8.0,2427.0,44.0,20.0,9.0,3480.0,50.0,26.0,5.0,4309.0,47.0,22.0,12.0,3720.0,7.0,4.0,2.0,590.0,Premier League,15-07-16,17.3.2.23,Sadio ManÃ©,85100467,41,10-Apr-92,24,36,10,6,1,6548,6951,7650,168,159,130528970,175,69,AM/S RC,2,3,4,3,4,2,2,3,1,2,2,6,13,16,14,15,7,5,12,4,8,12,8,11,15,11,12,10,12,10,12,12,15,16,5,15,12,14,13,17,17,15,6,12,14,16,20,14,12,13,8,13,8,9,16,15,11,13,15,12,15,7,Sadio ManÃ©,Â£36.00m ,Premier League
19-06-17,18.3.4.28,Georges-KÃ©vin Nkoudou,85103980,769,13-Feb-95,22,0,0,6,1,4900,6150,6150,139,128,17572785,175,73,AM L,2,2,1,1,2,2,1,4,3,2,3,8,13,13,12,13,7,5,11,6,8,12,8,6,13,7,12,10,12,12,12,12,8,13,5,13,7,11,12,16,15,13,7,7,14,16,20,11,12,12,7,10,7,10,12,10,10,9,9,10,13,5,8,8,14,20,13,20,1,AM L,503,1,1,12,1,20,13,1,8,1,1,1,14,13,8,1,34359738369.0,1,0,0,0,0,0,0,0,0,0,0,0,0,0,0,0,0,0,0,0,0,0,0,0,0,0,0,0,0,0,0,0,0,0,0,1,0,0,0,0,0,0,0,0,0,0,0,0,Georges-Kevin N'Koudou,Â£6.30m ,25.0,172.0,Forward - Left Winger,right,Besiktas JK,17.0,0.0,1.0,323.0,14.0,1.0,0.0,370.0,6.0,0.0,1.0,141.0,32.0,4.0,3.0,2173.0,1.0,0.0,0.0,90.0,Premier League,15-07-16,17.3.2.23,Georges-KÃ©vin Nkoudou,85103980,769,13-Feb-95,21,0,0,0,0,4650,6150,6150,146,123,15569850,172,68,AM L,3,3,3,2,4,1,1,2,3,3,1,5,13,13,12,13,7,5,11,6,8,12,8,3,13,7,14,10,12,12,7,12,8,13,5,13,7,11,13,16,13,13,7,7,14,16,20,12,12,12,7,7,7,8,15,13,12,12,10,13,10,6,Georges-Kevin N'Koudou,Â£6.30m ,Premier League
19-06-17,18.3.4.28,Sofiane Boufal,85104863,34,17-Sep-93,23,4,0,0,0,5500,7050,7050,149,137,46127798,169,59,AM RLC,1,3,2,1,1,1,3,1,1,3,1,12,13,15,13,15,13,7,13,8,6,12,13,5,15,10,10,8,13,11,14,10,12,14,7,12,6,10,8,16,15,17,6,12,12,15,20,13,9,10,8,12,8,12,13,13,13,14,12,10,12,9,1,1,15,20,15,20,17,AM RLC,506,1,1,13,17,20,15,1,1,1,1,10,15,15,1,1,2251800000000000.0,0,0,0,0,0,0,0,0,0,0,0,0,0,0,0,0,1,0,0,0,0,0,0,0,0,0,0,0,0,0,0,0,0,0,0,0,0,0,0,0,0,0,0,0,0,0,0,0,Sofiane Boufal,Â£10.80m ,27.0,175.0,Forward - Left Winger,right,SCO Angers,30.0,2.0,1.0,1380.0,30.0,2.0,2.0,1490.0,35.0,3.0,4.0,2098.0,25.0,1.0,2.0,1082.0,2.0,1.0,0.0,131.0,Premier League,15-07-16,17.3.2.23,Sofiane Boufal,85104863,34,17-Sep-93,22,2,0,0,0,5500,7050,7050,155,141,24914371,169,59,AM RLC,3,1,3,1,3,2,3,1,3,3,2,13,13,15,13,15,13,7,13,8,6,13,13,5,16,10,10,8,13,11,14,12,12,14,10,12,6,10,8,16,15,17,6,12,12,15,20,13,9,12,8,12,8,12,13,13,13,14,12,10,18,9,Sofiane Boufal,Â£13.50m ,Premier League
19-06-17,18.3.4.28,FoussÃ©ni DiabatÃ©,85121414,31,18-Oct-95,21,0,0,0,0,3750,6000,6000,140,120,12882189,175,66,AM/S RL,4,2,3,3,3,2,1,2,1,1,2,12,12,11,13,13,8,9,13,6,6,11,7,5,13,8,11,8,12,11,9,12,2,10,8,14,7,13,13,16,13,11,9,20,14,15,8,13,10,13,8,11,11,11,18,14,10,10,12,11,11,7,1,1,12,19,17,19,10,AM/S RL,625,1,1,20,10,19,17,1,1,1,1,1,12,12,1,1,0.0,0,0,0,0,0,0,0,0,0,0,0,0,0,0,0,0,0,0,0,0,0,0,0,0,0,0,0,0,0,0,0,0,0,0,0,0,0,0,0,0,0,0,0,0,0,0,0,0,Fousseni DiabatÃ©,Â£2.70m ,25.0,175.0,Forward - Right Winger,left,Trabzonspor,2.0,0.0,0.0,59.0,38.0,5.0,2.0,2527.0,27.0,3.0,3.0,2169.0,24.0,1.0,3.0,1397.0,3.0,0.0,0.0,101.0,Premier League
19-06-17,18.3.4.28,Ibrahim Afellay,857024,784,02-Apr-86,31,53,7,0,0,6250,6750,6550,150,131,19080384,180,76,M/AM RLC,2,2,1,1,1,3,3,2,1,3,1,13,14,15,14,15,11,7,12,8,5,16,13,6,17,7,11,6,11,9,13,11,8,17,9,14,6,12,12,12,12,14,9,15,10,11,20,12,10,12,8,13,14,14,12,13,13,13,14,9,12,16,1,1,17,20,19,20,16,M/AM RLC,526,1,1,14,16,20,19,1,1,1,1,16,17,17,1,1,585191000000.0,0,0,0,0,0,0,0,0,0,0,0,0,0,0,0,0,0,0,0,1,1,0,0,0,0,0,0,0,0,0,1,0,0,0,0,1,0,0,0,1,0,0,0,0,0,0,0,0,Ibrahim Afellay,Â£1.35m ,34.0,181.0,Midfielder - Left Midfield,right,Without Club,14.0,0.0,0.0,529.0,8.0,1.0,0.0,315.0,nan,nan,nan,nan,4.0,0.0,1.0,164.0,nan,nan,nan,nan,Premier League,15-07-16,17.3.2.23,Ibrahim Afellay,857024,784,02-Apr-86,30,53,7,0,0,6750,7000,6750,150,145,232186002,180,76,M/AM RLC,3,2,2,3,2,1,1,3,1,2,3,13,14,15,14,15,11,7,12,8,5,16,13,6,17,7,11,6,11,9,13,11,8,17,9,14,6,12,12,15,15,14,9,15,10,14,20,12,10,12,8,13,14,14,12,13,13,13,14,9,12,16,Ibrahim Afellay,Â£2.70m ,Premier League
19-06-17,18.3.4.28,Georginio Wijnaldum,859612,784,11-Nov-90,26,40,8,25,10,6250,7000,7350,158,150,54022375,175,74,DM/M/AM LC,1,1,4,1,2,2,2,4,2,2,1,10,12,14,14,15,10,12,11,6,11,15,10,12,15,11,15,12,15,14,13,14,14,13,9,15,13,15,15,14,15,15,11,10,17,13,20,14,12,14,8,13,7,14,15,13,13,14,17,15,17,6,10,1,20,16,14,16,20,DM/M/AM LC,434,1,1,12,15,16,12,10,1,1,17,20,14,14,1,1,1.44133e+17,0,1,0,0,0,0,0,0,0,0,0,0,0,0,0,0,0,0,0,0,0,0,0,0,0,0,0,0,0,0,0,1,0,0,0,0,0,0,0,0,0,0,0,0,1,0,0,0,Georginio Wijnaldum,Â£27.00m ,29.0,175.0,Midfielder - Central Midfield,right,Liverpool FC,42.0,6.0,11.0,3338.0,50.0,2.0,4.0,3600.0,47.0,5.0,1.0,3705.0,47.0,6.0,0.0,3674.0,9.0,0.0,0.0,644.0,Premier League,15-07-16,17.3.2.23,Georginio Wijnaldum,859612,784,11-Nov-90,25,30,6,25,10,6250,7000,7350,154,146,45692188,175,74,M/AM RLC,3,3,3,3,3,2,2,1,1,3,3,10,12,14,14,15,11,12,12,6,8,15,13,9,15,10,14,12,15,13,13,14,13,14,12,15,14,15,15,14,14,14,10,11,15,14,20,14,11,14,8,13,7,14,14,13,13,14,14,14,15,6,Georginio Wijnaldum,Â£25.20m ,Premier League
19-06-17,18.3.4.28,Willian,8832889,1651,09-Aug-88,28,47,7,10,0,6750,8000,7750,162,161,101750010,175,78,M/AM RLC,1,1,1,1,1,1,1,1,1,1,1,9,14,17,11,15,16,9,15,8,5,15,12,8,16,11,14,9,13,12,15,14,16,15,8,15,7,18,20,16,13,10,11,7,12,17,20,14,11,14,8,14,4,12,14,15,10,14,14,13,12,8,1,1,16,20,20,17,19,M/AM RLC,526,1,1,12,19,17,20,1,1,1,1,16,15,15,1,1,2269940000000000.0,0,0,0,0,0,0,0,0,0,0,0,0,0,0,0,0,0,0,0,0,0,0,0,0,0,0,0,0,0,0,0,0,0,0,0,0,0,0,0,1,0,0,0,0,1,0,0,0,Willian,Â£28.80m ,32.0,175.0,Forward - Right Winger,right,Arsenal FC,41.0,12.0,5.0,2026.0,55.0,13.0,12.0,3053.0,56.0,8.0,14.0,3533.0,47.0,11.0,9.0,3365.0,6.0,0.0,2.0,385.0,Premier League,15-07-16,17.3.2.23,Willian,8832889,1651,09-Aug-88,27,38,6,10,0,6750,8000,7750,162,161,119117388,175,77,M/AM RLC,1,1,1,1,1,1,1,1,1,1,1,9,14,17,11,15,16,9,15,8,5,15,12,8,16,11,14,9,13,12,15,14,16,15,8,15,7,18,20,16,13,10,11,7,12,17,20,14,11,14,8,14,4,12,14,15,10,14,14,13,12,8,Willian,Â£28.80m ,Premier League
19-06-17,18.3.4.28,Josh Gordon,90048727,765,10-Oct-94,22,0,0,0,0,2000,4500,4500,110,97,406923,178,70,AM/S RL,3,3,2,1,2,1,2,2,3,2,2,4,8,12,11,11,5,9,10,3,5,10,9,6,12,4,13,10,12,10,9,12,16,9,7,12,11,12,14,13,12,11,8,5,11,12,20,11,10,10,5,10,3,10,11,12,12,11,13,14,10,8,1,1,12,18,18,18,1,AM/S RL,625,1,1,20,1,18,18,1,1,1,1,1,12,12,1,1,8208.0,0,0,0,0,1,0,0,0,0,0,0,0,0,1,0,0,0,0,0,0,0,0,0,0,0,0,0,0,0,0,0,0,0,0,0,0,0,0,0,0,0,0,0,0,0,0,0,0,nan,nan,nan,nan,nan,nan,nan,nan,nan,nan,nan,nan,nan,nan,nan,nan,nan,nan,nan,nan,nan,nan,nan,nan,nan,nan,nan,nan,
19-06-17,18.3.4.28,Leroy SanÃ©,91138280,771,11-Jan-96,21,6,0,10,5,6850,7400,7700,176,153,143824811,183,75,M/AM RLC,1,2,1,2,2,2,3,2,2,1,2,12,13,16,14,16,10,10,14,7,4,13,10,6,16,13,12,10,10,9,12,10,13,16,6,16,5,10,13,17,16,14,11,20,14,18,9,13,10,13,4,12,6,14,15,17,8,14,12,11,12,10,1,1,18,20,17,20,16,M/AM RLC,526,1,1,14,16,20,17,1,1,1,1,1,18,16,1,1,549756000000.0,0,0,0,0,0,0,0,0,0,0,1,0,0,0,0,0,0,0,0,0,0,0,0,0,0,0,0,0,0,0,0,0,0,0,0,0,0,0,0,1,0,0,0,0,0,0,0,0,Leroy SanÃ©,Â£81.00m ,24.0,184.0,Forward - Left Winger,left,Bayern Munich,37.0,9.0,8.0,2597.0,49.0,14.0,19.0,3648.0,47.0,16.0,18.0,2694.0,3.0,0.0,0.0,81.0,4.0,2.0,2.0,238.0,Premier League,15-07-16,17.3.2.23,Leroy SanÃ©,91138280,771,11-Jan-96,20,4,0,6,5,6850,7350,7350,176,147,109542903,183,75,M/AM RLC,1,3,2,1,3,3,3,1,1,3,1,11,11,16,14,16,10,10,14,7,5,12,10,6,15,13,12,10,10,8,12,9,13,15,6,16,6,10,13,16,16,12,11,20,14,18,9,12,9,11,4,11,6,14,12,17,8,14,12,11,12,10,Leroy SanÃ©,Â£31.50m ,Premier League
19-06-17,18.3.4.28,Abdelhamid Sabiri,91175740,34,28-Nov-96,20,0,0,0,0,4150,5350,5850,130,117,11058218,183,80,M/AM LC,1,1,4,3,1,1,3,1,2,3,4,10,11,13,13,12,14,14,12,8,5,14,12,6,15,12,14,14,13,9,15,8,12,16,6,14,5,9,10,12,15,10,13,12,13,12,20,11,11,11,10,12,5,13,9,14,6,13,10,8,10,16,1,1,19,20,10,19,20,M/AM LC,524,1,1,14,20,19,10,1,1,1,1,12,19,10,1,1,584116000000.0,0,0,0,0,1,0,0,0,0,0,1,0,1,0,0,0,0,0,0,0,0,0,0,0,0,0,0,0,0,0,0,0,0,0,0,1,0,0,0,1,0,0,0,0,0,0,0,0,Abdelhamid Sabiri,Â£900Th. ,23.0,186.0,Midfielder - Attacking Midfield,right,Ascoli Calcio,30.0,17.0,6.0,2289.0,10.0,0.0,1.0,505.0,3.0,0.0,0.0,93.0,25.0,4.0,1.0,1124.0,4.0,1.0,0.0,209.0,Premier League
19-06-17,18.3.4.28,Heung-Min Son,92020288,135,08-Jul-92,24,51,17,0,0,6600,8250,7600,159,154,131108996,183,77,AM/S RL,2,2,3,2,1,1,2,2,1,1,1,11,13,14,16,11,10,11,15,6,5,12,13,6,15,8,13,6,13,12,12,14,13,13,5,16,7,14,15,15,14,11,10,18,16,15,20,15,10,11,5,14,5,14,14,17,7,13,18,12,15,8,1,6,15,20,18,20,11,AM/S RL,515,1,1,16,11,20,18,1,1,1,1,1,13,15,6,1,18141900000000.0,0,0,0,0,1,0,0,0,0,1,0,0,0,0,0,0,0,0,0,0,0,0,0,0,0,0,0,0,0,0,0,0,0,0,0,0,0,0,0,1,0,0,0,0,1,0,0,0,Heung-min Son,Â£45.00m ,28.0,184.0,Forward - Left Winger,both,Tottenham Hotspur,47.0,21.0,9.0,2972.0,53.0,18.0,11.0,3379.0,48.0,20.0,10.0,3292.0,41.0,18.0,12.0,3174.0,8.0,9.0,4.0,586.0,Premier League,15-07-16,17.3.2.23,Heung-Min Son,92020288,135,08-Jul-92,24,48,16,0,0,6750,7400,7500,159,150,118067422,183,76,M/AM/S RL,2,3,2,2,1,1,2,3,3,2,3,10,11,13,17,12,10,12,15,6,5,10,13,6,12,14,12,10,13,10,9,9,10,13,5,11,7,10,14,16,15,12,10,18,16,16,20,14,10,11,5,14,5,14,14,17,7,13,18,12,15,8,Heung-min Son,Â£27.00m ,Premier League
19-06-17,18.3.4.28,Sead Haksabanovic,93065007,62002127,04-May-99,18,1,0,0,0,3750,5500,5500,150,110,3172018,174,70,M/AM RLC,2,1,1,1,3,1,3,3,2,1,2,11,12,13,11,14,11,5,14,5,5,12,11,5,14,8,11,9,11,11,13,12,14,15,5,12,6,9,11,13,13,11,8,10,12,12,20,12,7,13,5,9,4,15,13,14,15,13,13,13,12,7,1,1,20,19,15,20,19,M/AM RLC,416,1,1,14,19,18,15,1,1,1,1,14,20,15,1,1,1.44115e+17,0,0,0,0,0,0,0,0,1,0,0,0,0,0,0,0,0,0,0,0,0,0,0,0,0,0,0,0,0,0,0,0,0,0,0,0,0,0,0,0,0,0,0,0,0,0,0,0,Sead Haksabanovic,Â£1.35m ,21.0,174.0,Midfielder - Left Midfield,right,IFK NorrkÃ¶ping,22.0,5.0,1.0,1898.0,20.0,0.0,1.0,1348.0,31.0,6.0,8.0,1742.0,30.0,8.0,8.0,2202.0,nan,nan,nan,nan,Premier League
19-06-17,18.3.4.28,Xherdan Shaqiri,98003827,798,10-Oct-91,25,62,20,7,1,6448,8184,7350,163,144,65652415,169,72,M/AM RLC,3,1,2,2,3,2,2,2,2,4,1,12,14,15,11,17,13,4,14,4,3,14,10,2,15,14,12,13,11,9,13,10,14,18,5,15,2,10,10,16,17,16,5,20,13,14,12,14,11,12,8,12,8,14,10,15,13,13,16,12,14,8,1,1,19,20,20,19,18,M/AM RLC,526,1,1,10,18,19,20,1,1,1,1,12,19,18,1,1,584116000000.0,0,0,0,0,0,0,0,0,0,0,0,1,0,0,0,0,0,1,0,0,0,0,0,0,0,0,0,0,0,0,0,0,0,0,0,1,0,0,0,1,0,0,0,0,0,0,0,0,Xherdan Shaqiri,Â£16.20m ,29.0,169.0,Forward - Right Winger,left,Liverpool FC,22.0,4.0,2.0,1781.0,38.0,8.0,7.0,3080.0,30.0,6.0,5.0,1413.0,11.0,1.0,0.0,293.0,2.0,1.0,0.0,105.0,Premier League,15-07-16,17.3.2.23,Xherdan Shaqiri,98003827,798,10-Oct-91,24,57,18,7,1,6491,8063,7550,163,149,70875785,169,72,M/AM RLC,1,1,1,3,1,2,3,1,2,1,1,12,14,15,12,17,13,4,14,4,6,14,10,6,15,14,12,13,11,9,13,10,14,18,5,15,6,10,10,16,17,16,5,20,10,14,12,14,13,12,8,12,8,14,10,15,13,13,16,12,14,8,Xherdan Shaqiri,Â£13.50m ,Premier League
19-06-17,18.3.4.28,Mohamed Salah,98028755,16,15-Jun-92,25,53,29,11,4,6700,8000,8000,178,172,203307722,175,72,AM/S RL,3,3,3,3,3,2,1,1,3,1,1,11,13,16,17,15,9,11,15,3,8,14,12,8,16,9,15,10,14,14,14,15,14,14,5,17,7,13,12,18,17,15,7,20,14,18,8,14,13,15,4,15,6,9,15,17,9,14,15,13,16,9,1,1,1,20,20,18,14,AM/S RL,515,1,1,16,14,18,20,1,1,1,1,1,1,1,1,1,2.90482e+17,0,0,0,0,0,0,0,0,0,0,1,0,0,1,0,0,0,0,0,0,0,0,0,0,0,0,0,1,0,0,0,0,0,0,0,0,0,0,0,0,0,0,0,0,0,0,0,0,Mohamed Salah,Â£135.00m ,28.0,175.0,Forward - Right Winger,left,Liverpool FC,41.0,19.0,15.0,3185.0,52.0,44.0,16.0,4119.0,52.0,27.0,12.0,4342.0,48.0,23.0,13.0,4091.0,9.0,6.0,0.0,751.0,Premier League,15-07-16,17.3.2.23,Mohamed Salah,98028755,16,15-Jun-92,24,42,25,11,4,6250,7800,7800,164,156,87599570,175,72,AM/S RL,2,1,1,4,1,3,2,2,3,2,1,6,12,16,15,16,6,5,12,3,4,12,11,6,15,8,16,7,13,11,12,13,13,17,5,17,7,10,10,18,17,11,6,20,14,18,9,14,8,14,4,16,6,14,15,17,10,14,11,10,14,9,Mohamed Salah,Â£31.50m ,Serie A
19-06-17,18.3.4.28,Edimilson Fernandes,98030084,798,15-Apr-96,21,2,0,4,2,3850,6250,6250,143,126,23805289,190,70,M/AM RLC,1,1,3,3,1,3,1,2,2,2,3,10,12,13,7,14,8,11,13,7,9,14,6,10,15,8,10,9,12,13,13,9,11,13,7,13,10,13,12,13,12,14,14,12,11,13,20,14,11,11,7,13,8,10,12,12,13,9,12,12,13,7,1,1,20,19,17,15,20,M/AM RLC,416,1,1,8,19,15,17,1,1,1,13,20,15,17,1,1,1.44115e+17,0,0,0,0,0,0,0,0,0,0,0,0,0,0,0,0,0,0,0,0,0,0,0,0,0,0,0,0,0,0,0,1,0,0,0,0,0,0,0,0,0,0,0,0,0,0,0,0,Edimilson Fernandes,Â£4.50m ,24.0,190.0,Midfielder - Central Midfield,right,1.FSV Mainz 05,42.0,2.0,2.0,2049.0,17.0,0.0,2.0,1096.0,33.0,2.0,0.0,2193.0,25.0,1.0,0.0,1579.0,2.0,0.0,0.0,57.0,Premier League,15-07-16,17.3.2.23,Edimilson Fernandes,98030084,798,15-Apr-96,20,0,0,1,0,3850,6050,6200,160,122,19744252,190,70,M/AM RLC,2,1,1,3,3,2,3,3,2,2,1,10,12,13,7,14,8,11,12,7,7,14,10,8,15,8,9,9,12,13,13,9,10,13,7,13,8,13,10,13,12,14,14,12,11,13,20,14,11,10,7,13,11,11,19,12,13,9,10,9,13,9,Edimilson Fernandes,Â£4.50m ,Premier League
19-06-17,18.3.4.28,Bertrand TraorÃ©,13112706,9,06-Sep-95,21,40,6,0,0,5450,6950,6950,159,139,48488490,181,73,M/AM/S RL,1,2,3,3,1,1,2,1,2,4,1,12,12,15,12,14,12,9,10,4,5,11,9,4,15,7,10,9,12,10,13,12,15,13,7,13,9,13,13,16,14,10,10,20,14,16,7,13,11,13,3,11,6,14,10,15,9,12,14,14,10,1,1,1,17,20,20,17,1,M/AM/S RL,535,1,1,19,1,17,20,1,1,1,1,1,17,17,1,1,549756000000.0,0,0,0,0,0,0,0,0,0,0,0,0,0,0,0,0,0,0,0,0,0,0,0,0,0,0,0,0,0,0,0,0,0,0,0,0,0,0,0,1,0,0,0,0,0,0,0,0,Bertrand TraorÃ©,Â£16.20m ,25.0,181.0,Forward - Right Winger,left,Aston Villa,39.0,13.0,6.0,3074.0,43.0,18.0,7.0,3019.0,48.0,11.0,5.0,2717.0,35.0,4.0,5.0,1913.0,6.0,1.0,0.0,189.0,Ligue 1
19-06-17,18.3.4.28,Ambroise Oyongo,13113344,11,22-Jun-91,25,29,2,0,0,3750,5900,5900,120,118,2644408,176,69,D/WB/M L,3,3,2,3,1,3,2,3,2,3,2,9,13,12,6,11,11,9,7,8,11,11,11,11,11,6,10,8,9,9,7,11,11,8,4,13,11,12,15,15,14,15,7,20,15,15,10,13,6,12,5,5,6,12,14,9,12,11,11,9,16,5,20,20,16,13,14,20,1,D/WB/M L,123,1,1,1,1,13,1,1,20,14,1,1,16,1,20,13,1.0,1,0,0,0,0,0,0,0,0,0,0,0,0,0,0,0,0,0,0,0,0,0,0,0,0,0,0,0,0,0,0,0,0,0,0,0,0,0,0,0,0,0,0,0,0,0,0,0,Ambroise Oyongo,Â£675Th. ,29.0,176.0,Defender - Left-Back,left,Montpellier HSC,12.0,1.0,1.0,1080.0,3.0,0.0,0.0,203.0,27.0,2.0,1.0,2231.0,24.0,0.0,0.0,1991.0,7.0,0.0,1.0,258.0,Ligue 1
19-06-17,18.3.4.28,Casimir Ninga,13117428,14,17-May-93,24,15,5,0,0,4000,6250,6250,130,125,8256765,186,81,AM/S L,2,4,1,3,2,3,1,2,2,2,2,5,10,13,14,10,5,11,13,5,4,9,10,4,10,13,11,14,12,9,8,8,15,13,7,13,7,10,11,16,13,15,12,7,10,17,20,17,15,12,8,11,14,12,12,15,13,12,15,13,13,6,1,1,1,18,1,18,1,AM/S L,623,1,1,20,1,18,1,1,1,1,1,1,1,1,1,1,134218752.0,0,0,0,0,0,0,0,0,0,0,1,0,0,0,0,0,0,0,0,0,0,0,0,0,0,0,0,1,0,0,0,0,0,0,0,0,0,0,0,0,0,0,0,0,0,0,0,0,Casimir Ninga,Â£1.35m ,27.0,186.0,Forward - Left Winger,right,Sivasspor,9.0,5.0,2.0,515.0,34.0,4.0,1.0,1568.0,36.0,8.0,3.0,2581.0,18.0,3.0,1.0,812.0,4.0,0.0,0.0,168.0,Ligue 1,15-07-16,17.3.2.23,Casimir Ninga,13117428,14,17-May-93,23,15,5,0,0,4000,6050,6200,130,121,8322041,186,81,AM/S L,2,1,3,3,2,1,2,2,2,3,1,5,10,13,14,10,5,11,13,5,4,9,10,4,10,13,11,14,12,9,8,8,15,13,7,8,7,10,10,15,12,15,12,7,10,18,20,17,15,8,8,11,12,12,12,15,13,12,15,13,13,6,Casimir Ninga,Â£2.25m ,Ligue 1
19-06-17,18.3.4.28,Firmin Mubele,13136838,53,17-Apr-94,23,39,9,0,0,3900,6450,6450,134,129,10816215,178,71,AM/S RL,4,3,2,2,3,1,3,1,1,1,1,11,12,14,12,13,7,8,8,5,5,11,9,6,13,7,13,11,12,12,9,11,12,12,7,13,7,13,11,16,14,12,6,8,14,15,20,13,11,13,7,1,8,12,14,14,12,14,12,10,10,10,1,1,14,19,19,15,1,AM/S RL,625,1,1,20,1,15,19,1,1,1,1,1,1,14,1,1,0.0,0,0,0,0,0,0,0,0,0,0,0,0,0,0,0,0,0,0,0,0,0,0,0,0,0,0,0,0,0,0,0,0,0,0,0,0,0,0,0,0,0,0,0,0,0,0,0,0,Firmin Mubele,Â£5.40m ,26.0,175.0,Forward - Centre-Forward,right,FC Toulouse,27.0,11.0,4.0,2246.0,34.0,6.0,3.0,1810.0,22.0,2.0,1.0,732.0,7.0,0.0,0.0,236.0,nan,nan,nan,nan,Ligue 1
19-06-17,18.3.4.28,Ãngel Di MarÃ­a,14000219,1649,14-Feb-88,29,86,19,13,3,6750,8500,7550,174,156,59173982,180,70,M/AM RLC,2,2,2,1,2,4,2,3,1,3,1,16,14,15,13,17,15,6,15,4,5,15,14,8,16,11,15,12,16,12,16,13,13,16,10,14,8,12,12,16,17,12,10,20,14,15,8,14,9,12,14,14,8,16,14,17,13,16,14,6,12,10,1,7,19,20,20,20,15,M/AM RLC,526,1,1,7,15,20,20,1,1,1,1,14,19,12,7,1,2.90482e+17,0,0,0,0,0,0,0,0,0,0,0,0,0,0,0,0,1,0,0,0,0,0,0,0,0,0,0,1,0,0,0,0,0,0,0,0,0,0,0,0,0,0,0,0,0,0,0,0,Ãngel Di MarÃ­a,Â£36.00m ,32.0,180.0,Forward - Right Winger,left,Paris Saint-Germain,43.0,14.0,15.0,3091.0,45.0,21.0,12.0,3119.0,45.0,19.0,17.0,3498.0,41.0,12.0,23.0,3250.0,5.0,1.0,2.0,423.0,Ligue 1,15-07-16,17.3.2.23,Ãngel Di MarÃ­a,14000219,1649,14-Feb-88,28,66,15,13,3,8250,8500,8300,174,166,126901256,180,70,M/AM RLC,1,2,3,3,4,3,2,3,2,3,1,14,15,16,13,17,15,6,15,4,5,16,14,8,17,13,16,11,15,13,16,14,13,17,10,14,9,13,13,16,18,12,10,20,14,15,8,16,9,13,14,12,10,15,14,15,10,16,14,6,12,10,Ãngel Di MarÃ­a,Â£36.00m ,Ligue 1
19-06-17,18.3.4.28,Javier Pastore,14006099,1649,20-Jun-89,27,27,2,0,0,6500,7450,7450,159,149,48682433,187,75,M/AM LC,3,3,3,1,2,1,3,1,1,3,3,13,14,15,12,17,13,8,14,3,3,16,14,2,17,8,14,9,15,11,17,14,11,18,10,14,5,14,9,15,14,12,12,14,11,14,20,13,11,10,8,15,13,10,10,16,14,12,14,15,15,7,1,1,16,20,10,15,20,M/AM LC,524,1,1,1,20,15,10,1,1,1,1,16,15,10,1,1,18142000000000.0,0,0,0,0,0,0,0,0,0,0,0,0,0,0,0,0,0,0,0,0,1,0,0,0,1,0,0,0,0,0,0,0,0,0,0,0,0,0,0,1,0,0,0,0,1,0,0,0,Javier Pastore,Â£13.50m ,31.0,187.0,Midfielder - Attacking Midfield,right,AS Roma,23.0,3.0,9.0,1151.0,37.0,5.0,6.0,1850.0,17.0,4.0,1.0,790.0,15.0,0.0,2.0,795.0,nan,nan,nan,nan,Ligue 1,15-07-16,17.3.2.23,Javier Pastore,14006099,1649,20-Jun-89,27,10,0,0,0,6750,7900,7600,160,151,30132139,187,75,M/AM LC,1,2,3,1,3,1,2,3,2,2,1,13,13,15,11,18,13,8,13,4,3,17,14,4,17,10,13,9,14,12,17,13,12,18,8,14,6,14,9,15,16,12,12,14,12,14,20,12,11,13,8,13,13,10,11,17,13,12,14,15,15,8,Javier Pastore,Â£18.00m ,Ligue 1
19-06-17,18.3.4.28,Lucas Ocampos,14031132,1649,11-Jul-94,22,0,0,0,0,5250,6450,6450,141,129,14456288,187,84,AM/S RL,2,2,1,1,1,4,3,2,1,2,1,11,13,14,11,14,11,13,14,8,5,13,13,5,15,9,11,14,11,7,10,9,13,17,8,13,7,12,12,13,15,12,15,9,13,14,20,15,13,13,8,13,5,14,11,15,13,14,13,7,12,6,1,1,14,20,15,20,10,AM/S RL,515,3,1,17,10,20,15,1,1,1,1,1,14,13,1,1,2252380000000000.0,0,0,0,0,0,0,0,0,0,0,0,0,0,0,0,0,0,0,0,0,0,0,0,0,0,0,0,0,0,0,0,0,0,0,0,1,0,0,0,1,0,0,0,0,0,0,0,0,Lucas Ocampos,Â£10.80m ,26.0,187.0,Forward - Right Winger,both,Sevilla FC,29.0,3.0,2.0,1518.0,53.0,16.0,4.0,3668.0,40.0,5.0,8.0,3217.0,44.0,17.0,5.0,3574.0,7.0,1.0,0.0,523.0,Ligue 1,15-07-16,17.3.2.23,Lucas Ocampos,14031132,1649,11-Jul-94,22,0,0,0,0,4800,6350,6650,150,133,20833531,187,84,AM RL,1,3,3,2,1,2,3,1,3,2,3,11,13,15,12,14,11,13,14,4,5,12,14,5,16,12,12,14,12,10,10,9,14,17,10,12,7,10,14,14,16,14,15,9,13,14,20,14,14,14,8,15,5,14,11,16,13,14,13,15,15,6,Lucas Ocampos,Â£4.95m ,Serie A
19-06-17,18.3.4.28,Giovani Lo Celso,14108651,1649,09-Apr-96,21,0,0,0,0,4754,6006,6700,166,134,21850813,176,69,M/AM LC,2,4,3,3,3,2,1,3,3,2,2,11,15,14,9,16,13,10,13,8,9,16,14,10,15,10,12,13,14,13,15,14,15,15,10,12,12,14,12,13,12,14,11,20,12,13,8,12,11,12,11,12,10,10,12,13,15,13,15,12,10,8,1,1,19,20,7,15,20,M/AM LC,524,1,1,1,20,1,1,1,1,1,13,19,15,7,1,1,0.0,0,0,0,0,0,0,0,0,0,0,0,0,0,0,0,0,0,0,0,0,0,0,0,0,0,0,0,0,0,0,0,0,0,0,0,0,0,0,0,0,0,0,0,0,0,0,0,0,Giovani Lo Celso,Â£27.00m ,24.0,177.0,Midfielder - Central Midfield,left,Tottenham Hotspur,14.0,1.0,4.0,736.0,48.0,6.0,7.0,2452.0,46.0,16.0,6.0,3497.0,37.0,2.0,3.0,2152.0,7.0,2.0,0.0,310.0,Ligue 1,15-07-16,17.3.2.23,Giovani Lo Celso,14108651,1649,09-Apr-96,20,0,0,0,0,2497,5997,5997,169,128,5670346,176,69,M/AM LC,1,4,3,1,2,3,3,1,2,1,3,11,15,13,9,16,13,10,12,8,9,15,14,9,15,11,11,12,13,13,15,14,15,15,11,12,12,12,11,13,12,13,11,20,12,13,8,13,11,12,11,11,11,10,9,13,15,11,15,12,10,8,Giovani Lo Celso,Â£7.20m ,Ligue 1
19-06-17,18.3.4.28,Neymar,19024412,1651,05-Feb-92,25,77,52,7,9,9500,9500,9500,197,190,232186002,174,68,M/AM/S LC,3,4,2,1,2,1,1,4,1,3,1,16,16,20,16,17,16,9,13,3,3,16,16,3,20,10,17,14,15,15,16,15,16,19,14,19,3,10,10,18,19,14,6,14,16,16,20,13,10,14,11,15,6,12,16,17,9,14,11,8,8,13,1,1,18,20,14,20,18,M/AM/S LC,534,1,1,19,18,20,14,1,1,1,1,1,18,12,1,1,2322750000000000.0,0,0,0,0,0,0,0,0,0,0,0,0,0,0,1,0,0,0,0,0,0,0,0,0,0,0,0,0,0,0,0,0,0,0,0,1,0,0,0,1,0,0,0,0,0,0,1,0,Neymar,Â£162.00m ,28.0,175.0,Forward - Left Winger,right,Paris Saint-Germain,45.0,20.0,26.0,3972.0,30.0,28.0,16.0,2697.0,28.0,23.0,13.0,2351.0,27.0,19.0,12.0,2386.0,5.0,2.0,4.0,450.0,Ligue 1,15-07-16,17.3.2.23,Neymar,19024412,1651,05-Feb-92,24,70,46,7,9,9000,9350,9350,197,190,175725149,174,68,M/AM/S LC,1,1,2,1,2,2,2,1,1,1,3,16,16,20,16,17,16,9,13,3,4,16,16,4,20,10,17,14,15,15,16,15,15,19,13,19,4,13,12,18,19,14,6,15,16,16,20,13,10,14,11,15,6,12,15,16,19,14,15,8,8,17,Neymar,Â£90.00m ,LaLiga
19-06-17,18.3.4.28,Lucas Lima,19082750,1651,10-Oct-91,25,0,0,0,0,3900,6350,6350,133,127,6934198,178,73,D/WB L,2,4,3,3,2,2,1,3,1,2,3,8,13,13,11,12,12,10,12,11,12,13,5,8,13,5,13,9,12,12,12,11,15,12,5,12,8,13,13,15,14,12,9,20,12,15,8,15,12,12,12,12,6,13,17,14,9,10,9,6,9,6,20,19,15,14,1,20,1,D/WB L,113,1,1,1,1,14,1,1,20,1,1,1,15,1,19,1,32.0,0,0,0,0,0,1,0,0,0,0,0,0,0,0,0,0,0,0,0,0,0,0,0,0,0,0,0,0,0,0,0,0,0,0,0,0,0,0,0,0,0,0,0,0,0,0,0,0,Lucas Lima,Â£4.05m ,29.0,179.0,Defender - Left-Back,left,Al-Ahli Jeddah,42.0,1.0,3.0,3660.0,36.0,3.0,3.0,2907.0,36.0,0.0,5.0,2946.0,34.0,1.0,2.0,3019.0,2.0,0.0,1.0,180.0,Ligue 1,15-07-16,17.3.2.23,Lucas Lima,19082750,1651,10-Oct-91,24,0,0,0,0,3600,6150,6150,135,124,4713531,178,73,D/WB L,3,3,2,3,3,1,2,2,3,2,3,8,13,13,11,12,12,10,12,11,12,13,5,8,13,5,12,9,12,12,12,11,15,12,5,12,7,13,12,15,15,11,9,20,12,15,8,14,11,11,12,12,6,13,17,14,9,10,9,6,9,6,Lucas Lima,Â£1.58m ,Ligue 1
19-06-17,18.3.4.28,Jonathan Cafu,19087214,1651,10-Jul-91,25,0,0,0,0,4250,6000,6350,137,127,8157878,173,64,AM/S RL,2,3,2,2,2,2,1,2,1,2,3,11,11,16,12,12,12,7,11,3,3,11,11,6,13,10,10,12,11,9,11,10,12,13,7,13,4,8,10,16,17,10,7,9,13,15,20,11,8,8,8,11,6,16,13,13,11,9,12,8,8,9,1,1,11,20,20,15,1,AM/S RL,515,1,1,18,1,15,20,1,1,1,1,1,11,11,1,1,2251800000000000.0,0,0,0,0,0,0,0,0,0,0,0,0,1,0,0,0,0,0,0,0,0,0,0,0,0,0,0,1,0,0,0,0,0,0,0,0,0,0,0,0,0,0,0,0,0,0,0,0,Jonathan CafÃº,Â£3.60m ,29.0,175.0,Forward - Right Winger,right,Al-Hazm,45.0,14.0,11.0,3796.0,25.0,2.0,2.0,1037.0,9.0,2.0,0.0,495.0,17.0,2.0,1.0,1340.0,nan,nan,nan,nan,Ligue 1
19-06-17,18.3.4.28,Gabriel Silva,19089286,1651,13-May-91,26,0,0,9,1,3500,6050,6050,134,121,3242331,179,75,D/WB/M L,1,2,1,2,2,2,3,3,3,2,2,13,13,12,10,12,11,6,11,11,10,12,12,11,13,11,11,11,11,11,11,11,16,12,3,13,11,12,12,14,13,11,10,20,16,15,9,14,10,14,8,13,7,14,9,14,15,14,16,9,14,9,20,19,18,5,1,20,1,D/WB/M L,123,1,1,1,1,5,1,1,20,1,1,1,18,1,19,1,2252350000000000.0,0,0,0,0,0,1,0,0,0,0,0,0,0,0,0,0,0,0,0,0,1,0,0,0,0,0,0,0,0,0,0,0,0,0,0,0,0,0,0,1,0,0,0,0,0,0,0,0,Gabriel Silva,Â£2.25m ,29.0,179.0,Defender - Left-Back,left,AS Saint-Ãtienne,18.0,0.0,0.0,1297.0,27.0,1.0,1.0,2208.0,19.0,0.0,2.0,1433.0,9.0,1.0,0.0,486.0,nan,nan,nan,nan,Ligue 1,15-07-16,17.3.2.23,Gabriel Silva,19089286,1651,13-May-91,25,0,0,9,1,3500,6500,6450,136,129,5822393,179,75,D/WB/M L,1,2,3,3,3,2,2,1,2,2,2,13,13,12,10,12,11,6,11,10,10,12,12,11,13,11,12,11,11,11,11,11,16,14,3,13,12,12,14,14,14,11,10,20,16,15,12,15,11,14,8,13,7,14,9,14,15,14,16,9,14,9,Gabriel Silva,Â£2.25m ,Serie A
19-06-17,18.3.4.28,Danilo Avelar,19123883,1651,09-Jun-89,28,0,0,0,0,3750,6050,6050,131,121,2030652,185,76,D/WB/M L,3,3,2,2,1,1,1,1,2,3,1,9,14,12,8,12,15,8,13,7,13,12,15,13,13,12,13,11,11,12,12,13,16,12,7,14,12,12,13,14,12,13,11,20,14,14,5,12,12,14,11,13,9,14,11,10,10,10,13,14,14,13,20,19,18,1,1,20,1,D/WB/M L,123,1,1,1,1,1,1,1,20,1,1,1,18,1,19,1,17179869216.0,0,0,0,0,0,1,0,0,0,0,0,0,0,0,0,0,0,0,0,0,0,0,0,0,0,0,0,0,0,0,0,0,0,0,1,0,0,0,0,0,0,0,0,0,0,0,0,0,Danilo Avelar,Â£1.35m ,31.0,185.0,Defender - Centre-Back,left,Sport Club Corinthians Paulista,6.0,0.0,0.0,515.0,46.0,2.0,2.0,3866.0,33.0,2.0,2.0,2897.0,19.0,3.0,0.0,1705.0,nan,nan,nan,nan,Serie A,15-07-16,17.3.2.23,Danilo Avelar,19123883,1651,09-Jun-89,27,0,0,0,0,3250,6350,6250,131,124,4037666,185,75,D/WB L,2,4,2,1,2,2,3,2,1,2,1,9,14,12,8,12,15,8,13,7,13,12,15,13,13,12,13,11,11,12,12,13,16,12,7,14,12,12,13,15,12,14,11,20,14,15,5,13,13,14,11,13,9,14,11,10,10,10,13,14,14,13,Danilo Avelar,Â£1.35m ,Serie A
19-06-17,18.3.4.28,Boschilia,19202696,1651,05-Mar-96,21,0,0,7,2,5800,6300,6650,158,132,20316002,172,63,M/AM RLC,1,2,3,3,3,3,2,1,3,3,2,15,13,15,12,14,16,8,13,4,5,14,13,6,16,13,12,13,14,12,13,12,14,14,11,13,7,12,13,14,15,12,6,20,13,13,9,13,9,13,8,13,9,15,11,15,13,13,14,13,14,7,1,1,16,20,16,20,18,M/AM RLC,526,1,1,1,18,20,16,1,1,1,1,12,16,15,1,1,18141900000000.0,0,0,0,1,0,0,0,0,1,0,1,0,0,0,0,0,0,0,0,0,0,0,0,0,0,0,0,0,0,0,0,0,0,0,0,0,0,0,0,1,0,0,0,0,1,0,0,0,nan,nan,nan,nan,nan,nan,nan,nan,nan,nan,nan,nan,nan,nan,nan,nan,nan,nan,nan,nan,nan,nan,nan,nan,nan,nan,nan,nan,15-07-16,17.3.2.23,Boschilia,19202696,1651,05-Mar-96,20,0,0,7,2,5648,6298,6298,151,126,12814291,172,63,AM RLC,3,1,1,1,3,1,2,2,4,1,2,15,13,15,11,14,16,10,13,5,7,13,12,7,16,13,12,12,13,12,13,12,14,14,11,13,7,12,13,14,14,8,6,20,14,13,10,13,8,13,8,12,8,14,10,15,12,13,13,13,14,7,nan,nan,nan
19-06-17,18.3.4.28,Luiz AraÃºjo,19215572,1651,02-Jun-96,21,0,0,0,0,3750,6500,6500,147,125,19799723,175,67,AM RL,2,2,4,2,3,2,1,4,1,1,2,12,13,14,11,12,11,8,11,11,8,12,10,9,12,12,12,11,11,12,13,13,12,14,11,13,6,13,12,13,15,11,7,20,12,14,11,13,8,13,10,12,12,12,13,13,13,12,12,9,12,6,1,1,1,20,20,17,14,AM RL,505,1,1,12,14,17,20,1,1,1,1,1,1,1,1,1,0.0,0,0,0,0,0,0,0,0,0,0,0,0,0,0,0,0,0,0,0,0,0,0,0,0,0,0,0,0,0,0,0,0,0,0,0,0,0,0,0,0,0,0,0,0,0,0,0,0,Luiz AraÃºjo,Â£6.30m ,24.0,175.0,Forward - Right Winger,left,LOSC Lille,5.0,2.0,0.0,265.0,36.0,6.0,3.0,2175.0,29.0,4.0,1.0,1036.0,33.0,4.0,2.0,1479.0,9.0,2.0,1.0,434.0,Ligue 1
19-06-17,18.3.4.28,Jorge,19226738,1651,28-Mar-96,21,1,0,13,1,6050,6450,6700,156,134,22415922,184,71,D L,3,4,3,3,3,2,1,2,1,3,1,11,14,15,10,14,11,10,13,11,12,14,11,13,15,12,14,13,12,13,14,13,14,14,8,13,12,12,13,14,15,12,11,20,13,14,8,14,11,13,8,14,6,13,12,14,13,15,14,14,15,7,20,15,15,12,1,20,1,D L,103,1,1,1,1,12,1,1,20,1,1,1,15,1,15,1,2251940000000000.0,0,0,0,0,0,0,0,0,1,1,0,0,0,0,0,0,0,0,0,0,0,0,0,0,0,0,0,0,0,0,0,0,0,0,0,0,0,1,0,0,0,0,0,0,0,0,0,0,Jorge,Â£10.80m ,24.0,184.0,Defender - Left-Back,left,FC Basel 1893,5.0,1.0,0.0,365.0,27.0,1.0,4.0,2372.0,34.0,1.0,4.0,2920.0,2.0,0.0,0.0,180.0,nan,nan,nan,nan,Ligue 1,15-07-16,17.3.2.23,Jorge,19226738,1651,28-Mar-96,20,0,0,0,0,3250,6450,6450,158,134,13732612,184,71,D/WB/M L,3,3,1,4,1,2,3,1,1,3,1,11,14,15,13,13,8,9,13,7,12,14,11,11,15,10,14,8,12,13,14,13,14,14,7,13,11,13,14,14,15,11,8,20,12,14,9,14,10,12,5,13,10,14,9,14,8,15,13,10,14,8,Jorge,Â£5.40m ,Ligue 1
19-06-17,18.3.4.28,Malcom,19229435,1651,26-Feb-97,20,0,0,13,2,5500,7250,7150,158,143,33628694,171,65,AM RL,1,2,1,4,1,2,3,2,2,1,3,14,13,15,12,15,15,8,12,6,4,13,12,4,16,8,13,10,14,13,14,14,14,15,8,15,6,13,12,15,16,14,7,20,13,15,10,13,9,14,6,14,8,11,12,15,10,12,12,6,12,10,1,1,12,20,20,18,14,AM RL,505,1,1,13,14,18,20,1,1,1,1,1,12,10,1,1,2.8823e+17,0,0,0,0,0,0,0,0,0,0,1,1,0,0,0,0,0,0,0,0,1,0,0,0,0,0,0,0,0,0,0,0,0,0,0,0,0,0,0,0,0,0,0,0,0,0,0,0,Malcom,Â£40.50m ,23.0,171.0,Forward - Right Winger,left,Zenit St. Petersburg,45.0,9.0,7.0,3275.0,38.0,12.0,8.0,3124.0,24.0,4.0,2.0,1067.0,15.0,4.0,3.0,1125.0,11.0,1.0,1.0,891.0,Ligue 1,15-07-16,17.3.2.23,Malcom,19229435,1651,26-Feb-97,19,0,0,11,1,5191,6491,6541,160,131,26115547,171,65,AM RL,3,2,3,1,2,3,2,4,3,1,1,14,13,13,11,14,15,8,12,6,4,13,12,4,15,8,12,10,12,8,13,13,14,15,8,14,6,13,12,15,16,10,7,20,13,15,10,12,7,11,6,11,8,11,12,13,11,12,12,6,12,5,Malcom,Â£9.00m ,Ligue 1
19-06-17,18.3.4.28,Adama MbenguÃ©,20028883,41,01-Dec-93,23,3,0,0,0,3500,5800,5800,125,116,2391520,178,68,D/M L,2,3,3,2,2,1,4,2,2,2,2,12,12,11,9,12,7,8,8,12,9,11,12,11,11,7,11,9,12,10,9,11,12,12,8,11,10,11,14,15,13,15,9,20,10,14,8,14,12,11,9,9,11,11,12,9,9,13,11,13,20,5,20,14,16,15,13,20,1,D/M L,113,1,1,1,1,15,13,1,20,1,1,1,16,10,14,3,0.0,0,0,0,0,0,0,0,0,0,0,0,0,0,0,0,0,0,0,0,0,0,0,0,0,0,0,0,0,0,0,0,0,0,0,0,0,0,0,0,0,0,0,0,0,0,0,0,0,Adama Mbengue,Â£2.70m ,26.0,178.0,Defender - Left-Back,left,SM Caen,nan,nan,nan,nan,21.0,0.0,0.0,1750.0,15.0,1.0,1.0,1077.0,21.0,1.0,1.0,1466.0,7.0,1.0,0.0,630.0,Ligue 1
19-06-17,18.3.4.28,Martin Braithwaite,27013113,764,05-Jun-91,26,17,1,2,0,5200,6500,6650,136,132,27753564,177,77,AM/S RLC,3,2,3,1,1,2,3,1,2,3,2,8,11,12,12,12,9,11,10,4,3,11,10,5,13,12,12,13,11,10,11,10,14,16,14,15,5,13,14,15,14,12,12,12,14,16,20,12,11,14,7,14,11,13,14,12,14,8,12,13,15,6,1,1,10,18,16,18,16,AM/S RLC,626,1,1,20,16,18,16,1,1,1,1,10,10,10,1,1,17626700000000.0,0,0,0,0,1,0,0,0,0,0,0,0,0,0,0,0,0,0,0,1,0,0,0,0,0,0,0,1,0,0,0,0,0,0,0,1,0,0,0,0,0,0,0,0,1,0,0,0,Martin Braithwaite,Â£7.20m ,29.0,177.0,Forward - Centre-Forward,right,FC Barcelona,36.0,12.0,3.0,3188.0,35.0,10.0,5.0,2435.0,40.0,8.0,7.0,2833.0,38.0,9.0,1.0,2533.0,2.0,0.0,0.0,13.0,Ligue 1,15-07-16,17.3.2.23,Martin Braithwaite,27013113,764,05-Jun-91,25,14,1,2,0,5200,6800,6800,139,136,17139560,177,77,AM/S RLC,2,4,2,2,2,3,2,2,3,1,1,8,11,13,12,12,10,11,10,2,3,11,10,5,13,12,12,13,11,10,11,10,14,16,14,15,5,13,14,15,14,12,12,12,14,16,20,13,14,13,7,14,11,13,14,11,12,8,12,13,15,6,Martin Braithwaite,Â£6.75m ,Ligue 1
19-06-17,18.3.4.28,Jeff Reine-Adelaide,28106680,769,17-Jan-98,19,0,0,0,0,4600,5750,5750,142,120,10104601,188,75,AM RLC,3,1,4,3,1,2,2,1,2,1,2,8,11,14,11,13,10,11,10,2,6,12,11,8,13,8,11,9,14,9,13,11,13,15,8,12,7,12,13,14,12,14,13,11,12,14,20,11,13,12,8,11,13,14,12,11,10,12,13,12,14,7,1,8,14,20,18,20,16,AM RLC,506,1,1,10,16,20,18,1,1,1,8,14,12,12,8,8,1.44133e+17,0,0,0,0,0,0,0,0,0,0,0,0,0,0,0,0,0,0,0,0,0,0,0,0,0,0,0,0,0,0,0,0,0,0,0,0,0,0,0,0,0,0,0,0,1,0,0,0,Jeff Reine-AdÃ©laÃ¯de,Â£2.70m ,22.0,184.0,Midfielder - Central Midfield,right,OGC Nice,15.0,0.0,2.0,1138.0,18.0,1.0,2.0,1019.0,36.0,3.0,3.0,2645.0,23.0,3.0,4.0,1195.0,2.0,0.0,0.0,32.0,Premier League
19-06-17,18.3.4.28,Max Gradel,29001331,24,30-Nov-87,29,55,9,0,0,5489,7485,6750,152,135,34795897,181,69,M/AM RLC,1,3,3,2,2,1,3,2,3,3,2,8,12,15,13,13,12,10,12,3,5,13,10,7,14,14,9,11,10,8,13,13,19,14,5,13,11,12,13,16,14,14,6,5,12,16,20,14,12,10,12,15,11,11,16,18,13,8,10,8,5,9,1,1,20,20,20,20,17,M/AM RLC,416,1,1,14,17,19,20,1,1,1,1,1,20,17,1,1,70952900000000.0,0,0,0,0,0,0,0,0,0,1,0,0,0,0,0,0,0,1,0,0,0,0,0,0,0,0,0,0,0,0,0,0,0,0,0,1,0,0,0,1,0,0,0,0,0,0,1,0,Max Gradel,Â£6.30m ,32.0,175.0,Forward - Left Winger,right,Sivasspor,13.0,1.0,0.0,333.0,35.0,11.0,4.0,2897.0,39.0,13.0,10.0,3481.0,22.0,4.0,2.0,1701.0,6.0,2.0,0.0,497.0,Ligue 1,15-07-16,17.3.2.23,Max Gradel,29001331,24,30-Nov-87,28,46,9,0,0,5500,7500,7100,152,143,34171370,181,70,M/AM RLC,1,3,1,2,1,2,1,2,2,1,2,8,13,15,13,13,14,10,12,3,5,13,10,7,15,14,8,11,9,8,13,13,19,14,5,13,11,12,13,16,15,15,6,6,12,17,20,14,13,11,12,15,10,11,16,18,13,8,10,8,5,9,Max Gradel,Â£6.30m ,Premier League
19-06-17,18.3.4.28,Clinton N'jie,29114945,11,15-Aug-93,23,18,6,0,0,5000,6650,6650,139,129,16110142,175,68,AM/S RL,1,4,4,1,2,1,3,1,3,3,1,10,11,13,12,12,10,8,13,5,5,11,10,5,13,9,12,10,12,10,8,11,12,14,8,14,6,9,10,17,14,12,9,8,14,16,20,14,13,12,9,11,7,10,10,14,11,10,12,8,10,7,1,1,1,17,16,17,1,AM/S RL,625,1,1,20,1,17,16,1,1,1,1,1,1,1,1,1,0.0,0,0,0,0,0,0,0,0,0,0,0,0,0,0,0,0,0,0,0,0,0,0,0,0,0,0,0,0,0,0,0,0,0,0,0,0,0,0,0,0,0,0,0,0,0,0,0,0,Clinton N'Jie,Â£9.00m ,27.0,175.0,Forward - Right Winger,right,Dynamo Moscow,23.0,4.0,1.0,1141.0,39.0,9.0,7.0,1732.0,21.0,3.0,2.0,530.0,19.0,1.0,1.0,775.0,12.0,2.0,0.0,817.0,Ligue 1
19-06-17,18.3.4.28,Nabil Fekir,29114975,769,18-Jul-93,23,7,1,1,0,6250,7550,7550,165,151,130161706,173,72,AM/S RLC,1,1,2,1,2,1,1,2,2,1,1,15,14,16,15,16,14,5,13,4,4,16,14,4,17,9,13,9,15,13,17,15,16,16,15,12,7,12,13,15,16,15,5,20,15,15,6,14,15,15,11,15,7,14,20,15,12,12,14,9,11,9,1,1,12,20,16,16,20,AM/S RLC,516,1,1,19,20,16,16,1,1,1,1,12,1,1,1,1,2251830000000000.0,0,0,1,0,0,0,0,0,0,0,0,0,0,0,0,0,0,0,0,0,0,0,0,0,0,0,0,0,0,0,0,0,0,0,0,1,0,0,0,0,0,0,0,0,0,0,0,0,Nabil Fekir,Â£54.00m ,27.0,173.0,Midfielder - Attacking Midfield,left,Real Betis BalompiÃ©,49.0,14.0,12.0,3387.0,40.0,23.0,8.0,3235.0,39.0,12.0,9.0,2815.0,33.0,7.0,7.0,2769.0,7.0,1.0,1.0,563.0,Ligue 1,15-07-16,17.3.2.23,Nabil Fekir,29114975,769,18-Jul-93,22,5,1,1,0,5750,7050,7050,160,141,50605568,173,72,AM/S RLC,1,1,3,4,4,3,1,1,3,1,1,14,13,16,14,16,14,5,11,5,5,15,11,5,16,8,13,9,14,13,15,13,15,16,5,13,5,9,10,15,16,14,5,20,14,15,5,12,14,13,11,13,8,14,10,15,12,10,13,10,10,13,Nabil Fekir,Â£12.60m ,Ligue 1
19-06-17,18.3.4.28,Jonathan Bamba,29114989,769,26-Mar-96,21,0,0,2,1,3900,6300,6450,136,125,15368105,175,72,AM RL,3,3,3,1,3,2,1,1,3,3,1,11,11,14,10,12,8,5,12,7,4,11,10,4,13,12,12,11,12,11,10,10,10,11,7,14,7,9,12,16,14,14,6,8,14,15,20,14,11,12,5,11,7,11,9,11,9,10,12,10,15,1,1,1,14,20,20,15,10,AM RL,505,1,1,15,10,15,20,1,1,1,1,1,10,14,1,1,0.0,0,0,0,0,0,0,0,0,0,0,0,0,0,0,0,0,0,0,0,0,0,0,0,0,0,0,0,0,0,0,0,0,0,0,0,0,0,0,0,0,0,0,0,0,0,0,0,0,Jonathan Bamba,Â£7.20m ,24.0,175.0,Forward - Left Winger,right,LOSC Lille,30.0,6.0,2.0,1772.0,37.0,8.0,10.0,2798.0,41.0,14.0,4.0,3280.0,37.0,1.0,9.0,2671.0,9.0,3.0,4.0,798.0,Ligue 1
19-06-17,18.3.4.28,Timo Stavitski,33061457,768,17-Jul-99,17,0,0,0,0,2750,4250,4750,120,88,871704,181,0,M/AM RL,2,2,2,1,3,2,1,2,3,1,2,10,11,8,6,10,10,8,9,1,2,10,10,5,9,11,8,8,8,7,10,9,14,12,6,10,6,10,10,14,9,8,8,11,12,13,20,8,7,12,5,9,9,10,12,14,12,11,12,10,13,8,1,1,18,20,19,20,12,M/AM RL,525,1,1,12,12,20,19,1,1,1,1,12,18,16,1,1,0.0,0,0,0,0,0,0,0,0,0,0,0,0,0,0,0,0,0,0,0,0,0,0,0,0,0,0,0,0,0,0,0,0,0,0,0,0,0,0,0,0,0,0,0,0,0,0,0,0,Timo Stavitski,Â£450Th. ,21.0,180.0,Forward - Right Winger,right,MVV Maastricht,35.0,2.0,5.0,2435.0,11.0,1.0,0.0,548.0,2.0,0.0,0.0,93.0,nan,nan,nan,nan,7.0,0.0,0.0,280.0,Ligue 1
19-06-17,18.3.4.28,Julian Palmieri,34000583,769,07-Dec-86,30,0,0,0,0,3900,6300,6300,129,125,232186002,170,66,D/WB/M RLC,3,2,1,1,2,3,3,1,2,1,3,11,14,10,7,13,10,7,12,9,13,12,8,13,11,15,11,16,12,13,10,13,14,12,10,13,10,14,16,11,13,12,7,20,14,12,9,14,10,13,14,14,6,16,9,13,14,14,16,11,9,9,20,17,17,15,15,20,16,D/WB/M RLC,126,1,1,1,1,15,15,1,20,10,13,16,17,15,17,10,2251940000000000.0,0,0,0,0,0,0,0,0,0,0,0,0,0,0,0,0,0,1,0,0,0,0,0,0,0,0,0,0,0,0,0,0,0,0,0,0,0,1,0,0,0,0,0,0,0,0,0,0,Julian Palmieri,Â£1.35m ,33.0,170.0,Defender - Left-Back,left,Without Club,28.0,1.0,2.0,2024.0,15.0,0.0,0.0,1132.0,15.0,0.0,2.0,881.0,nan,nan,nan,nan,nan,nan,nan,nan,Ligue 1,15-07-16,17.3.2.23,Julian Palmieri,34000583,769,07-Dec-86,29,0,0,0,0,4500,6450,6450,132,129,4839229,170,66,D/WB/M RLC,4,3,3,4,4,1,1,1,3,2,3,11,13,12,7,12,10,7,12,9,13,12,8,12,13,14,11,15,12,14,10,12,14,12,10,13,8,13,15,14,13,10,7,20,15,13,10,15,7,14,14,14,6,16,9,13,14,14,16,11,9,9,Julian Palmieri,Â£1.80m ,Ligue 1
19-06-17,18.3.4.28,GaÃ«l Kakuta,34001371,53,21-Jun-91,25,2,1,0,0,4250,6550,6550,142,131,27855451,173,72,M/AM RLC,1,1,4,1,2,3,1,1,3,3,3,14,14,15,12,15,14,7,14,5,4,13,13,4,15,8,13,11,13,11,12,11,14,17,5,14,5,11,11,14,16,13,7,20,13,13,10,12,10,12,6,14,8,11,15,18,13,11,14,16,16,7,1,1,18,20,16,20,20,M/AM RLC,526,1,1,11,20,20,16,1,1,1,1,13,18,13,1,1,2251850000000000.0,0,0,0,0,0,0,0,0,1,0,0,0,0,0,0,0,0,0,0,0,0,0,0,0,0,0,0,0,0,0,0,0,0,0,1,1,0,0,0,0,0,0,0,0,0,0,0,0,GaÃ«l Kakuta,Â£5.40m ,29.0,173.0,Midfielder - Attacking Midfield,left,RC Lens,10.0,2.0,1.0,542.0,38.0,6.0,6.0,3198.0,12.0,1.0,0.0,720.0,24.0,2.0,5.0,2010.0,7.0,4.0,1.0,519.0,Ligue 1,15-07-16,17.3.2.23,GaÃ«l Kakuta,34001371,53,21-Jun-91,25,0,0,18,6,5000,6750,7000,152,142,59174458,173,72,M/AM RLC,2,2,1,1,1,1,3,3,2,3,2,13,14,17,12,17,14,7,13,5,4,13,13,4,16,8,13,11,13,11,14,11,14,17,5,14,5,12,12,16,17,13,7,20,14,14,10,12,10,13,6,14,8,11,15,18,13,11,12,16,16,7,GaÃ«l Kakuta,Â£900Th. ,LaLiga
19-06-17,18.3.4.28,Gilles Sunu,34003025,50,30-Mar-91,26,0,0,0,0,3900,6250,6250,127,125,5579180,181,75,AM/S RL,2,4,3,1,3,4,3,1,3,1,4,5,13,14,7,12,10,9,11,5,5,12,10,3,13,5,10,10,10,13,10,9,13,14,10,11,8,13,10,15,13,14,9,10,12,16,20,13,13,11,5,15,10,8,13,14,16,13,12,14,14,7,1,1,10,18,18,15,14,AM/S RL,625,1,1,20,14,15,18,1,1,1,1,1,10,10,1,1,2251800000000000.0,0,0,0,0,0,0,0,0,0,0,0,0,0,0,0,0,0,0,0,0,0,0,0,0,0,0,0,0,0,0,0,0,0,0,0,0,0,0,0,0,0,0,0,0,0,0,0,0,Gilles Sunu,Â£1.35m ,29.0,181.0,Forward - Centre-Forward,right,LB ChÃÂ¢teauroux,27.0,0.0,0.0,964.0,23.0,1.0,1.0,842.0,28.0,4.0,2.0,1951.0,14.0,3.0,1.0,712.0,8.0,1.0,1.0,592.0,Ligue 1,15-07-16,17.3.2.23,Gilles Sunu,34003025,50,30-Mar-91,25,0,0,0,0,3921,6199,6199,134,124,5735106,181,75,AM/S R,3,1,1,4,2,2,1,1,1,3,2,5,14,14,12,12,10,9,11,5,5,12,10,3,13,5,10,10,10,10,12,9,14,14,10,11,8,13,10,15,15,13,9,10,12,16,20,10,13,11,5,15,10,8,11,15,16,13,14,14,14,7,Gilles Sunu,Â£1.35m ,Ligue 1
19-06-17,18.3.4.28,Emmanuel Bourgaud,34005678,769,25-Oct-87,29,0,0,0,0,3250,5550,5550,119,111,1105715,179,70,M/AM RLC,1,1,1,4,1,2,3,2,2,3,3,11,11,13,12,12,11,7,12,6,6,12,11,7,12,8,12,13,11,11,11,11,17,11,7,11,9,12,13,14,12,10,9,8,13,12,20,12,9,12,8,14,9,10,11,12,13,14,14,16,16,5,1,1,18,20,15,20,17,M/AM RLC,526,1,1,1,17,20,15,1,1,1,13,17,18,15,1,1,17592200000000.0,0,0,0,0,0,0,0,0,0,0,0,0,0,0,0,0,0,0,0,0,0,0,1,0,0,0,0,0,0,0,0,0,0,0,0,0,0,0,0,0,0,0,0,0,1,0,0,0,Emmanuel Bourgaud,Â£540Th. ,33.0,178.0,Midfielder - Right Midfield,right,Les Herbiers VF,31.0,3.0,3.0,1917.0,20.0,1.0,2.0,794.0,24.0,0.0,1.0,1667.0,13.0,1.0,2.0,569.0,5.0,2.0,0.0,363.0,Ligue 1
19-06-17,18.3.4.28,RÃ©my Cabella,34008670,769,08-Mar-90,27,4,0,17,4,4250,6450,6550,145,131,11318889,171,62,M/AM LC,2,2,3,3,3,2,1,3,1,3,2,12,14,14,10,15,12,6,12,5,3,15,14,4,15,10,13,11,14,12,14,13,14,15,7,14,7,15,12,14,15,10,6,10,14,14,20,13,8,12,10,13,6,12,9,15,15,12,14,12,15,5,1,1,16,20,14,18,20,M/AM LC,524,1,1,12,20,18,14,1,1,1,1,14,16,10,1,1,2251830000000000.0,0,0,0,0,0,0,0,0,0,0,0,0,0,0,0,0,0,0,0,0,1,0,0,0,0,0,0,0,0,0,0,0,0,0,0,1,0,0,0,0,0,0,0,0,0,0,0,0,RÃ©my Cabella,Â£8.10m ,30.0,171.0,Midfielder - Attacking Midfield,right,FK Krasnodar,32.0,6.0,5.0,1853.0,31.0,8.0,7.0,2415.0,37.0,10.0,5.0,3239.0,12.0,2.0,1.0,556.0,10.0,6.0,2.0,714.0,Ligue 1,15-07-16,17.3.2.23,RÃ©my Cabella,34008670,769,08-Mar-90,26,4,0,17,4,5697,6247,6697,142,134,13493185,171,62,M/AM LC,1,3,3,3,1,2,2,2,3,2,2,12,12,14,12,15,12,6,12,5,3,14,14,4,15,10,13,11,13,12,12,11,14,15,7,15,7,11,10,16,15,10,6,12,14,15,20,13,7,12,10,13,6,12,13,13,15,13,14,12,15,5,RÃ©my Cabella,Â£6.75m ,Ligue 1
19-06-17,18.3.4.28,HervÃ© Bazile,34008821,375,18-Mar-90,27,1,0,0,0,3700,6000,6000,125,119,2613382,180,73,AM RL,1,1,2,2,3,2,2,1,3,3,1,6,12,13,11,13,12,7,11,6,4,11,12,5,13,7,12,9,12,12,8,10,14,13,5,13,7,9,14,16,14,12,10,20,13,15,6,13,13,10,7,13,11,8,13,13,13,12,11,14,14,9,1,1,15,20,17,20,1,AM RL,505,1,1,13,1,20,17,1,1,1,1,1,15,15,1,1,2251800000000000.0,0,0,0,0,1,0,0,0,0,0,0,0,0,0,0,0,0,0,0,0,0,0,0,0,0,0,0,0,0,0,0,0,0,0,0,0,0,0,0,0,0,0,0,0,0,0,0,0,HervÃ© Bazile,Â£720Th. ,30.0,181.0,Forward - Left Winger,left,AC Le Havre,21.0,2.0,3.0,904.0,22.0,0.0,1.0,1098.0,25.0,5.0,2.0,1426.0,7.0,0.0,0.0,145.0,4.0,1.0,0.0,187.0,Ligue 1,15-07-16,17.3.2.23,HervÃ© Bazile,34008821,375,18-Mar-90,26,1,0,0,0,3700,5850,6050,125,121,3685707,180,73,AM RL,2,1,2,2,2,1,1,2,1,3,1,6,12,13,12,13,12,7,11,6,4,11,12,5,14,7,12,9,12,12,8,10,16,13,5,13,7,9,14,16,14,13,10,20,13,15,6,13,13,10,7,13,7,8,20,14,15,13,12,14,14,9,HervÃ© Bazile,Â£1.35m ,Ligue 1
19-06-17,18.3.4.28,Jonathan Tinhan,34011449,769,01-Jun-89,28,0,0,0,0,3250,5500,5500,116,110,525487,178,69,M/AM RL,2,1,3,2,2,3,2,3,3,1,3,6,11,13,10,12,6,10,8,5,1,10,12,2,12,7,12,10,12,11,9,9,14,13,5,12,5,11,13,16,14,10,9,6,12,15,20,13,9,10,6,14,11,10,13,13,13,11,14,15,15,5,1,1,17,20,20,15,1,M/AM RL,525,1,1,10,1,15,20,1,1,1,1,1,13,17,1,1,2251800000000000.0,0,0,0,0,1,0,0,0,0,0,0,0,0,0,0,0,0,0,0,0,0,0,0,0,0,0,0,0,0,0,0,0,0,0,0,0,0,0,0,0,0,0,0,0,0,0,0,0,Jonathan Tinhan,Â£810Th. ,31.0,177.0,Forward - Centre-Forward,right,Retired,34.0,8.0,2.0,1659.0,9.0,0.0,0.0,276.0,22.0,2.0,1.0,707.0,24.0,1.0,3.0,1372.0,nan,nan,nan,nan,Ligue 1
19-06-17,18.3.4.28,Wahbi Khazri,34011589,51,08-Feb-91,26,32,11,1,0,4950,6800,6600,143,132,29456523,182,76,AM RLC,3,1,1,3,1,4,1,1,2,3,1,16,13,15,11,13,14,8,12,5,5,13,13,5,15,11,12,12,13,12,15,11,13,14,6,15,9,11,14,14,13,14,10,11,11,14,20,12,13,12,11,15,5,12,6,15,16,11,13,16,16,7,1,1,14,20,15,18,20,AM RLC,506,1,1,1,20,18,15,1,1,1,1,13,14,12,1,1,2289180000000000.0,0,0,0,0,0,0,0,0,0,0,0,1,0,0,0,0,0,1,0,0,0,0,0,0,0,0,0,0,0,0,0,0,0,0,0,0,0,0,0,0,0,1,0,0,0,1,0,0,Wahbi Khazri,Â£9.00m ,29.0,182.0,Forward - Centre-Forward,right,AS Saint-Ãtienne,23.0,1.0,1.0,1000.0,34.0,11.0,4.0,2549.0,35.0,14.0,8.0,3011.0,23.0,6.0,4.0,1659.0,2.0,0.0,0.0,62.0,Ligue 1,15-07-16,17.3.2.23,Wahbi Khazri,34011589,51,08-Feb-91,25,19,6,0,0,5450,6800,6500,143,133,22259565,182,78,AM RLC,3,1,2,3,1,2,2,2,3,3,3,16,13,12,11,12,13,8,12,5,5,13,13,5,15,11,12,12,13,12,15,12,15,14,6,15,9,11,14,15,14,14,10,11,11,14,20,12,13,10,11,15,5,12,12,15,16,11,13,16,16,7,Wahbi Khazri,Â£6.30m ,Premier League
19-06-17,18.3.4.28,FranÃ§ois Kamano,36515298,22,01-May-96,21,15,4,0,0,3950,6350,6350,139,127,15877162,182,75,AM RL,3,1,3,1,2,2,4,2,3,2,2,9,10,15,12,13,11,12,12,5,4,12,5,5,14,7,12,6,11,9,10,10,11,17,4,14,8,9,11,17,15,14,11,12,14,15,20,9,11,11,7,11,13,11,12,14,13,11,12,13,13,6,1,1,1,20,20,18,1,AM RL,505,1,1,14,1,18,20,1,1,1,1,1,1,1,1,1,1.44115e+17,0,0,0,0,0,0,0,0,0,0,0,1,0,0,0,0,0,0,0,0,0,0,0,0,0,0,0,0,0,0,0,0,0,0,0,1,0,0,0,0,0,0,0,0,0,0,0,0,FranÃ§ois Kamano,Â£6.30m ,24.0,182.0,Forward - Left Winger,right,Lokomotiv Moscow,37.0,8.0,4.0,2164.0,39.0,8.0,6.0,2334.0,51.0,13.0,4.0,3388.0,12.0,1.0,0.0,659.0,9.0,0.0,0.0,399.0,Ligue 1,15-07-16,17.3.2.23,FranÃ§ois Kamano,36515298,22,01-May-96,20,7,1,0,0,3000,6000,5800,129,116,3607795,182,75,AM/S RL,1,2,4,2,1,3,2,1,3,1,2,11,11,13,12,13,11,12,12,5,4,12,8,5,13,3,12,11,11,8,10,10,11,10,13,13,8,12,12,15,14,13,11,6,14,13,20,12,13,12,10,11,9,11,9,12,12,12,12,11,10,4,FranÃ§ois Kamano,Â£4.05m ,Ligue 1
19-06-17,18.3.4.28,Memphis Depay,37024470,784,13-Feb-94,23,31,5,7,0,6300,7100,7100,153,142,56245961,177,78,AM/S L,3,3,1,2,2,1,1,2,3,1,1,14,13,15,12,16,15,11,14,4,4,15,12,4,16,8,11,12,13,10,12,10,14,17,6,14,5,9,10,15,14,14,9,10,17,16,20,14,14,12,7,14,4,12,13,16,10,14,10,13,11,12,1,1,15,20,14,20,12,AM/S L,513,1,1,17,12,20,14,1,1,1,1,1,15,1,1,1,652835000000.0,0,0,0,0,0,0,0,0,0,0,0,0,0,0,0,0,0,0,0,0,0,0,0,0,0,0,0,0,0,0,0,0,0,0,0,1,1,0,0,1,0,0,0,0,0,0,0,0,Memphis Depay,Â£40.50m ,26.0,176.0,Forward - Left Winger,right,Olympique Lyon,26.0,5.0,8.0,1382.0,51.0,22.0,17.0,3655.0,47.0,12.0,16.0,3537.0,22.0,15.0,2.0,1695.0,8.0,5.0,3.0,514.0,Ligue 1,15-07-16,17.3.2.23,Memphis Depay,37024470,784,13-Feb-94,22,24,3,7,0,6050,7250,6700,162,143,23471642,177,78,AM/S L,1,4,1,1,3,2,3,1,2,2,2,10,13,16,14,16,16,8,16,4,4,15,12,4,16,7,11,12,13,10,11,8,13,17,5,14,5,10,12,15,14,13,9,10,17,16,20,15,14,12,7,15,4,12,14,16,14,14,11,13,10,12,Memphis Depay,Â£17.10m ,Premier League
19-06-17,18.3.4.28,Anwar El Ghazi,37041913,784,03-May-95,22,2,0,0,0,5800,6450,6450,141,129,16536330,189,87,M/AM/S RL,2,3,1,3,3,3,2,2,1,1,2,10,13,16,12,14,14,13,12,8,5,11,12,7,14,11,14,12,10,10,11,11,12,15,6,14,3,9,7,12,12,14,15,12,13,14,20,14,11,9,4,12,9,10,9,15,8,12,12,9,8,6,1,1,17,20,20,16,13,M/AM/S RL,535,1,1,17,13,16,20,1,1,1,1,10,13,17,1,1,34359742466.0,0,1,0,0,0,0,0,0,0,0,0,0,1,0,0,0,0,0,0,0,0,0,0,0,0,0,0,0,0,0,0,0,0,0,0,1,0,0,0,0,0,0,0,0,0,0,0,0,Anwar El Ghazi,Â£4.50m ,25.0,189.0,Forward - Right Winger,right,Aston Villa,37.0,8.0,5.0,2172.0,31.0,4.0,4.0,1955.0,36.0,6.0,6.0,2628.0,40.0,6.0,7.0,2549.0,3.0,1.0,0.0,260.0,Ligue 1,15-07-16,17.3.2.23,Anwar El Ghazi,37041913,784,03-May-95,21,2,0,0,0,5800,6400,6400,142,130,16952435,189,87,M/AM/S RL,1,2,2,1,3,1,1,2,3,3,2,10,13,16,12,14,14,13,12,8,5,11,12,7,14,11,14,12,10,10,11,11,12,15,6,14,3,9,7,12,12,14,15,12,13,14,20,14,11,9,4,12,9,10,11,15,8,12,12,9,8,6,Anwar El Ghazi,Â£5.40m ,Ligue 1
19-06-17,18.3.4.28,Keita BaldÃ©,43093942,41,08-Mar-95,22,13,3,0,0,6500,7500,7350,166,147,104913535,184,80,AM/S RL,3,1,2,2,2,2,2,2,3,2,1,7,13,15,14,15,9,10,13,5,3,13,14,4,15,12,13,12,13,10,12,12,14,16,10,15,5,11,11,16,14,13,11,12,16,16,20,13,14,12,10,13,8,14,16,17,13,15,13,12,12,8,1,1,12,20,15,20,10,AM/S RL,515,1,1,18,10,20,15,1,1,1,1,1,12,12,1,1,2322720000000000.0,0,0,0,0,1,0,0,0,0,0,0,0,0,0,0,0,0,0,0,0,0,0,0,0,0,0,0,1,0,0,0,0,0,0,0,0,0,0,0,1,0,0,0,0,0,0,1,0,Keita BaldÃ©,Â£27.00m ,25.0,184.0,Forward - Left Winger,both,UC Sampdoria,34.0,16.0,5.0,2075.0,33.0,8.0,11.0,2006.0,30.0,5.0,2.0,1089.0,26.0,8.0,4.0,1266.0,2.0,0.0,1.0,35.0,Serie A,15-07-16,17.3.2.23,Keita BaldÃ©,43093942,41,08-Mar-95,21,3,0,0,0,5350,7300,7350,169,147,62319910,181,77,AM/S RL,2,2,2,3,2,1,3,3,1,2,1,6,13,16,12,15,7,6,10,5,5,13,10,6,16,13,13,13,9,10,11,13,15,17,10,14,5,12,11,16,15,13,10,15,16,15,20,13,14,14,10,13,8,16,17,17,11,14,10,9,11,9,Keita BaldÃ©,Â£22.50m ,Serie A
19-06-17,18.3.4.28,Ismail Haddou,43159573,5,15-Feb-96,21,0,0,0,0,1500,4500,4500,101,90,284352,178,67,AM RL,2,4,2,2,2,2,2,2,2,3,2,8,10,11,9,10,9,7,7,7,5,10,9,6,12,10,10,8,8,10,8,9,6,8,8,9,9,10,10,14,12,11,11,10,11,13,20,12,10,9,5,8,16,10,13,11,9,12,10,1,16,6,1,1,15,20,20,16,14,AM RL,505,1,1,1,14,16,20,1,1,1,1,1,12,15,1,1,0.0,0,0,0,0,0,0,0,0,0,0,0,0,0,0,0,0,0,0,0,0,0,0,0,0,0,0,0,0,0,0,0,0,0,0,0,0,0,0,0,0,0,0,0,0,0,0,0,0,nan,nan,nan,nan,nan,nan,nan,nan,nan,nan,nan,nan,nan,nan,nan,nan,nan,nan,nan,nan,nan,nan,nan,nan,nan,nan,nan,nan,
19-06-17,18.3.4.28,Faitout Maouassa,48031025,769,06-Jul-98,18,0,0,0,0,3800,5950,5950,148,119,6131858,170,74,D/M/AM L,3,3,1,1,1,2,1,3,2,1,2,13,12,13,10,11,12,5,11,7,8,10,7,10,12,12,10,11,11,9,12,10,10,14,8,13,9,11,10,15,13,12,6,20,14,14,8,11,12,12,12,11,5,14,12,16,11,13,12,7,14,5,20,15,16,19,10,20,14,D/M/AM L,123,1,1,1,10,19,10,1,20,10,10,14,16,1,15,1,0.0,0,0,0,0,0,0,0,0,0,0,0,0,0,0,0,0,0,0,0,0,0,0,0,0,0,0,0,0,0,0,0,0,0,0,0,0,0,0,0,0,0,0,0,0,0,0,0,0,Faitout Maouassa,Â£4.05m ,22.0,170.0,Defender - Left-Back,left,Stade Rennais FC,19.0,3.0,3.0,1302.0,24.0,1.0,3.0,1208.0,30.0,0.0,1.0,2439.0,32.0,3.0,2.0,2607.0,4.0,0.0,1.0,311.0,Ligue 1
19-06-17,18.3.4.28,Imad Faraj,48036724,769,11-Feb-99,18,0,0,0,0,2000,5100,5100,132,102,1464004,172,0,AM RLC,1,2,4,1,3,2,2,3,3,1,3,10,9,13,8,12,10,9,8,4,10,11,6,12,14,7,9,9,12,9,11,10,5,13,12,11,5,11,9,13,14,10,7,10,13,12,20,10,9,8,10,10,10,13,19,13,14,10,11,11,18,7,1,1,12,20,19,17,20,AM RLC,506,1,1,1,20,17,19,1,1,1,1,12,1,1,1,1,0.0,0,0,0,0,0,0,0,0,0,0,0,0,0,0,0,0,0,0,0,0,0,0,0,0,0,0,0,0,0,0,0,0,0,0,0,0,0,0,0,0,0,0,0,0,0,0,0,0,Imad Faraj,Â£450Th. ,21.0,177.0,Forward - Right Winger,right,Royal Excel Mouscron,nan,nan,nan,nan,8.0,0.0,1.0,159.0,nan,nan,nan,nan,5.0,0.0,0.0,105.0,8.0,0.0,1.0,508.0,Ligue 1
19-06-17,18.3.4.28,Samuel Grandsir,48037146,769,14-Aug-96,20,0,0,0,0,3700,6250,6250,136,125,7466988,168,64,AM RLC,3,2,2,3,1,2,3,2,2,1,3,10,13,16,13,12,8,5,10,6,7,12,12,4,15,13,13,14,12,12,11,12,12,13,6,13,9,11,12,14,13,11,8,10,12,14,20,13,11,12,12,12,8,12,10,11,9,11,8,7,8,10,1,1,1,20,20,17,16,AM RLC,506,1,1,10,16,17,20,1,1,1,1,1,1,1,1,1,0.0,0,0,0,0,0,0,0,0,0,0,0,0,0,0,0,0,0,0,0,0,0,0,0,0,0,0,0,0,0,0,0,0,0,0,0,0,0,0,0,0,0,0,0,0,0,0,0,0,Samuel Grandsir,Â£4.50m ,24.0,170.0,Forward - Right Winger,right,AS Monaco,36.0,3.0,3.0,1974.0,40.0,3.0,6.0,2998.0,27.0,1.0,1.0,1121.0,27.0,5.0,1.0,1705.0,nan,nan,nan,nan,Ligue 1
19-06-17,18.3.4.28,Myziane Maolida,48039186,769,14-Feb-99,18,0,0,0,0,1750,5350,5350,167,107,2698264,181,70,AM/S RL,3,2,3,3,2,3,2,3,1,1,2,5,8,13,13,12,8,8,11,3,4,11,9,4,12,4,11,10,9,8,12,10,13,13,4,12,7,8,8,15,13,12,9,8,13,15,20,10,8,10,9,4,7,11,20,11,11,11,12,9,10,3,1,1,1,20,18,20,1,AM/S RL,515,1,1,20,1,20,18,1,1,1,1,1,1,1,1,1,1.46367e+17,0,0,0,0,0,0,0,0,0,0,0,0,0,0,0,0,0,0,0,0,0,0,0,0,0,0,0,0,0,0,0,0,0,0,0,0,0,0,0,0,0,0,0,0,0,0,0,0,Myziane Maolida,Â£4.05m ,21.0,182.0,Forward - Centre-Forward,right,OGC Nice,6.0,2.0,1.0,521.0,22.0,3.0,0.0,658.0,15.0,1.0,4.0,1047.0,22.0,1.0,2.0,810.0,5.0,1.0,0.0,179.0,Ligue 1
19-06-17,18.3.4.28,IsmaÄla Sarr,48042766,41,25-Feb-98,19,8,1,0,0,3950,6250,6250,136,125,16154541,180,78,AM RL,1,1,1,2,4,3,3,2,2,3,2,11,8,14,12,12,11,8,12,6,6,10,14,6,12,11,11,14,12,10,10,11,4,13,9,14,4,10,13,15,13,14,10,8,15,15,20,14,13,12,5,11,6,11,12,13,10,12,12,11,12,4,1,1,13,20,17,20,10,AM RL,505,1,1,15,10,20,17,1,1,1,1,1,13,10,1,1,70368700000000.0,0,1,0,0,0,0,0,0,0,0,0,0,0,0,0,0,0,0,0,0,0,0,0,0,0,0,0,0,0,0,0,0,0,0,0,0,0,0,0,0,0,0,0,0,0,0,1,0,IsmaÃ¯la Sarr,Â£12.60m ,22.0,185.0,Forward - Right Winger,right,Watford FC,33.0,5.0,5.0,2113.0,27.0,5.0,5.0,1976.0,50.0,13.0,11.0,4152.0,30.0,6.0,6.0,2130.0,4.0,0.0,1.0,351.0,Ligue 1,15-07-16,17.3.2.23,IsmaÄla Sarr,48042766,41,25-Feb-98,18,0,0,4,0,1753,4509,5100,129,102,1513437,188,81,AM RL,3,2,3,3,2,3,1,2,3,1,2,6,8,13,10,10,10,8,12,6,6,10,14,6,9,10,7,14,9,9,11,11,8,8,10,8,4,11,13,12,13,14,13,8,14,14,20,12,13,10,10,4,6,10,9,9,13,11,9,10,19,8,IsmaÃ¯la Sarr,Â£2.25m ,Ligue 1
19-06-17,18.3.4.28,Bassem Srarfi,49038543,51,25-Jun-97,19,0,0,0,0,3700,5750,5750,134,115,4019125,176,71,AM RL,2,2,1,2,1,1,3,2,1,3,4,11,12,15,10,14,11,6,9,5,5,11,12,5,15,6,11,7,12,11,12,9,9,14,6,13,7,11,11,15,14,12,6,20,13,13,8,12,9,10,10,11,7,11,10,14,12,11,12,6,14,5,1,1,14,20,20,15,13,AM RL,505,1,1,1,13,15,20,1,1,1,1,1,10,14,1,1,2.8823e+17,0,0,0,0,0,0,0,0,0,0,0,0,0,0,0,0,0,0,0,0,0,0,0,0,0,0,0,1,0,0,0,0,0,0,0,0,0,0,0,0,0,0,0,0,0,0,0,0,Bassem Srarfi,Â£2.70m ,23.0,176.0,Forward - Right Winger,left,SV Zulte Waregem,16.0,4.0,2.0,647.0,35.0,3.0,1.0,1329.0,25.0,1.0,2.0,968.0,8.0,0.0,0.0,271.0,8.0,0.0,1.0,366.0,Ligue 1,15-07-16,17.3.2.23,Bassem Srarfi,49038543,51,25-Jun-97,19,0,0,0,0,2500,5000,5200,138,104,1553668,166,63,AM RL,1,2,3,2,1,3,2,1,1,3,3,10,9,14,10,13,10,6,9,5,5,10,12,5,15,10,12,8,11,10,12,10,11,14,7,13,6,11,10,14,13,12,6,20,13,13,8,10,9,10,10,9,8,11,10,12,11,11,12,1,13,6,Bassem Srarfi,Â£1.13m ,Ligue 1
19-06-17,18.3.4.28,Prejuce Nakoulma,54005468,9,21-Apr-87,30,30,6,0,0,4750,6250,6250,126,126,232186002,178,76,M/AM/S RL,2,1,3,1,1,2,2,2,1,3,2,6,11,14,10,12,5,8,8,5,4,13,7,3,12,7,10,12,11,10,8,9,13,15,4,13,7,12,12,16,15,14,8,10,13,16,20,10,13,11,11,10,10,5,9,16,9,10,11,11,14,3,1,1,18,20,18,20,9,M/AM/S RL,535,1,1,18,9,20,18,1,1,1,1,1,18,18,1,1,549890000000.0,0,1,0,0,0,0,0,0,0,0,0,0,0,1,0,0,0,0,0,0,0,0,0,0,0,0,0,1,0,0,0,0,0,0,0,0,0,0,0,1,0,0,0,0,0,0,0,0,PrÃ©juce Nakoulma,Â£2.25m ,33.0,178.0,Forward - Centre-Forward,right,Without Club,24.0,8.0,1.0,1988.0,18.0,3.0,0.0,1149.0,12.0,2.0,0.0,213.0,6.0,1.0,0.0,300.0,nan,nan,nan,nan,Ligue 1,15-07-16,17.3.2.23,Prejuce Nakoulma,54005468,9,21-Apr-87,29,30,6,0,0,5300,5500,5950,123,120,2195547,178,76,M/AM RL,3,3,3,2,3,1,2,2,4,2,2,6,11,16,10,12,5,8,8,5,4,13,7,3,12,7,8,12,11,10,8,9,13,15,4,13,7,12,10,16,15,14,8,11,13,16,20,10,13,10,11,10,10,5,9,16,9,10,11,11,14,3,PrÃ©juce Nakoulma,Â£2.25m ,Ligue 1
19-06-17,18.3.4.28,Rony Lopes,55038681,788,28-Dec-95,21,0,0,12,1,5750,6350,6750,153,135,23283243,174,68,M/AM RLC,2,3,3,3,2,1,3,2,3,1,1,13,13,15,12,15,13,6,12,3,5,14,11,6,15,10,12,11,12,11,14,11,14,14,8,13,7,11,13,15,15,13,7,20,13,14,9,13,10,12,8,13,8,14,15,15,12,14,14,15,15,6,1,1,18,20,20,19,18,M/AM RLC,526,1,1,1,18,19,20,1,1,1,1,12,17,18,1,1,2308.0,0,0,1,0,0,0,0,0,1,0,0,1,0,0,0,0,0,0,0,0,0,0,0,0,0,0,0,0,0,0,0,0,0,0,0,0,0,0,0,0,0,0,0,0,0,0,0,0,Rony Lopes,Â£25.20m ,24.0,174.0,Forward - Right Winger,left,OGC Nice,29.0,6.0,5.0,2218.0,50.0,17.0,12.0,3288.0,29.0,4.0,2.0,2229.0,15.0,0.0,1.0,683.0,8.0,0.0,0.0,538.0,Ligue 1,15-07-16,17.3.2.23,Rony Lopes,55038681,788,28-Dec-95,20,0,0,10,1,4250,6000,6200,146,124,10693309,174,68,M/AM RLC,1,3,3,1,2,1,3,2,3,1,3,11,12,15,11,14,12,6,12,2,4,14,11,4,15,9,11,10,12,11,14,12,14,14,7,13,7,11,13,14,15,13,7,20,12,14,10,13,9,12,7,12,10,12,15,16,12,14,13,15,15,5,Rony Lopes,Â£7.20m ,Ligue 1
19-06-17,18.3.4.28,Joris Kayembe,55070229,757,08-Aug-94,22,0,0,8,3,3250,5700,6050,132,121,5701254,180,71,D/M/AM L,1,2,3,3,2,3,2,1,2,3,3,12,13,14,9,12,8,5,9,8,8,11,11,9,13,8,7,7,10,8,11,10,13,16,7,12,8,8,12,16,15,12,9,20,14,15,7,12,10,10,10,10,8,13,13,14,11,12,14,12,11,8,18,12,17,20,14,20,1,D/M/AM L,533,1,1,1,1,20,14,1,18,1,1,1,17,1,12,1,2.8823e+17,1,0,0,0,0,0,0,0,0,0,0,0,0,0,0,0,0,0,0,0,0,0,0,0,0,0,0,0,0,0,0,0,0,0,0,0,0,0,0,0,0,0,0,0,0,0,0,0,Joris Kayembe,Â£900Th. ,26.0,182.0,Defender - Left-Back,left,RSC Charleroi,28.0,6.0,3.0,2295.0,3.0,0.0,0.0,87.0,nan,nan,nan,nan,9.0,0.0,2.0,413.0,11.0,0.0,0.0,1011.0,Ligue 1
19-06-17,18.3.4.28,Danijel Milicevic,5728821,759,05-Jan-86,31,1,0,2,0,4700,6400,6000,125,123,232186002,177,61,AM RLC,4,3,2,3,1,3,1,2,2,3,1,10,14,11,11,12,14,9,12,11,10,14,9,11,13,11,12,15,12,13,14,14,14,10,18,13,7,13,13,12,13,14,7,12,10,11,20,11,8,13,10,12,10,11,15,14,12,8,14,10,10,10,1,1,14,20,18,15,20,AM RLC,506,1,1,14,20,15,18,1,1,1,1,14,14,14,1,1,0.0,0,0,0,0,0,0,0,0,0,0,0,0,0,0,0,0,0,0,0,0,0,0,0,0,0,0,0,0,0,0,0,0,0,0,0,0,0,0,0,0,0,0,0,0,0,0,0,0,Danijel Milicevic,Â£1.17m ,34.0,171.0,Midfielder - Attacking Midfield,right,RFC Seraing,48.0,9.0,13.0,3483.0,35.0,6.0,7.0,2090.0,21.0,0.0,2.0,1135.0,24.0,5.0,7.0,1997.0,nan,nan,nan,nan,Ligue 1
19-06-17,18.3.4.28,Jimmy Durmaz,611474,797,22-Mar-89,28,41,3,8,0,4500,6450,6450,135,128,10753663,180,69,M/AM LC,1,1,1,1,1,3,2,2,1,1,2,16,15,14,12,14,16,6,14,6,7,14,13,7,15,13,10,10,12,11,13,11,12,13,7,13,8,10,13,13,14,12,9,20,13,14,10,13,11,12,12,10,6,8,8,13,10,10,14,7,8,12,1,1,18,20,14,20,17,M/AM LC,524,1,1,1,17,20,14,1,1,1,1,10,18,10,1,1,1.0,1,0,0,0,0,0,0,0,0,0,0,0,0,0,0,0,0,0,0,0,0,0,0,0,0,0,0,0,0,0,0,0,0,0,0,0,0,0,0,0,0,0,0,0,0,0,0,0,Jimmy Durmaz,Â£1.80m ,31.0,180.0,Forward - Right Winger,left,Fatih KaragÃ¼mrÃ¼k,30.0,3.0,1.0,1657.0,25.0,4.0,3.0,1242.0,37.0,4.0,1.0,1925.0,15.0,0.0,1.0,452.0,4.0,0.0,0.0,54.0,Ligue 1,15-07-16,17.3.2.23,Jimmy Durmaz,611474,797,22-Mar-89,27,34,2,8,0,4500,6500,6500,135,130,10119063,180,69,M/AM LC,2,4,3,3,3,1,2,3,1,2,1,16,15,14,12,14,16,6,14,6,7,14,13,7,15,13,10,10,12,11,13,12,12,13,7,13,8,10,13,13,14,12,9,20,13,14,10,13,11,11,12,10,6,8,8,13,10,10,14,7,8,12,Jimmy Durmaz,Â£1.80m ,Ligue 1
19-06-17,18.3.4.28,Alexander Kacaniklic,618356,797,13-Aug-91,25,19,3,0,0,3800,5950,5850,124,117,927395,181,72,M/AM RL,1,2,2,3,4,3,2,1,1,3,1,11,13,13,11,13,11,9,11,7,8,12,10,6,14,4,10,6,10,10,13,11,11,12,10,13,8,11,10,14,13,10,9,20,14,14,12,13,6,11,6,9,9,14,14,13,10,10,12,13,14,3,1,1,16,20,15,20,13,M/AM RL,525,1,1,1,13,20,15,1,1,1,1,1,16,13,1,1,70919100000000.0,0,0,0,0,0,0,0,0,0,0,0,0,0,0,0,0,0,0,0,0,0,0,0,0,1,0,0,0,0,1,0,0,0,0,0,0,0,0,0,1,0,0,0,0,0,0,1,0,Alexander Kacaniklic,Â£1.35m ,29.0,181.0,Midfielder - Left Midfield,left,Hammarby IF,19.0,0.0,2.0,787.0,12.0,0.0,2.0,422.0,25.0,10.0,8.0,1696.0,23.0,8.0,12.0,1615.0,2.0,0.0,0.0,26.0,Ligue 1,15-07-16,17.3.2.23,Alexander Kacaniklic,618356,797,13-Aug-91,24,19,3,0,0,3950,5950,5800,124,118,2955896,181,72,M/AM RL,2,1,2,1,1,1,1,1,2,4,1,11,13,13,11,13,11,9,11,7,8,12,10,6,13,4,9,6,10,10,13,11,11,12,10,13,8,11,10,14,13,10,9,20,14,14,11,13,6,11,6,9,9,14,14,13,10,10,12,13,14,3,Alexander Kacaniklic,Â£1.35m ,Ligue 1
19-06-17,18.3.4.28,Keagan Dolly,65024990,45,22-Jan-93,24,9,2,15,5,3750,6650,6450,131,122,10385873,173,70,AM RLC,1,3,1,1,3,4,1,2,3,1,3,6,11,13,13,11,9,5,16,6,4,12,8,6,13,6,8,7,9,8,14,8,14,13,7,14,13,11,10,15,15,14,8,20,14,15,15,12,8,8,8,11,9,9,12,17,9,9,12,10,10,7,1,1,15,20,17,20,15,AM RLC,506,1,1,10,15,20,17,1,1,1,1,12,15,12,1,1,0.0,0,0,0,0,0,0,0,0,0,0,0,0,0,0,0,0,0,0,0,0,0,0,0,0,0,0,0,0,0,0,0,0,0,0,0,0,0,0,0,0,0,0,0,0,0,0,0,0,Keagan Dolly,Â£1.35m ,27.0,170.0,Forward - Left Winger,left,Montpellier HSC,23.0,1.0,2.0,1351.0,22.0,1.0,2.0,1076.0,4.0,0.0,0.0,104.0,6.0,0.0,0.0,142.0,4.0,0.0,0.0,54.0,Ligue 1,15-07-16,17.3.2.23,Keagan Dolly,65024990,45,22-Jan-93,23,3,2,15,5,3250,6250,6000,145,128,4690483,173,70,AM RLC,1,2,1,2,2,3,3,2,2,3,3,7,12,15,12,12,10,6,15,7,5,13,9,7,13,6,9,7,10,9,15,9,14,15,7,13,12,12,11,17,15,15,9,20,14,15,15,13,7,8,8,11,9,9,12,17,9,9,12,10,10,7,Keagan Dolly,Â£1.35m ,Ligue 1
19-06-17,18.3.4.28,Stiven Mendoza,76016258,1653,27-Jun-92,24,0,0,13,0,3250,5700,6200,129,124,6652993,171,73,AM RL,2,1,3,4,2,2,1,3,3,3,2,7,10,13,11,12,8,5,12,5,4,10,12,4,11,8,12,11,12,9,10,9,14,15,6,13,9,9,15,18,15,11,8,20,14,17,4,13,7,9,6,10,12,13,12,13,9,12,12,12,7,8,1,8,15,20,15,20,10,AM RL,505,1,1,15,10,20,15,1,1,1,1,1,15,10,8,1,0.0,0,0,0,0,0,0,0,0,0,0,0,0,0,0,0,0,0,0,0,0,0,0,0,0,0,0,0,0,0,0,0,0,0,0,0,0,0,0,0,0,0,0,0,0,0,0,0,0,Stiven Mendoza,Â£1.13m ,28.0,172.0,Forward - Left Winger,left,Amiens SC,31.0,8.0,3.0,2413.0,13.0,2.0,0.0,1037.0,28.0,2.0,2.0,2028.0,17.0,6.0,0.0,1261.0,3.0,1.0,0.0,222.0,Ligue 1
19-06-17,18.3.4.28,Yassine El Ghanassy,8189685,757,12-Jul-90,26,1,0,5,1,4700,6000,6200,130,124,5949311,175,68,AM RL,1,3,1,3,1,3,1,2,3,2,2,14,15,16,13,15,11,6,11,5,5,14,11,5,15,9,13,17,14,13,10,14,14,15,7,13,9,6,10,13,14,8,7,8,4,15,20,10,8,13,8,11,9,11,12,10,10,12,3,7,5,17,1,1,14,20,18,20,14,AM RL,505,1,1,1,14,20,18,1,1,1,1,14,14,14,1,1,2251800000000000.0,0,0,0,0,0,0,0,0,0,0,0,0,0,0,0,0,0,0,0,0,0,0,0,0,0,0,0,0,0,0,0,0,0,0,0,0,0,0,0,0,0,0,0,0,0,0,0,0,Yassine El Ghanassy,Â£1.35m ,30.0,173.0,Forward - Left Winger,right,Without Club,41.0,4.0,7.0,2641.0,26.0,0.0,0.0,922.0,18.0,1.0,0.0,1022.0,nan,nan,nan,nan,nan,nan,nan,nan,Ligue 1
19-06-17,18.3.4.28,StÃ©phane Darbion,8428612,769,22-Mar-84,33,0,0,0,0,3600,6150,6150,125,123,232186002,183,77,M/AM RLC,1,1,2,1,2,3,1,2,2,1,3,13,14,12,11,14,14,10,13,8,6,13,14,5,14,7,13,11,13,14,13,13,12,12,13,12,8,14,15,11,13,14,11,20,12,11,8,13,14,14,7,12,11,8,6,14,12,12,14,13,13,7,1,1,17,20,18,20,15,M/AM RLC,526,1,1,1,15,20,18,1,1,1,1,14,17,15,1,1,17592700000000.0,0,0,0,0,0,0,0,0,0,1,0,0,0,0,0,0,0,0,0,0,0,0,0,0,0,0,0,0,0,1,0,0,0,0,0,0,0,0,0,0,0,0,0,0,1,0,0,0,StÃ©phane Darbion,Â£450Th. ,36.0,183.0,Midfielder - Left Midfield,left,Retired,42.0,6.0,12.0,3551.0,25.0,3.0,2.0,1846.0,7.0,0.0,0.0,169.0,8.0,0.0,0.0,158.0,nan,nan,nan,nan,Ligue 1
19-06-17,18.3.4.28,FrÃ©dÃ©ric Sammaritano,8428645,769,23-Mar-86,31,0,0,0,0,3900,6150,6150,126,123,3997427,162,65,AM RLC,3,1,1,1,3,1,4,2,1,2,3,13,12,14,10,14,15,5,12,6,4,11,12,3,15,11,12,8,10,13,13,12,17,15,9,13,7,11,14,15,14,7,3,14,11,13,20,11,7,13,11,15,11,8,11,14,13,14,14,13,10,6,1,1,12,20,18,20,18,AM RLC,506,1,1,1,18,20,18,1,1,1,1,11,12,12,1,1,2251830000000000.0,0,0,0,0,0,0,0,1,0,0,0,0,0,0,0,0,0,0,0,0,0,0,0,0,0,0,0,0,0,0,0,0,0,0,0,1,0,0,0,0,0,0,0,0,0,0,0,0,FrÃ©dÃ©ric Sammaritano,Â£900Th. ,34.0,162.0,Midfielder - Attacking Midfield,right,Dijon FCO,31.0,4.0,4.0,1969.0,27.0,1.0,4.0,1551.0,15.0,0.0,0.0,559.0,13.0,2.0,2.0,806.0,7.0,0.0,0.0,223.0,Ligue 1,15-07-16,17.3.2.23,FrÃ©dÃ©ric Sammaritano,8428645,769,23-Mar-86,30,0,0,0,0,3909,5800,5950,126,119,232186002,162,65,AM RLC,1,3,1,1,3,1,1,2,1,3,3,13,12,14,10,14,15,5,12,6,4,11,12,3,15,11,12,8,10,13,13,12,17,15,9,13,7,11,14,15,14,7,3,14,11,13,20,11,7,13,11,15,11,8,13,14,13,14,14,13,10,6,FrÃ©dÃ©ric Sammaritano,Â£900Th. ,Ligue 1
19-06-17,18.3.4.28,Vincent Bessat,8431098,769,08-Nov-85,31,0,0,0,0,3900,6350,6350,127,127,232186002,178,73,D/M/AM L,1,2,1,2,1,2,1,4,2,3,2,13,13,12,7,13,12,7,13,5,10,13,9,10,14,11,12,12,13,13,12,13,14,12,7,12,10,13,14,13,14,15,8,20,14,14,8,14,11,13,11,14,8,15,13,12,12,9,12,12,10,10,20,14,17,19,1,20,10,D/M/AM L,123,1,1,1,1,19,1,1,20,1,10,10,17,1,14,1,1.0,1,0,0,0,0,0,0,0,0,0,0,0,0,0,0,0,0,0,0,0,0,0,0,0,0,0,0,0,0,0,0,0,0,0,0,0,0,0,0,0,0,0,0,0,0,0,0,0,Vincent Bessat,Â£450Th. ,34.0,178.0,Defender - Left-Back,left,Without Club,39.0,0.0,6.0,2928.0,25.0,0.0,1.0,1658.0,23.0,2.0,0.0,1841.0,2.0,0.0,0.0,210.0,nan,nan,nan,nan,Ligue 1,15-07-16,17.3.2.23,Vincent Bessat,8431098,769,08-Nov-85,30,0,0,0,0,3999,6449,6399,129,127,232186002,178,73,M/AM L,3,3,1,2,1,3,1,1,1,3,1,13,14,12,7,13,12,7,13,5,10,13,9,10,13,11,11,12,12,13,11,14,14,11,7,11,10,13,15,13,15,15,8,20,14,14,8,14,11,13,11,14,8,10,14,12,12,9,12,12,10,10,Vincent Bessat,Â£900Th. ,Ligue 1
19-06-17,18.3.4.28,Yannis Salibur,8434934,769,24-Jan-91,26,0,0,0,0,3900,6350,6350,128,127,5497067,177,76,M/AM RL,2,1,1,2,1,1,3,1,2,1,1,12,12,14,12,14,13,7,13,6,3,12,12,3,14,9,13,8,13,12,12,13,10,14,5,13,4,7,8,16,15,12,8,20,13,14,8,14,12,11,9,14,9,8,11,14,11,8,10,11,11,9,1,1,18,20,20,19,13,M/AM RL,525,1,1,10,13,19,20,1,1,1,1,1,15,18,1,1,2252380000000000.0,0,0,0,0,0,0,0,0,0,0,0,0,0,0,0,0,0,0,0,0,0,0,0,0,0,0,0,0,0,0,0,0,0,0,0,1,0,0,0,1,0,0,0,0,0,0,0,0,Yannis Salibur,Â£4.50m ,29.0,177.0,Forward - Right Winger,left,Fatih KaragÃ¼mrÃ¼k,37.0,8.0,6.0,2989.0,24.0,3.0,1.0,1630.0,24.0,1.0,4.0,1107.0,4.0,0.0,0.0,78.0,3.0,0.0,0.0,200.0,Ligue 1,15-07-16,17.3.2.23,Yannis Salibur,8434934,769,24-Jan-91,25,0,0,0,0,3999,6299,6299,128,126,7149578,176,74,AM RL,3,3,1,3,3,3,3,1,3,2,2,12,12,14,12,14,13,7,12,6,3,12,12,3,15,9,10,8,12,11,12,10,10,14,5,13,4,6,8,17,15,12,8,20,12,14,8,13,12,11,9,14,10,8,11,14,12,7,10,11,11,9,Yannis Salibur,Â£4.50m ,Ligue 1
19-06-17,18.3.4.28,Kevin Monnet-Paquet,8440065,769,19-Aug-88,28,0,0,6,0,4400,6400,6500,134,127,8599568,183,73,AM RL,2,1,3,4,1,3,2,3,4,4,3,10,11,14,9,14,10,7,11,5,4,12,12,5,14,8,11,11,10,11,9,10,11,12,6,12,7,11,13,17,13,12,10,5,15,15,20,15,12,10,8,13,6,9,14,14,16,8,14,15,15,8,1,1,14,20,17,20,12,AM RL,505,1,1,15,12,20,17,1,1,1,1,10,14,13,1,1,2251800000000000.0,0,0,0,0,0,0,0,0,0,0,0,0,0,0,0,0,0,0,0,0,0,0,0,0,0,0,0,0,0,0,0,0,0,0,0,0,0,0,0,0,0,0,0,0,0,0,0,0,KÃ©vin Monnet-Paquet,Â£1.80m ,32.0,184.0,Forward - Left Winger,right,AS Saint-Ãtienne,48.0,5.0,4.0,3355.0,31.0,2.0,2.0,1835.0,26.0,2.0,1.0,1695.0,0.0,0.0,0.0,0.0,5.0,0.0,0.0,151.0,Ligue 1,15-07-16,17.3.2.23,Kevin Monnet-Paquet,8440065,769,19-Aug-88,27,0,0,6,0,4400,6400,6500,134,129,10060542,183,73,AM RL,2,4,3,1,1,3,2,3,3,1,2,10,11,14,9,14,10,7,11,5,4,12,12,5,14,8,12,12,10,12,9,10,11,13,6,13,7,11,13,17,13,12,10,5,15,15,20,15,12,12,8,14,6,9,17,14,16,8,14,15,15,8,KÃ©vin Monnet-Paquet,Â£2.25m ,Ligue 1
19-06-17,18.3.4.28,Ludovic Baal,8441947,917496,24-May-86,31,12,3,0,0,4300,6450,6450,131,129,232186002,176,75,D/WB L,3,1,2,3,2,1,3,1,2,2,2,9,14,11,6,12,9,11,10,12,11,11,10,12,12,13,13,14,10,12,11,11,12,8,10,9,12,13,15,15,13,12,9,20,15,14,6,16,12,12,13,13,6,14,10,14,14,12,14,13,13,8,20,18,15,14,1,20,14,D/WB L,113,1,1,1,1,14,1,1,20,1,15,14,15,1,18,1,8.0,0,0,0,1,0,0,0,0,0,0,0,0,0,0,0,0,0,0,0,0,0,0,0,0,0,0,0,0,0,0,0,0,0,0,0,0,0,0,0,0,0,0,0,0,0,0,0,0,Ludovic Baal,Â£900Th. ,34.0,176.0,Defender - Left-Back,left,Stade Brest 29,35.0,0.0,5.0,3062.0,21.0,0.0,1.0,1438.0,3.0,0.0,0.0,152.0,11.0,0.0,0.0,825.0,2.0,0.0,0.0,161.0,Ligue 1,15-07-16,17.3.2.23,Ludovic Baal,8441947,769,24-May-86,30,0,0,0,0,4350,6250,6450,132,130,232186002,176,75,D/WB L,3,2,4,3,2,1,1,2,2,1,3,9,14,11,6,12,9,11,10,12,11,11,10,12,12,13,13,14,10,10,11,11,12,8,10,9,12,13,15,15,13,12,9,20,15,14,6,17,12,12,13,13,6,14,7,14,14,12,14,13,13,9,Ludovic Baal,Â£1.35m ,Ligue 1
19-06-17,18.3.4.28,Dimitri Payet,8442349,769,29-Mar-87,30,35,8,12,4,5750,7650,7250,158,145,232186002,175,77,AM RLC,1,2,2,2,2,1,1,2,1,2,2,15,14,15,14,15,16,6,16,6,5,16,11,5,17,8,14,10,15,10,16,13,14,16,8,14,5,11,8,13,14,14,8,15,15,14,20,13,12,10,9,12,7,8,8,15,8,13,12,13,11,10,1,1,12,20,15,19,20,AM RLC,506,1,1,10,20,19,15,1,1,1,1,12,12,10,1,1,88545000000000.0,0,0,0,0,0,0,0,0,0,0,0,1,0,0,0,0,0,0,0,0,0,0,0,0,0,0,0,0,0,0,0,0,0,0,0,1,0,0,0,1,0,0,0,0,1,0,1,0,Dimitri Payet,Â£19.80m ,33.0,175.0,Forward - Left Winger,right,Olympique Marseille,39.0,8.0,11.0,3153.0,47.0,10.0,23.0,3536.0,38.0,6.0,8.0,2461.0,27.0,12.0,6.0,2400.0,6.0,1.0,1.0,424.0,Ligue 1,15-07-16,17.3.2.23,Dimitri Payet,8442349,769,29-Mar-87,29,26,6,12,4,7000,7700,7700,163,153,44833251,175,77,AM RLC,3,2,3,2,3,1,3,3,1,3,1,16,14,16,15,15,18,6,15,6,6,18,11,5,17,9,12,10,16,12,16,14,14,16,6,16,6,10,10,13,15,14,8,15,15,14,20,13,12,11,9,16,7,8,8,11,8,13,12,13,11,10,Dimitri Payet,Â£23.40m ,Premier League
19-06-17,18.3.4.28,Giovanni Sio,8442431,24,31-Mar-89,28,24,2,0,0,4300,6350,6300,127,126,7413376,180,78,S L,1,4,1,1,2,3,1,3,1,3,2,7,10,12,13,12,10,14,12,7,5,11,9,4,11,12,13,14,11,12,10,10,12,13,5,13,7,9,16,16,15,13,11,20,13,15,8,15,14,13,12,15,8,10,12,14,13,11,13,13,13,10,1,1,12,15,10,15,13,S L,603,1,1,20,13,15,10,1,1,1,1,1,12,10,1,1,4398050000000.0,0,0,0,0,0,0,0,0,0,0,0,0,0,0,0,0,0,0,0,1,1,0,0,0,0,0,0,0,0,0,0,0,0,0,0,0,0,0,0,0,0,0,1,0,0,0,0,0,Giovanni Sio,Â£3.15m ,31.0,180.0,Forward - Centre-Forward,left,Genclerbirligi Ankara,35.0,9.0,2.0,2763.0,37.0,10.0,3.0,2463.0,22.0,7.0,4.0,1414.0,28.0,11.0,3.0,2146.0,3.0,0.0,0.0,193.0,Ligue 1,15-07-16,17.3.2.23,Giovanni Sio,8442431,24,31-Mar-89,27,17,2,0,0,4594,6194,6194,127,126,5734641,180,78,AM/S L,3,3,3,3,3,3,4,1,3,2,1,7,10,13,12,13,11,12,12,7,5,12,9,4,12,12,13,14,10,11,11,10,12,14,5,13,7,10,14,16,15,14,11,20,12,15,8,14,14,11,12,15,9,10,6,14,12,11,13,13,13,10,Giovanni Sio,Â£4.05m ,Ligue 1
19-06-17,18.3.4.28,Razza Camara,8449420,22,20-Feb-90,27,16,4,0,0,4500,6350,5900,135,121,2832447,178,72,AM RL,1,1,2,1,3,1,2,1,2,2,1,10,12,13,9,12,10,7,12,7,5,12,10,6,12,6,9,7,10,8,12,9,16,12,8,11,6,8,9,17,14,8,8,20,14,17,7,12,13,10,6,11,6,8,14,15,14,10,11,14,12,11,1,1,14,20,17,20,1,AM RL,505,1,1,12,1,20,17,1,1,1,1,1,14,12,1,1,2251830000000000.0,0,0,0,0,0,0,0,0,0,0,0,0,0,0,0,0,0,0,0,0,0,0,0,0,0,0,0,0,0,0,0,0,0,0,0,1,0,0,0,0,0,0,0,0,0,0,0,0,nan,nan,nan,nan,nan,nan,nan,nan,nan,nan,nan,nan,nan,nan,nan,nan,nan,nan,nan,nan,nan,nan,nan,nan,nan,nan,nan,nan,
19-06-17,18.3.4.28,Ronny Rodelin,85006064,769,18-Nov-89,27,0,0,0,0,3850,6350,6350,128,127,9122789,193,81,AM/S RL,3,1,2,2,1,2,2,3,2,3,1,4,9,14,10,13,10,15,14,5,5,10,13,3,13,8,13,12,11,11,10,12,13,15,5,13,6,10,14,13,12,14,16,12,14,14,20,13,13,12,8,14,9,8,7,15,12,12,13,13,12,10,1,1,15,17,17,15,13,AM/S RL,625,1,1,20,13,15,17,1,1,1,1,1,10,15,1,1,4432410000000.0,0,0,0,0,0,0,0,0,0,0,0,0,0,0,0,0,0,0,0,0,0,0,0,0,0,0,0,0,0,0,0,0,0,0,0,1,0,0,0,0,0,0,1,0,0,0,0,0,Ronny Rodelin,Â£4.50m ,30.0,192.0,Forward - Right Winger,right,EA Guingamp,40.0,11.0,4.0,3078.0,43.0,6.0,6.0,3645.0,24.0,1.0,1.0,1113.0,26.0,6.0,6.0,1945.0,6.0,0.0,0.0,444.0,Ligue 1,15-07-16,17.3.2.23,Ronny Rodelin,85006064,769,18-Nov-89,26,0,0,0,0,3900,5950,6150,123,123,5053024,193,81,AM RL,1,3,2,1,1,1,2,3,3,2,3,4,9,14,10,13,12,14,14,5,5,10,12,3,14,8,13,12,9,10,11,11,12,16,5,14,6,9,12,14,13,14,16,14,13,13,20,13,14,10,8,14,9,8,20,16,11,13,11,13,13,10,Ronny Rodelin,Â£3.15m ,Ligue 1
19-06-17,18.3.4.28,LoÄc Puyo,85009949,769,19-Dec-88,28,0,0,0,0,3500,5800,5800,120,116,2445425,182,76,DM/AM L,1,1,2,3,2,2,2,3,3,2,3,13,13,11,7,13,15,10,11,7,9,13,8,9,13,11,13,14,13,12,12,12,14,8,7,8,12,15,14,12,12,14,11,20,15,13,5,15,13,12,11,13,9,12,10,12,13,9,15,15,15,6,1,10,15,20,1,20,13,DM/AM L,523,1,1,1,10,20,1,1,1,1,17,13,15,1,10,1,8796090000000.0,0,0,0,0,0,0,0,0,0,0,0,0,0,0,0,0,0,0,0,0,0,0,0,0,0,0,0,0,0,0,0,0,0,0,0,0,0,0,0,0,0,0,0,1,0,0,0,0,LoÃ¯c Puyo,Â£810Th. ,31.0,182.0,Midfielder - Central Midfield,left,Macarthur FC,24.0,4.0,2.0,1609.0,11.0,0.0,1.0,376.0,nan,nan,nan,nan,19.0,0.0,1.0,1539.0,nan,nan,nan,nan,Ligue 1,15-07-16,17.3.2.23,LoÄc Puyo,85009949,769,19-Dec-88,27,0,0,0,0,3254,5850,5850,120,117,1958526,182,76,DM/AM L,4,1,2,1,2,2,3,1,2,1,2,13,13,11,7,13,15,10,11,7,9,13,8,9,13,11,13,14,13,12,12,12,14,8,7,8,12,15,12,10,12,13,11,20,15,11,5,15,13,12,11,13,9,12,9,12,13,9,15,15,15,6,LoÃ¯c Puyo,Â£810Th. ,Ligue 1
19-06-17,18.3.4.28,YÃ©ni Ngbakoto,85010373,53,23-Jan-92,25,2,1,0,0,4000,5900,5900,129,118,2783590,174,73,AM RL,1,3,3,2,1,2,3,2,2,1,2,13,11,13,13,12,14,9,15,5,2,9,11,4,15,11,9,12,8,12,9,9,13,14,10,11,5,7,10,15,14,12,8,9,11,15,20,14,11,13,11,15,8,10,4,15,14,10,12,11,9,8,1,1,12,20,20,15,14,AM RL,505,1,1,12,14,15,20,1,1,1,1,8,12,12,1,1,2251830000000000.0,0,0,0,0,0,0,0,0,0,1,0,0,0,0,0,0,0,0,0,0,0,0,0,0,0,0,0,0,0,0,0,0,0,0,0,1,0,0,0,0,0,0,0,0,0,0,0,0,Yeni N'Gbakoto,Â£1.80m ,28.0,173.0,Forward - Right Winger,right,EA Guingamp,28.0,4.0,4.0,1486.0,24.0,5.0,1.0,978.0,19.0,3.0,0.0,871.0,23.0,4.0,1.0,931.0,8.0,1.0,1.0,404.0,Ligue 1
19-06-17,18.3.4.28,Maxime PoundjÃ©,85011273,769,16-Aug-92,24,0,0,0,0,3250,5800,5800,124,108,789479,179,71,D/WB L,2,1,2,3,2,2,2,2,2,2,3,8,10,10,6,9,10,5,10,10,10,10,6,9,9,9,11,12,10,7,8,8,11,12,5,13,8,12,14,16,13,13,10,20,16,15,8,14,14,13,9,14,7,10,10,10,14,13,12,13,13,5,20,18,15,12,8,20,1,D/WB L,113,1,1,1,1,12,5,1,20,8,1,1,15,5,18,8,2251800000000000.0,1,0,0,1,0,0,0,0,1,0,0,0,0,0,0,0,0,0,0,0,0,0,0,0,0,0,0,0,0,0,0,0,0,0,0,0,0,0,0,0,0,0,0,0,0,0,0,0,Maxime PoundjÃ©,Â£4.05m ,28.0,179.0,Defender - Left-Back,left,FC Girondins Bordeaux,10.0,0.0,0.0,810.0,21.0,0.0,2.0,1909.0,43.0,1.0,2.0,3625.0,3.0,0.0,0.0,107.0,4.0,0.0,0.0,100.0,Ligue 1,15-07-16,17.3.2.23,Maxime PoundjÃ©,85011273,769,16-Aug-92,23,0,0,0,0,3696,5793,5793,125,117,2013805,179,71,D/WB L,2,2,1,1,1,3,3,3,2,1,3,8,10,12,6,12,10,5,10,13,11,11,6,12,11,9,11,12,12,7,10,9,15,12,5,13,8,12,14,16,13,13,10,20,16,15,8,14,14,13,9,14,7,10,12,14,14,13,15,13,13,5,Maxime PoundjÃ©,Â£1.35m ,Ligue 1
19-06-17,18.3.4.28,Nicolas De PrÃ©ville,85018475,769,08-Jan-91,26,0,0,0,0,4300,6450,6450,130,128,9616256,182,77,AM/S RL,1,3,3,2,1,1,1,3,2,1,2,5,11,14,10,13,12,13,14,5,3,14,11,5,13,10,12,12,12,13,12,12,15,13,5,14,4,13,16,14,13,10,11,10,12,13,20,15,13,13,10,14,7,12,9,13,13,8,13,13,8,7,1,1,10,19,17,19,1,AM/S RL,625,5,1,20,1,19,17,1,1,1,1,1,10,10,1,1,1.44115e+17,0,0,0,0,1,0,0,0,0,0,0,0,0,0,0,0,0,0,0,0,0,0,0,0,0,0,0,0,0,0,0,0,0,0,0,0,0,0,0,0,0,0,0,0,0,0,0,0,Nicolas de PrÃ©ville,Â£6.30m ,29.0,182.0,Forward - Centre-Forward,right,FC Girondins Bordeaux,33.0,14.0,1.0,2156.0,35.0,6.0,4.0,2435.0,34.0,4.0,3.0,1800.0,28.0,8.0,4.0,2251.0,8.0,0.0,1.0,567.0,Ligue 1,15-07-16,17.3.2.23,Nicolas De PrÃ©ville,85018475,769,08-Jan-91,25,0,0,4,3,4750,6250,6400,133,128,10920513,182,77,AM/S RL,3,1,2,1,3,2,2,1,2,2,1,5,11,14,8,13,12,13,13,5,3,14,11,5,14,10,12,12,11,13,14,12,15,15,5,14,4,13,14,15,14,8,11,10,12,14,20,12,12,13,10,14,7,12,10,13,13,8,13,13,8,7,Nicolas de PrÃ©ville,Â£4.95m ,Ligue 1
19-06-17,18.3.4.28,Johann Obiang,85028010,19,05-Jul-93,23,22,0,0,0,3000,5450,5450,124,109,1232580,170,64,D/WB/M L,3,1,1,1,3,1,1,2,2,2,3,7,12,11,7,11,7,7,9,11,11,12,7,11,10,10,12,11,12,11,10,11,13,11,8,12,11,12,14,15,14,12,7,20,12,13,6,13,7,13,8,10,8,12,15,10,14,11,13,15,12,6,20,18,17,15,1,20,1,D/WB/M L,123,1,1,1,1,15,1,1,20,1,1,1,17,1,18,1,1.0,1,0,0,0,0,0,0,0,0,0,0,0,0,0,0,0,0,0,0,0,0,0,0,0,0,0,0,0,0,0,0,0,0,0,0,0,0,0,0,0,0,0,0,0,0,0,0,0,Johann Obiang,Â£810Th. ,27.0,170.0,Defender - Left-Back,left,Rodez AF,25.0,0.0,2.0,1612.0,11.0,0.0,0.0,769.0,27.0,0.0,2.0,2040.0,15.0,0.0,2.0,1380.0,4.0,0.0,0.0,349.0,Ligue 1
19-06-17,18.3.4.28,Rachid Ghezzal,85031826,5,09-May-92,25,11,1,0,0,5500,6400,6650,138,133,12260506,182,70,M/AM RLC,3,2,1,4,1,1,3,1,2,3,1,14,14,15,11,15,14,9,11,4,7,14,12,7,16,12,12,13,12,11,15,12,12,14,8,12,7,11,11,14,15,13,10,20,13,14,8,14,11,11,12,13,9,13,11,14,14,13,10,9,9,11,1,1,16,20,20,16,15,M/AM RLC,526,1,1,1,15,16,20,1,1,1,1,1,12,16,1,1,2.88248e+17,0,0,0,0,0,0,0,0,0,0,0,1,0,0,0,0,0,0,0,0,0,0,0,0,0,0,0,0,0,0,1,0,0,0,0,1,0,0,0,0,0,0,0,0,1,0,0,0,Rachid Ghezzal,Â£3.60m ,28.0,182.0,Forward - Right Winger,left,Besiktas JK,38.0,3.0,7.0,1898.0,35.0,2.0,4.0,1352.0,23.0,3.0,0.0,1043.0,21.0,1.0,1.0,904.0,1.0,0.0,0.0,86.0,Ligue 1,15-07-16,17.3.2.23,Rachid Ghezzal,85031826,5,09-May-92,24,6,1,0,0,4100,6350,6350,140,127,5192979,183,66,M/AM RL,3,4,3,1,3,2,3,2,3,3,1,14,14,14,10,14,14,9,10,8,8,14,10,8,15,9,11,13,11,11,13,10,14,13,5,12,9,14,13,14,16,12,9,20,13,14,5,15,9,12,10,12,8,9,15,9,16,13,11,12,13,9,Rachid Ghezzal,Â£7.20m ,Ligue 1
19-06-17,18.3.4.28,Florian Thauvin,85046587,769,26-Jan-93,24,1,0,10,7,5750,7400,7400,149,148,53985149,179,70,AM RLC,2,1,4,2,1,1,1,1,2,3,1,10,13,16,16,16,11,8,15,5,3,14,12,5,16,11,13,12,14,12,14,13,12,16,6,14,6,13,14,16,14,13,9,20,14,15,10,15,10,14,7,14,6,10,10,15,10,12,10,14,12,8,1,1,14,20,20,16,15,AM RLC,506,1,1,10,15,16,20,1,1,1,1,12,13,14,1,1,2.90482e+17,0,0,0,0,0,0,0,0,0,1,0,0,0,0,0,0,0,0,0,0,0,0,0,0,0,0,0,0,0,0,0,0,0,0,0,1,0,0,0,0,0,0,0,0,0,0,0,0,Florian Thauvin,Â£45.00m ,27.0,179.0,Forward - Right Winger,left,Olympique Marseille,43.0,15.0,12.0,3500.0,54.0,26.0,17.0,4161.0,37.0,18.0,9.0,2942.0,2.0,0.0,0.0,20.0,9.0,3.0,5.0,730.0,Ligue 1,15-07-16,17.3.2.23,Florian Thauvin,85046587,769,26-Jan-93,23,0,0,10,7,5294,6494,6744,144,135,34447554,179,70,AM RLC,1,1,1,2,3,3,4,2,2,2,2,10,13,14,12,15,11,10,13,6,3,13,12,4,16,11,12,11,13,11,13,12,12,16,6,14,6,10,12,16,14,12,9,20,13,14,10,13,10,12,7,12,6,8,12,13,5,10,8,14,12,8,Florian Thauvin,Â£16.20m ,Ligue 1
19-06-17,18.3.4.28,Paul-Georges Ntep,85049375,769,29-Jul-92,24,2,0,15,9,5600,6850,6600,144,137,8901885,180,82,M/AM RL,3,1,3,3,2,3,2,2,3,3,3,10,13,15,12,12,11,8,14,7,5,11,10,5,14,9,11,13,10,12,13,11,14,16,5,13,5,10,8,18,13,15,10,10,11,16,20,12,13,10,6,14,12,10,6,16,11,13,10,10,8,14,1,1,20,20,15,20,1,M/AM RL,415,1,1,12,1,20,15,1,1,1,1,1,20,15,1,1,1.44115e+17,0,0,0,0,0,0,0,0,0,0,0,0,0,0,1,0,0,0,0,0,0,0,0,0,1,0,0,1,1,0,0,0,0,0,0,0,0,0,0,0,0,0,0,0,0,0,0,0,Paul-Georges Ntep,Â£3.60m ,28.0,180.0,Forward - Left Winger,right,EA Guingamp,27.0,2.0,7.0,1739.0,20.0,1.0,1.0,751.0,nan,nan,nan,nan,9.0,0.0,0.0,430.0,3.0,0.0,0.0,61.0,Bundesliga,15-07-16,17.3.2.23,Paul-Georges Ntep,85049375,769,29-Jul-92,23,2,0,15,9,5450,6650,6950,144,139,28091350,180,82,M/AM RL,4,3,3,3,1,2,2,2,3,3,2,10,13,15,12,12,11,8,14,7,5,12,11,5,14,9,11,13,10,10,13,11,14,16,6,12,5,11,10,18,13,15,10,10,14,16,20,13,13,10,5,14,12,10,9,16,11,13,12,10,8,14,Paul-Georges Ntep,Â£7.20m ,Bundesliga
19-06-17,18.3.4.28,Franck Tabanou,85050974,769,30-Jan-89,28,0,0,10,0,4000,6350,6350,135,127,6578935,178,77,D/M/AM L,2,2,3,3,3,2,3,1,3,3,2,13,14,13,8,15,13,10,12,10,9,13,8,10,14,10,12,13,13,14,13,12,13,13,6,14,10,11,15,14,13,12,9,20,10,14,7,13,12,12,9,15,8,10,8,16,13,14,11,13,13,13,19,15,17,20,1,20,1,D/M/AM L,533,1,1,1,1,20,1,1,19,1,1,1,17,1,15,1,0.0,0,0,0,0,0,0,0,0,0,0,0,0,0,0,0,0,0,0,0,0,0,0,0,0,0,0,0,0,0,0,0,0,0,0,0,0,0,0,0,0,0,0,0,0,0,0,0,0,Franck Tabanou,Â£1.80m ,31.0,178.0,Defender - Left-Back,left,Without Club,8.0,0.0,0.0,547.0,15.0,0.0,2.0,1046.0,4.0,0.0,0.0,420.0,nan,nan,nan,nan,nan,nan,nan,nan,Ligue 1,15-07-16,17.3.2.23,Franck Tabanou,85050974,769,30-Jan-89,27,0,0,10,0,5650,6750,6500,135,131,19675622,178,77,D/M/AM L,2,3,1,1,3,1,2,1,2,3,3,13,14,15,8,15,13,10,12,10,9,13,8,10,15,10,12,13,13,14,13,12,13,13,6,14,10,11,15,14,14,13,9,20,10,14,7,13,12,12,9,15,8,10,8,16,13,14,11,13,13,13,Franck Tabanou,Â£1.80m ,Premier League
19-06-17,18.3.4.28,Jules Iloki,85052020,769,14-Jan-92,25,0,0,0,0,3250,5850,5850,119,117,2183785,172,72,AM RL,2,3,2,2,2,2,2,3,3,2,4,10,11,12,10,11,8,8,10,7,7,11,11,6,12,8,12,11,11,11,11,12,15,12,5,12,11,13,15,15,13,12,9,8,14,13,20,14,13,11,8,13,7,12,10,13,13,12,10,12,12,6,1,1,14,20,20,17,10,AM RL,505,1,1,12,10,17,20,1,1,1,1,1,14,14,1,1,2251800000000000.0,0,0,0,0,0,0,0,0,0,0,0,0,0,0,0,0,0,0,0,0,1,0,0,0,1,0,0,0,0,0,0,0,0,0,0,0,0,0,0,0,0,0,0,0,0,0,0,0,Jules Iloki,Â£1.13m ,28.0,172.0,Midfielder - Right Midfield,right,Suzhou Dongwu,27.0,1.0,6.0,1454.0,29.0,0.0,0.0,1568.0,7.0,0.0,0.0,160.0,4.0,0.0,0.0,308.0,nan,nan,nan,nan,Ligue 1,15-07-16,17.3.2.23,Jules Iloki,85052020,769,14-Jan-92,24,0,0,0,0,3000,5550,5700,119,114,2526643,172,72,AM RL,1,4,2,1,1,3,2,4,1,1,2,10,11,12,10,11,8,8,10,7,7,11,11,6,12,8,11,11,10,10,11,12,15,12,5,10,11,13,15,15,13,10,9,8,14,13,20,14,11,11,8,13,7,12,18,13,11,11,11,10,19,6,Jules Iloki,Â£1.13m ,Ligue 1
19-06-17,18.3.4.28,NaÄm Sliti,85059261,51,27-Jul-92,24,13,3,0,0,3800,6100,6100,126,122,5586814,173,75,AM RLC,1,4,3,2,1,1,1,3,3,3,3,11,10,14,9,15,14,7,10,6,8,14,12,5,15,8,12,8,14,10,14,12,12,13,9,14,5,7,10,13,14,12,8,14,13,13,20,12,8,12,8,10,6,14,10,14,14,10,14,15,10,5,1,1,15,20,18,18,20,AM RLC,506,1,1,1,20,18,18,1,1,1,1,10,15,15,1,1,2252350000000000.0,0,0,0,0,0,0,0,1,0,0,0,0,0,0,0,0,0,0,0,0,0,0,0,0,0,0,0,0,0,0,0,0,0,0,0,0,0,0,0,1,0,0,0,0,0,0,0,0,NaÃ¯m Sliti,Â£6.30m ,28.0,173.0,Forward - Left Winger,right,Al-Ettifaq,20.0,1.0,2.0,1117.0,33.0,7.0,7.0,2369.0,42.0,10.0,10.0,2897.0,22.0,4.0,5.0,1645.0,2.0,1.0,0.0,82.0,Ligue 1,15-07-16,17.3.2.23,NaÄm Sliti,85059261,51,27-Jul-92,23,0,0,0,0,4243,6243,6243,135,125,8429428,173,75,AM RLC,2,3,1,4,4,2,1,3,2,3,1,11,10,16,9,15,14,7,10,6,8,14,12,5,15,8,10,8,15,10,14,15,12,13,9,14,5,7,10,14,14,12,8,15,13,12,20,9,8,12,8,8,6,14,12,15,15,10,18,15,10,5,NaÃ¯m Sliti,Â£1.58m ,Ligue 1
19-06-17,18.3.4.28,Bouna Sarr,85072773,22,31-Jan-92,25,0,0,0,0,3800,6300,6300,127,126,7413376,177,65,D/AM RL,4,1,3,2,2,3,4,2,2,1,2,8,11,13,10,13,8,10,11,7,5,12,13,8,13,8,11,9,10,9,9,10,12,12,5,13,8,7,10,16,15,12,8,10,15,15,20,14,11,12,8,13,7,12,10,14,13,13,9,9,11,10,16,1,10,20,20,15,12,D/AM RL,525,1,1,1,12,15,20,1,1,16,8,10,10,10,1,1,2251830000000000.0,0,0,0,0,0,0,0,0,0,0,0,0,0,0,0,0,0,0,0,0,0,0,0,0,0,0,0,0,0,0,0,0,0,0,0,1,0,0,0,0,0,0,0,0,0,0,0,0,Bouna Sarr,Â£5.40m ,28.0,177.0,Defender - Right-Back,right,Bayern Munich,29.0,1.0,2.0,1270.0,48.0,1.0,4.0,3109.0,37.0,1.0,1.0,2654.0,32.0,2.0,3.0,2535.0,5.0,0.0,3.0,271.0,Ligue 1,15-07-16,17.3.2.23,Bouna Sarr,85072773,22,31-Jan-92,24,0,0,0,0,4100,6250,6200,134,124,7108269,177,65,AM RL,1,2,1,2,2,2,2,4,1,3,2,8,11,13,10,13,8,10,11,7,5,12,13,6,13,8,11,9,10,9,9,11,13,12,5,12,8,7,9,16,15,12,8,10,15,15,20,14,12,11,8,13,7,12,7,14,13,13,9,8,11,10,Bouna Sarr,Â£1.80m ,Ligue 1
19-06-17,18.3.4.28,GaÃ«tan Laborde,85075725,769,03-May-94,23,0,0,0,0,4500,6050,6250,136,125,8400361,181,81,AM/S L,1,3,2,2,2,4,2,2,2,1,3,5,11,13,13,12,6,13,10,5,4,12,12,4,14,8,13,14,13,12,11,10,15,11,5,14,10,16,15,13,12,14,10,20,15,12,14,13,12,13,8,12,5,14,13,12,15,9,13,12,14,7,1,1,12,16,14,16,12,AM/S L,623,1,1,20,12,16,14,1,1,1,1,10,12,12,1,1,4398050000000.0,0,0,0,0,1,0,0,0,0,0,0,0,0,0,0,0,0,0,0,0,0,0,0,0,0,0,0,0,0,0,0,0,0,0,0,0,0,0,0,0,0,0,1,0,0,0,0,0,GaÃ«tan Laborde,Â£3.60m ,26.0,181.0,Forward - Centre-Forward,left,Montpellier HSC,42.0,13.0,5.0,2406.0,22.0,3.0,0.0,1080.0,42.0,13.0,5.0,3234.0,33.0,7.0,6.0,2668.0,8.0,2.0,4.0,689.0,Ligue 1,15-07-16,17.3.2.23,GaÃ«tan Laborde,85075725,769,03-May-94,22,0,0,0,0,3801,5945,6195,136,124,7533815,181,81,AM/S L,1,1,2,1,1,2,3,3,3,1,1,5,11,12,14,12,6,13,10,5,4,12,12,4,13,8,12,13,12,12,11,11,15,14,5,14,10,13,15,13,12,14,10,20,15,12,14,13,14,13,8,12,5,14,7,12,12,9,13,12,14,7,GaÃ«tan Laborde,Â£4.50m ,Ligue 1
19-06-17,18.3.4.28,Nicolas BÃ©nÃ©zet,85077805,769,24-Feb-91,26,0,0,0,0,3800,6200,6200,126,124,5949311,172,61,AM RLC,2,3,1,1,1,3,3,3,2,1,3,12,13,14,10,12,11,4,12,3,4,14,11,6,15,5,13,8,12,13,16,14,10,14,6,11,9,13,12,13,15,14,5,12,12,13,20,11,7,10,4,15,15,13,12,13,10,12,8,14,14,8,1,1,15,20,16,20,18,AM RLC,506,1,1,1,18,20,16,1,1,1,1,1,15,10,1,1,2251830000000000.0,0,0,0,0,0,0,0,0,0,0,0,0,0,0,0,0,0,0,0,0,0,0,0,0,0,0,0,0,0,0,0,0,0,0,0,1,0,0,0,0,0,0,0,0,0,0,0,0,Nicolas Benezet,Â£1.80m ,29.0,170.0,Forward - Left Winger,right,Colorado Rapids,7.0,2.0,1.0,210.0,30.0,3.0,4.0,1710.0,41.0,6.0,1.0,2687.0,8.0,0.0,1.0,295.0,nan,nan,nan,nan,Ligue 1,15-07-16,17.3.2.23,Nicolas BÃ©nÃ©zet,85077805,769,24-Feb-91,25,0,0,3,2,3600,5950,5950,125,119,1013313,170,61,AM RL,3,3,1,3,1,1,3,3,2,3,3,11,12,13,10,13,8,5,8,7,4,14,10,4,15,11,10,9,7,10,14,8,13,13,6,12,8,8,12,16,14,7,5,12,15,16,20,14,6,12,11,13,8,8,8,13,15,10,10,14,14,8,Nicolas Benezet,Â£1.80m ,Ligue 1
19-06-17,18.3.4.28,Thomas TourÃ©,85080148,24,27-Dec-93,23,1,0,0,0,3800,5950,5850,126,117,3288041,177,73,AM/S RL,3,2,2,1,1,2,2,1,3,3,1,12,13,14,10,14,12,10,14,2,5,13,14,7,15,12,10,6,11,8,8,9,7,15,8,13,8,5,8,15,15,14,8,8,10,14,20,13,11,10,9,11,12,12,8,14,13,12,8,9,8,12,1,1,10,16,15,16,1,AM/S RL,625,1,1,20,1,16,15,1,1,1,1,1,10,10,1,1,2251820000000000.0,0,0,0,0,0,0,0,0,1,0,0,0,0,0,0,0,0,0,0,0,0,1,0,0,0,0,0,0,0,0,0,0,0,0,1,0,0,0,0,0,0,0,0,0,0,0,0,0,Thomas TourÃ©,Â£1.35m ,26.0,175.0,Forward - Left Winger,right,SCO Angers,6.0,0.0,1.0,369.0,11.0,0.0,1.0,202.0,10.0,2.0,0.0,244.0,23.0,2.0,1.0,1231.0,4.0,0.0,0.0,336.0,Ligue 1,15-07-16,17.3.2.23,Thomas TourÃ©,85080148,24,27-Dec-93,22,1,0,0,0,3794,5944,5794,129,118,2755126,177,73,AM/S RL,3,3,3,3,3,2,1,2,3,2,2,12,13,14,10,14,12,10,14,2,5,13,14,7,15,12,10,6,10,7,8,8,7,15,8,13,8,5,8,16,15,14,8,8,10,15,20,12,11,8,9,11,12,12,16,13,13,12,6,9,6,14,Thomas TourÃ©,Â£1.35m ,Ligue 1
19-06-17,18.3.4.28,Karl Toko Ekambi,85085653,11,14-Sep-92,24,14,2,0,0,3850,6450,6450,130,129,10816215,185,70,AM/S L,2,1,3,3,3,1,2,3,2,2,1,5,8,12,13,13,7,14,11,5,5,9,13,5,13,6,13,10,12,12,11,11,13,13,7,13,9,8,12,16,12,14,12,8,14,15,20,14,13,12,7,15,7,7,13,14,13,10,12,15,15,7,1,1,12,17,12,17,1,AM/S L,623,1,1,20,1,17,12,1,1,1,1,1,1,12,1,1,16.0,0,0,0,0,1,0,0,0,0,0,0,0,0,0,0,0,0,0,0,0,0,0,0,0,0,0,0,0,0,0,0,0,0,0,0,0,0,0,0,0,0,0,0,0,0,0,0,0,Karl Toko Ekambi,Â£16.20m ,28.0,185.0,Forward - Centre-Forward,right,Olympique Lyon,33.0,8.0,5.0,2537.0,39.0,17.0,6.0,3148.0,43.0,18.0,7.0,2752.0,35.0,8.0,6.0,2123.0,7.0,4.0,1.0,527.0,Ligue 1,15-07-16,17.3.2.23,Karl Toko Ekambi,85085653,11,14-Sep-92,23,1,0,0,0,3511,6098,6098,131,122,6392067,185,70,S L,3,3,2,2,1,3,1,4,3,2,1,5,8,12,13,13,7,14,11,5,5,8,13,5,13,6,13,10,12,12,11,11,13,12,7,13,9,8,10,16,12,14,12,8,14,15,20,13,13,12,7,15,7,7,19,13,12,10,12,15,15,7,Karl Toko Ekambi,Â£2.25m ,Ligue 1
19-06-17,18.3.4.28,Thomas Lemar,85093001,769,12-Nov-95,21,5,0,9,1,6500,7550,7550,172,151,159233357,170,58,M/AM RLC,3,3,3,1,3,3,3,1,2,1,3,17,15,16,13,16,17,6,14,2,7,16,14,6,17,9,12,11,13,12,15,14,15,16,9,13,9,14,15,15,16,11,7,20,14,15,8,14,9,15,5,15,8,16,12,15,16,15,16,18,16,3,10,12,18,20,15,20,20,M/AM RLC,526,1,1,1,20,20,15,1,10,1,1,14,18,13,12,1,2252350000000000.0,0,0,0,1,0,0,0,0,1,0,0,0,0,0,0,0,0,0,0,0,0,0,0,0,0,0,0,0,0,0,0,0,0,0,0,0,0,0,0,1,0,0,0,0,0,0,0,0,Thomas Lemar,Â£58.50m ,24.0,171.0,Forward - Left Winger,left,AtlÃ©tico Madrid,55.0,14.0,18.0,4209.0,38.0,3.0,10.0,2874.0,43.0,3.0,6.0,2608.0,29.0,0.0,0.0,1177.0,4.0,0.0,0.0,133.0,Ligue 1,15-07-16,17.3.2.23,Thomas Lemar,85093001,769,12-Nov-95,20,0,0,7,1,6499,6799,7199,170,144,82360980,170,58,M/AM RLC,1,1,1,3,2,2,2,1,2,4,2,16,14,16,13,16,17,5,14,2,6,15,13,4,17,9,12,14,12,12,14,13,15,16,7,13,9,13,15,15,16,11,7,20,14,15,8,14,8,15,5,15,7,16,20,15,15,14,16,18,16,3,Thomas Lemar,Â£21.60m ,Ligue 1
19-06-17,18.3.4.28,Pierrick Capelle,85098947,769,15-Apr-87,30,0,0,0,0,3800,6250,6250,124,124,5675998,180,71,M/AM LC,3,1,2,1,2,3,2,3,3,2,1,10,11,12,9,13,11,8,14,6,8,11,10,8,12,10,11,12,12,9,12,11,14,12,7,12,10,12,14,15,14,12,10,20,16,13,12,15,12,12,10,15,7,8,20,12,12,13,14,15,15,6,12,12,20,16,1,16,20,M/AM LC,414,1,1,1,10,16,1,1,12,1,1,20,15,1,12,1,0.0,0,0,0,0,0,0,0,0,0,0,0,0,0,0,0,0,0,0,0,0,0,0,0,0,0,0,0,0,0,0,0,0,0,0,0,0,0,0,0,0,0,0,0,0,0,0,0,0,Pierrick Capelle,Â£900Th. ,33.0,181.0,Midfielder - Left Midfield,left,SCO Angers,35.0,4.0,1.0,1997.0,30.0,2.0,1.0,2029.0,28.0,3.0,3.0,1976.0,27.0,3.0,2.0,1974.0,7.0,0.0,2.0,411.0,Ligue 1,15-07-16,17.3.2.23,Pierrick Capelle,85098947,769,15-Apr-87,29,0,0,0,0,3506,6147,6147,123,123,3624817,180,71,M/AM LC,2,1,1,2,2,3,2,3,3,1,2,10,11,12,9,13,11,8,14,6,8,11,10,8,12,10,11,12,12,9,12,11,14,12,7,12,10,12,14,15,14,12,10,20,16,13,12,15,10,13,10,15,7,8,9,12,12,13,14,15,15,6,Pierrick Capelle,Â£900Th. ,Ligue 1
19-06-17,18.3.4.28,Opa Nguette,85099577,41,08-Jul-94,22,2,0,0,0,3500,5600,5600,127,111,2661777,181,73,AM RL,3,3,3,3,2,1,3,1,1,4,3,6,9,12,11,11,8,9,11,6,4,9,12,3,13,10,12,12,11,13,9,12,14,13,6,13,6,10,12,15,14,13,10,8,12,14,20,12,12,10,10,14,10,8,13,14,12,14,12,15,15,8,1,1,12,20,18,20,10,AM RL,505,1,1,12,10,20,18,1,1,1,1,1,12,10,1,1,2251830000000000.0,0,0,0,0,1,0,0,0,0,0,0,0,0,0,0,0,0,0,0,0,0,0,0,0,0,0,0,0,0,0,0,0,0,0,0,1,0,0,0,0,0,0,0,0,0,0,0,0,Opa Nguette,Â£1.80m ,26.0,182.0,Forward - Left Winger,right,FC Metz,37.0,3.0,3.0,2504.0,20.0,0.0,0.0,1207.0,36.0,7.0,2.0,2575.0,28.0,5.0,2.0,1933.0,8.0,1.0,0.0,585.0,Ligue 1,15-07-16,17.3.2.23,Opa Nguette,85099577,769,08-Jul-94,22,0,0,0,0,2795,5295,5295,131,106,1569935,181,73,AM RL,4,1,3,3,2,1,1,3,2,2,3,6,9,12,11,11,8,9,11,6,4,9,12,3,13,10,11,12,11,9,9,9,14,13,6,13,6,10,12,15,14,13,10,8,12,14,20,11,12,12,10,14,10,8,20,13,13,14,12,15,15,8,Opa Nguette,Â£1.80m ,Ligue 1
19-06-17,18.3.4.28,Bryan PelÃ©,85104270,769,25-Mar-92,25,0,0,0,0,3600,5800,5800,121,116,2445425,169,65,AM RL,1,2,2,3,3,2,1,2,3,3,3,13,13,12,7,13,11,5,10,6,3,11,12,5,13,7,12,9,13,11,13,12,12,12,6,13,6,13,15,14,14,12,6,20,12,13,10,12,8,12,7,14,8,8,9,13,16,11,11,11,19,2,1,1,14,20,17,20,1,AM RL,505,1,1,1,1,20,17,1,1,1,1,1,14,14,1,1,2251800000000000.0,0,0,0,0,0,0,0,0,0,0,0,0,0,0,0,0,0,0,0,0,0,0,0,0,0,0,0,0,0,0,0,0,0,0,0,0,0,0,0,0,0,0,0,0,0,0,0,0,Bryan PelÃ©,Â£900Th. ,28.0,169.0,Midfielder - Left Midfield,left,EA Guingamp,35.0,3.0,6.0,2419.0,34.0,2.0,3.0,1827.0,34.0,6.0,10.0,2720.0,29.0,7.0,4.0,1991.0,7.0,1.0,0.0,411.0,Ligue 1
19-06-17,18.3.4.28,Wesley SaÄd,85104577,769,19-Apr-95,22,0,0,1,0,3850,6050,6050,136,121,6521579,172,70,AM/S L,2,3,4,2,3,1,1,2,2,2,3,5,9,14,12,15,7,6,11,5,3,11,12,4,15,7,12,9,11,9,10,11,11,16,6,14,5,8,9,15,16,12,7,12,13,14,20,13,11,12,7,2,12,12,9,12,14,11,12,16,16,5,1,1,14,17,10,17,1,AM/S L,623,1,1,20,1,17,10,1,1,1,1,1,14,1,1,1,2251830000000000.0,0,0,0,0,1,0,0,0,0,0,0,0,0,0,0,0,0,0,0,0,0,0,0,0,0,0,0,0,0,0,0,0,0,0,0,1,0,0,0,0,0,0,0,0,0,0,0,0,Wesley SaÃ¯d,Â£5.40m ,25.0,171.0,Forward - Centre-Forward,right,FC Toulouse,29.0,6.0,0.0,1335.0,31.0,9.0,4.0,1992.0,42.0,8.0,2.0,2752.0,24.0,2.0,1.0,1198.0,nan,nan,nan,nan,Ligue 1,15-07-16,17.3.2.23,Wesley SaÄd,85104577,769,19-Apr-95,21,0,0,0,0,3707,5449,6049,139,119,5894296,172,70,AM/S L,2,2,1,2,2,2,3,1,1,1,2,5,7,14,12,14,7,6,11,5,3,12,12,4,15,7,12,9,12,10,10,11,12,16,6,14,5,9,9,14,16,14,7,12,13,15,20,13,12,11,7,3,12,12,18,12,14,11,13,16,16,5,Wesley SaÃ¯d,Â£1.35m ,Ligue 1
19-06-17,18.3.4.28,Farid Boulaya,85116898,5,25-Feb-93,24,0,0,0,0,3000,5750,5750,121,115,1752492,180,65,AM RLC,3,3,1,1,2,1,4,2,3,3,2,10,13,13,10,14,11,10,12,6,3,12,6,6,14,7,12,8,12,11,13,12,11,12,6,13,5,8,7,12,15,8,10,12,11,14,20,12,8,12,10,11,14,11,10,12,10,10,12,9,12,5,1,1,15,20,15,19,20,AM RLC,506,1,1,1,20,19,15,1,1,1,1,15,10,10,1,1,34359738368.0,0,0,0,0,0,0,0,0,0,0,0,0,0,0,0,0,0,0,0,0,0,0,0,0,0,0,0,0,0,0,0,0,0,0,0,1,0,0,0,0,0,0,0,0,0,0,0,0,Farid Boulaya,Â£360Th. ,27.0,180.0,Forward - Right Winger,right,FC Metz,2.0,0.0,0.0,18.0,10.0,0.0,2.0,440.0,42.0,6.0,7.0,2880.0,20.0,2.0,1.0,909.0,6.0,1.0,1.0,518.0,LaLiga,15-07-16,17.3.2.23,Farid Boulaya,85116898,5,25-Feb-93,23,0,0,0,0,3250,5700,5650,130,114,2386708,180,65,AM RLC,1,2,3,1,3,4,2,3,1,3,3,10,13,13,12,14,11,10,12,6,3,12,9,6,14,7,10,8,10,12,13,12,4,12,6,13,5,8,7,12,15,7,10,12,11,14,20,12,8,12,11,11,11,11,14,11,12,12,12,6,17,1,Farid Boulaya,Â£720Th. ,Ligue 1
19-06-17,18.3.4.28,Maxwel Cornet,85117459,24,27-Sep-96,20,2,0,0,0,4000,6500,6500,145,130,19931884,180,69,AM/S RL,2,3,2,2,3,3,3,3,2,1,2,10,11,11,13,11,10,10,10,5,7,11,10,7,11,8,11,12,9,9,10,8,14,12,6,14,9,14,14,16,13,13,10,20,15,16,10,15,13,11,8,11,7,15,20,13,13,10,13,14,14,6,1,1,1,20,19,20,1,AM/S RL,515,1,1,18,1,20,19,1,1,1,1,1,1,1,1,1,2251800000000000.0,0,0,0,0,0,0,0,0,0,0,0,0,0,0,0,0,0,0,0,0,0,0,0,0,0,0,0,0,0,0,0,0,0,0,0,0,0,0,0,0,0,0,0,0,0,0,0,0,Maxwel Cornet,Â£13.50m ,24.0,179.0,Forward - Left Winger,left,Olympique Lyon,51.0,10.0,3.0,3002.0,43.0,7.0,8.0,2001.0,36.0,12.0,5.0,1692.0,38.0,6.0,5.0,2546.0,8.0,0.0,0.0,611.0,Ligue 1,15-07-16,17.3.2.23,Maxwel Cornet,85117459,769,27-Sep-96,19,0,0,3,1,4002,6350,6350,149,127,16019110,181,69,AM/S L,1,1,1,2,2,2,3,1,3,3,3,10,10,12,12,12,7,8,11,5,7,10,10,7,11,8,10,10,12,8,11,8,14,13,6,14,8,13,13,16,14,13,9,20,15,16,10,15,13,12,8,11,7,12,13,14,15,10,12,14,14,6,Maxwel Cornet,Â£9.00m ,Ligue 1
19-06-17,18.3.4.28,Roli Pereira de Sa,85121088,769,10-Dec-96,20,0,0,0,0,2250,4700,4700,120,94,546293,177,71,M LC,2,1,3,2,2,2,1,2,1,2,1,6,7,11,8,11,8,6,11,6,9,11,5,9,13,13,10,12,10,9,10,9,9,13,8,12,6,8,9,13,14,12,8,20,12,15,7,12,10,8,4,14,5,10,8,10,10,9,10,9,11,6,1,1,20,15,10,15,20,M LC,404,1,1,7,12,15,10,1,1,1,10,20,1,1,1,1,0.0,0,0,0,0,0,0,0,0,0,0,0,0,0,0,0,0,0,0,0,0,0,0,0,0,0,0,0,0,0,0,0,0,0,0,0,0,0,0,0,0,0,0,0,0,0,0,0,0,nan,nan,nan,nan,nan,nan,nan,nan,nan,nan,nan,nan,nan,nan,nan,nan,nan,nan,nan,nan,nan,nan,nan,nan,nan,nan,nan,nan,
19-06-17,18.3.4.28,Flavien Tait,85121618,769,02-Feb-93,24,0,0,0,0,3250,5750,5750,124,115,2083082,175,70,AM LC,2,2,3,3,4,2,3,2,1,3,2,9,11,12,9,13,8,6,13,7,5,13,10,6,13,7,13,9,13,11,13,12,13,12,10,12,10,13,12,11,12,13,8,8,14,12,20,14,12,13,9,9,10,11,16,12,14,10,14,11,10,7,1,1,13,20,14,15,20,AM LC,504,1,1,1,20,15,14,1,1,1,1,13,12,12,1,1,0.0,0,0,0,0,0,0,0,0,0,0,0,0,0,0,0,0,0,0,0,0,0,0,0,0,0,0,0,0,0,0,0,0,0,0,0,0,0,0,0,0,0,0,0,0,0,0,0,0,Flavien Tait,Â£4.50m ,27.0,175.0,Forward - Left Winger,right,Stade Rennais FC,16.0,2.0,4.0,634.0,34.0,4.0,4.0,2519.0,37.0,5.0,9.0,3071.0,26.0,2.0,4.0,1673.0,8.0,0.0,1.0,393.0,Ligue 1,15-07-16,17.3.2.23,Flavien Tait,85121618,769,02-Feb-93,23,0,0,0,0,3002,5500,5500,121,110,1646322,175,70,AM LC,3,3,1,2,1,3,3,4,3,1,2,11,11,12,9,13,8,6,13,10,5,13,10,6,13,7,13,9,13,11,13,12,13,12,10,12,10,13,12,11,12,13,8,8,14,12,20,14,12,13,9,9,10,11,15,12,14,12,13,9,20,7,Flavien Tait,Â£630Th. ,Ligue 1
19-06-17,18.3.4.28,Adama Diakhaby,85121813,769,05-Jul-96,20,0,0,2,0,5500,6300,6300,147,126,13312192,188,74,AM/S RL,3,1,2,3,3,2,1,3,1,1,2,6,12,14,12,13,8,13,10,3,4,12,12,4,14,8,11,11,12,9,11,11,13,13,7,14,7,12,12,15,13,12,16,20,13,15,9,12,10,11,7,12,8,13,17,13,12,12,13,16,15,6,1,1,14,17,16,17,1,AM/S RL,625,1,1,20,1,17,16,1,1,1,1,1,14,13,1,1,549756000000.0,1,0,0,0,1,0,0,0,0,0,0,0,0,0,0,0,0,0,0,0,0,0,0,0,0,0,0,0,0,0,0,0,0,0,0,0,0,0,0,1,0,0,0,0,0,0,0,0,Adama Diakhaby,Â£4.50m ,24.0,184.0,Forward - Left Winger,left,Huddersfield Town,29.0,5.0,0.0,963.0,30.0,3.0,3.0,1250.0,13.0,0.0,0.0,624.0,32.0,0.0,3.0,1208.0,6.0,0.0,0.0,226.0,Ligue 1,15-07-16,17.3.2.23,Adama Diakhaby,85121813,769,05-Jul-96,20,0,0,0,0,3349,5299,5949,135,116,5215081,185,65,AM/S RL,1,3,3,2,3,3,1,2,1,1,2,4,12,12,9,11,8,12,10,6,4,10,12,6,13,8,11,11,11,11,10,11,11,13,7,13,7,11,13,14,12,14,14,20,13,15,8,12,8,11,8,12,8,11,13,12,9,13,12,11,19,2,Adama Diakhaby,Â£1.35m ,Ligue 1
19-06-17,18.3.4.28,Jordan Amavi,85126966,769,09-Mar-94,23,0,0,3,0,5250,6800,6800,145,136,19862028,176,70,D/WB L,1,3,3,2,1,4,2,1,2,1,4,5,14,13,6,13,5,13,10,9,9,13,8,12,14,10,13,12,13,14,10,13,14,12,8,14,13,14,15,14,13,12,10,20,14,15,10,15,13,13,10,13,8,10,10,15,14,11,15,14,13,7,20,17,15,15,1,20,1,D/WB L,113,1,1,1,1,15,1,1,20,1,1,1,15,1,17,1,1.0,1,0,0,0,0,0,0,0,0,0,0,0,0,0,0,0,0,0,0,0,0,0,0,0,0,0,0,0,0,0,0,0,0,0,0,0,0,0,0,0,0,0,0,0,0,0,0,0,Jordan Amavi,Â£14.40m ,26.0,176.0,Defender - Left-Back,left,Olympique Marseille,36.0,0.0,1.0,2679.0,43.0,1.0,7.0,3465.0,33.0,0.0,2.0,2637.0,29.0,1.0,1.0,2432.0,6.0,1.0,0.0,540.0,Ligue 1
19-06-17,18.3.4.28,Adrien Thomasson,85128018,769,10-Dec-93,23,0,0,0,0,4300,6400,6400,139,128,8898530,177,72,M LC,1,2,3,3,2,1,1,2,4,2,2,9,12,13,11,12,10,12,12,11,10,13,11,11,13,11,12,12,12,9,14,12,4,12,11,14,11,13,14,15,13,12,9,8,15,14,20,13,13,11,6,12,7,12,11,14,13,10,11,10,10,4,1,1,20,14,14,18,20,M LC,404,1,1,1,13,12,14,1,1,1,13,20,18,12,1,1,0.0,0,0,0,0,0,0,0,0,0,0,0,0,0,0,0,0,0,0,0,0,0,0,0,0,0,0,0,0,0,0,0,0,0,0,0,0,0,0,0,0,0,0,0,0,0,0,0,0,Adrien Thomasson,Â£7.20m ,26.0,177.0,Midfielder - Attacking Midfield,left,RC Strasbourg Alsace,33.0,3.0,2.0,2211.0,38.0,7.0,4.0,2770.0,38.0,5.0,8.0,2827.0,32.0,10.0,3.0,2529.0,8.0,0.0,0.0,420.0,Ligue 1,15-07-16,17.3.2.23,Adrien Thomasson,85128018,769,10-Dec-93,22,0,0,0,0,4295,6345,6345,139,127,11095960,177,72,M LC,2,3,2,1,3,3,3,2,2,1,1,11,12,13,11,12,10,12,12,4,10,13,11,11,13,11,12,11,11,9,13,12,9,12,5,14,12,12,13,16,13,12,9,8,15,14,20,14,13,10,11,11,11,12,13,11,11,10,9,10,12,4,Adrien Thomasson,Â£2.25m ,Ligue 1
19-06-17,18.3.4.28,James LÃ©a-Siliki,85128158,769,12-Jun-96,21,0,0,0,0,3250,5750,5750,130,115,3515507,183,70,M/AM LC,1,2,2,3,1,3,4,2,3,3,2,11,13,13,8,11,8,9,11,6,12,12,7,13,14,11,13,7,10,11,12,12,11,12,8,13,12,10,11,14,14,12,12,20,13,12,8,12,8,11,8,12,7,14,18,12,11,12,11,10,16,3,1,10,20,18,1,18,20,M/AM LC,414,1,1,1,12,18,1,1,1,1,10,20,18,1,10,1,1.0,1,0,0,0,0,0,0,0,0,0,0,0,0,0,0,0,0,0,0,0,0,0,0,0,0,0,0,0,0,0,0,0,0,0,0,0,0,0,0,0,0,0,0,0,0,0,0,0,James LÃ©a Siliki,Â£4.50m ,24.0,183.0,Midfielder - Central Midfield,left,Stade Rennais FC,2.0,0.0,0.0,29.0,37.0,4.0,3.0,2147.0,34.0,0.0,4.0,1714.0,29.0,1.0,0.0,1674.0,0.0,0.0,0.0,0.0,Ligue 1
19-06-17,18.3.4.28,Dimitri LiÃ©nard,85128265,769,13-Feb-88,29,0,0,0,0,3600,6200,6200,127,124,6320343,181,77,M/AM LC,2,2,1,3,3,1,2,1,4,2,3,15,14,12,9,13,16,7,14,7,7,13,12,8,13,10,13,12,13,14,12,12,14,12,10,12,10,15,14,13,13,12,10,20,14,12,8,14,13,14,11,13,8,15,9,13,16,14,14,11,15,4,1,1,20,19,7,19,20,M/AM LC,414,1,1,7,13,19,7,1,1,1,1,20,15,1,1,1,0.0,0,0,0,0,0,0,0,0,0,0,0,0,0,0,0,0,0,0,0,0,0,0,0,0,0,0,0,0,0,0,0,0,0,0,0,0,0,0,0,0,0,0,0,0,0,0,0,0,Dimitri LiÃ©nard,Â£1.80m ,32.0,184.0,Midfielder - Central Midfield,left,RC Strasbourg Alsace,33.0,5.0,11.0,2653.0,38.0,5.0,6.0,2935.0,28.0,1.0,3.0,1739.0,30.0,2.0,4.0,2036.0,6.0,0.0,1.0,267.0,Ligue 1
19-06-17,18.3.4.28,Isaac Mbenza,85131331,757,08-Mar-96,21,0,0,0,0,3256,5311,5950,134,119,5116505,188,77,AM/S L,2,2,1,3,3,3,3,2,3,2,2,5,12,15,13,12,8,11,14,6,4,13,10,4,13,14,12,14,13,12,12,14,15,13,7,13,7,8,12,15,14,12,14,4,15,14,20,11,12,12,7,14,4,11,16,14,11,10,9,10,10,2,1,1,12,20,13,20,1,AM/S L,513,1,1,17,1,20,13,1,1,1,1,1,12,1,1,1,2251800000000000.0,0,0,0,0,0,0,0,0,0,0,0,0,0,0,0,0,0,0,0,0,0,0,0,0,0,0,0,0,0,0,0,0,0,0,0,0,0,0,0,0,0,0,0,0,0,0,0,0,Isaac Mbenza,Â£3.15m ,24.0,188.0,Forward - Left Winger,right,Huddersfield Town,43.0,4.0,1.0,1680.0,43.0,10.0,2.0,2438.0,24.0,1.0,1.0,1086.0,9.0,0.0,0.0,358.0,8.0,0.0,0.0,481.0,Ligue 1,15-07-16,17.3.2.23,Isaac Mbenza,85131331,757,08-Mar-96,20,0,0,0,0,1500,5300,5750,132,112,4025864,188,81,AM/S L,3,1,2,2,2,2,3,3,2,3,2,5,12,12,12,12,8,11,8,6,4,13,8,4,13,14,12,14,9,12,12,10,15,13,7,13,7,8,12,14,13,12,14,9,15,14,20,11,12,12,5,14,4,11,19,14,10,10,9,10,10,8,Isaac Mbenza,Â£1.35m ,Ligue 1
19-06-17,18.3.4.28,Allan Saint-Maximin,85132406,769,12-Mar-97,20,0,0,0,0,5450,6400,6400,149,128,19450445,173,67,AM RL,2,1,4,2,3,2,2,1,3,3,2,13,12,15,10,14,11,6,12,4,2,11,12,4,14,7,12,9,11,8,10,9,10,17,5,14,4,9,9,17,16,12,7,8,14,16,20,13,9,12,6,12,6,15,8,13,10,11,10,14,14,8,1,1,15,20,20,19,13,AM RL,505,1,1,14,13,19,20,1,1,1,1,1,12,15,1,1,1.44115e+17,0,0,0,0,0,0,0,0,0,0,0,0,0,0,0,0,0,0,0,0,0,0,0,0,0,0,0,0,0,0,0,0,0,0,0,1,0,0,0,0,0,0,0,0,0,0,0,0,Allan Saint-Maximin,Â£18.00m ,23.0,173.0,Forward - Left Winger,right,Newcastle United,36.0,3.0,3.0,2842.0,40.0,5.0,9.0,2988.0,36.0,6.0,5.0,3046.0,30.0,4.0,7.0,2182.0,6.0,1.0,1.0,367.0,Ligue 1,15-07-16,17.3.2.23,Allan Saint-Maximin,85132406,769,12-Mar-97,19,0,0,0,0,4300,5950,6200,146,122,11914143,173,67,M/AM RLC,1,3,1,2,1,1,2,3,3,3,1,13,13,15,10,14,11,6,12,4,4,12,11,5,14,10,12,9,10,8,12,8,11,15,5,12,6,8,10,16,15,13,7,8,13,15,20,11,9,12,6,12,6,15,8,13,8,12,9,14,13,9,Allan Saint-Maximin,Â£2.70m ,Ligue 1
19-06-17,18.3.4.28,Harrison Manzala,85133709,53,06-Mar-94,23,0,0,4,2,3450,5950,5950,124,119,3718206,177,71,AM RL,2,2,3,1,3,2,2,3,3,1,3,6,13,16,13,13,10,9,12,5,4,13,10,4,13,7,12,10,11,8,10,11,12,14,5,13,8,10,10,16,14,10,11,8,13,14,20,10,11,14,7,11,9,8,12,14,10,10,12,14,10,6,1,1,14,20,20,18,12,AM RL,505,1,1,10,12,18,20,1,1,1,1,1,14,14,1,1,2251830000000000.0,0,0,0,0,0,0,0,0,0,0,0,0,0,0,0,0,0,0,0,0,0,0,0,0,0,0,0,0,0,0,0,0,0,0,0,1,0,0,0,0,0,0,0,0,0,0,0,0,Harrison Manzala,Â£1.35m ,26.0,177.0,Forward - Right Winger,right,Kayserispor,19.0,5.0,3.0,1119.0,38.0,4.0,3.0,1935.0,18.0,0.0,1.0,696.0,17.0,3.0,2.0,1105.0,nan,nan,nan,nan,Ligue 1
19-06-17,18.3.4.28,Kylian MbappÃ©,85139014,769,20-Dec-98,18,4,0,0,0,7500,7800,8050,190,156,189734458,178,68,AM/S RL,3,1,3,2,3,2,2,2,4,2,2,11,12,17,14,15,12,8,12,2,3,13,15,3,17,10,12,12,14,12,13,13,14,18,8,17,5,13,12,18,16,12,9,9,14,17,20,12,10,15,7,15,6,14,14,18,12,15,16,15,16,6,1,1,10,20,20,15,1,AM/S RL,515,1,1,20,1,15,20,1,1,1,1,1,10,10,1,1,2252380000000000.0,0,0,0,1,0,0,0,0,0,0,0,1,0,0,0,0,0,0,0,0,0,0,0,0,0,0,0,0,0,0,0,0,0,0,0,1,0,0,0,1,0,0,0,0,0,0,0,0,Kylian MbappÃ©,Â£108.00m ,21.0,178.0,Forward - Left Winger,right,Paris Saint-Germain,44.0,26.0,14.0,2663.0,46.0,21.0,15.0,3554.0,43.0,39.0,17.0,3504.0,37.0,30.0,19.0,2718.0,6.0,6.0,4.0,450.0,Ligue 1,15-07-16,17.3.2.23,Kylian MbappÃ©,85139014,769,20-Dec-98,17,0,0,0,0,5200,5800,6250,165,116,15341930,178,68,AM RL,1,1,1,3,4,2,2,2,3,2,3,10,11,15,12,13,10,8,9,2,3,12,12,3,16,11,9,11,12,9,12,10,17,17,9,13,5,9,13,15,14,11,9,8,14,14,20,12,9,14,7,15,7,13,16,19,12,16,15,14,14,7,Kylian MbappÃ©,Â£31.50m ,Ligue 1
19-06-17,18.3.4.28,Arnaud Lusamba,85140186,769,04-Jan-97,20,0,0,0,0,3750,5750,5750,131,115,3479974,179,67,AM LC,1,2,1,3,2,1,3,2,3,3,2,10,12,14,12,13,7,9,11,5,8,13,8,10,14,10,11,10,11,12,12,10,2,12,7,13,8,11,10,14,13,14,10,7,12,14,20,12,10,12,10,14,5,12,9,13,10,10,11,14,14,1,1,1,15,20,14,17,20,AM LC,504,1,1,10,20,17,14,1,1,1,1,15,12,10,1,1,0.0,0,0,0,0,0,0,0,0,0,0,0,0,0,0,0,0,0,0,0,0,0,0,0,0,0,0,0,0,0,0,0,0,0,0,0,0,0,0,0,0,0,0,0,0,0,0,0,0,Arnaud Lusamba,Â£1.80m ,23.0,180.0,Midfielder - Central Midfield,right,Amiens SC,9.0,0.0,1.0,442.0,7.0,0.0,1.0,283.0,25.0,0.0,1.0,2118.0,15.0,1.0,2.0,984.0,nan,nan,nan,nan,Ligue 1,15-07-16,17.3.2.23,Arnaud Lusamba,85140186,769,04-Jan-97,19,0,0,0,0,3250,5450,5900,143,118,5639475,179,67,AM RLC,1,3,3,1,3,3,1,1,2,1,3,10,12,14,12,14,7,9,11,5,9,13,8,10,14,10,10,6,11,12,13,12,10,12,7,13,11,11,11,14,13,14,10,6,12,14,20,12,10,12,10,14,5,8,15,13,12,10,12,14,14,7,Arnaud Lusamba,Â£1.80m ,Ligue 1
19-06-17,18.3.4.28,FodÃ© Ballo-TourÃ©,85140284,769,03-Jan-97,20,0,0,0,0,2000,4900,4900,134,98,643399,178,64,D/WB L,2,1,3,2,2,2,2,2,1,1,2,10,11,11,6,11,7,5,8,6,8,10,6,11,12,8,10,7,9,11,10,9,14,12,5,13,8,12,13,13,12,12,9,20,14,14,7,12,9,9,8,10,5,10,11,14,12,13,10,14,12,2,20,17,14,15,1,20,1,D/WB L,113,1,1,1,1,15,1,1,20,1,1,1,14,1,17,1,1099510000000.0,1,0,0,0,0,0,0,0,0,0,0,0,0,0,0,0,0,0,0,0,0,0,0,0,0,0,0,0,0,0,0,0,0,0,0,0,0,0,0,0,1,0,0,0,0,0,0,0,FodÃ© Ballo-TourÃ©,Â£1.80m ,23.0,182.0,Defender - Left-Back,left,AS Monaco,6.0,0.0,1.0,540.0,29.0,0.0,0.0,2267.0,38.0,0.0,5.0,3400.0,25.0,0.0,0.0,1946.0,3.0,0.0,1.0,270.0,Ligue 1
19-06-17,18.3.4.28,Marcus Coco,85142872,769,24-Jun-96,20,0,0,8,0,3800,6250,6250,140,124,13063041,180,75,AM RL,3,2,3,2,1,4,3,2,3,2,2,8,12,14,10,11,7,10,13,7,6,12,11,6,12,8,10,11,12,10,10,11,13,12,6,13,7,13,15,16,12,12,11,8,15,15,20,13,14,12,10,14,6,13,12,14,11,12,14,12,20,4,1,1,15,20,20,19,1,AM RL,505,1,1,7,1,19,20,1,1,1,1,1,14,15,1,1,134217729.0,1,0,0,0,0,0,0,0,0,0,0,0,0,0,0,0,0,0,0,0,0,0,0,0,0,0,0,1,0,0,0,0,0,0,0,0,0,0,0,0,0,0,0,0,0,0,0,0,Marcus Coco,Â£2.70m ,24.0,184.0,Forward - Right Winger,right,FC Nantes,40.0,4.0,3.0,2960.0,32.0,3.0,2.0,1836.0,40.0,1.0,4.0,2518.0,1.0,0.0,0.0,15.0,6.0,0.0,1.0,305.0,Ligue 1,15-07-16,17.3.2.23,Marcus Coco,85142872,769,24-Jun-96,20,0,0,2,0,4100,6300,6400,149,128,18793677,180,75,M/AM RL,2,2,4,3,2,3,3,3,3,2,4,8,13,14,9,13,8,10,9,6,5,12,6,5,14,8,13,12,13,12,12,12,10,13,8,14,7,12,13,15,13,14,10,8,14,15,20,13,12,13,11,10,7,13,12,11,9,11,10,9,17,8,Marcus Coco,Â£2.70m ,Ligue 1
19-06-17,18.3.4.28,Jean-Luc DompÃ©,85144028,769,12-Aug-95,21,0,0,0,0,3450,5550,5550,130,111,2768472,174,65,AM RL,1,2,1,2,3,2,3,1,2,2,2,10,12,13,9,11,13,8,11,6,3,9,6,4,14,8,9,8,10,9,9,10,14,13,5,11,10,14,13,15,13,11,7,8,13,14,20,13,12,12,9,11,9,11,8,12,12,8,10,8,7,13,1,1,14,20,17,20,1,AM RL,505,1,1,1,1,20,17,1,1,1,1,1,14,13,1,1,34359738369.0,1,0,0,0,0,0,0,0,0,0,0,0,0,0,0,0,0,0,0,0,0,0,0,0,0,0,0,0,0,0,0,0,0,0,0,1,0,0,0,0,0,0,0,0,0,0,0,0,Jean-Luc DompÃ©,Â£675Th. ,25.0,170.0,Forward - Left Winger,right,SV Zulte Waregem,12.0,0.0,2.0,554.0,1.0,0.0,0.0,28.0,32.0,4.0,7.0,1892.0,17.0,1.0,3.0,486.0,8.0,2.0,1.0,406.0,Ligue 1
19-06-17,18.3.4.28,Jonathan IkonÃ©,85145148,769,02-May-98,19,0,0,1,0,3500,5750,5750,150,115,4778837,175,67,AM/S RL,1,3,2,3,2,2,2,1,3,2,3,9,9,14,12,13,11,9,13,7,8,9,8,4,14,8,10,12,10,9,10,14,11,14,5,11,7,9,9,14,15,12,9,20,14,14,8,11,9,12,5,12,6,11,19,12,11,12,12,11,10,4,1,1,1,20,20,18,1,AM/S RL,515,1,1,20,1,18,20,1,1,1,1,1,1,1,1,1,2252380000000000.0,0,0,0,0,0,0,0,0,0,0,0,0,0,0,0,0,0,0,0,0,1,0,0,0,0,0,0,0,0,0,0,0,0,0,0,1,0,0,0,1,0,0,0,0,0,0,0,0,Jonathan IkonÃ©,Â£630Th. ,22.0,175.0,Midfielder - Attacking Midfield,left,LOSC Lille,25.0,3.0,1.0,1222.0,23.0,2.0,1.0,1308.0,41.0,3.0,10.0,3006.0,36.0,4.0,7.0,2649.0,9.0,2.0,0.0,483.0,Ligue 1,15-07-16,17.3.2.23,Jonathan IkonÃ©,85145148,769,02-May-98,18,0,0,0,0,2702,5200,5700,144,104,4499008,175,67,AM RL,4,3,3,1,2,2,1,1,2,3,2,9,9,14,10,13,11,7,12,7,4,9,7,4,14,8,10,12,10,9,9,10,11,14,5,11,7,9,10,13,15,12,9,20,14,14,8,11,9,11,10,12,6,9,11,12,12,12,12,11,11,8,Jonathan IkonÃ©,Â£630Th. ,Ligue 1
19-06-17,18.3.4.28,Julien Ielsch,915404,769,05-Mar-83,34,0,0,0,0,3000,5300,5300,115,106,81175,172,66,D/WB/M L,4,2,1,1,1,1,1,3,2,1,3,11,11,9,5,10,12,7,11,12,12,12,6,11,10,14,14,18,12,13,9,12,16,8,12,10,13,14,16,11,14,11,6,20,12,12,5,12,7,14,14,13,9,12,12,12,14,13,15,11,12,7,20,18,17,1,13,20,10,D/WB/M L,123,1,1,1,1,1,1,10,20,13,15,1,17,13,18,13,1.0,1,0,0,0,0,0,0,0,0,0,0,0,0,0,0,0,0,0,0,0,0,0,0,0,0,0,0,0,0,0,0,0,0,0,0,0,0,0,0,0,0,0,0,0,0,0,0,0,Julien Ielsch,Â£225Th. ,37.0,173.0,Defender - Left-Back,left,Retired,23.0,1.0,1.0,1373.0,15.0,1.0,0.0,963.0,nan,nan,nan,nan,nan,nan,nan,nan,nan,nan,nan,nan,Ligue 1
19-06-17,18.3.4.28,Chaouki Ben Saada,918393,51,01-Jul-84,32,38,5,0,0,3500,5000,5450,115,109,483160,176,72,AM RLC,3,2,2,3,2,1,2,1,1,1,2,12,12,13,8,13,13,7,12,5,2,13,12,3,14,6,12,8,11,10,13,10,11,15,5,11,6,11,10,13,13,12,8,20,11,13,10,12,12,11,6,14,12,10,11,10,16,15,13,17,17,5,1,1,13,20,20,17,18,AM RLC,506,1,1,1,18,17,20,1,1,1,1,10,13,13,1,1,34360786948.0,0,0,1,0,0,0,0,0,0,0,0,0,0,0,0,0,0,0,0,0,1,0,0,0,0,0,0,0,0,0,0,0,0,0,0,1,0,0,0,0,0,0,0,0,0,0,0,0,Chaouki Ben Saada,Â£450Th. ,36.0,176.0,Midfielder - Attacking Midfield,left,SC Bastia,35.0,5.0,1.0,1844.0,17.0,0.0,0.0,419.0,11.0,1.0,0.0,354.0,5.0,0.0,0.0,350.0,3.0,0.0,0.0,134.0,Ligue 1
19-06-17,18.3.4.28,Serge GakpÃ©,919971,50,07-May-87,30,45,4,6,1,3900,6200,6200,127,124,232186002,176,75,M/AM RL,1,2,3,3,1,1,2,3,1,2,3,10,13,14,11,14,11,9,12,6,3,12,8,3,14,6,11,10,10,11,11,12,12,12,5,13,6,11,12,15,14,13,8,10,12,14,20,13,12,12,6,13,11,10,10,14,14,13,13,15,15,6,1,1,16,20,20,18,10,M/AM RL,525,1,1,14,10,18,20,1,1,1,1,1,14,16,1,1,2251800000000000.0,0,0,0,0,0,0,0,0,0,0,0,0,0,0,0,0,0,0,0,0,0,0,0,0,0,0,0,0,0,0,0,0,0,0,0,0,0,0,0,0,0,0,0,0,0,0,0,0,Serge GakpÃ©,Â£810Th. ,33.0,176.0,Forward - Right Winger,right,Apollon Limassol,16.0,1.0,1.0,653.0,30.0,3.0,1.0,1927.0,27.0,6.0,1.0,1540.0,21.0,8.0,1.0,1248.0,2.0,0.0,0.0,58.0,Ligue 1,15-07-16,17.3.2.23,Serge GakpÃ©,919971,50,07-May-87,29,38,4,6,1,4900,6150,6150,127,122,2228565,176,75,M/AM RL,1,2,2,3,3,2,3,2,1,1,1,10,11,14,11,14,11,9,12,6,3,12,8,3,14,6,11,10,10,11,11,12,12,12,5,13,6,11,12,15,14,13,10,10,12,14,20,13,13,12,6,13,11,10,7,14,14,13,13,15,15,6,Serge GakpÃ©,Â£810Th. ,Serie A
19-06-17,18.3.4.28,Julian Draxler,92030193,771,20-Sep-93,23,35,5,1,1,6500,7900,7700,169,154,166790018,187,75,M/AM RLC,1,3,2,3,3,2,1,2,4,3,1,13,13,16,14,17,10,9,17,8,6,14,10,8,16,10,12,8,13,10,15,12,11,15,7,14,8,13,12,15,14,10,16,17,12,13,20,14,11,10,5,15,12,16,12,17,8,10,16,12,14,13,1,1,20,20,19,20,16,M/AM RLC,416,1,1,1,16,20,19,1,1,1,1,15,20,15,1,1,141322000000000.0,0,0,0,0,0,0,0,0,0,0,0,0,0,0,0,0,0,0,0,0,0,0,0,0,0,0,0,0,0,0,0,0,0,0,0,1,0,0,0,1,0,0,0,0,0,0,0,1,Julian Draxler,Â£31.50m ,27.0,187.0,Midfielder - Attacking Midfield,right,Paris Saint-Germain,39.0,10.0,5.0,2721.0,47.0,5.0,10.0,2630.0,46.0,5.0,12.0,2977.0,22.0,0.0,7.0,1194.0,6.0,2.0,0.0,400.0,Ligue 1,15-07-16,17.3.2.23,Julian Draxler,92030193,771,20-Sep-93,22,24,2,1,1,7350,7850,7850,169,152,137467434,187,75,M/AM RLC,1,3,1,3,3,3,2,3,3,2,3,13,13,16,13,17,10,9,17,8,6,14,10,8,16,10,12,9,12,10,15,11,10,15,7,13,8,12,11,15,14,10,16,18,12,13,20,14,11,8,5,15,12,13,11,17,8,10,16,12,14,13,Julian Draxler,Â£31.50m ,Bundesliga
19-06-17,18.3.4.28,Milot Rashica,11024791,217945,28-Jun-96,20,6,0,0,0,4900,6400,6400,140,128,14511168,177,73,M/AM RL,2,3,2,1,2,1,2,2,1,1,2,11,15,15,11,12,9,6,10,7,5,11,9,5,13,13,10,10,8,12,11,9,12,14,7,11,6,12,13,17,16,10,8,10,13,15,20,13,7,13,6,12,6,8,16,16,9,11,13,14,14,10,1,1,20,20,20,16,14,M/AM RL,415,1,1,8,14,16,20,1,1,1,1,1,16,20,1,1,2251800000000000.0,0,0,0,0,0,0,0,0,0,0,0,0,0,0,0,0,0,0,0,0,0,0,0,0,0,0,0,0,0,0,0,0,0,0,0,0,0,0,0,0,0,0,0,0,0,0,0,0,Milot Rashica,Â£6.30m ,24.0,177.0,Forward - Left Winger,right,SV Werder Bremen,39.0,4.0,14.0,3044.0,37.0,4.0,5.0,2757.0,30.0,12.0,6.0,1812.0,34.0,11.0,8.0,2791.0,1.0,0.0,0.0,24.0,Bundesliga
19-06-17,18.3.4.28,Pablo De Blasis,14003917,1649,04-Feb-88,29,0,0,0,0,5050,6550,6550,135,131,9492227,164,66,M/AM RLC,2,3,1,2,2,2,3,1,1,3,3,10,11,13,12,14,10,17,10,8,6,13,10,10,14,13,16,18,12,10,14,12,16,16,10,15,7,10,16,13,17,14,7,10,13,11,20,13,8,14,13,13,6,16,10,12,14,15,12,7,7,8,1,1,20,20,16,20,15,M/AM RLC,416,1,1,12,15,20,16,1,1,1,1,10,20,16,1,1,549756000000.0,0,0,0,0,0,0,0,0,0,0,1,0,0,0,0,0,0,0,0,0,0,0,0,0,0,0,0,0,0,0,0,0,0,0,0,0,0,0,0,1,0,0,0,0,0,0,0,0,Pablo de Blasis,Â£2.70m ,32.0,165.0,Forward - Left Winger,right,Without Club,38.0,7.0,6.0,2299.0,28.0,5.0,4.0,1871.0,27.0,2.0,0.0,1739.0,33.0,5.0,5.0,1860.0,nan,nan,nan,nan,Bundesliga,15-07-16,17.3.2.23,Pablo De Blasis,14003917,1649,04-Feb-88,28,0,0,0,0,4750,6500,6750,135,135,12608542,164,66,M/AM RLC,4,2,1,3,3,1,1,1,3,3,4,10,11,13,11,15,10,17,10,8,6,13,10,10,15,17,16,18,12,10,14,12,16,16,10,15,7,10,17,13,17,14,7,10,13,11,20,13,8,14,13,13,6,16,10,12,14,15,12,8,7,8,Pablo de Blasis,Â£2.70m ,Bundesliga
19-06-17,18.3.4.28,Guido Burgstaller,16004033,755,29-Apr-89,28,11,0,11,0,4950,6450,6950,139,139,19735707,187,80,M/AM/S RL,1,2,1,2,4,3,2,3,1,2,3,8,12,11,14,10,8,13,11,8,6,9,10,7,11,17,14,16,12,12,9,9,16,15,11,16,8,12,17,12,10,16,13,16,17,15,20,15,14,14,10,14,5,15,12,14,8,15,12,8,10,10,1,1,18,18,18,16,12,M/AM/S RL,635,1,1,20,12,16,18,1,1,1,1,1,16,18,1,1,134217744.0,0,0,0,0,1,0,0,0,0,0,0,0,0,0,0,0,0,0,0,0,0,0,0,0,0,0,0,1,0,0,0,0,0,0,0,0,0,0,0,0,0,0,0,0,0,0,0,0,Guido Burgstaller,Â£11.70m ,31.0,187.0,Forward - Centre-Forward,right,FC St. Pauli,43.0,26.0,4.0,3659.0,37.0,13.0,6.0,2740.0,33.0,5.0,2.0,2010.0,24.0,2.0,2.0,1446.0,2.0,0.0,0.0,105.0,Bundesliga,15-07-16,17.3.2.23,Guido Burgstaller,16004033,755,29-Apr-89,27,9,0,11,0,4300,6300,6800,138,136,15253328,187,80,M/AM/S RL,2,1,2,1,2,3,2,4,1,1,2,8,12,11,13,10,8,13,10,8,6,9,11,7,11,17,14,16,12,12,9,9,16,15,11,16,8,12,17,12,10,16,13,16,17,15,20,15,14,14,10,14,5,15,12,14,8,15,12,8,10,10,Guido Burgstaller,Â£6.30m ,Bundesliga
19-06-17,18.3.4.28,Karim Onisiwo,16037392,755,17-Mar-92,25,2,0,1,0,3100,6100,6100,126,122,4745564,188,76,M/AM/S RL,3,3,2,2,3,2,2,1,1,2,1,9,11,14,12,11,8,10,9,8,5,10,11,5,13,11,7,13,10,10,13,7,12,14,6,10,5,8,11,16,12,15,14,9,14,16,20,11,13,12,6,12,6,15,9,15,6,11,10,12,10,13,1,1,20,20,15,20,12,M/AM/S RL,425,1,1,17,12,20,15,1,1,1,1,1,20,15,1,1,1.44115e+17,0,0,0,0,0,0,0,0,0,0,1,0,0,0,0,0,0,0,0,0,0,0,0,0,0,0,0,0,0,0,0,0,0,0,0,1,0,0,0,0,0,0,0,0,0,0,0,0,Karim Onisiwo,Â£450Th. ,28.0,188.0,Forward - Centre-Forward,right,1.FSV Mainz 05,22.0,1.0,0.0,1366.0,10.0,0.0,0.0,365.0,27.0,7.0,3.0,1242.0,33.0,4.0,7.0,1810.0,4.0,0.0,0.0,288.0,Bundesliga,15-07-16,17.3.2.23,Karim Onisiwo,16037392,755,17-Mar-92,24,1,0,1,0,2800,6300,6300,132,126,7740706,188,76,M/AM/S RL,3,1,1,2,2,2,2,1,3,1,1,9,11,14,12,11,8,10,9,8,5,10,11,6,13,11,8,12,10,10,13,8,12,14,7,10,5,8,11,16,12,15,14,9,14,16,20,12,13,12,6,12,6,15,9,15,6,11,10,12,10,13,Karim Onisiwo,Â£1.35m ,Bundesliga
19-06-17,18.3.4.28,Florian Kainz,16042540,755,24-Oct-92,24,2,0,17,1,4350,6350,6350,136,127,8562060,176,71,M/AM LC,3,2,3,3,1,1,3,2,2,3,3,15,14,14,12,12,11,7,15,8,6,13,10,9,13,14,11,9,12,10,15,11,10,16,7,12,9,12,14,14,15,8,8,12,13,13,20,14,7,13,4,11,5,12,8,15,12,13,12,10,10,12,1,1,20,20,14,20,18,M/AM LC,414,1,1,1,18,20,14,1,1,1,1,10,20,14,1,1,1.44115e+17,0,0,0,0,0,0,0,0,0,0,0,1,0,0,0,0,0,0,0,0,0,0,0,0,0,0,0,0,0,0,0,0,0,0,0,1,0,0,0,0,0,0,0,0,0,0,0,0,Florian Kainz,Â£3.60m ,28.0,176.0,Forward - Left Winger,right,1. FC KÃ¶ln,15.0,2.0,3.0,332.0,34.0,4.0,4.0,1949.0,24.0,2.0,7.0,1774.0,29.0,6.0,8.0,1680.0,nan,nan,nan,nan,Bundesliga,15-07-16,17.3.2.23,Florian Kainz,16042540,755,24-Oct-92,23,1,0,17,1,3850,6350,6350,141,127,8416830,176,71,M/AM LC,3,3,2,3,2,2,2,3,1,1,3,15,14,14,12,12,11,7,15,8,6,13,10,9,13,14,11,9,12,10,15,11,10,16,7,12,9,12,14,14,15,8,8,12,13,13,20,14,7,13,4,11,5,12,8,15,12,13,12,10,10,12,Florian Kainz,Â£2.70m ,Bundesliga
19-06-17,18.3.4.28,Marcel Sabitzer,16045721,755,17-Mar-94,23,27,4,7,1,6300,7300,7300,152,146,46360061,177,74,M/AM/S RL,2,3,1,1,2,1,3,2,2,1,2,9,11,13,15,12,9,8,11,6,6,12,10,8,13,17,11,14,12,10,13,9,15,13,10,14,8,10,17,16,13,14,9,14,17,14,20,16,11,15,6,15,4,15,10,18,7,16,13,8,8,15,1,1,20,20,20,18,14,M/AM/S RL,425,1,1,17,14,18,20,1,1,1,1,1,18,20,1,1,549756000000.0,0,0,0,0,1,0,0,0,0,0,0,0,0,0,0,0,0,0,0,0,0,0,0,0,0,0,0,0,0,0,0,0,0,0,0,0,0,0,0,1,0,0,0,0,0,0,0,0,Marcel Sabitzer,Â£22.50m ,26.0,177.0,Forward - Right Winger,right,RB Leipzig,33.0,9.0,4.0,2718.0,34.0,5.0,9.0,2617.0,43.0,5.0,6.0,3287.0,44.0,16.0,11.0,3558.0,2.0,1.0,1.0,66.0,Bundesliga,15-07-16,17.3.2.23,Marcel Sabitzer,16045721,755,17-Mar-94,22,21,3,7,1,5250,7250,7250,152,145,13901010,177,74,M/AM/S RL,1,2,2,3,3,1,2,2,2,1,1,9,11,13,15,12,9,8,11,6,6,12,10,8,13,17,11,14,12,10,13,9,15,13,7,14,8,10,17,16,13,14,9,14,17,14,20,16,11,15,6,15,4,15,10,18,7,16,13,8,8,15,Marcel Sabitzer,Â£11.70m ,Bundesliga
19-06-17,18.3.4.28,Valentino Lazaro,16067510,755,24-Mar-96,21,8,0,6,0,5400,6900,6900,155,138,13599777,178,75,M/AM RL,1,2,4,2,4,3,4,3,1,1,3,13,13,15,10,14,11,9,11,7,8,14,10,11,15,14,13,8,12,10,14,12,9,15,6,11,10,12,14,15,16,10,9,10,12,14,20,14,9,11,6,11,14,18,9,12,13,12,10,14,14,10,14,10,20,20,20,16,14,M/AM RL,415,1,1,10,14,16,20,1,1,14,1,12,16,20,1,10,34359738368.0,0,0,0,0,0,0,0,0,0,0,0,0,0,0,0,0,0,0,0,0,0,0,0,0,0,0,0,0,0,0,0,0,0,0,0,1,0,0,0,0,0,0,0,0,0,0,0,0,Valentino Lazaro,Â£8.10m ,24.0,180.0,Midfielder - Right Midfield,right,Borussia MÃ¶nchengladbach,46.0,7.0,10.0,3529.0,35.0,3.0,8.0,2550.0,34.0,3.0,7.0,3043.0,26.0,2.0,2.0,1092.0,nan,nan,nan,nan,Bundesliga
19-06-17,18.3.4.28,Divock Origi,18045347,757,18-Apr-95,22,23,3,2,0,6750,7000,7250,161,145,43362300,185,75,S L,3,2,1,1,1,2,2,2,2,4,2,7,10,14,12,16,9,13,13,6,5,12,13,7,15,15,12,11,11,12,11,10,13,15,5,14,8,12,15,15,14,15,14,13,13,18,20,13,14,12,5,13,9,10,17,15,12,13,16,12,14,5,1,1,15,15,12,15,11,S L,603,1,1,20,11,15,12,1,1,1,1,1,15,12,1,1,584116000000.0,0,0,0,0,0,0,0,0,0,0,0,0,0,0,0,0,0,0,0,0,0,0,0,0,0,0,0,0,0,0,0,0,0,0,0,1,0,0,0,1,0,0,0,0,0,0,0,0,Divock Origi,Â£9.00m ,25.0,185.0,Forward - Centre-Forward,right,Liverpool FC,43.0,11.0,4.0,2081.0,37.0,7.0,3.0,2375.0,22.0,8.0,2.0,763.0,42.0,6.0,4.0,1426.0,2.0,1.0,1.0,119.0,Premier League,15-07-16,17.3.2.23,Divock Origi,18045347,757,18-Apr-95,21,21,3,2,0,6000,7000,7250,156,145,74362451,185,75,S L,1,1,2,3,1,3,1,1,1,1,1,4,11,16,14,16,7,12,14,4,4,11,14,7,16,11,13,11,14,12,11,12,15,15,5,14,9,13,13,15,16,14,11,13,13,16,20,12,14,12,5,12,9,10,14,15,15,13,14,12,14,5,Divock Origi,Â£10.80m ,Premier League
19-06-17,18.3.4.28,Leon Bailey,18083491,377,09-Aug-97,19,0,0,0,0,7407,5350,7700,178,149,85534758,180,75,M/AM RL,2,2,3,1,1,2,3,3,4,4,3,15,14,16,13,13,11,8,15,6,4,11,12,6,15,13,11,10,12,10,12,9,15,17,5,14,5,8,13,18,16,10,12,20,14,18,9,13,9,12,6,15,3,13,16,18,5,12,10,10,7,18,1,10,20,20,20,18,14,M/AM RL,415,1,1,12,14,18,20,1,1,1,1,1,18,20,10,1,584116000000.0,0,0,0,0,0,0,0,0,0,0,0,0,0,0,0,0,0,0,0,0,0,0,0,0,0,0,0,0,0,0,0,0,0,0,0,1,0,0,0,1,0,0,0,0,0,0,0,0,Leon Bailey,Â£40.50m ,23.0,178.0,Forward - Left Winger,left,Bayer 04 Leverkusen,45.0,8.0,11.0,2953.0,34.0,12.0,6.0,2521.0,39.0,5.0,5.0,2553.0,33.0,7.0,3.0,1465.0,5.0,0.0,4.0,271.0,Bundesliga,15-07-16,17.3.2.23,Leon Bailey,18083491,377,09-Aug-97,18,0,0,0,0,6037,5530,6950,165,139,50646448,180,75,M/AM RL,1,3,3,1,1,2,2,4,1,2,1,14,14,16,12,13,10,8,14,6,4,10,12,7,15,13,10,10,12,9,13,8,15,17,6,11,5,9,12,18,16,10,12,20,14,16,10,12,7,10,6,15,3,13,16,18,5,12,10,10,7,18,Leon Bailey,Â£9.90m ,Bundesliga
19-06-17,18.3.4.28,Caiuby,19008354,1651,14-Jul-88,28,0,0,0,0,4235,5268,6600,132,132,10722822,184,85,M/AM/S L,3,3,2,3,1,1,3,2,2,1,3,10,13,12,10,10,11,14,12,8,7,9,13,9,11,17,11,16,10,12,11,9,15,14,8,13,9,13,17,12,11,17,13,20,16,15,11,16,16,12,13,11,4,15,16,12,13,11,11,10,12,10,1,1,20,20,14,20,12,M/AM/S L,423,1,1,16,12,20,14,1,1,1,1,1,20,14,1,1,134217728.0,0,0,0,0,0,0,0,0,0,0,0,0,0,0,0,0,0,0,0,0,0,0,0,0,0,0,0,1,0,0,0,0,0,0,0,0,0,0,0,0,0,0,0,0,0,0,0,0,Caiuby,Â£4.50m ,32.0,185.0,Forward - Centre-Forward,left,Without Club,6.0,0.0,0.0,335.0,33.0,5.0,8.0,2859.0,25.0,2.0,1.0,1934.0,nan,nan,nan,nan,nan,nan,nan,nan,Bundesliga,15-07-16,17.3.2.23,Caiuby,19008354,1651,14-Jul-88,28,0,0,0,0,4083,5670,6500,130,130,5447115,184,85,M/AM/S L,3,1,1,2,2,3,3,4,1,1,2,10,13,12,10,10,11,14,12,8,6,9,13,8,11,17,10,15,9,11,10,8,14,14,8,12,9,13,17,12,11,16,13,20,16,17,11,15,14,12,13,11,4,15,16,12,13,11,11,10,12,10,Caiuby,Â£1.80m ,Bundesliga
19-06-17,18.3.4.28,Andrej Kramaric,24004434,761,19-Jun-91,26,21,5,9,5,6700,7300,7200,148,144,27820933,177,73,M/AM/S L,3,1,3,2,1,1,3,2,1,1,1,9,11,14,15,16,10,13,13,6,5,13,16,6,15,13,15,10,12,12,14,9,10,16,5,13,7,12,17,15,16,12,10,15,16,14,20,15,10,11,4,11,5,10,11,17,12,10,14,12,16,13,1,1,16,16,10,16,14,M/AM/S L,633,1,1,20,14,16,10,1,1,1,1,1,16,10,1,1,1.44115e+17,0,0,0,0,0,0,0,0,0,0,1,0,0,0,0,0,0,0,0,0,0,1,0,0,0,0,0,0,0,0,0,0,0,0,0,1,0,0,0,0,0,0,0,0,0,0,0,0,Andrej Kramaric,Â£24.30m ,29.0,177.0,Forward - Centre-Forward,right,TSG 1899 Hoffenheim,36.0,18.0,8.0,2583.0,42.0,13.0,9.0,2928.0,37.0,22.0,5.0,2976.0,20.0,12.0,4.0,1509.0,4.0,8.0,0.0,390.0,Bundesliga,15-07-16,17.3.2.23,Andrej Kramaric,24004434,761,19-Jun-91,25,14,4,9,5,6700,7200,7200,145,144,33404987,177,73,M/AM/S L,1,1,2,2,4,3,1,2,1,2,1,8,11,14,15,16,10,13,12,6,5,13,16,6,15,13,15,10,12,12,14,9,10,16,5,13,7,12,17,16,15,13,10,15,16,14,20,14,10,11,4,11,5,10,11,17,12,10,14,12,16,13,Andrej Kramaric,Â£13.50m ,Bundesliga
19-06-17,18.3.4.28,Ante Rebic,24023726,761,21-Sep-93,23,10,1,8,4,5150,6400,6650,143,133,20755008,185,78,M/AM/S L,2,3,1,3,3,1,1,3,2,2,3,9,12,14,13,15,10,8,12,9,5,12,10,6,14,9,10,15,13,8,13,9,13,14,5,12,6,8,9,14,13,17,11,10,12,17,20,12,14,10,14,12,9,14,12,12,8,14,9,7,7,16,1,1,19,19,10,19,14,M/AM/S L,633,1,1,20,14,19,10,1,1,1,1,1,19,10,1,1,1.44133e+17,0,0,0,0,0,0,0,0,0,0,0,0,0,0,0,0,1,0,0,0,0,0,0,0,0,0,0,0,0,0,0,0,0,0,0,0,0,0,0,0,0,0,0,0,1,0,0,0,Ante Rebic,Â£9.00m ,27.0,185.0,Forward - Left Winger,right,AC Milan,28.0,3.0,2.0,1744.0,28.0,9.0,3.0,2029.0,38.0,10.0,6.0,2514.0,36.0,15.0,5.0,2056.0,2.0,0.0,1.0,148.0,Serie A,15-07-16,17.3.2.23,Ante Rebic,24023726,761,21-Sep-93,22,10,1,8,4,3700,5950,6350,140,127,9121345,185,78,M/AM/S L,3,2,2,2,1,3,1,3,2,3,1,9,12,15,13,14,10,8,12,9,5,12,10,5,14,9,11,15,12,8,12,9,13,14,5,12,5,8,9,16,13,17,12,10,12,14,20,11,14,10,14,12,9,14,12,12,8,14,9,7,7,16,Ante Rebic,Â£2.25m ,Bundesliga
19-06-17,18.3.4.28,Josip Brekalo,24046837,761,23-Jun-98,18,0,0,2,0,4450,6200,6450,153,124,18565560,175,70,M/AM RL,4,2,3,4,4,3,3,2,1,4,2,13,13,16,11,14,9,4,15,6,4,12,10,5,15,11,11,7,10,8,13,8,14,17,5,13,6,10,11,15,16,10,8,12,13,14,20,11,7,11,5,12,6,10,14,17,7,12,12,12,16,10,1,1,20,20,18,20,14,M/AM RL,415,1,1,10,14,20,18,1,1,1,1,1,20,18,1,1,1.44115e+17,0,0,0,0,0,0,0,0,0,0,1,0,0,0,0,0,0,0,0,0,0,0,0,0,0,0,0,0,0,0,0,0,0,0,0,1,0,0,0,0,0,0,0,0,0,0,0,0,Josip Brekalo,Â£4.95m ,22.0,175.0,Forward - Left Winger,right,VfL Wolfsburg,17.0,1.0,1.0,806.0,32.0,6.0,2.0,1966.0,27.0,3.0,4.0,1527.0,41.0,7.0,7.0,2499.0,6.0,1.0,1.0,512.0,Bundesliga
19-06-17,18.3.4.28,Jacob Bruun Larsen,27112672,764,19-Sep-98,18,0,0,4,0,4200,5700,6200,148,119,12698672,183,75,M/AM RL,3,1,1,2,2,3,3,2,2,3,4,11,11,12,13,10,12,8,14,9,7,11,10,8,12,15,11,10,8,8,12,8,11,13,7,13,9,12,15,15,13,11,10,16,16,12,20,11,9,12,4,11,12,17,14,17,11,10,13,15,17,5,13,13,20,20,18,20,12,M/AM RL,415,1,1,10,12,20,18,1,12,13,1,1,20,18,12,13,1.44115e+17,0,0,0,0,0,0,0,0,0,0,0,0,0,0,0,0,0,0,0,0,0,0,0,0,0,0,0,0,0,0,0,0,0,0,0,0,0,0,0,0,0,0,0,0,0,0,0,0,Jacob Bruun Larsen,Â£450Th. ,22.0,183.0,Forward - Left Winger,right,TSG 1899 Hoffenheim,26.0,21.0,16.0,2086.0,12.0,4.0,3.0,639.0,30.0,3.0,3.0,1476.0,21.0,0.0,2.0,619.0,3.0,0.0,0.0,101.0,Bundesliga
19-06-17,18.3.4.28,Serge Gnabry,28066083,771,14-Jul-95,21,2,3,15,4,6650,7150,7150,157,143,50458236,173,73,M/AM RLC,1,1,3,2,3,2,2,3,3,1,1,10,11,15,15,12,11,9,14,8,5,12,10,8,14,13,12,14,10,10,13,9,11,17,5,15,7,10,13,16,15,17,8,14,14,16,20,12,12,10,5,11,13,14,12,17,8,13,14,14,10,10,1,10,20,20,16,20,19,M/AM RLC,416,1,1,1,19,20,16,1,1,1,1,10,20,16,1,10,1.44115e+17,0,0,0,0,0,0,0,0,0,0,1,0,0,0,1,0,0,0,0,0,0,0,0,0,0,0,0,0,0,0,0,0,0,0,0,0,0,0,0,0,0,0,0,0,0,0,0,0,Serge Gnabry,Â£18.00m ,25.0,175.0,Forward - Right Winger,right,Bayern Munich,27.0,11.0,2.0,1970.0,27.0,10.0,8.0,1806.0,42.0,13.0,9.0,2541.0,46.0,23.0,14.0,3346.0,6.0,3.0,1.0,474.0,Bundesliga,15-07-16,17.3.2.23,Serge Gnabry,28066083,771,14-Jul-95,21,0,0,7,1,6150,7150,7150,161,143,8000000,173,73,M/AM RLC,2,3,3,1,1,2,1,2,2,1,2,10,12,15,14,11,11,9,13,8,5,13,10,7,14,12,11,14,10,9,13,10,11,17,5,14,7,10,12,16,15,17,8,14,14,16,20,13,12,10,5,12,13,14,12,17,8,13,14,14,10,10,Serge Gnabry,Â£13.50m ,Bundesliga
19-06-17,18.3.4.28,Jadon Sancho,28108490,765,25-Mar-00,17,0,0,0,0,4165,5169,6650,171,123,28293335,180,76,M/AM RL,1,2,1,3,1,3,1,3,3,4,4,10,11,16,13,12,10,7,11,5,5,12,13,7,15,12,11,8,12,8,13,11,13,16,5,14,6,12,13,15,16,10,9,8,12,14,20,12,7,11,5,15,6,13,8,17,7,14,10,12,10,14,1,1,20,20,16,20,14,M/AM RL,415,1,1,10,14,20,16,1,1,1,1,1,20,16,1,1,1.44115e+17,0,0,0,0,0,0,0,0,0,0,1,0,0,0,0,0,0,0,0,0,0,0,0,0,0,0,0,0,1,0,0,0,0,0,0,0,0,0,0,0,0,0,0,0,0,0,0,0,Jadon Sancho,Â£13.50m ,20.0,180.0,Forward - Right Winger,right,Borussia Dortmund,33.0,20.0,7.0,2588.0,21.0,5.0,7.0,1400.0,43.0,13.0,19.0,2967.0,44.0,20.0,20.0,3274.0,6.0,1.0,3.0,464.0,Bundesliga
19-06-17,18.3.4.28,Alexander Esswein,29022519,771,25-Mar-90,27,0,0,13,5,4050,6550,6550,132,131,9492227,183,85,M/AM RL,1,3,3,3,3,3,1,4,3,1,3,11,13,13,11,11,9,9,14,10,6,10,11,6,12,14,10,14,9,12,10,8,11,13,6,11,7,10,14,15,12,15,10,11,12,18,20,13,14,10,4,11,7,14,7,14,8,10,12,11,11,9,1,1,20,20,20,18,1,M/AM RL,415,1,1,12,1,18,20,1,1,1,1,1,18,20,1,1,549756000000.0,0,0,0,0,0,0,0,0,0,1,0,0,0,0,0,0,0,0,0,0,0,0,0,0,0,0,0,0,0,0,0,0,0,0,0,0,0,0,0,1,0,0,0,0,0,0,0,0,Alexander Esswein,Â£1.80m ,30.0,182.0,Forward - Right Winger,right,SV Sandhausen,30.0,2.0,3.0,1346.0,22.0,2.0,2.0,1013.0,24.0,2.0,1.0,1807.0,10.0,1.0,1.0,492.0,2.0,0.0,0.0,89.0,Bundesliga,15-07-16,17.3.2.23,Alexander Esswein,29022519,771,25-Mar-90,26,0,0,13,5,4550,6550,6550,132,131,9171712,183,85,M/AM RL,1,3,1,1,2,3,1,1,3,3,2,11,13,13,11,12,9,9,14,10,6,10,9,6,12,14,10,14,8,12,10,8,11,13,6,11,7,10,14,15,12,16,10,11,12,18,20,13,14,10,4,11,7,14,7,14,8,10,12,11,11,9,Alexander Esswein,Â£2.25m ,Bundesliga
19-06-17,18.3.4.28,Mathew Leckie,29065287,1435,04-Feb-91,26,44,5,13,3,4750,6750,6750,135,135,14499066,181,82,M/AM RL,2,4,2,1,1,4,3,4,2,2,1,9,11,13,11,12,8,13,10,6,6,10,14,8,12,17,10,14,8,12,10,9,12,13,7,13,8,12,17,14,12,15,12,10,16,19,20,15,13,12,5,10,7,14,14,16,8,11,15,13,12,3,1,1,20,20,16,20,12,M/AM RL,415,1,1,14,12,20,16,1,1,1,1,1,20,16,1,1,134218752.0,0,0,0,0,0,0,0,0,0,0,1,0,0,0,0,0,0,0,0,0,0,0,0,0,0,0,0,1,0,0,0,0,0,0,0,0,0,0,0,0,0,0,0,0,0,0,0,0,Mathew Leckie,Â£3.60m ,29.0,181.0,Forward - Right Winger,right,Hertha BSC,32.0,0.0,3.0,2327.0,29.0,6.0,3.0,2026.0,19.0,2.0,1.0,938.0,10.0,0.0,0.0,383.0,3.0,0.0,2.0,128.0,Bundesliga,15-07-16,17.3.2.23,Mathew Leckie,29065287,1435,04-Feb-91,25,32,3,13,3,5800,6800,6800,139,136,17057485,181,82,M/AM RL,3,1,2,3,3,3,2,3,1,3,1,9,11,13,12,12,8,11,9,6,6,10,14,8,12,17,10,13,9,12,10,8,12,13,7,13,8,12,17,15,12,15,10,10,16,19,20,15,13,12,5,10,7,14,14,16,8,11,15,13,12,3,Mathew Leckie,Â£2.25m ,Bundesliga
19-06-17,18.3.4.28,Ademola Lookman,29141828,765,20-Oct-97,19,0,0,0,0,5050,6300,6550,146,126,50481332,174,78,M/AM RLC,3,3,3,2,3,2,1,2,2,3,3,9,10,15,13,13,11,5,14,6,4,10,10,5,14,13,9,8,12,10,10,8,16,14,5,12,6,8,13,17,15,13,7,12,14,15,20,12,7,10,2,14,5,12,8,17,10,13,10,13,15,12,1,1,20,20,15,20,16,M/AM RLC,416,1,1,13,16,20,15,1,1,1,1,1,20,15,1,1,2252350000000000.0,0,0,0,0,0,0,0,0,0,0,0,0,0,0,0,0,0,0,0,0,0,0,0,0,0,0,0,0,0,0,0,0,0,0,0,0,0,0,0,1,0,0,0,0,0,0,0,0,Ademola Lookman,Â£10.80m ,23.0,174.0,Forward - Left Winger,right,Fulham FC,34.0,9.0,2.0,2141.0,28.0,8.0,4.0,1255.0,24.0,1.0,2.0,830.0,13.0,0.0,0.0,377.0,4.0,1.0,0.0,247.0,Premier League,15-07-16,17.3.2.23,Ademola Lookman,29141828,765,20-Oct-97,18,0,0,0,0,3500,6500,6500,160,121,43322765,174,78,AM LC,2,2,1,1,3,3,1,2,3,2,3,9,8,14,13,13,11,4,12,11,3,9,11,5,14,7,12,8,14,8,10,8,13,14,4,12,6,6,11,16,15,13,5,15,14,15,20,12,6,10,2,5,11,5,14,15,16,14,15,13,15,3,Ademola Lookman,Â£4.50m ,Premier League
19-06-17,18.3.4.28,Fin Bartels,35002841,771,07-Feb-87,30,0,0,1,0,6300,6550,6800,136,136,232186002,176,69,M/AM RLC,1,2,1,1,2,2,2,2,1,1,1,10,11,14,12,14,9,10,13,6,6,12,9,8,13,16,12,13,10,9,14,11,14,15,7,14,8,12,16,16,16,8,7,12,12,14,20,13,7,10,8,11,6,16,8,11,12,13,10,8,9,8,8,8,20,20,20,17,18,M/AM RLC,416,1,1,12,18,17,20,1,1,8,1,1,17,20,1,8,1.44115e+17,0,0,0,0,1,0,0,0,0,0,0,0,0,0,0,0,0,0,0,0,1,0,0,0,0,0,0,0,0,0,0,0,0,0,0,0,0,0,0,0,0,0,0,0,0,0,0,0,Fin Bartels,Â£2.25m ,33.0,176.0,Forward - Second Striker,right,Holstein Kiel,32.0,8.0,9.0,2301.0,14.0,2.0,3.0,1128.0,4.0,1.0,1.0,153.0,17.0,0.0,1.0,374.0,5.0,1.0,0.0,385.0,Bundesliga,15-07-16,17.3.2.23,Fin Bartels,35002841,771,07-Feb-87,29,0,0,1,0,5800,6550,6800,136,136,12356162,176,69,M/AM RLC,3,1,3,3,3,1,3,3,3,1,1,10,11,14,12,14,9,10,13,6,6,12,9,8,13,16,12,13,10,9,14,11,14,15,7,14,8,12,16,16,16,8,7,12,12,14,20,13,7,10,8,11,6,16,8,11,12,13,10,8,9,8,Fin Bartels,Â£3.38m ,Bundesliga
19-06-17,18.3.4.28,Mike Frantz,35004501,771,14-Oct-86,30,0,0,0,0,6150,6400,6650,133,133,11732966,182,80,M/AM RLC,1,3,4,1,1,1,1,3,1,1,1,10,12,13,9,11,10,9,11,11,9,12,9,12,13,17,11,15,8,14,10,10,17,11,12,14,9,13,17,13,12,16,9,15,15,13,20,16,14,16,10,15,10,18,6,16,14,14,13,8,10,10,1,1,20,20,20,15,18,M/AM RLC,416,1,1,8,10,15,20,1,1,1,14,18,15,20,1,1,0.0,0,0,0,0,0,0,0,0,0,0,0,0,0,0,0,0,0,0,0,0,0,0,0,0,0,0,0,0,0,0,0,0,0,0,0,0,0,0,0,0,0,0,0,0,0,0,0,0,Mike Frantz,Â£1.35m ,34.0,182.0,Midfielder - Central Midfield,right,Hannover 96,30.0,0.0,2.0,2502.0,20.0,0.0,1.0,1487.0,34.0,3.0,2.0,2523.0,20.0,0.0,1.0,496.0,6.0,0.0,0.0,366.0,Bundesliga,15-07-16,17.3.2.23,Mike Frantz,35004501,771,14-Oct-86,29,0,0,0,0,5100,6350,6600,132,132,7656429,180,77,M/AM RLC,4,3,2,3,1,2,1,3,2,1,3,10,12,13,9,11,10,9,11,11,9,12,9,11,13,17,10,15,8,13,10,10,17,11,12,13,9,13,17,13,12,16,9,15,15,13,20,16,14,16,10,15,10,18,6,16,14,14,13,8,10,10,Mike Frantz,Â£2.25m ,Bundesliga
19-06-17,18.3.4.28,Marcel Heller,35004504,771,12-Feb-86,31,0,0,11,3,4000,6500,6500,132,130,232186002,175,70,M/AM RL,1,3,3,3,3,2,3,2,2,2,3,9,11,14,11,12,9,5,10,5,7,10,8,8,13,15,10,12,8,12,10,9,17,14,7,13,6,10,15,17,15,10,6,11,13,17,20,13,8,15,10,18,7,9,7,14,10,13,15,10,7,7,1,1,20,20,18,20,1,M/AM RL,415,1,1,1,1,20,18,1,1,1,1,1,20,18,1,1,2199160000000.0,0,0,0,0,0,0,0,0,0,0,0,0,0,0,0,0,0,0,0,0,0,0,0,0,0,0,0,1,0,0,0,0,0,0,0,0,0,0,0,0,0,1,0,0,0,0,0,0,Marcel Heller,Â£900Th. ,34.0,176.0,Midfielder - Right Midfield,right,SC Paderborn 07,34.0,4.0,6.0,2901.0,25.0,0.0,2.0,1367.0,34.0,4.0,8.0,2992.0,28.0,2.0,0.0,1571.0,1.0,0.0,0.0,21.0,Bundesliga,15-07-16,17.3.2.23,Marcel Heller,35004504,771,12-Feb-86,30,0,0,11,3,5050,6550,6550,133,131,232186002,173,70,M/AM RL,1,1,2,2,2,2,3,2,3,3,3,9,12,14,11,11,9,5,9,5,7,10,8,8,12,15,10,11,8,11,10,9,17,14,5,13,6,10,15,18,15,10,6,11,13,17,20,13,8,17,10,18,7,9,6,14,10,13,15,10,7,7,Marcel Heller,Â£1.13m ,Bundesliga
19-06-17,18.3.4.28,Nicolai MÃ¼ller,35009581,771,25-Sep-87,29,2,0,0,0,6050,6800,7050,143,141,22752068,175,66,M/AM RLC,1,3,3,2,3,1,1,2,1,1,1,10,12,14,14,12,8,5,11,7,8,10,9,10,13,17,13,14,9,12,10,10,17,14,10,16,9,12,17,17,16,14,8,9,17,15,20,15,8,13,8,13,3,15,9,14,12,10,16,13,15,6,1,1,20,20,20,15,16,M/AM RLC,416,1,1,14,16,15,20,1,1,1,1,10,15,20,1,1,1.44115e+17,0,0,0,0,1,0,0,0,0,0,0,0,1,0,0,0,0,0,0,0,0,0,0,0,0,0,0,1,1,0,0,0,0,0,0,0,0,0,0,0,0,0,0,0,0,0,0,0,Nicolai MÃ¼ller,Â£2.70m ,33.0,173.0,Forward - Right Winger,right,Western Sydney Wanderers,27.0,5.0,7.0,2035.0,3.0,1.0,0.0,116.0,26.0,5.0,0.0,1268.0,19.0,5.0,3.0,1505.0,nan,nan,nan,nan,Bundesliga,15-07-16,17.3.2.23,Nicolai MÃ¼ller,35009581,771,25-Sep-87,28,2,0,0,0,6050,7050,7050,143,141,21578131,175,66,M/AM RLC,4,1,1,1,1,2,3,2,3,2,2,10,12,14,14,12,8,5,11,7,8,10,9,10,13,17,13,14,9,12,10,10,17,14,10,16,9,12,17,17,16,14,8,9,17,15,20,15,8,13,8,13,3,15,9,14,12,10,16,13,15,6,Nicolai MÃ¼ller,Â£4.05m ,Bundesliga
19-06-17,18.3.4.28,Christian Clemens,35014354,771,04-Aug-91,25,0,0,5,0,4350,6350,6350,131,127,6924100,181,78,M/AM RL,2,2,2,3,3,1,2,3,2,2,1,14,12,13,11,10,12,10,15,12,8,10,13,9,12,15,10,13,8,12,9,9,13,13,10,12,9,12,15,15,13,14,10,8,11,17,20,13,12,12,7,11,12,14,8,14,12,10,14,13,15,5,12,10,20,20,20,17,10,M/AM RL,415,1,1,8,10,17,20,1,1,12,1,8,17,20,1,10,1.44115e+17,0,0,0,0,0,0,0,0,0,0,0,1,0,0,0,0,0,0,0,0,0,0,0,0,0,0,0,0,0,0,0,0,0,0,0,0,0,0,0,0,0,0,0,0,0,0,0,0,Christian Clemens,Â£1.13m ,29.0,179.0,Midfielder - Right Midfield,right,1. FC KÃ¶ln,18.0,1.0,1.0,1222.0,20.0,2.0,1.0,914.0,21.0,2.0,7.0,1461.0,1.0,0.0,0.0,15.0,2.0,0.0,0.0,154.0,Bundesliga,15-07-16,17.3.2.23,Christian Clemens,35014354,771,04-Aug-91,24,0,0,5,0,4100,6600,6600,135,132,11586221,181,78,M/AM RL,3,3,3,1,2,3,3,2,3,1,1,15,14,13,13,11,12,10,15,12,8,10,13,9,12,15,10,13,8,12,10,9,13,13,10,12,9,12,15,15,13,15,10,8,13,17,20,14,12,12,7,11,6,14,8,14,12,10,14,13,15,5,Christian Clemens,Â£2.25m ,Bundesliga
19-06-17,18.3.4.28,Edgar Prib,35014762,771,15-Dec-89,27,0,0,0,0,4000,6250,6500,135,130,7775932,180,77,M/AM LC,3,3,1,3,3,1,3,1,1,3,2,15,14,11,10,12,14,9,12,11,9,13,10,11,12,17,13,15,10,13,12,10,14,11,9,14,10,15,18,12,14,14,10,20,16,12,8,17,11,14,12,14,9,19,10,12,14,11,17,15,15,4,14,14,20,20,10,20,18,M/AM LC,414,1,1,6,18,20,10,1,14,1,12,16,20,10,14,1,154619000000.0,0,0,0,0,0,0,0,0,0,0,0,0,0,0,0,0,0,0,0,0,0,0,0,0,0,0,0,0,0,0,0,0,0,0,1,0,0,1,0,0,0,0,0,0,0,0,0,0,Edgar Prib,Â£1.35m ,30.0,180.0,Midfielder - Central Midfield,left,Fortuna DÃ¼sseldorf,30.0,1.0,9.0,2144.0,1.0,0.0,0.0,90.0,5.0,2.0,1.0,292.0,27.0,5.0,1.0,1763.0,1.0,0.0,0.0,82.0,Bundesliga
19-06-17,18.3.4.28,Ibrahima TraorÃ©,35015030,22,21-Apr-88,29,41,8,0,0,4800,6800,6800,138,136,15786373,172,62,M/AM RL,1,1,1,1,2,2,2,3,3,4,1,12,14,15,9,13,10,6,12,8,8,12,9,10,13,16,10,10,8,12,9,8,13,16,7,12,10,13,16,18,17,7,6,20,13,15,10,14,6,14,6,12,5,15,15,15,9,10,12,14,16,5,10,14,20,20,18,20,10,M/AM RL,415,1,1,1,10,20,18,1,1,10,1,1,20,18,1,14,134217728.0,0,0,0,0,0,0,0,0,0,0,0,0,0,0,0,0,0,0,0,0,0,0,0,0,0,0,0,1,0,0,0,0,0,0,0,0,0,0,0,0,0,0,0,0,0,0,0,0,Ibrahima TraorÃ©,Â£3.15m ,32.0,171.0,Forward - Right Winger,left,Borussia MÃ¶nchengladbach,22.0,1.0,4.0,1382.0,9.0,0.0,1.0,362.0,17.0,0.0,3.0,590.0,7.0,0.0,1.0,148.0,3.0,1.0,0.0,35.0,Bundesliga,15-07-16,17.3.2.23,Ibrahima TraorÃ©,35015030,22,21-Apr-88,28,36,8,0,0,4550,6800,7050,138,136,19837299,172,62,M/AM RL,1,2,3,4,2,3,3,2,1,3,3,12,14,15,9,13,10,6,12,8,8,12,9,10,13,16,10,10,8,12,9,8,13,16,7,12,10,13,16,18,17,7,6,20,13,15,10,14,6,14,6,12,5,15,15,15,9,10,12,14,16,5,Ibrahima TraorÃ©,Â£4.50m ,Bundesliga
19-06-17,18.3.4.28,Danny Blum,35017408,771,07-Jan-91,26,0,0,0,0,2600,6100,6100,124,122,3214736,184,81,M/AM/S L,3,1,2,3,2,2,1,1,3,3,2,13,14,14,11,12,11,8,14,10,6,12,10,8,13,12,10,13,9,8,10,8,10,15,7,12,7,8,12,16,14,12,11,20,15,15,6,13,11,11,10,11,14,11,7,14,7,12,9,8,10,14,1,1,20,20,10,20,12,M/AM/S L,423,1,1,18,12,20,10,1,1,1,1,1,20,10,1,1,51539609600.0,0,0,0,0,0,0,0,0,0,0,0,1,0,0,0,0,0,0,0,0,0,0,0,0,0,0,0,0,0,0,0,0,0,0,1,1,0,0,0,0,0,0,0,0,0,0,0,0,Danny Blum,Â£675Th. ,29.0,183.0,Forward - Left Winger,left,VfL Bochum,18.0,2.0,1.0,581.0,3.0,2.0,0.0,36.0,27.0,1.0,5.0,1313.0,26.0,9.0,12.0,2015.0,6.0,0.0,1.0,157.0,Bundesliga,15-07-16,17.3.2.23,Danny Blum,35017408,771,07-Jan-91,25,0,0,0,0,2150,6150,6150,124,123,4996971,184,82,M/AM/S L,2,3,2,1,1,2,2,1,1,3,3,12,14,14,11,12,11,8,14,10,6,12,10,8,13,12,10,10,9,8,10,8,10,15,7,12,7,8,12,16,14,12,11,20,17,15,6,14,11,11,10,11,10,12,15,14,7,12,9,8,10,14,Danny Blum,Â£1.35m ,Bundesliga
19-06-17,18.3.4.28,Patrick Herrmann,35017417,771,12-Feb-91,26,2,0,14,3,4800,6800,6800,141,136,15786373,177,61,M/AM RL,3,4,2,1,3,1,4,1,2,3,4,9,10,14,13,12,8,9,11,7,8,12,9,11,13,16,13,10,12,11,13,12,11,14,6,15,9,14,16,17,16,10,8,10,14,15,20,12,6,14,7,14,13,16,9,12,14,11,15,16,14,3,8,12,20,20,20,15,10,M/AM RL,415,1,1,11,10,15,20,1,1,8,1,1,15,20,1,12,137439000000.0,0,0,0,0,1,0,0,0,0,0,1,0,0,0,1,0,0,0,0,0,0,0,0,0,0,0,0,0,0,0,0,0,0,0,0,0,0,1,0,0,0,0,0,0,0,0,0,0,Patrick Herrmann,Â£4.05m ,29.0,179.0,Forward - Right Winger,right,Borussia MÃ¶nchengladbach,31.0,1.0,3.0,1380.0,26.0,0.0,2.0,1208.0,26.0,3.0,3.0,1137.0,33.0,7.0,8.0,1669.0,7.0,2.0,1.0,234.0,Bundesliga,15-07-16,17.3.2.23,Patrick Herrmann,35017417,771,12-Feb-91,25,2,0,14,3,5050,7050,7050,144,141,22690002,177,61,M/AM RL,2,1,2,1,1,3,3,3,3,2,1,9,11,14,13,12,7,9,10,7,8,12,9,11,13,16,13,10,12,11,12,13,11,14,6,15,9,14,16,17,16,10,8,10,14,16,20,13,7,15,7,15,12,15,9,12,14,11,15,16,14,3,Patrick Herrmann,Â£6.30m ,Bundesliga
19-06-17,18.3.4.28,Mario GÃ¶tze,35017438,771,03-Jun-92,25,62,17,2,0,7350,7850,7850,165,157,158952276,176,75,M/AM/S RLC,2,2,1,2,3,3,3,3,2,2,3,12,12,16,13,18,10,8,13,5,6,14,10,8,18,12,16,8,13,13,18,18,9,17,6,17,8,15,12,13,15,13,7,9,11,11,20,12,8,15,5,15,12,15,7,11,12,13,13,15,18,8,1,1,19,20,15,15,20,M/AM/S RLC,536,1,1,16,20,15,15,1,1,1,8,19,15,15,1,1,549757000000.0,0,0,0,0,0,0,0,0,0,0,1,0,1,0,0,0,0,0,0,0,1,0,0,0,0,0,0,0,0,0,0,0,0,0,0,0,0,0,0,1,0,0,0,0,0,0,0,0,Mario GÃ¶tze,Â£16.20m ,28.0,176.0,Midfielder - Attacking Midfield,right,PSV Eindhoven,16.0,2.0,2.0,1175.0,32.0,2.0,7.0,2202.0,34.0,7.0,7.0,2266.0,21.0,3.0,1.0,609.0,2.0,2.0,0.0,112.0,Bundesliga,15-07-16,17.3.2.23,Mario GÃ¶tze,35017438,771,03-Jun-92,24,56,17,2,0,7300,7800,7800,165,156,108705842,176,75,AM/S RLC,1,1,2,3,2,1,2,2,2,1,1,12,12,16,13,18,10,8,13,5,6,14,10,8,18,12,16,8,13,13,18,18,9,17,6,17,8,15,12,13,15,13,7,9,12,11,20,12,8,15,5,15,11,15,7,11,12,13,13,15,18,8,Mario GÃ¶tze,Â£18.00m ,Bundesliga
19-06-17,18.3.4.28,Marco Terrazzino,35025621,771,15-Apr-91,26,0,0,0,0,4300,6300,6300,129,126,6478634,176,76,M/AM/S LC,3,2,3,1,2,1,2,1,1,3,1,11,12,14,12,14,10,9,14,7,6,13,10,7,13,12,10,7,10,9,14,12,8,15,5,13,7,13,12,14,14,8,8,15,10,12,20,11,9,11,5,11,15,15,7,11,13,7,11,14,12,5,1,1,18,20,12,18,20,M/AM/S LC,534,1,1,16,20,18,12,1,1,1,1,1,18,12,1,1,1.44115e+17,0,0,0,0,0,0,0,0,0,0,0,0,0,0,0,0,0,0,0,0,1,0,0,0,0,0,0,0,0,0,0,0,0,0,0,1,0,0,0,0,0,0,0,0,0,0,0,0,Marco Terrazzino,Â£2.25m ,29.0,177.0,Forward - Left Winger,right,SC Paderborn 07,13.0,4.0,6.0,640.0,26.0,0.0,2.0,1601.0,14.0,1.0,0.0,570.0,16.0,2.0,0.0,1025.0,2.0,0.0,0.0,48.0,Bundesliga,15-07-16,17.3.2.23,Marco Terrazzino,35025621,771,15-Apr-91,25,0,0,0,0,2800,6300,6300,129,126,6259875,176,76,M/AM/S LC,2,1,2,3,2,2,2,2,1,2,1,11,12,14,12,14,10,9,14,7,6,13,10,6,13,12,10,7,10,8,14,12,8,15,5,13,7,13,12,14,14,8,8,15,10,12,20,11,9,11,5,11,15,15,7,11,13,7,11,14,12,5,Marco Terrazzino,Â£1.35m ,Bundesliga
19-06-17,18.3.4.28,Anastasios Donis,36077213,772,29-Aug-96,20,1,0,7,1,4900,6400,6400,143,128,8246784,178,77,AM/S LC,2,1,2,1,1,1,3,1,2,3,2,7,10,15,11,12,8,10,11,4,6,12,10,8,13,15,11,14,10,11,12,9,14,15,8,15,7,10,14,17,14,13,9,12,12,14,20,12,11,11,4,13,8,14,15,17,10,12,13,10,12,7,1,1,15,19,12,15,19,AM/S LC,624,1,1,20,19,15,12,1,1,1,1,1,15,12,1,1,549907000000.0,0,0,0,0,1,0,0,0,0,0,0,0,0,0,0,0,0,0,0,0,0,0,0,0,1,0,0,1,0,0,0,0,0,0,0,0,0,0,0,1,0,0,0,0,0,0,0,0,Anastasios Donis,Â£2.70m ,24.0,178.0,Forward - Centre-Forward,right,Stade Reims,22.0,5.0,2.0,631.0,19.0,2.0,2.0,1002.0,27.0,5.0,3.0,1124.0,21.0,0.0,0.0,809.0,4.0,0.0,0.0,148.0,Bundesliga,15-07-16,17.3.2.23,Anastasios Donis,36077213,772,29-Aug-96,19,0,0,2,0,1350,5000,5000,128,107,864527,175,66,AM/S RLC,1,1,1,1,2,4,3,3,1,3,2,4,7,11,15,12,9,10,9,3,4,12,7,4,13,11,11,12,12,11,9,11,10,14,12,13,4,8,10,14,13,12,9,8,12,13,20,12,9,11,4,13,8,8,12,18,13,12,12,10,12,7,Anastasios Donis,Â£1.13m ,Ligue 1
19-06-17,18.3.4.28,Yoshinori MutÃ´,45030287,116,15-Jul-92,24,19,2,0,0,6000,7000,7000,151,140,23673591,179,72,M/AM/S L,3,3,2,3,1,3,3,2,2,1,2,9,10,14,15,13,9,12,13,5,6,12,11,6,13,17,13,14,12,10,10,10,13,14,8,12,10,13,17,16,16,12,10,14,12,14,20,14,8,15,8,13,13,15,12,17,10,14,17,11,13,7,1,1,17,17,13,17,14,M/AM/S L,633,1,1,20,14,17,13,1,1,1,1,1,17,13,1,1,1.44115e+17,0,0,0,0,0,0,0,0,0,0,1,0,0,0,0,0,0,0,0,0,0,0,0,0,0,0,0,0,0,0,0,0,0,0,0,0,0,0,0,0,0,0,0,0,0,0,0,0,Yoshinori Muto,Â£5.40m ,28.0,178.0,Forward - Centre-Forward,right,SD Eibar,21.0,6.0,2.0,1172.0,30.0,10.0,5.0,2066.0,18.0,1.0,0.0,593.0,10.0,1.0,0.0,350.0,4.0,0.0,0.0,195.0,Bundesliga,15-07-16,17.3.2.23,Yoshinori MutÃ´,45030287,116,15-Jul-92,24,18,2,0,0,6000,7000,7000,151,140,22855220,179,72,M/AM/S L,3,1,2,1,2,2,3,2,3,1,3,9,10,14,15,14,9,12,13,5,6,12,11,6,13,17,13,14,12,10,10,10,13,14,8,12,6,13,17,16,16,12,10,14,12,14,20,14,8,15,8,13,10,15,12,17,10,14,17,11,13,7,Yoshinori Muto,Â£4.05m ,Bundesliga
19-06-17,18.3.4.28,Takuma Asano,45078327,116,10-Nov-94,22,11,2,18,6,4700,6200,6200,132,124,19165117,173,71,S L,2,1,3,1,2,3,1,1,1,1,2,7,8,12,10,10,7,14,8,4,5,9,12,8,11,16,12,15,9,12,7,7,13,12,8,14,8,10,16,18,16,10,9,15,12,16,20,14,9,11,5,13,4,13,8,16,13,11,17,14,18,3,1,1,15,15,12,15,10,S L,603,1,1,20,10,15,12,1,1,1,1,1,15,12,1,1,549890000000.0,0,0,0,0,1,0,0,0,0,0,1,0,1,0,0,0,0,0,0,0,0,0,0,0,0,0,0,1,0,0,0,0,0,0,0,0,0,0,0,1,0,0,0,0,0,0,0,0,Takuma Asano,Â£1.80m ,25.0,173.0,Forward - Left Winger,right,FK Partizan Belgrade,27.0,4.0,4.0,1747.0,20.0,2.0,2.0,1059.0,15.0,1.0,1.0,851.0,37.0,9.0,5.0,2783.0,14.0,7.0,4.0,1216.0,Bundesliga
19-06-17,18.3.4.28,Marco FabiÃ¡n,51002595,379,21-Jul-89,27,35,8,20,15,6250,6500,6750,138,135,14499066,170,65,AM RLC,1,3,3,2,1,1,1,3,1,3,3,15,15,13,14,17,13,12,17,7,5,14,13,6,16,9,12,10,15,10,17,13,9,17,8,11,5,12,8,13,17,12,7,12,10,10,20,11,8,8,6,15,8,12,8,10,15,12,8,10,12,17,1,1,14,20,15,16,20,AM RLC,506,1,1,10,20,16,15,1,1,1,1,12,14,13,1,1,1.44115e+17,0,0,0,0,0,0,0,0,0,1,0,1,0,0,0,0,0,0,0,0,0,0,0,0,0,0,0,0,0,0,0,0,0,0,0,1,0,0,0,0,0,0,0,0,0,0,0,0,Marco FabiÃ¡n,Â£4.05m ,31.0,170.0,Midfielder - Attacking Midfield,right,FC JuÃ¡rez,27.0,7.0,4.0,2312.0,9.0,1.0,0.0,530.0,27.0,8.0,1.0,1417.0,3.0,1.0,0.0,246.0,9.0,0.0,0.0,743.0,Bundesliga,15-07-16,17.3.2.23,Marco FabiÃ¡n,51002595,379,21-Jul-89,26,29,6,20,15,6345,6595,6845,138,137,18333358,170,65,AM RLC,1,3,1,4,3,1,1,1,3,2,3,15,15,14,14,17,13,12,17,7,5,14,13,6,17,9,12,10,14,10,16,13,9,17,8,11,5,12,9,13,17,12,7,12,10,11,20,11,8,8,6,15,8,12,8,10,15,12,8,10,12,17,Marco FabiÃ¡n,Â£6.30m ,Bundesliga
19-06-17,18.3.4.28,Bruma,55026952,788,24-Oct-94,22,0,0,15,5,5550,6550,7050,160,141,27229869,173,70,M/AM RL,2,3,3,3,1,3,2,2,3,2,1,11,10,17,12,14,9,7,15,6,4,12,11,6,15,14,11,7,10,10,13,9,13,18,4,14,6,8,14,18,16,10,7,10,13,17,20,13,8,12,6,13,8,13,10,18,7,12,12,14,10,14,1,1,20,20,16,20,14,M/AM RL,415,1,1,10,14,20,16,1,1,1,1,1,20,16,1,1,2252350000000000.0,0,0,0,0,0,0,0,0,0,0,0,0,0,0,0,0,0,0,0,0,0,0,0,0,0,0,0,1,0,0,0,0,0,0,0,0,0,0,0,1,0,0,0,0,0,0,0,0,Bruma,Â£11.25m ,26.0,173.0,Forward - Left Winger,right,Olympiacos Piraeus,37.0,11.0,9.0,3116.0,40.0,7.0,2.0,2466.0,27.0,3.0,3.0,1458.0,31.0,5.0,4.0,1768.0,4.0,0.0,2.0,208.0,Bundesliga
19-06-17,18.3.4.28,Alexandru Maxim,57024538,790,08-Jul-90,26,28,3,3,0,5100,6100,6600,137,132,10722822,178,70,M/AM RLC,1,3,2,2,2,1,4,2,1,2,2,17,14,15,13,15,13,5,12,4,5,14,12,6,16,10,13,7,14,10,16,12,12,17,5,14,6,12,10,14,15,8,7,16,11,11,20,10,7,10,5,12,6,13,14,16,12,10,9,10,8,14,1,1,16,20,15,16,20,M/AM RLC,526,1,1,10,20,16,15,1,1,1,10,13,16,15,1,1,584116000000.0,0,0,0,0,0,0,0,0,0,0,1,1,0,0,0,0,0,0,0,0,0,0,0,0,0,0,0,0,0,0,0,0,0,0,0,1,0,0,0,1,0,0,0,0,0,0,0,0,Alexandru Maxim,Â£1.80m ,30.0,177.0,Midfielder - Attacking Midfield,right,Gaziantep FK,27.0,5.0,7.0,1493.0,26.0,2.0,3.0,1217.0,24.0,3.0,2.0,727.0,21.0,7.0,2.0,1432.0,6.0,2.0,0.0,497.0,Bundesliga
19-06-17,18.3.4.28,Filip Kostic,62070416,802,01-Nov-92,24,15,2,9,2,6400,6900,6900,142,138,20581453,184,82,M/AM RL,3,3,1,3,3,2,1,3,1,3,1,14,15,14,12,12,10,7,13,10,5,12,11,6,13,11,10,14,12,10,11,10,10,14,6,13,6,8,11,18,14,16,10,20,11,16,9,12,12,12,8,12,5,11,12,17,6,14,9,8,10,15,8,8,20,20,16,20,14,M/AM RL,415,1,1,12,14,20,16,1,8,1,1,10,20,16,8,1,2.8823e+17,0,0,0,0,0,0,0,0,0,1,0,0,0,0,0,0,0,0,0,0,0,0,0,0,0,0,0,1,0,0,0,0,0,0,1,0,0,0,0,0,0,0,0,0,0,0,0,0,Filip Kostic,Â£5.40m ,27.0,184.0,Midfielder - Left Midfield,left,Eintracht Frankfurt,35.0,4.0,5.0,2803.0,30.0,5.0,1.0,2412.0,46.0,10.0,13.0,3994.0,51.0,12.0,18.0,4570.0,2.0,0.0,0.0,105.0,Bundesliga,15-07-16,17.3.2.23,Filip Kostic,62070416,802,01-Nov-92,23,9,0,9,2,6100,6850,7100,154,142,28020819,184,82,M/AM RL,2,1,3,2,3,2,1,3,2,3,1,15,16,15,12,13,10,8,14,10,5,12,11,6,13,11,10,14,12,10,11,10,13,14,6,13,6,8,11,18,14,16,10,20,11,16,8,12,13,12,8,12,5,11,12,17,6,14,9,8,10,15,Filip Kostic,Â£7.20m ,Bundesliga
19-06-17,18.3.4.28,Mijat Gacinovic,62096212,802,08-Feb-95,22,1,1,12,3,4600,6350,6600,141,132,16026584,175,66,M/AM LC,1,1,2,1,2,1,1,3,2,3,2,10,12,15,11,14,10,9,11,6,7,12,10,9,13,14,12,8,9,12,11,9,13,15,10,14,9,12,14,16,17,8,8,11,12,14,20,13,6,13,8,13,9,16,13,15,12,9,15,9,11,7,1,1,20,20,13,20,19,M/AM LC,414,1,1,1,19,20,13,1,1,1,10,17,20,13,1,1,1.44115e+17,0,0,0,0,0,0,0,0,0,0,0,0,0,0,0,0,0,0,0,0,0,0,0,0,0,0,0,0,0,0,0,0,0,0,0,0,0,0,0,0,0,0,0,0,0,0,0,0,Mijat Gacinovic,Â£7.20m ,25.0,175.0,Midfielder - Attacking Midfield,right,TSG 1899 Hoffenheim,34.0,2.0,1.0,2721.0,33.0,4.0,5.0,2103.0,45.0,2.0,9.0,2913.0,36.0,1.0,2.0,1651.0,7.0,0.0,1.0,218.0,Bundesliga,15-07-16,17.3.2.23,Mijat Gacinovic,62096212,802,08-Feb-95,21,0,0,3,1,4546,6046,6546,145,126,9865244,175,66,M/AM RLC,2,1,3,2,2,2,2,3,1,2,2,10,12,14,12,14,10,9,11,6,6,11,10,8,13,13,12,8,10,11,11,10,13,15,13,14,6,12,10,16,16,8,8,11,12,14,20,10,7,13,8,13,9,12,13,14,13,12,12,11,13,8,Mijat Gacinovic,Â£3.15m ,Bundesliga
19-06-17,18.3.4.28,Admir Mehmedi,69004160,798,16-Mar-91,26,53,7,9,6,5250,6750,6750,141,135,14499066,183,78,M/AM/S L,3,3,3,3,3,3,1,2,1,3,1,9,11,15,12,15,9,10,14,6,7,13,12,8,14,15,12,8,10,9,14,12,11,15,6,14,8,15,16,12,14,9,10,10,13,15,20,14,10,11,5,11,5,14,10,16,7,9,14,12,10,8,1,1,20,20,13,20,14,M/AM/S L,423,1,1,18,14,20,13,1,1,1,1,8,20,13,1,1,1.44115e+17,0,0,0,0,0,0,0,0,0,0,1,1,0,0,0,0,0,0,0,1,0,0,0,0,0,0,0,0,0,0,0,0,0,0,0,0,0,0,0,0,0,0,0,0,0,0,0,0,Admir Mehmedi,Â£4.50m ,29.0,183.0,Forward - Second Striker,right,VfL Wolfsburg,30.0,4.0,2.0,1663.0,21.0,3.0,5.0,1284.0,28.0,7.0,7.0,1799.0,26.0,3.0,5.0,1631.0,9.0,2.0,1.0,663.0,Bundesliga,15-07-16,17.3.2.23,Admir Mehmedi,69004160,798,16-Mar-91,25,46,5,9,6,5400,6900,6900,141,138,17783119,182,76,M/AM/S L,2,1,3,2,3,3,3,1,3,1,3,9,11,15,12,15,9,10,14,6,7,13,12,8,14,15,12,8,10,10,14,12,11,15,6,14,8,15,17,12,14,9,10,10,13,15,20,15,10,11,5,11,5,14,10,16,7,9,14,12,10,8,Admir Mehmedi,Â£3.15m ,Bundesliga
19-06-17,18.3.4.28,Steven Zuber,69004250,798,17-Aug-91,25,3,0,18,5,6900,6750,6900,143,138,17484340,182,81,WB/M/AM L,3,1,2,2,3,3,1,4,2,1,1,13,11,14,12,12,11,8,14,12,10,11,10,11,13,15,11,13,9,12,10,9,11,14,7,11,10,13,15,14,12,15,10,12,13,17,20,14,13,13,5,11,5,15,12,15,8,10,17,12,10,5,12,20,18,18,13,20,1,WB/M/AM L,223,1,1,1,1,18,13,1,12,1,1,1,18,13,20,1,584116000000.0,0,0,0,0,0,0,0,0,0,0,0,1,0,0,0,0,0,0,0,0,0,0,0,0,0,0,0,0,0,0,0,0,0,0,0,1,0,0,0,1,0,0,0,0,0,0,0,0,Steven Zuber,Â£6.30m ,29.0,182.0,Midfielder - Left Midfield,right,Eintracht Frankfurt,27.0,7.0,4.0,2296.0,27.0,1.0,2.0,1913.0,28.0,6.0,2.0,1862.0,16.0,2.0,1.0,911.0,6.0,0.0,0.0,393.0,Bundesliga,15-07-16,17.3.2.23,Steven Zuber,69004250,798,17-Aug-91,24,0,0,18,5,4550,6300,6550,139,136,11091324,182,81,WB/M/AM L,4,1,2,3,4,1,3,2,2,3,2,13,11,14,12,12,11,8,14,12,7,11,10,9,13,15,10,13,9,12,10,9,11,14,7,11,8,12,15,14,13,15,10,12,13,17,20,14,12,13,5,11,5,14,12,14,8,10,14,12,10,5,Steven Zuber,Â£4.50m ,Bundesliga
19-06-17,18.3.4.28,Eugene Konoplyanka,71000324,800,29-Sep-89,27,63,14,16,5,6750,7650,7250,153,145,42447357,176,69,M/AM LC,2,3,4,3,1,1,2,2,2,2,1,14,13,17,12,15,12,6,14,7,5,13,12,6,15,8,11,10,12,12,12,11,12,17,8,13,7,10,8,18,16,10,8,14,13,15,20,12,8,13,8,14,8,10,8,12,15,13,14,10,16,14,1,1,20,20,14,20,19,M/AM LC,414,1,1,10,19,20,14,1,1,1,1,1,20,13,1,1,1.44115e+17,0,0,0,0,0,0,0,0,0,0,0,1,0,0,0,0,0,0,0,0,0,0,0,0,0,0,0,1,0,0,0,0,0,0,0,0,0,0,0,0,0,0,0,0,0,0,0,0,Yevgen Konoplyanka,Â£9.00m ,31.0,178.0,Forward - Left Winger,right,Shakhtar Donetsk,29.0,7.0,2.0,1214.0,30.0,6.0,5.0,1785.0,21.0,1.0,2.0,1214.0,30.0,5.0,3.0,1496.0,4.0,0.0,0.0,74.0,Bundesliga,15-07-16,17.3.2.23,Eugene Konoplyanka,71000324,800,29-Sep-89,26,95,13,16,5,6950,7700,7450,153,149,35296094,176,69,M/AM L,1,1,3,2,1,3,1,2,1,3,3,14,13,17,12,15,12,6,14,7,5,13,12,6,15,8,11,10,12,12,12,11,12,17,8,14,7,10,8,18,16,12,8,14,14,16,20,12,8,13,8,14,8,10,8,12,15,13,14,10,16,10,Yevgen Konoplyanka,Â£9.00m ,LaLiga
19-06-17,18.3.4.28,Andriy Yarmolenko,71003202,800,23-Oct-89,27,70,29,16,3,6550,7800,7550,160,156,104064590,189,81,M/AM RL,2,1,1,1,1,2,1,1,3,1,1,13,15,16,15,16,12,12,15,8,6,14,16,7,17,12,14,16,13,14,14,15,14,16,13,16,8,12,11,13,14,16,13,20,18,16,10,13,14,17,8,10,4,13,12,10,16,14,16,8,12,10,1,6,20,20,20,15,10,M/AM RL,415,1,1,14,10,15,20,1,1,1,1,1,15,20,6,1,2.8823e+17,0,0,0,0,0,0,0,0,0,0,0,0,0,0,0,0,0,0,0,1,0,0,0,0,0,0,0,0,0,0,0,0,0,0,0,1,0,0,0,0,0,0,0,0,0,0,0,0,Andriy Yarmolenko,Â£20.70m ,31.0,190.0,Forward - Right Winger,left,West Ham United,36.0,19.0,10.0,2955.0,36.0,10.0,9.0,2475.0,10.0,2.0,1.0,549.0,23.0,5.0,1.0,985.0,7.0,2.0,3.0,351.0,Bundesliga
19-06-17,18.3.4.28,James RodrÃ­guez,76002390,1653,12-Jul-91,25,56,20,8,1,7800,8550,8300,172,166,225596475,180,75,M/AM RLC,3,1,2,3,3,1,2,2,1,2,3,17,18,14,16,19,16,12,17,8,6,16,14,8,17,11,17,13,18,15,19,17,13,18,12,14,8,14,11,12,14,15,10,20,12,12,9,14,11,15,10,16,13,15,15,17,9,13,11,12,14,15,1,1,18,20,17,18,20,M/AM RLC,526,1,1,9,20,18,17,1,1,1,1,15,18,17,1,1,9345850000000.0,0,0,0,0,0,0,0,0,0,0,0,1,0,0,0,0,0,0,0,0,1,0,0,0,0,0,0,0,0,0,0,0,0,0,0,0,0,0,0,1,0,0,0,1,0,0,0,0,James RodrÃ­guez,Â£63.00m ,29.0,181.0,Midfielder - Attacking Midfield,left,Everton FC,33.0,11.0,12.0,1884.0,39.0,8.0,14.0,2643.0,28.0,7.0,6.0,1654.0,14.0,1.0,2.0,758.0,7.0,3.0,4.0,602.0,Bundesliga,15-07-16,17.3.2.23,James RodrÃ­guez,76002390,1653,12-Jul-91,25,46,18,8,1,7995,9095,8250,169,165,73526057,180,77,M/AM RLC,3,2,2,3,1,2,1,2,1,1,3,17,16,16,15,17,16,12,17,8,7,17,17,6,16,12,15,12,16,15,17,15,14,18,13,17,10,13,14,14,15,15,10,20,12,13,9,16,12,13,11,16,13,17,15,15,9,14,11,16,14,15,James RodrÃ­guez,Â£45.00m ,LaLiga
19-06-17,18.3.4.28,Franck RibÃ©ry,8426264,769,07-Apr-83,34,81,16,13,2,7400,7900,7900,178,158,16531836,170,62,M/AM LC,2,3,3,1,3,2,3,1,1,1,1,12,13,17,15,18,14,5,15,6,7,14,12,8,17,11,14,12,15,12,16,16,16,19,9,15,8,10,11,13,15,16,6,15,13,16,20,12,9,19,8,16,15,9,12,17,12,15,10,6,7,18,1,1,20,20,13,20,15,M/AM LC,414,1,1,8,15,20,13,1,1,1,1,10,20,13,1,1,1.44115e+17,0,0,0,0,0,0,0,0,0,0,1,0,0,0,0,0,0,0,0,0,0,0,0,0,0,0,0,1,0,0,0,0,0,0,0,1,0,0,0,0,0,0,0,0,0,0,0,0,Franck RibÃ©ry,Â£3.60m ,37.0,170.0,Forward - Left Winger,right,ACF Fiorentina,32.0,5.0,17.0,1946.0,34.0,6.0,6.0,2241.0,38.0,7.0,4.0,1935.0,21.0,3.0,3.0,1424.0,3.0,0.0,2.0,248.0,Bundesliga,15-07-16,17.3.2.23,Franck RibÃ©ry,8426264,769,07-Apr-83,33,81,16,13,2,8000,8000,8400,178,160,232186002,170,62,M/AM LC,3,1,2,2,3,1,3,1,3,1,1,12,13,17,15,18,14,5,15,6,7,14,12,7,17,12,14,13,15,12,15,16,16,19,9,16,8,10,12,14,16,16,6,15,13,16,20,12,9,19,8,16,15,9,11,17,10,15,10,6,7,18,Franck RibÃ©ry,Â£6.30m ,Bundesliga
19-06-17,18.3.4.28,Thorgan Hazard,85023676,757,29-Mar-93,24,4,0,10,1,5550,6800,7050,148,141,30109950,174,69,M/AM/S RLC,2,2,1,2,4,2,3,3,4,1,2,14,12,16,12,16,13,7,14,7,6,14,13,8,15,13,11,8,10,10,16,12,10,16,6,14,7,12,14,14,16,10,9,10,12,13,20,13,7,13,6,12,8,14,11,16,10,12,12,14,14,8,1,1,20,20,15,20,18,M/AM/S RLC,426,1,1,16,18,20,15,1,1,1,8,10,20,15,1,1,1.44115e+17,0,0,0,0,0,0,0,0,0,0,0,1,0,0,0,0,0,0,0,0,0,0,0,0,1,0,0,0,0,0,0,0,0,0,0,0,0,0,0,0,0,0,0,0,0,0,0,0,Thorgan Hazard,Â£19.80m ,27.0,175.0,Forward - Left Winger,right,Borussia Dortmund,33.0,11.0,7.0,2272.0,37.0,11.0,9.0,3211.0,35.0,13.0,12.0,3058.0,43.0,7.0,14.0,3095.0,3.0,1.0,1.0,122.0,Bundesliga,15-07-16,17.3.2.23,Thorgan Hazard,85023676,757,29-Mar-93,23,1,0,10,1,6000,6500,7000,148,140,25712122,174,69,M/AM/S LC,3,3,2,2,3,3,1,1,2,3,2,14,12,15,12,16,13,7,14,7,6,14,13,8,16,13,11,9,10,10,16,12,10,16,6,14,7,12,14,14,16,10,9,10,12,13,20,13,8,13,6,12,8,14,11,16,10,12,12,14,14,8,Thorgan Hazard,Â£10.80m ,Bundesliga
19-06-17,18.3.4.28,Yoric Ravet,85033191,769,12-Sep-89,27,0,0,0,0,6250,6250,6750,135,135,16214009,178,74,M/AM RL,1,3,1,1,1,3,3,2,1,2,1,15,15,12,12,12,14,8,14,6,6,14,10,8,13,16,14,10,11,12,15,11,14,13,8,14,8,12,15,14,12,14,9,10,13,16,20,14,10,15,8,12,8,11,12,15,8,11,14,10,15,11,1,1,20,20,20,15,13,M/AM RL,415,1,1,12,13,15,20,1,1,1,1,8,15,20,1,1,549756000000.0,0,0,0,0,1,0,0,0,0,0,1,0,0,0,0,0,0,0,0,0,0,0,0,0,0,0,0,0,0,0,0,0,0,0,0,0,0,0,0,1,0,0,0,0,0,0,0,0,Yoric Ravet,Â£2.70m ,31.0,178.0,Forward - Right Winger,right,Grenoble Foot 38,44.0,10.0,20.0,3438.0,20.0,2.0,7.0,1181.0,21.0,3.0,1.0,1413.0,0.0,0.0,0.0,0.0,7.0,1.0,2.0,599.0,Bundesliga
19-06-17,18.3.4.28,RaphaÃ«l Guerreiro,85045409,788,22-Dec-93,23,20,2,13,0,7050,7550,7550,170,151,123653625,170,71,D/WB/M LC,2,1,3,3,2,2,1,2,1,1,1,15,15,12,10,14,15,8,13,12,9,13,10,10,14,14,16,10,17,14,12,16,14,12,8,13,10,17,16,15,17,10,6,20,17,13,8,16,7,15,6,15,8,17,13,13,12,12,14,16,16,8,20,20,17,15,1,20,17,D/WB/M LC,124,1,1,8,12,15,1,1,20,1,12,17,15,1,20,1,296354000000.0,0,0,0,0,0,0,0,0,0,0,0,0,0,0,0,0,0,0,0,0,1,0,0,0,0,0,0,0,0,0,0,0,1,0,1,0,0,0,1,0,0,0,0,0,0,0,0,0,RaphaÃ«l Guerreiro,Â£16.20m ,26.0,170.0,Midfielder - Left Midfield,left,Borussia Dortmund,35.0,7.0,9.0,2334.0,15.0,2.0,1.0,910.0,32.0,6.0,6.0,2036.0,38.0,8.0,5.0,2962.0,5.0,0.0,2.0,338.0,Bundesliga,15-07-16,17.3.2.23,RaphaÃ«l Guerreiro,85045409,788,22-Dec-93,22,12,2,13,0,6150,7650,7650,170,153,114707574,170,71,D/WB/M/AM LC,1,2,2,2,2,1,2,1,3,3,2,15,15,12,10,14,15,8,13,12,9,13,10,10,14,14,16,10,17,14,12,16,14,12,8,14,10,17,16,16,17,10,6,20,17,13,8,15,7,15,6,15,8,17,13,13,12,12,14,16,16,8,RaphaÃ«l Guerreiro,Â£18.00m ,Bundesliga
19-06-17,18.3.4.28,Arjen Robben,850881,784,23-Jan-84,33,92,33,8,1,7700,8200,8200,180,164,232186002,180,75,M/AM RL,1,3,3,1,1,3,3,3,2,3,3,16,16,20,17,19,12,12,17,13,6,14,13,8,19,12,15,7,13,16,12,12,16,17,10,14,8,7,14,16,14,12,10,20,17,16,8,13,9,17,6,15,16,10,17,18,7,14,18,6,8,16,1,10,20,20,20,17,12,M/AM RL,415,1,1,12,12,17,20,1,1,1,1,1,17,20,1,10,2.8823e+17,0,0,0,0,0,0,0,0,0,0,0,1,0,0,0,0,0,0,0,0,0,0,0,0,0,0,0,0,0,0,0,0,0,0,1,0,0,0,0,0,0,0,0,0,0,0,0,0,Arjen Robben,Â£6.30m ,36.0,180.0,Forward - Right Winger,left,FC Groningen,37.0,16.0,14.0,2730.0,34.0,7.0,12.0,2336.0,19.0,6.0,2.0,1008.0,nan,nan,nan,nan,2.0,0.0,0.0,44.0,Bundesliga,15-07-16,17.3.2.23,Arjen Robben,850881,784,23-Jan-84,32,88,30,8,1,8100,8600,8600,180,172,232186002,180,75,M/AM RL,2,3,2,3,2,1,3,3,1,3,4,17,16,20,17,19,12,12,17,13,6,14,13,8,19,12,16,7,13,16,12,12,16,17,9,17,8,7,14,16,15,12,10,20,17,17,8,14,10,17,6,15,16,10,17,18,7,14,18,6,8,16,Arjen Robben,Â£9.00m ,Bundesliga
19-06-17,18.3.4.28,Kingsley Coman,85104424,769,13-Jun-96,21,11,1,9,2,7300,7800,7800,171,156,170468631,178,71,M/AM RLC,2,3,1,3,2,2,1,1,4,1,3,12,13,15,11,14,10,8,11,8,6,12,10,7,14,15,11,13,10,11,12,10,12,15,6,12,8,13,15,17,16,12,10,11,16,19,20,14,10,14,6,15,8,15,16,18,7,14,13,13,17,14,1,1,20,20,18,20,15,M/AM RLC,416,1,1,12,15,20,18,1,1,1,1,1,20,18,1,1,1.44115e+17,0,0,0,0,0,0,0,0,0,0,0,0,0,0,0,0,0,0,0,0,0,0,0,0,0,0,0,1,1,0,0,0,0,0,0,0,0,0,0,0,0,0,0,0,0,0,0,0,Kingsley Coman,Â£45.00m ,24.0,179.0,Forward - Left Winger,right,Bayern Munich,25.0,2.0,1.0,1116.0,33.0,7.0,8.0,1869.0,30.0,10.0,7.0,1928.0,38.0,8.0,7.0,2434.0,5.0,2.0,2.0,303.0,Bundesliga,15-07-16,17.3.2.23,Kingsley Coman,85104424,769,13-Jun-96,20,11,1,9,2,6650,7650,7650,171,153,85552944,178,71,M/AM RLC,3,4,2,1,1,2,2,2,3,1,1,12,13,15,11,14,10,8,11,8,6,12,10,7,14,15,11,13,10,11,12,10,12,15,6,12,8,13,15,17,16,13,10,10,16,19,20,12,10,14,6,15,8,15,16,18,7,14,13,13,17,14,Kingsley Coman,Â£18.00m ,Bundesliga
19-06-17,18.3.4.28,Amine Harit,85137101,34,18-Jun-97,20,0,0,0,0,5600,6850,7100,159,142,22334124,179,67,M/AM LC,1,4,3,2,2,2,1,3,3,3,2,12,12,16,10,17,10,7,10,4,6,13,12,10,17,10,12,8,13,10,15,14,13,16,7,12,10,13,15,15,17,13,8,12,14,12,20,13,7,12,9,11,7,15,12,14,8,15,10,9,11,14,1,1,18,20,12,18,20,M/AM LC,524,1,1,1,20,18,12,1,1,1,10,15,18,12,1,1,549774000000.0,0,0,0,0,0,0,0,0,0,0,0,0,0,0,0,0,0,0,0,1,1,0,0,0,1,0,0,0,0,0,0,0,0,0,0,0,0,0,0,1,0,0,0,0,0,0,0,0,Amine Harit,Â£22.50m ,23.0,180.0,Midfielder - Attacking Midfield,right,FC Schalke 04,34.0,1.0,1.0,2399.0,35.0,3.0,7.0,2364.0,25.0,1.0,3.0,1431.0,28.0,7.0,7.0,2408.0,3.0,0.0,0.0,198.0,Bundesliga,15-07-16,17.3.2.23,Amine Harit,85137101,769,18-Jun-97,19,0,0,0,0,3240,5340,6290,157,116,13211016,179,66,M LC,3,2,1,2,3,2,2,2,4,1,1,13,11,14,10,14,13,9,10,4,7,13,11,9,15,10,12,10,13,10,13,12,14,13,10,13,12,11,11,12,14,12,6,10,12,13,20,12,10,12,11,11,11,11,11,14,12,11,13,11,13,10,Amine Harit,Â£1.80m ,Ligue 1
19-06-17,18.3.4.28,Salomon Kalou,859510,24,05-Aug-85,31,93,28,0,0,6650,7150,7150,151,143,232186002,184,77,M/AM/S L,3,1,4,3,2,1,2,2,2,4,3,8,10,14,13,16,12,16,12,7,6,12,17,6,15,10,15,9,16,12,14,13,10,15,10,14,8,10,12,13,15,12,11,10,14,12,20,13,11,13,6,14,5,13,16,14,12,17,16,12,17,14,1,1,20,20,12,20,14,M/AM/S L,423,1,1,19,14,20,12,1,1,1,1,1,20,12,1,1,549764000000.0,0,0,0,0,0,0,0,0,0,0,1,0,0,0,0,0,0,0,0,0,0,0,0,1,0,0,0,0,0,0,0,0,0,0,0,0,0,0,0,1,0,0,0,0,0,0,0,0,Salomon Kalou,Â£3.15m ,35.0,184.0,Forward - Left Winger,right,Botafogo de Futebol e Regatas,31.0,8.0,5.0,2490.0,36.0,12.0,3.0,2535.0,33.0,8.0,4.0,2573.0,20.0,3.0,0.0,1074.0,nan,nan,nan,nan,Bundesliga,15-07-16,17.3.2.23,Salomon Kalou,859510,24,05-Aug-85,30,85,28,0,0,6700,7200,7200,151,144,232186002,184,77,M/AM/S LC,2,1,3,2,3,1,1,2,3,2,3,8,10,14,13,16,10,16,12,7,6,12,17,6,15,10,15,9,16,12,14,13,10,15,10,14,8,10,12,14,15,12,11,10,13,12,20,13,11,13,6,14,5,12,17,14,12,16,12,12,17,14,Salomon Kalou,Â£3.60m ,Bundesliga
19-06-17,18.3.4.28,Sejad Salihovic,8708032,759,08-Oct-84,32,47,4,4,2,3500,6000,6000,141,120,1474385,182,82,M/AM LC,1,4,3,1,1,3,3,1,2,4,2,18,16,11,12,13,19,8,17,12,10,15,17,11,15,14,11,14,15,10,15,11,14,16,12,10,10,12,10,11,12,15,10,20,11,11,6,10,13,11,13,14,8,17,10,12,16,16,10,7,8,14,12,12,20,17,1,17,20,M/AM LC,414,1,1,1,16,17,1,1,12,1,14,20,17,1,12,1,103079000000.0,0,0,0,0,0,0,0,0,0,0,1,1,0,0,0,0,0,0,0,0,0,0,0,0,0,0,0,0,0,0,0,0,0,0,0,1,1,0,0,0,0,0,0,0,0,0,0,0,Sejad Salihovic,Â£315Th. ,36.0,182.0,Midfielder - Central Midfield,left,Retired,13.0,0.0,2.0,558.0,10.0,1.0,1.0,366.0,nan,nan,nan,nan,nan,nan,nan,nan,nan,nan,nan,nan,Bundesliga
19-06-17,18.3.4.28,Fabian Johnson,8726381,390,11-Dec-87,29,56,2,0,0,5400,6900,6900,149,143,18946115,183,70,D/WB/M/AM RL,3,3,1,3,3,2,1,1,2,3,3,10,13,12,11,12,10,8,11,16,9,10,9,10,11,16,9,13,10,12,10,9,13,11,8,14,8,13,16,14,13,11,11,20,17,17,15,14,9,12,9,13,5,18,10,15,12,12,15,16,18,5,17,18,20,20,16,20,10,D/WB/M/AM RL,445,1,1,1,1,20,12,1,17,16,10,10,20,12,18,16,135266304.0,0,0,0,0,0,0,0,0,0,0,0,0,0,0,0,0,0,0,0,0,1,0,0,0,0,0,0,1,0,0,0,0,0,0,0,0,0,0,0,0,0,0,0,0,0,0,0,0,Fabian Johnson,Â£4.05m ,32.0,183.0,Forward - Left Winger,right,Without Club,35.0,4.0,4.0,2038.0,12.0,1.0,0.0,479.0,18.0,1.0,1.0,1008.0,7.0,0.0,0.0,298.0,nan,nan,nan,nan,Bundesliga,15-07-16,17.3.2.23,Fabian Johnson,8726381,390,11-Dec-87,28,49,2,0,0,6700,7450,7200,149,149,27448186,183,70,D/WB/M/AM RL,1,3,1,2,2,3,2,2,1,1,1,10,13,12,11,12,10,8,11,16,9,10,9,10,11,16,9,13,10,12,10,9,13,11,8,14,8,13,16,15,13,11,11,20,17,17,15,16,9,12,9,13,5,18,10,15,12,12,15,16,18,5,Fabian Johnson,Â£5.40m ,Bundesliga
19-06-17,18.3.4.28,AndrÃ© SchÃ¼rrle,91002405,771,06-Nov-90,26,57,22,4,3,6150,7400,7150,158,148,29927394,184,74,M/AM/S RL,2,3,2,2,2,2,1,3,3,2,4,9,12,14,14,12,10,8,16,6,7,11,13,9,13,17,12,9,11,12,12,11,15,13,7,15,10,13,17,16,14,11,10,10,18,16,20,15,9,10,5,14,6,14,12,18,7,14,14,11,13,12,1,1,20,20,15,20,12,M/AM/S RL,425,1,1,17,12,20,15,1,1,1,1,1,20,15,1,1,1.44115e+17,0,0,0,0,0,0,0,0,0,0,0,0,0,0,0,0,0,0,0,0,0,0,0,0,0,0,0,1,0,0,0,0,0,0,0,0,0,0,0,0,0,0,0,0,0,0,0,0,AndrÃ© SchÃ¼rrle,Â£13.50m ,29.0,184.0,Forward - Left Winger,right,Retired,25.0,5.0,4.0,1126.0,26.0,3.0,6.0,1706.0,25.0,6.0,0.0,1732.0,18.0,2.0,4.0,1139.0,nan,nan,nan,nan,Bundesliga,15-07-16,17.3.2.23,AndrÃ© SchÃ¼rrle,91002405,771,06-Nov-90,25,55,20,4,3,7000,7750,7500,158,155,76312070,184,74,M/AM/S RL,2,4,3,3,2,2,1,1,3,2,3,9,13,15,14,12,10,8,16,6,7,12,14,8,13,17,12,9,10,12,11,11,15,13,7,15,9,13,17,17,14,12,10,10,18,17,20,15,10,10,5,14,6,14,12,18,7,14,14,11,13,12,AndrÃ© SchÃ¼rrle,Â£18.00m ,Bundesliga
19-06-17,18.3.4.28,Daniel Caligiuri,91003264,771,15-Jan-89,28,0,0,0,0,5050,6550,7050,141,141,23132297,182,79,WB/M/AM RL,4,4,1,2,2,1,3,2,3,2,2,10,12,13,11,12,10,8,12,12,9,11,14,14,12,16,11,13,11,12,12,10,12,14,7,12,10,14,16,13,12,15,9,10,14,16,20,16,12,13,8,13,8,16,9,14,12,11,15,13,10,8,12,20,18,18,20,16,10,WB/M/AM RL,225,1,1,10,10,16,18,1,1,12,1,1,16,18,1,20,1.44115e+17,0,0,0,0,0,0,0,0,0,0,1,0,0,0,0,0,0,0,0,0,0,0,0,0,0,0,0,0,0,0,0,0,0,0,0,0,0,0,0,0,0,0,0,0,0,0,0,0,Daniel Caligiuri,Â£6.75m ,32.0,182.0,Midfielder - Right Midfield,right,FC Augsburg,41.0,6.0,6.0,2969.0,37.0,6.0,11.0,3187.0,40.0,7.0,5.0,3516.0,30.0,4.0,5.0,2466.0,6.0,3.0,1.0,511.0,Bundesliga,15-07-16,17.3.2.23,Daniel Caligiuri,91003264,771,15-Jan-89,27,0,0,0,0,4400,6900,6900,141,138,17783119,182,79,M/AM RL,2,1,3,2,3,2,2,3,2,3,1,10,12,14,13,12,10,8,14,11,7,11,14,9,13,16,11,13,9,12,10,10,12,14,7,12,9,14,16,15,13,15,9,9,14,17,20,14,12,13,8,13,8,15,9,14,12,11,15,13,10,8,Daniel Caligiuri,Â£4.50m ,Bundesliga
19-06-17,18.3.4.28,Kevin Kampl,91005023,795,09-Oct-90,26,25,2,17,2,6018,6670,7500,150,150,62648655,178,67,M/AM RLC,1,2,3,1,1,2,1,2,3,3,2,11,11,14,10,15,12,6,13,6,8,13,10,12,15,18,12,8,13,12,15,14,14,15,7,14,11,16,18,15,17,10,8,12,16,12,20,17,7,15,5,14,6,17,9,17,6,13,12,10,10,13,1,1,20,20,20,15,18,M/AM RLC,416,1,1,1,17,15,20,1,1,1,10,18,15,20,1,1,549778000000.0,0,0,0,0,0,0,0,0,0,0,0,0,0,0,0,0,0,0,0,1,1,0,1,0,1,0,0,0,0,0,0,0,0,0,0,0,0,0,0,1,0,0,0,0,0,0,0,0,Kevin Kampl,Â£16.20m ,30.0,178.0,Midfielder - Central Midfield,right,RB Leipzig,39.0,2.0,4.0,3372.0,39.0,1.0,5.0,2993.0,40.0,3.0,8.0,3160.0,15.0,2.0,2.0,965.0,6.0,0.0,1.0,353.0,Bundesliga,15-07-16,17.3.2.23,Kevin Kampl,91005023,795,09-Oct-90,25,23,2,17,2,6500,7250,7500,152,150,34521695,178,65,M/AM RLC,1,3,3,2,1,1,3,1,2,3,3,11,11,14,10,15,10,6,13,6,8,13,10,12,15,18,12,8,13,12,15,14,14,15,7,15,11,16,18,15,17,10,8,12,16,12,20,17,7,15,5,14,6,17,9,16,7,13,12,10,10,11,Kevin Kampl,Â£13.50m ,Bundesliga
19-06-17,18.3.4.28,Simon Zoller,91007707,771,26-Jun-91,25,0,0,0,0,4300,6300,6300,128,126,6478634,179,70,S RL,1,2,3,1,3,1,3,3,1,4,1,6,9,13,13,12,7,14,10,5,6,10,11,6,12,12,15,10,12,12,11,10,11,13,7,14,8,12,14,16,15,10,10,10,12,13,20,13,8,11,6,11,3,13,10,15,7,9,12,12,10,7,1,1,15,15,15,15,12,S RL,605,1,1,20,12,15,15,1,1,1,1,1,15,15,1,1,4398050000000.0,0,0,0,0,0,0,0,0,0,0,0,0,0,0,0,0,0,0,0,1,0,1,0,0,0,0,0,0,0,0,0,0,0,0,0,0,0,0,0,0,0,0,1,0,0,0,0,0,Simon Zoller,Â£1.58m ,29.0,179.0,Forward - Centre-Forward,right,VfL Bochum,29.0,2.0,3.0,1234.0,22.0,5.0,3.0,1328.0,12.0,2.0,1.0,709.0,25.0,6.0,4.0,1582.0,6.0,4.0,0.0,446.0,Bundesliga,15-07-16,17.3.2.23,Simon Zoller,91007707,771,26-Jun-91,25,0,0,0,0,4400,6400,6400,129,128,7125519,179,70,S RL,3,1,1,1,2,1,1,2,3,3,2,6,9,13,13,11,7,14,10,5,6,10,11,6,12,12,15,10,14,12,11,10,11,13,7,14,8,12,14,16,15,10,10,10,12,13,20,13,9,11,6,11,3,13,10,15,7,9,12,12,10,7,Simon Zoller,Â£2.25m ,Bundesliga
19-06-17,18.3.4.28,Marco Reus,91013383,771,31-May-89,28,29,9,2,0,7400,8400,8400,171,168,232186002,180,75,M/AM RL,3,2,1,3,3,2,4,1,1,1,1,15,13,14,16,14,16,6,14,7,6,12,15,8,13,16,16,7,12,12,14,16,15,15,7,18,10,13,14,18,15,9,8,14,14,16,20,14,8,17,4,17,12,16,9,14,15,17,13,10,12,9,1,1,20,20,16,20,14,M/AM RL,415,1,1,15,14,20,16,1,1,1,1,1,20,16,1,1,1.44115e+17,0,0,0,0,1,0,0,0,0,0,0,0,0,0,0,0,0,0,0,0,1,0,0,0,0,0,0,1,0,0,0,0,0,0,0,0,0,0,0,0,0,0,0,0,0,0,0,0,Marco Reus,Â£31.50m ,31.0,180.0,Midfielder - Attacking Midfield,right,Borussia Dortmund,24.0,13.0,8.0,1703.0,15.0,7.0,1.0,1163.0,36.0,21.0,13.0,3053.0,26.0,12.0,7.0,2120.0,8.0,2.0,0.0,334.0,Bundesliga,15-07-16,17.3.2.23,Marco Reus,91013383,771,31-May-89,27,29,9,2,0,7500,8500,8500,171,170,196228716,180,75,M/AM/S RLC,3,3,2,3,3,3,3,1,1,2,2,15,13,14,16,14,16,6,14,7,6,12,15,8,13,16,16,7,12,12,14,16,15,15,7,18,10,13,14,18,15,9,8,14,14,16,20,14,8,17,4,17,12,16,9,14,15,17,13,10,12,9,Marco Reus,Â£31.50m ,Bundesliga
19-06-17,18.3.4.28,Felix Klaus,91016409,771,13-Sep-92,24,0,0,4,0,4550,6550,6550,135,131,10614965,180,79,M/AM RL,2,3,2,3,3,2,2,4,2,4,1,10,11,14,13,11,12,6,14,8,6,10,9,7,12,14,12,7,10,12,11,8,9,13,6,14,8,12,10,15,13,14,9,12,10,18,20,12,12,10,8,12,10,14,6,13,7,14,8,10,12,11,1,1,20,20,18,20,12,M/AM RL,415,1,1,10,12,20,18,1,1,1,1,1,20,18,1,1,2.8823e+17,0,0,0,0,0,0,0,0,0,0,0,0,0,0,0,0,0,0,0,0,0,0,0,0,0,0,0,0,0,0,0,0,0,0,0,0,0,0,0,0,0,0,0,0,0,0,0,0,Felix Klaus,Â£4.05m ,28.0,179.0,Forward - Right Winger,right,VfL Wolfsburg,33.0,9.0,7.0,2699.0,29.0,4.0,9.0,2080.0,15.0,1.0,1.0,435.0,29.0,0.0,2.0,850.0,5.0,0.0,0.0,275.0,Bundesliga
19-06-17,18.3.4.28,Jonathan Schmid,91016490,769,26-Jun-90,26,0,0,0,0,4100,5619,6550,140,131,9492227,179,77,M/AM RL,3,3,1,2,1,2,2,3,2,2,3,11,14,12,13,11,15,8,10,13,9,12,10,11,12,16,12,14,9,12,11,10,16,13,8,14,10,14,16,15,13,15,9,10,17,14,20,14,10,13,8,14,4,16,14,12,13,15,14,11,13,8,12,12,20,20,18,20,1,M/AM RL,415,1,1,1,1,20,18,1,10,12,1,1,20,18,10,12,549890000000.0,0,0,0,0,1,0,0,0,0,0,1,1,0,0,0,0,0,0,0,0,0,0,0,0,0,0,0,1,0,0,0,0,0,0,0,0,0,0,0,1,0,0,0,0,0,0,0,0,Jonathan Schmid,Â£2.25m ,30.0,180.0,Defender - Right-Back,right,SC Freiburg,26.0,1.0,3.0,1729.0,26.0,0.0,0.0,1557.0,29.0,3.0,7.0,2640.0,35.0,5.0,2.0,3050.0,6.0,1.0,0.0,518.0,Bundesliga,15-07-16,17.3.2.23,Jonathan Schmid,91016490,769,26-Jun-90,26,0,0,0,0,4649,5913,6600,140,137,10665616,179,77,M/AM RL,2,1,1,2,1,3,2,2,2,3,3,11,15,12,13,12,15,8,10,14,9,13,9,11,12,17,12,14,10,12,11,10,16,13,9,15,9,14,17,15,13,16,9,10,17,14,20,15,11,13,8,14,4,16,14,12,13,15,14,11,13,8,Jonathan Schmid,Â£2.70m ,Bundesliga
19-06-17,18.3.4.28,Yunus Malli,91017783,799,24-Feb-92,25,12,0,0,0,6700,6700,7200,148,144,34497957,179,70,M/AM/S LC,3,3,2,3,1,3,1,2,1,3,1,14,12,15,13,15,12,7,11,4,6,14,12,8,16,16,13,7,12,9,15,12,8,16,5,16,10,13,17,15,17,8,6,12,14,11,20,15,7,13,4,11,8,14,7,10,12,10,14,14,18,9,1,1,16,20,12,16,20,M/AM/S LC,534,1,1,17,20,16,12,1,1,1,8,13,16,12,1,1,549757000000.0,0,0,0,0,0,0,0,0,0,0,1,0,0,0,0,0,0,0,0,0,1,0,0,0,0,0,0,0,0,0,0,0,0,0,0,0,0,0,0,1,0,0,0,0,0,0,0,0,Yunus Malli,Â£8.10m ,28.0,179.0,Midfielder - Attacking Midfield,right,VfL Wolfsburg,43.0,9.0,9.0,3377.0,37.0,6.0,5.0,2704.0,23.0,1.0,2.0,773.0,15.0,0.0,1.0,726.0,1.0,0.0,0.0,58.0,Bundesliga,15-07-16,17.3.2.23,Yunus Malli,91017783,799,24-Feb-92,24,7,0,0,0,6300,6800,7300,152,146,38910983,179,70,M/AM/S LC,2,2,2,1,2,3,3,1,2,1,3,14,12,15,13,16,12,7,11,4,6,14,12,8,16,16,13,7,12,9,15,12,8,16,5,16,10,13,17,15,17,8,6,12,14,11,20,15,7,13,4,11,8,14,7,10,12,10,14,14,18,9,Yunus Malli,Â£9.00m ,Bundesliga
19-06-17,18.3.4.28,AndrÃ© Hahn,91018460,771,13-Aug-90,26,1,0,0,0,6250,6750,6750,140,140,16691101,185,79,M/AM/S RL,3,1,1,1,3,2,2,3,3,1,2,9,14,11,13,10,8,14,12,12,7,9,12,8,10,17,12,16,11,13,10,9,17,12,11,15,10,12,17,12,10,16,12,12,18,18,20,16,13,13,8,14,4,15,10,16,8,14,13,12,9,9,1,1,20,20,20,15,10,M/AM/S RL,425,1,1,16,10,15,20,1,1,1,1,1,15,20,1,1,16.0,0,0,0,0,1,0,0,0,0,0,0,0,0,0,0,0,0,0,0,0,0,0,0,0,0,0,0,0,0,0,0,0,0,0,0,0,0,0,0,0,0,0,0,0,0,0,0,0,AndrÃ© Hahn,Â£1.35m ,30.0,185.0,Forward - Right Winger,right,FC Augsburg,45.0,5.0,4.0,2332.0,24.0,3.0,0.0,1441.0,32.0,5.0,5.0,2381.0,16.0,2.0,0.0,788.0,6.0,2.0,3.0,304.0,Bundesliga,15-07-16,17.3.2.23,AndrÃ© Hahn,91018460,771,13-Aug-90,25,1,0,0,0,5000,7000,7000,146,145,21039217,185,79,M/AM/S RL,3,3,1,1,3,3,1,2,1,2,1,9,15,11,14,10,8,14,12,13,7,9,12,8,11,18,12,16,11,14,10,10,17,12,11,15,10,12,18,12,10,17,12,12,18,18,20,16,13,14,8,14,4,15,10,16,8,14,13,12,9,10,AndrÃ© Hahn,Â£4.05m ,Bundesliga
19-06-17,18.3.4.28,Philipp Max,91100531,771,30-Sep-93,23,0,0,0,0,6350,6600,6850,142,137,18153879,177,77,D/WB L,1,1,2,1,2,2,1,3,3,2,1,13,16,10,7,10,11,8,9,14,10,12,9,13,11,16,10,14,9,13,12,11,15,11,10,11,10,14,17,16,12,14,9,20,15,14,10,16,11,15,8,15,5,15,10,18,10,12,17,13,13,6,20,20,15,15,12,20,8,D/WB L,113,1,1,1,1,15,10,1,20,12,8,8,15,10,20,12,0.0,0,0,0,0,0,0,0,0,0,0,0,0,0,0,0,0,0,0,0,0,0,0,0,0,0,0,0,0,0,0,0,0,0,0,0,0,0,0,0,0,0,0,0,0,0,0,0,0,Philipp Max,Â£13.50m ,27.0,177.0,Defender - Left-Back,left,PSV Eindhoven,26.0,1.0,3.0,1907.0,34.0,2.0,13.0,3050.0,34.0,4.0,7.0,2995.0,31.0,8.0,6.0,2714.0,8.0,1.0,5.0,690.0,Bundesliga,15-07-16,17.3.2.23,Philipp Max,91100531,771,30-Sep-93,22,0,0,0,0,4397,6397,6397,134,128,10083707,178,75,D/WB L,3,3,1,3,2,3,2,2,3,2,3,9,13,10,7,11,11,8,9,14,10,12,12,14,11,16,10,14,9,12,10,10,13,11,9,13,9,14,16,16,12,14,9,20,16,14,10,14,10,15,8,15,5,15,9,15,10,11,13,14,14,6,Philipp Max,Â£3.15m ,Bundesliga
19-06-17,18.3.4.28,Vincenzo Grifo,91105243,776,07-Apr-93,24,0,0,0,0,4950,6450,6950,144,139,24404370,181,75,M/AM RLC,2,3,3,1,1,1,1,1,3,3,3,17,16,13,13,16,17,6,16,8,7,15,13,10,15,11,13,8,15,10,17,14,11,16,7,12,9,10,13,13,15,10,9,8,11,11,20,15,9,14,4,13,5,14,10,15,7,13,10,7,9,13,1,1,20,20,15,20,18,M/AM RLC,416,1,1,8,18,20,15,1,1,1,1,12,20,15,1,1,1.44115e+17,0,0,0,0,0,0,0,0,0,0,1,1,0,0,0,0,0,0,0,0,0,0,0,0,0,0,0,0,0,0,0,0,0,0,0,0,1,0,0,0,0,0,0,0,0,0,0,0,Vincenzo Grifo,Â£6.75m ,27.0,180.0,Forward - Left Winger,right,SC Freiburg,32.0,9.0,12.0,2648.0,18.0,0.0,4.0,793.0,26.0,7.0,7.0,1881.0,29.0,4.0,10.0,1769.0,6.0,2.0,1.0,435.0,Bundesliga,15-07-16,17.3.2.23,Vincenzo Grifo,91105243,776,07-Apr-93,23,0,0,0,0,5300,6300,6800,143,136,17057485,181,75,M/AM RLC,2,1,1,3,1,3,3,3,3,1,1,17,16,13,13,15,17,6,16,8,6,14,12,9,15,10,12,8,14,9,16,13,11,16,8,13,8,10,12,13,15,10,9,8,11,12,20,15,9,14,4,13,5,13,10,15,7,13,10,7,8,13,Vincenzo Grifo,Â£9.00m ,Bundesliga
19-06-17,18.3.4.28,Christian GÃ¼nter,91105585,771,28-Feb-92,25,1,0,9,0,6100,6600,6600,137,132,11391556,185,80,D/WB L,3,3,2,1,2,2,3,3,2,2,1,11,13,14,7,11,10,9,12,16,12,10,8,12,11,16,10,14,9,12,8,9,13,11,9,12,10,13,16,14,11,14,10,20,16,17,10,16,12,13,10,12,4,14,5,10,16,11,17,14,14,4,20,20,15,15,12,20,10,D/WB L,113,1,1,1,1,15,1,10,20,12,1,1,15,1,20,12,0.0,0,0,0,0,0,0,0,0,0,0,0,0,0,0,0,0,0,0,0,0,0,0,0,0,0,0,0,0,0,0,0,0,0,0,0,0,0,0,0,0,0,0,0,0,0,0,0,0,Christian GÃ¼nter,Â£4.50m ,27.0,185.0,Defender - Left-Back,left,SC Freiburg,33.0,0.0,2.0,2905.0,39.0,1.0,6.0,3510.0,34.0,0.0,7.0,3090.0,36.0,2.0,10.0,3241.0,6.0,0.0,1.0,540.0,Bundesliga,15-07-16,17.3.2.23,Christian GÃ¼nter,91105585,771,28-Feb-92,24,1,0,9,0,5047,6547,6547,137,131,9671738,184,81,D/WB L,2,3,3,2,2,2,2,4,1,2,1,11,13,13,7,11,10,9,12,16,12,10,8,12,11,16,10,14,9,12,8,9,13,11,10,12,9,13,16,14,11,14,10,20,16,17,10,16,12,13,10,12,4,14,8,12,15,9,17,14,10,4,Christian GÃ¼nter,Â£3.15m ,Bundesliga
19-06-17,18.3.4.28,Maximilian Philipp,91108767,771,01-Mar-94,23,0,0,10,0,4650,6900,7150,155,143,37091816,182,77,M/AM/S RLC,2,1,1,1,1,3,1,3,2,2,2,9,10,14,13,14,11,10,15,6,6,12,13,9,13,16,12,8,10,12,14,11,11,15,6,15,9,17,16,14,15,9,11,14,13,13,20,15,10,12,4,11,5,15,8,14,13,10,16,16,18,3,1,1,16,18,15,16,18,M/AM/S RLC,636,1,1,20,18,16,15,1,1,1,1,8,16,15,1,1,549774000000.0,0,0,0,0,0,0,0,0,0,0,0,0,0,0,0,0,0,0,0,0,1,0,0,0,1,0,0,0,0,0,0,0,0,0,0,0,0,0,0,1,0,0,0,0,0,0,0,0,Maximilian Philipp,Â£18.00m ,26.0,183.0,Forward - Second Striker,right,VfL Wolfsburg,27.0,9.0,5.0,2130.0,28.0,9.0,5.0,1655.0,23.0,2.0,3.0,1046.0,21.0,8.0,1.0,1310.0,10.0,1.0,0.0,547.0,Bundesliga,15-07-16,17.3.2.23,Maximilian Philipp,91108767,771,01-Mar-94,22,0,0,0,0,5250,6750,6750,146,135,12150261,182,77,AM/S RLC,1,2,1,2,1,1,1,3,1,4,3,10,11,14,12,14,11,9,14,6,6,12,13,8,13,16,11,9,10,9,14,11,10,14,5,15,8,17,16,12,14,9,11,14,13,15,20,13,10,12,4,12,5,15,8,12,13,8,15,15,18,4,Maximilian Philipp,Â£13.50m ,Bundesliga
19-06-17,18.3.4.28,Julian Brandt,91119265,771,02-May-96,21,10,1,8,1,6900,7400,7400,172,148,54318095,183,82,M/AM RLC,2,1,3,4,2,1,2,1,1,2,2,12,12,16,14,18,13,6,12,7,5,13,11,6,16,10,14,7,12,9,15,15,10,14,5,16,8,13,10,16,14,9,12,12,13,13,20,12,11,11,4,11,4,14,9,17,8,11,14,14,16,7,1,8,20,20,18,20,16,M/AM RLC,416,1,1,14,16,20,18,1,1,1,1,1,20,18,1,8,1.44115e+17,0,0,0,0,0,0,0,0,0,0,0,0,0,0,1,0,0,0,0,0,1,0,0,0,1,0,0,0,0,0,0,0,0,0,0,0,0,0,0,0,0,0,0,0,0,0,0,0,Julian Brandt,Â£36.00m ,24.0,185.0,Midfielder - Central Midfield,right,Borussia Dortmund,40.0,4.0,11.0,2839.0,39.0,12.0,7.0,2731.0,43.0,10.0,17.0,3337.0,42.0,7.0,13.0,2876.0,8.0,1.0,0.0,337.0,Bundesliga,15-07-16,17.3.2.23,Julian Brandt,91119265,771,02-May-96,20,1,0,8,1,5250,7250,7250,172,145,70547626,185,82,M/AM RLC,3,2,2,3,1,1,3,1,2,2,3,12,12,16,14,17,13,6,11,7,5,13,11,6,16,10,14,7,12,9,15,13,10,15,5,15,8,13,10,16,14,10,12,12,13,13,20,12,11,11,4,11,4,14,10,17,8,11,14,14,16,7,Julian Brandt,Â£18.00m ,Bundesliga
19-06-17,18.3.4.28,RenÃ© Klingenburg,91119623,771,29-Dec-93,23,0,0,0,0,1479,4192,4250,84,72,55051,187,83,M/AM RL,3,1,1,1,2,2,1,2,3,1,1,7,10,9,8,9,6,6,7,6,6,7,2,6,9,9,9,3,7,7,3,11,11,9,13,8,6,7,8,13,13,7,13,10,11,13,20,8,11,9,6,5,7,9,6,11,12,13,13,13,13,6,1,1,18,20,20,18,1,M/AM RL,525,1,1,14,1,18,20,1,1,1,1,1,15,18,1,1,0.0,0,0,0,0,0,0,0,0,0,0,0,0,0,0,0,0,0,0,0,0,0,0,0,0,0,0,0,0,0,0,0,0,0,0,0,0,0,0,0,0,0,0,0,0,0,0,0,0,nan,nan,nan,nan,nan,nan,nan,nan,nan,nan,nan,nan,nan,nan,nan,nan,nan,nan,nan,nan,nan,nan,nan,nan,nan,nan,nan,nan,
19-06-17,18.3.4.28,Levin Ãztunali,91119701,771,15-Mar-96,21,0,0,13,3,4650,6900,6650,145,138,23976756,184,80,M/AM RLC,3,3,2,3,1,1,3,3,2,1,4,13,14,14,10,14,10,6,13,12,8,12,10,10,13,15,10,8,9,10,13,8,10,13,7,12,9,13,15,14,12,14,11,14,17,17,20,13,11,10,6,11,4,18,7,17,10,8,14,16,18,3,13,13,20,20,20,16,15,M/AM RLC,416,1,1,10,15,16,20,1,1,13,8,12,16,20,1,13,0.0,0,0,0,0,0,0,0,0,0,0,0,0,0,0,0,0,0,0,0,0,0,0,0,0,0,0,0,0,0,0,0,0,0,0,0,0,0,0,0,0,0,0,0,0,0,0,0,0,Levin Ãztunali,Â£4.95m ,24.0,185.0,Midfielder - Right Midfield,right,1.FSV Mainz 05,36.0,6.0,6.0,2173.0,26.0,0.0,5.0,1870.0,16.0,0.0,2.0,954.0,27.0,4.0,4.0,1778.0,5.0,0.0,1.0,237.0,Bundesliga,15-07-16,17.3.2.23,Levin Ãztunali,91119701,771,15-Mar-96,20,0,0,3,1,4650,6900,6650,153,138,25983054,184,80,M/AM RLC,1,3,4,2,2,2,2,3,3,3,1,13,14,14,10,14,10,6,13,12,8,12,10,10,13,15,10,8,9,10,13,8,10,13,7,12,9,13,15,14,12,14,11,14,17,17,20,13,11,11,6,11,4,18,7,17,10,8,14,16,18,3,Levin Ãztunali,Â£5.85m ,Bundesliga
19-06-17,18.3.4.28,Sinan Kurt,91121017,771,23-Jul-96,20,0,0,0,0,3100,5600,5600,140,112,2045574,173,71,M/AM RLC,2,1,1,3,3,2,3,2,1,1,1,14,12,13,15,12,14,7,14,5,4,12,11,4,13,7,12,6,10,7,13,10,7,15,5,13,5,10,7,16,15,7,6,20,11,14,8,9,6,8,4,8,10,14,5,17,5,12,7,10,12,14,1,1,20,20,15,20,18,M/AM RLC,416,1,1,14,18,20,15,1,1,1,1,8,20,15,1,1,1.44115e+17,0,0,0,0,1,0,0,0,0,0,0,1,0,0,0,0,0,0,0,0,0,0,0,0,0,0,0,0,0,0,0,0,0,0,1,0,0,0,0,0,0,0,0,0,0,0,0,0,Sinan Kurt,Â£113Th. ,24.0,178.0,Forward - Left Winger,left,SV Straelen,10.0,1.0,2.0,596.0,21.0,1.0,2.0,1281.0,20.0,1.0,2.0,726.0,nan,nan,nan,nan,3.0,0.0,1.0,241.0,Bundesliga,15-07-16,17.3.2.23,Sinan Kurt,91121017,771,23-Jul-96,19,0,0,0,0,3600,5600,5600,135,112,2282720,173,71,M/AM RLC,1,3,3,3,1,2,3,3,3,2,1,14,12,13,15,12,14,7,14,5,4,12,11,4,13,7,12,6,10,7,13,10,7,15,5,13,5,10,7,16,15,7,6,20,12,14,8,9,6,8,4,8,5,14,7,17,5,12,8,10,12,14,Sinan Kurt,Â£270Th. ,Bundesliga
19-06-17,18.3.4.28,Kenan Karaman,91121536,799,05-Mar-94,23,0,0,9,1,3800,5750,6300,139,126,6053538,189,83,M/AM RLC,1,4,3,1,2,3,3,2,3,1,1,8,11,13,12,14,9,12,14,6,5,12,10,7,14,9,12,10,10,8,14,9,9,15,5,11,8,12,9,13,13,10,14,14,13,16,20,12,12,11,4,11,5,15,9,15,10,10,13,14,16,6,1,1,20,20,15,20,18,M/AM RLC,416,1,1,14,18,20,15,1,1,1,1,1,20,15,1,1,1.44115e+17,0,0,0,0,0,0,0,0,0,0,0,0,0,0,0,0,0,0,0,0,1,0,0,0,0,0,0,0,0,0,0,0,0,0,0,1,0,0,0,0,0,0,0,0,0,0,0,0,Kenan Karaman,Â£1.35m ,26.0,189.0,Forward - Centre-Forward,right,Fortuna DÃ¼sseldorf,34.0,6.0,6.0,1786.0,24.0,2.0,1.0,898.0,22.0,3.0,3.0,947.0,21.0,6.0,1.0,1432.0,4.0,1.0,0.0,343.0,Bundesliga
19-06-17,18.3.4.28,Marius Wolf,91124151,771,27-May-95,22,0,0,0,0,4250,6500,6750,141,135,23549289,187,73,WB/M/AM RL,3,3,3,3,1,2,1,1,1,3,3,12,10,13,11,11,9,10,13,12,9,10,13,11,12,15,10,14,8,12,11,8,17,13,9,14,10,12,16,15,11,13,13,10,16,17,20,15,9,12,4,11,6,17,7,16,9,10,11,11,13,9,10,20,19,19,20,15,1,WB/M/AM RL,225,1,1,11,1,15,19,1,1,10,1,1,15,19,1,20,0.0,0,0,0,0,0,0,0,0,0,0,0,0,0,0,0,0,0,0,0,0,0,0,0,0,0,0,0,0,0,0,0,0,0,0,0,0,0,0,0,0,0,0,0,0,0,0,0,0,Marius Wolf,Â£9.00m ,25.0,187.0,Forward - Right Winger,right,1. FC KÃ¶ln,13.0,1.0,1.0,803.0,34.0,6.0,11.0,2790.0,22.0,1.0,0.0,1258.0,24.0,1.0,5.0,1615.0,3.0,0.0,0.0,224.0,Bundesliga,15-07-16,17.3.2.23,Marius Wolf,91124151,771,27-May-95,21,0,0,0,0,2800,5800,5800,130,116,4071736,185,68,M/AM RL,3,2,3,1,2,3,1,3,2,1,2,8,10,12,9,12,7,11,8,10,6,9,13,7,11,14,10,13,8,10,8,8,15,14,7,12,7,12,11,16,12,10,12,10,14,16,20,13,9,12,4,11,6,13,8,14,12,10,13,11,14,8,Marius Wolf,Â£450Th. ,Bundesliga
19-06-17,18.3.4.28,Ihlas Bebou,91132870,50,23-Apr-94,23,12,0,0,0,5250,6750,6750,139,135,16214009,183,77,M/AM/S RL,1,3,2,1,2,1,1,3,2,1,1,8,10,14,10,12,8,7,9,8,6,11,13,6,14,14,10,13,9,12,10,8,11,15,6,14,7,10,14,15,14,13,12,9,11,18,20,13,12,11,7,11,14,13,10,14,9,12,13,12,10,8,1,1,20,20,20,17,10,M/AM/S RL,425,1,1,16,10,17,20,1,1,1,1,1,17,20,1,1,2251800000000000.0,0,0,0,0,0,0,0,0,0,0,0,0,0,0,0,0,0,0,0,0,0,0,0,0,0,0,0,1,0,0,0,0,0,0,0,0,0,0,0,0,0,0,0,0,0,0,0,0,Ihlas Bebou,Â£7.65m ,26.0,183.0,Forward - Right Winger,right,TSG 1899 Hoffenheim,34.0,6.0,11.0,2884.0,36.0,7.0,2.0,2683.0,14.0,5.0,3.0,1249.0,35.0,7.0,5.0,2365.0,6.0,0.0,3.0,239.0,Bundesliga
19-06-17,18.3.4.28,Erik Thommy,91137292,771,20-Aug-94,22,0,0,0,0,2750,6000,6250,126,120,2838145,174,64,M/AM RL,1,3,2,2,3,1,1,3,1,3,2,15,14,14,12,12,15,7,15,6,5,13,12,7,13,13,10,8,12,10,14,11,11,15,6,12,8,12,13,14,16,8,7,10,11,12,20,12,6,13,5,13,8,15,7,14,12,10,12,13,15,8,1,1,20,20,16,20,12,M/AM RL,415,1,1,14,12,20,16,1,1,1,1,1,20,16,1,1,618475000000.0,0,0,0,0,0,0,0,0,0,0,0,1,0,0,0,0,0,0,0,0,0,0,0,0,0,0,0,0,0,0,0,0,0,0,0,0,1,0,0,1,0,0,0,0,0,0,0,0,Erik Thommy,Â£4.50m ,26.0,175.0,Midfielder - Left Midfield,right,VfB Stuttgart,40.0,8.0,9.0,3534.0,20.0,2.0,6.0,1159.0,21.0,1.0,3.0,939.0,37.0,6.0,6.0,2514.0,nan,nan,nan,nan,Bundesliga
19-06-17,18.3.4.28,Nadiem Amiri,91143491,771,27-Oct-96,20,0,0,11,2,5250,6750,6750,160,135,28530422,180,72,M/AM RLC,3,3,2,1,2,3,2,2,1,3,3,15,15,14,11,12,14,5,13,7,9,13,12,11,14,17,12,14,10,9,13,9,15,14,10,15,10,15,17,12,13,13,9,12,16,15,20,16,10,11,10,11,4,16,10,16,10,13,11,8,8,14,1,1,16,20,16,16,20,M/AM RLC,526,1,1,1,20,16,16,1,1,1,10,14,16,16,1,1,549756000000.0,0,0,0,0,0,0,0,0,0,0,0,0,0,0,0,0,0,0,0,0,0,0,0,0,0,0,0,0,0,0,0,0,0,0,0,0,0,0,0,1,0,0,0,0,0,0,0,0,Nadiem Amiri,Â£15.30m ,24.0,180.0,Midfielder - Attacking Midfield,right,Bayer 04 Leverkusen,35.0,2.0,4.0,2111.0,33.0,4.0,3.0,2096.0,15.0,3.0,3.0,859.0,42.0,1.0,6.0,2561.0,7.0,3.0,1.0,365.0,Bundesliga,15-07-16,17.3.2.23,Nadiem Amiri,91143491,771,27-Oct-96,19,0,0,1,0,4495,6495,6495,160,130,17569197,180,72,M/AM RLC,2,2,3,3,2,2,4,2,1,1,1,16,15,15,12,12,15,5,13,7,7,13,12,10,14,17,10,14,10,8,13,9,15,15,9,14,10,15,17,12,14,11,9,12,15,14,20,15,10,11,10,11,4,16,10,16,10,13,11,8,8,14,Nadiem Amiri,Â£9.00m ,Bundesliga
19-06-17,18.3.4.28,Ugur Tezel,91143710,799,27-Feb-97,20,0,0,0,0,1000,4800,4800,118,96,364740,180,60,M/AM RLC,4,3,4,1,1,3,2,1,2,1,1,7,8,11,8,13,5,4,7,7,7,9,6,9,13,6,6,9,9,7,8,13,13,13,4,7,8,8,10,13,13,8,9,15,10,13,20,9,5,6,10,2,4,10,8,11,11,15,11,13,12,9,1,1,20,20,20,15,15,M/AM RLC,416,1,1,1,10,15,20,1,1,1,15,15,15,20,1,1,0.0,0,0,0,0,0,0,0,0,0,0,0,0,0,0,0,0,0,0,0,0,0,0,0,0,0,0,0,0,0,0,0,0,0,0,0,0,0,0,0,0,0,0,0,0,0,0,0,0,nan,nan,nan,nan,nan,nan,nan,nan,nan,nan,nan,nan,nan,nan,nan,nan,nan,nan,nan,nan,nan,nan,nan,nan,nan,nan,nan,nan,
19-06-17,18.3.4.28,Noah-Joel Sarenren-Bazee,91144364,771,21-Aug-96,20,0,0,0,0,3850,5850,6350,136,122,7521755,182,73,M/AM RL,1,1,1,1,2,1,3,1,3,3,1,8,11,13,10,11,8,10,9,7,5,10,9,6,12,11,10,9,12,10,13,8,11,14,4,12,5,10,11,17,14,10,12,8,14,17,20,12,10,12,5,12,11,14,8,15,7,13,12,10,10,12,1,1,20,20,20,17,10,M/AM RL,415,1,1,14,10,17,20,1,1,1,1,1,17,20,1,1,16.0,0,0,0,0,1,0,0,0,0,0,0,0,0,0,0,0,0,0,0,0,0,0,0,0,0,0,0,0,0,0,0,0,0,0,0,0,0,0,0,0,0,0,0,0,0,0,0,0,Noah Sarenren Bazee,Â£1.35m ,24.0,183.0,Forward - Right Winger,right,FC Augsburg,15.0,1.0,7.0,864.0,7.0,0.0,0.0,110.0,6.0,1.0,3.0,402.0,10.0,1.0,0.0,378.0,2.0,0.0,0.0,123.0,Bundesliga
19-06-17,18.3.4.28,Robin Hack,91144396,771,27-Aug-98,18,0,0,0,0,3250,5750,6250,142,115,13294969,176,69,M/AM LC,1,3,2,2,2,1,1,2,4,3,3,9,11,14,14,12,10,8,13,6,5,10,14,7,12,14,10,7,12,8,9,8,14,15,6,14,8,10,14,15,15,7,7,14,12,14,20,10,6,11,5,12,10,13,9,14,10,13,12,12,10,8,1,1,20,20,13,20,19,M/AM LC,414,1,1,14,19,20,13,1,1,1,1,8,20,13,1,1,549756000000.0,0,0,0,0,0,0,0,0,0,0,1,0,0,0,0,0,0,0,0,0,0,0,0,0,0,0,0,0,0,0,0,0,0,0,0,0,0,0,0,1,0,0,0,0,0,0,0,0,Robin Hack,Â£450Th. ,22.0,176.0,Forward - Left Winger,right,1.FC Nuremberg,21.0,15.0,4.0,1709.0,22.0,4.0,4.0,1588.0,10.0,1.0,0.0,679.0,34.0,10.0,2.0,2851.0,6.0,1.0,0.0,427.0,Bundesliga
19-06-17,18.3.4.28,Gerrit Holtmann,91147351,771,25-Mar-95,22,0,0,0,0,4350,6350,6350,145,127,10348924,183,73,WB/M/AM L,3,1,3,3,2,3,1,3,2,3,3,10,12,14,11,14,9,5,12,10,8,11,9,10,13,14,9,10,8,10,10,9,11,15,5,12,9,10,14,17,14,10,10,20,13,15,8,12,8,12,6,11,10,16,9,14,8,12,12,13,15,6,10,19,20,20,14,20,12,WB/M/AM L,433,1,1,10,12,20,14,1,10,1,1,1,20,14,19,1,0.0,0,0,0,0,0,0,0,0,0,0,0,0,0,0,0,0,0,0,0,0,0,0,0,0,0,0,0,0,0,0,0,0,0,0,0,0,0,0,0,0,0,0,0,0,0,0,0,0,Gerrit Holtmann,Â£1.80m ,25.0,185.0,Forward - Left Winger,left,VfL Bochum,12.0,0.0,1.0,577.0,19.0,2.0,1.0,1069.0,7.0,0.0,0.0,371.0,26.0,1.0,0.0,1199.0,4.0,0.0,0.0,228.0,Bundesliga,15-07-16,17.3.2.23,Gerrit Holtmann,91147351,771,25-Mar-95,21,0,0,0,0,2622,6100,6100,145,122,7938037,183,73,M/AM RL,2,2,1,2,3,2,1,2,2,1,3,10,11,15,12,14,9,5,13,6,5,11,9,6,13,13,10,10,8,10,11,9,11,15,4,12,6,10,13,17,15,10,10,20,13,15,8,12,8,12,6,11,10,14,9,14,9,12,12,13,15,6,Gerrit Holtmann,Â£1.35m ,Bundesliga
19-06-17,18.3.4.28,Marco Richter,91155514,771,24-Nov-97,19,0,0,0,0,2250,5250,5750,128,115,4772457,176,74,S L,2,1,2,3,3,1,1,3,2,3,2,7,8,14,15,13,12,10,13,5,6,10,11,7,12,15,14,10,13,12,8,7,11,15,7,11,9,10,15,14,14,10,8,14,13,12,20,12,9,12,6,13,5,10,7,12,13,14,12,10,11,9,1,1,15,15,10,15,12,S L,603,1,1,20,12,15,10,1,1,1,1,1,15,10,1,1,1.44115e+17,0,0,0,0,0,0,0,0,0,0,1,0,0,0,0,0,0,0,0,0,0,1,0,0,0,0,0,0,0,0,0,0,0,0,0,0,0,0,0,0,0,0,0,0,0,0,0,0,Marco Richter,Â£900Th. ,22.0,176.0,Forward - Right Winger,right,FC Augsburg,27.0,24.0,4.0,1937.0,26.0,10.0,1.0,1830.0,29.0,5.0,7.0,1731.0,32.0,4.0,3.0,2374.0,2.0,0.0,0.0,24.0,Bundesliga
19-06-17,18.3.4.28,Timothy Tillman,91158046,771,04-Jan-99,18,0,0,0,0,4400,5150,5400,160,108,1244888,183,74,M/AM LC,2,2,3,2,3,1,1,4,2,4,3,10,12,14,10,13,9,6,12,7,6,13,10,7,15,15,10,12,10,7,14,9,13,15,7,13,6,12,14,14,15,8,11,10,12,12,20,8,7,10,6,12,5,14,12,14,11,11,12,10,7,10,1,1,20,20,12,20,18,M/AM LC,414,1,1,1,18,20,12,1,1,1,1,14,20,12,1,1,549773000000.0,0,0,0,0,0,0,0,0,0,0,0,0,0,0,0,0,0,0,0,0,0,0,0,0,1,0,0,0,0,0,0,0,0,0,0,0,0,0,0,1,0,0,0,0,0,0,0,0,Timothy Tillman,Â£90Th. ,21.0,183.0,Midfielder - Attacking Midfield,right,SpVgg Greuther FÃ¼rth,31.0,7.0,6.0,2816.0,34.0,6.0,7.0,2233.0,13.0,0.0,0.0,725.0,12.0,0.0,2.0,488.0,4.0,0.0,2.0,134.0,Bundesliga,15-07-16,17.3.2.23,Timothy Tillman,91158046,771,04-Jan-99,17,0,0,0,0,4000,5000,5500,152,110,1803222,182,71,M/AM LC,1,3,2,2,3,4,3,2,3,3,3,10,12,14,10,13,9,6,12,7,6,13,10,7,15,15,10,12,10,7,15,10,13,15,7,13,6,12,14,14,15,8,11,10,12,12,20,8,7,10,6,12,5,14,12,14,11,11,12,10,7,10,nan,nan,nan
19-06-17,18.3.4.28,Elias Abouchabaka,91172579,771,31-Mar-00,17,0,0,0,0,3250,5250,5750,149,110,5682124,183,73,M/AM LC,3,1,1,2,2,4,1,2,1,3,2,14,12,14,11,15,12,7,11,6,5,13,12,6,15,10,11,9,13,8,15,11,10,16,6,15,7,14,10,12,15,13,10,20,12,10,8,9,9,12,5,13,6,13,8,15,7,14,13,10,15,12,1,1,19,20,10,19,20,M/AM LC,524,1,1,10,20,19,10,1,1,1,1,16,19,10,1,1,17181442048.0,0,0,0,0,0,0,0,0,0,0,0,0,0,0,0,0,0,0,0,1,1,0,0,0,0,0,0,0,0,0,0,0,0,0,1,0,0,0,0,0,0,0,0,0,0,0,0,0,nan,nan,nan,nan,nan,nan,nan,nan,nan,nan,nan,nan,nan,nan,nan,nan,nan,nan,nan,nan,nan,nan,nan,nan,nan,nan,nan,nan,
19-06-17,18.3.4.28,Tatsuya Ito,91177224,116,26-Jun-97,19,0,0,0,0,4308,4815,6250,135,120,12929330,163,59,M/AM RL,2,3,1,2,3,1,1,1,2,1,2,8,10,14,10,14,7,10,8,3,6,12,9,7,13,16,10,14,10,8,14,12,14,15,6,13,8,14,16,15,17,7,5,14,12,12,20,10,5,11,6,12,10,14,10,16,12,12,15,13,16,5,1,1,20,20,18,20,12,M/AM RL,415,1,1,14,12,20,18,1,1,1,1,1,20,18,1,1,1048576.0,0,0,0,0,0,0,0,0,0,0,0,0,0,0,0,0,0,0,0,0,1,0,0,0,0,0,0,0,0,0,0,0,0,0,0,0,0,0,0,0,0,0,0,0,0,0,0,0,Tatsuya Ito,Â£1.80m ,23.0,163.0,Forward - Left Winger,left,Sint-Truidense VV,19.0,1.0,2.0,952.0,29.0,0.0,10.0,1756.0,20.0,0.0,2.0,989.0,10.0,0.0,1.0,339.0,5.0,0.0,0.0,70.0,Bundesliga
19-06-17,18.3.4.28,Rico Wehrle,91179697,771,04-Sep-93,23,0,0,0,0,750,4100,4100,91,82,46655,180,0,AM/S RL,2,2,3,2,3,2,2,1,1,4,1,9,12,13,14,13,7,9,7,7,5,8,7,4,9,9,8,6,6,6,6,14,9,8,12,9,7,8,9,14,12,8,9,3,14,13,20,7,7,9,9,4,9,9,9,11,11,12,10,10,16,6,1,1,15,18,18,15,1,AM/S RL,625,1,1,20,1,15,18,1,1,1,1,1,1,15,1,1,0.0,0,0,0,0,0,0,0,0,0,0,0,0,0,0,0,0,0,0,0,0,0,0,0,0,0,0,0,0,0,0,0,0,0,0,0,0,0,0,0,0,0,0,0,0,0,0,0,0,nan,nan,nan,nan,nan,nan,nan,nan,nan,nan,nan,nan,nan,nan,nan,nan,nan,nan,nan,nan,nan,nan,nan,nan,nan,nan,nan,nan,
19-06-17,18.3.4.28,Daniel Didavi,92012101,771,21-Feb-90,27,0,0,5,1,6550,6800,7050,145,141,24349786,180,77,AM LC,3,2,4,1,3,1,1,2,1,2,1,15,14,12,15,16,15,10,17,6,7,14,13,9,15,15,14,8,13,10,16,12,9,15,7,13,10,12,15,14,15,11,9,20,12,12,10,14,11,14,7,13,16,10,8,12,14,12,13,11,11,7,1,1,15,20,14,15,20,AM LC,504,1,1,1,20,15,14,1,1,1,10,12,15,14,1,1,549756000000.0,0,0,0,0,0,0,0,0,0,0,0,1,0,0,0,0,0,0,0,0,0,0,0,0,0,0,0,0,0,0,0,0,0,0,0,0,0,0,0,1,0,0,0,0,0,0,0,0,Daniel Didavi,Â£6.30m ,30.0,180.0,Midfielder - Attacking Midfield,left,VfB Stuttgart,22.0,4.0,5.0,1235.0,33.0,10.0,7.0,2411.0,23.0,2.0,2.0,1111.0,21.0,6.0,4.0,1609.0,6.0,1.0,2.0,468.0,Bundesliga,15-07-16,17.3.2.23,Daniel Didavi,92012101,771,21-Feb-90,26,0,0,5,1,4650,7150,7150,145,143,22137839,180,77,AM LC,1,1,2,2,1,1,2,2,2,1,3,15,14,12,15,16,15,10,17,6,7,14,13,9,16,15,14,8,13,10,16,13,9,15,7,13,10,12,15,14,15,11,9,20,12,12,10,14,11,14,7,13,16,10,8,12,14,12,13,11,11,7,Daniel Didavi,Â£3.60m ,Bundesliga
19-06-17,18.3.4.28,Julian Schieber,92012104,771,13-Feb-89,28,0,0,7,5,3900,6400,6400,133,128,6161828,188,83,M/AM/S L,3,3,3,3,2,1,2,1,1,4,2,6,9,12,13,10,11,12,13,7,6,10,11,7,11,16,11,18,10,12,13,13,14,9,7,14,9,15,18,14,12,17,13,20,11,16,8,13,15,11,6,10,14,4,9,13,11,9,17,13,14,4,1,1,17,17,1,17,12,M/AM/S L,633,1,1,20,12,17,1,1,1,1,1,1,17,1,1,1,17314087424.0,0,0,0,0,0,0,0,0,0,1,0,0,0,0,0,0,0,0,0,0,0,0,0,0,0,0,0,1,0,0,0,0,0,0,1,0,0,0,0,0,0,0,0,0,0,0,0,0,Julian Schieber,Â£900Th. ,31.0,186.0,Forward - Centre-Forward,left,FC Augsburg,22.0,3.0,1.0,538.0,4.0,1.0,0.0,143.0,9.0,1.0,0.0,255.0,3.0,0.0,0.0,44.0,nan,nan,nan,nan,Bundesliga,15-07-16,17.3.2.23,Julian Schieber,92012104,771,13-Feb-89,27,0,0,7,5,4100,6600,6600,133,132,10360756,188,83,M/AM/S L,2,2,1,1,2,2,1,3,2,2,2,6,9,12,13,10,11,12,13,7,6,10,11,7,11,16,12,18,10,12,12,13,14,9,7,14,9,15,18,14,12,17,13,20,12,17,8,14,15,11,6,10,11,4,9,13,11,9,17,13,14,4,Julian Schieber,Â£1.80m ,Bundesliga
19-06-17,18.3.4.28,Leonardo Bittencourt,92014331,771,19-Dec-93,23,0,0,20,3,6300,6800,6800,145,136,23255194,171,60,M/AM RL,1,4,1,2,1,1,2,2,1,4,2,14,14,15,11,13,11,8,11,5,6,12,10,8,13,16,11,14,10,10,12,10,15,15,7,13,7,12,15,16,16,10,6,14,14,15,20,12,7,11,9,12,14,17,11,16,12,12,13,11,8,9,1,10,20,20,16,20,14,M/AM RL,415,1,1,12,14,20,16,1,1,1,8,10,20,16,10,7,1048576.0,0,0,0,0,0,0,0,0,0,0,0,0,0,0,0,0,0,0,0,0,1,0,0,0,0,0,0,0,0,0,0,0,0,0,0,0,0,0,0,0,0,0,0,0,0,0,0,0,Leonardo Bittencourt,Â£5.40m ,26.0,171.0,Midfielder - Attacking Midfield,right,SV Werder Bremen,18.0,3.0,8.0,1101.0,28.0,6.0,5.0,1968.0,26.0,1.0,4.0,1324.0,33.0,6.0,2.0,2125.0,6.0,1.0,1.0,423.0,Bundesliga,15-07-16,17.3.2.23,Leonardo Bittencourt,92014331,771,19-Dec-93,22,0,0,20,3,5800,6800,6800,152,136,17057485,171,60,M/AM RL,2,3,3,2,2,3,3,1,2,3,3,13,14,15,12,13,10,8,11,5,7,12,10,8,13,16,10,14,10,10,12,10,15,15,7,13,7,12,15,16,16,10,6,14,14,15,20,12,6,11,9,12,6,17,11,16,10,12,13,10,8,9,Leonardo Bittencourt,Â£5.40m ,Bundesliga
19-06-17,18.3.4.28,Karim Bellarabi,92017768,771,08-Apr-90,27,11,1,5,0,4600,7100,7100,151,145,28180410,183,80,M/AM RL,3,2,1,1,1,1,3,1,2,3,2,11,10,16,12,14,9,6,11,7,6,12,9,10,15,16,12,8,10,12,11,10,9,16,5,13,10,8,16,17,16,10,8,9,12,18,20,14,9,12,5,11,11,13,8,15,13,11,12,10,8,13,1,10,20,20,20,18,12,M/AM RL,415,1,1,14,12,18,20,1,1,1,1,1,18,20,1,10,1.44115e+17,0,0,0,0,0,0,0,0,0,0,1,0,0,0,0,0,0,0,0,0,0,0,0,0,0,0,0,0,0,0,0,0,0,0,0,0,0,0,0,0,0,0,0,0,0,0,0,0,Karim Bellarabi,Â£10.80m ,30.0,184.0,Forward - Right Winger,right,Bayer 04 Leverkusen,19.0,4.0,6.0,1349.0,29.0,2.0,4.0,1385.0,24.0,9.0,6.0,1428.0,39.0,6.0,12.0,2233.0,7.0,2.0,1.0,362.0,Bundesliga,15-07-16,17.3.2.23,Karim Bellarabi,92017768,771,08-Apr-90,26,10,1,5,0,6646,7646,7646,154,153,57176060,183,76,M/AM RL,3,1,1,2,4,3,1,2,3,1,2,11,11,17,12,15,9,6,11,7,6,12,9,10,15,17,12,8,10,12,11,10,9,16,5,13,9,8,17,18,16,10,8,9,12,18,20,15,9,12,5,11,11,13,8,15,13,11,12,10,8,13,Karim Bellarabi,Â£16.20m ,Bundesliga
19-06-17,18.3.4.28,Niclas FÃ¼llkrug,92018043,771,09-Feb-93,24,0,0,0,0,4150,6650,6650,135,133,13382912,189,83,S L,3,3,1,1,2,1,2,1,1,1,1,7,9,13,11,13,14,16,13,5,5,10,14,6,12,10,12,14,12,11,13,10,9,15,6,13,7,12,11,13,11,13,15,14,11,16,20,13,14,11,8,13,10,11,7,12,12,14,11,12,14,12,1,1,15,15,13,15,12,S L,603,1,1,20,12,15,13,1,1,1,1,1,15,13,1,1,1.44115e+17,0,0,0,0,0,0,0,0,0,1,0,1,0,0,0,0,0,0,0,0,0,0,0,0,0,0,0,0,0,0,0,0,0,0,0,0,0,0,0,0,0,0,0,0,0,0,0,0,Niclas FÃ¼llkrug,Â£7.20m ,27.0,189.0,Forward - Centre-Forward,right,SV Werder Bremen,29.0,5.0,3.0,1319.0,36.0,16.0,3.0,2489.0,15.0,3.0,2.0,1194.0,11.0,4.0,2.0,504.0,6.0,4.0,0.0,300.0,Bundesliga
19-06-17,18.3.4.28,Marvin Plattenhardt,92021287,771,26-Jan-92,25,3,0,7,0,6450,7200,6950,143,139,18759533,181,79,D/WB L,1,3,3,3,2,3,1,1,3,3,3,14,16,10,8,12,17,8,11,16,12,13,10,14,12,9,11,10,15,13,12,15,11,10,11,9,13,15,10,14,12,14,9,20,16,16,7,15,12,13,6,13,3,9,8,13,10,11,14,16,12,6,20,18,15,15,10,20,1,D/WB L,113,1,1,1,1,15,1,1,20,10,1,1,15,1,18,10,85899347968.0,0,0,0,0,0,0,0,0,0,0,0,1,0,0,0,0,0,0,0,0,0,0,0,0,0,0,0,0,0,0,0,0,0,0,1,0,1,0,0,0,0,0,0,0,0,0,0,0,Marvin Plattenhardt,Â£13.50m ,28.0,181.0,Defender - Left-Back,left,Hertha BSC,31.0,3.0,4.0,2820.0,38.0,0.0,8.0,3420.0,25.0,2.0,2.0,2226.0,19.0,0.0,5.0,1587.0,3.0,0.0,0.0,168.0,Bundesliga,15-07-16,17.3.2.23,Marvin Plattenhardt,92021287,771,26-Jan-92,24,0,0,7,0,4798,6798,6798,143,136,12754116,181,79,D/WB L,2,3,3,2,1,1,3,2,2,1,1,14,15,10,8,12,15,8,11,16,12,13,10,14,12,9,11,10,15,12,12,15,11,10,11,9,11,15,10,14,12,14,9,20,16,16,7,15,12,13,6,13,3,9,8,13,10,10,14,16,12,6,Marvin Plattenhardt,Â£7.20m ,Bundesliga
19-06-17,18.3.4.28,Nico Schulz,92027397,771,01-Apr-93,24,0,0,14,2,3850,6600,6350,139,127,7277750,180,78,D/WB/M/AM L,1,3,2,3,1,1,3,1,3,3,2,10,11,12,8,11,10,7,9,14,10,9,8,13,11,14,9,14,8,12,8,9,16,11,7,10,10,12,16,16,11,14,9,20,15,18,6,15,12,13,4,12,5,16,8,12,14,9,13,15,15,5,20,18,16,16,12,20,10,D/WB/M/AM L,133,1,1,1,1,16,12,1,20,1,10,10,16,12,18,1,17330864128.0,0,0,0,0,0,0,0,0,0,0,0,0,0,0,0,0,0,0,0,0,0,0,0,0,1,0,0,1,0,0,0,0,0,0,1,0,0,0,0,0,0,0,0,0,0,0,0,0,Nico Schulz,Â£6.30m ,27.0,180.0,Defender - Left-Back,left,Borussia Dortmund,18.0,1.0,2.0,705.0,34.0,2.0,4.0,2344.0,37.0,2.0,9.0,3139.0,18.0,1.0,0.0,1164.0,2.0,0.0,0.0,29.0,Bundesliga,15-07-16,17.3.2.23,Nico Schulz,92027397,771,01-Apr-93,23,0,0,14,2,3348,6348,6348,139,127,5705654,180,78,D/WB/M/AM L,2,2,4,1,2,3,2,2,2,1,3,10,11,12,8,11,10,7,9,14,10,9,8,13,11,14,9,14,8,12,8,9,16,11,7,10,10,12,16,16,11,14,9,20,15,18,6,15,12,13,4,12,5,16,8,12,14,9,13,15,15,5,Nico Schulz,Â£1.80m ,Bundesliga
19-06-17,18.3.4.28,Jonas Hofmann,92027981,771,14-Jul-92,24,0,0,10,5,4550,6550,6550,136,131,11737701,176,65,M/AM RL,2,2,3,1,4,2,3,3,1,1,2,13,13,12,10,14,10,6,9,15,8,11,11,9,13,17,13,8,11,12,14,10,16,13,7,15,10,16,17,14,14,8,8,8,13,16,20,15,7,13,6,12,12,16,8,13,10,13,15,9,14,6,1,1,20,20,20,16,14,M/AM RL,415,1,1,8,14,16,20,1,1,1,1,12,16,20,1,1,549757000000.0,0,0,0,0,0,0,0,0,0,0,0,0,0,0,0,0,0,0,0,0,1,0,0,0,0,0,0,0,0,0,0,0,0,0,0,0,0,0,0,1,0,0,0,0,0,0,0,0,Jonas Hofmann,Â£2.70m ,28.0,176.0,Midfielder - Central Midfield,right,Borussia MÃ¶nchengladbach,29.0,2.0,4.0,2030.0,25.0,1.0,5.0,1076.0,29.0,6.0,8.0,2079.0,29.0,5.0,3.0,1944.0,7.0,4.0,5.0,568.0,Bundesliga,15-07-16,17.3.2.23,Jonas Hofmann,92027981,771,14-Jul-92,24,0,0,10,5,4750,6750,6750,141,135,17323561,176,65,M/AM RLC,1,3,2,1,1,1,1,1,2,2,1,13,13,12,10,14,11,6,9,15,8,12,11,9,13,17,14,8,12,12,14,10,16,13,7,16,10,16,17,14,14,8,8,8,13,16,20,15,7,13,6,13,12,16,8,13,10,13,15,9,14,6,Jonas Hofmann,Â£3.15m ,Bundesliga
19-06-17,18.3.4.28,Timo Werner,92051583,771,06-Mar-96,21,6,3,7,3,6050,7550,7550,165,151,68714809,180,75,S L,2,1,2,3,2,1,2,4,1,1,1,7,9,13,14,12,8,13,10,6,5,11,14,7,11,16,13,11,13,12,9,9,12,11,6,16,9,10,16,18,14,17,11,15,15,18,20,16,11,14,5,12,3,12,8,16,13,10,13,8,14,10,1,1,15,15,13,15,10,S L,603,1,1,20,10,15,13,1,1,1,1,1,15,13,1,1,1.4412e+17,0,0,0,0,0,0,0,0,0,0,0,0,1,0,0,0,0,0,0,0,0,0,0,0,0,0,0,1,0,0,0,0,0,0,0,0,0,0,0,0,0,0,1,0,0,0,0,0,Timo Werner,Â£54.00m ,24.0,181.0,Forward - Centre-Forward,right,Chelsea FC,32.0,21.0,7.0,2464.0,45.0,21.0,10.0,3397.0,37.0,19.0,10.0,3101.0,45.0,34.0,13.0,3589.0,8.0,3.0,2.0,701.0,Bundesliga,15-07-16,17.3.2.23,Timo Werner,92051583,771,06-Mar-96,20,0,0,4,3,5950,6950,6950,156,139,8201853,180,75,S L,3,1,3,2,2,3,3,3,2,2,3,7,9,12,14,11,8,13,11,6,5,10,12,6,12,15,13,10,12,10,8,9,11,11,6,15,8,10,14,17,14,12,11,15,14,17,20,15,11,13,5,12,3,12,8,16,13,10,13,8,14,10,Timo Werner,Â£22.50m ,Bundesliga
19-06-17,18.3.4.28,Boubacar Barry,92071612,771,15-May-96,21,0,0,0,0,2900,5150,5400,125,108,847333,182,73,M/AM RLC,2,2,2,1,3,1,3,2,1,2,3,8,11,13,10,13,8,5,10,6,5,13,8,6,15,10,8,8,6,8,12,8,10,14,5,12,6,12,12,14,15,8,10,12,13,13,20,12,8,12,5,12,5,14,8,14,9,10,12,12,9,10,1,1,18,20,18,15,20,M/AM RLC,526,1,1,1,20,15,18,1,1,1,1,13,15,18,1,1,0.0,0,0,0,0,0,0,0,0,0,0,0,0,0,0,0,0,0,0,0,0,0,0,0,0,0,0,0,0,0,0,0,0,0,0,0,0,0,0,0,0,0,0,0,0,0,0,0,0,Boubacar Kamara,Â£3.15m ,20.0,184.0,Midfielder - Defensive Midfield,right,Olympique Marseille,1.0,0.0,0.0,82.0,18.0,0.0,1.0,1450.0,37.0,1.0,0.0,2867.0,28.0,2.0,2.0,2501.0,8.0,0.0,0.0,686.0,Ligue 1
19-06-17,18.3.4.28,Berkay Ãzcan,92071861,799,15-Feb-98,19,0,0,1,0,4800,5550,6300,152,121,7037839,178,80,AM/S LC,3,1,1,3,1,3,1,3,2,2,1,15,14,12,10,14,12,7,11,8,6,13,12,7,15,9,11,15,13,9,15,11,12,14,10,13,6,12,10,11,12,16,9,12,15,13,20,11,13,12,6,12,4,14,10,15,7,14,13,11,16,10,1,1,15,20,1,15,20,AM/S LC,514,1,1,18,20,15,1,1,1,1,8,12,15,1,1,1,1.44115e+17,0,0,0,0,0,0,0,0,0,0,0,0,0,0,0,0,0,0,0,0,1,0,0,0,0,0,0,0,0,0,0,0,0,0,0,0,0,0,0,0,0,0,0,0,0,0,0,0,Berkay Ãzcan,Â£2.25m ,22.0,180.0,Midfielder - Attacking Midfield,right,Istanbul Basaksehir FK,26.0,3.0,6.0,1416.0,24.0,1.0,4.0,1504.0,20.0,2.0,3.0,1139.0,29.0,0.0,0.0,954.0,7.0,0.0,0.0,210.0,Bundesliga
19-06-17,18.3.4.28,Christian Pulisic,92074020,390,18-Sep-98,18,16,7,0,0,6600,7350,7600,164,142,195538445,172,69,M/AM RLC,1,2,2,4,2,3,3,3,2,1,3,12,11,15,12,16,11,8,10,6,6,13,10,8,15,14,12,10,11,10,15,11,12,17,7,15,8,15,14,16,17,8,7,12,13,14,20,13,7,13,4,12,6,13,15,17,10,13,14,16,13,6,1,1,20,20,20,18,15,M/AM RLC,416,1,1,10,15,18,20,1,1,1,1,10,18,20,1,1,1.44115e+17,0,0,0,0,0,0,0,0,0,0,1,0,0,0,0,0,0,0,0,0,1,0,0,0,0,0,0,0,0,0,0,0,0,0,0,0,0,0,0,0,0,0,0,0,0,0,0,0,Christian Pulisic,Â£40.50m ,22.0,172.0,Forward - Left Winger,right,Chelsea FC,43.0,5.0,13.0,2323.0,42.0,5.0,7.0,3038.0,30.0,7.0,6.0,1701.0,34.0,11.0,10.0,2348.0,4.0,0.0,0.0,265.0,Bundesliga,15-07-16,17.3.2.23,Christian Pulisic,92074020,390,18-Sep-98,17,6,1,0,0,5500,7000,7500,180,140,141278691,172,69,M/AM RLC,2,3,2,3,1,2,4,2,2,3,2,12,11,15,12,16,11,8,10,6,6,13,10,8,15,14,12,10,11,8,16,11,12,17,6,15,8,15,14,16,17,9,7,12,13,13,20,12,7,13,4,12,6,13,15,17,10,13,14,16,13,6,Christian Pulisic,Â£16.20m ,Bundesliga
19-06-17,18.3.4.28,Bernard Tekpetey,92083704,21,03-Sep-97,19,2,0,0,0,3150,5650,5650,131,108,2823566,172,69,M/AM RL,2,1,1,1,3,1,3,1,3,2,2,8,9,13,13,11,8,6,12,7,4,10,10,5,12,15,11,13,8,9,7,7,13,14,7,14,5,8,15,15,15,12,8,12,12,14,20,11,9,12,6,11,7,12,13,15,10,11,11,9,10,12,1,1,20,20,20,15,10,M/AM RL,415,1,1,14,10,15,20,1,1,1,1,1,15,20,1,1,549756000000.0,0,0,0,0,0,0,0,0,0,0,0,0,0,0,0,0,0,0,0,0,0,0,0,0,0,0,0,0,0,0,0,0,0,0,0,0,0,0,0,1,0,0,0,0,0,0,0,0,Bernard Tekpetey,Â£360Th. ,23.0,172.0,Forward - Right Winger,right,PFK Ludogorets Razgrad,3.0,0.0,1.0,93.0,12.0,3.0,0.0,604.0,36.0,11.0,7.0,2369.0,10.0,0.0,1.0,494.0,10.0,0.0,1.0,492.0,Bundesliga
19-06-17,18.3.4.28,Emil Forsberg,93011051,797,23-Oct-91,25,27,5,0,0,6600,7600,7600,155,152,75088370,179,78,M/AM RLC,2,3,3,1,4,2,1,2,2,3,1,14,12,16,13,15,13,6,14,8,6,14,10,8,15,11,13,11,13,12,16,16,14,15,8,15,9,14,12,15,13,16,7,14,14,12,20,15,10,16,6,14,5,12,13,17,8,13,15,10,14,12,1,1,20,20,15,20,18,M/AM RLC,416,1,1,10,18,20,15,1,1,1,1,12,20,15,1,1,1.44256e+17,0,0,0,0,0,0,0,0,0,0,1,0,0,0,0,0,0,0,0,1,1,0,0,0,0,0,0,0,0,0,0,0,0,0,0,0,0,0,0,0,0,0,0,0,0,0,0,1,Emil Forsberg,Â£22.50m ,29.0,179.0,Forward - Left Winger,right,RB Leipzig,31.0,8.0,22.0,2427.0,33.0,5.0,4.0,2219.0,29.0,7.0,9.0,1753.0,32.0,10.0,4.0,1751.0,7.0,2.0,2.0,436.0,Bundesliga,15-07-16,17.3.2.23,Emil Forsberg,93011051,797,23-Oct-91,24,20,2,0,0,5800,7300,7300,150,146,14965762,179,78,M/AM RLC,1,2,1,1,3,3,3,1,2,1,1,13,12,15,13,15,12,6,13,8,5,14,10,7,14,12,13,11,13,12,16,14,14,15,7,16,8,14,12,15,14,16,7,14,14,13,20,15,10,16,6,14,5,12,12,16,12,13,15,10,14,6,Emil Forsberg,Â£19.80m ,Bundesliga
19-06-17,18.3.4.28,Bartosz Kapustka,96049729,787,23-Dec-96,20,14,3,3,0,3650,6150,6150,142,123,22892987,179,62,M/AM RLC,1,1,1,1,4,3,3,4,4,1,1,12,13,13,10,13,10,7,12,6,7,14,11,9,14,13,11,9,12,10,15,12,12,14,7,14,8,15,13,12,14,10,9,12,14,12,20,13,8,10,9,12,8,16,10,15,9,14,10,11,8,8,1,1,20,20,15,20,18,M/AM RLC,416,1,1,1,18,20,15,1,1,1,8,14,20,15,1,1,1.44115e+17,0,0,0,0,0,0,0,0,0,0,0,0,0,0,0,0,0,0,0,1,0,0,0,0,1,0,0,0,0,0,0,0,0,0,0,0,0,0,0,0,0,0,0,0,0,0,0,0,Bartosz Kapustka,Â£2.70m ,23.0,179.0,Midfielder - Attacking Midfield,right,Legia Warszawa,16.0,3.0,1.0,1127.0,11.0,1.0,0.0,434.0,23.0,4.0,1.0,1754.0,2.0,0.0,1.0,173.0,8.0,0.0,1.0,372.0,Bundesliga,15-07-16,17.3.2.23,Bartosz Kapustka,96049729,787,23-Dec-96,19,11,2,0,0,4500,6000,6000,157,113,10453748,179,67,M/AM RLC,1,2,2,2,3,2,2,4,1,3,1,12,12,11,8,12,10,8,9,11,7,13,14,8,12,12,12,11,12,12,14,12,13,11,7,11,7,13,11,12,12,12,10,13,14,12,20,12,9,11,11,11,8,15,11,13,13,12,13,12,15,4,Bartosz Kapustka,Â£5.40m ,Premier League
19-06-17,18.3.4.28,Josip Drmic,98006385,798,08-Aug-92,24,26,9,11,6,4450,6450,6450,143,129,9682212,183,81,M/AM/S L,1,1,2,3,1,1,2,1,2,3,2,8,10,14,15,14,8,10,10,7,5,11,13,6,13,11,12,11,14,12,9,9,10,15,7,13,6,10,11,15,15,13,12,12,11,14,20,12,11,10,10,10,16,12,10,17,6,12,12,9,8,15,1,1,16,16,12,16,1,M/AM/S L,633,1,1,20,1,16,12,1,1,1,1,1,16,12,1,1,1.44115e+17,0,0,0,0,0,0,0,0,0,0,1,0,1,0,0,0,0,0,0,0,0,0,0,0,0,0,0,0,0,0,0,0,0,0,0,1,0,0,0,0,0,0,0,0,0,0,0,0,Josip Drmic,Â£3.15m ,28.0,184.0,Forward - Centre-Forward,right,Norwich City,16.0,0.0,4.0,517.0,15.0,4.0,1.0,516.0,5.0,2.0,0.0,219.0,24.0,3.0,0.0,892.0,2.0,2.0,0.0,161.0,Bundesliga,15-07-16,17.3.2.23,Josip Drmic,98006385,798,08-Aug-92,23,25,8,11,6,5350,6850,6850,146,137,20772110,181,70,M/AM/S L,2,3,2,1,3,2,2,1,1,4,2,8,10,14,16,15,8,10,10,7,5,11,13,6,14,11,12,11,15,12,9,9,10,15,7,13,6,10,11,16,15,13,12,12,14,15,20,12,11,10,10,10,5,12,10,17,6,12,12,9,8,15,Josip Drmic,Â£2.70m ,Bundesliga
19-06-17,18.3.4.28,Renato Steffen,98029078,798,03-Nov-91,25,5,0,0,0,5000,6450,6700,135,134,13226122,170,65,M/AM RL,1,4,1,2,1,2,1,3,2,3,1,13,14,14,13,11,8,14,11,6,6,12,10,7,13,17,13,15,12,10,12,11,17,13,9,15,8,12,17,16,17,9,8,20,13,14,8,14,8,9,13,14,8,9,10,14,8,10,13,5,7,14,1,1,20,20,20,17,10,M/AM RL,415,1,1,10,10,17,20,1,1,1,1,1,17,20,1,1,2.8823e+17,0,0,0,0,0,0,0,0,0,0,0,0,0,0,0,0,1,1,0,0,0,0,0,0,0,0,0,1,0,0,0,0,0,0,0,0,0,0,0,0,0,0,0,0,0,0,0,0,Renato Steffen,Â£3.15m ,28.0,170.0,Forward - Right Winger,left,VfL Wolfsburg,39.0,7.0,12.0,3001.0,45.0,3.0,6.0,2927.0,34.0,5.0,1.0,1663.0,38.0,6.0,4.0,2213.0,8.0,0.0,2.0,559.0,Bundesliga
19-06-17,18.3.4.28,Chadrac Akolo,98033347,53,01-Apr-95,22,0,0,0,0,4200,6450,6700,145,134,14790501,172,72,M/AM RL,3,2,1,2,1,2,3,1,1,1,3,8,10,14,13,15,9,10,13,6,5,12,11,7,14,15,11,12,11,10,13,10,10,17,7,14,6,13,15,15,16,13,8,14,14,14,20,12,9,12,5,11,6,15,13,16,12,8,15,12,14,6,1,1,20,20,20,18,12,M/AM RL,415,1,1,14,12,18,20,1,1,1,1,1,18,20,1,1,549756000000.0,0,0,0,0,1,0,0,0,0,0,0,0,0,0,0,0,0,0,1,0,0,0,0,0,0,0,0,0,0,0,0,0,0,0,0,0,0,0,0,1,0,0,0,0,0,0,0,0,Chadrac Akolo,Â£4.50m ,25.0,172.0,Forward - Left Winger,right,Amiens SC,40.0,18.0,5.0,3131.0,25.0,6.0,2.0,1332.0,19.0,0.0,1.0,692.0,16.0,2.0,1.0,620.0,3.0,0.0,0.0,181.0,Bundesliga
19-06-17,18.3.4.28,Kwadwo Asamoah,12012662,21,09-Dec-88,28,69,4,0,0,6000,7400,7400,158,146,33940029,173,75,D/WB/M LC,3,3,3,2,2,2,3,2,1,1,1,9,11,13,10,13,10,9,13,14,13,14,12,14,13,14,12,13,14,14,10,11,13,12,7,13,16,15,17,14,13,16,9,20,4,14,9,15,15,16,7,14,20,16,14,13,13,15,14,14,16,4,17,19,20,8,1,19,20,D/WB/M LC,434,1,1,1,1,8,1,1,17,1,12,20,19,1,19,1,4.0,0,0,1,0,0,0,0,0,0,0,0,0,0,0,0,0,0,0,0,0,0,0,0,0,0,0,0,0,0,0,0,0,0,0,0,0,0,0,0,0,0,0,0,0,0,0,0,0,Kwadwo Asamoah,Â£12.60m ,31.0,173.0,Midfielder - Left Midfield,left,Without Club,24.0,0.0,2.0,1883.0,26.0,0.0,0.0,2029.0,42.0,0.0,2.0,3578.0,11.0,0.0,1.0,899.0,nan,nan,nan,nan,Serie A,15-07-16,17.3.2.23,Kwadwo Asamoah,12012662,21,09-Dec-88,27,69,4,0,0,5900,7500,7600,163,151,37525793,173,76,WB/M LC,2,3,3,3,2,1,3,4,1,3,1,9,11,14,10,13,10,9,13,10,14,14,12,14,13,14,13,13,14,15,12,12,13,12,7,13,16,15,17,14,14,16,11,20,4,14,10,17,15,16,7,14,20,16,14,15,13,15,12,14,16,4,Kwadwo Asamoah,Â£9.90m ,Serie A
19-06-17,18.3.4.28,Lucas Castro,14003924,1649,09-Apr-89,28,0,0,0,0,4500,6950,6950,145,139,23625071,182,80,M/AM RLC,2,2,3,3,2,2,2,2,2,1,2,11,14,14,12,14,12,12,11,12,8,14,8,13,14,15,14,12,10,11,13,11,17,16,11,11,13,13,15,14,16,15,11,11,13,13,20,14,11,14,12,12,6,18,15,13,14,13,16,14,18,7,1,1,20,19,15,15,20,M/AM RLC,416,1,1,11,19,15,15,1,1,1,1,20,15,15,1,1,70368700000000.0,0,0,0,0,0,1,0,0,0,0,0,0,0,0,0,0,0,0,0,0,0,0,0,0,0,0,0,0,0,0,0,0,0,0,0,0,0,0,0,0,0,0,0,0,0,0,1,0,Lucas Castro,Â£6.30m ,31.0,182.0,Midfielder - Central Midfield,right,SPAL,35.0,6.0,5.0,2936.0,25.0,3.0,3.0,1993.0,13.0,1.0,3.0,987.0,24.0,2.0,0.0,1150.0,4.0,2.0,1.0,293.0,Serie A,15-07-16,17.3.2.23,Lucas Castro,14003924,1649,09-Apr-89,27,0,0,0,0,4000,6450,6650,137,134,12427337,182,80,M/AM RLC,3,1,4,3,3,4,1,2,1,3,2,11,11,14,12,14,10,12,8,12,8,14,8,13,14,15,14,12,9,11,10,11,14,15,11,11,13,13,14,14,16,15,12,9,10,13,20,14,12,12,12,11,6,17,13,13,14,12,15,15,15,7,Lucas Castro,Â£6.75m ,Serie A
19-06-17,18.3.4.28,Diego Perotti,14005006,1649,26-Jul-88,28,2,0,2,1,5900,7150,7400,154,148,76071727,179,70,AM RLC,3,2,2,3,4,1,3,3,3,3,2,14,15,17,9,16,14,6,9,5,5,14,17,8,17,9,13,9,14,10,15,13,14,16,11,12,6,10,12,15,16,14,8,14,10,15,20,11,10,8,10,13,12,15,17,12,13,12,14,15,16,7,1,1,13,20,15,20,16,AM RLC,506,1,1,14,16,20,15,1,1,1,1,1,13,8,1,1,4.61403e+18,0,0,0,0,0,0,0,0,0,0,0,0,0,0,0,0,0,0,0,0,0,0,0,0,0,0,0,0,0,0,0,0,0,0,0,1,0,0,0,1,0,0,0,0,1,0,1,0,Diego Perotti,Â£18.00m ,32.0,179.0,Forward - Left Winger,right,Fenerbahce SK,45.0,10.0,10.0,2362.0,35.0,8.0,5.0,2364.0,15.0,5.0,1.0,811.0,26.0,6.0,4.0,1131.0,nan,nan,nan,nan,Serie A,15-07-16,17.3.2.23,Diego Perotti,14005006,1649,26-Jul-88,27,2,0,2,1,5800,6900,7600,154,152,69871065,179,77,AM/S RLC,4,3,3,2,3,1,1,3,3,1,2,14,15,17,10,16,14,6,10,5,6,16,15,6,17,9,13,9,14,10,16,15,12,16,11,12,6,12,12,14,16,14,8,14,9,13,20,12,10,8,10,13,12,15,17,11,14,12,13,14,16,7,Diego Perotti,Â£15.30m ,Serie A
19-06-17,18.3.4.28,Rodrigo De Paul,14048343,1649,24-May-94,23,0,0,0,0,5000,6600,6850,153,137,21762937,180,0,AM RLC,2,2,1,1,1,3,3,1,3,3,1,14,15,16,12,13,13,8,14,3,7,15,13,8,16,15,12,13,12,9,14,11,15,15,12,13,7,10,13,14,14,13,8,12,14,14,20,13,10,12,15,11,8,13,13,15,9,12,12,9,8,11,1,1,14,20,19,17,20,AM RLC,506,1,1,11,20,17,19,1,1,1,1,10,10,14,1,1,1.46367e+17,0,0,0,0,0,0,0,1,1,1,0,0,0,0,0,0,0,0,0,0,0,0,0,0,0,0,0,0,0,0,0,0,0,0,0,0,0,0,0,0,0,0,0,0,0,0,0,0,Rodrigo de Paul,Â£5.40m ,26.0,180.0,Midfielder - Central Midfield,right,Udinese Calcio,35.0,5.0,4.0,2447.0,39.0,4.0,7.0,2453.0,37.0,9.0,7.0,3314.0,35.0,7.0,7.0,2917.0,5.0,0.0,1.0,450.0,Serie A,15-07-16,17.3.2.23,Rodrigo De Paul,14048343,1649,24-May-94,22,0,0,0,0,5000,6750,6600,153,135,18313597,180,75,M/AM RLC,3,3,4,1,1,1,3,2,1,3,2,14,13,15,12,13,13,8,14,3,7,15,12,8,16,15,12,14,13,9,14,11,15,15,12,13,7,10,13,13,14,13,8,12,14,14,20,13,13,12,15,11,11,13,13,15,11,12,12,9,8,11,Rodrigo de Paul,Â£3.60m ,Serie A
19-06-17,18.3.4.28,Luca Antonelli,1408492,776,11-Feb-87,30,13,0,1,1,5250,6550,6800,146,136,12949971,184,79,D/WB/M L,1,2,1,1,1,1,1,1,1,1,1,6,12,12,8,11,4,14,7,14,13,13,5,15,11,13,14,14,13,13,11,13,14,7,11,13,12,15,14,14,12,14,12,20,12,15,8,16,14,11,12,12,16,10,12,10,18,13,15,14,11,7,20,19,18,7,1,20,9,D/WB/M L,123,1,1,1,1,7,1,9,20,1,1,1,18,1,19,1,1236950000000.0,1,0,0,0,0,0,0,0,0,0,0,0,0,0,0,0,0,0,0,0,0,0,0,0,0,0,0,0,0,0,0,0,0,0,0,0,0,1,0,0,1,0,0,0,0,0,0,0,Luca Antonelli,Â£1.80m ,33.0,184.0,Defender - Left-Back,left,Without Club,9.0,0.0,0.0,417.0,13.0,1.0,1.0,584.0,13.0,0.0,1.0,759.0,14.0,2.0,1.0,928.0,0.0,0.0,0.0,0.0,Serie A,15-07-16,17.3.2.23,Luca Antonelli,1408492,776,11-Feb-87,29,13,0,1,1,5250,7150,7000,146,140,10073779,184,79,D/WB/M L,3,1,1,1,1,2,2,1,2,2,2,9,12,12,8,11,2,14,7,11,13,13,5,15,12,14,15,14,12,13,11,13,14,7,11,12,12,16,15,15,14,14,12,20,14,15,8,16,14,12,12,12,13,10,15,10,18,12,15,13,11,7,Luca Antonelli,Â£4.95m ,Serie A
19-06-17,18.3.4.28,Danilo D'Ambrosio,1414241,776,09-Sep-88,28,1,0,3,0,5250,7100,7050,144,141,20945745,180,75,D/WB/M RL,2,3,2,2,3,1,3,2,2,2,2,7,13,12,11,13,7,12,9,12,12,12,6,13,12,17,12,15,12,13,10,13,12,7,6,13,12,14,15,14,13,12,10,10,14,15,20,14,12,12,12,10,10,16,13,14,11,12,15,15,14,8,20,19,18,1,20,19,13,D/WB/M RL,125,1,1,1,1,1,1,13,19,20,1,1,17,18,18,19,1099510000000.0,0,0,0,0,0,1,0,0,0,0,0,0,0,0,0,0,0,0,0,0,0,0,0,0,0,0,0,0,0,0,0,0,0,0,0,0,0,0,0,0,1,0,0,0,0,0,0,0,Danilo D'Ambrosio,Â£10.80m ,32.0,180.0,Defender - Right-Back,right,Inter Milan,39.0,3.0,3.0,3366.0,34.0,2.0,4.0,2986.0,38.0,2.0,6.0,3250.0,32.0,5.0,0.0,2095.0,5.0,2.0,0.0,371.0,Serie A,15-07-16,17.3.2.23,Danilo D'Ambrosio,1414241,776,09-Sep-88,27,0,0,3,0,4500,6850,6800,144,138,10657647,180,75,D/WB/M RL,2,3,3,1,1,3,3,1,2,2,2,7,12,13,10,13,7,12,9,12,12,12,6,12,13,14,12,14,12,13,12,13,12,7,6,13,12,13,14,14,14,12,10,10,14,14,20,14,12,12,11,10,10,16,13,14,11,12,15,15,14,8,Danilo D'Ambrosio,Â£9.00m ,Serie A
19-06-17,18.3.4.28,Iago FalquÃ©,1510571,796,04-Jan-90,27,0,0,1,0,5400,6700,7350,148,147,48422768,174,69,AM RLC,3,2,3,2,3,1,1,4,1,3,1,14,15,14,14,16,14,6,12,8,6,16,14,8,16,9,14,10,14,12,15,15,12,15,7,15,8,13,13,14,15,13,7,20,11,12,10,14,7,8,10,12,8,9,14,11,10,10,14,14,15,5,1,1,15,20,20,19,16,AM RLC,506,1,1,15,16,19,20,1,1,1,1,8,14,15,1,1,2097296.0,0,0,0,0,1,0,0,1,0,0,0,0,0,0,0,0,0,0,0,0,0,1,0,0,0,0,0,0,0,0,0,0,0,0,0,0,0,0,0,0,0,0,0,0,0,0,0,0,Iago Falque,Â£11.70m ,30.0,174.0,Forward - Right Winger,left,Benevento Calcio,35.0,12.0,6.0,2532.0,40.0,14.0,9.0,3079.0,28.0,6.0,6.0,1797.0,16.0,2.0,1.0,753.0,2.0,0.0,0.0,118.0,Serie A,15-07-16,17.3.2.23,Iago FalquÃ©,1510571,796,04-Jan-90,26,0,0,1,0,5400,6700,7150,148,143,27802762,174,69,AM RLC,3,2,1,3,3,2,2,3,2,3,4,14,15,14,13,16,13,6,12,12,6,16,15,7,16,9,13,9,14,12,15,15,11,15,6,14,9,13,13,14,15,12,7,20,11,11,10,14,7,8,10,12,8,9,14,8,10,8,14,14,15,5,Iago Falque,Â£9.00m ,Serie A
19-06-17,18.3.4.28,Jordan Lukaku,18044106,757,25-Jul-94,22,7,0,9,0,5250,6750,6700,146,134,19154409,177,86,D/WB L,3,1,4,2,3,3,1,1,2,3,2,8,14,15,6,13,6,7,6,4,12,11,10,13,13,14,13,15,11,11,8,12,15,12,8,15,11,15,13,16,11,14,10,20,16,16,12,12,15,13,14,12,11,14,14,14,12,13,14,14,13,4,20,19,15,12,5,20,1,D/WB L,113,1,1,1,1,12,1,1,20,5,1,1,15,1,19,5,134217760.0,0,0,0,0,0,1,0,0,0,0,0,0,0,0,0,0,0,0,0,0,0,0,0,0,0,0,0,1,0,0,0,0,0,0,0,0,0,0,0,0,0,0,0,0,0,0,0,0,Jordan Lukaku,Â£6.30m ,26.0,177.0,Defender - Left-Back,left,Royal Antwerp FC,20.0,0.0,2.0,1122.0,44.0,1.0,3.0,2209.0,8.0,0.0,1.0,231.0,13.0,0.0,2.0,385.0,0.0,0.0,0.0,0.0,Serie A,15-07-16,17.3.2.23,Jordan Lukaku,18044106,757,25-Jul-94,21,5,0,9,0,5500,6250,6500,138,130,9008106,177,83,D/WB/M L,1,3,3,3,1,1,3,1,3,2,3,11,14,13,6,13,9,7,9,5,12,10,10,13,13,14,12,14,11,11,8,10,15,12,8,12,12,12,13,15,12,13,10,20,16,16,15,12,14,10,14,12,12,14,13,13,12,12,10,14,13,4,Jordan Lukaku,Â£4.05m ,Serie A
19-06-17,18.3.4.28,Dennis Praet,18045342,757,14-May-94,23,1,0,17,2,5150,6400,6650,145,133,16838828,181,78,M/AM LC,1,2,3,2,2,2,1,3,3,2,2,14,15,13,11,15,12,8,12,12,8,15,13,12,16,7,11,11,13,18,14,14,12,16,12,13,7,14,11,12,13,8,9,12,14,12,20,14,8,12,8,12,8,16,12,12,11,14,10,10,18,12,1,1,20,18,14,15,20,M/AM LC,414,1,1,1,18,15,14,1,1,1,1,20,15,12,1,1,137439000000.0,0,0,0,0,0,0,1,0,0,0,0,0,0,0,0,0,0,0,0,0,0,0,0,0,0,0,0,0,0,0,0,0,0,0,0,0,0,1,0,0,0,0,0,0,0,0,0,0,Dennis Praet,Â£22.50m ,26.0,181.0,Midfielder - Central Midfield,right,Leicester City,36.0,1.0,1.0,1965.0,35.0,1.0,2.0,2936.0,37.0,2.0,3.0,3194.0,36.0,1.0,3.0,1805.0,7.0,1.0,1.0,463.0,Serie A,15-07-16,17.3.2.23,Dennis Praet,18045342,757,14-May-94,22,1,0,11,1,6500,6250,6500,148,130,9999999,181,78,M/AM LC,2,4,2,2,3,3,1,4,1,1,3,14,15,12,11,15,12,7,11,12,8,15,10,12,16,7,10,11,13,18,14,14,7,15,12,12,7,14,11,11,12,8,7,12,14,11,20,14,7,12,8,12,8,16,12,12,11,14,10,10,18,12,Dennis Praet,Â£7.65m ,Serie A
19-06-17,18.3.4.28,Samuel Bastien,18072298,757,26-Sep-96,20,0,0,2,0,3350,6250,6400,150,128,16836379,177,73,DM/M RLC,1,3,3,2,1,2,2,2,1,1,1,12,12,13,10,13,10,8,12,7,10,14,10,12,14,14,13,12,14,12,13,12,14,11,10,14,12,14,14,15,12,11,8,8,12,14,20,13,8,14,6,12,4,14,16,11,13,12,13,12,13,3,8,13,20,13,17,17,20,DM/M RLC,426,1,1,1,13,13,13,1,6,8,17,20,17,17,11,13,2251800000000000.0,0,0,0,0,0,0,0,0,1,0,0,0,0,0,0,0,0,0,0,0,0,0,0,0,0,0,0,0,0,0,0,0,0,0,0,0,0,0,0,0,0,0,0,0,0,0,0,0,Samuel Bastien,Â£2.25m ,24.0,175.0,Midfielder - Central Midfield,right,Standard LiÃ¨ge,13.0,1.0,0.0,888.0,22.0,1.0,0.0,1451.0,30.0,2.0,2.0,1477.0,32.0,5.0,4.0,2809.0,5.0,2.0,0.0,447.0,Serie A,15-07-16,17.3.2.23,Samuel Bastien,18072298,757,26-Sep-96,19,0,0,1,0,1500,5400,5750,136,118,3886443,177,73,DM/M RC,1,2,1,3,3,1,2,1,3,3,3,12,12,12,10,12,10,7,12,7,10,14,9,10,13,13,14,12,14,11,12,10,14,11,9,14,9,11,13,15,12,5,6,8,12,15,20,8,7,11,5,10,8,14,12,11,12,12,11,11,16,4,Samuel Bastien,Â£1.35m ,Serie A
19-06-17,18.3.4.28,Douglas Costa,19044710,1651,14-Sep-90,26,21,3,12,4,7300,7800,7850,166,160,105713888,172,70,M/AM RLC,1,1,1,1,1,1,1,1,1,1,1,14,13,18,11,15,14,5,14,10,5,12,11,6,17,14,13,9,10,12,13,10,13,18,5,14,7,8,14,19,17,14,6,20,14,16,11,15,10,13,4,12,3,12,10,12,14,13,12,8,11,15,1,1,16,20,19,20,15,M/AM RLC,526,1,1,8,15,20,19,1,1,1,1,8,16,15,1,1,2.8823e+17,0,0,0,0,0,0,0,0,0,0,0,1,0,0,1,0,0,0,0,0,0,0,0,0,0,0,0,1,0,0,0,0,0,0,0,1,0,0,0,0,0,0,0,0,0,0,0,0,Douglas Costa,Â£49.50m ,30.0,172.0,Forward - Right Winger,left,Bayern Munich,34.0,7.0,9.0,1925.0,47.0,6.0,13.0,2912.0,25.0,1.0,1.0,969.0,29.0,3.0,7.0,1084.0,6.0,0.0,1.0,211.0,Serie A,15-07-16,17.3.2.23,Douglas Costa,19044710,1651,14-Sep-90,25,17,3,12,4,7550,8050,8050,164,161,101463902,172,65,M/AM RLC,1,1,1,1,1,1,1,1,1,1,1,14,15,18,10,15,14,5,13,10,5,13,11,6,16,14,12,9,10,11,12,10,13,18,5,13,7,8,14,19,18,14,6,20,14,16,11,15,9,13,4,12,3,12,10,12,15,13,12,8,11,14,Douglas Costa,Â£27.00m ,Bundesliga
19-06-17,18.3.4.28,Alex Sandro,19067093,1651,26-Jan-91,26,7,0,11,0,7002,7503,8400,172,167,224939693,180,80,D/WB/M L,1,3,3,4,1,3,1,2,3,3,1,12,16,16,12,16,10,11,11,12,12,14,9,15,16,11,14,13,18,12,11,15,13,15,8,17,14,15,15,16,15,15,12,20,16,16,9,15,16,14,11,12,8,12,13,14,14,13,16,15,17,6,20,20,18,12,1,20,1,D/WB/M L,123,1,1,1,1,12,1,1,20,1,1,1,18,1,20,1,2097193.0,1,0,0,1,0,1,0,0,0,0,0,0,0,0,0,0,0,0,0,0,0,1,0,0,0,0,0,0,0,0,0,0,0,0,0,0,0,0,0,0,0,0,0,0,0,0,0,0,Alex Sandro,Â£40.50m ,29.0,181.0,Defender - Left-Back,left,Juventus FC,43.0,3.0,8.0,3416.0,39.0,4.0,6.0,3280.0,43.0,1.0,4.0,3322.0,41.0,1.0,4.0,3466.0,nan,nan,nan,nan,Serie A,15-07-16,17.3.2.23,Alex Sandro,19067093,1651,26-Jan-91,25,6,0,0,0,6250,7500,8000,167,161,99309769,180,78,D/WB/M L,2,3,3,1,3,2,2,2,1,3,1,12,16,15,12,16,10,7,11,11,11,14,9,13,17,11,13,13,18,13,11,15,13,15,9,17,12,15,16,16,15,14,12,20,16,16,9,15,12,12,11,12,8,12,12,12,14,12,15,15,17,6,Alex Sandro,Â£31.50m ,Serie A
19-06-17,18.3.4.28,DodÃ´,19074834,1651,06-Feb-92,25,0,0,3,0,4500,5950,6200,137,124,3824641,177,75,D/WB/M L,2,3,2,1,2,1,3,1,3,2,3,14,12,13,8,12,7,7,11,13,10,13,9,10,15,13,10,9,10,9,12,10,11,14,6,16,8,12,16,15,15,12,9,20,13,15,8,13,9,12,8,11,14,13,12,15,8,11,15,11,10,9,20,19,19,12,1,20,1,D/WB/M L,123,1,1,1,1,12,1,1,20,1,1,1,19,1,19,1,33.0,1,0,0,0,0,1,0,0,0,0,0,0,0,0,0,0,0,0,0,0,0,0,0,0,0,0,0,0,0,0,0,0,0,0,0,0,0,0,0,0,0,0,0,0,0,0,0,0,DodÃ´,Â£1.58m ,28.0,177.0,Defender - Left-Back,left,UC Sampdoria,9.0,0.0,0.0,533.0,42.0,1.0,7.0,3694.0,20.0,1.0,1.0,1526.0,nan,nan,nan,nan,nan,nan,nan,nan,Serie A,15-07-16,17.3.2.23,DodÃ´,19074834,1651,06-Feb-92,24,0,0,3,0,5200,6550,6100,143,121,3212897,177,69,D/WB/M L,2,3,2,1,2,3,1,3,1,3,3,14,12,13,8,12,7,7,11,13,10,13,9,10,15,13,10,9,11,10,12,10,13,14,6,16,8,12,16,15,15,12,9,20,13,15,8,13,9,12,8,11,14,13,12,15,8,12,15,11,10,9,DodÃ´,Â£2.25m ,Serie A
19-06-17,18.3.4.28,Felipe Anderson,19105713,1651,15-Apr-93,24,1,0,10,1,5850,7000,7550,165,151,109399487,175,70,AM RLC,1,1,2,2,1,3,1,1,3,2,1,10,14,17,13,16,14,6,13,3,4,15,14,7,17,12,14,10,11,12,15,11,16,20,9,16,5,14,13,16,15,10,8,15,16,15,20,11,8,14,10,13,8,16,16,13,17,12,18,16,14,3,1,13,15,20,20,18,18,AM RLC,506,1,1,14,18,18,20,1,1,1,1,1,14,15,10,13,70403200000000.0,0,0,0,0,1,0,0,1,0,0,0,0,0,0,0,0,0,0,0,0,0,0,0,0,0,0,0,1,0,0,0,0,0,0,0,1,0,0,0,0,0,0,0,0,0,0,1,0,Felipe Anderson,Â£27.00m ,27.0,175.0,Forward - Left Winger,right,FC Porto,41.0,5.0,12.0,3244.0,32.0,8.0,9.0,1760.0,40.0,10.0,5.0,3197.0,27.0,1.0,5.0,1610.0,6.0,1.0,2.0,302.0,Serie A,15-07-16,17.3.2.23,Felipe Anderson,19105713,1651,15-Apr-93,23,1,0,6,1,6000,7450,7500,164,150,30385486,178,69,M/AM RLC,4,1,1,2,1,2,1,4,2,2,4,10,15,16,12,16,12,6,14,4,4,15,10,6,17,12,14,10,10,10,15,11,16,19,9,14,4,12,11,17,16,10,8,15,15,16,20,11,8,13,10,12,8,16,14,14,14,10,18,16,14,5,Felipe Anderson,Â£22.50m ,Serie A
19-06-17,18.3.4.28,GÃ©rson,19217413,1651,20-May-97,20,0,0,8,0,4700,6200,6400,145,126,15986472,184,73,M/AM RLC,3,2,4,3,1,3,3,3,2,1,1,12,13,14,11,16,10,9,12,9,8,14,10,9,16,8,14,10,12,11,15,12,11,16,6,12,7,8,9,12,14,9,10,20,12,13,11,12,10,9,6,12,8,12,8,14,12,9,12,9,10,6,1,1,19,20,20,15,19,M/AM RLC,526,1,1,1,15,15,20,1,1,1,1,19,10,18,1,1,536871040.0,0,0,0,0,0,0,0,1,0,0,0,0,0,0,0,0,0,0,0,0,0,0,0,0,0,0,0,0,0,1,0,0,0,0,0,0,0,0,0,0,0,0,0,0,0,0,0,0,Gerson,Â£9.00m ,23.0,184.0,Midfielder - Central Midfield,left,Clube de Regatas do Flamengo,12.0,1.0,1.0,491.0,31.0,2.0,0.0,1186.0,74.0,5.0,8.0,5117.0,29.0,2.0,2.0,2335.0,nan,nan,nan,nan,Serie A,15-07-16,17.3.2.23,GÃ©rson,19217413,1651,20-May-97,19,0,0,8,0,4250,6750,6450,158,128,14901289,180,69,M/AM RLC,2,3,2,2,1,2,2,3,2,1,2,12,13,15,11,16,10,9,12,9,8,14,10,7,18,8,12,9,12,10,15,12,10,16,8,13,7,12,11,12,15,9,10,20,13,13,12,11,10,9,6,12,8,12,13,15,12,10,12,7,10,6,Gerson,Â£7.20m ,Serie A
19-06-17,18.3.4.28,RogÃ©rio,19284576,1651,13-Jan-98,19,0,0,5,0,1200,4750,4850,147,103,643786,178,71,D/WB L,2,3,2,3,2,3,3,1,1,1,2,7,12,13,6,11,7,10,5,8,10,10,5,10,10,11,11,10,11,13,9,11,13,15,10,13,12,10,13,14,13,10,9,20,10,13,6,13,11,11,8,8,10,10,12,12,10,9,12,9,11,4,20,19,15,8,1,20,1,D/WB L,113,1,1,1,1,8,1,1,20,1,1,1,15,1,19,1,0.0,0,0,0,0,0,0,0,0,0,0,0,0,0,0,0,0,0,0,0,0,0,0,0,0,0,0,0,0,0,0,0,0,0,0,0,0,0,0,0,0,0,0,0,0,0,0,0,0,RogÃ©rio,Â£1.80m ,22.0,178.0,Defender - Left-Back,left,US Sassuolo,28.0,1.0,4.0,2284.0,15.0,0.0,0.0,1089.0,35.0,1.0,1.0,2841.0,18.0,1.0,1.0,1202.0,2.0,0.0,0.0,77.0,Serie A
19-06-17,18.3.4.28,Ãder,2105181,776,15-Nov-86,30,23,6,0,0,5750,7400,7050,150,141,232186002,179,77,AM/S LC,1,3,1,3,1,1,3,2,3,1,1,6,12,15,14,14,14,10,13,3,5,12,14,7,14,8,14,15,14,11,11,12,15,15,11,15,9,14,17,16,14,12,9,9,12,15,20,13,9,12,8,12,5,14,12,14,13,12,15,14,9,12,1,1,1,20,9,20,15,AM/S LC,514,1,1,19,15,20,9,1,1,1,1,1,1,1,1,1,1.44115e+17,0,0,0,0,0,0,0,0,0,0,0,0,0,0,0,0,0,0,0,0,0,0,0,0,0,0,0,1,0,0,0,0,0,0,0,0,0,0,0,0,0,0,0,0,0,0,0,0,nan,nan,nan,nan,nan,nan,nan,nan,nan,nan,nan,nan,nan,nan,nan,nan,nan,nan,nan,nan,nan,nan,nan,nan,nan,nan,nan,nan,15-07-16,17.3.2.23,Ãder,2105181,776,15-Nov-86,29,20,3,0,0,5500,7450,7050,150,140,13501867,179,74,AM/S L,1,2,2,2,3,3,1,1,1,2,2,6,12,15,14,13,14,10,13,3,5,12,15,7,15,8,13,15,13,11,11,12,15,15,11,14,9,14,16,16,15,12,9,9,12,15,20,13,10,12,8,12,5,14,12,15,14,13,15,14,9,12,Ãder,Â£4.50m ,Ligue 1
19-06-17,18.3.4.28,Hrvoje Milic,24003762,761,10-May-89,28,6,0,0,0,3000,6000,6000,135,120,1916500,183,74,D/WB/M L,1,2,3,1,2,1,4,3,3,3,1,12,12,11,8,13,11,11,10,13,11,12,10,13,12,11,11,9,11,12,11,11,12,12,6,10,12,13,15,14,13,12,11,20,14,14,7,14,12,12,10,13,6,14,9,12,13,10,13,14,8,13,20,19,16,10,1,20,1,D/WB/M L,123,1,1,1,1,10,1,1,20,1,1,1,16,1,19,1,292059000000.0,1,0,0,0,0,1,0,0,0,0,0,0,0,0,0,0,0,0,0,0,1,0,0,0,0,0,0,0,0,0,0,0,0,0,1,0,0,0,1,0,0,0,0,0,0,0,0,0,Hrvoje Milic,Â£450Th. ,31.0,183.0,Defender - Left-Back,left,Esteghlal FC,23.0,0.0,4.0,1727.0,4.0,0.0,0.0,267.0,9.0,0.0,0.0,454.0,16.0,2.0,0.0,1315.0,nan,nan,nan,nan,Serie A,15-07-16,17.3.2.23,Hrvoje Milic,24003762,761,10-May-89,27,6,0,0,0,3250,6000,5900,125,120,1379457,183,74,D/WB/M/AM L,1,2,2,2,2,2,2,3,3,1,1,13,13,11,8,13,13,9,10,13,11,10,11,11,13,11,10,9,10,13,8,8,12,12,8,12,8,12,16,13,13,10,11,20,14,14,5,15,11,11,6,13,6,9,16,12,16,8,13,14,8,13,Hrvoje Milic,Â£900Th. ,Serie A
19-06-17,18.3.4.28,Ladislav Krejci,25018650,763,05-Jul-92,24,32,4,6,0,4500,6900,6700,140,134,17232340,179,61,AM L,3,3,2,2,2,2,2,1,2,3,1,14,13,13,9,12,14,7,11,8,5,13,14,13,13,6,11,11,10,12,13,11,16,19,10,15,9,15,13,15,13,15,8,20,10,16,9,14,8,12,8,13,9,6,11,14,16,15,15,13,11,4,1,1,15,20,10,20,9,AM L,503,1,1,10,9,20,10,1,1,1,1,1,15,1,1,1,134225953.0,1,0,0,0,0,1,0,0,0,0,0,0,0,1,0,0,0,0,0,0,0,0,0,0,0,0,0,1,0,0,0,0,0,0,0,0,0,0,0,0,0,0,0,0,0,0,0,0,Ladislav Krejci,Â£3.15m ,28.0,178.0,Forward - Left Winger,left,AC Sparta Praha,38.0,2.0,8.0,2878.0,13.0,0.0,1.0,432.0,18.0,0.0,3.0,1060.0,15.0,1.0,0.0,1118.0,4.0,1.0,2.0,282.0,Serie A,15-07-16,17.3.2.23,Ladislav Krejci,25018650,763,05-Jul-92,24,26,4,6,0,4750,6900,6650,140,131,12855758,179,61,AM L,3,4,1,3,1,4,1,2,1,1,3,14,10,13,9,12,15,5,11,7,5,13,15,13,13,6,11,9,10,12,11,11,15,19,9,15,8,15,13,15,13,15,7,20,10,16,8,14,8,12,8,13,9,6,9,13,18,14,14,12,10,4,Ladislav Krejci,Â£4.50m ,Serie A
19-06-17,18.3.4.28,Fabio Borini,28018401,776,29-Mar-91,26,1,0,18,6,5350,6500,6500,145,130,18212657,180,74,M/AM/S RL,2,1,1,4,2,4,3,1,2,1,3,11,12,11,9,10,9,8,12,10,5,12,16,9,11,11,12,11,14,11,10,10,16,12,7,14,11,12,17,13,14,11,10,12,14,13,20,15,11,10,4,16,5,16,14,17,12,16,15,6,11,4,1,13,16,20,16,20,13,M/AM/S RL,535,1,1,19,13,20,15,1,1,1,1,1,16,16,11,13,2748780000000.0,0,0,0,0,0,0,0,0,1,0,0,0,0,0,0,0,0,0,0,0,0,0,0,0,0,0,0,0,0,0,0,0,0,0,0,0,0,0,0,1,0,1,0,0,0,0,0,0,Fabio Borini,Â£6.30m ,29.0,180.0,Forward - Left Winger,right,Without Club,26.0,2.0,0.0,1911.0,44.0,5.0,5.0,2429.0,29.0,3.0,1.0,1494.0,16.0,3.0,0.0,880.0,nan,nan,nan,nan,Serie A,15-07-16,17.3.2.23,Fabio Borini,28018401,776,29-Mar-91,25,1,0,18,6,5600,6800,6650,145,133,24454378,179,75,AM/S RL,2,2,3,3,1,3,3,2,3,3,3,12,12,12,13,13,11,9,13,10,5,12,16,9,13,11,12,11,14,11,11,9,15,12,7,14,11,12,17,14,14,10,9,12,14,13,20,16,10,10,4,16,5,13,14,17,12,16,15,6,11,4,Fabio Borini,Â£4.50m ,Premier League
19-06-17,18.3.4.28,Rolando Aarons,28082548,765,16-Nov-95,21,0,0,0,0,3750,5750,5750,145,124,8008241,176,66,AM RL,2,1,2,2,4,1,1,1,2,3,3,11,13,15,12,13,4,5,8,3,5,11,5,5,12,4,12,4,12,10,12,10,13,16,7,15,4,10,12,18,15,6,6,20,10,16,10,10,5,10,3,10,18,11,12,11,13,13,13,8,13,6,1,1,15,20,18,20,11,AM RL,505,1,1,10,11,20,18,1,1,1,1,1,15,15,1,1,2251800000000000.0,0,0,0,0,0,0,0,0,0,0,0,0,0,0,0,0,0,0,0,0,0,0,0,0,0,0,0,1,0,0,0,0,0,0,0,0,0,0,0,0,0,0,0,0,0,0,0,0,Rolando Aarons,Â£630Th. ,24.0,178.0,Forward - Left Winger,left,Newcastle United,5.0,0.0,0.0,100.0,20.0,2.0,1.0,1035.0,23.0,1.0,1.0,1414.0,21.0,3.0,2.0,1342.0,nan,nan,nan,nan,Premier League
19-06-17,18.3.4.28,Adel Taarabt,34001033,34,24-May-89,28,18,4,0,0,5250,6500,6250,140,125,1090024,180,80,AM LC,1,1,2,1,1,1,3,4,3,1,1,12,12,17,11,17,12,4,15,7,5,15,10,5,17,7,11,9,12,9,14,10,14,13,7,11,6,9,8,11,12,13,8,15,7,12,20,9,12,6,7,13,7,8,10,11,13,14,8,11,13,18,1,10,13,20,14,17,20,AM LC,504,1,1,15,20,17,14,1,1,1,1,10,13,12,10,1,70952900000000.0,0,0,0,0,0,0,0,0,0,0,1,0,0,0,0,0,0,0,0,0,0,0,0,0,0,0,0,0,0,0,0,0,0,0,0,1,0,0,0,1,0,0,0,0,0,0,1,0,Adel Taarabt,Â£1.35m ,31.0,180.0,Midfielder - Central Midfield,right,SL Benfica,6.0,0.0,3.0,209.0,23.0,2.0,2.0,1688.0,10.0,0.0,2.0,399.0,38.0,1.0,3.0,2730.0,4.0,0.0,0.0,286.0,Serie A,15-07-16,17.3.2.23,Adel Taarabt,34001033,34,24-May-89,27,18,4,0,0,5900,6500,6300,145,126,1165490,180,80,AM LC,1,2,3,1,3,2,1,1,2,1,2,12,13,18,10,17,12,4,15,7,5,15,10,5,18,7,11,10,14,9,14,12,9,13,7,10,8,9,8,11,12,13,7,15,7,12,20,9,13,6,7,13,7,8,5,6,8,9,3,6,8,18,Adel Taarabt,Â£540Th. ,Serie A
19-06-17,18.3.4.28,Ivan Perisic,34012563,761,02-Feb-89,28,57,15,8,3,6750,8050,7800,160,156,146540793,186,80,M/AM RLC,2,2,2,1,1,2,1,3,2,1,2,12,14,15,14,14,13,13,12,5,7,14,13,7,14,8,16,12,13,11,12,13,13,13,6,17,8,10,12,16,13,13,13,15,13,16,20,14,12,11,7,15,6,17,12,15,10,15,14,12,10,16,7,7,18,20,16,20,15,M/AM RLC,526,1,1,14,15,20,16,1,7,4,11,7,18,13,7,6,4947800000000.0,0,0,0,1,0,1,0,0,0,0,0,0,0,0,0,0,0,0,0,0,0,0,0,0,0,0,0,0,0,0,0,0,0,0,0,0,0,0,0,1,0,0,1,0,0,0,0,0,Ivan Perisic,Â£36.00m ,31.0,187.0,Forward - Left Winger,both,Inter Milan,42.0,11.0,10.0,3042.0,39.0,11.0,11.0,3489.0,45.0,9.0,8.0,3631.0,35.0,8.0,10.0,1756.0,6.0,0.0,2.0,397.0,Serie A,15-07-16,17.3.2.23,Ivan Perisic,34012563,761,02-Feb-89,27,51,15,8,3,6250,7650,7650,154,153,73952544,186,79,M/AM RLC,3,1,1,4,3,1,3,2,1,2,2,12,13,15,14,15,14,13,12,5,7,13,12,7,14,8,14,11,14,11,11,13,13,13,6,16,8,12,12,16,13,13,13,15,13,15,20,14,12,14,7,15,6,17,13,16,9,15,10,12,10,16,Ivan Perisic,Â£27.00m ,Serie A
19-06-17,18.3.4.28,Charalabos Lykogiannis,36045542,772,22-Oct-93,23,0,0,9,0,5000,6350,6350,137,128,5795371,186,78,D/WB/M/AM LC,3,1,1,1,3,1,1,2,2,1,3,8,3,10,9,12,12,11,14,13,13,14,11,13,13,14,13,14,12,13,11,11,14,10,9,13,12,13,13,13,12,14,13,20,13,14,7,14,15,13,10,12,6,13,11,10,13,14,14,15,10,6,20,18,16,16,10,20,16,D/WB/M/AM LC,134,1,1,1,10,16,10,16,20,1,10,14,16,6,18,1,512.0,0,0,0,0,0,0,0,0,0,1,0,0,0,0,0,0,0,0,0,0,0,0,0,0,0,0,0,0,0,0,0,0,0,0,0,0,0,0,0,0,0,0,0,0,0,0,0,0,Charalampos Lykogiannis,Â£1.80m ,27.0,190.0,Defender - Left-Back,left,Cagliari Calcio,36.0,3.0,3.0,3231.0,33.0,2.0,4.0,2602.0,12.0,0.0,2.0,917.0,23.0,0.0,1.0,1607.0,5.0,1.0,1.0,438.0,Serie A
19-06-17,18.3.4.28,Robin Gosens,37041773,771,05-Jul-94,22,0,0,0,0,3500,5500,6100,132,122,6483740,184,76,D/WB/M/AM L,1,2,3,1,2,1,3,2,2,3,1,11,10,11,6,11,14,4,14,9,11,14,7,10,9,4,10,9,11,11,12,11,5,10,7,15,12,14,15,14,13,13,10,20,9,14,10,14,10,13,6,7,5,11,13,11,9,11,9,13,6,7,20,19,18,16,1,20,10,D/WB/M/AM L,133,1,1,1,1,16,1,5,20,1,12,10,18,1,19,1,32800.0,0,0,0,0,0,1,0,0,0,0,0,0,0,0,0,1,0,0,0,0,0,0,0,0,0,0,0,0,0,0,0,0,0,0,0,0,0,0,0,0,0,0,0,0,0,0,0,0,Robin Gosens,Â£2.25m ,26.0,183.0,Defender - Left-Back,left,Atalanta BC,32.0,2.0,5.0,2667.0,26.0,2.0,2.0,1685.0,36.0,3.0,2.0,2488.0,43.0,10.0,8.0,3372.0,6.0,1.0,2.0,464.0,Serie A
19-06-17,18.3.4.28,Giacomo Bonaventura,43006720,776,22-Aug-89,27,8,0,12,3,6000,7400,7650,155,153,109879505,180,75,M/AM LC,1,2,1,3,3,3,2,4,2,1,2,14,14,15,11,14,15,13,15,6,10,14,12,11,15,12,14,13,14,14,13,14,15,14,14,15,12,15,14,15,14,11,11,12,14,14,20,13,12,15,8,15,9,17,13,15,15,16,15,13,14,5,1,1,20,19,13,19,20,M/AM LC,414,1,1,1,18,19,12,1,1,1,1,20,19,13,1,1,1.44117e+17,0,0,0,0,1,0,0,1,0,0,0,0,0,0,0,0,0,0,0,0,0,0,0,0,0,0,0,0,0,0,0,0,0,0,0,0,0,0,0,0,0,1,0,0,0,0,0,0,Giacomo Bonaventura,Â£20.70m ,31.0,180.0,Midfielder - Central Midfield,right,ACF Fiorentina,22.0,5.0,5.0,1874.0,47.0,9.0,4.0,3557.0,10.0,3.0,0.0,797.0,32.0,4.0,6.0,1530.0,5.0,0.0,1.0,388.0,Serie A,15-07-16,17.3.2.23,Giacomo Bonaventura,43006720,776,22-Aug-89,26,8,0,12,3,5200,7400,7600,155,153,70277494,180,75,M/AM LC,3,3,3,1,1,1,3,3,2,3,2,14,14,15,11,15,15,13,15,6,10,14,11,11,14,12,14,13,14,13,14,14,14,14,12,15,12,15,14,15,14,12,11,12,15,14,20,13,11,14,8,15,4,17,16,15,15,13,15,13,14,5,Giacomo Bonaventura,Â£21.60m ,Serie A
19-06-17,18.3.4.28,Joel Obi,43008775,38,22-May-91,26,12,0,0,0,4000,6250,6500,138,130,9750849,177,72,WB/M RLC,1,1,1,1,1,1,1,1,1,1,1,12,13,12,9,12,7,9,10,7,12,12,8,14,13,14,13,14,11,11,12,11,13,14,8,13,13,14,14,15,16,13,9,20,11,14,9,14,12,13,13,14,13,18,15,13,13,10,12,12,11,9,9,16,20,8,15,18,20,WB/M RLC,426,1,1,1,7,8,8,1,9,7,1,20,18,15,16,12,134217732.0,0,0,1,0,0,0,0,0,0,0,0,0,0,0,0,0,0,0,0,0,0,0,0,0,0,0,0,1,0,0,0,0,0,0,0,0,0,0,0,0,0,0,0,0,0,0,0,0,Joel Obi,Â£4.50m ,29.0,178.0,Midfielder - Central Midfield,left,Chievo Verona,23.0,0.0,1.0,854.0,25.0,6.0,1.0,1397.0,13.0,1.0,0.0,694.0,29.0,1.0,2.0,2044.0,4.0,0.0,1.0,322.0,Serie A,15-07-16,17.3.2.23,Joel Obi,43008775,38,22-May-91,25,12,0,0,0,4000,6500,6450,138,130,7417931,177,72,M RLC,1,1,1,1,1,1,1,1,1,1,1,12,13,12,9,12,7,7,10,7,10,12,8,13,13,14,13,14,11,11,12,11,13,14,8,13,12,14,14,15,16,13,9,20,11,14,9,14,11,13,13,14,13,18,15,13,13,10,12,12,11,9,Joel Obi,Â£1.35m ,Serie A
19-06-17,18.3.4.28,Marco D'Alessandro,43013928,776,17-Feb-91,26,0,0,10,0,4000,6100,6100,135,122,591312,173,65,M/AM RL,3,2,1,2,2,3,2,4,1,3,3,6,11,12,5,13,6,6,8,5,6,14,7,11,12,13,10,10,8,12,8,10,12,14,5,12,7,9,12,18,15,10,6,7,13,17,20,12,8,6,9,12,4,12,19,11,15,12,14,12,10,5,1,8,18,20,20,17,1,M/AM RL,525,1,1,9,1,17,20,1,1,1,1,1,15,18,5,8,2251800000000000.0,0,1,0,0,1,1,0,0,0,0,0,0,0,0,0,0,0,0,0,0,0,0,0,0,0,0,0,0,0,0,0,0,0,0,0,0,0,0,0,0,0,0,0,0,0,0,0,0,Marco D'Alessandro,Â£2.25m ,29.0,173.0,Midfielder - Right Midfield,right,SPAL,27.0,1.0,1.0,1006.0,17.0,1.0,1.0,1133.0,25.0,0.0,2.0,1548.0,17.0,2.0,0.0,937.0,3.0,0.0,0.0,189.0,Serie A,15-07-16,17.3.2.23,Marco D'Alessandro,43013928,776,17-Feb-91,25,0,0,10,0,4000,6500,6400,135,128,7166199,173,65,M/AM RL,1,3,1,1,2,3,1,1,1,1,3,6,12,13,7,12,6,6,8,5,6,12,7,11,12,13,9,12,8,10,10,11,12,14,5,12,7,9,12,18,15,10,6,7,13,18,20,12,8,13,9,12,4,12,9,11,15,12,14,12,10,5,Marco D'Alessandro,Â£1.35m ,Serie A
19-06-17,18.3.4.28,Diego Farias,43017920,1651,10-May-90,27,0,0,0,0,3500,6400,6400,135,128,10071805,173,66,AM/S RLC,2,2,2,3,1,2,1,1,1,3,2,11,13,14,12,12,13,7,12,4,4,13,14,8,14,9,11,12,11,11,12,10,10,14,7,13,8,10,11,14,15,11,6,11,14,12,20,15,11,11,8,13,3,12,15,12,10,11,12,10,9,2,1,1,7,20,19,15,20,AM/S RLC,516,1,1,17,20,15,19,1,1,1,1,1,7,7,1,1,17592200000000.0,0,0,0,0,0,1,0,0,0,0,0,0,0,0,0,0,0,0,0,0,0,0,0,0,0,0,0,0,0,0,0,0,0,0,0,0,0,0,0,0,0,0,0,0,1,0,0,0,Diego Farias,Â£2.97m ,30.0,172.0,Forward - Second Striker,right,Spezia Calcio,20.0,7.0,2.0,1163.0,30.0,1.0,6.0,1810.0,35.0,7.0,5.0,2051.0,19.0,2.0,2.0,837.0,3.0,1.0,0.0,66.0,Serie A,15-07-16,17.3.2.23,Diego Farias,43017920,1651,10-May-90,26,0,0,0,0,3500,6400,6400,138,128,5702136,173,66,AM RLC,2,2,3,2,3,3,1,1,3,1,2,11,13,14,12,12,10,7,12,4,4,13,12,8,14,9,10,12,11,11,12,11,10,14,7,12,8,10,11,14,15,11,6,11,14,14,20,15,12,11,8,13,3,12,15,12,10,11,12,10,9,2,Diego Farias,Â£3.60m ,Serie A
19-06-17,18.3.4.28,Antonino Ragusa,43017933,776,27-Mar-90,27,0,0,2,0,3900,6400,6400,131,128,3195860,183,78,AM RL,3,3,2,1,3,3,1,3,2,1,3,9,12,14,12,11,8,10,9,3,5,12,10,9,13,8,11,12,10,10,12,8,12,12,10,15,8,13,12,15,13,14,10,14,13,15,20,14,12,9,5,11,12,14,12,14,14,8,13,14,9,2,1,1,15,20,15,20,10,AM RL,505,1,1,13,10,20,15,1,1,1,1,1,15,10,1,1,549890000000.0,0,0,0,0,1,0,0,0,0,0,0,0,0,0,0,0,0,0,0,0,0,0,0,0,0,0,0,1,0,0,0,0,0,0,0,0,0,0,0,1,0,0,0,0,0,0,0,0,Antonino Ragusa,Â£1.35m ,30.0,183.0,Forward - Left Winger,right,Brescia Calcio,33.0,5.0,5.0,1943.0,32.0,0.0,2.0,964.0,12.0,0.0,0.0,684.0,27.0,8.0,2.0,1367.0,1.0,0.0,0.0,31.0,Serie A,15-07-16,17.3.2.23,Antonino Ragusa,43017933,776,27-Mar-90,26,0,0,2,0,3400,6000,6300,128,127,6026950,183,78,AM RL,3,3,3,1,3,3,2,2,3,1,3,9,12,13,12,11,8,10,9,3,5,12,10,9,13,8,11,12,10,10,12,8,12,12,10,13,8,12,11,15,13,14,10,13,13,15,20,14,12,9,5,11,12,14,12,14,14,8,13,14,9,2,Antonino Ragusa,Â£1.80m ,Serie A
19-06-17,18.3.4.28,NiccolÅ Giannetti,43018057,776,12-May-91,26,0,0,1,0,1500,5700,5700,128,114,1662663,177,73,AM/S L,1,2,4,2,1,3,1,2,2,2,2,4,5,12,13,13,7,11,9,5,5,10,13,6,13,13,14,12,12,13,9,12,11,12,6,15,7,12,13,13,14,11,8,10,13,14,20,13,11,11,7,9,9,12,10,10,8,12,11,13,13,9,1,1,1,16,10,16,1,AM/S L,623,1,1,20,1,16,10,1,1,1,1,1,1,1,1,1,1.44115e+17,0,0,0,0,0,0,0,0,0,0,0,0,0,0,0,0,0,0,0,0,0,0,0,0,0,0,0,0,0,0,0,0,0,0,0,0,0,0,0,0,0,0,0,0,0,0,0,0,NiccolÃ² Giannetti,Â£900Th. ,29.0,181.0,Forward - Centre-Forward,right,US Salernitana 1919,22.0,1.0,0.0,810.0,9.0,0.0,0.0,362.0,27.0,9.0,0.0,1419.0,21.0,4.0,2.0,1249.0,4.0,0.0,0.0,35.0,Serie A
19-06-17,18.3.4.28,Cristiano Biraghi,43029905,776,01-Sep-92,24,0,0,22,1,3750,6550,6050,135,121,4918691,184,78,D/WB/M L,1,3,3,3,2,2,4,2,1,2,3,11,13,11,7,11,10,11,12,13,11,12,9,13,11,12,10,11,9,10,9,10,13,8,12,11,11,12,15,14,11,14,11,20,13,14,7,16,13,14,9,14,8,12,10,13,14,8,8,14,14,2,20,19,18,1,7,20,13,D/WB/M L,123,1,1,1,1,1,1,13,20,7,1,1,18,7,19,7,17179869184.0,0,0,0,0,0,0,0,0,0,0,0,0,0,0,0,0,0,0,0,0,0,0,0,0,0,0,0,0,0,0,0,0,0,0,1,0,0,0,0,0,0,0,0,0,0,0,0,0,Cristiano Biraghi,Â£4.50m ,28.0,185.0,Defender - Left-Back,left,ACF Fiorentina,37.0,1.0,4.0,3169.0,35.0,1.0,4.0,3055.0,40.0,1.0,6.0,3555.0,37.0,3.0,7.0,2121.0,5.0,1.0,3.0,448.0,Serie A,15-07-16,17.3.2.23,Cristiano Biraghi,43029905,776,01-Sep-92,23,0,0,22,1,3350,6500,6250,142,124,4515239,184,78,D/WB/M L,2,3,2,2,3,1,3,1,3,4,3,11,13,11,8,11,9,11,9,13,11,12,4,13,11,12,11,13,12,12,9,10,13,8,13,11,13,14,15,14,11,14,11,20,13,15,8,16,13,13,9,14,8,12,10,13,14,11,15,14,14,5,Cristiano Biraghi,Â£2.25m ,Serie A
19-06-17,18.3.4.28,Marcello Trotta,43030618,776,29-Sep-92,24,0,0,9,3,3750,6100,6100,130,122,2660905,188,82,AM/S RL,1,2,3,3,1,1,2,2,3,1,1,5,9,12,13,13,7,14,10,5,5,12,14,5,13,10,12,12,14,13,8,13,14,12,9,13,6,13,13,13,11,13,14,20,15,12,8,15,14,13,5,11,5,10,14,15,11,11,13,12,12,5,1,1,1,17,17,15,9,AM/S RL,625,1,1,20,9,15,17,1,1,1,1,1,1,1,1,1,0.0,0,0,0,0,0,0,0,0,0,0,0,0,0,0,0,0,0,0,0,0,0,0,0,0,0,0,0,0,0,0,0,0,0,0,0,0,0,0,0,0,0,0,0,0,0,0,0,0,Marcello Trotta,Â£3.15m ,28.0,188.0,Forward - Centre-Forward,left,FC FamalicÃ£o,31.0,3.0,5.0,1907.0,35.0,7.0,4.0,2294.0,14.0,0.0,0.0,489.0,30.0,9.0,3.0,1569.0,2.0,0.0,0.0,63.0,Serie A,15-07-16,17.3.2.23,Marcello Trotta,43030618,776,29-Sep-92,23,0,0,9,3,3750,5850,6050,138,120,338907,187,82,S R,1,2,4,1,3,2,2,3,3,2,2,5,8,13,13,14,7,14,10,5,5,12,13,7,14,10,12,12,14,13,12,13,14,11,9,12,13,11,11,11,11,12,14,20,13,12,10,14,14,10,8,11,8,9,14,15,11,11,13,12,12,5,Marcello Trotta,Â£2.25m ,Serie A
19-06-17,18.3.4.28,Luca Rizzo,43031592,776,24-Apr-92,25,0,0,0,0,3500,6400,6400,138,128,8556192,188,80,M RLC,3,1,1,1,2,3,1,3,3,4,3,6,13,12,8,13,10,12,10,5,12,14,10,11,14,11,14,13,13,14,12,13,13,12,12,13,14,16,16,11,12,13,13,9,14,12,20,13,15,14,10,13,7,14,10,15,15,12,12,13,10,6,8,10,20,13,18,20,19,M RLC,406,1,1,1,11,13,13,1,1,8,14,19,20,18,1,10,66.0,0,1,0,0,0,0,1,0,0,0,0,0,0,0,0,0,0,0,0,0,0,0,0,0,0,0,0,0,0,0,0,0,0,0,0,0,0,0,0,0,0,0,0,0,0,0,0,0,Luca Rizzo,Â£1.80m ,28.0,188.0,Midfielder - Central Midfield,right,Without Club,13.0,0.0,0.0,511.0,13.0,2.0,0.0,510.0,5.0,0.0,0.0,195.0,4.0,0.0,0.0,165.0,nan,nan,nan,nan,Serie A,15-07-16,17.3.2.23,Luca Rizzo,43031592,776,24-Apr-92,24,0,0,0,0,2500,6550,6450,139,128,8199651,185,80,M/AM RLC,2,2,4,3,1,3,3,2,2,3,3,6,13,12,8,14,10,12,10,5,12,14,10,11,14,11,14,13,13,14,12,13,13,12,12,14,14,16,17,11,12,13,13,9,14,12,20,13,15,14,10,13,7,14,10,15,15,12,12,13,10,6,Luca Rizzo,Â£2.25m ,Serie A
19-06-17,18.3.4.28,Leonardo Spinazzola,43036586,776,25-Mar-93,24,3,0,0,0,4500,7350,7150,154,143,33856104,186,75,D/WB/M RL,1,3,2,1,1,3,2,3,3,3,1,6,13,13,7,13,6,10,8,8,11,11,8,12,13,9,13,11,9,9,11,11,12,14,7,13,11,12,13,16,13,12,12,12,16,17,20,15,12,12,7,12,5,18,15,15,10,12,12,12,7,5,20,20,19,13,15,20,10,D/WB/M RL,125,1,1,1,1,13,12,1,20,13,1,10,19,15,20,15,134234112.0,0,0,0,0,0,0,0,0,0,0,0,0,0,0,1,0,0,0,0,0,0,0,0,0,0,0,0,1,0,0,0,0,0,0,0,0,0,0,0,0,0,0,0,0,0,0,0,0,Leonardo Spinazzola,Â£10.80m ,27.0,186.0,Defender - Left-Back,right,AS Roma,32.0,0.0,4.0,2680.0,25.0,0.0,4.0,2137.0,14.0,1.0,1.0,912.0,32.0,2.0,3.0,2160.0,6.0,0.0,0.0,494.0,Serie A,15-07-16,17.3.2.23,Leonardo Spinazzola,43036586,776,25-Mar-93,23,0,0,0,0,2257,5770,6500,144,130,3860618,186,79,D/WB/M RL,1,1,2,3,2,4,2,2,3,1,1,6,12,13,7,10,7,9,8,8,10,11,8,9,12,9,10,9,8,10,12,10,12,14,7,12,11,12,11,16,13,12,11,11,15,17,20,13,10,9,7,12,5,18,15,15,10,10,12,9,7,5,Leonardo Spinazzola,Â£7.20m ,Serie A
19-06-17,18.3.4.28,Stephan El Shaarawy,43036636,776,27-Oct-92,24,21,3,5,3,5750,7250,7250,156,145,62535140,178,72,AM RL,3,1,3,3,1,1,3,3,1,2,3,11,12,13,15,15,12,8,13,7,4,13,14,6,16,9,15,11,14,12,13,15,12,14,7,17,7,12,11,15,15,11,8,10,10,16,20,12,11,11,6,13,12,14,10,16,12,9,12,15,15,8,1,1,10,20,18,20,1,AM RL,505,1,1,15,1,20,18,1,1,1,1,1,10,10,1,1,1.44115e+17,0,0,0,0,1,0,0,0,0,0,1,0,0,0,0,0,0,0,0,0,0,0,0,0,0,0,0,0,1,0,0,0,0,0,1,0,0,0,0,0,0,0,0,0,0,0,0,0,Stephan El Shaarawy,Â£18.00m ,27.0,178.0,Forward - Left Winger,right,Shanghai Greenland Shenhua,44.0,12.0,10.0,2325.0,44.0,9.0,7.0,2612.0,46.0,15.0,8.0,3182.0,6.0,0.0,1.0,378.0,nan,nan,nan,nan,Serie A,15-07-16,17.3.2.23,Stephan El Shaarawy,43036636,776,27-Oct-92,23,20,3,5,3,5900,7000,7300,159,145,57147430,178,72,AM/S RL,1,1,1,3,3,3,3,3,2,2,4,11,12,15,15,15,11,8,13,7,4,13,14,6,15,9,15,11,14,12,13,14,13,16,7,17,7,10,11,15,15,11,8,10,10,16,20,12,10,11,6,13,12,14,10,16,12,9,12,15,15,8,Stephan El Shaarawy,Â£15.30m ,Serie A
19-06-17,18.3.4.28,Lorenzo Insigne,43043933,776,04-Jun-91,26,16,3,15,7,6250,7650,8150,172,164,223431474,163,59,AM/S LC,2,1,4,1,2,3,2,1,4,1,3,15,14,15,14,18,14,6,14,3,7,16,14,7,17,10,15,14,9,12,17,12,14,18,13,16,7,14,15,17,18,11,3,12,15,14,20,16,6,14,7,14,8,13,10,15,17,9,14,12,12,5,1,1,1,20,13,20,16,AM/S LC,514,1,1,16,16,20,13,1,1,1,1,1,1,1,1,1,1.44115e+17,0,0,0,0,0,0,0,0,0,0,0,0,0,0,0,0,0,0,0,0,0,0,0,0,0,0,0,1,0,0,0,0,0,0,0,1,0,0,0,0,0,0,0,0,0,0,0,0,Lorenzo Insigne,Â£54.00m ,29.0,163.0,Forward - Left Winger,right,SSC Napoli,49.0,20.0,11.0,3767.0,48.0,14.0,13.0,3865.0,41.0,14.0,6.0,3068.0,46.0,13.0,8.0,3513.0,4.0,2.0,0.0,232.0,Serie A,15-07-16,17.3.2.23,Lorenzo Insigne,43043933,776,04-Jun-91,25,12,2,15,7,5900,7400,7700,165,154,67872721,163,59,AM/S LC,2,3,1,3,3,2,1,3,2,2,2,15,14,15,12,16,15,6,13,5,5,15,14,7,16,12,13,14,8,12,15,11,14,17,11,15,7,14,15,17,18,10,3,12,15,15,20,14,6,11,7,14,8,12,10,16,16,5,14,12,12,5,Lorenzo Insigne,Â£31.50m ,Serie A
19-06-17,18.3.4.28,Mattia Valoti,43050913,776,06-Sep-93,23,0,0,0,0,3250,5800,5900,135,118,5216701,181,66,M/AM LC,1,3,4,3,4,2,1,3,3,1,1,12,11,13,11,11,12,10,11,7,5,14,12,6,14,11,12,10,11,13,14,13,15,17,11,16,10,13,13,14,13,10,11,7,15,13,20,12,12,14,11,13,10,15,7,10,11,6,13,15,10,7,1,1,20,18,13,16,20,M/AM LC,414,1,1,11,18,16,13,1,1,1,1,20,1,1,1,1,0.0,0,0,0,0,0,0,0,0,0,0,0,0,0,0,0,0,0,0,0,0,0,0,0,0,0,0,0,0,0,0,0,0,0,0,0,0,0,0,0,0,0,0,0,0,0,0,0,0,Mattia Valoti,Â£900Th. ,27.0,181.0,Midfielder - Central Midfield,right,SPAL,24.0,3.0,8.0,1288.0,28.0,3.0,0.0,1664.0,25.0,2.0,0.0,1296.0,30.0,5.0,2.0,1642.0,5.0,1.0,0.0,378.0,Serie A
19-06-17,18.3.4.28,Nnamdi Oduamadi,43052341,38,17-Oct-90,26,14,4,7,1,2600,4850,5100,106,102,149388,173,65,AM RL,1,1,4,2,1,3,2,2,3,1,1,6,9,13,8,10,7,6,8,5,4,8,13,6,11,10,10,9,8,8,9,8,12,9,7,14,4,7,8,16,15,8,6,9,12,16,20,10,6,12,6,6,8,14,16,13,7,10,15,14,16,7,1,1,15,20,20,18,10,AM RL,505,1,1,12,10,18,20,1,1,1,1,1,14,15,1,1,549756000000.0,0,1,0,0,0,0,0,0,0,0,0,0,0,0,0,0,0,0,0,0,0,0,0,0,0,0,0,0,0,0,0,0,0,0,0,0,0,0,0,1,0,0,0,0,0,0,0,0,Nnamdi Oduamadi,Â£180Th. ,30.0,175.0,Forward - Right Winger,right,Without Club,4.0,0.0,0.0,283.0,1.0,0.0,1.0,84.0,13.0,1.0,0.0,822.0,nan,nan,nan,nan,nan,nan,nan,nan,Serie A,15-07-16,17.3.2.23,Nnamdi Oduamadi,43052341,38,17-Oct-90,25,13,4,0,0,1100,5250,5250,120,110,195641,173,65,AM RL,3,1,3,3,2,3,3,2,1,1,3,6,9,14,9,10,7,6,8,8,4,8,13,6,13,10,10,9,8,10,11,10,12,9,7,15,4,7,9,16,15,8,6,9,12,16,20,10,6,12,6,6,8,14,15,13,7,10,15,14,16,7,nan,nan,nan
19-06-17,18.3.4.28,Ryder Matos,43052610,1651,27-Feb-93,24,0,0,0,0,4000,6100,6100,130,122,2660905,181,71,AM/S RLC,1,2,1,2,2,3,2,2,3,3,1,8,11,13,9,13,9,9,10,7,5,11,9,8,13,10,11,10,11,11,11,12,13,13,7,12,8,10,13,15,15,11,10,7,12,15,20,12,7,12,10,12,4,15,10,13,13,12,15,13,12,3,1,1,10,19,18,16,19,AM/S RLC,626,1,1,20,19,16,18,1,1,1,1,1,10,10,1,1,2251800000000000.0,0,0,0,0,0,0,0,0,0,0,0,0,0,0,0,0,0,0,0,0,0,0,0,0,0,0,0,0,0,0,1,0,0,0,0,0,0,0,0,0,0,0,0,0,0,0,0,0,Ryder Matos,Â£1.17m ,27.0,182.0,Forward - Second Striker,right,FC Empoli,21.0,0.0,0.0,602.0,19.0,0.0,0.0,1226.0,31.0,4.0,5.0,2087.0,26.0,1.0,2.0,1576.0,1.0,0.0,0.0,12.0,Serie A,15-07-16,17.3.2.23,Ryder Matos,43052610,1651,27-Feb-93,23,0,0,0,0,4000,6100,6250,143,124,6772859,179,71,AM/S RLC,1,2,1,3,3,2,1,2,1,2,1,8,11,13,11,13,9,9,10,7,5,11,10,8,14,10,11,10,11,11,12,12,13,13,7,13,8,10,13,15,15,11,10,7,12,15,20,12,8,12,10,12,4,15,10,13,13,12,15,13,12,3,Ryder Matos,Â£1.98m ,Serie A
19-06-17,18.3.4.28,Bruno Martella,43061296,776,14-Aug-92,24,0,0,0,0,3500,6200,6200,136,124,6313693,184,78,D/WB/M L,1,1,2,3,3,3,1,3,2,1,2,13,15,10,7,10,13,10,14,14,13,13,9,14,12,13,15,12,12,12,8,12,15,13,11,11,13,10,12,14,13,12,10,20,16,14,8,12,12,15,5,14,3,14,13,18,11,15,15,18,14,7,20,19,18,9,1,20,1,D/WB/M L,123,1,1,1,1,9,1,1,20,1,1,1,18,1,19,1,0.0,0,0,0,0,0,0,0,0,0,0,0,0,0,0,0,0,0,0,0,0,0,0,0,0,0,0,0,0,0,0,0,0,0,0,0,0,0,0,0,0,0,0,0,0,0,0,0,0,Bruno Martella,Â£1.98m ,28.0,183.0,Defender - Left-Back,left,Brescia Calcio,29.0,0.0,0.0,2323.0,32.0,1.0,4.0,2798.0,27.0,2.0,5.0,1968.0,24.0,0.0,0.0,1263.0,4.0,0.0,0.0,360.0,Serie A,15-07-16,17.3.2.23,Bruno Martella,43061296,776,14-Aug-92,23,0,0,0,0,2500,5750,6000,130,122,1093717,184,78,D/WB/M L,3,2,3,2,1,4,2,1,1,3,3,10,16,13,7,9,13,10,12,13,12,13,10,12,12,13,15,12,10,10,9,14,15,13,9,8,11,10,12,17,13,12,10,20,16,13,6,12,10,15,10,14,5,14,13,18,11,15,15,18,14,7,Bruno Martella,Â£1.62m ,Serie A
19-06-17,18.3.4.28,Simone Verdi,43061356,776,12-Jul-92,24,1,0,5,1,4750,7200,7200,154,144,38780854,171,61,AM/S RLC,1,2,3,3,3,2,2,2,2,1,3,12,12,15,13,12,14,5,13,6,5,14,14,10,14,12,12,12,13,14,14,13,15,14,11,13,8,14,13,15,13,11,6,20,7,13,17,12,9,12,5,11,12,16,17,15,19,12,18,17,15,4,1,1,5,20,20,15,18,AM/S RLC,516,1,1,16,18,15,20,1,1,1,1,5,5,5,1,1,145136000000000.0,0,0,0,0,1,0,0,0,1,0,0,0,0,0,0,0,0,0,0,0,0,0,0,0,0,0,0,0,0,0,0,0,0,0,0,0,0,0,0,0,0,0,1,0,0,0,0,1,Simone Verdi,Â£22.50m ,28.0,174.0,Midfielder - Attacking Midfield,both,Torino FC,29.0,6.0,5.0,2214.0,35.0,10.0,10.0,2843.0,24.0,4.0,3.0,811.0,34.0,2.0,8.0,2208.0,4.0,0.0,0.0,131.0,Serie A,15-07-16,17.3.2.23,Simone Verdi,43061356,776,12-Jul-92,24,0,0,5,1,3250,6250,6550,140,132,10613616,171,62,AM RLC,4,1,1,2,2,3,3,2,1,3,1,12,12,12,10,10,14,5,11,4,4,14,11,6,14,12,11,12,13,13,13,14,14,14,11,13,5,14,13,15,13,11,6,20,11,14,12,13,13,12,5,11,5,16,16,14,18,11,17,16,14,4,Simone Verdi,Â£5.40m ,Serie A
19-06-17,18.3.4.28,Achraf Lazaar,43061408,34,22-Jan-92,25,16,0,0,0,4750,6750,6150,143,123,1124800,184,74,D/WB/M L,1,1,1,2,3,2,2,2,1,2,1,12,15,13,6,12,10,8,10,10,10,13,10,11,15,10,10,9,14,8,10,11,13,12,8,13,12,8,12,15,15,16,10,20,14,13,7,15,10,11,8,10,7,14,14,15,11,15,13,13,12,6,20,19,17,10,1,20,1,D/WB/M L,123,1,1,1,1,10,1,1,20,1,1,1,17,1,19,1,536870912.0,0,0,0,0,0,0,0,0,0,0,0,0,0,0,0,0,0,0,0,0,0,0,0,0,0,0,0,0,0,1,0,0,0,0,0,0,0,0,0,0,0,0,0,0,0,0,0,0,Achraf Lazaar,Â£900Th. ,28.0,184.0,Defender - Left-Back,left,Newcastle United,11.0,0.0,0.0,652.0,10.0,1.0,0.0,541.0,8.0,0.0,3.0,480.0,9.0,1.0,0.0,343.0,1.0,0.0,0.0,90.0,Premier League
19-06-17,18.3.4.28,Gianluca Caprari,43067331,776,30-Jul-93,23,0,0,0,0,4000,6600,6550,146,131,16929472,176,72,AM/S RLC,3,2,2,1,1,4,1,2,1,3,1,14,12,14,13,13,12,7,12,7,4,14,13,7,15,10,10,10,10,10,12,10,15,16,13,13,5,12,13,14,15,13,7,9,13,14,20,15,10,16,5,14,3,13,13,16,15,10,10,15,17,3,1,1,8,18,17,16,18,AM/S RLC,626,1,1,20,18,16,17,1,1,1,1,1,8,8,1,1,1.44133e+17,0,0,0,0,1,0,0,0,0,0,0,0,0,0,0,0,0,0,0,0,1,0,0,0,0,0,0,1,0,0,0,0,0,0,0,0,0,0,0,0,0,0,0,0,1,0,0,0,Gianluca Caprari,Â£6.75m ,27.0,171.0,Forward - Second Striker,right,Benevento Calcio,36.0,9.0,5.0,3202.0,37.0,7.0,1.0,2064.0,24.0,6.0,2.0,1158.0,32.0,6.0,0.0,1394.0,5.0,3.0,1.0,370.0,Serie A,15-07-16,17.3.2.23,Gianluca Caprari,43067331,776,30-Jul-93,22,0,0,0,0,4000,6500,6300,146,125,4740329,171,70,AM/S RLC,2,2,4,2,4,1,2,2,1,1,3,12,11,13,13,13,12,7,12,8,4,14,12,8,14,11,10,12,10,10,12,10,14,15,13,12,5,12,13,14,13,10,6,7,12,14,20,13,13,12,4,14,6,13,10,15,14,13,15,15,13,1,Gianluca Caprari,Â£5.40m ,Serie A
19-06-17,18.3.4.28,Andrea Nalini,43073566,776,20-Jun-90,27,0,0,0,0,3000,5750,5750,121,115,981962,180,72,AM RL,3,2,2,1,3,2,1,3,2,2,1,10,12,15,10,14,10,8,11,6,3,13,10,3,13,13,12,12,12,12,11,11,12,13,10,14,6,11,10,14,13,12,9,8,15,14,20,11,11,13,4,15,15,13,8,14,12,12,11,14,11,7,1,1,13,20,20,16,14,AM RL,505,1,1,13,14,16,20,1,1,1,1,1,12,13,1,1,2.8823e+17,0,0,0,0,1,0,0,0,0,0,0,0,0,0,0,0,0,0,0,0,0,0,0,0,0,0,0,0,0,0,0,0,0,0,0,1,0,0,0,0,0,0,0,0,0,0,0,0,Andrea Nalini,Â£900Th. ,30.0,180.0,Forward - Right Winger,right,LR Vicenza Virtus,18.0,2.0,2.0,814.0,23.0,0.0,4.0,1645.0,15.0,2.0,2.0,898.0,10.0,0.0,2.0,445.0,2.0,0.0,0.0,103.0,Serie A,15-07-16,17.3.2.23,Andrea Nalini,43073566,776,20-Jun-90,26,0,0,0,0,2300,5350,5350,120,108,432843,180,72,AM RL,2,1,3,3,1,1,2,2,1,3,3,10,12,15,8,12,10,8,7,7,7,12,10,8,13,12,12,11,9,12,11,11,12,13,6,13,9,11,9,14,13,12,10,5,15,14,20,11,11,13,7,13,15,9,8,14,12,12,11,14,11,7,Andrea Nalini,Â£720Th. ,Serie A
19-06-17,18.3.4.28,Ibrahima Mbaye,43078377,41,19-Nov-94,22,1,0,6,0,3500,6100,6100,140,122,6986355,188,70,D/WB/M RL,1,2,1,1,3,2,1,1,3,1,3,7,11,11,8,11,4,11,7,12,12,11,8,16,11,14,12,11,10,11,9,10,13,6,7,10,12,10,12,14,11,13,14,10,13,13,20,14,14,13,14,11,9,16,13,13,11,15,14,12,12,9,20,19,17,1,20,17,10,D/WB/M RL,125,1,1,1,1,1,1,10,17,20,1,1,15,17,16,19,0.0,0,0,0,0,0,0,0,0,0,0,0,0,0,0,0,0,0,0,0,0,0,0,0,0,0,0,0,0,0,0,0,0,0,0,0,0,0,0,0,0,0,0,0,0,0,0,0,0,Ibrahima Mbaye,Â£2.97m ,25.0,188.0,Defender - Right-Back,right,Bologna FC 1909,17.0,0.0,1.0,1186.0,25.0,1.0,0.0,1748.0,25.0,2.0,0.0,2102.0,21.0,0.0,4.0,1596.0,1.0,0.0,0.0,26.0,Serie A,15-07-16,17.3.2.23,Ibrahima Mbaye,43078377,41,19-Nov-94,21,1,0,6,0,3500,6100,6000,143,120,3221972,188,70,D/WB/M RL,2,3,1,1,4,3,1,2,2,3,3,6,11,11,8,10,4,11,7,11,12,10,8,16,11,14,12,11,10,11,10,9,13,6,8,10,12,10,12,14,11,13,14,10,13,13,20,13,14,13,14,11,9,16,13,13,11,15,14,12,12,9,Ibrahima Mbaye,Â£2.70m ,Serie A
19-06-17,18.3.4.28,Filippo Costa,43083239,776,21-May-95,22,0,0,0,0,2250,6000,6000,150,120,1798968,175,68,D/WB/M L,2,1,2,2,1,1,2,2,2,2,3,10,12,9,5,11,9,10,8,13,11,11,5,13,11,13,12,11,12,12,12,10,12,9,11,8,11,13,13,15,12,12,8,20,13,15,11,14,12,15,8,12,7,14,11,13,14,12,15,13,13,5,17,17,20,1,1,20,1,D/WB/M L,433,1,1,1,1,1,1,1,17,1,1,1,20,1,17,1,134217728.0,0,0,0,0,0,0,0,0,0,0,0,0,0,0,0,0,0,0,0,0,0,0,0,0,0,0,0,1,0,0,0,0,0,0,0,0,0,0,0,0,0,0,0,0,0,0,0,0,Filippo Costa,Â£900Th. ,25.0,175.0,Defender - Left-Back,left,Virtus Entella,17.0,1.0,6.0,1355.0,24.0,0.0,1.0,1504.0,11.0,0.0,0.0,659.0,32.0,1.0,6.0,2334.0,3.0,0.0,0.0,240.0,Serie A
19-06-17,18.3.4.28,Federico Mattiello,43085786,776,14-Jul-95,21,0,0,0,0,2750,5750,6000,143,120,4627607,182,77,D/WB/M RL,1,1,2,1,2,1,2,1,1,2,3,7,12,12,6,11,6,10,9,13,12,12,5,12,12,13,12,13,13,13,5,11,16,11,6,12,12,14,14,14,13,12,10,20,9,14,7,13,10,15,6,8,15,16,9,13,11,12,14,13,13,5,20,19,18,8,20,17,1,D/WB/M RL,125,1,1,1,1,7,8,1,17,20,1,1,15,18,16,19,0.0,0,0,0,0,0,0,0,0,0,0,0,0,0,0,0,0,0,0,0,0,0,0,0,0,0,0,0,0,0,0,0,0,0,0,0,0,0,0,0,0,0,0,0,0,0,0,0,0,Federico Mattiello,Â£2.25m ,25.0,184.0,Defender - Right-Back,right,Spezia Calcio,7.0,2.0,4.0,630.0,31.0,0.0,0.0,2259.0,19.0,1.0,2.0,1495.0,18.0,0.0,1.0,925.0,nan,nan,nan,nan,Serie A,15-07-16,17.3.2.23,Federico Mattiello,43085786,776,14-Jul-95,21,0,0,0,0,1700,5500,5750,145,115,2242160,182,77,D/WB/M RL,1,1,3,3,1,2,3,1,2,2,1,6,12,11,5,10,5,10,8,12,11,11,4,11,11,13,12,14,12,12,7,10,16,11,6,11,11,13,14,14,11,11,9,20,9,14,7,11,9,15,6,12,9,16,19,13,11,12,14,13,13,5,Federico Mattiello,Â£360Th. ,Serie A
19-06-17,18.3.4.28,Federico Di Francesco,43087308,776,14-Jun-94,23,0,0,6,3,3750,6600,6600,145,132,14295418,171,0,AM RL,1,2,2,2,1,1,2,3,1,3,3,12,14,13,13,11,11,12,11,5,6,10,13,11,12,12,13,12,11,13,13,13,12,7,12,14,10,14,13,13,14,13,13,10,13,14,20,14,15,12,7,11,8,13,9,10,11,9,12,12,9,5,1,1,15,20,20,19,13,AM RL,505,1,1,12,13,19,20,1,1,1,1,1,15,15,1,1,549756000000.0,0,0,0,0,0,0,0,0,0,0,0,0,0,1,0,0,0,0,0,0,0,0,0,0,0,0,0,0,0,0,0,0,0,0,0,0,0,0,0,1,0,0,0,0,0,0,0,0,Federico Di Francesco,Â£3.15m ,26.0,171.0,Forward - Left Winger,right,SPAL,27.0,5.0,4.0,1306.0,25.0,1.0,3.0,1688.0,21.0,2.0,3.0,1181.0,21.0,3.0,3.0,1163.0,2.0,0.0,0.0,117.0,Serie A,15-07-16,17.3.2.23,Federico Di Francesco,43087308,776,14-Jun-94,22,0,0,0,0,2000,5900,6200,135,126,7324610,171,71,AM RL,1,1,2,2,4,2,3,2,3,1,2,9,13,13,14,12,9,13,12,6,7,11,9,8,13,12,13,12,10,13,14,13,10,7,12,15,14,15,14,14,14,14,11,9,12,13,20,15,14,12,7,11,8,13,7,10,11,9,11,12,8,5,Federico Di Francesco,Â£2.25m ,Serie A
19-06-17,18.3.4.28,Kevin Lasagna,43092927,776,10-Aug-92,24,0,0,0,0,2500,6350,6500,140,129,12618704,186,80,S L,1,1,3,1,3,1,3,2,3,2,4,9,12,12,13,11,12,9,13,5,5,12,13,8,13,14,13,13,12,12,11,11,15,13,7,15,12,14,14,16,15,12,10,20,15,16,7,13,12,13,8,14,4,12,13,14,13,12,15,14,10,2,1,1,1,15,12,15,14,S L,603,1,1,20,14,15,12,1,1,1,1,1,1,1,1,1,2251800000000000.0,0,0,1,0,1,0,0,0,0,1,0,0,0,0,0,0,0,0,0,0,0,0,0,0,0,0,0,0,0,0,0,0,0,0,0,0,0,0,0,0,0,0,0,0,0,0,0,0,Kevin Lasagna,Â£6.75m ,28.0,181.0,Forward - Centre-Forward,left,Udinese Calcio,47.0,14.0,5.0,3468.0,32.0,14.0,4.0,2317.0,37.0,6.0,1.0,2568.0,39.0,12.0,3.0,2796.0,5.0,0.0,0.0,407.0,Serie A
19-06-17,18.3.4.28,Matteo Politano,43093382,776,03-Aug-93,23,0,0,2,0,4000,7000,7000,153,140,26533312,171,68,AM RL,3,2,3,3,2,2,3,1,1,1,3,14,14,14,12,14,12,7,13,7,6,12,14,8,14,11,12,13,12,13,13,13,13,14,11,15,7,15,15,15,16,13,7,20,13,13,10,14,10,13,6,13,5,15,10,12,12,13,14,14,12,2,1,1,14,20,18,20,12,AM RL,505,1,1,12,12,20,18,1,1,1,1,1,14,12,1,1,134217728.0,0,0,0,0,0,0,0,0,0,0,0,0,0,0,0,0,0,0,0,0,0,0,0,0,0,0,0,1,0,0,0,0,0,0,0,0,0,0,0,0,0,0,0,0,0,0,0,0,Matteo Politano,Â£19.80m ,27.0,171.0,Forward - Right Winger,left,SSC Napoli,42.0,8.0,8.0,2878.0,39.0,11.0,4.0,3010.0,48.0,6.0,6.0,3438.0,35.0,2.0,2.0,1198.0,5.0,2.0,2.0,206.0,Serie A,15-07-16,17.3.2.23,Matteo Politano,43093382,776,03-Aug-93,22,0,0,2,0,3752,7000,6850,152,138,13115182,171,68,AM L,3,3,1,3,2,1,2,3,1,1,2,14,14,14,11,13,11,7,13,7,6,12,12,6,14,11,10,12,11,12,12,12,13,14,11,14,7,15,13,15,15,12,7,20,10,15,9,14,13,13,6,13,5,15,10,12,12,13,14,14,12,2,Matteo Politano,Â£6.75m ,Serie A
19-06-17,18.3.4.28,Federico Ricci,43093393,776,27-May-94,23,0,0,10,0,3750,6300,6300,146,126,8735093,175,63,AM RL,2,1,3,3,1,2,2,3,1,2,2,10,14,14,12,16,9,6,13,3,3,13,12,4,16,5,13,11,12,10,12,12,11,16,5,14,4,14,13,14,16,9,6,20,13,12,13,12,6,12,8,9,5,15,9,14,14,9,13,13,11,3,1,1,10,20,20,19,12,AM RL,505,1,1,10,12,19,20,1,1,1,1,1,10,10,1,1,17592200000000.0,0,0,0,0,0,0,0,1,0,0,0,0,0,0,0,0,0,0,0,0,0,0,0,0,0,0,0,0,0,0,0,0,0,0,0,0,0,0,0,0,0,0,0,0,1,0,0,0,Federico Ricci,Â£2.43m ,26.0,175.0,Forward - Right Winger,left,US Sassuolo,31.0,2.0,0.0,1389.0,21.0,1.0,2.0,1236.0,32.0,2.0,7.0,1499.0,29.0,4.0,3.0,1805.0,1.0,0.0,0.0,3.0,Serie A,15-07-16,17.3.2.23,Federico Ricci,43093393,776,27-May-94,22,0,0,2,0,4250,6000,6300,160,128,6521332,175,63,AM RL,2,2,2,2,3,4,3,1,1,1,2,10,13,15,12,16,9,6,13,3,3,15,12,4,16,5,13,7,11,10,14,12,11,16,5,14,4,11,12,15,16,9,6,20,13,13,13,11,5,12,8,9,5,15,9,14,14,9,13,13,11,3,Federico Ricci,Â£3.15m ,Serie A
19-06-17,18.3.4.28,Federico Bernardeschi,43093476,776,16-Feb-94,23,9,1,16,5,6000,7500,7600,172,152,76610496,185,77,M/AM RLC,2,3,2,3,2,2,3,2,1,3,2,14,14,17,14,17,14,10,13,6,6,14,14,7,17,11,14,11,13,11,14,14,13,17,9,15,9,13,12,15,14,12,11,20,15,15,10,13,10,13,11,12,10,13,12,15,15,13,13,14,12,9,1,1,16,20,20,17,17,M/AM RLC,526,1,1,14,17,17,20,1,1,1,1,1,13,16,1,1,2252350000000000.0,0,0,0,0,1,0,0,0,0,0,0,0,0,0,0,0,0,0,0,0,0,0,0,0,0,0,0,0,0,0,0,0,0,0,0,0,0,0,0,1,0,0,0,0,0,0,0,0,Federico Bernardeschi,Â£36.00m ,26.0,183.0,Forward - Right Winger,left,Juventus FC,42.0,14.0,5.0,2851.0,31.0,5.0,6.0,1104.0,39.0,3.0,6.0,2206.0,38.0,2.0,3.0,1971.0,3.0,0.0,0.0,92.0,Serie A,15-07-16,17.3.2.23,Federico Bernardeschi,43093476,776,16-Feb-94,22,7,0,10,0,5500,7500,7450,169,149,84115395,183,75,M/AM RLC,3,3,2,1,3,1,2,2,2,4,4,14,14,16,13,16,14,10,13,6,6,14,14,9,17,11,14,12,13,12,13,13,13,17,9,14,9,13,12,15,14,12,11,20,15,15,10,14,10,14,11,12,10,15,7,15,15,13,13,14,12,9,Federico Bernardeschi,Â£27.00m ,Serie A
19-06-17,18.3.4.28,Daniele Verde,43094108,776,20-Jun-96,20,0,0,2,0,2000,5750,5800,137,116,5736625,168,64,AM RL,3,3,4,1,3,3,2,1,2,1,3,11,13,12,12,13,12,6,14,4,4,14,13,4,15,10,11,12,11,10,13,9,11,15,7,10,5,10,10,14,16,12,5,20,13,14,8,12,10,11,3,15,8,12,11,15,12,12,14,11,10,2,1,1,13,20,20,19,13,AM RL,505,1,1,13,13,19,20,1,1,1,1,1,13,13,1,1,0.0,0,0,0,0,0,0,0,0,0,0,0,0,0,0,0,0,0,0,0,0,0,0,0,0,0,0,0,0,0,0,0,0,0,0,0,0,0,0,0,0,0,0,0,0,0,0,0,0,Daniele Verde,Â£3.15m ,24.0,168.0,Forward - Right Winger,left,Spezia Calcio,33.0,8.0,5.0,1953.0,33.0,4.0,3.0,2139.0,26.0,6.0,0.0,895.0,38.0,6.0,6.0,2305.0,4.0,1.0,0.0,218.0,Serie A
19-06-17,18.3.4.28,Antonio Barreca,43094517,776,18-Mar-95,22,0,0,13,0,3500,6500,6750,153,135,21273477,180,70,D/WB/M L,1,1,1,3,1,1,2,3,3,3,2,11,15,13,7,12,9,11,10,14,13,13,8,13,12,9,13,12,11,14,11,14,15,11,7,12,13,15,13,14,14,13,11,20,14,14,9,14,12,15,7,12,9,8,11,14,14,14,16,9,13,4,20,18,17,1,1,20,1,D/WB/M L,123,1,1,1,1,1,1,1,20,1,1,1,17,1,18,1,17314086912.0,0,0,0,0,0,0,0,0,0,0,0,0,0,0,0,0,0,0,0,0,0,0,0,0,0,0,0,1,0,0,0,0,0,0,1,0,0,0,0,0,0,0,0,0,0,0,0,0,Antonio Barreca,Â£3.15m ,25.0,183.0,Defender - Left-Back,left,ACF Fiorentina,30.0,0.0,2.0,2566.0,10.0,0.0,0.0,506.0,11.0,0.0,2.0,855.0,19.0,0.0,1.0,1214.0,0.0,0.0,0.0,0.0,Serie A,15-07-16,17.3.2.23,Antonio Barreca,43094517,776,18-Mar-95,21,0,0,5,0,1250,5700,6050,148,123,3905494,184,70,D/WB L,2,4,2,2,2,3,1,2,2,3,3,11,15,10,7,10,9,11,10,13,12,14,8,13,11,9,11,12,9,12,11,10,15,10,7,12,11,15,13,14,12,12,11,20,14,13,8,14,10,13,7,10,9,8,10,14,11,14,16,12,18,6,Antonio Barreca,Â£3.60m ,Serie A
19-06-17,18.3.4.28,Vittorio Parigini,43094538,776,25-Mar-96,21,0,0,4,1,4000,5850,5750,144,117,2619016,180,72,AM RLC,2,1,4,4,2,1,3,1,2,3,2,10,11,14,12,13,7,7,12,5,5,11,10,7,14,9,12,11,12,11,10,10,14,15,6,13,5,11,11,16,15,11,9,6,16,14,20,10,10,12,5,14,5,12,8,15,13,15,11,13,14,11,1,1,14,20,20,16,17,AM RLC,506,1,1,14,17,16,20,1,1,1,1,1,14,14,1,1,0.0,0,0,0,0,0,0,0,0,0,0,0,0,0,0,0,0,0,0,0,0,0,0,0,0,0,0,0,0,0,0,0,0,0,0,0,0,0,0,0,0,0,0,0,0,0,0,0,0,Vittorio Parigini,Â£990Th. ,24.0,180.0,Forward - Right Winger,right,Genoa CFC,20.0,1.0,1.0,698.0,21.0,0.0,0.0,854.0,18.0,0.0,0.0,443.0,15.0,3.0,1.0,737.0,1.0,0.0,0.0,11.0,Serie A
19-06-17,18.3.4.28,Domenico Berardi,43094553,776,01-Aug-94,22,0,0,23,4,5400,6950,7250,165,143,41475149,183,72,AM/S RLC,3,1,2,2,2,2,3,1,2,2,3,12,15,15,13,14,13,11,13,5,5,14,18,7,15,17,14,12,14,10,14,12,14,15,11,14,6,12,11,15,15,12,10,20,12,14,10,13,10,13,15,13,5,14,11,16,13,12,10,8,5,9,1,1,10,20,20,15,15,AM/S RLC,516,1,1,16,15,15,20,1,1,1,1,1,9,10,1,1,2.8823e+17,0,0,0,0,0,0,0,0,0,0,1,0,0,0,0,0,0,0,0,0,0,0,0,0,0,0,0,0,0,1,0,0,0,0,0,0,0,0,0,0,0,0,0,0,0,0,0,0,Domenico Berardi,Â£16.20m ,26.0,183.0,Forward - Right Winger,left,US Sassuolo,25.0,10.0,11.0,2042.0,33.0,5.0,2.0,2424.0,37.0,10.0,4.0,3058.0,32.0,14.0,10.0,2591.0,5.0,3.0,2.0,447.0,Serie A,15-07-16,17.3.2.23,Domenico Berardi,43094553,776,01-Aug-94,21,0,0,1,1,5250,6950,7400,169,148,37865307,183,70,AM/S RLC,2,1,3,2,3,1,1,1,2,3,3,12,15,14,15,15,14,11,13,5,5,14,18,7,15,17,12,9,13,10,13,11,13,15,11,14,7,12,10,16,15,12,11,20,11,15,11,13,10,13,15,13,5,14,11,17,13,13,10,8,8,9,Domenico Berardi,Â£22.50m ,Serie A
19-06-17,18.3.4.28,Luca Crecco,43123117,776,06-Sep-95,21,0,0,0,0,3500,5800,5800,138,116,4567745,183,76,WB/M/AM LC,3,1,3,3,2,3,1,3,2,1,2,7,11,12,9,12,8,10,10,7,10,13,8,9,13,14,12,13,11,10,10,12,13,9,7,13,13,12,15,13,11,12,11,20,13,13,7,14,12,12,12,12,10,13,10,12,16,10,16,16,15,3,15,17,20,17,1,20,18,WB/M/AM LC,434,1,1,1,8,17,1,1,15,1,10,18,20,1,17,1,0.0,0,0,0,0,0,0,0,0,0,0,0,0,0,0,0,0,0,0,0,0,0,0,0,0,0,0,0,0,0,0,0,0,0,0,0,0,0,0,0,0,0,0,0,0,0,0,0,0,Luca Crecco,Â£360Th. ,25.0,183.0,Midfielder - Central Midfield,left,Delfino Pescara 1936,16.0,1.0,1.0,747.0,4.0,0.0,0.0,323.0,23.0,2.0,1.0,1341.0,23.0,1.0,1.0,1285.0,0.0,0.0,0.0,0.0,Serie A,15-07-16,17.3.2.23,Luca Crecco,43123117,776,06-Sep-95,20,0,0,0,0,1500,5000,5250,129,108,1245827,183,76,M/AM L,3,1,2,1,1,2,2,1,3,3,3,8,10,12,6,10,9,10,10,10,7,12,9,8,13,15,12,11,12,11,11,11,3,9,7,13,12,12,13,12,11,12,11,20,16,13,10,13,11,12,10,12,10,13,17,13,12,11,11,10,11,8,Luca Crecco,Â£540Th. ,Serie A
19-06-17,18.3.4.28,Cristiano Lombardi,43123385,776,19-Aug-95,21,0,0,0,0,3500,5950,5950,145,119,5014254,180,75,M/AM/S RL,2,2,1,2,3,1,4,2,2,1,2,7,11,12,11,11,7,8,8,5,5,12,13,5,13,15,13,14,10,10,10,11,18,14,8,14,6,13,14,14,13,11,9,11,14,14,20,11,11,13,11,13,7,16,10,13,17,12,17,14,15,2,1,11,17,20,20,15,13,M/AM/S RL,535,1,1,17,13,15,20,1,1,1,1,1,13,17,1,11,16.0,0,0,0,0,1,0,0,0,0,0,0,0,0,0,0,0,0,0,0,0,0,0,0,0,0,0,0,0,0,0,0,0,0,0,0,0,0,0,0,0,0,0,0,0,0,0,0,0,Cristiano Lombardi,Â£720Th. ,25.0,180.0,Forward - Right Winger,right,US Salernitana 1919,19.0,1.0,0.0,485.0,17.0,0.0,2.0,1116.0,13.0,0.0,2.0,1071.0,23.0,5.0,4.0,1631.0,4.0,0.0,0.0,112.0,Serie A,15-07-16,17.3.2.23,Cristiano Lombardi,43123385,776,19-Aug-95,20,0,0,0,0,1350,5450,5850,135,120,3416220,180,75,M/AM RL,1,3,1,3,3,2,1,2,1,4,3,8,11,14,13,13,8,9,11,6,6,11,14,7,14,15,13,15,13,11,10,12,18,14,8,15,6,11,16,14,12,10,9,15,9,14,20,11,11,15,11,13,8,16,10,13,17,12,17,14,15,2,Cristiano Lombardi,Â£630Th. ,Serie A
19-06-17,18.3.4.28,Francesco Cassata,43141850,776,16-Jul-97,19,0,0,0,0,1800,5600,5600,128,112,3080942,183,75,M/AM RLC,4,3,1,2,3,1,3,3,2,1,2,10,11,10,9,11,9,10,11,9,9,13,10,11,11,11,13,12,10,12,13,12,12,11,10,14,12,15,14,13,13,12,11,7,12,13,20,13,12,10,4,11,7,17,11,13,12,9,11,12,8,2,10,12,20,17,17,15,20,M/AM RLC,416,1,1,1,12,14,17,1,1,10,1,20,15,16,10,12,48.0,0,0,0,0,1,1,0,0,0,0,0,0,0,0,0,0,0,0,0,0,0,0,0,0,0,0,0,0,0,0,0,0,0,0,0,0,0,0,0,0,0,0,0,0,0,0,0,0,Francesco Cassata,Â£3.15m ,23.0,183.0,Midfielder - Central Midfield,right,Genoa CFC,36.0,1.0,5.0,2931.0,12.0,1.0,0.0,598.0,19.0,2.0,2.0,1129.0,26.0,2.0,1.0,1675.0,nan,nan,nan,nan,Serie A
19-06-17,18.3.4.28,Gian Filippo Felicioli,43152263,776,30-Sep-97,19,0,0,0,0,1400,5650,5300,129,106,1642993,180,74,D/WB/M L,3,1,3,2,3,1,2,3,3,4,3,6,12,10,2,11,6,7,8,10,10,10,4,10,12,9,11,11,10,10,11,11,15,7,9,12,10,13,12,14,13,10,9,20,14,14,8,12,11,13,7,8,12,16,10,15,15,11,16,14,14,5,20,19,16,13,14,20,1,D/WB/M L,123,1,1,1,1,13,5,1,20,14,1,1,16,8,19,12,0.0,0,0,0,0,0,0,0,0,0,0,0,0,0,0,0,0,0,0,0,0,0,0,0,0,0,0,0,0,0,0,0,0,0,0,0,0,0,0,0,0,0,0,0,0,0,0,0,0,Gian Filippo Felicioli,Â£450Th. ,23.0,182.0,Defender - Left-Back,left,Venezia FC,22.0,0.0,2.0,1830.0,8.0,0.0,0.0,379.0,10.0,0.0,0.0,823.0,9.0,0.0,1.0,626.0,2.0,0.0,0.0,177.0,Serie A
19-06-17,18.3.4.28,Giovanni Crociata,43153059,776,11-Aug-97,19,0,0,0,0,1750,5250,5250,129,105,1681308,178,70,M/AM LC,1,2,3,1,2,3,2,2,3,1,3,11,8,12,5,11,9,4,9,6,9,12,8,8,13,14,13,13,12,12,12,11,16,9,8,13,8,13,10,15,14,7,9,11,15,13,20,10,9,13,8,8,11,15,7,16,17,10,15,12,14,3,1,1,20,16,10,20,18,M/AM LC,414,1,1,1,16,1,1,1,1,1,11,18,20,10,1,1,0.0,0,0,0,0,0,0,0,0,0,0,0,0,0,0,0,0,0,0,0,0,0,0,0,0,0,0,0,0,0,0,0,0,0,0,0,0,0,0,0,0,0,0,0,0,0,0,0,0,Giovanni Crociata,Â£450Th. ,23.0,174.0,Midfielder - Central Midfield,right,FC Crotone,20.0,1.0,4.0,1209.0,12.0,1.0,0.0,352.0,16.0,1.0,4.0,819.0,30.0,5.0,3.0,1875.0,1.0,0.0,0.0,13.0,Serie A
19-06-17,18.3.4.28,Mohamed Fares,43153070,5,15-Feb-96,21,0,0,0,0,3000,5650,5650,138,113,3713374,183,75,WB/M/AM L,3,3,3,1,3,3,4,3,4,2,1,11,13,12,10,12,8,7,10,6,5,12,13,7,13,10,13,13,12,8,12,12,13,18,8,17,10,12,13,13,13,11,11,20,15,12,9,12,8,13,5,12,5,15,14,15,8,11,12,10,11,9,15,16,17,20,1,20,12,WB/M/AM L,533,1,1,10,12,20,1,1,15,1,1,1,17,1,16,1,0.0,0,0,0,0,0,0,0,0,0,0,0,0,0,0,0,0,0,0,0,0,0,0,0,0,0,0,0,0,0,0,0,0,0,0,0,0,0,0,0,0,0,0,0,0,0,0,0,0,Mohamed Fares,Â£4.05m ,24.0,183.0,Midfielder - Left Midfield,left,SS Lazio,17.0,0.0,1.0,790.0,33.0,1.0,1.0,2798.0,36.0,3.0,1.0,3037.0,9.0,0.0,0.0,482.0,4.0,0.0,1.0,279.0,Serie A
19-06-17,18.3.4.28,Simone Edera,43159557,776,09-Jan-97,20,0,0,0,0,1550,4750,4400,120,105,442132,184,70,AM RL,2,3,3,2,3,3,4,3,2,3,2,11,14,12,9,11,8,8,8,8,8,10,2,9,14,8,9,9,10,9,8,8,10,13,12,10,6,9,10,14,14,9,7,20,13,14,11,7,6,9,6,7,10,10,13,13,12,10,12,11,19,4,1,1,15,20,20,16,1,AM RL,505,1,1,12,1,16,20,1,1,1,1,1,14,15,1,1,0.0,0,0,0,0,0,0,0,0,0,0,0,0,0,0,0,0,0,0,0,0,0,0,0,0,0,0,0,0,0,0,0,0,0,0,0,0,0,0,0,0,0,0,0,0,0,0,0,0,Simone Edera,Â£1.35m ,23.0,174.0,Forward - Right Winger,left,Torino FC,16.0,1.0,0.0,494.0,17.0,2.0,1.0,430.0,8.0,1.0,0.0,363.0,13.0,1.0,1.0,394.0,0.0,0.0,0.0,0.0,Serie A
19-06-17,18.3.4.28,Federico Chiesa,43161651,776,25-Oct-97,19,0,0,6,0,4000,7050,7000,165,140,72711482,175,70,M/AM RL,2,1,1,3,3,2,2,2,1,3,2,12,13,14,12,14,12,10,13,7,7,15,10,9,14,13,14,13,13,13,13,14,14,13,8,16,9,14,15,14,14,12,9,9,16,15,20,13,11,13,11,14,7,14,12,14,14,15,15,14,10,8,1,1,18,20,20,17,13,M/AM RL,525,1,1,10,13,17,20,1,1,1,1,1,12,18,1,1,32.0,0,0,0,0,0,1,0,0,0,0,0,0,0,0,0,0,0,0,0,0,0,0,0,0,0,0,0,0,0,0,0,0,0,0,0,0,0,0,0,0,0,0,0,0,0,0,0,0,Federico Chiesa,Â£40.50m ,23.0,180.0,Forward - Right Winger,right,Juventus FC,36.0,5.0,4.0,2166.0,38.0,6.0,7.0,3202.0,41.0,12.0,5.0,3383.0,37.0,11.0,9.0,2820.0,5.0,1.0,2.0,392.0,Serie A,15-07-16,17.3.2.23,Federico Chiesa,43161651,776,25-Oct-97,18,0,0,0,0,2014,5490,6500,147,130,19054744,175,69,AM/S RL,2,2,3,3,1,1,3,3,1,2,2,11,11,15,10,11,11,13,9,11,10,11,7,11,13,12,12,10,11,11,12,10,5,12,12,14,10,12,13,14,15,12,10,12,12,13,20,11,8,10,10,5,12,10,14,10,13,11,11,12,10,3,Federico Chiesa,Â£9.00m ,Serie A
19-06-17,18.3.4.28,Giuseppe Pezzella,43161921,776,29-Nov-97,19,0,0,0,0,1750,6000,6000,142,120,8249215,187,81,D/WB L,1,3,4,3,3,3,1,3,2,1,2,9,10,10,6,10,7,11,6,13,9,11,5,13,10,12,10,12,10,12,8,12,17,8,8,11,12,12,14,15,11,14,12,20,15,15,10,14,12,15,8,12,3,15,10,12,15,17,17,14,17,5,20,19,15,12,12,20,14,D/WB L,113,1,1,1,1,12,1,14,20,12,1,1,15,10,19,11,134217729.0,1,0,0,0,0,0,0,0,0,0,0,0,0,0,0,0,0,0,0,0,0,0,0,0,0,0,0,1,0,0,0,0,0,0,0,0,0,0,0,0,0,0,0,0,0,0,0,0,Giuseppe Pezzella,Â£2.70m ,22.0,187.0,Defender - Left-Back,left,Parma Calcio 1913,11.0,0.0,0.0,926.0,18.0,0.0,1.0,1135.0,10.0,0.0,1.0,369.0,25.0,0.0,0.0,1207.0,4.0,0.0,1.0,360.0,Serie A,15-07-16,17.3.2.23,Giuseppe Pezzella,43161921,776,29-Nov-97,18,0,0,0,0,1753,5211,5550,143,118,2260485,185,81,D/WB L,2,2,1,1,3,2,3,1,1,2,1,9,10,10,6,10,7,11,6,13,10,11,5,13,10,12,10,12,10,12,8,12,17,8,8,11,12,12,14,15,11,14,12,20,15,15,10,14,12,16,8,12,3,15,18,12,15,17,17,14,17,5,Giuseppe Pezzella,Â£900Th. ,Serie A
19-06-17,18.3.4.28,Riccardo Orsolini,43162321,776,24-Jan-97,20,0,0,0,0,1750,6000,6250,151,128,13673011,183,73,AM/S RL,1,2,2,2,1,2,1,3,2,1,3,12,13,13,13,13,12,12,12,6,6,13,13,8,13,10,11,11,10,11,12,11,11,12,11,15,10,12,13,13,13,12,12,20,11,14,11,13,12,10,6,12,6,13,13,16,10,11,11,12,11,7,1,1,10,20,20,17,12,AM/S RL,515,1,1,16,12,17,20,1,1,1,1,1,10,10,1,1,16.0,0,0,0,0,1,0,0,0,0,0,0,0,0,0,0,0,0,0,0,0,0,0,0,0,0,0,0,0,0,0,0,0,0,0,0,0,0,0,0,0,0,0,0,0,0,0,0,0,Riccardo Orsolini,Â£3.15m ,23.0,183.0,Forward - Right Winger,left,Bologna FC 1909,42.0,8.0,6.0,2893.0,17.0,0.0,1.0,559.0,37.0,10.0,5.0,2041.0,39.0,9.0,8.0,2873.0,5.0,1.0,0.0,251.0,Serie A
19-06-17,18.3.4.28,Jakub Jankto,43207792,763,19-Jan-96,21,4,1,7,3,3500,6500,6650,158,133,10794119,179,70,M/AM LC,1,1,1,2,1,4,3,1,2,1,3,12,14,11,13,12,13,9,14,7,10,14,12,12,13,11,13,12,14,11,13,12,15,14,9,14,12,12,12,15,14,13,10,20,12,14,9,14,10,14,12,11,5,15,14,13,13,12,14,13,11,6,1,1,20,16,14,18,20,M/AM LC,414,1,1,1,16,15,10,1,1,1,1,20,18,14,1,1,0.0,0,0,0,0,0,0,0,0,0,0,0,0,0,0,0,0,0,0,0,0,0,0,0,0,0,0,0,0,0,0,0,0,0,0,0,0,0,0,0,0,0,0,0,0,0,0,0,0,Jakub Jankto,Â£13.50m ,24.0,184.0,Midfielder - Central Midfield,left,UC Sampdoria,30.0,5.0,4.0,1918.0,39.0,6.0,6.0,2870.0,28.0,1.0,1.0,1180.0,31.0,2.0,5.0,2191.0,4.0,1.0,1.0,338.0,Serie A,15-07-16,17.3.2.23,Jakub Jankto,43207792,763,19-Jan-96,20,0,0,4,3,2251,5454,5900,137,122,4480455,179,70,M LC,2,2,2,1,1,1,1,1,3,3,1,13,13,14,12,13,14,8,14,5,9,14,13,11,14,11,12,11,11,11,14,12,12,14,9,14,11,13,13,15,13,12,11,20,12,14,7,13,10,11,11,11,5,15,14,13,13,12,13,13,11,6,Jakub Jankto,Â£7.20m ,Serie A
19-06-17,18.3.4.28,Giuseppe Borello,43271237,776,28-Apr-99,18,0,0,0,0,500,3550,3550,111,76,149455,167,59,AM RLC,1,3,1,3,3,3,3,2,1,1,3,10,9,10,7,10,9,5,9,3,4,7,10,5,12,8,8,7,9,9,10,10,13,13,11,11,9,8,9,12,12,8,4,20,12,11,10,8,9,8,6,8,8,4,10,12,14,11,12,14,12,6,1,1,1,20,20,15,18,AM RLC,506,1,1,15,18,15,20,1,1,1,1,1,1,1,1,1,0.0,0,0,0,0,0,0,0,0,0,0,0,0,0,0,0,0,0,0,0,0,0,0,0,0,0,0,0,0,0,0,0,0,0,0,0,0,0,0,0,0,0,0,0,0,0,0,0,0,Giuseppe Borello,Â£180Th. ,21.0,168.0,Forward - Right Winger,left,FC Pro Vercelli 1892,25.0,6.0,0.0,1789.0,34.0,14.0,5.0,2485.0,32.0,5.0,3.0,2131.0,29.0,6.0,2.0,1969.0,4.0,0.0,0.0,73.0,Serie A
19-06-17,18.3.4.28,Moise Kean,43274977,776,28-Feb-00,17,0,0,0,0,2516,4782,6000,160,120,11314563,183,76,AM/S L,2,1,1,2,1,1,4,2,2,1,1,3,11,13,14,11,11,13,12,2,5,12,8,5,12,13,10,12,11,11,12,13,15,11,12,15,5,10,9,14,15,14,12,10,18,13,20,12,12,15,15,11,6,8,20,20,12,9,13,9,14,5,1,1,1,18,1,18,8,AM/S L,623,1,1,20,8,18,1,1,1,1,1,1,1,1,1,1,2269940000000000.0,0,0,0,0,0,0,0,0,0,0,0,0,0,0,0,0,0,0,0,0,0,0,0,0,0,0,0,0,0,0,0,0,0,0,0,0,0,0,0,1,0,0,0,0,1,0,0,0,Moise Kean,Â£10.80m ,20.0,183.0,Forward - Centre-Forward,right,Paris Saint-Germain,24.0,14.0,5.0,1480.0,20.0,4.0,0.0,1221.0,17.0,7.0,0.0,661.0,33.0,2.0,2.0,1024.0,7.0,4.0,0.0,324.0,Serie A
19-06-17,18.3.4.28,Adam Ounas,48034668,5,11-Nov-96,20,0,0,0,0,5250,6350,6600,153,132,22955142,172,65,AM RLC,1,1,3,2,2,3,3,1,2,2,3,11,13,15,11,15,10,6,11,3,3,13,11,3,16,8,10,10,12,10,13,11,12,16,8,13,4,10,11,16,16,14,6,20,11,15,13,10,9,7,10,14,8,10,13,14,9,10,9,2,10,10,1,1,12,20,18,20,15,AM RLC,506,1,1,10,15,20,18,1,1,1,1,1,12,10,1,1,2.90482e+17,0,0,0,0,0,0,0,0,0,0,0,1,0,0,0,0,0,0,0,0,0,0,0,0,0,0,0,0,0,0,0,0,0,0,0,1,0,0,0,0,0,0,0,0,0,0,0,0,Adam Ounas,Â£4.05m ,23.0,172.0,Forward - Right Winger,left,Cagliari Calcio,30.0,4.0,3.0,1462.0,14.0,2.0,0.0,424.0,26.0,4.0,1.0,783.0,19.0,4.0,4.0,1401.0,2.0,0.0,0.0,22.0,Serie A,15-07-16,17.3.2.23,Adam Ounas,48034668,5,11-Nov-96,19,0,0,0,0,5200,6200,6450,153,129,22610321,172,64,AM RL,2,4,2,2,3,3,2,2,1,3,2,13,13,15,12,15,12,6,12,3,2,13,11,3,16,8,10,9,12,9,13,10,12,15,8,13,4,5,7,17,16,14,5,20,11,15,12,10,8,8,10,14,8,10,16,14,9,10,9,11,10,10,Adam Ounas,Â£3.60m ,Ligue 1
19-06-17,18.3.4.28,ZinÃ©dine Machach,48038202,769,05-Jan-96,21,0,0,0,0,3500,5500,5500,129,110,1947695,170,77,M/AM LC,3,3,3,3,3,3,1,2,3,4,2,10,13,13,7,12,10,7,12,6,9,11,10,9,13,14,12,13,8,8,10,12,11,14,7,12,7,9,12,13,13,14,7,10,10,13,20,11,14,10,15,7,8,13,16,15,10,11,7,6,7,12,1,13,17,20,1,20,17,M/AM LC,524,1,1,1,13,20,1,1,1,1,10,17,15,1,13,1,0.0,0,0,0,0,0,0,0,0,0,0,0,0,0,0,0,0,0,0,0,0,0,0,0,0,0,0,0,0,0,0,0,0,0,0,0,0,0,0,0,0,0,0,0,0,0,0,0,0,ZinÃ©dine Machach,Â£810Th. ,24.0,185.0,Midfielder - Central Midfield,right,VVV-Venlo,12.0,1.0,0.0,581.0,4.0,1.0,0.0,192.0,26.0,0.0,1.0,1115.0,18.0,1.0,1.0,1068.0,3.0,0.0,0.0,170.0,Serie A,15-07-16,17.3.2.23,ZinÃ©dine Machach,48038202,769,05-Jan-96,20,0,0,0,0,4000,5650,5650,124,113,2735938,170,77,M/AM LC,3,2,1,3,1,3,3,1,3,2,1,11,13,12,7,12,11,7,12,7,9,11,8,11,13,14,12,13,8,9,14,12,3,14,10,12,7,9,13,13,13,14,7,10,10,13,20,11,14,10,15,1,11,11,19,12,9,9,13,6,15,4,ZinÃ©dine Machach,Â£1.13m ,Ligue 1
19-06-17,18.3.4.28,Moussa Diaby,48044574,769,07-Jul-99,17,0,0,0,0,3500,5250,5250,147,105,2578323,168,0,AM L,1,3,1,1,1,1,2,2,2,3,3,10,10,14,8,12,10,10,10,5,4,10,3,4,14,10,9,10,10,8,10,9,4,14,7,12,6,10,14,15,15,10,6,20,13,13,10,9,8,10,7,4,10,10,20,12,12,10,9,12,11,2,1,1,12,20,13,20,10,AM L,503,1,1,1,10,20,13,1,1,1,1,1,12,1,1,1,0.0,0,0,0,0,0,0,0,0,0,0,0,0,0,0,0,0,0,0,0,0,0,0,0,0,0,0,0,0,0,0,0,0,0,0,0,0,0,0,0,0,0,0,0,0,0,0,0,0,Moussa Diaby,Â£450Th. ,21.0,170.0,Forward - Left Winger,left,Bayer 04 Leverkusen,7.0,3.0,1.0,508.0,10.0,2.0,5.0,749.0,34.0,4.0,7.0,1526.0,39.0,8.0,8.0,2551.0,7.0,2.0,1.0,584.0,Serie A
19-06-17,18.3.4.28,Rafik Zekhnini,53114431,786,12-Jan-98,19,0,0,3,0,4500,5750,5750,143,121,5823129,179,63,AM RL,4,3,2,4,3,1,1,2,2,2,3,9,12,13,10,14,10,5,11,4,4,10,8,6,14,13,11,5,10,9,10,9,15,17,5,12,6,12,12,16,14,12,7,14,12,15,20,11,6,12,5,12,12,11,15,16,11,14,14,14,1,5,1,1,12,20,17,20,1,AM RL,505,1,1,1,1,20,17,1,1,1,1,1,12,11,1,1,34359738368.0,0,0,0,0,0,0,0,0,0,0,0,0,0,0,0,0,0,0,0,0,0,0,0,0,0,0,0,0,0,0,0,0,0,0,0,1,0,0,0,0,0,0,0,0,0,0,0,0,Rafik Zekhnini,Â£900Th. ,22.0,179.0,Forward - Left Winger,right,FC Lausanne-Sport,17.0,1.0,2.0,1075.0,16.0,1.0,1.0,786.0,29.0,6.0,4.0,1292.0,24.0,2.0,1.0,965.0,1.0,0.0,0.0,8.0,Serie A
19-06-17,18.3.4.28,Guilherme,55024926,1651,21-May-91,26,0,0,0,0,4500,5500,5750,122,116,867957,174,70,M/AM RLC,1,1,1,2,2,3,3,3,3,2,1,12,13,14,8,14,14,6,10,8,7,16,13,10,14,12,13,15,7,10,13,9,15,17,11,14,8,12,13,14,14,10,6,20,10,11,8,13,8,11,14,12,12,13,14,15,8,12,10,8,10,14,12,10,17,20,20,15,19,M/AM RLC,526,1,1,1,19,15,20,1,12,1,10,17,15,10,10,1,34359869440.0,0,0,0,0,0,0,0,0,0,0,0,0,0,0,0,0,0,1,0,0,0,0,0,0,0,0,0,0,0,0,0,0,0,0,0,1,0,0,0,0,0,0,0,0,0,0,0,0,Guilherme,Â£3.60m ,29.0,174.0,Forward - Right Winger,left,GÃ¶ztepe,41.0,7.0,8.0,2955.0,34.0,7.0,4.0,2469.0,35.0,5.0,7.0,2577.0,44.0,9.0,8.0,2649.0,5.0,2.0,0.0,312.0,Serie A,15-07-16,17.3.2.23,Guilherme,19105719,1651,05-Apr-91,25,0,0,0,0,4000,6250,6400,137,131,6927383,179,77,DM C,3,2,4,3,1,2,3,3,3,2,1,5,12,12,10,12,11,12,14,10,13,13,10,14,14,12,13,12,12,12,13,12,13,9,9,12,14,15,13,14,14,14,10,9,14,13,20,14,12,10,10,11,5,14,10,13,14,14,14,10,14,8,Guilherme,Â£3.60m ,LaLiga
19-06-17,18.3.4.28,MÃ¡rio Rui,55027761,788,27-May-91,26,0,0,3,0,4850,6600,6850,145,137,15474703,168,67,D/WB/M L,2,2,4,4,4,1,1,2,1,2,3,13,15,12,5,12,12,8,12,12,12,12,7,14,12,14,14,15,13,13,11,14,15,12,9,13,13,14,15,16,15,8,6,20,16,15,7,15,9,13,10,12,7,11,14,12,9,10,13,14,13,8,20,18,17,1,1,20,1,D/WB/M L,123,1,1,1,1,1,1,1,20,1,1,1,17,1,18,1,1099510000000.0,0,0,0,0,0,1,0,0,0,0,0,0,0,0,0,0,0,0,0,0,0,0,0,0,0,0,0,0,0,0,0,0,0,0,0,0,0,0,0,0,1,0,0,0,0,0,0,0,MÃ¡rio Rui,Â£12.60m ,29.0,170.0,Defender - Left-Back,left,SSC Napoli,10.0,0.0,0.0,739.0,30.0,2.0,4.0,2312.0,31.0,1.0,2.0,2318.0,35.0,0.0,2.0,2847.0,2.0,0.0,0.0,121.0,Serie A,15-07-16,17.3.2.23,MÃ¡rio Rui,55027761,788,27-May-91,25,0,0,3,0,5000,6750,7050,150,141,15014685,170,67,D/WB L,2,1,3,4,3,1,3,3,1,2,3,13,15,13,5,13,12,8,12,12,12,12,7,14,14,14,14,15,13,13,11,14,15,12,9,13,13,14,15,16,15,13,6,20,16,15,7,15,12,13,10,12,7,11,14,12,13,10,14,14,13,3,MÃ¡rio Rui,Â£6.30m ,Serie A
19-06-17,18.3.4.28,Iuri Medeiros,55028139,788,10-Jul-94,22,0,0,19,1,3500,6650,6650,148,133,8675819,174,66,AM RLC,1,1,1,3,2,3,1,3,3,1,1,15,15,15,11,15,14,6,15,6,6,15,11,6,16,12,10,12,14,13,14,13,14,15,8,14,9,11,12,13,14,14,7,20,11,13,11,11,11,12,5,12,6,10,9,12,14,11,11,9,9,12,1,1,14,20,20,18,17,AM RLC,506,1,1,1,17,18,20,1,1,1,1,10,14,8,1,1,2.88235e+17,0,0,0,0,0,0,0,0,0,0,0,0,0,0,0,0,0,0,0,0,0,0,0,0,0,0,0,0,0,0,0,0,0,0,0,0,0,0,0,0,0,0,1,0,0,0,0,0,Iuri Medeiros,Â£4.50m ,26.0,174.0,Forward - Right Winger,left,SC Braga,30.0,8.0,9.0,2564.0,23.0,3.0,2.0,1079.0,18.0,3.0,1.0,888.0,11.0,0.0,0.0,554.0,6.0,1.0,1.0,316.0,Serie A,15-07-16,17.3.2.23,Iuri Medeiros,55028139,788,10-Jul-94,22,0,0,12,0,3500,6800,6800,158,136,3847355,174,66,AM RLC,3,3,1,1,3,1,1,1,2,2,2,15,15,15,11,14,14,6,15,6,6,15,11,6,17,12,10,12,14,13,14,13,14,15,8,14,9,11,11,14,15,14,7,20,11,13,11,11,11,12,5,12,6,10,11,12,14,11,11,9,9,13,Iuri Medeiros,Â£4.50m ,Liga NOS
19-06-17,18.3.4.28,Dalbert,55072311,1651,08-Sep-93,23,0,0,0,0,5500,6550,6750,153,139,20519681,181,74,D/WB/M L,1,1,4,3,2,1,3,2,1,1,1,12,14,13,7,13,11,9,12,13,11,13,4,11,13,16,13,14,13,12,12,12,13,13,8,14,10,14,15,15,14,12,11,20,14,16,8,15,12,14,12,11,10,10,13,15,14,13,13,12,13,7,20,19,16,7,1,20,1,D/WB/M L,123,1,1,1,1,7,1,1,20,1,1,1,16,1,19,1,137573000000.0,0,0,0,0,0,1,0,0,0,0,0,0,0,0,0,0,0,0,0,0,0,0,0,0,0,0,0,1,0,0,0,0,0,0,0,0,0,1,0,0,0,0,0,0,0,0,0,0,Dalbert,Â£10.80m ,27.0,181.0,Defender - Left-Back,left,Stade Rennais FC,38.0,0.0,3.0,3258.0,16.0,0.0,0.0,682.0,12.0,1.0,1.0,900.0,34.0,0.0,9.0,2751.0,3.0,0.0,0.0,190.0,Serie A,15-07-16,17.3.2.23,Dalbert,55072311,1651,08-Sep-93,22,0,0,0,0,4405,5626,6500,139,130,12975249,181,74,D/WB L,3,3,3,3,1,4,3,2,1,2,1,12,13,12,8,13,11,9,11,13,10,12,8,12,13,16,12,14,13,11,11,13,13,12,8,14,10,11,14,14,14,12,11,20,13,15,8,15,12,14,13,11,10,10,13,15,10,12,12,12,1,1,Dalbert,Â£4.50m ,Ligue 1
19-06-17,18.3.4.28,Gil Dias,55082920,788,28-Sep-96,20,0,0,0,0,5050,6650,6300,148,126,13312192,187,0,AM RLC,1,2,2,1,4,3,1,2,2,1,2,11,11,14,10,13,11,10,11,4,6,13,13,5,14,11,12,11,13,10,14,12,13,13,8,14,8,10,11,14,13,12,13,20,13,15,10,12,11,13,8,5,4,12,13,14,10,12,12,13,13,7,1,1,14,20,18,20,17,AM RLC,506,1,1,12,17,20,18,1,1,1,1,13,14,10,1,1,0.0,0,0,0,0,0,0,0,0,0,0,0,0,0,0,0,0,0,0,0,0,0,0,0,0,0,0,0,0,0,0,0,0,0,0,0,0,0,0,0,0,0,0,0,0,0,0,0,0,Gil Dias,Â£2.70m ,24.0,186.0,Forward - Right Winger,left,FC FamalicÃ£o,39.0,8.0,7.0,2972.0,29.0,2.0,2.0,1203.0,34.0,3.0,2.0,1726.0,29.0,0.0,1.0,1526.0,3.0,0.0,0.0,141.0,Serie A,15-07-16,17.3.2.23,Gil Dias,55082920,788,28-Sep-96,19,0,0,0,0,3800,6650,6650,157,133,15659191,187,79,M/AM LC,2,2,3,2,3,2,3,2,3,1,3,11,12,14,10,13,11,10,11,4,6,13,13,5,15,11,11,11,13,10,14,11,13,13,8,14,8,10,11,15,13,11,11,20,13,15,10,12,10,12,8,4,4,11,13,14,10,12,12,13,13,7,Gil Dias,Â£1.80m ,Ligue 1
19-06-17,18.3.4.28,Adrian Stoian,57022205,790,11-Feb-91,26,1,0,4,0,3600,5750,6000,128,120,3678733,178,66,M/AM RLC,1,3,1,1,1,3,3,3,1,3,3,12,11,14,9,13,12,5,11,4,4,11,14,4,14,12,9,7,9,8,12,8,14,14,5,12,4,9,9,15,16,10,6,15,12,14,20,13,8,10,12,11,12,12,16,13,12,12,11,12,11,10,1,1,18,20,17,20,18,M/AM RLC,526,1,1,12,18,20,17,1,1,1,1,1,18,15,1,1,0.0,0,0,0,0,0,0,0,0,0,0,0,0,0,0,0,0,0,0,0,0,0,0,0,0,0,0,0,0,0,0,0,0,0,0,0,0,0,0,0,0,0,0,0,0,0,0,0,0,Adrian Stoian,Â£1.62m ,29.0,177.0,Forward - Left Winger,both,FC Viitorul ConstanÈa,28.0,3.0,3.0,1615.0,34.0,2.0,4.0,2306.0,21.0,2.0,0.0,1109.0,3.0,0.0,0.0,51.0,2.0,0.0,1.0,24.0,Serie A,15-07-16,17.3.2.23,Adrian Stoian,57022205,790,11-Feb-91,25,1,0,4,0,3600,5900,5800,136,117,645265,178,66,AM RLC,3,1,1,2,2,1,3,3,1,2,4,10,11,14,11,12,7,5,11,10,6,10,12,8,16,9,6,6,10,9,13,10,11,12,7,12,6,9,9,16,16,10,5,7,12,15,20,10,8,9,12,11,15,12,16,10,8,7,8,11,7,12,Adrian Stoian,Â£900Th. ,Serie A
19-06-17,18.3.4.28,Darko Lazovic,5747078,802,15-Sep-90,26,6,0,10,5,4500,6350,6350,137,127,5694068,181,66,WB/M/AM RL,2,1,3,2,1,4,1,3,2,3,3,13,12,13,10,13,12,9,13,5,5,13,11,9,13,10,12,8,11,11,13,11,10,15,11,13,8,11,12,14,13,12,10,10,12,14,20,13,10,13,7,11,8,14,12,13,12,8,10,11,10,12,1,17,18,20,20,16,14,WB/M/AM RL,535,1,1,5,14,16,20,1,1,1,1,1,8,18,1,17,549756000000.0,0,0,0,0,0,0,0,0,0,0,1,1,0,0,0,0,0,0,0,0,0,0,0,0,0,0,0,0,0,0,0,0,0,0,0,0,0,0,0,1,0,0,0,0,0,0,0,0,Darko Lazovic,Â£1.62m ,30.0,181.0,Midfielder - Left Midfield,right,Hellas Verona,36.0,2.0,5.0,2624.0,24.0,0.0,0.0,1457.0,34.0,3.0,4.0,2667.0,39.0,3.0,7.0,3314.0,3.0,0.0,0.0,225.0,Serie A,15-07-16,17.3.2.23,Darko Lazovic,5747078,802,15-Sep-90,25,6,0,10,5,4750,6300,6450,137,130,7808348,181,66,AM RL,2,3,3,2,1,1,2,2,2,2,4,13,13,14,13,13,12,9,14,5,5,13,11,9,16,10,12,12,11,12,13,11,10,15,11,12,8,10,12,14,13,12,9,10,12,14,20,12,10,13,7,11,14,15,12,13,12,8,10,11,10,12,Darko Lazovic,Â£2.25m ,Serie A
19-06-17,18.3.4.28,Massimo Gobbi,6100012,776,31-Oct-80,36,1,0,0,0,3750,6500,6500,136,130,232186002,183,78,D/WB/M L,1,3,1,1,3,1,3,3,1,3,1,11,14,11,8,10,7,9,10,14,13,13,8,14,12,14,13,14,14,10,9,13,14,9,13,15,13,16,14,12,13,13,10,20,15,14,11,14,12,13,8,12,7,18,11,12,13,10,16,14,11,4,20,19,16,1,11,20,8,D/WB/M L,123,1,1,1,1,1,1,6,20,11,1,8,16,1,19,10,8796090000000.0,1,0,0,0,1,0,0,0,0,0,0,0,0,0,0,0,0,0,0,0,1,0,0,0,0,0,0,0,0,0,0,0,0,0,0,0,0,0,0,0,0,0,0,1,0,0,0,0,Massimo Gobbi,Â£270Th. ,39.0,183.0,Defender - Left-Back,left,Retired,32.0,1.0,2.0,2782.0,26.0,0.0,2.0,2158.0,17.0,0.0,1.0,1271.0,nan,nan,nan,nan,nan,nan,nan,nan,Serie A,15-07-16,17.3.2.23,Massimo Gobbi,6100012,776,31-Oct-80,35,1,0,0,0,3750,6500,6500,136,130,232186002,182,76,D/WB/M L,1,2,3,1,1,3,3,2,1,3,2,11,14,11,8,10,7,9,10,14,13,13,8,14,12,14,13,14,14,10,9,13,14,9,13,15,12,16,14,12,13,13,10,20,15,14,11,14,13,13,8,12,7,18,11,12,13,10,16,14,11,4,Massimo Gobbi,Â£270Th. ,Serie A
19-06-17,18.3.4.28,Adem Ljajic,62012544,802,29-Sep-91,25,20,2,11,1,5400,6800,7250,154,145,41959062,182,74,AM RLC,1,3,1,3,2,2,2,1,3,1,4,16,16,16,13,17,16,9,13,3,4,16,14,5,18,8,14,8,13,10,14,13,12,17,9,13,6,11,7,15,16,11,10,10,13,13,20,11,10,11,7,12,10,14,12,14,11,11,7,8,7,16,1,1,1,20,16,20,18,AM RLC,506,1,1,15,18,20,16,1,1,1,1,1,1,1,1,1,1.46385e+17,0,0,0,0,0,0,0,1,0,0,1,0,0,0,0,0,0,0,0,0,0,0,0,0,0,0,0,0,0,0,0,0,0,0,0,0,0,0,0,0,0,0,0,0,1,0,0,0,Adem Ljajic,Â£11.70m ,29.0,182.0,Midfielder - Attacking Midfield,right,Besiktas JK,36.0,12.0,9.0,2754.0,28.0,6.0,12.0,2254.0,33.0,9.0,14.0,2603.0,29.0,7.0,7.0,1995.0,5.0,0.0,0.0,185.0,Serie A,15-07-16,17.3.2.23,Adem Ljajic,62012544,802,29-Sep-91,24,20,2,11,1,5500,7200,7150,155,143,27802762,182,74,AM/S RLC,3,3,2,3,4,4,1,3,1,3,2,15,15,15,12,17,14,9,13,3,4,16,14,5,17,8,14,8,13,10,14,13,12,17,9,12,6,11,7,16,15,11,10,10,13,13,20,11,10,11,7,12,10,14,12,14,11,11,7,8,7,16,Adem Ljajic,Â£9.90m ,Serie A
19-06-17,18.3.4.28,Filip Djuricic,62015188,802,30-Jan-92,25,25,4,21,4,4500,6500,6400,136,128,3873770,181,72,M/AM LC,3,2,3,3,1,1,1,1,1,3,3,11,12,16,14,16,11,7,12,6,6,15,13,7,17,7,13,8,14,10,17,11,11,17,9,13,7,11,9,12,14,7,8,15,13,11,20,8,10,10,9,10,4,8,13,15,7,12,10,11,10,16,1,1,19,20,12,16,20,M/AM LC,524,1,1,9,20,16,12,1,1,1,1,19,1,1,1,1,549757000000.0,0,0,0,0,0,0,0,0,0,0,1,0,0,0,1,0,0,0,0,0,1,0,0,0,0,0,0,0,0,0,0,0,0,0,0,0,0,0,0,1,0,0,0,0,0,0,0,0,Filip Djuricic,Â£1.35m ,28.0,181.0,Midfielder - Attacking Midfield,right,US Sassuolo,21.0,0.0,1.0,660.0,17.0,0.0,1.0,999.0,26.0,2.0,2.0,1485.0,30.0,5.0,6.0,1674.0,5.0,3.0,1.0,441.0,Serie A,15-07-16,17.3.2.23,Filip Djuricic,62015188,802,30-Jan-92,24,25,4,21,4,6000,7000,6400,135,128,8861429,179,72,M/AM LC,2,1,4,1,3,3,3,3,1,1,3,11,12,15,14,16,11,7,12,6,6,15,13,7,17,7,13,8,14,10,17,11,11,17,9,13,7,11,9,12,14,7,8,15,13,11,20,8,10,10,9,10,4,8,13,15,7,12,10,11,10,16,Filip Djuricic,Â£2.25m ,Serie A
19-06-17,18.3.4.28,Petar Micin,62163215,802,29-Sep-98,18,0,0,0,0,2250,5000,5000,131,105,920734,184,65,M/AM RLC,1,3,3,2,2,2,2,1,2,2,3,11,11,12,11,10,10,10,11,9,9,11,12,9,12,11,11,11,11,11,11,10,11,12,8,10,10,13,11,12,11,11,10,9,17,13,20,11,11,12,8,2,10,10,12,12,9,11,11,12,12,5,1,1,20,19,20,18,18,M/AM RLC,416,1,1,1,18,18,19,1,1,1,1,12,17,20,1,1,0.0,0,0,0,0,0,0,0,0,0,0,0,0,0,0,0,0,0,0,0,0,0,0,0,0,0,0,0,0,0,0,0,0,0,0,0,0,0,0,0,0,0,0,0,0,0,0,0,0,nan,nan,nan,nan,nan,nan,nan,nan,nan,nan,nan,nan,nan,nan,nan,nan,nan,nan,nan,nan,nan,nan,nan,nan,nan,nan,nan,nan,
19-06-17,18.3.4.28,Mario Mandzukic,661804,761,21-May-86,31,76,29,9,1,7000,8800,8050,166,161,135270313,190,85,AM/S L,2,1,1,3,3,2,1,1,3,1,1,6,11,10,14,12,6,17,8,6,10,13,14,13,15,20,16,20,14,15,11,16,20,14,16,14,13,20,20,11,11,17,17,15,19,14,20,18,18,17,14,16,4,11,15,14,8,18,16,7,9,14,1,1,7,19,10,19,7,AM/S L,623,1,1,20,7,19,10,1,1,1,1,1,7,1,1,1,984064.0,0,0,0,0,0,0,0,0,0,0,1,0,0,0,0,0,1,1,1,1,0,0,0,0,0,0,0,0,0,0,0,0,0,0,0,0,0,0,0,0,0,0,0,0,0,0,0,0,Mario Mandzukic,Â£16.20m ,34.0,190.0,Forward - Centre-Forward,right,Without Club,50.0,11.0,6.0,3879.0,43.0,10.0,3.0,3208.0,33.0,10.0,5.0,2599.0,7.0,1.0,0.0,572.0,nan,nan,nan,nan,Serie A,15-07-16,17.3.2.23,Mario Mandzukic,661804,761,21-May-86,30,69,24,9,1,6969,9011,8050,163,161,232186002,190,85,S L,1,2,2,2,3,3,3,2,2,1,3,6,10,10,16,13,6,19,8,7,6,13,15,9,14,18,16,18,14,15,11,15,18,13,11,14,9,18,19,11,12,17,17,15,18,14,20,18,17,15,17,16,4,10,15,15,6,18,15,7,9,14,Mario Mandzukic,Â£18.00m ,Serie A
19-06-17,18.3.4.28,Ivan Strinic,662144,761,17-Jul-87,29,39,0,2,0,5100,6850,6850,144,137,15456522,186,78,D/WB/M L,3,3,1,3,1,2,2,3,1,3,1,8,13,12,5,13,6,11,15,14,13,13,8,13,12,15,12,14,13,14,13,13,17,12,10,12,13,15,17,14,14,14,13,20,10,14,8,14,14,14,13,14,7,11,12,14,14,11,16,7,12,4,20,19,16,1,1,20,1,D/WB/M L,123,1,1,1,1,1,1,1,20,1,1,1,16,1,19,1,40.0,0,0,0,1,0,1,0,0,0,0,0,0,0,0,0,0,0,0,0,0,0,0,0,0,0,0,0,0,0,0,0,0,0,0,0,0,0,0,0,0,0,0,0,0,0,0,0,0,Ivan Strinic,Â£3.60m ,33.0,186.0,Defender - Left-Back,left,Without Club,15.0,0.0,2.0,1266.0,18.0,0.0,2.0,1334.0,0.0,0.0,0.0,0.0,nan,nan,nan,nan,nan,nan,nan,nan,Serie A,15-07-16,17.3.2.23,Ivan Strinic,662144,761,17-Jul-87,28,38,0,2,0,5400,7000,6850,145,137,9212129,186,78,D/WB/M L,1,1,1,1,1,1,2,2,1,3,1,8,13,12,5,13,6,11,15,14,13,12,8,14,13,15,12,14,13,13,13,13,17,12,10,13,13,15,17,14,14,14,13,20,10,14,8,14,14,14,13,14,7,11,12,14,14,11,16,7,12,4,Ivan Strinic,Â£4.05m ,Serie A
19-06-17,18.3.4.28,JosÃ© CallejÃ³n,67011213,796,11-Feb-87,30,3,0,4,1,6250,7250,8050,161,161,232186002,178,73,AM/S RL,3,3,3,1,3,2,2,1,2,3,3,9,14,12,14,15,11,10,13,8,9,14,12,9,15,12,14,14,14,14,14,14,16,15,10,18,10,16,14,16,14,13,10,11,17,15,20,18,12,15,8,15,7,13,16,15,15,14,14,10,8,11,5,1,10,20,20,15,10,AM/S RL,515,1,1,16,10,15,20,1,1,5,1,1,7,10,1,1,2.8823e+17,0,0,0,0,1,0,0,0,0,0,0,0,0,1,0,0,0,0,0,0,0,0,0,0,0,0,0,0,0,0,0,0,0,0,0,0,0,0,0,0,0,0,0,0,0,0,0,0,JosÃ© CallejÃ³n,Â£21.60m ,33.0,178.0,Forward - Right Winger,right,ACF Fiorentina,49.0,17.0,15.0,4146.0,50.0,12.0,13.0,4163.0,47.0,4.0,15.0,3708.0,45.0,4.0,10.0,3001.0,2.0,0.0,0.0,78.0,Serie A,15-07-16,17.3.2.23,JosÃ© CallejÃ³n,67011213,796,11-Feb-87,29,2,0,4,1,6250,7200,7750,160,155,59761731,178,73,AM/S RL,3,2,1,3,3,3,2,1,2,2,3,9,13,12,14,15,11,10,13,8,9,14,12,10,15,12,14,14,14,14,14,14,16,15,10,17,9,17,15,15,15,13,10,11,14,14,20,16,12,15,8,15,7,13,16,15,15,14,14,10,8,11,JosÃ© CallejÃ³n,Â£22.50m ,Serie A
19-06-17,18.3.4.28,Suso,67085965,796,19-Nov-93,23,0,0,5,0,6100,7500,7600,161,152,51747304,176,70,AM RLC,3,3,2,2,2,1,1,1,2,1,3,14,15,17,14,16,14,7,14,7,6,15,10,9,17,12,14,11,14,13,15,14,13,15,10,16,9,13,13,15,16,12,8,20,13,14,10,13,8,12,8,13,4,13,17,15,12,13,14,12,11,10,1,1,14,20,20,15,16,AM RLC,506,1,1,10,16,15,20,1,1,1,1,12,9,14,1,1,2.88301e+17,0,0,0,0,0,0,0,0,0,0,0,0,0,0,0,0,0,0,0,0,0,0,0,0,0,0,0,0,0,0,0,0,0,0,1,0,0,0,0,0,0,0,0,0,0,0,1,0,Suso,Â£31.50m ,26.0,177.0,Forward - Right Winger,left,Sevilla FC,37.0,7.0,11.0,3120.0,50.0,8.0,12.0,3893.0,41.0,8.0,10.0,3446.0,40.0,3.0,3.0,2665.0,7.0,0.0,0.0,355.0,Serie A,15-07-16,17.3.2.23,Suso,67085965,796,19-Nov-93,22,0,0,5,0,5500,6850,7500,158,150,88725619,176,70,AM RLC,1,3,1,2,1,4,3,2,1,3,2,14,13,16,11,16,13,7,14,13,12,15,10,9,16,12,14,8,14,13,14,13,14,15,8,16,9,13,12,15,16,12,8,20,13,15,10,14,8,11,8,11,4,15,17,15,12,13,9,7,11,10,Suso,Â£13.50m ,Serie A
19-06-17,18.3.4.28,Rafinha,67100016,1651,12-Feb-93,24,2,1,5,0,6800,7200,7550,167,152,68841973,174,71,M/AM RLC,1,3,2,3,2,2,1,3,2,2,2,14,15,16,11,15,13,10,12,8,8,15,13,10,15,15,12,14,12,13,14,13,14,13,11,13,10,14,16,15,13,14,8,20,14,13,8,15,12,13,11,14,13,14,13,13,12,12,13,12,13,7,1,1,19,20,19,16,20,M/AM RLC,526,1,1,15,20,16,19,1,1,1,10,19,13,11,1,1,2148532224.0,0,0,0,0,0,0,0,0,0,0,0,0,0,0,0,0,0,0,0,0,1,0,0,0,0,0,0,0,0,0,0,1,0,0,0,0,0,0,0,0,0,0,0,0,0,0,0,0,Rafinha,Â£25.20m ,27.0,174.0,Midfielder - Attacking Midfield,left,Paris Saint-Germain,28.0,7.0,5.0,1567.0,18.0,2.0,3.0,1062.0,8.0,1.0,0.0,348.0,33.0,4.0,2.0,2344.0,3.0,0.0,1.0,154.0,Serie A,15-07-16,17.3.2.23,Rafinha,67100016,1651,12-Feb-93,23,2,1,5,0,6800,7200,7550,167,153,42867644,174,71,M/AM RLC,1,1,1,2,2,2,1,2,1,3,2,14,15,16,11,15,13,11,12,8,8,15,13,12,15,16,12,14,12,13,14,13,14,13,11,13,12,14,17,15,13,14,8,20,14,13,8,16,12,13,11,14,6,14,13,13,12,12,13,12,13,7,Rafinha,Â£13.50m ,LaLiga
19-06-17,18.3.4.28,Ãlex Berenguer,67157520,796,04-Jul-95,21,0,0,0,0,4300,6600,6550,145,131,19895220,175,69,M/AM RL,1,1,1,2,1,1,1,3,4,3,3,8,12,13,9,13,9,7,10,10,8,11,7,10,14,9,11,11,10,11,12,11,11,13,8,13,7,11,11,15,14,13,8,12,12,14,20,14,11,12,11,12,7,15,19,12,12,9,10,12,10,8,14,14,18,20,20,19,12,M/AM RL,525,1,1,10,12,19,20,1,12,14,1,10,15,18,12,14,32.0,0,0,0,0,0,1,0,0,0,0,0,0,0,0,0,0,0,0,0,0,0,0,0,0,0,0,0,0,0,0,0,0,0,0,0,0,0,0,0,0,0,0,0,0,0,0,0,0,Ãlex Berenguer,Â£4.50m ,25.0,175.0,Forward - Left Winger,right,Athletic Bilbao,31.0,2.0,8.0,2251.0,25.0,2.0,4.0,1238.0,34.0,2.0,4.0,1662.0,36.0,6.0,4.0,2363.0,5.0,1.0,0.0,312.0,Serie A,15-07-16,17.3.2.23,Ãlex Berenguer,67157520,796,04-Jul-95,21,0,0,0,0,3950,6350,6350,145,127,3758213,175,69,M/AM RL,3,2,2,1,1,1,3,4,1,2,1,8,12,13,9,13,7,7,10,8,8,11,7,10,14,9,11,11,10,11,12,11,11,13,9,13,7,10,10,15,14,13,8,12,12,14,20,13,11,12,11,11,11,11,19,11,8,11,9,9,14,7,Ãlex Berenguer,Â£5.40m ,LaLiga
19-06-17,18.3.4.28,Seung-Woo Lee,67207191,135,06-Jan-98,19,0,0,0,0,2500,5000,5050,123,101,954834,173,67,AM/S LC,3,2,4,4,3,2,2,4,2,1,1,10,12,10,9,14,6,10,10,9,6,11,7,10,10,9,11,4,8,8,10,11,6,10,8,8,10,10,11,14,11,10,8,9,13,13,20,11,8,10,10,9,10,10,13,13,11,11,13,9,14,6,1,1,9,20,11,20,18,AM/S LC,514,1,1,16,18,20,11,1,1,1,1,1,9,1,1,1,0.0,0,0,0,0,0,0,0,0,0,0,0,0,0,0,0,0,0,0,0,0,0,0,0,0,0,0,0,0,0,0,0,0,0,0,0,0,0,0,0,0,0,0,0,0,0,0,0,0,Seung-woo Lee,Â£900Th. ,22.0,173.0,Forward - Left Winger,right,Sint-Truidense VV,7.0,1.0,2.0,417.0,16.0,1.0,0.0,490.0,27.0,1.0,3.0,1769.0,6.0,0.0,0.0,357.0,9.0,2.0,0.0,562.0,Serie A
19-06-17,18.3.4.28,Senad Lulic,69002026,759,18-Jan-86,31,54,3,0,0,5500,7500,7250,152,145,232186002,183,78,D/WB/M/AM LC,3,2,1,2,3,1,1,1,2,3,2,12,15,13,13,12,5,11,12,3,12,12,12,13,13,15,16,13,12,12,8,12,16,12,17,17,12,17,16,13,11,13,10,12,16,14,20,15,13,15,11,16,8,17,16,14,18,14,18,13,12,6,16,19,20,18,9,20,19,D/WB/M/AM LC,444,1,1,1,1,18,9,1,16,6,8,19,20,9,19,6,134218800.0,0,0,0,0,1,1,0,0,0,0,1,0,0,0,0,0,0,0,0,0,0,0,0,0,0,0,0,1,0,0,0,0,0,0,0,0,0,0,0,0,0,0,0,0,0,0,0,0,Senad Lulic,Â£5.85m ,34.0,183.0,Midfielder - Left Midfield,right,SS Lazio,35.0,3.0,9.0,2838.0,50.0,5.0,7.0,3294.0,46.0,4.0,1.0,3657.0,27.0,1.0,2.0,1909.0,nan,nan,nan,nan,Serie A,15-07-16,17.3.2.23,Senad Lulic,69002026,759,18-Jan-86,30,49,2,0,0,5500,7750,7250,152,145,232186002,183,75,D/WB/M/AM LC,2,3,3,2,2,1,1,1,1,1,3,12,14,13,13,12,6,10,13,12,12,12,9,13,12,14,16,11,12,12,12,10,16,11,13,15,11,16,14,13,12,13,10,15,16,13,20,15,13,14,14,16,8,17,15,14,15,14,16,13,14,6,Senad Lulic,Â£6.30m ,Serie A
19-06-17,18.3.4.28,Daniel Pavlovic,69002800,759,22-Apr-88,29,2,0,16,1,3750,6200,6200,131,124,6313693,183,76,D/WB/M L,2,3,3,1,2,2,3,1,1,2,2,13,15,12,8,13,14,12,10,14,12,13,8,13,14,7,12,11,10,12,10,12,10,10,11,13,13,12,12,11,12,14,11,20,13,12,10,14,12,10,7,10,5,10,14,12,11,12,13,13,7,6,20,19,19,1,8,20,1,D/WB/M L,123,1,1,1,1,1,1,1,20,8,12,1,19,5,19,5,0.0,0,0,0,0,0,0,0,0,0,0,0,0,0,0,0,0,0,0,0,0,0,0,0,0,0,0,0,0,0,0,0,0,0,0,0,0,0,0,0,0,0,0,0,0,0,0,0,0,Daniel Pavlovic,Â£360Th. ,32.0,183.0,Defender - Left-Back,left,Without Club,10.0,0.0,0.0,731.0,11.0,0.0,0.0,846.0,0.0,0.0,0.0,0.0,4.0,0.0,0.0,143.0,nan,nan,nan,nan,Serie A,15-07-16,17.3.2.23,Daniel Pavlovic,69002800,759,22-Apr-88,28,0,0,16,1,3250,5900,6200,129,126,3307931,184,76,D/WB/M L,1,3,3,1,1,3,3,3,2,1,2,13,14,12,8,12,13,12,10,14,13,13,8,14,12,7,12,11,10,12,10,12,10,10,11,12,12,12,12,12,13,14,11,20,13,13,10,14,12,10,7,10,5,10,14,12,11,12,13,13,7,6,Daniel Pavlovic,Â£720Th. ,Serie A
19-06-17,18.3.4.28,Ali Adnan,70087636,115,19-Dec-93,23,38,1,10,3,3979,6964,6200,138,124,7102905,185,78,D/WB/M L,2,1,2,3,3,3,3,1,3,2,3,13,13,13,11,12,12,11,15,12,8,11,10,12,13,14,10,11,13,8,8,10,14,13,13,9,7,10,14,15,13,15,12,20,15,15,8,14,12,13,10,10,3,12,14,12,13,13,10,12,12,4,20,19,19,5,12,20,8,D/WB/M L,123,1,1,1,1,5,1,8,20,12,1,1,19,1,19,1,68719477537.0,1,0,0,0,0,1,0,0,1,1,0,0,0,0,0,0,0,0,0,0,0,0,0,0,0,0,0,0,0,0,0,0,0,0,0,0,1,0,0,0,0,0,0,0,0,0,0,0,Ali Adnan,Â£1.62m ,26.0,185.0,Defender - Left-Back,left,Vancouver Whitecaps FC,14.0,0.0,0.0,866.0,24.0,0.0,1.0,1653.0,35.0,1.0,4.0,2827.0,20.0,2.0,3.0,1665.0,nan,nan,nan,nan,Serie A,15-07-16,17.3.2.23,Ali Adnan,70087636,115,19-Dec-93,22,40,3,10,5,5231,6975,6300,148,125,6678101,185,78,D/WB/M L,3,1,2,4,3,1,4,1,3,2,1,13,14,14,11,12,15,11,15,12,6,11,10,12,13,14,11,14,13,8,8,10,14,13,13,8,8,10,15,15,13,15,12,20,15,15,8,14,13,10,10,10,3,11,16,13,12,13,10,13,10,7,Ali Adnan,Â£1.62m ,Serie A
19-06-17,18.3.4.28,Cengiz Ãnder,70096289,799,14-Jul-97,19,4,2,3,0,2150,6750,6350,153,127,17082204,173,66,AM RLC,4,3,1,1,3,1,4,1,3,3,2,13,13,13,13,13,10,10,14,6,5,12,9,6,14,7,13,8,14,12,13,12,11,14,5,14,7,14,13,14,14,12,7,20,10,14,12,12,7,13,10,14,7,11,5,13,13,12,14,10,10,5,1,1,13,20,20,18,17,AM RLC,506,1,1,1,17,18,20,1,1,1,1,1,12,13,1,1,2.8823e+17,0,0,0,0,0,0,0,0,0,0,0,0,0,0,0,0,0,0,0,0,0,0,0,0,0,0,0,0,0,0,0,0,0,0,0,1,0,0,0,0,0,0,0,0,0,0,0,0,Cengiz Ãnder,Â£24.30m ,23.0,173.0,Forward - Right Winger,left,Leicester City,43.0,9.0,7.0,3292.0,32.0,8.0,2.0,1552.0,33.0,6.0,10.0,1892.0,23.0,3.0,0.0,1152.0,3.0,0.0,1.0,75.0,Serie A
19-06-17,18.3.4.28,Andrea Cossu,706323,776,03-May-80,37,2,0,0,0,1750,5000,5450,124,109,65690,171,63,AM LC,4,3,2,3,3,2,3,2,3,3,1,13,12,15,8,14,12,6,12,6,6,14,12,6,15,10,11,12,10,13,18,13,18,16,17,14,9,12,13,9,11,7,5,13,8,8,20,9,7,12,12,13,10,10,6,9,20,10,18,12,10,12,1,1,14,20,12,17,20,AM LC,504,1,1,1,20,17,12,1,1,1,1,14,1,1,1,1,17592200000000.0,0,0,0,0,1,0,0,0,0,0,0,0,0,0,0,0,0,0,0,0,0,0,0,0,0,0,0,0,0,0,0,0,0,0,0,0,0,0,0,0,0,0,0,0,1,0,0,0,Andrea Cossu,Â£90Th. ,40.0,170.0,Midfielder - Attacking Midfield,right,Retired,27.0,2.0,11.0,2109.0,13.0,0.0,1.0,362.0,nan,nan,nan,nan,nan,nan,nan,nan,nan,nan,nan,nan,Serie A
19-06-17,18.3.4.28,Nani,736009,788,17-Nov-86,30,86,15,10,1,6750,7350,7250,165,145,232186002,177,68,M/AM/S RLC,3,3,1,2,2,2,2,3,2,1,2,13,13,19,13,17,14,6,14,3,3,15,13,3,17,10,9,10,12,9,14,12,14,20,4,12,3,9,9,13,13,11,8,16,15,13,20,12,12,10,11,13,14,14,17,14,13,16,16,7,7,12,1,1,18,20,18,20,18,M/AM/S RLC,536,1,1,18,18,20,18,1,1,1,1,11,15,18,1,1,88545000000000.0,0,0,0,0,0,0,0,0,1,0,0,0,0,0,0,0,0,0,0,0,0,0,0,0,0,0,0,0,0,0,0,0,0,0,0,1,0,0,0,1,0,0,0,0,1,0,1,0,Nani,Â£4.50m ,33.0,177.0,Forward - Left Winger,both,Orlando City SC,26.0,5.0,8.0,1930.0,25.0,3.0,3.0,660.0,61.0,21.0,13.0,4736.0,20.0,7.0,5.0,1585.0,nan,nan,nan,nan,Serie A,15-07-16,17.3.2.23,Nani,736009,788,17-Nov-86,29,86,15,10,1,7500,7550,7550,165,150,39454830,175,66,M/AM RL,4,4,1,2,2,1,4,3,3,2,2,13,13,19,13,15,14,6,15,6,4,15,13,5,18,11,7,6,10,5,13,8,10,19,4,12,5,9,13,15,17,10,8,17,15,15,20,14,13,8,11,13,9,10,15,16,13,16,14,5,8,12,Nani,Â£9.00m ,LaLiga
19-06-17,18.3.4.28,Valter Birsa,7581802,795,07-Aug-86,30,85,6,10,3,5000,7400,7000,141,140,232186002,184,81,AM RLC,3,1,1,2,1,3,1,3,3,1,2,15,13,14,12,15,14,9,14,5,6,14,15,7,15,9,13,12,14,12,14,12,13,14,11,13,9,13,13,12,13,14,11,20,15,13,14,15,13,14,6,12,6,12,16,13,14,11,16,17,13,6,1,1,12,20,15,19,20,AM RLC,506,1,1,12,20,19,15,1,1,1,1,12,8,8,1,1,1073743104.0,0,0,0,0,0,0,0,0,1,0,1,0,0,0,0,0,0,0,0,0,0,0,0,0,0,0,0,0,0,0,1,0,0,0,0,0,0,0,0,0,0,0,0,0,0,0,0,0,Valter Birsa,Â£3.60m ,34.0,184.0,Midfielder - Attacking Midfield,left,Cagliari Calcio,37.0,7.0,9.0,2881.0,36.0,3.0,7.0,2639.0,31.0,2.0,2.0,1534.0,15.0,0.0,0.0,475.0,nan,nan,nan,nan,Serie A,15-07-16,17.3.2.23,Valter Birsa,7581802,795,07-Aug-86,29,81,6,10,3,5000,7250,6950,139,139,12910908,184,81,AM RLC,2,2,1,1,2,2,2,3,1,3,1,15,13,14,12,15,14,9,14,5,6,14,15,7,15,7,13,12,14,12,12,12,13,14,8,13,9,13,13,12,13,14,11,20,15,13,14,15,13,14,7,12,6,8,16,13,14,11,15,17,13,6,Valter Birsa,Â£4.05m ,Serie A
19-06-17,18.3.4.28,GastÃ³n RamÃ­rez,78027222,1657,02-Dec-90,26,41,0,6,1,5500,6800,6750,145,135,16745098,183,78,AM RLC,3,1,3,2,2,2,3,4,2,3,3,13,13,15,12,15,15,9,13,7,9,15,13,7,16,16,14,11,13,10,15,12,11,15,10,14,11,9,9,14,13,14,10,20,12,13,10,13,14,9,13,12,11,14,12,14,5,10,5,9,6,15,1,1,14,20,18,18,20,AM RLC,506,1,1,10,20,18,18,1,1,1,1,14,13,10,1,1,655364.0,0,0,1,0,0,0,0,0,0,0,0,0,0,0,0,0,0,1,0,1,0,0,0,0,0,0,0,0,0,0,0,0,0,0,0,0,0,0,0,0,0,0,0,0,0,0,0,0,GastÃÂ³n RamÃÂ­rez,Â£9.00m ,29.0,183.0,Midfielder - Attacking Midfield,left,UC Sampdoria,26.0,2.0,3.0,1591.0,40.0,5.0,10.0,2330.0,29.0,4.0,5.0,1753.0,27.0,7.0,2.0,1468.0,5.0,0.0,0.0,263.0,Serie A,15-07-16,17.3.2.23,GastÃ³n RamÃ­rez,78027222,1657,02-Dec-90,25,38,0,6,1,5489,7037,7050,145,127,31853509,183,77,AM RLC,1,3,2,2,2,3,3,3,2,3,1,15,14,15,10,14,15,10,13,7,9,15,13,9,15,16,11,10,12,10,15,12,11,15,12,14,8,9,9,12,14,12,10,20,11,13,9,13,14,10,13,9,14,13,10,10,15,9,14,10,9,10,GastÃÂ³n RamÃÂ­rez,Â£5.40m ,Premier League
19-06-17,18.3.4.28,Maximiliano Olivera,78041259,1657,05-Mar-92,25,0,0,12,0,3750,5950,6300,138,126,6211156,181,72,D/WB/M L,2,2,2,3,2,3,2,1,1,1,3,10,13,12,10,13,12,14,10,13,14,12,8,13,13,14,12,13,13,14,12,12,13,12,14,12,13,14,13,12,12,13,11,20,11,13,7,13,12,13,13,13,7,12,11,12,12,11,11,12,12,7,20,18,17,1,1,20,13,D/WB/M L,123,1,1,1,1,1,1,13,20,1,1,1,17,1,18,1,0.0,0,0,0,0,0,0,0,0,0,0,0,0,0,0,0,0,0,0,0,0,0,0,0,0,0,0,0,0,0,0,0,0,0,0,0,0,0,0,0,0,0,0,0,0,0,0,0,0,Maximiliano Olivera,Â£900Th. ,28.0,182.0,Defender - Left-Back,left,FC JuÃ¡rez,27.0,0.0,1.0,1899.0,7.0,0.0,0.0,409.0,5.0,0.0,1.0,390.0,9.0,1.0,2.0,611.0,14.0,1.0,1.0,1232.0,Serie A,15-07-16,17.3.2.23,Maximiliano Olivera,78041259,1657,05-Mar-92,24,0,0,12,0,2250,5950,6050,134,122,920125,181,72,D LC,3,1,3,4,3,1,1,2,3,1,1,10,12,13,10,13,12,14,10,13,14,12,5,13,13,14,12,13,13,14,11,12,13,12,14,12,13,14,13,9,10,13,11,20,11,12,7,13,12,13,13,13,7,12,9,12,12,11,11,12,12,7,Maximiliano Olivera,Â£1.35m ,Serie A
19-06-17,18.3.4.28,Diego Laxalt,78048399,1657,07-Feb-93,24,3,0,13,1,4250,6650,6650,145,133,16550984,178,66,WB/M/AM LC,3,2,1,3,2,1,3,1,2,3,3,9,11,13,12,12,5,5,7,11,14,13,10,11,13,12,13,10,10,10,11,11,14,12,7,12,10,14,13,16,16,7,7,20,15,15,8,16,6,9,8,10,4,14,14,15,13,14,13,15,14,7,10,17,20,19,9,20,17,WB/M/AM LC,434,1,1,1,7,19,9,1,10,1,1,17,20,7,17,1,0.0,0,0,0,0,0,0,0,0,0,0,0,0,0,0,0,0,0,0,0,0,0,0,0,0,0,0,0,0,0,0,0,0,0,0,0,0,0,0,0,0,0,0,0,0,0,0,0,0,Diego Laxalt,Â£11.70m ,27.0,178.0,Defender - Left-Back,left,Celtic FC,39.0,1.0,4.0,3440.0,34.0,4.0,3.0,3020.0,29.0,0.0,1.0,1276.0,24.0,0.0,1.0,903.0,3.0,0.0,0.0,251.0,Serie A,15-07-16,17.3.2.23,Diego Laxalt,78048399,1657,07-Feb-93,23,2,0,13,1,3500,6450,6450,144,133,11119291,178,66,M/AM LC,1,3,3,3,2,1,3,3,3,4,1,10,13,14,13,13,5,5,10,11,14,13,10,11,14,12,13,11,10,10,11,10,12,12,7,11,10,12,14,16,16,10,7,20,15,14,8,17,6,9,8,10,4,14,12,13,11,12,11,13,12,7,Diego Laxalt,Â£6.75m ,Serie A
19-06-17,18.3.4.28,Alessio Cerci,7984079,776,23-Jul-87,29,14,0,6,1,5750,6400,6600,150,132,11944617,180,78,AM/S RL,1,1,2,3,1,3,3,2,1,4,1,14,15,14,13,15,13,8,14,5,5,14,13,6,16,12,13,8,11,10,12,11,14,17,8,14,6,10,11,14,14,13,9,20,14,14,8,13,11,13,9,13,12,11,8,16,9,7,4,10,11,18,1,1,10,19,19,17,12,AM/S RL,625,1,1,20,12,17,19,1,1,1,1,1,8,10,1,1,2.88301e+17,0,0,0,0,0,0,0,0,0,0,0,0,0,0,0,0,0,0,0,0,0,0,0,0,0,0,0,1,0,0,0,0,0,0,1,1,0,0,0,0,0,0,0,0,0,0,1,0,Alessio Cerci,Â£1.80m ,33.0,180.0,Forward - Right Winger,left,SS Arezzo,2.0,0.0,0.0,43.0,25.0,3.0,4.0,1712.0,16.0,5.0,3.0,718.0,10.0,0.0,1.0,330.0,2.0,0.0,0.0,105.0,Serie A,15-07-16,17.3.2.23,Alessio Cerci,7984079,776,23-Jul-87,28,14,0,6,1,5750,6750,6750,154,135,5258111,180,78,AM/S RL,3,1,2,2,2,3,1,3,1,1,1,14,14,14,13,15,13,8,14,5,5,14,13,6,16,12,13,8,11,10,12,11,14,17,8,14,6,10,11,14,16,13,9,20,14,15,8,13,11,13,9,13,12,11,8,16,9,7,4,10,11,18,Alessio Cerci,Â£3.60m ,LaLiga
19-06-17,18.3.4.28,Emanuele Giaccherini,7990445,776,05-May-85,32,29,4,0,0,5500,6600,6850,154,137,9104429,167,60,M/AM RLC,1,2,2,2,2,3,1,3,1,3,3,11,15,13,12,13,8,7,12,6,5,15,11,8,15,15,14,12,14,14,14,14,17,16,4,17,9,14,15,14,14,8,4,14,10,14,20,10,7,16,11,15,15,15,8,16,13,12,14,13,11,9,1,9,20,20,20,19,19,M/AM RLC,416,1,1,5,15,19,20,1,1,1,1,19,15,20,8,9,4707280000000.0,0,0,0,0,1,0,0,0,0,0,0,0,0,0,0,0,0,0,0,0,0,0,0,0,0,0,0,0,0,0,0,0,0,0,0,1,0,0,1,0,0,0,1,0,0,0,0,0,Emanuele Giaccherini,Â£900Th. ,35.0,167.0,Midfielder - Left Midfield,right,Chievo Verona,19.0,2.0,0.0,386.0,18.0,3.0,1.0,1027.0,28.0,3.0,2.0,2186.0,24.0,5.0,4.0,1541.0,nan,nan,nan,nan,Serie A,15-07-16,17.3.2.23,Emanuele Giaccherini,7990445,776,05-May-85,31,29,4,0,0,5750,6650,7050,154,141,232186002,167,60,M/AM RLC,3,2,3,2,1,3,3,3,1,1,1,11,15,15,12,13,8,7,12,6,5,15,11,8,15,15,15,12,14,13,14,14,15,16,4,17,9,14,15,15,14,8,4,14,10,14,20,10,7,16,11,15,15,15,8,16,16,12,14,13,11,9,Emanuele Giaccherini,Â£1.35m ,Serie A
19-06-17,18.3.4.28,Dries Mertens,8169425,757,06-May-87,30,58,12,0,0,6250,8750,8300,167,166,232186002,169,61,AM/S RL,1,1,1,2,2,2,1,2,3,2,3,14,14,16,17,17,14,7,14,7,5,16,14,6,16,12,16,15,14,13,14,14,15,16,12,18,6,13,13,16,17,12,6,13,13,15,20,14,9,14,10,14,6,13,17,14,14,15,14,6,12,10,1,1,1,19,15,19,13,AM/S RL,625,1,1,20,13,19,15,1,1,1,1,1,1,1,1,1,134217744.0,0,0,0,0,1,0,0,0,0,0,0,0,0,0,0,0,0,0,0,0,0,0,0,0,0,0,0,1,0,0,0,0,0,0,0,0,0,0,0,0,0,0,0,0,0,0,0,0,Dries Mertens,Â£27.00m ,33.0,169.0,Forward - Centre-Forward,right,SSC Napoli,46.0,34.0,12.0,3215.0,49.0,22.0,12.0,3807.0,47.0,19.0,12.0,3016.0,42.0,16.0,11.0,2487.0,5.0,2.0,3.0,378.0,Serie A,15-07-16,17.3.2.23,Dries Mertens,8169425,757,06-May-87,29,51,8,0,0,5850,7250,7750,161,157,64288985,169,61,AM/S RL,2,2,2,1,3,2,2,2,4,1,3,14,15,16,14,18,12,7,14,7,6,15,13,7,16,12,13,14,14,13,14,13,15,16,12,17,6,11,13,15,16,12,6,12,13,15,20,12,10,13,10,14,6,13,17,14,13,15,13,6,12,10,Dries Mertens,Â£25.20m ,Serie A
19-06-17,18.3.4.28,Eros Schiavon,829773,776,24-Apr-83,34,0,0,0,0,1950,5850,5850,125,117,210777,178,76,M RLC,3,2,4,3,4,2,2,2,3,3,2,11,10,9,14,12,6,10,15,6,12,13,6,13,11,14,14,15,11,13,11,12,14,9,12,12,13,14,14,12,13,14,10,8,14,12,20,13,12,14,11,11,10,14,10,11,12,13,14,14,12,5,1,1,20,6,17,15,20,M RLC,406,1,1,1,1,3,6,1,1,1,13,20,15,17,1,1,0.0,0,0,0,0,0,0,0,0,0,0,0,0,0,0,0,0,0,0,0,0,0,0,0,0,0,0,0,0,0,0,0,0,0,0,0,0,0,0,0,0,0,0,0,0,0,0,0,0,Eros Schiavon,Â£90Th. ,37.0,178.0,Midfielder - Central Midfield,right,ACN Siena 1904,19.0,1.0,2.0,948.0,13.0,0.0,0.0,460.0,21.0,0.0,0.0,930.0,21.0,0.0,1.0,1793.0,3.0,0.0,0.0,209.0,Serie A
19-06-17,18.3.4.28,Cristian Molinaro,830873,776,30-Jul-83,33,2,0,0,0,4500,6200,6200,136,124,749457,182,80,D/WB/M L,1,1,1,1,1,1,1,1,1,1,1,12,12,10,6,9,6,10,10,16,12,11,7,14,8,17,13,15,8,13,11,9,15,6,12,12,14,15,15,14,11,14,12,20,13,14,8,16,15,13,14,13,10,12,14,13,14,12,13,8,12,7,20,18,17,1,1,20,9,D/WB/M L,123,1,1,1,1,1,1,9,20,1,1,1,17,1,18,1,137573000000.0,0,0,0,0,0,0,0,0,0,0,0,0,0,0,0,0,0,0,0,0,0,0,0,0,0,0,0,1,0,0,0,0,0,0,0,0,0,1,0,0,0,0,0,0,0,0,0,0,Cristian Molinaro,Â£270Th. ,37.0,182.0,Defender - Left-Back,left,Venezia FC,11.0,0.0,2.0,841.0,24.0,0.0,1.0,1922.0,15.0,0.0,0.0,1250.0,12.0,0.0,0.0,861.0,4.0,0.0,1.0,260.0,Serie A,15-07-16,17.3.2.23,Cristian Molinaro,830873,776,30-Jul-83,32,2,0,0,0,5500,6400,6300,136,125,122960,182,82,D/WB L,1,1,1,1,1,1,1,1,1,1,1,12,12,10,6,9,6,10,10,16,13,11,7,14,8,17,14,15,8,14,11,9,15,6,11,13,14,16,16,14,11,14,12,20,13,14,8,17,15,13,14,13,10,12,14,13,14,12,13,8,12,7,Cristian Molinaro,Â£270Th. ,Serie A
19-06-17,18.3.4.28,Simone Padoin,836918,776,18-Mar-84,33,0,0,6,0,5250,6550,6550,145,131,232186002,177,74,M RLC,3,3,1,3,2,2,1,3,2,1,1,8,11,9,8,11,8,9,11,14,12,14,8,13,12,15,13,15,10,14,11,14,17,6,7,11,15,18,18,12,12,12,9,10,14,13,20,17,11,15,10,13,6,20,6,12,17,14,18,16,18,5,14,15,20,8,20,16,19,M RLC,406,1,1,1,5,8,8,1,13,14,11,19,16,20,14,15,140737000000000.0,0,0,0,0,0,0,0,0,0,0,0,0,0,0,0,1,0,0,0,0,0,0,0,0,0,0,0,0,0,0,0,0,0,0,0,0,0,0,0,0,0,0,0,0,0,0,0,1,Simone Padoin,Â£450Th. ,36.0,177.0,Midfielder - Left Midfield,right,Retired,32.0,1.0,2.0,2262.0,37.0,1.0,0.0,3117.0,32.0,0.0,1.0,2016.0,31.0,0.0,3.0,2436.0,1.0,0.0,0.0,9.0,Serie A,15-07-16,17.3.2.23,Simone Padoin,836918,776,18-Mar-84,32,0,0,7,0,5250,6750,6700,145,133,232186002,177,74,M RLC,1,1,1,3,3,3,2,2,3,2,1,8,11,10,8,11,8,10,11,15,12,14,8,13,12,15,13,15,10,13,10,15,17,6,7,11,15,18,18,14,13,13,9,12,15,13,20,18,12,16,10,13,6,19,6,11,17,14,18,15,18,5,Simone Padoin,Â£720Th. ,Serie A
19-06-17,18.3.4.28,Boukary DramÃ©,8430574,41,22-Jul-85,31,13,0,0,0,4250,6200,5850,133,117,655791,181,78,D/WB/M L,3,4,1,3,1,1,2,3,3,3,3,5,11,10,6,7,6,10,10,13,11,11,6,14,7,15,13,14,10,8,6,11,11,8,8,11,12,13,15,15,14,16,11,20,14,15,5,15,14,11,14,14,16,12,9,13,12,11,11,11,16,11,20,19,18,1,1,20,14,D/WB/M L,123,1,1,1,1,1,1,14,20,1,1,1,18,1,19,1,154652000000.0,0,0,0,0,0,1,0,0,0,0,0,0,0,0,0,1,0,0,0,0,0,0,0,0,0,1,0,0,0,0,0,0,0,0,1,0,0,1,0,0,0,0,0,0,0,0,0,0,Boukary DramÃ©,Â£360Th. ,35.0,180.0,Defender - Left-Back,left,Paganese Calcio 1926,12.0,0.0,0.0,808.0,5.0,0.0,0.0,90.0,nan,nan,nan,nan,6.0,0.0,0.0,297.0,nan,nan,nan,nan,Serie A,15-07-16,17.3.2.23,Boukary DramÃ©,8430574,41,22-Jul-85,30,13,0,0,0,4250,6200,6350,128,128,2057621,181,78,D/WB LC,1,2,2,2,2,1,4,2,2,2,3,5,11,12,6,7,6,11,10,13,11,11,6,16,7,15,14,17,10,8,6,13,11,8,8,11,13,13,15,15,14,16,12,20,14,17,5,16,15,11,14,14,10,12,17,13,12,11,11,11,16,11,Boukary DramÃ©,Â£1.53m ,Serie A
19-06-17,18.3.4.28,Francesco Migliore,8440216,776,17-Apr-88,29,0,0,0,0,3750,5900,6100,124,122,4674323,173,70,D/WB/M L,4,3,1,2,3,3,4,2,3,3,3,9,15,13,6,7,5,5,8,10,12,14,5,13,12,15,13,14,12,12,12,12,15,8,13,12,12,14,14,15,13,10,6,20,15,14,6,15,10,14,12,12,5,12,14,12,13,13,13,13,13,8,20,19,16,1,1,20,1,D/WB/M L,123,1,1,1,1,1,1,1,20,1,1,1,16,1,19,1,0.0,0,0,0,0,0,0,0,0,0,0,0,0,0,0,0,0,0,0,0,0,0,0,0,0,0,0,0,0,0,0,0,0,0,0,0,0,0,0,0,0,0,0,0,0,0,0,0,0,Francesco Migliore,Â£720Th. ,32.0,173.0,Defender - Left-Back,left,Without Club,40.0,1.0,6.0,3610.0,8.0,1.0,0.0,508.0,25.0,2.0,3.0,2100.0,24.0,2.0,3.0,2129.0,nan,nan,nan,nan,Serie A
19-06-17,18.3.4.28,Cyril ThÃ©rÃ©au,8442996,769,24-Apr-83,34,0,0,0,0,4750,6700,6850,143,137,232186002,189,78,AM/S LC,1,2,2,3,3,2,2,1,3,2,2,14,13,13,14,13,13,12,11,9,9,13,14,8,13,12,13,14,12,13,13,13,11,12,12,14,9,14,16,13,12,14,14,9,5,14,20,14,15,12,2,13,13,13,12,14,8,9,16,17,15,7,1,1,1,18,1,18,18,AM/S LC,624,1,1,20,18,18,1,1,1,1,1,1,1,1,1,1,17592300000000.0,0,0,0,0,0,0,0,0,0,0,0,0,0,0,0,0,0,0,0,1,0,0,0,0,0,0,0,1,0,0,0,0,0,0,0,0,0,0,0,0,0,0,0,0,1,0,0,0,Cyril ThÃ©rÃ©au,Â£900Th. ,37.0,189.0,Forward - Second Striker,right,Without Club,33.0,12.0,2.0,2500.0,23.0,8.0,4.0,1372.0,7.0,0.0,0.0,153.0,nan,nan,nan,nan,nan,nan,nan,nan,Serie A,15-07-16,17.3.2.23,Cyril ThÃ©rÃ©au,8442996,769,24-Apr-83,33,0,0,0,0,5150,6500,6850,143,138,232186002,189,78,AM/S C,3,3,3,3,3,3,3,2,2,1,4,14,13,13,14,12,12,12,11,9,9,13,13,8,13,12,13,14,12,13,12,13,11,12,12,14,9,14,16,13,12,14,14,9,5,14,20,15,15,12,2,13,13,12,12,14,8,9,16,17,15,7,Cyril ThÃ©rÃ©au,Â£1.35m ,Serie A
19-06-17,18.3.4.28,Valentin Eysseric,85010867,769,25-Mar-92,25,0,0,4,0,4750,6400,6500,136,130,9601854,181,73,AM RLC,1,1,1,2,3,2,1,1,3,2,1,13,12,14,8,14,13,8,13,7,4,14,12,3,14,8,13,9,13,12,13,13,13,14,6,13,6,11,11,15,14,12,11,12,12,14,20,13,11,14,8,10,9,8,14,14,13,12,12,13,12,9,1,1,10,20,16,20,18,AM RLC,506,1,1,1,18,20,16,1,1,1,1,10,10,10,1,1,2251800000000000.0,0,0,0,0,0,0,0,0,0,0,0,0,0,0,0,0,0,0,0,0,0,0,0,0,0,0,0,0,0,0,0,0,0,0,0,0,0,0,0,0,0,0,0,0,0,0,0,0,Valentin Eysseric,Â£4.50m ,28.0,181.0,Midfielder - Attacking Midfield,right,ACF Fiorentina,33.0,4.0,8.0,2308.0,26.0,1.0,1.0,1020.0,15.0,1.0,3.0,655.0,10.0,0.0,0.0,469.0,nan,nan,nan,nan,Serie A,15-07-16,17.3.2.23,Valentin Eysseric,85010867,769,25-Mar-92,24,0,0,4,0,4251,6200,6400,136,128,8257080,181,73,AM RC,2,2,2,2,3,1,2,1,3,3,2,13,12,13,8,14,13,8,13,7,4,13,12,3,14,8,12,9,13,11,13,12,13,14,6,14,6,10,11,15,14,12,11,12,12,14,20,13,11,13,8,10,9,8,13,14,13,12,12,13,13,9,Valentin Eysseric,Â£6.30m ,Ligue 1
19-06-17,18.3.4.28,MâBaye Niang,85051236,41,19-Dec-94,22,0,0,0,0,5450,6450,7000,154,140,19134601,184,78,AM/S RL,2,3,2,1,3,3,3,1,4,1,2,10,12,14,12,11,12,12,12,11,5,11,13,7,12,13,12,12,11,11,11,9,12,14,6,15,8,11,12,16,15,13,12,10,14,16,20,15,14,9,12,12,12,12,14,16,11,9,11,12,12,11,1,1,1,20,17,20,10,AM/S RL,515,1,1,19,10,20,17,1,1,1,1,1,1,1,1,1,2251800000000000.0,0,0,0,0,0,0,0,0,0,1,0,0,0,0,0,0,0,0,0,0,0,0,0,0,0,0,0,0,0,0,0,0,0,0,0,0,0,0,0,0,0,0,0,0,0,0,0,0,M'Baye Niang,Â£9.00m ,25.0,188.0,Forward - Centre-Forward,right,Stade Rennais FC,34.0,5.0,5.0,2377.0,31.0,4.0,3.0,1925.0,44.0,14.0,7.0,2802.0,36.0,15.0,2.0,2882.0,1.0,0.0,0.0,64.0,Serie A,15-07-16,17.3.2.23,MâBaye Niang,85051236,769,19-Dec-94,21,0,0,3,1,5450,6450,6950,163,138,20585358,184,75,AM/S RL,1,2,4,3,2,2,1,3,2,1,1,10,13,14,12,14,8,11,12,6,5,13,13,4,15,13,13,11,10,11,12,10,13,15,6,14,8,10,12,16,15,14,13,10,14,16,20,13,13,12,12,12,12,10,14,16,11,10,11,13,12,12,M'Baye Niang,Â£13.50m ,Premier League
19-06-17,18.3.4.28,PÃ«rparim Hetemaj,8505627,768,12-Dec-86,30,44,4,15,3,4500,6800,6600,140,132,232186002,175,76,M RLC,3,1,1,3,3,1,3,3,2,1,3,10,8,13,8,11,11,7,12,10,14,12,9,16,11,19,13,17,11,14,12,11,15,12,12,14,14,15,17,14,13,14,8,11,15,13,20,15,14,16,16,12,11,13,13,16,14,12,15,12,10,8,1,1,20,10,17,18,20,M RLC,406,1,1,3,10,10,10,1,1,1,10,20,18,17,1,1,0.0,0,0,0,0,0,0,0,0,0,0,0,0,0,0,0,0,0,0,0,0,0,0,0,0,0,0,0,0,0,0,0,0,0,0,0,0,0,0,0,0,0,0,0,0,0,0,0,0,Perparim Hetemaj,Â£3.15m ,33.0,179.0,Midfielder - Central Midfield,right,Benevento Calcio,24.0,0.0,1.0,1966.0,32.0,3.0,4.0,2493.0,31.0,2.0,1.0,2250.0,33.0,0.0,1.0,2349.0,4.0,0.0,0.0,99.0,Serie A
19-06-17,18.3.4.28,Cheick Keita,85136803,769,16-Apr-96,21,0,0,1,0,3500,5650,6000,140,120,9843996,180,68,D/WB/M L,2,2,1,1,1,3,3,3,3,1,2,7,12,11,6,12,5,7,6,10,11,12,10,13,12,10,12,12,13,12,10,11,10,14,10,11,12,7,10,14,15,11,9,20,11,14,8,15,13,11,5,12,5,12,12,14,11,9,12,12,7,2,20,19,16,1,1,20,1,D/WB/M L,123,1,1,1,1,1,1,1,20,1,1,1,16,1,19,1,34359738368.0,0,0,0,0,0,0,0,0,0,0,0,0,0,0,0,0,0,0,0,0,0,0,0,0,0,0,0,0,0,0,0,0,0,0,0,1,0,0,0,0,0,0,0,0,0,0,0,0,Cheick Keita,Â£900Th. ,24.0,180.0,Defender - Left-Back,left,Without Club,26.0,0.0,2.0,2044.0,8.0,0.0,0.0,438.0,24.0,2.0,1.0,1617.0,0.0,0.0,0.0,0.0,nan,nan,nan,nan,Serie A
19-06-17,18.3.4.28,Yann Karamoh,85144982,769,08-Jul-98,18,0,0,0,0,4200,5950,6200,133,121,15151097,185,77,AM/S RL,2,3,3,2,2,2,1,1,3,3,2,8,12,13,10,14,8,12,9,5,6,11,3,5,14,6,12,9,10,11,11,10,8,14,6,13,7,10,12,15,13,14,11,8,14,14,20,13,14,12,6,8,8,12,13,11,13,12,10,11,11,6,1,1,1,20,20,15,10,AM/S RL,515,1,1,18,10,15,20,1,1,1,1,1,1,1,1,1,0.0,0,0,0,0,0,0,0,0,0,0,0,0,0,0,0,0,0,0,0,0,0,0,0,0,0,0,0,0,0,0,0,0,0,0,0,0,0,0,0,0,0,0,0,0,0,0,0,0,Yann Karamoh,Â£6.30m ,22.0,185.0,Forward - Right Winger,right,Parma Calcio 1913,36.0,5.0,4.0,2263.0,18.0,1.0,0.0,641.0,33.0,3.0,3.0,1677.0,15.0,1.0,1.0,582.0,5.0,1.0,1.0,292.0,Serie A,15-07-16,17.3.2.23,Yann Karamoh,85144982,769,08-Jul-98,18,0,0,0,0,3000,5200,6200,145,108,12224278,181,68,AM/S R,4,3,2,2,2,3,1,1,2,2,1,8,11,14,11,13,8,11,11,5,3,11,7,5,14,8,11,8,10,10,11,12,14,13,6,11,9,10,8,14,14,14,10,5,12,14,20,12,11,9,6,5,10,12,17,11,10,9,10,11,14,3,Yann Karamoh,Â£2.70m ,Ligue 1
19-06-17,18.3.4.28,Kevin Mercado,86029649,1654,28-Jan-95,22,0,0,4,0,2750,5050,5400,123,109,1144795,170,70,AM/S LC,2,3,2,1,1,2,3,3,1,2,3,10,11,13,9,12,12,8,11,7,4,10,4,8,12,12,9,12,8,8,10,8,12,11,6,14,6,10,12,14,14,14,8,20,15,14,8,12,13,10,7,8,7,13,11,12,8,11,7,5,6,16,1,1,12,20,14,20,15,AM/S LC,514,1,1,16,15,20,14,1,1,1,1,1,12,10,1,1,2251800000000000.0,0,0,0,0,0,0,0,0,0,0,0,0,0,0,0,0,0,0,0,0,0,0,0,0,0,0,0,0,0,0,0,0,0,0,0,0,0,0,0,0,0,0,0,0,0,0,0,0,nan,nan,nan,nan,nan,nan,nan,nan,nan,nan,nan,nan,nan,nan,nan,nan,nan,nan,nan,nan,nan,nan,nan,nan,nan,nan,nan,nan,
19-06-17,18.3.4.28,Hakan Ãalhanoglu,92026209,799,08-Feb-94,23,26,8,2,0,5750,7500,7300,160,146,56900518,178,69,M/AM RLC,2,3,3,2,2,1,2,2,1,3,1,18,16,12,13,17,18,7,17,5,7,14,15,10,17,10,12,8,14,9,14,12,9,17,6,12,8,10,14,12,15,9,7,13,13,12,20,13,8,10,6,13,5,14,11,18,5,14,10,7,10,16,1,1,17,20,15,19,20,M/AM RLC,526,1,1,15,20,19,15,1,1,1,1,17,17,15,1,1,618475000000.0,0,0,0,0,0,0,0,0,0,0,0,1,0,0,0,0,0,0,0,0,0,0,0,0,0,0,0,0,0,0,0,0,0,0,0,0,1,0,0,1,0,0,0,0,0,0,0,0,Hakan Calhanoglu,Â£24.30m ,26.0,178.0,Midfielder - Attacking Midfield,right,AC Milan,22.0,7.0,7.0,1590.0,45.0,8.0,14.0,3159.0,46.0,4.0,13.0,3547.0,38.0,11.0,9.0,2931.0,8.0,4.0,3.0,671.0,Serie A,15-07-16,17.3.2.23,Hakan Ãalhanoglu,92026209,799,08-Feb-94,22,21,6,2,0,5800,7300,7300,160,146,59488907,178,69,M/AM/S LC,2,2,1,1,2,3,1,1,2,3,1,18,16,12,13,17,18,7,17,5,7,14,15,10,17,10,12,8,14,9,15,11,9,17,6,12,8,10,14,12,15,9,6,14,13,12,20,15,8,10,6,13,5,14,11,18,5,14,10,7,11,16,Hakan Calhanoglu,Â£18.00m ,Bundesliga
19-06-17,18.3.4.28,Rodrigo Palacio,955445,1649,05-Feb-82,35,27,3,0,0,5850,6750,6750,160,135,232186002,175,70,AM/S RLC,1,3,2,3,1,3,2,3,1,1,3,9,13,14,14,16,9,13,10,6,5,13,15,7,16,6,14,15,13,14,13,13,16,15,10,15,10,15,16,13,14,12,9,12,13,13,20,11,8,13,2,13,10,14,15,13,17,15,17,17,15,4,1,1,1,16,16,16,15,AM/S RLC,626,1,1,20,15,16,16,1,1,1,1,1,1,1,1,1,549756000000.0,0,0,0,0,0,0,0,0,0,0,1,0,0,0,0,0,0,0,0,0,0,0,0,0,0,0,0,0,0,0,0,0,0,0,0,0,0,0,0,1,0,0,0,0,0,0,0,0,Rodrigo Palacio,Â£630Th. ,38.0,176.0,Forward - Centre-Forward,right,Bologna FC 1909,20.0,2.0,3.0,767.0,28.0,4.0,2.0,2067.0,31.0,3.0,6.0,2481.0,36.0,8.0,3.0,2604.0,5.0,1.0,1.0,408.0,Serie A,15-07-16,17.3.2.23,Rodrigo Palacio,955445,1649,05-Feb-82,34,27,3,0,0,6000,7100,6900,160,137,1250448,175,70,AM/S RLC,4,3,2,2,4,1,3,1,1,3,2,8,13,14,14,16,8,13,10,3,5,13,15,7,16,6,14,13,13,14,13,13,16,15,9,15,9,15,15,14,14,12,9,12,13,15,20,11,8,14,2,13,10,14,15,13,17,15,17,17,15,4,Rodrigo Palacio,Â£720Th. ,Serie A
19-06-17,18.3.4.28,Alejandro GÃ³mez,955978,1649,15-Feb-88,29,1,1,11,2,6500,7000,7700,154,154,85538663,165,68,AM/S LC,1,2,1,2,3,3,1,1,1,4,3,14,16,19,14,16,13,4,17,4,3,14,15,5,16,12,11,13,12,11,13,12,17,17,14,14,7,11,10,17,17,11,4,13,15,15,20,11,6,15,6,13,8,15,16,16,11,14,15,15,15,7,1,1,12,20,14,20,17,AM/S LC,514,1,1,16,17,20,14,1,1,1,1,1,12,8,1,1,87995400000000.0,0,0,0,0,0,0,0,0,0,1,0,0,0,0,0,0,0,0,0,0,0,0,0,0,0,0,0,1,0,0,0,0,0,0,0,1,0,0,0,0,0,0,0,0,1,0,1,0,Alejandro GÃ¡lvez,Â£1.35m ,31.0,190.0,Defender - Centre-Back,right,Qatar SC,25.0,0.0,0.0,1823.0,25.0,1.0,0.0,2224.0,18.0,1.0,0.0,1426.0,20.0,0.0,0.0,1800.0,3.0,0.0,0.0,204.0,LaLiga,15-07-16,17.3.2.23,Alejandro GÃ³mez,955978,1649,15-Feb-88,28,0,0,11,2,5750,7000,850,147,147,1047,165,68,AM RLC,1,1,3,1,2,2,3,1,2,1,2,12,13,19,11,16,10,5,14,4,3,12,14,5,16,12,11,14,11,11,14,12,17,17,14,15,7,11,11,17,17,11,4,12,15,15,20,11,7,15,6,13,8,15,16,16,15,14,15,15,15,7,Alejandro GÃ¡lvez,Â£2.25m ,LaLiga
19-06-17,18.3.4.28,Pawel Jaroszynski,96045502,787,02-Oct-94,22,0,0,12,1,3250,5000,5050,122,101,484985,187,81,D/WB L,3,1,2,2,1,3,1,4,1,2,4,11,11,9,8,10,11,10,9,11,10,8,7,11,9,10,12,11,11,11,10,10,12,6,7,11,12,12,13,12,10,12,12,20,12,13,10,14,12,11,7,12,6,10,13,12,12,11,12,11,13,5,20,17,15,10,10,20,1,D/WB L,113,1,1,1,1,10,1,1,20,10,1,1,15,1,17,1,0.0,0,0,0,0,0,0,0,0,0,0,0,0,0,0,0,0,0,0,0,0,0,0,0,0,0,0,0,0,0,0,0,0,0,0,0,0,0,0,0,0,0,0,0,0,0,0,0,0,Pawel Jaroszynski,Â£450Th. ,26.0,184.0,Defender - Left-Back,left,Delfino Pescara 1936,12.0,0.0,0.0,812.0,12.0,0.0,0.0,911.0,20.0,0.0,0.0,1424.0,34.0,0.0,1.0,2898.0,4.0,0.0,0.0,334.0,Serie A
19-06-17,18.3.4.28,Ricardo RodrÃ­guez,98003635,798,25-Aug-92,24,45,1,4,0,5750,7700,7350,156,147,48283087,182,77,D/WB/M LC,3,2,3,1,4,1,2,1,1,3,3,15,17,9,10,11,14,8,12,16,11,13,15,14,12,11,16,14,17,14,12,16,13,10,8,11,12,17,14,12,11,15,9,20,18,12,9,17,12,15,6,15,3,12,15,14,12,18,16,17,19,4,20,19,17,10,1,20,15,D/WB/M LC,124,1,1,1,1,10,1,15,20,1,1,1,17,1,19,1,140742000000000.0,0,0,0,0,0,0,0,0,0,0,0,0,0,0,0,0,0,0,0,0,0,0,0,0,0,0,0,0,0,0,0,0,1,0,0,0,0,0,0,0,0,0,0,0,0,0,0,1,Ricardo RodrÃ­guez,Â£13.50m ,28.0,180.0,Defender - Left-Back,left,Torino FC,27.0,2.0,3.0,2289.0,47.0,4.0,2.0,4149.0,41.0,0.0,3.0,3530.0,11.0,0.0,0.0,835.0,2.0,0.0,0.0,177.0,Serie A,15-07-16,17.3.2.23,Ricardo RodrÃ­guez,98003635,798,25-Aug-92,23,41,0,0,0,6200,7700,7200,156,149,32668517,180,78,D/WB LC,1,3,1,3,3,3,2,1,4,2,2,15,17,9,8,11,13,8,12,16,11,13,15,16,12,11,16,14,17,14,12,16,13,10,8,11,12,17,14,12,11,15,9,20,18,12,10,18,12,15,6,15,3,12,14,14,12,18,16,17,19,4,Ricardo RodrÃ­guez,Â£15.30m ,Bundesliga
19-06-17,18.3.4.28,Yusupha Njie,13109635,20,01-Mar-94,23,1,0,0,0,2250,5000,5000,120,110,72981,188,77,AM/S LC,2,2,1,2,2,1,2,2,3,1,1,10,10,14,8,14,11,7,8,5,4,10,8,5,14,7,8,8,13,8,11,11,9,16,8,11,6,8,9,14,14,8,13,10,11,14,20,11,9,9,6,11,3,11,18,10,13,9,13,7,13,5,1,1,10,20,1,20,17,AM/S LC,514,1,1,19,17,20,1,1,1,1,1,10,1,1,1,1,0.0,0,0,0,0,0,0,0,0,0,0,0,0,0,0,0,0,0,0,0,0,0,0,0,0,0,0,0,0,0,0,0,0,0,0,0,0,0,0,0,0,0,0,0,0,0,0,0,0,Yusupha Njie,Â£540Th. ,26.0,188.0,Forward - Centre-Forward,both,Boavista FC,16.0,0.0,0.0,913.0,16.0,4.0,1.0,1142.0,11.0,4.0,0.0,697.0,27.0,1.0,1.0,1292.0,2.0,0.0,0.0,15.0,Liga NOS
19-06-17,18.3.4.28,Jorge Correa,14025040,1649,04-Apr-93,24,0,0,0,0,4150,5900,5900,128,121,875621,170,70,M/AM RLC,2,3,2,2,2,2,3,3,1,1,2,13,11,14,12,13,13,6,16,5,7,13,12,9,14,12,14,12,13,11,13,11,15,17,8,15,9,12,13,13,14,12,7,20,10,12,8,13,11,14,9,13,15,14,8,12,12,12,14,8,11,10,1,1,16,20,19,17,20,M/AM RLC,526,1,1,8,20,17,19,1,1,1,1,1,14,16,1,1,2251800000000000.0,0,0,0,0,1,0,0,0,0,0,1,0,0,0,0,0,0,0,0,0,1,0,0,0,0,0,0,0,0,0,0,0,0,0,0,0,0,0,0,0,0,0,0,0,0,0,0,0,Jorge Correa,Â£720Th. ,27.0,170.0,Midfielder - Left Midfield,left,CS MarÃ­timo,10.0,0.0,0.0,398.0,18.0,0.0,1.0,1280.0,37.0,5.0,2.0,2653.0,30.0,4.0,3.0,1959.0,5.0,0.0,0.0,257.0,Liga NOS
19-06-17,18.3.4.28,Marcos AcuÅa,14044037,1649,28-Oct-91,25,6,0,0,0,5500,7000,7250,149,145,34213963,172,73,M/AM RL,1,1,2,2,1,2,2,3,2,3,2,15,16,15,10,15,15,7,14,5,8,14,9,9,16,12,12,14,13,13,14,13,14,16,9,14,8,14,16,14,14,15,7,20,13,15,9,13,12,15,12,15,8,12,14,14,13,15,15,10,12,8,1,14,20,20,15,20,13,M/AM RL,415,1,1,1,10,20,15,1,1,1,1,13,20,5,14,1,0.0,0,0,0,0,0,0,0,0,0,0,0,0,0,0,0,0,0,0,0,0,0,0,0,0,0,0,0,0,0,0,0,0,0,0,0,0,0,0,0,0,0,0,0,0,0,0,0,0,Marcos AcuÃ±a,Â£13.50m ,28.0,172.0,Defender - Left-Back,left,Sevilla FC,28.0,10.0,13.0,2388.0,54.0,6.0,9.0,4055.0,45.0,1.0,12.0,3870.0,36.0,2.0,4.0,3047.0,5.0,0.0,0.0,432.0,Liga NOS
19-06-17,18.3.4.28,Franco Cervi,14078688,1649,26-May-94,23,0,0,0,0,3845,5896,7200,156,144,27349914,166,60,AM LC,2,1,2,1,1,1,1,3,2,3,3,14,14,16,13,16,12,4,12,4,8,13,12,10,16,16,15,14,13,11,14,12,16,16,9,15,11,13,13,16,15,13,7,20,13,16,8,11,7,11,10,10,11,12,12,12,14,11,14,12,13,7,1,1,13,20,10,20,19,AM LC,504,1,1,10,19,20,10,1,1,1,1,13,13,5,1,1,8.0,0,0,0,1,0,0,0,0,0,0,0,0,0,0,0,0,0,0,0,0,0,0,0,0,0,0,0,0,0,0,0,0,0,0,0,0,0,0,0,0,0,0,0,0,0,0,0,0,Franco Cervi,Â£16.20m ,26.0,166.0,Midfielder - Left Midfield,left,SL Benfica,41.0,7.0,6.0,2472.0,37.0,4.0,10.0,2726.0,38.0,5.0,5.0,2096.0,35.0,4.0,4.0,2482.0,0.0,0.0,0.0,0.0,Liga NOS,15-07-16,17.3.2.23,Franco Cervi,14078688,1649,26-May-94,22,0,0,0,0,3851,5905,7250,160,145,35867599,166,60,AM LC,1,1,2,2,2,1,2,2,2,2,3,14,14,16,13,16,12,4,12,4,8,15,12,10,17,11,13,13,12,12,14,12,13,16,9,14,11,11,13,16,16,13,7,20,13,16,8,11,7,11,10,10,11,12,11,12,14,11,14,12,13,8,Franco Cervi,Â£7.20m ,Liga NOS
19-06-17,18.3.4.28,Awer Mabil,15040452,1435,15-Sep-95,21,0,0,9,4,3750,5050,5500,118,110,465599,179,65,M/AM RL,1,1,2,4,3,1,2,1,2,1,2,9,11,14,11,13,14,6,10,4,4,12,8,4,14,9,13,8,7,6,11,5,10,15,4,12,3,8,13,16,13,12,8,14,10,14,20,11,8,7,6,10,5,10,11,14,12,7,10,7,6,5,1,1,18,20,18,20,12,M/AM RL,525,1,1,10,12,20,18,1,1,1,1,1,18,16,1,1,1.46367e+17,0,0,0,0,0,0,0,0,0,0,0,0,0,0,0,0,0,0,0,0,0,0,0,0,0,0,0,0,0,0,1,0,0,0,0,0,0,0,0,0,0,0,0,0,0,0,0,0,Awer Mabil,Â£495Th. ,25.0,179.0,Forward - Right Winger,right,FC Midtjylland,32.0,6.0,6.0,2159.0,30.0,3.0,4.0,1682.0,42.0,6.0,11.0,2662.0,39.0,8.0,9.0,2817.0,10.0,1.0,1.0,718.0,Liga NOS
19-06-17,18.3.4.28,Bryan RuÃ­z,18003360,366,18-Aug-85,31,104,23,0,0,5850,7550,6950,158,139,9895955,188,81,M/AM LC,3,3,3,1,2,1,3,2,2,1,2,15,16,16,12,16,15,11,13,3,6,16,16,8,16,7,11,9,15,10,16,16,11,16,10,16,9,12,10,11,16,13,11,20,14,11,12,10,9,13,5,10,11,12,13,13,13,13,14,15,10,10,1,1,16,20,13,19,20,M/AM LC,524,1,1,12,20,19,13,1,1,1,1,14,16,12,1,1,554696832.0,0,0,0,0,0,0,0,1,0,0,0,0,0,0,0,0,0,0,0,0,1,0,0,0,1,0,0,0,0,1,0,0,0,0,0,0,0,0,0,0,0,0,0,0,0,0,0,0,Bryan RuÃ­z,Â£1.35m ,35.0,188.0,Midfielder - Attacking Midfield,left,LD Alajuelense,42.0,3.0,8.0,2707.0,47.0,2.0,5.0,2241.0,nan,nan,nan,nan,nan,nan,nan,nan,8.0,2.0,1.0,562.0,Liga NOS,15-07-16,17.3.2.23,Bryan RuÃ­z,18003360,366,18-Aug-85,30,91,21,0,0,5850,7550,7300,158,146,232186002,188,81,M/AM LC,2,2,1,2,3,3,2,2,1,2,4,15,16,16,12,17,15,11,13,3,6,16,16,8,17,7,11,9,17,11,17,16,11,16,10,16,9,12,11,11,16,13,11,20,14,11,13,11,9,13,5,10,11,12,13,13,13,13,14,15,10,1,Bryan RuÃ­z,Â£4.50m ,Liga NOS
19-06-17,18.3.4.28,Zizo,18084626,16,10-Jan-96,21,0,0,0,0,3000,5650,5650,138,113,199404,174,67,M/AM LC,2,3,2,4,1,2,3,3,2,2,4,11,11,13,8,12,10,7,10,5,8,10,3,11,11,12,12,14,12,14,11,12,14,10,11,8,8,15,15,13,12,8,8,10,8,14,20,14,6,14,6,14,12,10,10,12,10,10,12,10,7,10,1,1,20,17,13,17,20,M/AM LC,414,1,1,1,15,17,13,1,1,1,1,20,1,1,1,1,0.0,0,0,0,0,0,0,0,0,0,0,0,0,0,0,0,0,0,0,0,0,0,0,0,0,0,0,0,0,0,0,0,0,0,0,0,0,0,0,0,0,0,0,0,0,0,0,0,0,Zizo,Â£540Th. ,24.0,180.0,Forward - Left Winger,right,Zamalek SC,31.0,3.0,5.0,2254.0,31.0,2.0,1.0,1946.0,24.0,1.0,2.0,1447.0,41.0,8.0,7.0,3031.0,nan,nan,nan,nan,Liga NOS
19-06-17,18.3.4.28,Edson Farias,19052685,1651,12-Jan-92,25,0,0,0,0,2095,4453,5850,122,117,234814,170,68,AM/S RL,2,3,3,3,2,2,2,1,3,2,1,7,9,14,11,11,6,6,7,5,8,10,12,8,14,13,13,13,10,8,8,8,14,14,5,14,8,11,14,16,15,10,4,9,12,15,20,11,6,10,11,10,8,14,12,12,9,13,11,11,18,5,1,1,7,20,20,19,13,AM/S RL,515,1,1,18,13,19,20,1,1,1,1,1,7,7,1,1,8.0,0,0,0,1,0,0,0,0,0,0,0,0,0,0,0,0,0,0,0,0,0,0,0,0,0,0,0,0,0,0,0,0,0,0,0,0,0,0,0,0,0,0,0,0,0,0,0,0,Edson Farias,Â£540Th. ,28.0,170.0,Forward - Right Winger,right,CD Feirense,11.0,1.0,0.0,649.0,30.0,1.0,2.0,2325.0,30.0,0.0,4.0,2543.0,25.0,2.0,1.0,2107.0,7.0,0.0,0.0,263.0,Liga NOS
19-06-17,18.3.4.28,Rafael Costa,19064867,1651,19-Jan-91,26,0,0,0,0,2000,5400,5750,120,116,205959,183,79,M/AM LC,1,4,3,2,2,4,1,3,1,2,1,12,12,12,11,14,14,9,14,8,8,14,13,7,15,10,12,10,11,12,11,10,2,14,9,12,12,12,12,12,11,12,11,20,11,12,10,13,12,11,8,11,8,13,14,10,12,14,12,9,12,5,5,7,19,20,1,19,20,M/AM LC,524,1,1,1,20,12,1,1,5,1,1,17,19,1,7,1,0.0,0,0,0,0,0,0,0,0,0,0,0,0,0,0,0,0,0,0,0,0,0,0,0,0,0,0,0,0,0,0,0,0,0,0,0,0,0,0,0,0,0,0,0,0,0,0,0,0,Rafael Costa,Â£360Th. ,29.0,183.0,Midfielder - Central Midfield,left,Without Club,nan,nan,nan,nan,25.0,3.0,3.0,1449.0,34.0,3.0,6.0,2283.0,21.0,3.0,2.0,1829.0,nan,nan,nan,nan,Liga NOS
19-06-17,18.3.4.28,Mattheus Oliveira,19094979,1651,07-Jul-94,22,0,0,4,0,4572,5334,6300,137,126,1345987,182,75,M/AM LC,3,2,2,2,3,4,3,3,3,1,1,15,15,14,11,15,14,8,14,6,9,15,13,11,16,6,14,8,15,12,14,14,11,13,10,11,11,15,11,11,12,12,12,20,12,11,10,12,7,12,3,8,5,12,12,15,11,13,16,11,13,4,1,1,20,18,1,18,20,M/AM LC,414,1,1,1,17,18,1,1,1,1,13,20,10,1,1,1,0.0,0,0,0,0,0,0,0,0,0,0,0,0,0,0,0,0,0,0,0,0,0,0,0,0,0,0,0,0,0,0,0,0,0,0,0,0,0,0,0,0,0,0,0,0,0,0,0,0,MathÃ­Â­as Olivera,Â£720Th. ,22.0,185.0,Defender - Left-Back,left,Getafe CF,0.0,0.0,0.0,0.0,4.0,1.0,0.0,191.0,29.0,1.0,1.0,2279.0,29.0,0.0,3.0,2319.0,6.0,0.0,0.0,530.0,LaLiga
19-06-17,18.3.4.28,Davidson,19126109,1651,05-Mar-91,26,0,0,0,0,2596,4934,6300,138,126,765854,177,76,AM RL,1,2,3,3,2,1,2,1,1,3,1,10,11,14,12,13,10,8,9,3,10,13,12,5,14,12,11,11,14,11,14,13,12,12,5,14,8,11,10,14,15,13,8,12,14,14,20,12,10,12,9,10,6,10,11,14,9,14,12,9,11,12,1,1,13,20,20,20,13,AM RL,505,1,1,13,13,20,20,1,1,1,1,1,13,13,1,1,16.0,0,0,0,0,1,0,0,0,0,0,0,0,0,0,0,0,0,0,0,0,0,0,0,0,0,0,0,0,0,0,0,0,0,0,0,0,0,0,0,0,0,0,0,0,0,0,0,0,Davidson,Â£1.13m ,29.0,177.0,Forward - Left Winger,right,Alanyaspor,45.0,6.0,6.0,3028.0,35.0,5.0,7.0,2551.0,39.0,10.0,9.0,2975.0,44.0,10.0,11.0,2996.0,7.0,6.0,1.0,543.0,Liga NOS,15-07-16,17.3.2.23,Davidson,19126109,1651,05-Mar-91,25,0,0,0,0,1019,4844,5800,126,116,254070,177,76,AM RL,1,3,3,2,3,2,1,2,1,2,4,10,11,14,12,12,10,8,9,3,10,13,12,5,14,12,8,11,9,10,13,11,12,12,5,13,8,9,10,14,15,12,8,11,10,14,20,12,10,10,9,10,6,10,11,14,9,10,12,8,11,12,Davidson,Â£360Th. ,Liga NOS
19-06-17,18.3.4.28,Nildo Petrolina,19135019,1651,01-May-86,31,0,0,0,0,4000,5250,5750,120,115,232186002,175,63,M/AM RLC,3,1,3,2,3,2,2,1,3,4,1,11,13,13,11,12,11,8,15,10,9,12,12,11,13,10,11,13,10,12,10,8,14,12,8,14,9,11,13,14,14,12,8,20,12,13,8,12,8,9,8,7,8,14,12,12,10,13,12,9,11,6,7,7,18,20,15,20,18,M/AM RLC,526,1,1,1,18,20,15,1,7,1,1,16,18,1,7,1,513.0,1,0,0,0,0,0,0,0,0,1,0,0,0,0,0,0,0,0,0,0,0,0,0,0,0,0,0,0,0,0,0,0,0,0,0,0,0,0,0,0,0,0,0,0,0,0,0,0,Nildo Petrolina,Â£360Th. ,34.0,175.0,Forward - Left Winger,left,Without Club,35.0,2.0,5.0,2056.0,30.0,4.0,4.0,2483.0,37.0,7.0,8.0,2610.0,27.0,4.0,3.0,2365.0,nan,nan,nan,nan,Liga NOS,15-07-16,17.3.2.23,Nildo Petrolina,19135019,1651,01-May-86,30,0,0,0,0,3900,5250,5800,120,116,112289,175,63,M/AM RLC,2,1,3,1,1,2,2,1,4,2,1,11,13,14,11,12,11,8,15,10,9,12,12,11,13,10,11,13,10,12,10,8,14,12,8,14,9,11,13,14,14,12,8,20,12,13,8,12,8,9,8,11,8,14,12,12,10,13,12,9,11,7,Nildo Petrolina,Â£540Th. ,Liga NOS
19-06-17,18.3.4.28,FabrÃ­cio Messias,19152301,1651,23-Mar-90,27,0,0,0,0,4000,6000,6000,135,120,338168,180,76,M/AM/S RLC,1,2,2,2,4,4,1,4,4,3,1,10,7,14,12,14,14,7,15,12,7,13,14,10,14,9,6,9,11,12,14,13,11,11,10,11,11,11,10,13,12,12,9,7,12,13,20,13,13,11,10,12,10,9,12,8,11,10,12,11,10,7,1,1,17,20,17,17,20,M/AM/S RLC,536,1,1,17,20,17,17,1,1,1,1,17,1,1,1,1,0.0,0,0,0,0,0,0,0,0,0,0,0,0,0,0,0,0,0,0,0,0,0,0,0,0,0,0,0,0,0,0,0,0,0,0,0,0,0,0,0,0,0,0,0,0,0,0,0,0,nan,nan,nan,nan,nan,nan,nan,nan,nan,nan,nan,nan,nan,nan,nan,nan,nan,nan,nan,nan,nan,nan,nan,nan,nan,nan,nan,nan,
19-06-17,18.3.4.28,Victor Andrade,19158044,1651,30-Sep-95,21,0,0,5,1,5000,5750,5750,115,105,664868,171,60,M/AM RL,3,2,2,2,2,2,1,2,3,2,3,8,12,15,10,13,8,9,10,4,6,11,12,6,15,8,10,9,9,9,12,5,13,13,8,13,6,8,10,14,15,11,5,10,11,13,20,11,6,10,4,9,14,8,8,12,13,11,10,6,12,14,1,1,20,20,18,20,1,M/AM RL,415,1,1,12,1,20,18,1,1,1,1,1,20,18,1,1,34359738368.0,0,0,0,0,0,0,0,0,0,0,0,0,0,0,0,0,0,0,0,0,0,0,0,0,0,0,0,0,0,0,0,0,0,0,0,1,0,0,0,0,0,0,0,0,0,0,0,0,Victor Andrade,Â£1.13m ,25.0,177.0,Forward - Left Winger,right,GoiÃ¡s Esporte Clube,9.0,1.0,0.0,272.0,24.0,0.0,0.0,1511.0,nan,nan,nan,nan,11.0,2.0,0.0,617.0,nan,nan,nan,nan,Liga NOS
19-06-17,18.3.4.28,Alex Telles,19162830,1651,15-Dec-92,24,0,0,0,0,5548,6305,7250,153,145,23189466,181,73,D/WB L,3,1,3,1,3,2,2,1,3,2,1,14,16,13,8,14,12,8,9,8,12,13,8,14,14,15,14,14,13,13,11,13,14,14,9,14,13,13,15,16,14,13,11,20,14,15,11,14,10,15,10,13,7,13,16,14,12,15,14,10,12,7,20,19,15,10,1,20,1,D/WB L,113,1,1,1,1,10,1,1,20,1,1,1,15,1,19,1,131104.0,0,0,0,0,0,1,0,0,0,0,0,0,0,0,0,0,0,1,0,0,0,0,0,0,0,0,0,0,0,0,0,0,0,0,0,0,0,0,0,0,0,0,0,0,0,0,0,0,Alex Telles,Â£22.50m ,27.0,181.0,Defender - Left-Back,left,Manchester United,45.0,1.0,10.0,3992.0,45.0,4.0,20.0,4022.0,53.0,6.0,13.0,4796.0,49.0,13.0,12.0,4102.0,4.0,2.0,2.0,325.0,Liga NOS,15-07-16,17.3.2.23,Alex Telles,19162830,1651,15-Dec-92,23,0,0,0,0,5500,6500,7100,152,142,17048329,181,73,D/WB L,2,1,1,1,3,3,2,2,2,2,2,14,16,13,8,14,12,8,9,8,12,13,8,14,14,14,14,13,13,13,11,13,13,14,9,14,13,13,14,16,14,13,11,20,14,15,9,14,10,14,6,13,7,13,13,12,12,15,14,10,12,7,Alex Telles,Â£8.10m ,Liga NOS
19-06-17,18.3.4.28,Paulinho,19170166,1651,10-Jul-94,22,0,0,0,0,4000,6750,6750,148,135,13315236,166,58,M/AM RLC,1,2,2,1,3,1,3,1,3,1,1,12,13,15,10,16,13,4,8,5,8,16,13,8,16,6,12,6,14,12,16,14,14,15,5,12,10,9,12,14,15,13,5,20,11,14,8,13,10,12,13,9,4,10,9,16,5,10,14,6,15,6,1,1,19,20,18,17,20,M/AM RLC,526,1,1,1,20,17,18,1,1,1,1,19,17,1,1,1,2.8823e+17,0,0,0,0,1,0,0,0,0,0,0,0,0,0,0,0,0,0,0,0,0,0,0,0,1,0,0,0,0,0,0,0,0,0,0,0,0,0,0,0,0,0,0,0,0,0,0,0,Paulinho,Â£36.00m ,32.0,183.0,Midfielder - Central Midfield,right,Guangzhou Evergrande Taobao,29.0,12.0,5.0,2610.0,68.0,22.0,10.0,4263.0,42.0,22.0,8.0,3632.0,16.0,10.0,4.0,1406.0,nan,nan,nan,nan,LaLiga,15-07-16,17.3.2.23,Paulinho,55013000,788,13-Jul-91,25,0,0,0,0,3500,6100,6100,138,122,801471,176,69,D R,3,2,1,2,1,3,2,1,3,1,4,9,12,12,6,10,8,10,8,12,12,11,8,13,13,12,12,13,12,11,11,12,15,10,10,14,13,15,15,14,13,13,8,8,14,15,20,15,10,15,9,13,2,11,13,14,11,14,14,10,12,4,Paulinho, ,Premier League
19-06-17,18.3.4.28,Allano,19171410,1651,24-Apr-95,22,0,0,0,0,2250,5750,5750,130,120,252279,182,74,AM RL,3,2,1,1,3,1,4,3,2,1,2,8,11,14,9,13,8,10,12,8,7,12,9,10,14,15,13,14,10,12,11,11,12,13,8,15,6,15,16,15,15,11,12,20,14,15,5,11,11,10,10,15,7,15,9,14,6,14,10,10,10,12,7,7,10,20,20,20,1,AM RL,505,1,1,13,1,20,20,1,7,1,1,1,10,10,7,1,2251800000000000.0,0,0,0,0,0,0,0,0,0,0,0,0,0,0,0,0,0,0,0,0,0,0,0,0,0,0,0,0,0,0,0,0,0,0,0,0,0,0,0,0,0,0,0,0,0,0,0,0,Allan,Â£29.70m ,29.0,175.0,Midfielder - Central Midfield,right,Everton FC,39.0,1.0,3.0,2074.0,50.0,4.0,4.0,3477.0,47.0,1.0,2.0,3631.0,33.0,2.0,1.0,1756.0,6.0,0.0,0.0,519.0,Serie A,15-07-16,17.3.2.23,Allano,19171410,1651,24-Apr-95,21,0,0,0,0,2250,5850,5850,130,117,1570926,173,62,WB/M/AM RL,1,1,3,2,3,2,3,1,2,3,3,8,9,13,9,12,6,5,8,6,8,12,9,10,11,12,13,10,8,9,10,9,8,13,5,13,8,12,16,14,15,9,7,20,14,14,5,14,9,11,10,10,7,15,15,10,6,6,7,7,7,5,Allan,Â£14.40m ,Serie A
19-06-17,18.3.4.28,Ewandro,19183233,1651,15-Mar-96,21,0,0,0,0,3250,5750,5500,135,110,1168617,174,61,AM RL,1,3,1,2,2,2,3,1,3,3,2,12,13,13,10,13,11,11,11,4,5,12,9,5,12,10,12,10,11,12,13,11,12,15,10,12,6,12,12,13,13,7,5,20,13,13,10,12,7,12,8,10,8,14,9,12,12,13,12,7,12,6,1,1,10,20,19,20,1,AM RL,505,1,1,15,1,20,19,1,1,1,1,1,10,9,1,1,16.0,0,0,0,0,1,0,0,0,0,0,0,0,0,0,0,0,0,0,0,0,0,0,0,0,0,0,0,0,0,0,0,0,0,0,0,0,0,0,0,0,0,0,0,0,0,0,0,0,Sandro,Â£2.25m ,31.0,187.0,Midfielder - Defensive Midfield,right,GoiÃ¡s Esporte Clube,20.0,3.0,0.0,1227.0,18.0,1.0,0.0,1328.0,26.0,0.0,1.0,1316.0,8.0,0.0,0.0,590.0,nan,nan,nan,nan,Serie A,15-07-16,17.3.2.23,Ewandro,19183233,1651,15-Mar-96,20,0,0,0,0,3250,6300,6100,145,121,7281240,174,61,AM/S RL,2,1,1,1,2,2,1,3,1,3,3,12,13,13,12,13,11,11,11,7,5,12,9,5,12,10,12,10,12,12,13,11,12,15,10,13,6,12,12,14,13,7,5,20,13,13,11,13,7,12,8,10,8,11,20,12,12,13,12,7,12,6,Evandro,Â£1.80m ,Premier League
19-06-17,18.3.4.28,Caio Rangel,19186017,1651,16-Jan-96,21,0,0,0,0,2250,5600,5600,132,112,563380,172,68,AM RLC,3,1,1,2,2,2,3,3,2,3,2,5,9,13,10,11,7,6,11,4,6,12,12,6,14,11,11,10,11,11,12,11,10,18,7,11,7,8,11,15,15,14,6,8,13,14,20,14,8,12,10,12,8,12,14,8,14,12,12,14,15,12,1,1,12,20,15,15,20,AM RLC,506,1,1,14,20,15,15,1,1,1,1,10,12,12,1,1,70953000000000.0,0,0,0,0,0,0,0,0,0,0,0,0,0,0,0,0,0,0,0,0,0,0,0,0,0,0,0,1,0,0,0,0,0,0,0,1,0,0,0,1,0,0,0,0,0,0,1,0,nan,nan,nan,nan,nan,nan,nan,nan,nan,nan,nan,nan,nan,nan,nan,nan,nan,nan,nan,nan,nan,nan,nan,nan,nan,nan,nan,nan,
19-06-17,18.3.4.28,Rafael Furlan,19186200,1651,24-Nov-94,22,0,0,0,0,1771,4808,5600,128,112,54588,177,74,D/AM LC,1,2,4,1,2,1,2,1,3,3,3,7,11,13,8,13,8,7,8,9,9,13,13,10,15,12,11,14,12,12,12,11,12,11,8,12,10,13,13,13,13,11,8,20,13,14,5,12,9,11,7,9,3,14,13,13,13,12,13,13,10,5,16,12,12,20,1,20,17,D/AM LC,524,1,1,10,17,20,1,1,16,1,1,12,12,1,12,1,0.0,0,0,0,0,0,0,0,0,0,0,0,0,0,0,0,0,0,0,0,0,0,0,0,0,0,0,0,0,0,0,0,0,0,0,0,0,0,0,0,0,0,0,0,0,0,0,0,0,Rafael Furlan,Â£180Th. ,26.0,177.0,Defender - Left-Back,left,LeixÃµes SC,nan,nan,nan,nan,12.0,0.0,0.0,518.0,31.0,1.0,5.0,2417.0,15.0,1.0,2.0,1130.0,3.0,0.0,1.0,147.0,Liga NOS
19-06-17,18.3.4.28,Ibson Melo,19186352,1651,08-Oct-89,27,0,0,0,0,1809,4136,5200,105,104,142779,179,72,AM RL,1,1,3,1,3,2,3,1,2,1,3,8,12,13,9,12,7,6,8,5,5,11,9,5,13,7,9,7,10,9,11,9,13,14,4,9,6,9,8,14,13,12,9,20,13,13,15,13,6,12,6,8,8,8,14,8,5,11,12,13,15,5,1,1,15,20,17,20,12,AM RL,505,1,1,8,12,20,17,1,1,1,6,10,15,14,1,1,2252350000000000.0,1,0,0,0,0,0,0,0,0,0,0,0,0,0,0,0,0,0,0,0,0,0,0,0,0,0,0,0,0,0,0,0,0,0,0,0,0,0,0,1,0,0,0,0,0,0,0,0,Ibson Melo,Â£360Th. ,31.0,178.0,Forward - Second Striker,left,Sukhothai FC,36.0,7.0,4.0,3083.0,23.0,1.0,3.0,920.0,19.0,9.0,0.0,1552.0,10.0,6.0,2.0,894.0,nan,nan,nan,nan,Liga NOS
19-06-17,18.3.4.28,OtÃ¡vio,19186901,1651,09-Feb-95,22,0,0,4,1,4500,6650,6850,155,137,14923293,172,62,AM LC,1,2,3,2,4,2,1,2,2,1,1,5,12,15,11,14,11,9,13,10,7,15,12,6,16,13,13,13,14,13,15,14,15,15,8,14,8,11,12,14,15,15,6,12,13,14,20,12,8,11,5,11,5,10,12,15,12,14,13,5,9,11,1,1,13,20,14,18,20,AM LC,504,1,1,10,20,18,14,1,1,1,1,13,13,10,1,1,1.46367e+17,0,0,0,0,0,0,0,0,0,0,0,0,0,0,0,0,0,1,0,0,0,0,0,0,0,0,0,0,0,0,0,0,0,0,0,0,0,0,0,0,0,0,0,0,0,0,0,0,OtÃ¡vio,Â£5.85m ,26.0,176.0,Midfielder - Defensive Midfield,right,FC Girondins Bordeaux,24.0,1.0,1.0,2084.0,21.0,0.0,0.0,1492.0,43.0,0.0,2.0,3532.0,28.0,2.0,3.0,2322.0,7.0,0.0,0.0,580.0,Ligue 1,15-07-16,17.3.2.23,OtÃ¡vio,19186901,1651,09-Feb-95,21,0,0,4,1,3500,7150,7150,160,143,29069548,172,62,AM LC,3,1,1,3,1,2,3,2,1,2,2,5,12,15,11,14,11,9,13,11,7,15,12,6,17,13,14,13,14,13,15,15,15,15,8,15,8,11,12,14,15,15,6,13,13,14,20,13,8,11,5,11,5,10,7,15,12,14,13,5,9,11,OtÃ¡vio,Â£6.30m ,Liga NOS
19-06-17,18.3.4.28,Matheus Ãndio,19192105,1651,28-Feb-96,21,0,0,0,0,2750,5450,5750,130,111,59861,179,70,AM RL,1,2,3,1,2,2,1,2,2,3,2,14,14,14,10,13,13,8,10,4,5,12,8,5,15,9,11,9,11,8,13,8,14,15,8,12,6,10,9,14,14,12,8,20,13,12,10,12,10,8,6,9,5,11,13,12,12,11,11,6,12,7,1,1,7,20,20,20,13,AM RL,505,1,1,1,13,20,20,1,1,1,1,1,5,7,1,1,4.0,0,0,1,0,0,0,0,0,0,0,0,0,0,0,0,0,0,0,0,0,0,0,0,0,0,0,0,0,0,0,0,0,0,0,0,0,0,0,0,0,0,0,0,0,0,0,0,0,Matheus Ãndio,Â£450Th. ,24.0,179.0,Midfielder - Right Midfield,left,Without Club,31.0,4.0,2.0,2085.0,12.0,0.0,0.0,480.0,19.0,1.0,0.0,1167.0,11.0,0.0,1.0,596.0,nan,nan,nan,nan,Liga NOS,15-07-16,17.3.2.23,Matheus Ãndio,19192105,1651,28-Feb-96,20,0,0,0,0,2754,5458,6150,140,123,528532,179,70,AM RC,2,4,1,4,3,3,2,2,3,2,3,15,15,14,11,14,15,8,10,4,5,13,8,5,16,10,11,10,13,11,14,10,13,15,8,12,6,10,11,14,14,12,8,20,13,13,10,12,10,10,11,10,5,11,15,12,12,12,11,6,12,7,Matheus Ãndio,Â£450Th. ,Liga NOS
19-06-17,18.3.4.28,Abner,19202686,1651,30-May-96,21,0,0,4,0,2966,4977,4950,135,113,324817,176,70,D/WB/M L,2,2,3,2,2,2,2,2,2,2,2,13,14,14,9,12,10,13,12,12,7,11,10,9,13,13,7,14,11,7,10,10,15,13,8,13,6,12,12,14,12,12,12,20,13,12,10,14,13,9,10,10,16,11,15,8,10,13,12,6,10,13,20,19,17,1,1,20,1,D/WB/M L,123,1,1,1,1,1,1,1,20,1,1,1,17,1,19,1,257.0,1,0,0,0,0,0,0,0,1,0,0,0,0,0,0,0,0,0,0,0,0,0,0,0,0,0,0,0,0,0,0,0,0,0,0,0,0,0,0,0,0,0,0,0,0,0,0,0,Abner,Â£315Th. ,24.0,179.0,Defender - Left-Back,left,SC Farense,21.0,0.0,0.0,999.0,30.0,0.0,3.0,1943.0,4.0,0.0,1.0,217.0,1.0,0.0,0.0,90.0,0.0,0.0,0.0,0.0,Liga NOS
19-06-17,18.3.4.28,Nathan,19222989,1651,13-Mar-96,21,0,0,14,3,3762,5017,5650,140,113,3224141,178,71,M/AM LC,2,1,3,3,1,1,2,1,1,1,3,11,11,15,12,14,12,7,13,4,5,13,12,6,15,10,12,10,11,11,11,11,14,15,7,13,5,12,8,13,14,10,8,13,9,12,20,10,9,9,7,8,5,13,12,14,10,12,11,6,12,6,1,1,17,20,1,18,20,M/AM LC,524,1,1,12,20,18,1,1,1,1,13,17,14,1,1,1,0.0,0,0,0,0,0,0,0,0,0,0,0,0,0,0,0,0,0,0,0,0,0,0,0,0,0,0,0,0,0,0,0,0,0,0,0,0,0,0,0,0,0,0,0,0,0,0,0,0,Nathan,Â£900Th. ,24.0,177.0,Midfielder - Attacking Midfield,right,Clube AtlÃ©tico Mineiro,32.0,5.0,3.0,1774.0,23.0,2.0,2.0,905.0,27.0,4.0,0.0,1333.0,16.0,6.0,2.0,1133.0,nan,nan,nan,nan,Ligue 1
19-06-17,18.3.4.28,Matheus SÃ¡vio,19237293,1651,15-Apr-97,20,0,0,7,1,2250,5400,5400,138,111,330742,171,62,AM LC,1,2,2,2,3,3,1,1,1,2,2,8,12,13,11,12,13,10,12,5,8,12,11,5,14,8,13,8,12,11,13,12,15,13,8,12,7,11,13,13,13,7,7,10,12,13,20,12,10,12,8,11,10,10,13,12,12,12,10,7,12,9,1,1,12,20,10,18,20,AM LC,504,1,1,1,20,18,10,1,1,1,1,12,1,1,1,1,0.0,0,0,0,0,0,0,0,0,0,0,0,0,0,0,0,0,0,0,0,0,0,0,0,0,0,0,0,0,0,0,0,0,0,0,0,0,0,0,0,0,0,0,0,0,0,0,0,0,Matheus Savio,Â£900Th. ,23.0,175.0,Midfielder - Attacking Midfield,right,Kashiwa Reysol,10.0,1.0,1.0,394.0,11.0,2.0,0.0,431.0,28.0,8.0,3.0,1692.0,6.0,0.0,0.0,247.0,nan,nan,nan,nan,Liga NOS
19-06-17,18.3.4.28,Bruno Tabata,19239601,1651,30-Mar-97,20,0,0,0,0,3500,5600,5600,135,115,195988,175,72,AM RLC,3,3,2,1,2,1,3,2,2,2,1,14,12,15,10,15,10,5,11,8,10,14,13,11,16,6,10,7,10,10,13,9,17,12,4,10,12,9,11,12,12,8,8,20,13,12,12,14,9,9,8,9,3,9,13,16,12,13,18,14,15,7,1,1,13,20,18,20,18,AM RLC,506,1,1,1,18,20,18,1,1,1,1,13,1,1,1,1,0.0,0,0,0,0,0,0,0,0,0,0,0,0,0,0,0,0,0,0,0,0,0,0,0,0,0,0,0,0,0,0,0,0,0,0,0,0,0,0,0,0,0,0,0,0,0,0,0,0,nan,nan,nan,nan,nan,nan,nan,nan,nan,nan,nan,nan,nan,nan,nan,nan,nan,nan,nan,nan,nan,nan,nan,nan,nan,nan,nan,nan,
19-06-17,18.3.4.28,Raphinha,19242277,1651,14-Dec-96,20,0,0,0,0,4394,4653,6700,146,134,5524226,176,0,AM RL,3,1,3,2,2,2,3,1,2,3,2,12,14,16,11,15,11,8,13,6,6,14,11,7,16,10,12,11,12,12,14,13,13,17,6,14,8,10,11,15,16,13,7,20,11,15,7,12,7,13,5,12,6,7,14,12,12,13,14,8,12,7,1,1,13,20,19,20,1,AM RL,505,1,1,10,1,20,19,1,1,1,1,1,13,7,1,1,0.0,0,0,0,0,0,0,0,0,0,0,0,0,0,0,0,0,0,0,0,0,0,0,0,0,0,0,0,0,0,0,0,0,0,0,0,0,0,0,0,0,0,0,0,0,0,0,0,0,Raphinha,Â£5.85m ,23.0,175.0,Forward - Right Winger,left,Leeds United,40.0,4.0,7.0,2200.0,43.0,18.0,6.0,3673.0,36.0,7.0,5.0,2358.0,35.0,9.0,5.0,2736.0,8.0,1.0,2.0,422.0,Liga NOS,15-07-16,17.3.2.23,Raphinha,19242277,1651,14-Dec-96,19,0,0,0,0,1326,3555,6000,140,120,1592905,176,69,S RL,4,1,2,3,3,2,3,2,3,3,3,12,13,16,9,14,11,8,9,4,3,12,6,5,15,8,12,9,12,10,12,11,11,17,6,13,7,11,19,15,14,8,7,20,11,14,11,10,7,9,7,12,3,4,13,12,12,14,13,10,12,8,Raphinha,Â£1.80m ,Liga NOS
19-06-17,18.3.4.28,Rafael Crivellaro,2111397,1651,18-Feb-89,28,0,0,0,0,5062,5062,5900,124,118,284344,184,77,M/AM RLC,2,3,3,2,1,2,1,1,2,1,3,13,14,13,12,14,14,7,14,4,7,15,14,8,15,6,9,9,14,12,15,14,10,12,8,10,10,11,8,11,12,13,12,20,8,11,11,11,11,11,6,10,10,6,5,11,11,11,11,14,13,3,1,1,20,16,17,17,20,M/AM RLC,416,1,1,1,16,13,5,1,1,1,1,20,17,17,1,1,0.0,0,0,0,0,0,0,0,0,0,0,0,0,0,0,0,0,0,0,0,0,0,0,0,0,0,0,0,0,0,0,0,0,0,0,0,0,0,0,0,0,0,0,0,0,0,0,0,0,Rafael Crivellaro,Â£360Th. ,31.0,183.0,Midfielder - Attacking Midfield,left,Chennaiyin FC,32.0,4.0,3.0,1635.0,16.0,1.0,1.0,1115.0,25.0,0.0,4.0,1463.0,20.0,7.0,8.0,1651.0,nan,nan,nan,nan,Liga NOS,15-07-16,17.3.2.23,Rafael Crivellaro,2111397,1651,18-Feb-89,27,0,0,0,0,5102,5150,5900,124,118,274742,184,77,M/AM RLC,4,3,2,2,1,1,3,1,2,4,2,13,14,13,12,14,14,7,14,4,7,15,14,8,15,6,9,9,14,12,15,14,10,12,8,10,10,11,8,11,12,13,12,20,8,11,11,11,11,11,6,10,10,6,5,11,14,13,11,13,16,6,Rafael Crivellaro,Â£540Th. ,Liga NOS
19-06-17,18.3.4.28,Bruno CÃ©sar,2114054,1651,03-Nov-88,28,2,0,0,0,5000,6750,6750,144,135,8702768,178,83,AM LC,2,2,1,2,3,1,2,4,1,1,1,16,15,14,13,15,14,11,17,4,7,15,14,8,16,6,13,10,15,12,15,14,8,15,10,14,6,13,11,12,14,14,7,20,8,13,7,11,11,12,10,12,10,12,12,13,7,8,8,10,13,7,15,14,15,20,14,17,20,AM LC,504,1,1,12,20,17,14,1,15,1,1,8,15,1,14,1,21990200000000.0,0,0,0,1,0,0,0,0,1,0,1,0,0,0,0,0,0,0,0,0,0,0,0,0,0,0,0,0,0,0,0,0,0,0,0,0,0,0,0,0,0,0,1,0,1,0,0,0,Bruno CÃ©sar,Â£2.70m ,31.0,178.0,Midfielder - Attacking Midfield,left,FC Penafiel,42.0,6.0,8.0,2773.0,33.0,2.0,0.0,1361.0,18.0,2.0,0.0,581.0,9.0,0.0,0.0,271.0,2.0,0.0,0.0,27.0,Liga NOS,15-07-16,17.3.2.23,Bruno CÃ©sar,2114054,1651,03-Nov-88,27,2,0,0,0,5000,6800,6800,144,136,12792455,178,83,AM LC,3,2,3,3,3,1,3,3,1,1,2,15,15,14,13,15,14,11,17,4,7,15,14,8,16,6,13,10,15,12,15,14,8,15,10,14,6,13,11,12,14,14,7,20,8,13,7,12,12,12,10,12,10,10,11,13,7,8,8,10,13,8,Bruno CÃ©sar,Â£4.05m ,Liga NOS
19-06-17,18.3.4.28,Jorge Intima,28097147,788,21-Sep-95,21,0,0,0,0,3500,5250,5500,124,110,1385376,171,64,AM RL,2,1,2,1,2,1,2,2,2,2,1,7,9,12,10,12,7,5,8,4,4,11,13,5,12,8,11,10,11,12,9,8,13,13,8,12,7,10,12,15,13,12,8,10,11,15,20,13,9,10,7,1,7,10,11,12,10,11,8,10,10,5,1,1,13,20,20,17,1,AM RL,505,1,1,12,1,17,20,1,1,1,1,1,7,13,1,1,0.0,0,0,0,0,0,0,0,0,0,0,0,0,0,0,0,0,0,0,0,0,0,0,0,0,0,0,0,0,0,0,0,0,0,0,0,0,0,0,0,0,0,0,0,0,0,0,0,0,nan,nan,nan,nan,nan,nan,nan,nan,nan,nan,nan,nan,nan,nan,nan,nan,nan,nan,nan,nan,nan,nan,nan,nan,nan,nan,nan,nan,15-07-16,17.3.2.23,Jorge Intima,28097147,788,21-Sep-95,20,0,0,0,0,2022,4815,4750,120,111,120402,171,64,AM RL,3,2,3,3,3,2,2,3,1,2,3,7,9,12,10,12,7,5,8,4,4,11,13,5,12,8,11,10,11,12,9,9,13,13,8,12,7,10,12,15,13,12,8,10,11,15,20,13,9,10,7,8,3,10,13,13,9,11,10,15,15,5,nan,nan,nan
19-06-17,18.3.4.28,Bilel Aouacheria,29114983,769,02-Apr-94,23,0,0,0,0,1500,5400,5400,125,109,37482,182,77,AM RL,2,1,1,1,2,3,1,2,2,4,1,12,12,13,9,12,12,8,11,5,6,12,10,7,14,8,7,8,12,9,12,11,11,13,5,14,4,8,8,14,12,12,11,11,14,13,20,12,11,11,5,12,7,10,12,10,13,8,13,14,14,12,1,1,12,20,18,20,1,AM RL,505,1,1,1,1,20,18,1,1,1,1,1,10,12,1,1,1.44115e+17,0,0,0,0,0,0,0,0,0,0,0,0,0,0,0,0,0,0,0,0,0,0,0,0,0,0,0,0,0,0,0,0,0,0,0,0,0,0,0,0,0,0,0,0,0,0,0,0,Bilel Aouacheria,Â£540Th. ,26.0,182.0,Forward - Right Winger,both,SC Farense,38.0,5.0,4.0,2439.0,34.0,5.0,2.0,2319.0,22.0,1.0,0.0,992.0,32.0,1.0,4.0,2093.0,1.0,0.0,0.0,8.0,Liga NOS
19-06-17,18.3.4.28,Tyler Boyd,30035243,1438,30-Dec-94,22,5,0,9,1,2500,5250,5250,120,105,25420,177,74,AM RL,2,2,2,2,3,1,2,2,2,4,2,4,9,12,11,12,8,7,8,4,3,10,8,5,12,9,11,11,8,8,8,9,13,11,6,14,7,12,12,14,14,12,10,10,14,15,20,11,9,11,4,11,7,11,15,14,13,12,13,13,10,5,1,1,1,20,18,20,1,AM RL,505,1,1,7,1,20,18,1,1,1,1,1,1,1,1,1,0.0,0,0,0,0,0,0,0,0,0,0,0,0,0,0,0,0,0,0,0,0,0,0,0,0,0,0,0,0,0,0,0,0,0,0,0,0,0,0,0,0,0,0,0,0,0,0,0,0,Tyler Boyd,Â£720Th. ,25.0,183.0,Forward - Left Winger,right,Besiktas JK,34.0,8.0,5.0,2619.0,29.0,5.0,4.0,1568.0,27.0,7.0,6.0,1825.0,28.0,3.0,1.0,1623.0,6.0,1.0,0.0,447.0,Liga NOS
19-06-17,18.3.4.28,Yacine Brahimi,34002647,5,08-Feb-90,27,38,8,0,0,6250,7500,7650,156,154,61104149,175,69,AM RLC,3,1,3,1,1,2,1,2,2,4,3,13,13,18,13,16,14,5,12,5,5,16,11,5,18,10,12,10,14,13,16,15,9,19,5,14,6,11,10,16,16,14,7,13,12,15,20,13,9,11,6,15,7,13,14,16,8,9,10,11,14,8,1,1,12,20,16,20,18,AM RLC,506,1,1,1,18,20,16,1,1,1,1,1,12,12,1,1,2252380000000000.0,0,0,0,0,0,0,0,0,0,0,0,0,0,0,0,0,0,0,0,0,1,0,0,0,0,0,0,0,0,0,0,0,0,0,0,1,0,0,0,1,0,0,0,0,0,0,0,0,Yacine Brahimi,Â£23.40m ,30.0,175.0,Forward - Left Winger,right,Al-Rayyan SC,31.0,7.0,4.0,1927.0,49.0,12.0,10.0,3914.0,49.0,13.0,9.0,3429.0,23.0,15.0,5.0,2040.0,4.0,1.0,1.0,360.0,Liga NOS,15-07-16,17.3.2.23,Yacine Brahimi,34002647,5,08-Feb-90,26,28,7,0,0,6000,7500,7550,162,151,49082187,175,69,AM RLC,1,3,2,2,1,1,3,1,3,1,2,13,13,18,13,16,14,5,12,5,5,14,11,5,18,6,12,8,14,12,14,11,9,19,5,13,6,9,9,16,16,14,7,13,12,16,20,13,10,8,6,15,7,13,7,16,8,9,10,11,14,8,Yacine Brahimi,Â£16.20m ,Liga NOS
19-06-17,18.3.4.28,Tasos Karamanos,36038063,772,21-Sep-90,26,0,0,0,0,3500,5600,5600,120,112,365474,185,79,AM/S RLC,1,3,2,2,2,4,3,2,2,1,1,6,7,11,14,12,8,12,9,7,6,10,12,6,11,12,12,11,10,12,10,12,12,14,6,12,6,13,12,12,12,12,12,9,12,13,20,14,12,11,4,10,4,12,13,16,13,12,14,11,10,5,1,1,10,19,16,16,19,AM/S RLC,626,1,1,20,19,16,16,1,1,1,1,8,7,10,1,1,1048592.0,0,0,0,0,1,0,0,0,0,0,0,0,0,0,0,0,0,0,0,0,1,0,0,0,0,0,0,0,0,0,0,0,0,0,0,0,0,0,0,0,0,0,0,0,0,0,0,0,Anastasios Karamanos,Â£450Th. ,30.0,185.0,Forward - Centre-Forward,right,PAS Lamia 1964,36.0,7.0,2.0,2647.0,23.0,1.0,1.0,826.0,35.0,4.0,1.0,2749.0,32.0,1.0,1.0,2471.0,5.0,0.0,0.0,341.0,Liga NOS,15-07-16,17.3.2.23,Tasos Karamanos,36038063,772,21-Sep-90,25,0,0,0,0,3516,4772,4750,120,108,50044,185,79,AM/S RLC,1,1,1,1,1,3,2,2,3,3,3,6,7,11,14,12,8,10,9,7,6,10,12,6,11,12,12,11,10,12,10,12,12,14,6,12,6,13,12,12,12,12,12,8,12,13,20,14,12,11,4,10,4,12,18,16,13,12,14,11,10,4,Anastasios Karamanos,Â£720Th. ,Liga NOS
19-06-17,18.3.4.28,Ousmane DramÃ©,43086995,769,25-Aug-92,24,0,0,0,0,3124,4426,5700,124,114,189993,174,68,AM/S RL,1,2,1,1,3,1,1,2,2,3,2,9,11,15,11,12,8,7,10,4,4,10,8,4,14,8,11,12,8,10,10,7,11,16,7,11,7,9,11,15,16,11,5,8,10,15,20,12,8,9,5,10,5,5,11,9,10,12,12,10,14,8,1,1,12,20,15,20,10,AM/S RL,515,1,1,18,10,20,15,1,1,1,1,1,10,12,1,1,1.44115e+17,0,0,0,0,0,0,0,0,0,0,0,0,0,0,0,0,0,0,0,0,0,0,0,0,0,0,0,0,0,0,0,0,0,0,0,0,0,0,0,0,0,0,0,0,0,0,0,0,Ousmane DramÃ©,Â£450Th. ,28.0,174.0,Forward - Left Winger,right,Retired,29.0,2.0,0.0,1841.0,11.0,0.0,0.0,97.0,10.0,1.0,2.0,318.0,nan,nan,nan,nan,nan,nan,nan,nan,Liga NOS,15-07-16,17.3.2.23,Ousmane DramÃ©,43086995,769,25-Aug-92,23,0,0,0,0,3253,4502,5700,124,114,219707,174,68,AM/S RL,3,3,3,3,2,2,2,2,3,1,3,9,11,15,11,12,8,7,10,4,4,10,8,4,14,8,11,12,8,10,10,7,11,16,7,11,7,9,11,15,16,11,5,8,10,15,20,12,8,9,5,10,5,5,8,9,10,12,12,10,14,8,Ousmane DramÃ©,Â£720Th. ,Liga NOS
19-06-17,18.3.4.28,Shoya Nakajima,45065338,116,23-Aug-94,22,0,0,8,5,3250,6650,6650,148,133,2496638,162,58,AM RLC,1,1,2,4,2,3,3,2,1,3,3,12,13,17,12,14,15,4,15,3,7,13,12,7,17,4,8,9,14,11,14,12,14,15,2,14,7,9,12,15,14,11,4,10,14,15,20,13,5,15,1,15,3,13,16,14,12,15,18,13,12,3,1,1,14,20,15,20,19,AM RLC,506,1,1,14,19,20,15,1,1,1,1,14,1,1,1,1,1.44117e+17,0,0,0,0,0,0,0,1,0,0,0,0,0,0,0,0,0,0,0,0,0,0,0,0,0,0,0,0,0,0,0,0,0,0,0,0,0,0,0,0,0,1,0,0,0,0,0,0,Shoya Nakajima,Â£7.20m ,26.0,164.0,Forward - Left Winger,right,FC Porto,29.0,6.0,7.0,1728.0,33.0,10.0,13.0,2801.0,27.0,7.0,6.0,2362.0,28.0,1.0,3.0,1316.0,2.0,0.0,1.0,92.0,Liga NOS
19-06-17,18.3.4.28,JesÃºs Corona,51012751,379,06-Jan-93,24,30,7,0,0,6250,6750,7200,155,144,22756799,173,66,AM RLC,1,3,3,3,3,1,2,2,2,4,2,13,13,17,14,16,11,5,11,4,4,13,10,5,17,7,11,11,12,10,13,12,13,17,7,15,7,9,11,16,16,10,4,13,13,16,20,11,7,7,8,12,5,12,13,13,7,11,7,11,11,10,1,1,14,20,20,19,18,AM RLC,506,1,1,12,18,19,20,1,1,1,1,12,14,14,1,1,4947800000000.0,0,0,0,1,0,0,0,0,0,0,0,0,0,0,0,0,0,0,0,0,0,0,0,0,0,0,0,0,0,0,0,0,0,0,0,0,0,0,0,1,0,0,1,0,0,0,0,0,JesÃºs Corona,Â£10.80m ,27.0,173.0,Forward - Right Winger,both,FC Porto,41.0,6.0,9.0,2219.0,41.0,3.0,5.0,2178.0,53.0,7.0,15.0,3673.0,51.0,4.0,21.0,4154.0,6.0,2.0,2.0,520.0,Liga NOS,15-07-16,17.3.2.23,JesÃºs Corona,51012751,379,06-Jan-93,23,25,6,0,0,6250,6750,7250,160,145,31114062,173,66,AM RLC,1,2,1,3,3,1,1,1,2,2,1,10,11,17,14,16,11,5,11,4,4,12,10,5,17,7,11,12,12,10,13,12,13,17,7,15,8,9,11,16,17,10,4,15,13,16,20,12,6,9,8,12,5,12,13,13,7,11,7,11,11,11,JesÃºs Corona,Â£10.80m ,Liga NOS
19-06-17,18.3.4.28,Nuno Pinto,55001184,788,06-Aug-86,30,0,0,0,0,4400,6050,6050,124,121,232186002,176,72,D/WB/M L,3,3,2,1,4,3,2,2,2,1,1,14,15,12,8,12,12,8,11,11,11,13,11,13,15,13,12,14,13,12,13,13,14,14,8,14,12,12,13,13,13,11,8,20,13,13,7,12,7,13,9,13,9,12,15,13,13,12,13,14,11,9,20,19,18,13,1,20,6,D/WB/M L,123,1,1,1,1,13,1,1,20,1,1,6,18,1,19,1,17592200000000.0,1,0,0,0,0,1,0,0,0,0,0,0,0,0,0,0,0,0,0,0,1,0,0,0,0,0,0,0,0,0,0,0,0,0,0,0,0,0,0,0,0,0,0,0,1,0,0,0,Nuno Pinto,Â£720Th. ,34.0,173.0,Defender - Left-Back,left,Without Club,37.0,0.0,9.0,3249.0,33.0,1.0,6.0,2811.0,13.0,0.0,3.0,955.0,15.0,0.0,1.0,1173.0,nan,nan,nan,nan,Liga NOS,15-07-16,17.3.2.23,Nuno Pinto,55001184,788,06-Aug-86,29,0,0,0,0,4400,6200,6200,124,124,563651,176,72,D/WB/M L,4,2,1,3,1,3,1,3,2,1,3,14,15,12,8,12,12,8,11,11,11,13,11,13,15,13,12,14,13,12,13,13,14,14,8,14,12,12,13,14,15,11,8,20,13,13,5,13,7,13,9,13,9,12,15,13,13,12,13,14,11,10,Nuno Pinto,Â£900Th. ,Liga NOS
19-06-17,18.3.4.28,Bruno Pereirinha,55001512,788,02-Mar-88,29,0,0,19,0,4750,5800,5800,133,116,51356,174,68,D/WB/M RL,3,2,1,3,3,2,1,3,1,1,2,12,12,12,9,13,8,7,10,10,10,12,10,12,13,10,12,13,13,11,11,12,13,13,9,13,11,13,12,12,13,10,8,9,12,12,20,11,8,12,8,12,14,17,14,13,15,13,18,17,17,4,20,19,18,10,20,18,1,D/WB/M RL,125,1,1,1,1,7,10,1,18,20,1,1,16,18,17,19,18.0,0,1,0,0,1,0,0,0,0,0,0,0,0,0,0,0,0,0,0,0,0,0,0,0,0,0,0,0,0,0,0,0,0,0,0,0,0,0,0,0,0,0,0,0,0,0,0,0,Bruno Pereirinha,Â£360Th. ,32.0,174.0,Forward - Right Winger,right,Without Club,nan,nan,nan,nan,18.0,0.0,0.0,960.0,18.0,0.0,0.0,1167.0,nan,nan,nan,nan,nan,nan,nan,nan,Liga NOS
19-06-17,18.3.4.28,RÃºben Ribeiro,55003873,788,01-Aug-87,29,0,0,0,0,4000,6850,6950,140,139,21107638,175,67,M/AM RLC,2,1,2,3,2,1,2,2,4,2,3,14,14,15,7,15,13,8,12,8,7,15,11,11,17,12,9,14,15,13,14,14,12,13,12,13,11,15,12,13,14,12,8,13,13,13,20,12,8,12,11,10,11,15,16,10,9,11,9,3,6,11,1,1,18,20,18,15,20,M/AM RLC,526,1,1,1,20,15,18,1,1,1,1,18,13,14,1,1,206158000000.0,0,0,0,0,0,1,0,0,0,0,0,0,0,0,0,0,0,0,0,0,0,0,0,0,0,0,0,0,0,0,0,0,0,0,0,0,1,1,0,0,0,0,0,0,0,0,0,0,RÃºben Ribeiro,Â£1.80m ,33.0,175.0,Forward - Left Winger,right,Hatayspor,36.0,1.0,3.0,2649.0,41.0,4.0,6.0,2806.0,11.0,2.0,3.0,812.0,13.0,4.0,4.0,917.0,3.0,0.0,0.0,207.0,Liga NOS,15-07-16,17.3.2.23,RÃºben Ribeiro,55003873,788,01-Aug-87,28,0,0,0,0,4400,6500,6500,132,130,856050,175,67,M/AM RLC,3,2,3,3,2,1,3,2,3,3,2,13,13,14,7,14,13,8,12,8,7,15,11,11,16,12,9,14,14,11,13,12,12,13,12,13,11,13,14,13,14,13,8,12,13,13,20,11,10,10,11,10,11,15,11,10,9,11,9,3,6,12,RÃºben Ribeiro,Â£1.13m ,Liga NOS
19-06-17,18.3.4.28,HÃ©lder Guedes,55004156,788,07-May-87,30,0,0,2,0,3800,6150,6150,124,123,232186002,182,75,AM/S L,3,3,4,2,3,1,3,1,1,1,1,9,11,14,13,13,11,13,10,4,6,13,17,6,14,13,14,13,9,11,12,13,15,11,10,14,11,15,14,13,12,13,12,10,13,13,20,12,11,12,8,11,10,10,19,13,11,10,10,9,9,8,1,1,1,17,13,17,10,AM/S L,623,1,1,20,10,17,13,1,1,1,1,1,1,1,1,1,17448305680.0,0,0,0,0,1,0,0,0,0,0,1,0,0,0,0,0,0,0,0,0,0,0,0,0,0,0,0,0,1,0,0,0,0,0,1,0,0,0,0,0,0,0,0,0,0,0,0,0,HÃ©lder Guedes,Â£1.35m ,33.0,184.0,Forward - Centre-Forward,right,GD Chaves,35.0,8.0,2.0,2175.0,36.0,12.0,8.0,2972.0,3.0,0.0,0.0,270.0,20.0,6.0,2.0,1048.0,2.0,0.0,0.0,134.0,Liga NOS,15-07-16,17.3.2.23,HÃ©lder Guedes,55004156,788,07-May-87,29,0,0,2,0,3800,5650,5650,118,116,115677,182,75,AM/S L,3,1,2,1,2,3,1,1,4,2,1,9,11,13,11,13,11,13,10,4,6,13,17,6,14,12,12,12,9,11,12,11,15,11,10,13,11,15,14,13,12,13,12,10,13,13,20,12,11,12,8,11,10,10,15,13,11,10,10,9,9,9,HÃ©lder Guedes,Â£1.13m ,Liga NOS
19-06-17,18.3.4.28,Yazalde,55008237,788,21-Sep-88,28,0,0,16,5,3500,5500,5500,124,110,96463,183,81,AM/S L,3,3,2,1,2,1,2,1,3,1,3,8,11,11,10,13,10,11,13,9,7,11,12,8,12,10,12,12,12,13,11,11,15,11,9,11,8,12,13,12,12,14,10,10,16,12,20,12,13,11,6,10,6,12,12,13,15,13,13,14,14,7,1,1,1,18,12,18,1,AM/S L,623,1,1,20,1,18,12,1,1,1,1,1,1,1,1,1,532480.0,0,0,0,0,0,0,0,0,0,0,0,0,0,1,0,0,0,0,0,1,0,0,0,0,0,0,0,0,0,0,0,0,0,0,0,0,0,0,0,0,0,0,0,0,0,0,0,0,Yazalde,Â£180Th. ,32.0,183.0,Forward - Centre-Forward,right,Without Club,19.0,1.0,0.0,900.0,9.0,1.0,1.0,364.0,25.0,6.0,1.0,765.0,37.0,6.0,5.0,2186.0,nan,nan,nan,nan,Liga NOS,15-07-16,17.3.2.23,Yazalde,55008237,788,21-Sep-88,27,0,0,16,5,3300,5500,5500,124,115,158388,183,81,AM/S L,1,2,3,1,3,2,3,1,1,1,1,8,11,12,10,13,10,11,13,9,7,11,12,8,12,10,12,12,12,13,11,11,15,11,9,11,8,12,13,13,12,14,10,11,16,12,20,13,13,11,6,10,6,12,12,13,15,13,13,14,14,6,Yazalde,Â£360Th. ,Liga NOS
19-06-17,18.3.4.28,LicÃ¡,55008674,788,08-Sep-88,28,1,0,5,1,3900,5650,5650,126,113,127152,181,71,AM RL,2,2,1,2,4,3,1,3,1,2,1,11,12,11,10,11,9,10,11,10,7,10,12,7,12,11,13,15,11,13,11,11,14,12,9,13,8,14,15,13,13,13,10,9,15,13,20,12,11,12,6,10,9,13,13,13,14,12,15,13,14,5,1,1,14,20,19,20,10,AM RL,505,1,1,10,10,20,19,1,1,1,1,1,14,13,1,1,549756000000.0,0,0,0,0,1,1,0,0,0,0,0,0,0,0,0,0,0,0,0,0,0,0,0,0,0,0,0,0,0,0,0,0,0,0,0,0,0,0,0,1,0,0,0,0,0,0,0,0,LicÃ¡,Â£450Th. ,32.0,181.0,Forward - Left Winger,right,Belenenses SAD,22.0,1.0,2.0,1376.0,17.0,3.0,2.0,1215.0,40.0,12.0,5.0,3344.0,36.0,8.0,3.0,2957.0,nan,nan,nan,nan,Liga NOS,15-07-16,17.3.2.23,LicÃ¡,55008674,788,08-Sep-88,27,1,0,5,1,3900,6000,6000,131,113,2294726,181,71,AM RL,2,1,2,1,1,3,1,2,3,2,3,11,11,10,10,11,8,10,11,8,7,10,12,8,12,11,13,15,11,13,12,11,14,12,7,13,7,14,15,12,13,13,10,12,15,13,20,12,12,12,6,10,9,13,10,13,14,10,15,11,14,5,LicÃ¡,Â£900Th. ,Liga NOS
19-06-17,18.3.4.28,Diogo Viana,55009686,788,22-Feb-90,27,0,0,8,0,4000,6250,6250,135,125,692078,173,65,AM RL,1,3,3,3,3,1,2,3,2,2,3,13,14,15,11,14,13,7,13,6,5,12,11,6,15,15,12,13,11,9,12,9,13,16,7,14,7,9,12,15,15,10,7,9,11,15,20,11,8,10,14,9,11,11,13,13,12,12,10,11,6,8,1,13,15,20,20,18,1,AM RL,505,1,1,10,1,18,20,1,1,1,1,1,15,15,1,13,549756000000.0,0,0,0,0,0,0,0,0,0,0,0,1,0,0,0,0,1,1,0,0,0,0,0,0,0,0,0,0,0,0,0,0,0,0,0,0,0,0,0,1,0,0,0,0,0,0,0,0,Diogo Viana,Â£900Th. ,30.0,174.0,Defender - Right-Back,right,Without Club,24.0,5.0,1.0,1546.0,31.0,0.0,2.0,2492.0,35.0,1.0,9.0,2715.0,8.0,0.0,0.0,571.0,nan,nan,nan,nan,Liga NOS,15-07-16,17.3.2.23,Diogo Viana,55009686,788,22-Feb-90,26,0,0,8,0,4000,5750,5800,124,117,70275,173,65,AM RL,1,4,4,1,4,1,1,1,1,2,2,13,14,15,12,14,12,7,13,6,5,12,11,6,15,12,11,11,12,9,12,10,11,16,7,14,7,10,10,14,16,10,7,7,11,13,20,11,8,10,11,9,11,11,10,13,12,12,10,11,10,8,Diogo Viana,Â£900Th. ,Liga NOS
19-06-17,18.3.4.28,Wilson Eduardo,55009688,788,08-Jul-90,26,0,0,14,6,3750,6300,5800,136,126,647863,179,73,M/AM/S RL,1,3,1,2,2,2,3,4,1,3,3,11,12,14,13,11,11,6,12,7,5,11,12,5,14,11,11,11,10,12,11,9,12,14,9,15,8,9,12,15,15,13,6,6,14,15,20,13,11,13,6,10,5,14,10,10,13,10,14,11,15,5,1,1,16,20,18,20,14,M/AM/S RL,535,1,1,17,14,20,18,1,1,1,1,1,14,16,1,1,8192.0,0,0,0,0,0,0,0,0,0,0,0,0,0,1,0,0,0,0,0,0,0,0,0,0,0,0,0,0,0,0,0,0,0,0,0,0,0,0,0,0,0,0,0,0,0,0,0,0,Wilson Eduardo,Â£3.60m ,30.0,179.0,Forward - Left Winger,right,Al-Ain FC,30.0,8.0,14.0,2233.0,21.0,8.0,3.0,1473.0,42.0,16.0,6.0,2914.0,31.0,8.0,2.0,1352.0,1.0,1.0,0.0,90.0,Liga NOS,15-07-16,17.3.2.23,Wilson Eduardo,55009688,788,08-Jul-90,26,0,0,13,6,3750,6750,6750,140,135,6306683,179,73,M/AM/S RL,3,1,3,3,2,3,4,2,3,2,3,12,13,14,13,12,11,7,13,7,5,12,13,5,14,11,13,11,12,12,12,12,12,14,9,15,8,10,13,15,15,13,9,6,14,15,20,13,12,13,6,10,5,14,7,10,13,10,14,11,15,5,Wilson Eduardo,Â£3.15m ,Liga NOS
19-06-17,18.3.4.28,RÃºben Lima,55009690,788,03-Oct-89,27,0,0,14,0,3750,5600,5600,117,112,163717,177,70,D/M/AM L,3,2,1,3,3,2,2,2,4,1,1,11,12,12,7,12,12,7,10,9,11,12,8,12,13,15,10,13,9,11,11,11,12,13,8,12,12,13,14,13,12,11,8,20,14,13,9,14,9,15,7,13,11,17,13,10,10,10,16,14,17,5,20,13,18,16,1,20,13,D/M/AM L,123,1,1,1,1,16,1,1,20,1,1,13,18,1,13,1,0.0,0,0,0,0,0,0,0,0,0,0,0,0,0,0,0,0,0,0,0,0,0,0,0,0,0,0,0,0,0,0,0,0,0,0,0,0,0,0,0,0,0,0,0,0,0,0,0,0,RÃºben Lima,Â£810Th. ,31.0,177.0,Defender - Left-Back,left,Belenenses SAD,38.0,0.0,3.0,3110.0,40.0,0.0,5.0,3609.0,21.0,0.0,1.0,1839.0,11.0,0.0,0.0,779.0,5.0,0.0,1.0,450.0,Liga NOS
19-06-17,18.3.4.28,Nuno Sequeira,55009772,788,19-Aug-90,26,0,0,0,0,3000,5850,5000,122,117,36165,184,79,D/WB L,1,3,3,2,1,2,1,2,2,2,4,13,13,14,9,12,13,8,11,11,9,12,8,11,13,14,12,11,13,12,12,12,13,13,8,13,11,13,11,14,13,12,12,20,13,13,5,13,13,12,13,10,6,12,12,13,11,12,12,14,10,6,20,16,15,15,5,20,1,D/WB L,113,1,1,12,1,15,5,1,20,1,1,1,15,1,16,1,68719476736.0,0,0,0,0,0,0,0,0,0,0,0,0,0,0,0,0,0,0,0,0,0,0,0,0,0,0,0,0,0,0,0,0,0,0,0,0,1,0,0,0,0,0,0,0,0,0,0,0,Nuno Sequeira,Â£810Th. ,30.0,184.0,Defender - Left-Back,left,SC Braga,29.0,0.0,0.0,2550.0,12.0,0.0,1.0,1010.0,40.0,1.0,10.0,3571.0,41.0,0.0,10.0,3455.0,6.0,0.0,1.0,524.0,Liga NOS,15-07-16,17.3.2.23,Nuno Sequeira,55009772,788,19-Aug-90,25,0,0,0,0,3000,5850,5800,122,117,148643,184,79,D/WB L,1,3,2,2,2,2,3,2,3,1,2,13,13,14,9,12,13,8,11,11,9,12,8,11,13,14,12,11,13,12,12,12,13,13,8,13,11,13,11,14,13,12,12,20,13,13,5,13,13,12,13,10,6,12,12,13,11,12,12,14,10,7,Nuno Sequeira,Â£900Th. ,Liga NOS
19-06-17,18.3.4.28,Sami,55011410,23,18-Dec-88,28,11,0,0,0,4750,6000,5650,122,113,209900,184,78,AM RL,2,2,2,1,1,1,2,4,1,3,2,10,12,12,11,12,11,8,12,7,6,12,12,8,12,12,11,12,9,10,8,9,14,13,7,13,8,10,13,14,12,13,10,10,14,14,20,13,12,10,8,11,7,11,13,14,14,13,14,14,14,5,1,1,1,20,20,17,10,AM RL,505,1,1,14,10,17,20,1,1,1,1,1,1,1,1,1,0.0,0,0,0,0,0,0,0,0,0,0,0,0,0,0,0,0,0,0,0,0,0,0,0,0,0,0,0,0,0,0,0,0,0,0,0,0,0,0,0,0,0,0,0,0,0,0,0,0,Sami,Â£180Th. ,31.0,184.0,Forward - Left Winger,right,Without Club,12.0,2.0,0.0,570.0,9.0,0.0,0.0,465.0,15.0,0.0,1.0,898.0,12.0,0.0,0.0,817.0,nan,nan,nan,nan,Liga NOS,15-07-16,17.3.2.23,Sami,55011410,23,18-Dec-88,27,10,0,0,0,4942,5992,5942,122,115,74373,184,78,AM RL,1,3,3,3,2,1,3,2,1,4,1,10,12,12,11,12,11,8,12,7,6,12,12,8,12,12,11,13,11,11,8,10,14,13,7,13,8,10,13,14,12,14,10,10,14,14,20,13,12,10,8,11,7,11,13,14,14,13,14,14,14,6,Sami,Â£900Th. ,Liga NOS
19-06-17,18.3.4.28,Pizzi,55012829,788,06-Oct-89,27,9,2,2,0,5600,7300,7300,156,146,36510240,177,70,M/AM RLC,2,1,2,2,1,3,3,1,2,2,1,12,14,15,13,15,14,7,14,7,8,15,13,8,16,13,12,12,15,12,16,12,13,14,8,14,12,14,13,13,14,14,9,13,13,12,20,14,11,12,6,12,7,11,16,12,14,11,15,12,13,7,1,1,20,20,20,16,20,M/AM RLC,416,1,1,5,19,16,20,1,1,1,2,20,10,13,1,1,140737000000000.0,0,0,0,1,0,0,0,0,0,0,1,0,0,0,0,0,0,0,0,1,1,0,0,0,0,0,0,0,0,0,0,0,0,0,0,0,0,0,0,0,0,0,0,0,0,0,0,1,Pizzi,Â£18.00m ,31.0,177.0,Midfielder - Right Midfield,right,SL Benfica,52.0,13.0,12.0,4251.0,45.0,6.0,12.0,3534.0,55.0,15.0,23.0,4215.0,51.0,30.0,19.0,4111.0,7.0,2.0,0.0,443.0,Liga NOS,15-07-16,17.3.2.23,Pizzi,55012829,788,06-Oct-89,26,4,1,2,0,5600,7000,7600,155,152,44999997,181,75,M/AM RLC,1,3,3,1,3,2,2,3,2,1,1,14,16,15,13,16,14,7,14,7,8,16,13,8,17,13,12,12,15,12,16,12,13,14,8,13,12,14,13,13,16,14,9,12,13,13,20,14,11,12,6,12,7,11,16,12,14,11,15,12,13,6,Pizzi,Â£18.00m ,Liga NOS
19-06-17,18.3.4.28,Renato Santos,55012992,788,05-Oct-91,25,0,0,0,0,4750,6250,6250,133,125,692078,181,73,M/AM RL,3,3,2,2,1,2,3,2,1,3,1,16,13,14,11,14,13,7,11,7,6,13,12,5,16,13,11,12,10,12,13,10,14,13,9,13,7,12,12,14,13,13,7,12,13,14,20,13,7,12,10,11,9,12,10,14,14,10,12,11,10,7,1,1,17,20,20,15,1,M/AM RL,525,1,1,10,1,15,20,1,1,1,1,1,14,17,1,1,1099510000000.0,0,0,0,0,0,0,0,0,0,0,0,0,0,0,0,0,0,0,0,0,0,0,0,0,0,0,0,0,0,0,0,0,0,0,0,0,0,0,0,0,1,0,0,0,0,0,0,0,Renato Santos,Â£900Th. ,29.0,175.0,Forward - Right Winger,right,Without Club,34.0,4.0,2.0,2683.0,27.0,6.0,1.0,2161.0,27.0,2.0,4.0,1467.0,33.0,0.0,3.0,1541.0,nan,nan,nan,nan,Liga NOS,15-07-16,17.3.2.23,Renato Santos,55012992,788,05-Oct-91,24,0,0,0,0,4400,6100,6100,133,122,459626,181,73,M/AM RL,1,2,3,1,1,2,3,2,3,1,1,16,13,14,11,14,13,7,11,7,6,13,12,5,16,13,11,12,9,12,13,9,14,13,9,13,7,12,12,14,13,13,7,12,13,14,20,12,7,12,10,11,9,12,10,14,14,10,12,11,10,6,Renato Santos,Â£900Th. ,Liga NOS
19-06-17,18.3.4.28,Pedro Tiba,55013997,788,31-Aug-88,28,0,0,0,0,4750,6050,6050,130,121,96231,174,70,DM/M RLC,2,1,1,1,3,3,1,1,1,1,1,11,10,12,10,12,11,9,11,6,8,13,12,11,13,10,12,12,13,13,12,12,16,13,10,13,12,14,14,13,14,13,7,10,13,12,20,14,10,14,9,13,6,16,17,12,13,14,17,16,11,5,1,1,20,15,15,15,20,DM/M RLC,426,1,1,1,10,15,15,1,1,1,17,20,10,10,1,1,0.0,0,0,0,0,0,0,0,0,0,0,0,0,0,0,0,0,0,0,0,0,0,0,0,0,0,0,0,0,0,0,0,0,0,0,0,0,0,0,0,0,0,0,0,0,0,0,0,0,Pedro Tiba,Â£1.58m ,32.0,174.0,Midfielder - Central Midfield,right,Lech Poznan,35.0,2.0,5.0,2382.0,34.0,11.0,7.0,2970.0,40.0,4.0,3.0,3490.0,37.0,2.0,10.0,3203.0,12.0,3.0,6.0,995.0,Liga NOS,15-07-16,17.3.2.23,Pedro Tiba,55013997,788,31-Aug-88,27,0,0,0,0,4750,6000,6000,130,120,77602,174,70,DM/M RLC,2,2,4,2,4,3,2,1,3,3,2,11,10,12,10,12,11,9,11,6,8,12,12,11,13,10,12,12,13,13,12,12,16,13,10,13,12,14,14,13,14,13,7,9,13,12,20,15,10,14,9,13,6,16,19,12,13,14,17,16,11,6,Pedro Tiba,Â£1.35m ,Liga NOS
19-06-17,18.3.4.28,Edgar Costa,55014155,788,14-Apr-87,30,0,0,0,0,3250,6000,6000,122,120,707618,178,74,AM RL,3,3,2,1,2,2,1,1,1,3,2,11,10,15,11,13,12,9,13,5,6,12,12,6,15,14,11,10,9,10,10,9,12,16,14,13,7,9,12,15,13,13,8,12,13,14,20,11,10,12,14,10,12,11,20,11,5,11,10,8,3,8,1,1,13,20,20,20,13,AM RL,505,1,1,13,13,20,20,1,1,1,1,1,13,13,1,1,1.44117e+17,0,0,0,0,0,0,0,0,0,1,0,0,0,0,0,0,0,0,0,0,0,0,0,0,0,0,0,0,0,0,0,0,0,0,0,0,0,0,0,0,0,1,0,0,0,0,0,0,Edgar Costa,Â£1.13m ,33.0,177.0,Midfielder - Right Midfield,right,CS MarÃ­timo,31.0,2.0,7.0,2372.0,28.0,2.0,4.0,1984.0,32.0,4.0,6.0,1981.0,30.0,0.0,2.0,1860.0,5.0,0.0,0.0,289.0,Liga NOS,15-07-16,17.3.2.23,Edgar Costa,55014155,788,14-Apr-87,29,0,0,0,0,3800,6100,6100,123,122,908877,178,74,AM RL,2,3,4,2,2,3,3,1,3,1,2,11,10,15,11,13,12,9,13,5,6,12,12,6,15,14,11,10,10,10,10,10,12,16,8,13,7,9,12,15,13,13,8,13,13,14,20,11,10,12,14,10,12,11,17,11,5,11,10,8,3,9,Edgar Costa,Â£1.35m ,Liga NOS
19-06-17,18.3.4.28,HÃ©ldon,55014369,12,14-Nov-88,28,46,15,10,8,4942,6920,6400,128,120,1617621,174,66,AM RL,2,1,1,1,1,2,3,2,4,3,3,10,11,14,12,13,12,7,11,5,5,12,12,4,14,8,11,9,10,10,11,9,12,18,9,14,7,9,11,15,15,12,8,11,13,15,20,12,7,11,7,14,10,10,13,12,12,12,13,7,9,5,1,1,14,20,19,20,7,AM RL,505,1,1,7,7,20,19,1,1,1,1,1,13,14,1,1,2251800000000000.0,0,0,0,1,1,0,0,0,0,0,1,0,0,0,0,0,0,0,0,0,0,0,0,0,0,0,0,0,0,0,0,0,0,0,0,0,0,0,0,0,0,0,0,0,0,0,0,0,HÃ©ldon,Â£1.35m ,31.0,174.0,Forward - Left Winger,right,FC Shabab Al-Ahli Dubai,33.0,2.0,6.0,2313.0,37.0,6.0,11.0,2581.0,32.0,12.0,12.0,2497.0,28.0,8.0,7.0,2287.0,1.0,0.0,0.0,90.0,Liga NOS,15-07-16,17.3.2.23,HÃ©ldon,55014369,12,14-Nov-88,27,42,15,10,8,4990,6986,6300,135,126,184998,174,68,AM RL,2,1,3,1,1,1,1,3,1,3,2,10,11,15,12,13,12,7,11,5,5,11,12,4,14,8,11,9,10,10,9,10,13,18,9,14,7,8,11,16,15,8,8,11,13,16,20,13,7,11,7,14,10,10,13,17,12,12,14,7,10,6,HÃ©ldon,Â£900Th. ,Liga NOS
19-06-17,18.3.4.28,Fredy,55017367,6,27-Mar-90,27,16,2,8,1,3500,5350,5350,113,112,92624,170,68,AM RL,1,2,3,2,2,1,2,2,1,2,3,12,11,14,9,12,10,9,11,7,6,10,12,6,14,11,10,11,10,10,10,8,14,13,8,13,6,9,13,16,14,11,10,6,14,15,20,10,10,9,7,12,7,11,13,16,12,14,12,13,13,5,1,1,1,20,20,20,1,AM RL,505,1,1,8,1,20,20,1,1,1,1,1,1,1,1,1,0.0,0,0,0,0,0,0,0,0,0,0,0,0,0,0,0,0,0,0,0,0,0,0,0,0,0,0,0,0,0,0,0,0,0,0,0,0,0,0,0,0,0,0,0,0,0,0,0,0,Fredy,Â£720Th. ,30.0,170.0,Midfielder - Attacking Midfield,right,Antalyaspor,33.0,2.0,4.0,2770.0,23.0,2.0,4.0,1808.0,33.0,8.0,6.0,2599.0,32.0,4.0,5.0,1905.0,4.0,0.0,2.0,346.0,Liga NOS
19-06-17,18.3.4.28,ZÃ© Manuel,55022020,788,23-Oct-90,26,0,0,0,0,3500,5750,5750,127,115,61267,181,72,AM/S RL,1,1,1,1,1,4,4,1,1,3,2,12,12,12,12,11,12,12,11,7,6,11,5,6,13,11,13,14,10,10,10,9,14,11,8,14,7,12,14,15,14,11,10,5,12,14,20,11,9,12,11,10,11,11,16,14,14,13,15,14,15,5,1,1,14,20,20,16,1,AM/S RL,515,1,1,18,1,16,20,1,1,1,1,1,11,14,1,1,2147483648.0,0,0,0,0,0,0,0,0,0,0,0,0,0,0,0,0,0,0,0,0,0,0,0,0,0,0,0,0,0,0,0,1,0,0,0,0,0,0,0,0,0,0,0,0,0,0,0,0,ZÃ© Manuel,Â£270Th. ,30.0,181.0,Forward - Centre-Forward,right,Gaz Metan Medias,33.0,3.0,3.0,1724.0,11.0,0.0,0.0,433.0,31.0,8.0,2.0,2369.0,30.0,5.0,1.0,1153.0,nan,nan,nan,nan,Liga NOS,15-07-16,17.3.2.23,ZÃ© Manuel,55022020,788,23-Oct-90,25,0,0,0,0,5000,6000,6000,128,120,367593,181,72,AM/S RL,2,3,3,3,2,3,1,1,1,2,3,12,12,12,12,11,12,12,11,7,6,11,7,6,13,11,13,14,10,10,10,9,11,11,8,14,7,12,14,15,14,11,10,8,12,14,20,12,9,12,11,10,10,11,12,12,9,10,11,12,13,3,ZÃ© Manuel,Â£810Th. ,Liga NOS
19-06-17,18.3.4.28,TozÃ©,55022422,788,14-Jan-93,24,0,0,12,0,4500,6200,6200,137,124,588174,174,66,M/AM LC,1,1,3,3,1,3,3,3,3,2,3,13,13,13,12,14,13,5,11,8,5,13,14,9,14,11,14,12,14,13,14,12,14,15,12,12,9,11,13,13,13,10,6,12,13,13,20,13,6,12,6,12,9,11,14,11,15,8,14,6,12,6,1,1,20,18,14,18,20,M/AM LC,414,1,1,1,18,18,14,1,1,1,1,20,5,5,1,1,1.44115e+17,0,0,0,0,0,0,0,0,1,0,0,0,0,0,0,0,0,0,0,0,0,0,0,0,0,0,0,0,0,0,0,0,0,0,0,0,0,0,0,0,0,0,0,0,0,0,0,0,TozÃ©,Â£900Th. ,27.0,174.0,Midfielder - Attacking Midfield,right,Al-Nasr (Dubai),16.0,0.0,1.0,576.0,32.0,11.0,6.0,2659.0,35.0,9.0,3.0,2827.0,19.0,5.0,2.0,1653.0,1.0,0.0,0.0,90.0,Liga NOS,15-07-16,17.3.2.23,TozÃ©,55022422,788,14-Jan-93,23,0,0,12,0,4500,5500,5500,137,117,445255,174,66,M/AM LC,3,1,3,1,3,3,1,3,4,2,1,13,13,13,12,14,13,5,11,8,5,13,14,9,14,11,14,12,14,13,14,12,14,15,12,12,9,11,13,11,13,8,6,12,13,11,20,13,6,12,6,12,7,11,9,11,15,8,14,6,12,5,TozÃ©,Â£720Th. ,Liga NOS
19-06-17,18.3.4.28,JoÄo Carlos Teixeira,55022472,788,18-Jan-93,24,0,0,2,1,3750,6550,6050,144,131,912427,177,70,M/AM LC,2,2,3,1,1,2,1,3,2,1,1,14,13,15,11,15,12,5,10,4,6,15,10,9,16,8,12,11,16,10,17,14,11,14,8,13,8,13,12,12,14,12,7,13,10,11,20,11,8,10,7,8,12,9,12,13,10,13,13,12,14,8,1,1,18,20,13,19,20,M/AM LC,524,1,1,1,20,19,13,1,1,1,1,18,12,8,1,1,0.0,0,0,0,0,0,0,0,0,0,0,0,0,0,0,0,0,0,0,0,0,0,0,0,0,0,0,0,0,0,0,0,0,0,0,0,0,0,0,0,0,0,0,0,0,0,0,0,0,JoÃ£o Carlos Teixeira,Â£900Th. ,27.0,177.0,Midfielder - Attacking Midfield,right,Feyenoord Rotterdam,10.0,0.0,1.0,166.0,23.0,1.0,2.0,1135.0,23.0,0.0,0.0,701.0,30.0,10.0,3.0,1716.0,6.0,0.0,2.0,349.0,Liga NOS,15-07-16,17.3.2.23,JoÄo Carlos Teixeira,55022472,788,18-Jan-93,23,0,0,0,0,3350,6550,6550,144,131,3743573,177,70,M/AM LC,2,3,1,2,1,2,4,1,4,3,1,14,13,15,11,15,12,5,10,4,6,15,10,9,16,8,12,11,16,10,17,14,11,14,8,13,8,13,12,12,14,12,7,13,10,11,20,11,8,10,7,8,12,9,9,13,10,13,13,12,14,8,JoÃ£o Carlos Teixeira,Â£900Th. ,Liga NOS
19-06-17,18.3.4.28,LuÃ­s AurÃ©lio,55023146,788,17-Aug-88,28,0,0,1,0,3500,5650,5650,120,113,166613,179,72,M/AM RLC,2,1,1,4,3,3,1,1,3,2,2,9,13,11,8,11,9,9,11,12,13,12,7,12,12,13,13,14,12,13,8,11,14,12,8,13,13,15,15,13,12,12,9,7,13,13,20,13,12,15,7,13,9,15,14,15,11,13,15,14,13,8,1,1,20,18,18,15,20,M/AM RLC,416,1,1,1,12,15,18,1,1,1,10,20,12,14,1,1,2147483648.0,0,0,0,0,0,0,0,0,0,0,0,0,0,0,0,0,0,0,0,0,0,0,0,0,0,0,0,0,0,0,0,1,0,0,0,0,0,0,0,0,0,0,0,0,0,0,0,0,LuÃ­s AurÃ©lio,Â£450Th. ,32.0,179.0,Midfielder - Central Midfield,right,CFR Cluj,35.0,0.0,2.0,2563.0,28.0,0.0,2.0,1828.0,36.0,1.0,1.0,2909.0,19.0,1.0,0.0,922.0,1.0,0.0,0.0,23.0,Liga NOS,15-07-16,17.3.2.23,LuÃ­s AurÃ©lio,55023146,788,17-Aug-88,27,0,0,1,0,3500,5850,5850,120,112,250588,179,72,M/AM RLC,3,1,2,1,3,3,2,3,3,1,2,9,12,12,8,11,8,8,11,12,10,12,7,8,12,12,13,14,14,13,10,12,14,12,8,13,12,13,14,13,12,12,9,8,13,13,20,12,12,15,7,13,10,15,13,15,11,13,15,14,13,9,LuÃ­s AurÃ©lio,Â£540Th. ,Liga NOS
19-06-17,18.3.4.28,ArsÃ©nio,55023250,788,30-Aug-89,27,0,0,0,0,4000,5600,5750,118,115,245068,180,73,M/AM RLC,1,1,3,2,1,1,3,2,2,1,4,13,12,14,11,14,11,12,13,7,7,12,11,7,14,10,11,9,13,11,12,11,13,13,7,14,9,10,12,13,14,10,10,6,13,13,20,12,10,11,10,13,7,13,14,14,13,11,15,10,10,7,1,1,16,20,20,20,16,M/AM RLC,526,1,1,9,16,20,20,1,1,1,1,12,15,16,1,1,1.44115e+17,0,0,0,0,0,0,0,0,0,0,0,0,0,0,0,0,0,0,0,0,0,0,0,0,0,0,0,0,0,0,0,0,0,0,0,0,0,0,0,0,0,0,0,0,0,0,0,0,ArsÃ©nio,Â£810Th. ,31.0,180.0,Forward - Right Winger,right,Al-Feiha FC,28.0,4.0,6.0,1934.0,35.0,5.0,2.0,2472.0,33.0,4.0,5.0,2495.0,29.0,1.0,2.0,2333.0,nan,nan,nan,nan,Liga NOS
19-06-17,18.3.4.28,Vasco Rocha,55023578,788,29-Jan-89,28,0,0,0,0,2250,5300,5300,110,106,107188,182,74,M/AM LC,4,1,2,3,1,1,2,2,3,1,4,8,10,12,7,11,7,7,9,7,8,12,11,7,12,13,12,12,13,12,14,12,12,13,11,14,13,12,12,12,13,14,10,8,15,12,20,12,12,11,5,16,7,17,13,14,11,12,12,10,10,5,1,1,20,16,12,16,20,M/AM LC,414,1,1,11,15,16,12,1,1,1,7,20,13,10,1,1,549756000000.0,0,0,0,0,0,0,0,0,0,0,0,0,0,0,0,0,0,0,0,0,0,0,0,0,0,0,0,0,0,0,0,0,0,0,0,0,0,0,0,1,0,0,0,0,0,0,0,0,Vasco Rocha,Â£360Th. ,31.0,182.0,Midfielder - Central Midfield,right,CD Trofense,25.0,1.0,0.0,1831.0,27.0,0.0,1.0,1770.0,32.0,1.0,0.0,1250.0,13.0,0.0,0.0,514.0,nan,nan,nan,nan,Liga NOS,15-07-16,17.3.2.23,Vasco Rocha,55023578,788,29-Jan-89,27,0,0,0,0,2313,4216,4100,110,104,7853,182,74,M/AM LC,2,3,1,3,2,2,2,1,1,1,1,8,10,12,7,11,7,7,9,7,8,12,11,7,12,13,12,12,13,12,14,12,12,13,11,14,13,12,12,12,13,14,10,7,15,12,20,12,12,11,5,16,7,17,19,14,12,11,9,10,15,7,Vasco Rocha,Â£720Th. ,Liga NOS
19-06-17,18.3.4.28,Filipe Ferreira,55024022,788,27-Sep-90,26,0,0,2,0,3250,5450,5450,115,109,75714,178,72,D/AM L,1,3,3,2,2,1,1,3,3,2,2,11,12,12,7,12,10,8,12,12,7,11,11,11,14,13,12,11,11,10,10,12,13,10,7,13,9,12,12,14,13,11,8,20,12,14,5,12,7,11,10,10,7,13,13,12,13,13,13,11,11,7,20,9,13,18,1,20,1,D/AM L,113,1,1,1,1,18,1,1,20,1,1,1,13,1,9,1,0.0,0,0,0,0,0,0,0,0,0,0,0,0,0,0,0,0,0,0,0,0,0,0,0,0,0,0,0,0,0,0,0,0,0,0,0,0,0,0,0,0,0,0,0,0,0,0,0,0,Filipe Ferreira,Â£630Th. ,30.0,178.0,Defender - Left-Back,left,CD Tondela,25.0,0.0,2.0,2262.0,14.0,0.0,1.0,1131.0,11.0,0.0,0.0,790.0,30.0,0.0,0.0,2382.0,5.0,1.0,0.0,360.0,Liga NOS,15-07-16,17.3.2.23,Filipe Ferreira,55024022,788,27-Sep-90,25,0,0,2,0,3250,5650,5650,120,113,110278,178,72,D/AM L,2,2,2,3,1,1,2,1,1,3,2,11,12,12,7,12,10,8,12,12,7,12,12,12,14,13,12,12,13,11,10,13,13,10,7,13,10,12,12,14,12,11,8,20,12,14,5,12,10,11,10,10,7,13,15,12,13,13,13,11,11,8,Filipe Ferreira,Â£900Th. ,Liga NOS
19-06-17,18.3.4.28,AndrÃ© Claro,55024507,788,31-Mar-91,26,0,0,0,0,4400,5850,5850,125,117,281029,183,74,M/AM/S RLC,3,1,2,2,1,1,3,2,1,3,2,10,12,12,13,12,7,12,10,9,6,13,18,7,12,12,12,12,13,12,11,11,14,11,9,14,8,12,14,12,12,13,12,7,13,12,20,12,11,14,5,10,5,17,16,15,11,13,15,13,14,8,1,1,17,20,18,20,17,M/AM/S RLC,536,1,1,18,17,20,18,1,1,1,1,17,14,12,1,1,4947800000000.0,0,0,0,0,0,0,0,0,1,0,0,0,0,0,0,0,0,0,0,1,0,0,0,0,0,0,0,0,0,0,0,0,0,0,0,0,0,0,0,1,0,0,1,0,0,0,0,0,AndrÃ© Claro,Â£450Th. ,29.0,183.0,Forward - Second Striker,right,UD Vilafranquense,28.0,7.0,4.0,1767.0,28.0,1.0,1.0,1418.0,19.0,1.0,0.0,650.0,25.0,9.0,2.0,2058.0,7.0,1.0,0.0,377.0,Liga NOS,15-07-16,17.3.2.23,AndrÃ© Claro,55024507,788,31-Mar-91,25,0,0,0,0,4400,6400,6400,132,128,884990,183,74,M/AM/S RL,3,3,3,1,2,1,3,3,1,1,2,10,12,12,14,12,7,13,11,8,7,13,18,7,12,12,14,14,13,12,11,12,14,11,9,14,8,12,15,13,12,13,12,9,13,12,20,14,11,15,7,8,5,13,16,15,11,13,15,13,12,8,AndrÃ© Claro,Â£1.35m ,Liga NOS
19-06-17,18.3.4.28,JoÄo Teixeira,55024870,788,06-Feb-94,23,0,0,3,0,4000,5750,5750,135,115,263448,178,70,M/AM LC,2,2,1,1,2,1,1,2,1,3,1,11,11,13,7,13,11,5,8,4,7,13,10,10,15,14,13,13,8,9,14,12,14,14,11,14,11,13,12,12,14,12,7,13,12,13,20,12,6,7,8,13,7,8,12,12,15,9,15,13,11,5,1,1,19,20,14,15,20,M/AM LC,524,1,1,1,20,15,14,1,1,1,5,19,1,1,1,1,137439000000.0,0,0,1,0,0,0,0,0,0,0,0,0,0,0,0,0,0,0,0,0,0,0,0,0,0,0,0,0,0,0,0,0,0,0,0,0,0,1,0,0,0,0,0,0,0,0,0,0,JoÃ£o Teixeira,Â£810Th. ,26.0,178.0,Midfielder - Attacking Midfield,right,GD Chaves,20.0,2.0,2.0,1005.0,29.0,2.0,1.0,2154.0,13.0,1.0,1.0,389.0,25.0,1.0,1.0,1726.0,7.0,2.0,2.0,503.0,Liga NOS
19-06-17,18.3.4.28,FÃ¡bio Martins,55028042,788,24-Jul-93,23,0,0,1,0,3600,6450,5950,140,130,1160156,178,72,AM RL,2,1,3,3,3,2,2,1,2,1,3,12,14,16,12,15,12,7,14,7,8,13,12,10,15,13,12,9,12,11,13,12,14,17,8,13,7,8,11,15,15,13,6,6,12,15,20,12,7,12,13,13,8,12,12,15,13,13,18,17,15,10,1,1,13,20,19,20,12,AM RL,505,1,1,12,12,20,19,1,1,1,1,1,12,13,1,1,2251830000000000.0,0,0,0,1,1,0,0,0,0,0,0,0,0,0,0,0,0,0,0,0,0,0,0,0,0,0,0,0,0,0,0,0,0,0,0,1,0,0,0,0,0,0,0,0,0,0,0,0,FÃ¡bio Martins,Â£1.80m ,27.0,177.0,Forward - Left Winger,right,Al-Shabab Riyadh,36.0,8.0,3.0,2647.0,40.0,7.0,5.0,1708.0,16.0,1.0,1.0,533.0,36.0,12.0,6.0,3113.0,1.0,0.0,0.0,64.0,Liga NOS,15-07-16,17.3.2.23,FÃ¡bio Martins,55028042,788,24-Jul-93,22,0,0,1,0,3600,6450,6450,140,129,958715,178,72,AM RL,2,1,1,2,1,3,2,3,2,1,2,12,12,16,12,16,12,11,12,7,5,13,12,6,16,13,12,9,12,11,12,11,13,17,8,13,7,8,11,15,16,13,6,8,12,14,20,12,8,12,13,13,8,12,18,15,13,13,15,11,11,10,FÃ¡bio Martins,Â£1.58m ,Liga NOS
19-06-17,18.3.4.28,VÃ­tor Bruno,55029391,788,13-Jan-90,27,0,0,0,0,4000,5900,5900,122,115,294147,171,69,D/M/AM L,3,2,2,1,4,2,1,2,3,1,1,12,12,11,7,11,13,8,13,9,11,11,9,13,12,17,15,15,12,13,10,12,16,12,10,12,12,14,14,13,12,12,7,20,12,13,5,14,9,13,7,12,8,12,14,14,8,13,14,14,8,6,20,15,18,20,13,20,1,D/M/AM L,123,1,1,1,1,20,13,1,20,1,1,1,18,13,15,1,256.0,0,0,0,0,0,0,0,0,1,0,0,0,0,0,0,0,0,0,0,0,0,0,0,0,0,0,0,0,0,0,0,0,0,0,0,0,0,0,0,0,0,0,0,0,0,0,0,0,VÃ­tor Bruno,Â£360Th. ,30.0,171.0,Defender - Left-Back,left,UD Vilafranquense,35.0,1.0,8.0,3111.0,17.0,0.0,1.0,917.0,33.0,1.0,2.0,2716.0,22.0,0.0,2.0,1609.0,6.0,0.0,1.0,525.0,Liga NOS,15-07-16,17.3.2.23,VÃ­tor Bruno,55029391,788,13-Jan-90,26,0,0,0,0,4000,5000,5000,116,109,27585,171,69,D/M/AM L,3,2,1,1,3,2,1,3,2,3,3,12,12,11,7,10,13,8,13,9,11,11,9,12,12,14,12,13,13,12,10,12,16,12,10,12,12,12,12,13,12,12,7,20,12,13,5,12,9,13,7,12,8,12,14,14,10,13,14,14,12,5,VÃ­tor Bruno,Â£720Th. ,Liga NOS
19-06-17,18.3.4.28,HernÃ¢ni,55030095,788,20-Aug-91,25,0,0,0,0,4250,6350,6350,135,127,567313,180,72,AM RL,2,2,2,3,2,3,1,3,2,4,3,14,14,15,11,14,11,10,12,8,7,12,12,7,15,10,12,8,11,10,12,11,11,16,8,14,8,9,10,15,15,13,10,20,13,16,5,11,10,9,8,13,8,14,11,14,10,14,10,11,10,10,1,1,14,20,20,19,7,AM RL,505,1,1,10,7,19,20,1,1,1,1,1,14,14,1,1,2.8823e+17,0,0,0,0,0,0,0,0,0,1,0,0,0,0,0,0,0,0,0,0,0,0,0,0,0,0,0,0,0,0,0,0,0,0,0,0,0,0,0,0,0,0,0,0,0,0,0,0,HernÃ¢ni,Â£2.25m ,29.0,180.0,Forward - Right Winger,left,Al-Wahda Mekka,35.0,12.0,7.0,2390.0,20.0,1.0,1.0,679.0,23.0,4.0,3.0,486.0,23.0,3.0,2.0,887.0,2.0,0.0,0.0,141.0,Liga NOS,15-07-16,17.3.2.23,HernÃ¢ni,55030095,788,20-Aug-91,24,0,0,0,0,4500,6300,6300,137,126,1368988,180,72,AM RL,3,1,2,1,1,1,1,2,2,1,1,14,14,15,11,14,11,10,12,8,7,12,12,7,15,10,12,8,10,9,12,10,11,16,8,14,8,9,10,15,15,12,10,20,13,16,5,12,11,9,8,13,8,14,10,14,10,14,10,11,10,10,HernÃ¢ni,Â£3.15m ,Liga NOS
19-06-17,18.3.4.28,Ricardo Valente,55032934,788,03-Apr-91,26,0,0,0,0,3000,6250,6250,130,125,1799404,181,76,AM/S RL,3,2,3,2,1,2,3,3,1,1,3,11,11,13,13,12,8,13,12,8,8,11,10,8,12,15,14,15,8,11,12,8,18,11,8,15,8,9,15,14,13,13,11,10,13,14,20,14,11,12,11,10,5,14,16,13,10,13,11,14,10,10,1,1,13,20,19,20,12,AM/S RL,515,1,1,17,12,20,19,1,1,1,1,1,12,13,1,1,549756000000.0,0,0,0,1,0,0,0,0,0,0,0,0,0,0,0,0,0,0,0,1,0,0,0,0,0,0,0,0,0,0,0,0,0,0,0,0,0,0,0,1,0,0,0,0,0,0,0,0,Ricardo Valente,Â£1.35m ,29.0,181.0,Forward - Left Winger,right,Gaz Metan Medias,32.0,4.0,0.0,1831.0,42.0,9.0,5.0,2972.0,17.0,2.0,0.0,768.0,22.0,2.0,2.0,1267.0,nan,nan,nan,nan,Liga NOS,15-07-16,17.3.2.23,Ricardo Valente,55032934,788,03-Apr-91,25,0,0,0,0,3350,5700,5700,126,117,125704,181,76,AM/S RL,3,3,2,3,2,1,4,2,2,1,1,11,12,12,13,12,8,12,12,8,8,12,10,8,12,15,14,15,8,12,12,8,18,11,8,15,8,9,15,13,12,13,10,10,13,12,20,14,11,12,11,10,5,14,16,13,10,13,11,14,18,11,Ricardo Valente,Â£900Th. ,Liga NOS
19-06-17,18.3.4.28,Rafa Soares,55038684,788,09-May-95,22,0,0,9,0,4000,6150,6150,145,123,464951,182,74,D/WB/M L,3,3,2,1,1,1,1,1,1,1,2,14,15,13,10,14,14,9,13,12,10,14,12,13,14,12,12,11,13,13,13,13,12,10,13,12,11,12,11,12,13,13,12,20,12,12,8,12,11,13,10,13,6,12,8,10,14,12,15,11,12,5,20,18,16,10,1,20,1,D/WB/M L,123,1,1,1,1,10,1,1,20,1,1,1,16,1,18,1,0.0,0,0,0,0,0,0,0,0,0,0,0,0,0,0,0,0,0,0,0,0,0,0,0,0,0,0,0,0,0,0,0,0,0,0,0,0,0,0,0,0,0,0,0,0,0,0,0,0,Rafa Soares,Â£1.35m ,25.0,178.0,Defender - Left-Back,left,SD Eibar,38.0,3.0,5.0,3450.0,19.0,0.0,2.0,1388.0,31.0,0.0,5.0,2641.0,23.0,0.0,2.0,1654.0,3.0,0.0,0.0,181.0,Liga NOS,15-07-16,17.3.2.23,Rafa Soares,55038684,788,09-May-95,21,0,0,9,0,4300,6150,6150,145,123,1139648,182,74,D/WB/M L,2,3,1,2,3,1,1,2,1,2,2,14,15,13,10,14,14,9,13,12,10,14,12,13,14,12,12,11,13,13,13,13,12,10,13,12,11,12,11,12,13,13,12,20,12,12,8,12,11,13,10,13,6,12,20,10,14,12,15,11,12,5,Rafa Soares,Â£1.80m ,Liga NOS
19-06-17,18.3.4.28,Rafinha,55041600,788,30-Apr-92,25,0,0,0,0,1000,4750,4750,114,100,32931,166,58,AM RLC,4,3,1,3,4,2,3,3,4,1,3,10,12,13,11,12,10,8,9,3,4,11,10,6,14,4,10,5,10,10,11,9,12,12,5,12,6,8,9,15,14,11,5,20,12,14,6,10,5,9,4,10,10,11,10,13,11,10,12,12,13,5,1,1,13,20,15,20,18,AM RLC,506,1,1,13,18,20,15,1,1,1,1,1,13,13,1,1,0.0,0,0,0,0,0,0,0,0,0,0,0,0,0,0,0,0,0,0,0,0,0,0,0,0,0,0,0,0,0,0,0,0,0,0,0,0,0,0,0,0,0,0,0,0,0,0,0,0,Rafinha,Â£25.20m ,27.0,174.0,Midfielder - Attacking Midfield,left,Paris Saint-Germain,28.0,7.0,5.0,1567.0,18.0,2.0,3.0,1062.0,8.0,1.0,0.0,348.0,33.0,4.0,2.0,2344.0,3.0,0.0,1.0,154.0,Serie A,15-07-16,17.3.2.23,Rafinha,67100016,1651,12-Feb-93,23,2,1,5,0,6800,7200,7550,167,153,42867644,174,71,M/AM RLC,1,1,1,2,2,2,1,2,1,3,2,14,15,16,11,15,13,11,12,8,8,15,13,12,15,16,12,14,12,13,14,13,14,13,11,13,12,14,17,15,13,14,8,20,14,13,8,16,12,13,11,14,6,14,13,13,12,12,13,12,13,7,Rafinha,Â£13.50m ,LaLiga
19-06-17,18.3.4.28,Xavier,55042759,788,06-Jul-92,24,0,0,0,0,3250,5600,5600,118,112,245575,181,73,M/AM RL,1,1,2,3,3,1,3,1,3,3,1,15,15,12,10,14,15,7,13,6,5,13,11,6,15,11,9,9,14,9,13,13,9,14,8,10,7,13,9,12,13,12,11,20,12,12,8,10,12,11,5,11,3,8,16,12,11,12,12,10,6,7,1,1,18,20,15,20,12,M/AM RL,525,1,1,5,12,20,15,1,1,1,1,1,18,8,1,1,1099510000000.0,0,0,0,0,0,0,0,0,0,0,0,0,0,0,0,0,0,0,0,0,0,0,0,0,0,0,0,0,0,0,0,0,0,0,0,0,0,0,0,0,1,0,0,0,0,0,0,0,Xavier,Â£720Th. ,28.0,176.0,Forward - Left Winger,left,Panathinaikos Athens,34.0,1.0,5.0,1770.0,37.0,1.0,11.0,2984.0,38.0,7.0,10.0,2879.0,26.0,1.0,2.0,1564.0,3.0,0.0,0.0,114.0,Liga NOS
19-06-17,18.3.4.28,LuÃ­s Machado,55045475,788,04-Nov-92,24,0,0,0,0,2500,5600,5300,122,112,124458,168,64,M/AM RL,1,2,1,2,1,1,3,3,1,3,1,8,12,14,9,13,8,8,9,6,7,12,11,3,13,10,11,12,12,12,12,11,14,14,8,14,10,10,12,14,13,11,7,8,13,14,20,12,8,10,5,12,5,13,14,12,10,10,15,16,14,5,1,1,17,20,20,16,6,M/AM RL,525,1,1,1,6,16,20,1,1,1,1,1,16,17,1,1,549756000000.0,1,0,0,0,0,0,0,0,0,0,0,0,0,0,0,0,0,0,0,0,0,0,0,0,0,0,0,0,0,0,0,0,0,0,0,0,0,0,0,1,0,0,0,0,0,0,0,0,LuÃ­s Machado,Â£630Th. ,27.0,171.0,Forward - Left Winger,right,NorthEast United FC,32.0,2.0,7.0,2154.0,32.0,3.0,2.0,1833.0,32.0,3.0,1.0,2409.0,24.0,1.0,3.0,1217.0,nan,nan,nan,nan,Liga NOS,15-07-16,17.3.2.23,LuÃ­s Machado,55045475,788,04-Nov-92,23,0,0,0,0,3252,4754,4750,115,106,46632,168,64,M/AM RL,1,4,1,1,1,1,2,2,2,3,2,8,12,13,9,12,8,8,9,6,7,12,11,3,12,10,11,12,12,12,12,11,14,13,8,13,12,10,12,13,13,9,5,10,13,13,20,12,8,10,5,12,5,13,14,12,10,10,15,16,14,4,LuÃ­s Machado,Â£540Th. ,Liga NOS
19-06-17,18.3.4.28,Costinha,55045820,788,25-Aug-92,24,0,0,0,0,4300,6600,6600,136,132,2012769,170,65,AM RLC,1,1,3,3,3,2,3,1,3,4,3,12,13,15,11,13,13,8,13,2,6,14,12,9,15,12,11,12,12,13,14,14,14,15,11,14,7,12,12,15,15,12,5,11,14,14,20,12,7,14,6,13,4,8,15,14,13,14,15,12,14,6,1,1,14,20,15,15,20,AM RLC,506,1,1,10,20,15,15,1,1,1,1,14,7,12,1,1,1.44186e+17,0,0,0,0,0,0,0,0,1,1,0,0,0,0,0,0,0,0,0,0,0,0,0,0,0,0,0,0,0,0,0,0,0,0,0,1,0,0,0,0,0,0,0,0,0,0,1,0,Costinha,Â£1.35m ,28.0,170.0,Midfielder - Attacking Midfield,right,CD Santa Clara,36.0,1.0,3.0,3143.0,38.0,2.0,6.0,3209.0,24.0,2.0,0.0,1219.0,29.0,1.0,5.0,2117.0,4.0,0.0,0.0,166.0,Liga NOS,15-07-16,17.3.2.23,Costinha,55045820,788,25-Aug-92,23,0,0,0,0,4300,6450,6450,135,129,2492660,170,65,AM RLC,1,3,1,3,4,1,2,1,3,3,3,12,13,15,11,13,13,11,12,2,6,14,12,9,15,12,11,13,11,13,11,12,14,14,4,14,7,11,12,16,15,11,5,11,13,15,20,12,7,11,6,10,11,8,15,14,11,11,15,12,11,5,Costinha,Â£1.13m ,Liga NOS
19-06-17,18.3.4.28,Kuca,55046002,12,02-Aug-89,27,16,2,0,0,3500,5600,5600,117,112,139640,181,70,AM RL,2,1,2,3,1,1,1,3,2,3,2,12,11,13,12,13,10,8,10,6,6,11,12,7,13,8,12,11,12,9,12,10,9,15,9,14,8,11,11,13,13,10,11,12,13,13,20,12,8,9,7,10,9,13,8,12,7,11,7,14,14,12,1,1,12,20,18,20,14,AM RL,505,1,1,1,14,20,18,1,1,1,1,1,12,12,1,1,1.44115e+17,0,0,0,1,0,0,0,0,0,0,0,0,0,0,0,0,0,0,0,0,0,0,0,0,0,0,0,0,0,0,0,0,0,0,0,0,0,0,0,0,0,0,0,0,0,0,0,0,Kuca,Â£720Th. ,31.0,181.0,Forward - Left Winger,right,Without Club,28.0,8.0,1.0,1359.0,32.0,3.0,1.0,1632.0,5.0,1.0,0.0,150.0,nan,nan,nan,nan,nan,nan,nan,nan,Liga NOS,15-07-16,17.3.2.23,Kuca,55046002,12,02-Aug-89,26,12,1,0,0,2700,5700,5750,117,115,236793,181,70,AM RL,3,1,1,2,1,2,2,2,3,3,1,13,11,14,12,14,10,8,10,6,6,11,12,7,14,8,12,11,12,9,12,10,9,15,9,14,8,11,12,13,13,10,11,12,13,13,20,12,8,9,7,10,9,13,7,14,7,11,11,14,14,5,Kuca,Â£720Th. ,Liga NOS
19-06-17,18.3.4.28,Paulinho,55060769,788,09-Nov-92,24,0,0,1,0,3500,6500,6500,140,130,2025161,187,75,AM/S RL,2,3,3,3,3,2,2,3,3,2,2,12,13,13,14,13,13,13,13,9,7,13,12,8,14,13,12,12,13,14,12,13,14,14,15,13,12,13,11,12,12,13,13,20,11,11,10,13,12,14,6,11,10,12,12,16,13,14,14,15,14,7,1,1,10,19,19,19,1,AM/S RL,625,1,1,20,1,19,19,1,1,1,1,1,10,5,1,1,2.8823e+17,0,0,0,0,0,0,0,0,0,0,1,0,0,0,0,0,0,0,0,0,0,0,0,0,0,0,0,0,0,0,0,0,0,0,0,1,0,0,0,0,0,0,0,0,0,0,0,0,Paulinho,Â£36.00m ,32.0,183.0,Midfielder - Central Midfield,right,Guangzhou Evergrande Taobao,29.0,12.0,5.0,2610.0,68.0,22.0,10.0,4263.0,42.0,22.0,8.0,3632.0,16.0,10.0,4.0,1406.0,nan,nan,nan,nan,LaLiga,15-07-16,17.3.2.23,Paulinho,55013000,788,13-Jul-91,25,0,0,0,0,3500,6100,6100,138,122,801471,176,69,D R,3,2,1,2,1,3,2,1,3,1,4,9,12,12,6,10,8,10,8,12,12,11,8,13,13,12,12,13,12,11,11,12,15,10,10,14,13,15,15,14,13,13,8,8,14,15,20,15,10,15,9,13,2,11,13,14,11,14,14,10,12,4,Paulinho, ,Premier League
19-06-17,18.3.4.28,Wilson ManafÃ¡,55061773,788,23-Jul-94,22,0,0,0,0,2750,5000,5000,115,109,102501,173,70,D/M/AM RL,2,3,2,4,3,3,2,2,2,3,3,6,10,9,8,8,8,11,9,10,8,10,8,12,12,13,10,12,11,10,9,7,11,10,7,13,11,12,10,16,12,10,11,6,14,16,20,12,10,8,8,9,6,14,14,9,9,7,13,11,11,3,20,12,16,19,20,17,10,D/M/AM RL,125,1,1,1,10,17,19,1,1,20,1,1,1,16,1,12,0.0,0,0,0,0,0,0,0,0,0,0,0,0,0,0,0,0,0,0,0,0,0,0,0,0,0,0,0,0,0,0,0,0,0,0,0,0,0,0,0,0,0,0,0,0,0,0,0,0,Wilson ManafÃ¡,Â£270Th. ,26.0,177.0,Defender - Right-Back,right,FC Porto,39.0,3.0,3.0,1958.0,22.0,0.0,3.0,685.0,34.0,3.0,5.0,2522.0,45.0,1.0,1.0,3190.0,6.0,0.0,1.0,467.0,Liga NOS
19-06-17,18.3.4.28,JoÄo Amaral,55062615,788,07-Sep-91,25,0,0,0,0,3350,6400,6400,130,128,915917,172,0,AM RL,3,1,1,1,3,2,1,3,1,3,1,11,12,16,12,13,8,4,11,5,5,12,11,6,16,12,12,11,12,9,12,12,14,16,9,15,6,11,11,16,16,12,6,5,13,16,20,11,7,12,7,11,9,8,13,12,10,16,16,11,14,10,1,1,10,20,20,18,1,AM RL,505,1,1,12,1,18,20,1,1,1,1,1,7,10,1,1,1.46385e+17,0,0,0,0,0,0,0,0,0,0,0,0,0,0,1,0,0,0,0,0,0,0,0,0,0,0,0,0,0,0,0,0,0,0,0,0,0,0,0,0,0,0,0,0,1,0,0,0,JoÃ£o Amaral,Â£1.35m ,29.0,172.0,Forward - Right Winger,both,FC PaÃ§os de Ferreira,36.0,5.0,2.0,2522.0,40.0,9.0,4.0,2805.0,30.0,10.0,5.0,2096.0,38.0,4.0,9.0,2166.0,3.0,0.0,1.0,202.0,Liga NOS,15-07-16,17.3.2.23,JoÄo Amaral,55062615,788,07-Sep-91,24,0,0,0,0,3350,6300,6300,130,126,1923984,172,67,AM RL,2,3,1,1,1,1,3,1,1,2,2,11,12,16,10,13,8,4,11,5,5,12,11,6,16,12,12,11,10,9,12,11,14,16,9,13,6,11,11,16,16,12,6,5,10,16,20,12,7,12,7,11,9,8,13,12,10,16,16,11,14,11,JoÃ£o Amaral,Â£900Th. ,Liga NOS
19-06-17,18.3.4.28,Wellington,55062670,1651,21-Nov-92,24,0,0,0,0,2513,5026,5000,128,114,66643,179,76,AM RL,2,2,1,1,4,1,1,3,1,2,2,6,12,15,10,12,8,12,10,4,3,11,7,5,11,7,8,7,8,11,12,9,13,16,6,14,9,10,11,15,14,8,8,9,14,15,20,12,12,5,3,6,4,7,13,14,12,16,13,13,10,8,1,1,1,20,20,20,7,AM RL,505,1,1,13,7,20,20,1,1,1,1,1,1,1,1,1,0.0,0,0,0,0,0,0,0,0,0,0,0,0,0,0,0,0,0,0,0,0,0,0,0,0,0,0,0,0,0,0,0,0,0,0,0,0,0,0,0,0,0,0,0,0,0,0,0,0,nan,nan,nan,nan,nan,nan,nan,nan,nan,nan,nan,nan,nan,nan,nan,nan,nan,nan,nan,nan,nan,nan,nan,nan,nan,nan,nan,nan,15-07-16,17.3.2.23,Wellington,19135387,1651,05-Oct-87,28,0,0,0,0,2140,3745,5250,115,105,47280,186,81,S ,2,1,1,2,1,2,2,3,2,2,3,5,8,10,13,11,6,14,9,6,5,9,11,6,9,10,13,12,12,13,13,12,13,11,10,13,6,11,11,13,12,13,12,7,12,12,20,12,13,11,4,11,3,6,14,12,9,11,12,12,12,5,Wellington,Â£90Th. ,Liga NOS
19-06-17,18.3.4.28,Arnold Issoko,55062785,53,06-Apr-92,25,1,0,0,0,3500,5600,5750,116,115,148456,185,76,D/AM RL,4,2,2,2,2,1,3,3,3,2,3,3,10,8,11,7,3,9,11,4,3,9,9,4,7,13,12,14,6,11,7,8,15,14,7,16,9,11,14,18,11,11,14,5,18,17,20,16,14,12,4,10,8,9,13,10,12,10,17,15,14,7,19,13,15,20,20,16,12,D/AM RL,525,1,1,12,12,16,20,1,1,19,1,1,12,15,1,13,2251800000000000.0,0,0,0,0,0,0,0,0,0,0,0,0,0,1,0,0,0,0,0,0,0,0,0,0,0,0,0,1,0,0,0,1,0,0,0,0,0,0,0,0,0,0,0,0,0,0,0,0,Arnold Issoko,Â£720Th. ,28.0,185.0,Forward - Right Winger,right,CD Cova Piedade,30.0,0.0,1.0,1348.0,37.0,1.0,1.0,2603.0,18.0,3.0,8.0,1599.0,7.0,1.0,0.0,310.0,6.0,2.0,0.0,397.0,Liga NOS,15-07-16,17.3.2.23,Arnold Issoko,55062785,53,06-Apr-92,24,1,0,0,0,3900,5600,5550,115,111,279482,185,76,AM RL,3,4,3,3,1,3,3,2,2,3,2,3,10,8,11,7,3,9,11,4,3,9,9,4,7,13,12,14,6,11,7,8,14,14,7,15,9,11,14,18,16,15,7,6,10,17,20,13,13,12,4,10,8,9,13,10,12,10,13,14,13,8,Arnold Issoko,Â£585Th. ,Liga NOS
19-06-17,18.3.4.28,PerdigÄo,55063071,1651,17-Jul-91,25,0,0,0,0,2930,4262,5900,125,118,299310,185,73,AM RL,2,2,1,2,1,1,2,2,1,1,3,8,11,14,11,12,11,8,8,5,6,12,6,7,14,8,12,11,12,13,10,12,10,16,8,13,8,12,13,14,13,12,12,9,11,14,20,12,11,14,7,14,5,7,12,13,13,12,14,13,10,5,1,1,13,20,20,20,10,AM RL,505,1,1,13,10,20,20,1,1,1,1,1,10,13,1,1,0.0,0,0,0,0,0,0,0,0,0,0,0,0,0,0,0,0,0,0,0,0,0,0,0,0,0,0,0,0,0,0,0,0,0,0,0,0,0,0,0,0,0,0,0,0,0,0,0,0,PerdigÃ£o,Â£540Th. ,29.0,185.0,Forward - Right Winger,right,Alashkert Yerevan,37.0,6.0,4.0,2721.0,22.0,0.0,0.0,844.0,30.0,3.0,3.0,1697.0,1.0,0.0,0.0,45.0,7.0,0.0,0.0,395.0,Liga NOS,15-07-16,17.3.2.23,PerdigÄo,55063071,1651,17-Jul-91,24,0,0,0,0,1670,3898,6100,125,122,459626,185,73,AM RL,3,2,1,1,2,2,1,3,3,2,3,8,11,14,13,12,11,8,8,5,6,12,6,7,14,8,12,11,13,14,10,14,10,16,8,14,12,12,13,14,14,12,9,9,11,14,20,12,11,14,7,14,5,7,19,13,11,11,12,2,16,8,PerdigÃ£o,Â£900Th. ,Liga NOS
19-06-17,18.3.4.28,Rochinha,55063244,788,03-May-95,22,0,0,0,0,3750,5750,5750,136,116,2281846,169,68,AM RLC,2,1,3,3,1,3,3,2,1,1,3,12,12,14,11,15,10,6,10,7,7,14,12,7,15,8,13,11,14,9,14,12,12,14,8,15,8,11,12,13,14,7,6,12,11,13,20,7,8,9,6,5,7,13,8,18,12,11,12,10,15,7,1,1,13,20,16,15,20,AM RLC,506,1,1,1,20,15,16,1,1,1,1,13,7,10,1,1,2322170000000000.0,0,0,0,0,0,0,0,1,0,0,0,0,0,0,0,0,0,0,0,1,0,0,0,0,0,0,0,0,0,0,0,0,0,0,0,0,0,0,0,0,0,0,0,0,0,0,1,0,Rochinha,Â£540Th. ,25.0,169.0,Forward - Right Winger,right,VitÃ³ria GuimarÃ£es SC,8.0,0.0,0.0,162.0,29.0,2.0,2.0,1424.0,33.0,4.0,3.0,2207.0,37.0,4.0,7.0,1848.0,5.0,0.0,0.0,315.0,Liga NOS,15-07-16,17.3.2.23,Rochinha,55063244,788,03-May-95,21,0,0,0,0,3700,5050,5050,126,102,700168,169,68,AM RLC,2,1,2,2,1,4,3,3,2,1,1,11,12,14,8,14,10,6,10,7,7,12,12,7,14,8,13,11,12,9,12,11,12,14,8,15,8,10,12,13,14,7,6,8,11,13,20,7,8,9,6,5,7,13,14,18,10,11,10,10,15,5,Rochinha,Â£180Th. ,Liga NOS
19-06-17,18.3.4.28,Gelson Martins,55063369,788,11-May-95,22,12,0,5,2,2500,7550,7550,170,151,62096763,173,65,AM RL,3,1,1,1,1,3,3,1,1,3,2,6,11,18,13,16,5,5,10,2,5,13,12,6,18,11,14,12,14,12,13,13,15,19,6,14,7,11,12,17,17,14,7,12,14,16,20,11,8,13,6,14,6,10,16,14,15,14,15,13,12,6,1,1,13,20,20,15,8,AM RL,505,1,1,5,8,15,20,1,1,1,1,1,11,13,1,1,34359738378.0,0,1,0,1,0,0,0,0,0,0,0,0,0,0,0,0,0,0,0,0,0,0,0,0,0,0,0,0,0,0,0,0,0,0,0,1,0,0,0,0,0,0,0,0,0,0,0,0,Gelson Martins,Â£31.50m ,25.0,173.0,Forward - Right Winger,right,AS Monaco,44.0,7.0,13.0,3642.0,52.0,13.0,13.0,4368.0,29.0,5.0,4.0,1919.0,23.0,4.0,1.0,1862.0,7.0,0.0,1.0,478.0,Liga NOS,15-07-16,17.3.2.23,Gelson Martins,55063369,788,11-May-95,21,0,0,3,1,2500,7350,7350,152,147,59101486,173,65,AM RL,1,2,2,3,2,1,4,2,3,3,4,6,10,18,13,16,5,5,9,2,5,11,12,6,17,11,14,12,14,12,13,12,15,19,6,14,7,11,12,17,17,14,7,12,14,16,20,11,8,13,6,14,6,10,16,14,15,14,15,13,12,7,Gelson Martins,Â£18.00m ,Liga NOS
19-06-17,18.3.4.28,Daniel Podence,55063406,788,21-Oct-95,21,0,0,9,3,4500,6700,6700,148,136,11706020,165,62,AM/S RLC,1,2,3,3,2,3,3,2,3,1,1,11,11,15,11,14,11,4,13,3,4,13,10,6,16,15,11,12,10,9,14,12,14,17,6,14,6,10,12,16,17,11,3,10,14,16,20,11,5,12,13,11,5,6,9,13,15,12,14,8,11,9,1,1,5,20,20,18,15,AM/S RLC,516,1,1,16,15,18,20,1,1,1,1,1,5,5,1,1,2251800000000000.0,0,0,0,0,0,0,0,0,0,0,0,0,0,0,0,0,0,0,0,0,1,0,0,0,0,0,0,0,0,0,0,0,0,0,0,0,0,0,0,0,0,0,0,0,0,0,0,0,Daniel Podence,Â£4.05m ,25.0,165.0,Forward - Left Winger,right,Wolverhampton Wanderers,31.0,4.0,6.0,1882.0,20.0,0.0,8.0,1041.0,41.0,8.0,9.0,3333.0,40.0,6.0,8.0,2582.0,6.0,0.0,2.0,383.0,Liga NOS,15-07-16,17.3.2.23,Daniel Podence,55063406,788,21-Oct-95,20,0,0,0,0,4300,6750,6750,148,135,15136039,165,62,AM RL,3,1,3,1,1,3,2,1,3,3,2,11,13,15,13,14,11,4,8,3,4,13,10,6,16,15,12,12,10,12,13,9,14,15,6,14,6,10,12,17,16,13,3,11,12,16,20,12,5,12,10,11,5,6,20,13,15,12,14,8,11,8,Daniel Podence,Â£2.25m ,Liga NOS
19-06-17,18.3.4.28,Rafa,55063493,788,17-May-93,24,9,0,13,3,5500,6800,6800,146,136,7864063,170,63,AM RLC,3,2,1,1,3,3,3,3,2,1,3,12,13,15,8,15,12,5,13,5,6,13,13,8,16,12,13,13,7,11,14,8,14,18,7,15,9,9,14,17,16,13,5,7,14,17,20,13,6,12,6,16,9,10,15,14,14,13,16,12,14,8,1,1,12,20,20,19,15,AM RLC,506,1,1,8,15,19,20,1,1,1,1,12,12,12,1,1,1.46367e+17,0,0,0,0,0,0,0,0,0,0,0,0,0,0,0,0,0,0,0,0,0,0,0,0,0,0,0,0,0,0,0,0,0,0,0,0,0,0,0,0,0,0,0,0,0,0,0,0,Rafael,Â£720Th. ,30.0,186.0,Goalkeeper,right,Reading FC,2.0,2.0,0.0,180.0,0.0,0.0,0.0,0.0,4.0,3.0,2.0,390.0,46.0,56.0,13.0,4170.0,7.0,1.0,6.0,630.0,Serie A,15-07-16,17.3.2.23,Rafa,55028339,788,28-Jul-91,24,0,0,0,0,1500,5500,5500,118,110,152142,185,81,S L,3,3,3,3,1,1,1,4,1,3,2,9,11,10,10,11,8,12,12,6,7,10,11,11,10,11,12,15,9,14,11,12,18,10,9,13,7,13,15,11,11,16,13,12,14,11,20,14,15,12,7,10,7,13,12,14,8,10,10,11,11,9,Rafael,Â£1.53m ,Serie A
19-06-17,18.3.4.28,Harramiz,55067778,40,03-Aug-90,26,4,0,0,0,2250,5000,5000,119,108,11599,180,73,AM/S RL,3,4,1,4,2,1,1,3,3,4,3,6,8,14,11,10,9,11,11,4,4,10,8,5,12,13,11,11,7,9,9,10,12,14,8,13,9,9,12,14,13,13,11,11,14,14,20,12,11,9,10,11,10,10,11,11,7,10,11,12,10,10,1,1,1,20,20,17,8,AM/S RL,515,1,1,19,8,17,20,1,1,1,1,1,1,1,1,1,2252350000000000.0,0,0,0,1,0,0,0,0,0,0,0,0,0,0,0,0,0,0,0,0,0,0,0,0,0,0,0,0,0,0,0,0,0,0,0,0,0,0,0,1,0,0,0,0,0,0,0,0,Harramiz,Â£225Th. ,30.0,180.0,Forward - Second Striker,right,GD Estoril Praia,47.0,11.0,2.0,3725.0,22.0,1.0,1.0,1090.0,32.0,11.0,7.0,2472.0,26.0,8.0,5.0,2089.0,7.0,2.0,1.0,468.0,Liga NOS
19-06-17,18.3.4.28,Ricardo Horta,55069796,788,15-Sep-94,22,1,0,20,4,4300,6550,6300,148,132,3152077,173,61,M/AM RL,1,1,3,1,2,1,1,3,3,1,3,11,13,15,13,15,10,7,14,6,5,13,14,5,15,7,7,11,12,12,14,13,11,15,6,13,5,9,9,15,16,14,7,11,13,15,20,11,7,14,6,7,7,12,10,14,13,15,15,11,14,5,1,1,19,20,20,18,13,M/AM RL,525,1,1,1,13,18,20,1,1,1,1,1,17,19,1,1,1.44116e+17,0,0,0,0,0,0,0,0,0,0,0,1,0,0,0,0,0,0,0,0,0,0,0,0,0,0,0,0,0,0,0,0,0,0,0,0,0,0,0,0,1,0,0,0,0,0,0,0,Ricardo Horta,Â£6.30m ,26.0,173.0,Forward - Left Winger,right,SC Braga,44.0,9.0,9.0,2755.0,43.0,12.0,8.0,2757.0,44.0,10.0,5.0,2724.0,52.0,24.0,8.0,4174.0,6.0,2.0,1.0,536.0,Liga NOS,15-07-16,17.3.2.23,Ricardo Horta,55069796,788,15-Sep-94,21,1,0,11,4,4300,6550,6550,148,131,10611314,173,61,M/AM RL,3,3,1,3,3,2,3,3,1,2,3,11,13,16,13,16,10,10,13,6,4,12,14,5,16,7,5,10,10,11,14,10,11,15,6,11,4,9,9,15,17,15,7,12,13,15,20,11,8,10,6,7,7,12,7,14,13,15,15,11,14,5,Ricardo Horta,Â£1.58m ,Liga NOS
19-06-17,18.3.4.28,Amilton,55069820,1651,12-Aug-89,27,0,0,0,0,4801,5302,5900,132,118,299310,172,68,M/AM RL,4,3,2,2,1,1,1,3,1,1,3,9,11,13,10,12,8,9,10,6,5,10,10,7,12,15,11,15,9,10,11,9,16,14,6,12,5,9,14,15,14,15,9,9,15,15,20,12,13,13,9,12,3,11,14,12,7,14,10,12,10,10,1,1,20,20,20,15,1,M/AM RL,415,1,1,12,1,15,20,1,1,1,1,1,15,20,1,1,2199160000000.0,0,0,0,0,0,0,0,0,0,0,0,0,0,0,0,0,0,0,0,0,0,0,0,0,0,0,0,1,0,0,0,0,0,0,0,0,0,0,0,0,0,1,0,0,0,0,0,0,Amilton,Â£810Th. ,31.0,172.0,Forward - Left Winger,right,Antalyaspor,37.0,6.0,9.0,3006.0,36.0,7.0,6.0,2849.0,37.0,3.0,8.0,2972.0,35.0,2.0,5.0,2585.0,6.0,0.0,2.0,478.0,Liga NOS
19-06-17,18.3.4.28,Nuno Santos,55070264,788,13-Feb-95,22,0,0,2,0,4400,5950,5950,145,119,317795,179,73,M/AM RL,3,2,3,3,1,2,2,2,1,2,1,13,15,14,11,14,14,9,14,2,6,14,11,7,15,11,11,13,13,12,13,12,14,14,6,13,8,13,13,13,13,11,7,20,13,13,7,12,8,14,8,14,8,12,9,13,13,14,15,13,12,5,1,1,19,20,20,20,10,M/AM RL,525,1,1,6,10,20,20,1,1,1,1,1,19,12,1,1,2.8823e+17,0,0,0,0,0,0,0,0,0,0,0,0,0,0,0,0,0,0,0,0,0,0,0,0,0,0,0,0,0,0,0,0,0,0,1,0,0,0,0,0,0,0,0,0,0,0,0,0,Nuno Santos,Â£810Th. ,25.0,176.0,Forward - Left Winger,left,Sporting CP,31.0,0.0,3.0,2080.0,32.0,2.0,3.0,979.0,8.0,3.0,1.0,594.0,38.0,5.0,7.0,2903.0,5.0,2.0,1.0,343.0,Liga NOS,15-07-16,17.3.2.23,Nuno Santos,55070264,788,13-Feb-95,21,0,0,2,0,4400,6100,6100,145,122,850309,179,73,M/AM RL,3,1,1,2,1,3,4,2,1,2,2,13,15,14,11,14,14,9,14,2,6,14,11,7,15,11,11,13,13,12,13,12,14,14,6,13,8,13,13,14,13,11,7,20,13,13,7,12,8,14,8,14,8,12,12,13,13,14,15,13,12,4,Nuno Santos,Â£900Th. ,Liga NOS
19-06-17,18.3.4.28,Matheus Pereira,55070289,1651,05-May-96,21,0,0,0,0,2904,4752,6400,154,128,2633262,175,69,AM RLC,2,2,1,1,2,3,1,2,1,2,1,12,13,15,12,15,12,6,13,6,6,14,13,6,17,11,10,9,14,11,14,12,9,17,8,13,6,9,9,14,15,12,7,20,12,14,8,13,9,13,15,13,4,11,16,16,10,14,8,8,8,14,1,1,12,20,20,19,19,AM RLC,506,1,1,13,19,19,20,1,1,1,1,5,12,10,1,1,2.88301e+17,0,0,0,0,0,0,0,0,0,0,0,0,0,0,0,0,0,0,0,0,0,0,0,0,0,0,0,0,0,0,0,0,0,0,0,0,0,0,0,0,0,0,0,0,0,0,1,0,Matheus Pereira,Â£360Th. ,22.0,181.0,Midfielder - Attacking Midfield,left,FC Barcelona B,20.0,0.0,6.0,1400.0,2.0,0.0,0.0,73.0,27.0,5.0,5.0,1668.0,13.0,0.0,0.0,678.0,1.0,0.0,0.0,11.0,Ligue 1,15-07-16,17.3.2.23,Matheus Pereira,55070289,1651,05-May-96,20,0,0,0,0,2851,4459,6550,151,131,6189870,175,69,AM RLC,1,3,3,3,1,1,3,1,3,2,1,12,13,15,12,14,12,6,13,6,6,14,13,6,17,8,10,9,14,11,14,12,10,17,8,13,6,10,11,15,15,12,7,20,12,14,8,13,10,13,8,13,4,11,16,16,10,14,8,12,13,13,Matheus Pereira,Â£315Th. ,Serie A
19-06-17,18.3.4.28,PitÃ©,55072239,788,22-Aug-94,22,0,0,0,0,4350,5650,5650,136,114,211121,188,80,D/AM RLC,1,2,3,3,2,2,1,1,2,2,1,11,13,13,8,12,13,11,15,9,8,13,12,12,14,8,10,8,11,10,12,8,12,15,6,13,9,8,10,13,11,13,12,20,14,14,5,11,12,12,6,10,6,16,18,13,12,14,12,10,10,7,18,13,14,20,17,19,20,D/AM RLC,526,1,1,1,20,19,17,1,18,1,1,14,13,1,13,1,34359738625.0,1,0,0,0,0,0,0,0,1,0,0,0,0,0,0,0,0,0,0,0,0,0,0,0,0,0,0,0,0,0,0,0,0,0,0,1,0,0,0,0,0,0,0,0,0,0,0,0,PitÃ©,Â£315Th. ,26.0,189.0,Midfielder - Left Midfield,left,Without Club,14.0,1.0,0.0,547.0,7.0,0.0,1.0,457.0,23.0,3.0,1.0,721.0,20.0,1.0,0.0,1086.0,nan,nan,nan,nan,Liga NOS,15-07-16,17.3.2.23,PitÃ©,55072239,788,22-Aug-94,21,0,0,0,0,4350,5800,5800,136,116,730450,188,80,D/AM RLC,3,3,3,1,1,1,2,2,3,1,1,11,13,13,8,12,13,12,15,9,9,13,10,12,14,8,10,9,12,11,13,10,12,15,6,13,9,9,10,13,12,13,12,20,12,14,4,10,13,12,6,10,6,16,11,13,12,14,12,10,10,8,PitÃ©,Â£315Th. ,Liga NOS
19-06-17,18.3.4.28,China,55081095,788,07-Jul-92,24,0,0,0,0,3250,5350,5350,116,107,121196,179,73,D/M/AM L,3,3,3,3,1,2,1,2,1,2,1,10,11,11,7,11,10,10,8,14,13,12,5,13,13,13,13,13,11,15,10,9,14,7,8,12,10,13,14,12,11,12,9,20,12,12,6,14,10,12,10,10,6,12,18,8,16,10,15,13,12,6,20,13,17,18,7,20,1,D/M/AM L,123,1,1,1,1,18,7,1,20,1,1,1,17,1,13,1,32800.0,0,0,0,0,0,1,0,0,0,0,0,0,0,0,0,1,0,0,0,0,0,0,0,0,0,0,0,0,0,0,0,0,0,0,0,0,0,0,0,0,0,0,0,0,0,0,0,0,nan,nan,nan,nan,nan,nan,nan,nan,nan,nan,nan,nan,nan,nan,nan,nan,nan,nan,nan,nan,nan,nan,nan,nan,nan,nan,nan,nan,15-07-16,17.3.2.23,China,55081095,788,07-Jul-92,24,0,0,0,0,3250,5350,5350,116,107,191115,179,73,D/M/AM L,2,3,1,3,2,3,3,3,1,1,1,10,11,11,7,11,10,10,8,14,13,12,5,13,13,13,13,13,11,15,10,9,14,7,8,12,10,13,14,12,11,12,9,20,12,12,6,14,10,12,10,10,6,12,10,8,16,10,15,13,12,6,nan,nan,nan
19-06-17,18.3.4.28,AndrÃ© Horta,55082342,788,07-Nov-96,20,0,0,3,0,4350,6700,6400,160,134,4121774,167,60,M/AM LC,1,1,1,4,3,1,1,1,3,2,1,12,12,15,11,15,10,7,11,5,6,16,11,7,15,12,13,13,15,11,15,12,14,14,9,13,10,14,12,14,15,13,6,11,14,14,20,11,9,12,5,11,12,10,13,14,14,15,16,12,14,7,1,1,20,19,7,17,20,M/AM LC,414,1,1,1,19,17,7,1,1,1,1,20,11,1,1,1,2251800000000000.0,0,0,0,0,0,0,0,0,0,0,0,0,0,0,0,0,0,0,0,0,0,0,0,0,0,0,0,0,0,0,0,0,0,0,0,0,0,0,0,0,0,0,0,0,0,0,0,0,AndrÃ© Horta,Â£5.40m ,23.0,175.0,Midfielder - Central Midfield,right,SC Braga,16.0,1.0,1.0,971.0,42.0,1.0,7.0,2241.0,4.0,0.0,0.0,184.0,38.0,4.0,5.0,2499.0,6.0,0.0,0.0,191.0,Liga NOS,15-07-16,17.3.2.23,AndrÃ© Horta,55082342,788,07-Nov-96,19,0,0,0,0,4350,6700,6700,154,134,12951122,167,60,M/AM LC,2,1,2,3,1,3,1,2,1,3,1,12,12,15,11,15,10,7,11,5,6,16,11,7,15,12,13,13,15,11,15,12,14,14,9,13,10,14,12,14,15,13,6,11,14,14,20,11,9,12,5,11,12,10,13,14,14,15,16,12,14,8,AndrÃ© Horta,Â£1.80m ,Liga NOS
19-06-17,18.3.4.28,Gevorg Ghazaryan,59006275,754,05-Apr-88,29,52,10,18,5,4998,6498,5900,125,118,581460,180,74,M/AM RLC,3,3,3,3,3,1,1,1,1,1,2,9,9,12,11,12,9,12,8,6,9,13,10,8,14,15,12,12,13,11,12,13,13,12,7,11,12,12,13,13,12,11,9,14,12,13,20,12,10,12,9,10,14,11,14,16,10,12,14,12,13,7,1,1,19,20,17,20,19,M/AM RLC,526,1,1,14,16,20,17,1,1,1,1,19,16,10,1,1,549773000000.0,0,0,0,0,0,0,0,0,0,0,1,0,0,0,0,0,0,0,0,0,0,0,0,0,1,0,0,0,0,0,0,0,0,0,0,0,0,0,0,1,0,0,0,0,0,0,0,0,Gevorg Ghazaryan,Â£675Th. ,32.0,180.0,Forward - Left Winger,left,AEL Limassol,29.0,4.0,3.0,1951.0,13.0,1.0,0.0,289.0,20.0,3.0,2.0,1174.0,15.0,0.0,0.0,725.0,2.0,1.0,0.0,78.0,Liga NOS,15-07-16,17.3.2.23,Gevorg Ghazaryan,59006275,754,05-Apr-88,28,49,9,18,5,5000,6500,5950,125,119,642531,180,74,M/AM RLC,2,3,3,4,1,3,3,1,1,4,2,9,9,12,11,12,9,12,8,6,9,13,10,8,13,15,12,12,13,11,12,13,13,12,7,11,13,12,13,13,12,11,9,14,13,13,20,14,10,12,9,10,13,11,13,16,10,12,14,12,13,6,Gevorg Ghazaryan,Â£900Th. ,Liga NOS
19-06-17,18.3.4.28,Thiago GalvÄo,62079380,1651,24-Aug-89,27,0,0,0,0,2760,4919,5550,113,111,127244,185,78,AM/S RLC,3,2,4,3,1,3,2,2,2,2,2,10,11,14,12,12,9,10,12,8,3,12,13,7,14,13,8,8,11,10,12,10,14,12,10,13,6,12,13,14,14,11,10,20,16,13,7,12,10,14,10,12,9,9,11,11,11,12,12,10,10,8,1,1,14,20,15,15,20,AM/S RLC,516,1,1,18,20,15,15,1,1,1,1,14,1,1,1,1,256.0,0,0,0,0,0,0,0,0,1,0,0,0,0,0,0,0,0,0,0,0,0,0,0,0,0,0,0,0,0,0,0,0,0,0,0,0,0,0,0,0,0,0,0,0,0,0,0,0,Tiago GalvÃ£o,Â£270Th. ,31.0,185.0,Midfielder - Attacking Midfield,right,Alashkert Yerevan,33.0,6.0,2.0,2880.0,8.0,0.0,1.0,264.0,16.0,2.0,2.0,1342.0,32.0,11.0,8.0,2525.0,7.0,0.0,0.0,548.0,Liga NOS
19-06-17,18.3.4.28,Andrija Zivkovic,62082823,802,11-Jul-96,20,5,0,14,1,4910,6264,7100,170,142,35377992,170,66,AM RLC,1,2,4,1,1,2,3,3,3,3,1,14,16,16,12,15,13,6,12,12,7,13,11,7,16,14,13,13,14,13,15,13,13,16,13,14,7,15,14,14,14,13,6,20,13,14,8,12,10,13,9,15,10,10,12,16,14,14,16,15,13,10,1,1,14,20,20,20,17,AM RLC,506,1,1,5,17,20,20,1,1,1,1,13,14,13,1,1,2748780000000.0,0,0,0,0,1,0,0,1,0,0,1,0,0,0,0,0,0,0,0,0,0,0,0,0,0,0,0,0,0,0,0,0,0,0,0,0,0,0,0,1,0,1,0,0,0,0,0,0,Andrija Zivkovic,Â£16.20m ,24.0,169.0,Forward - Right Winger,left,PAOK Thessaloniki,24.0,1.0,11.0,1583.0,30.0,3.0,6.0,2063.0,30.0,0.0,7.0,1377.0,4.0,0.0,0.0,124.0,9.0,2.0,1.0,581.0,Liga NOS,15-07-16,17.3.2.23,Andrija Zivkovic,62082823,802,11-Jul-96,20,5,0,4,0,4900,6700,7000,159,140,24456636,170,66,M/AM RL,2,3,3,2,3,1,2,3,1,3,3,14,15,16,12,15,13,6,12,12,7,13,11,7,17,14,13,13,13,13,13,13,15,16,13,14,7,13,14,15,14,13,6,20,13,14,8,12,10,13,9,15,10,10,12,16,16,14,16,15,13,9,Andrija Zivkovic,Â£6.30m ,Liga NOS
19-06-17,18.3.4.28,Ãlex Grimaldo,67153376,796,20-Sep-95,21,0,0,1,0,4300,6950,7100,162,143,26868462,171,63,D/WB/M L,2,2,1,2,1,1,3,3,2,3,1,12,14,15,8,15,12,7,12,12,12,15,10,14,16,14,14,15,15,14,15,14,14,13,8,15,12,14,13,14,15,13,6,20,12,14,8,14,8,14,8,15,12,14,16,15,12,13,14,13,12,5,20,19,16,14,1,20,12,D/WB/M L,123,1,1,1,1,14,1,1,20,1,1,12,16,1,19,1,549757000000.0,1,0,0,0,0,0,0,0,0,0,0,0,0,0,0,0,0,0,0,0,1,0,0,0,0,0,0,0,0,0,0,0,0,0,0,0,0,0,0,1,0,0,0,0,0,0,0,0,nan,nan,nan,nan,nan,nan,nan,nan,nan,nan,nan,nan,nan,nan,nan,nan,nan,nan,nan,nan,nan,nan,nan,nan,nan,nan,nan,nan,15-07-16,17.3.2.23,Ãlex Grimaldo,67153376,796,20-Sep-95,20,0,0,1,0,4300,6950,7150,165,143,27709840,171,63,D/WB/M L,2,3,2,4,4,2,1,3,1,4,1,12,14,15,8,15,13,7,12,12,12,15,10,14,16,14,14,15,14,14,12,13,14,13,8,15,12,14,13,15,15,14,6,20,14,14,9,14,8,14,8,15,12,14,16,15,12,13,14,13,12,6,nan,nan,nan
19-06-17,18.3.4.28,Ãliver,67169689,796,10-Nov-94,22,0,0,7,2,5250,6950,6750,163,141,13786763,178,70,M/AM RLC,2,3,1,1,1,2,2,3,1,1,1,13,12,15,9,16,11,5,8,4,5,18,10,8,16,8,14,13,15,11,17,14,14,14,8,11,13,15,14,13,14,15,7,13,11,13,20,10,9,12,7,14,10,13,15,13,14,12,16,15,10,7,1,1,17,20,15,17,20,M/AM RLC,526,1,1,1,20,14,12,1,1,1,7,16,17,15,1,1,140737000000000.0,0,0,0,0,0,0,0,1,0,0,0,0,0,0,0,0,0,0,0,0,1,0,1,0,0,0,0,0,0,0,0,0,0,0,0,0,0,0,0,0,0,0,0,0,0,0,0,1,nan,nan,nan,nan,nan,nan,nan,nan,nan,nan,nan,nan,nan,nan,nan,nan,nan,nan,nan,nan,nan,nan,nan,nan,nan,nan,nan,nan,15-07-16,17.3.2.23,Ãliver,67169689,796,10-Nov-94,21,0,0,7,2,4750,6950,7100,165,142,29825625,178,70,M/AM RLC,2,1,3,1,2,1,1,1,2,2,1,13,12,16,9,18,10,5,7,4,3,18,10,6,17,8,14,13,14,11,18,14,14,19,8,12,13,14,14,13,14,14,7,13,11,12,20,10,8,12,7,14,10,13,9,13,14,12,16,15,10,8,nan,nan,nan
19-06-17,18.3.4.28,Hendrio,67184126,1651,16-May-94,23,0,0,0,0,2002,4255,4250,110,95,3927,181,74,AM L,3,2,3,2,2,3,3,3,2,3,1,8,8,12,9,13,7,8,10,8,6,12,11,6,13,10,10,10,9,11,11,8,11,12,7,12,6,12,11,13,12,10,10,20,12,13,8,12,8,10,6,10,10,13,13,13,9,8,12,10,10,8,1,1,12,20,14,20,9,AM L,503,1,1,13,9,20,14,1,1,1,1,1,12,12,1,1,2251800000000000.0,0,0,0,0,0,0,0,0,0,0,0,0,0,0,0,0,0,0,0,0,0,0,0,0,0,0,0,0,0,0,0,0,0,0,0,0,0,0,0,0,0,0,0,0,0,0,0,0,nan,nan,nan,nan,nan,nan,nan,nan,nan,nan,nan,nan,nan,nan,nan,nan,nan,nan,nan,nan,nan,nan,nan,nan,nan,nan,nan,nan,
19-06-17,18.3.4.28,Miguel Cardoso,67203879,788,19-Jun-94,23,0,0,0,0,2500,5700,5700,125,114,227386,176,71,M/AM RL,1,1,2,1,2,1,3,2,3,4,4,10,11,15,11,13,10,6,8,4,4,12,11,4,14,8,10,10,8,9,11,8,10,16,7,13,5,7,10,15,15,11,5,12,12,15,20,11,7,8,5,10,5,3,11,10,12,9,13,7,13,7,1,1,16,20,20,20,9,M/AM RL,525,1,1,12,9,20,20,1,1,1,1,1,14,16,1,1,0.0,0,0,0,0,0,0,0,0,0,0,0,0,0,0,0,0,0,0,0,0,0,0,0,0,0,0,0,0,0,0,0,0,0,0,0,0,0,0,0,0,0,0,0,0,0,0,0,0,Miguel Cardoso,Â£900Th. ,26.0,176.0,Forward - Right Winger,both,Belenenses SAD,32.0,1.0,4.0,2262.0,33.0,8.0,6.0,2708.0,20.0,3.0,0.0,1544.0,7.0,1.0,0.0,278.0,5.0,0.0,1.0,435.0,Liga NOS,15-07-16,17.3.2.23,Miguel Cardoso,67203879,788,19-Jun-94,22,0,0,0,0,2250,5000,5000,121,104,13106,176,71,M/AM RL,2,3,1,3,2,3,4,3,2,2,1,10,11,14,11,13,10,6,8,4,4,12,11,4,14,8,9,9,8,8,11,8,10,16,7,13,5,7,9,15,14,8,5,12,12,14,20,10,6,7,5,10,5,3,17,12,10,9,13,9,12,2,Miguel Cardoso,Â£450Th. ,Liga NOS
19-06-17,18.3.4.28,Emrah Ba?san,70046132,799,17-Apr-92,25,0,0,17,6,3250,5500,5500,125,110,115448,177,68,M/AM RLC,1,2,3,3,2,3,1,2,4,1,1,14,13,14,12,13,13,10,14,9,7,14,10,7,14,11,9,9,10,12,12,9,7,14,4,10,7,13,13,13,13,11,11,20,9,12,7,12,7,10,9,12,4,11,14,13,11,8,11,8,11,6,1,1,18,20,20,18,16,M/AM RLC,526,1,1,1,16,18,20,1,1,1,1,12,16,18,1,1,384.0,0,0,0,0,0,0,0,1,1,0,0,0,0,0,0,0,0,0,0,0,0,0,0,0,0,0,0,0,0,0,0,0,0,0,0,0,0,0,0,0,0,0,0,0,0,0,0,0,Emrah Bassan,Â£1.13m ,28.0,177.0,Forward - Right Winger,left,BÃ¼yÃ¼ksehir Belediye Erzurumspor,29.0,9.0,4.0,2059.0,9.0,2.0,2.0,261.0,31.0,1.0,12.0,2316.0,34.0,7.0,5.0,2249.0,5.0,0.0,3.0,372.0,Liga NOS
19-06-17,18.3.4.28,Mateus,727982,6,18-Jun-84,33,50,8,0,0,4356,6931,6050,134,121,232186002,174,74,AM/S RL,3,3,3,3,3,3,3,1,3,1,1,12,12,14,13,13,12,11,13,10,8,12,13,8,13,10,12,12,12,12,10,11,14,14,8,14,7,10,12,13,13,12,13,9,12,13,20,11,11,12,8,10,13,11,14,14,11,12,15,15,15,9,1,1,1,20,19,20,5,AM/S RL,515,1,1,20,5,20,19,1,1,1,1,1,1,1,1,1,12.0,0,0,1,1,0,0,0,0,0,0,0,0,0,0,0,0,0,0,0,0,0,0,0,0,0,0,0,0,0,0,0,0,0,0,0,0,0,0,0,0,0,0,0,0,0,0,0,0,Mateus,Â£180Th. ,36.0,176.0,Forward - Left Winger,right,FC Penafiel,37.0,3.0,7.0,2639.0,33.0,6.0,1.0,1912.0,34.0,7.0,5.0,2246.0,29.0,1.0,2.0,1156.0,7.0,2.0,1.0,600.0,Liga NOS,15-07-16,17.3.2.23,Mateus,19088879,1651,26-Mar-90,26,0,0,0,0,1500,4650,4450,117,85,5561,178,72,DM C,2,2,2,1,3,3,1,2,3,1,1,1,8,10,11,10,1,11,12,9,11,11,12,12,11,13,11,11,10,11,7,11,2,10,10,8,11,10,11,11,10,10,11,5,13,11,20,11,9,11,11,11,8,13,7,9,8,9,13,1,6,5,Mateus,Â£540Th. ,Liga NOS
19-06-17,18.3.4.28,Hugo Seco,745687,788,17-Jun-88,29,0,0,0,0,2500,5450,5450,120,109,30715,178,72,AM RL,1,1,3,2,1,3,4,3,3,2,3,8,13,14,7,12,6,8,8,5,5,10,8,6,14,8,10,10,10,9,10,9,14,15,6,12,6,12,11,14,14,11,9,9,13,14,20,12,11,12,5,11,11,10,13,10,15,11,16,15,16,6,1,1,14,20,20,19,1,AM RL,505,1,1,5,1,19,20,1,1,1,1,1,12,14,1,1,1099530000000.0,0,0,0,0,0,0,0,0,0,0,0,0,0,0,1,0,0,0,0,0,0,0,0,0,1,0,0,0,0,0,0,0,0,0,0,0,0,0,0,0,1,0,0,0,0,0,0,0,Hugo Seco,Â£270Th. ,32.0,176.0,Forward - Right Winger,right,SC Farense,23.0,2.0,3.0,1603.0,45.0,2.0,4.0,2432.0,14.0,1.0,3.0,675.0,23.0,0.0,2.0,1328.0,2.0,0.0,0.0,63.0,Liga NOS,15-07-16,17.3.2.23,Hugo Seco,745687,788,17-Jun-88,28,0,0,0,0,2000,5400,5600,112,112,167493,178,72,AM RL,1,1,3,2,2,3,3,2,3,2,1,8,13,14,7,12,6,8,8,5,5,10,8,6,14,8,10,10,11,10,11,9,14,15,6,12,7,12,11,14,14,11,9,10,13,14,20,12,11,12,5,11,11,10,13,10,15,11,16,15,16,5,Hugo Seco,Â£360Th. ,Liga NOS
19-06-17,18.3.4.28,Juan Delgado,75018382,1652,05-Mar-93,24,0,0,0,0,4000,5800,5800,126,117,667515,176,68,AM/S RL,2,2,1,1,2,1,3,3,3,3,2,10,11,12,9,11,10,10,9,7,7,11,9,6,11,10,11,10,11,9,11,10,13,11,6,13,9,12,12,13,13,11,10,15,15,13,20,14,12,9,5,11,4,11,17,12,13,12,13,9,13,4,1,1,1,19,18,19,1,AM/S RL,625,1,1,20,1,19,18,1,1,1,1,1,1,1,1,1,2251800000000000.0,0,0,0,0,0,0,0,0,0,0,0,0,0,0,0,0,0,0,0,0,0,0,0,0,0,0,0,0,0,0,0,0,0,0,0,0,0,0,0,0,0,0,0,0,0,0,0,0,Juan Delgado,Â£360Th. ,27.0,176.0,Forward - Right Winger,right,Club Necaxa,27.0,4.0,1.0,1766.0,29.0,3.0,2.0,1497.0,39.0,8.0,3.0,1927.0,29.0,5.0,4.0,2272.0,13.0,0.0,0.0,927.0,Liga NOS
19-06-17,18.3.4.28,HÃ©ctor QuiÅÃ³nes,76016510,1653,17-Mar-92,25,0,0,10,1,2068,4653,5850,121,117,173183,178,71,D/WB L,3,1,1,2,1,3,1,4,4,3,2,12,12,12,9,12,11,9,12,12,11,12,8,12,13,12,12,12,12,12,11,12,12,11,8,13,11,12,12,13,12,12,11,20,13,13,8,13,12,8,11,6,6,10,12,12,12,10,12,12,11,5,20,19,15,10,1,20,1,D/WB L,113,1,1,1,1,10,1,1,20,1,1,1,15,1,19,1,0.0,0,0,0,0,0,0,0,0,0,0,0,0,0,0,0,0,0,0,0,0,0,0,0,0,0,0,0,0,0,0,0,0,0,0,0,0,0,0,0,0,0,0,0,0,0,0,0,0,HÃ©ctor QuiÃ±Ã³nes,Â£540Th. ,28.0,178.0,Defender - Left-Back,left,CD AmÃ©rica de Cali,4.0,0.0,0.0,360.0,19.0,1.0,0.0,1336.0,16.0,0.0,2.0,1366.0,nan,nan,nan,nan,nan,nan,nan,nan,Liga NOS
19-06-17,18.3.4.28,SebastiÃ¡n RincÃ³n,76018723,1653,14-Jan-94,23,0,0,0,0,2652,4244,5800,126,116,769125,185,81,AM/S RL,1,2,2,2,3,3,1,1,3,3,3,8,7,12,12,11,8,12,8,4,6,10,12,8,12,13,13,13,10,8,11,13,12,12,7,14,8,13,13,15,9,12,12,7,18,15,20,12,14,7,12,10,14,10,12,12,8,7,9,13,10,12,1,1,13,20,20,17,1,AM/S RL,515,1,1,20,1,17,20,1,1,1,1,1,13,13,1,1,549756000000.0,0,0,0,0,0,0,0,0,0,0,0,0,0,0,0,0,0,0,0,0,0,0,0,0,0,0,0,0,0,0,0,0,0,0,0,0,0,0,0,1,0,0,0,0,0,0,0,0,SebastiÃ¡n RincÃ³n,Â£540Th. ,26.0,185.0,Forward - Right Winger,nan,VitÃ³ria GuimarÃ£es SC B,25.0,2.0,3.0,1638.0,11.0,3.0,0.0,564.0,8.0,0.0,3.0,451.0,18.0,3.0,2.0,1151.0,nan,nan,nan,nan,Liga NOS
19-06-17,18.3.4.28,Paolo Hurtado,77004183,1656,27-Jul-90,26,28,2,0,0,4500,6050,6550,135,131,3989477,176,66,AM RLC,3,2,3,3,2,2,2,1,3,2,3,15,13,14,12,14,13,11,13,6,6,14,13,7,15,9,12,10,13,10,14,12,9,13,7,14,7,13,10,14,13,12,7,11,12,14,20,12,10,11,7,13,12,12,13,12,13,8,13,9,9,5,1,1,14,20,20,18,19,AM RLC,506,1,1,10,19,18,20,1,1,1,1,14,14,14,1,1,140737000000000.0,0,0,0,0,0,0,0,1,0,0,0,0,0,0,0,0,0,0,0,1,0,0,0,0,0,0,0,0,0,0,0,0,0,0,0,0,0,0,0,0,0,0,0,0,0,0,0,1,Paolo Hurtado,Â£3.60m ,30.0,175.0,Midfielder - Attacking Midfield,right,Konyaspor,40.0,9.0,3.0,2676.0,33.0,15.0,7.0,2326.0,16.0,3.0,3.0,505.0,12.0,0.0,0.0,242.0,0.0,0.0,0.0,0.0,Liga NOS,15-07-16,17.3.2.23,Paolo Hurtado,77004183,1656,27-Jul-90,25,25,2,0,0,4500,6050,6200,130,124,11375873,177,69,AM RL,1,2,2,2,2,3,2,3,3,2,4,15,11,13,12,13,13,8,13,6,6,11,13,7,14,9,12,10,10,11,12,9,9,13,7,14,7,11,12,16,15,9,7,8,12,14,20,13,11,9,7,13,12,12,3,12,13,8,10,9,9,6,Paolo Hurtado,Â£2.25m ,Liga NOS
19-06-17,18.3.4.28,Ricardo Clarke,80024854,382,27-Sep-92,24,3,0,0,0,4250,5100,5100,122,111,92656,180,75,M/AM RL,2,1,1,1,1,2,2,4,1,2,1,9,10,12,11,11,7,11,10,5,5,8,13,4,12,13,12,10,11,12,11,12,11,8,10,12,6,12,13,13,11,12,10,10,13,13,20,12,12,8,10,1,5,11,12,9,10,11,10,7,1,1,1,1,16,20,20,18,1,M/AM RL,525,1,1,15,1,18,20,1,1,1,1,1,15,16,1,1,0.0,0,0,0,0,0,0,0,0,0,0,0,0,0,0,0,0,0,0,0,0,0,0,0,0,0,0,0,0,0,0,0,0,0,0,0,0,0,0,0,0,0,0,0,0,0,0,0,0,Ricardo Clarke,Â£90Th. ,28.0,180.0,Forward - Left Winger,right,Sporting 89 San Miguelito,19.0,7.0,0.0,1265.0,7.0,0.0,0.0,225.0,0.0,0.0,0.0,0.0,nan,nan,nan,nan,nan,nan,nan,nan,Liga NOS
19-06-17,18.3.4.28,AndrÃ©zinho,83100596,788,06-Aug-95,21,0,0,0,0,2750,5750,5750,133,115,716824,174,66,M/AM LC,2,2,3,1,3,3,2,1,2,2,3,11,11,13,8,13,11,7,11,5,6,12,8,7,15,8,13,10,12,12,13,12,13,11,8,12,8,13,13,14,15,12,6,9,12,14,20,11,6,11,5,12,4,6,7,11,14,12,15,10,12,7,1,1,17,20,1,15,20,M/AM LC,524,1,1,5,20,15,1,1,1,1,1,17,12,1,1,1,1.44115e+17,0,0,0,0,0,0,0,0,0,0,0,0,0,0,0,0,0,0,0,0,0,0,0,0,0,0,0,0,0,0,0,0,0,0,0,0,0,0,0,0,0,0,0,0,0,0,0,0,Andrezinho,Â£630Th. ,25.0,174.0,Midfielder - Attacking Midfield,both,Without Club,25.0,3.0,5.0,1298.0,18.0,0.0,3.0,605.0,6.0,1.0,1.0,344.0,12.0,0.0,1.0,475.0,nan,nan,nan,nan,Liga NOS
19-06-17,18.3.4.28,Murilo,83152890,1651,12-May-96,21,0,0,0,0,2250,5800,6000,131,120,460103,174,65,AM L,2,2,2,2,3,2,1,2,4,3,3,13,13,14,11,13,13,6,13,5,5,9,4,6,14,13,13,12,10,12,11,11,13,11,6,12,6,5,14,15,14,11,7,20,11,15,7,12,10,11,4,11,4,5,10,11,11,12,12,11,13,5,1,1,13,20,13,20,1,AM L,503,1,1,1,1,20,13,1,1,1,1,1,13,7,1,1,0.0,0,0,0,0,0,0,0,0,0,0,0,0,0,0,0,0,0,0,0,0,0,0,0,0,0,0,0,0,0,0,0,0,0,0,0,0,0,0,0,0,0,0,0,0,0,0,0,0,Murilo,Â£765Th. ,24.0,176.0,Forward - Left Winger,left,GD Estoril Praia,21.0,1.0,2.0,670.0,25.0,8.0,3.0,1766.0,12.0,0.0,2.0,440.0,22.0,4.0,2.0,1227.0,nan,nan,nan,nan,Liga NOS,15-07-16,17.3.2.23,Murilo,83152890,1651,12-May-96,20,0,0,0,0,500,4306,4300,115,97,57886,174,65,AM L,1,1,4,2,2,3,3,4,2,1,1,7,10,11,7,11,8,6,11,5,5,9,6,6,12,13,10,12,7,8,10,8,13,11,6,12,6,9,12,15,14,11,7,20,11,15,5,10,10,8,10,4,4,5,14,12,12,13,12,9,4,3,Murilo,Â£180Th. ,Liga NOS
19-06-17,18.3.4.28,Galeno,83152910,1651,21-Oct-97,19,0,0,0,0,2612,3919,6050,140,121,1164899,182,72,AM RL,3,4,2,1,1,1,3,2,1,2,2,7,11,14,11,12,11,6,13,4,4,10,5,5,12,11,12,10,8,8,10,9,15,15,4,15,4,8,11,17,15,13,12,8,13,16,20,11,10,10,5,12,6,4,16,14,12,13,15,9,13,5,1,1,11,20,20,18,1,AM RL,505,1,1,12,1,18,20,1,1,1,1,1,11,11,1,1,1.44115e+17,0,0,0,0,0,0,0,0,0,1,0,0,0,0,0,0,0,0,0,0,0,0,0,0,0,0,0,1,0,0,0,0,0,0,0,0,0,0,0,0,0,0,0,0,0,0,0,0,Galeno,Â£1.80m ,23.0,179.0,Forward - Right Winger,right,SC Braga,37.0,10.0,6.0,2176.0,28.0,6.0,10.0,1846.0,36.0,9.0,11.0,2845.0,41.0,7.0,11.0,2520.0,6.0,3.0,3.0,401.0,Liga NOS
19-06-17,18.3.4.28,Rui Costa,84125051,788,20-Feb-96,21,0,0,0,0,2500,6050,5500,138,121,169728,179,0,S RL,2,2,4,3,2,3,2,2,1,2,1,6,10,15,14,13,7,8,11,5,6,11,10,7,14,14,13,12,13,9,11,8,14,11,9,15,8,11,12,15,15,12,10,8,10,15,20,12,12,10,7,11,8,9,11,13,13,15,14,10,10,5,1,1,1,15,15,15,12,S RL,605,1,1,20,12,15,15,1,1,1,1,1,1,1,1,1,0.0,0,0,0,0,0,0,0,0,0,0,0,0,0,0,0,0,0,0,0,0,0,0,0,0,0,0,0,0,0,0,0,0,0,0,0,0,0,0,0,0,0,0,0,0,0,0,0,0,Rui Costa,Â£675Th. ,24.0,179.0,Forward - Centre-Forward,right,Deportivo de La CoruÃ±a,45.0,14.0,2.0,3392.0,20.0,12.0,3.0,1265.0,20.0,3.0,3.0,1116.0,23.0,3.0,2.0,988.0,1.0,0.0,0.0,7.0,Liga NOS
19-06-17,18.3.4.28,Hamdou Elhouni,84125494,28,12-Feb-94,23,14,1,0,0,1750,6100,5600,130,112,192608,175,65,M/AM RL,2,3,4,3,2,1,3,1,2,2,1,9,11,15,10,12,7,8,11,6,6,10,11,6,13,10,8,10,11,10,10,9,13,17,7,12,6,9,10,15,16,11,8,11,10,13,20,11,8,11,11,14,10,10,15,12,10,12,12,12,12,5,1,1,17,20,20,20,1,M/AM RL,525,1,1,1,1,20,20,1,1,1,1,1,13,17,1,1,0.0,0,0,0,0,0,0,0,0,0,0,0,0,0,0,0,0,0,0,0,0,0,0,0,0,0,0,0,0,0,0,0,0,0,0,0,0,0,0,0,0,0,0,0,0,0,0,0,0,Hamdou Elhouni,Â£270Th. ,26.0,169.0,Forward - Left Winger,right,Esperance Tunis,15.0,1.0,1.0,663.0,23.0,1.0,0.0,847.0,34.0,3.0,5.0,1713.0,35.0,10.0,7.0,2676.0,nan,nan,nan,nan,Liga NOS,15-07-16,17.3.2.23,Hamdou Elhouni,84125494,28,12-Feb-94,22,11,0,0,0,1750,6100,5700,139,114,54926,175,65,AM RL,3,3,2,3,2,1,3,1,2,3,2,9,11,15,10,12,7,9,11,6,7,10,11,6,13,10,8,10,11,10,10,10,13,17,7,12,6,9,10,15,17,12,8,13,10,13,20,9,8,11,11,14,6,10,15,12,10,12,12,12,12,7,Hamdou Elhouni,Â£315Th. ,Liga NOS
19-06-17,18.3.4.28,Jhonder CÃ¡diz,86027648,1658,29-Jul-95,21,0,0,0,0,4500,5400,5400,122,108,37265,191,81,S RL,3,2,2,2,2,2,3,2,1,3,4,4,7,10,11,11,7,13,11,8,6,8,8,6,11,13,12,14,12,11,9,11,11,7,6,11,7,12,12,12,11,13,16,10,14,13,20,13,14,12,10,10,5,11,13,10,14,10,13,8,13,7,1,1,1,15,15,15,1,S RL,605,1,1,20,1,15,15,1,1,1,1,1,1,1,1,1,0.0,0,0,0,0,0,0,0,0,0,0,0,0,0,0,0,0,0,0,0,0,0,0,0,0,0,0,0,0,0,0,0,0,0,0,0,0,0,0,0,0,0,0,0,0,0,0,0,0,Jhonder CÃ¡diz,Â£540Th. ,25.0,190.0,Forward - Centre-Forward,right,Nashville SC,11.0,1.0,1.0,403.0,39.0,10.0,2.0,2428.0,35.0,10.0,2.0,2477.0,25.0,4.0,3.0,1307.0,nan,nan,nan,nan,Liga NOS,15-07-16,17.3.2.23,Jhonder CÃ¡diz,86027648,1658,29-Jul-95,20,0,0,0,0,4500,5000,5000,122,106,131382,191,81,S RL,3,2,2,2,4,1,3,2,2,3,3,4,7,10,11,11,7,13,11,8,6,8,8,6,11,13,12,14,12,11,9,11,4,7,6,11,7,12,12,12,11,13,16,9,14,13,20,13,14,12,10,2,5,11,16,11,9,12,11,7,11,4,Jhonder CÃ¡diz,Â£360Th. ,Liga NOS
19-06-17,18.3.4.28,FÃ¡bio CoentrÄo,8877532,788,11-Mar-88,29,52,5,8,6,6000,7000,7050,150,141,21189405,179,70,D/WB L,3,2,2,3,1,4,3,1,2,3,4,13,15,15,11,14,12,10,12,14,12,13,12,15,15,14,15,15,13,14,14,14,12,13,11,16,13,13,14,13,13,14,10,20,10,13,10,11,11,12,14,16,16,15,13,14,14,13,8,9,8,14,20,18,15,13,1,20,10,D/WB L,113,1,1,1,1,13,1,1,20,1,10,10,15,1,18,1,1048609.0,1,0,0,0,0,1,0,0,0,0,0,0,0,0,0,0,0,0,0,0,1,0,0,0,0,0,0,0,0,0,0,0,0,0,0,0,0,0,0,0,0,0,0,0,0,0,0,0,FÃ¡bio CoentrÃ£o,Â£4.50m ,32.0,179.0,Defender - Left-Back,left,Rio Ave FC,6.0,0.0,1.0,297.0,44.0,1.0,4.0,3585.0,23.0,0.0,5.0,1970.0,nan,nan,nan,nan,1.0,0.0,0.0,45.0,Liga NOS,15-07-16,17.3.2.23,FÃ¡bio CoentrÄo,8877532,788,11-Mar-88,28,52,5,8,6,6000,7500,7000,150,145,10280452,179,70,D/WB L,1,2,1,2,3,1,2,3,2,3,3,13,15,15,11,14,12,12,12,14,13,14,12,16,14,14,15,15,12,14,13,14,12,13,11,16,13,13,15,14,13,14,10,20,9,14,8,13,11,13,14,17,15,15,12,14,14,13,8,11,12,14,FÃ¡bio CoentrÃ£o,Â£4.50m ,LaLiga
19-06-17,18.3.4.28,Majeed Waris,93019439,21,19-Sep-91,25,27,4,0,0,4250,6250,6250,130,125,6246422,172,70,M/AM/S L,4,1,3,2,2,1,3,3,2,1,2,8,9,14,12,14,8,11,10,6,5,11,12,3,13,10,12,12,12,9,10,10,14,13,7,14,7,9,12,16,15,12,6,8,13,15,20,14,10,12,11,13,8,10,12,14,10,11,12,13,10,8,1,1,17,19,13,19,5,M/AM/S L,633,1,1,20,5,19,13,1,1,1,1,1,17,10,1,1,0.0,0,0,0,0,0,0,0,0,0,0,0,0,0,0,0,0,0,0,0,0,0,0,0,0,0,0,0,0,0,0,0,0,0,0,0,0,0,0,0,0,0,0,0,0,0,0,0,0,Majeed Waris,Â£2.25m ,29.0,172.0,Forward - Centre-Forward,right,RC Strasbourg Alsace,40.0,11.0,4.0,3278.0,15.0,1.0,1.0,635.0,38.0,7.0,6.0,2571.0,8.0,2.0,1.0,432.0,6.0,0.0,0.0,269.0,Liga NOS,15-07-16,17.3.2.23,Majeed Waris,93019439,21,19-Sep-91,24,24,4,0,0,4500,6500,6250,131,125,7977964,172,74,AM/S L,2,2,1,1,1,3,1,3,1,1,1,8,9,14,13,14,9,11,10,7,5,12,12,3,13,10,12,12,13,12,11,10,14,13,7,14,9,9,13,16,15,13,6,8,13,16,20,14,12,11,11,13,9,8,9,13,9,11,12,13,10,9,Majeed Waris,Â£4.05m ,Ligue 1
19-06-17,18.3.4.28,Mubarak Wakaso,12006112,21,25-Jul-90,26,41,10,2,0,4500,6500,6350,135,127,4427173,171,78,M/AM RLC,3,3,2,3,1,1,1,4,3,2,2,11,14,12,8,9,11,8,13,14,12,11,9,12,10,17,8,16,7,8,12,8,11,12,4,12,10,9,17,15,14,12,7,20,17,15,10,16,10,11,14,11,8,11,12,12,10,7,7,7,5,15,10,14,20,18,17,20,17,M/AM RLC,416,1,1,1,10,18,17,1,10,1,10,17,20,16,14,1,137573000000.0,0,0,0,0,0,0,0,0,0,0,0,0,0,0,0,0,0,1,0,0,0,0,0,0,0,0,0,1,0,0,0,0,0,0,0,0,0,1,0,0,0,0,0,0,0,0,0,0,Mubarak Wakaso,Â£1.08m ,30.0,171.0,Midfielder - Central Midfield,left,Jiangsu Suning,27.0,2.0,3.0,2158.0,24.0,0.0,2.0,1374.0,29.0,1.0,1.0,1663.0,32.0,0.0,1.0,2466.0,nan,nan,nan,nan,LaLiga,15-07-16,17.3.2.23,Mubarak Wakaso,12006112,21,25-Jul-90,25,41,10,2,0,4500,6500,6500,135,130,3816415,171,78,M/AM RLC,3,2,3,1,1,4,4,2,1,3,4,11,14,12,8,9,11,8,13,14,12,11,9,12,10,17,8,16,7,8,12,8,15,12,4,12,10,9,17,16,15,12,7,20,17,15,10,16,10,11,14,11,8,11,12,14,10,8,8,7,6,14,Mubarak Wakaso,Â£900Th. ,LaLiga
19-06-17,18.3.4.28,Isaac Success,13135061,38,07-Jan-96,21,1,0,4,2,5519,5570,6500,161,130,37831683,182,90,M/AM/S L,2,1,1,3,1,3,3,3,3,1,1,9,12,14,13,12,10,9,13,5,7,11,12,8,15,9,13,11,10,10,8,7,10,16,7,14,5,11,12,15,13,14,12,10,15,15,20,14,16,11,7,11,9,14,13,14,13,7,6,10,7,16,1,1,17,20,13,20,13,M/AM/S L,533,1,1,20,13,20,13,1,1,1,1,1,17,1,1,1,1.44115e+17,0,0,0,0,0,0,0,0,0,0,0,0,0,0,0,0,0,0,0,0,0,0,0,0,0,0,0,1,0,0,0,0,0,0,0,0,0,0,0,0,0,0,0,0,0,0,0,0,Isaac Success,Â£1.80m ,24.0,182.0,Forward - Left Winger,right,Watford FC,19.0,1.0,1.0,503.0,10.0,0.0,2.0,541.0,35.0,4.0,1.0,1402.0,7.0,0.0,2.0,245.0,nan,nan,nan,nan,Premier League,15-07-16,17.3.2.23,Isaac Success,13135061,38,07-Jan-96,20,0,0,4,2,5506,5557,6500,161,135,22519279,186,86,M/AM/S L,1,3,2,3,1,2,3,2,1,1,1,8,11,14,13,11,9,8,12,4,6,10,11,7,14,8,12,11,11,9,9,10,12,16,7,13,4,10,12,14,12,13,11,10,15,16,20,13,15,11,7,11,6,14,13,14,11,7,7,11,7,14,Isaac Success,Â£3.60m ,Premier League
19-06-17,18.3.4.28,Oghenekaro Etebo,13162731,38,09-Nov-95,21,10,1,0,0,3785,5552,6400,147,128,4144527,176,70,M/AM RLC,2,1,1,1,3,1,1,1,1,2,3,7,12,14,13,14,12,8,8,6,10,13,10,10,14,14,14,13,14,14,14,14,13,14,7,15,10,14,14,14,13,12,9,5,15,13,20,13,13,14,7,12,5,12,15,14,12,10,14,15,14,7,1,1,17,20,20,17,17,M/AM RLC,526,1,1,13,17,17,20,1,1,1,1,17,13,13,1,1,2199020000000.0,0,0,0,0,0,0,0,0,0,0,0,0,0,0,0,0,0,0,0,1,0,0,0,0,0,0,0,0,0,0,0,0,0,0,0,0,0,0,0,0,0,1,0,0,0,0,0,0,Oghenekaro Etebo,Â£1.35m ,24.0,174.0,Midfielder - Central Midfield,right,Galatasaray SK,28.0,4.0,2.0,2323.0,34.0,4.0,2.0,2968.0,37.0,2.0,1.0,2821.0,26.0,1.0,0.0,1481.0,6.0,0.0,0.0,287.0,LaLiga,15-07-16,17.3.2.23,Oghenekaro Etebo,13162731,38,09-Nov-95,20,7,1,0,0,3600,5250,5250,128,112,355550,176,70,AM RL,3,1,3,1,4,1,2,4,1,2,3,7,11,13,12,11,12,8,8,6,6,11,10,7,12,13,14,13,14,12,12,12,13,14,7,15,9,14,14,14,13,12,8,5,15,13,20,12,13,12,7,12,5,12,15,14,12,10,14,15,14,8,Oghenekaro Etebo,Â£900Th. ,Liga NOS
19-06-17,18.3.4.28,Pablo HernÃ¡ndez,14003946,1652,24-Oct-86,30,4,3,0,0,5800,7250,7250,151,145,232186002,185,81,DM/M/AM LC,3,2,3,2,2,2,2,2,2,2,3,10,14,15,13,15,14,13,14,8,9,15,14,10,15,16,15,16,14,17,14,14,14,14,11,14,11,16,15,10,13,10,14,20,11,14,10,14,14,8,14,11,13,15,12,15,10,9,14,13,8,8,1,1,18,20,10,15,20,DM/M/AM LC,534,1,1,12,20,15,10,1,1,1,16,18,13,8,1,1,0.0,0,0,0,0,0,0,0,0,0,0,0,0,0,0,0,0,0,0,0,0,0,0,0,0,0,0,0,0,0,0,0,0,0,0,0,0,0,0,0,0,0,0,0,0,0,0,0,0,Pablo HernÃ¡ndez,Â£4.50m ,34.0,185.0,Midfielder - Central Midfield,left,Club AtlÃ©tico Independiente,45.0,1.0,1.0,3570.0,37.0,3.0,2.0,2322.0,28.0,5.0,1.0,2072.0,nan,nan,nan,nan,nan,nan,nan,nan,LaLiga,15-07-16,17.3.2.23,Pablo HernÃ¡ndez,14003946,1652,24-Oct-86,29,4,3,0,0,5800,7150,7300,151,146,14999999,185,81,DM/M/AM LC,1,3,3,1,3,2,3,3,2,1,2,10,14,15,13,15,16,13,14,8,9,15,14,10,15,16,15,16,14,17,14,14,14,14,11,14,11,16,15,10,13,10,14,20,11,14,10,14,14,8,14,11,13,15,12,15,10,9,14,13,8,8,Pablo HernÃ¡ndez,Â£5.40m ,LaLiga
19-06-17,18.3.4.28,Pablo Piatti,14004181,1649,31-Mar-89,28,1,0,6,0,6472,6523,7300,155,147,29374426,163,63,M/AM RLC,1,3,2,4,1,1,1,2,3,2,2,16,14,13,13,14,13,6,14,6,5,14,14,10,14,10,13,15,14,14,14,14,18,14,9,16,9,14,16,16,17,16,5,20,13,13,7,14,10,12,9,15,13,11,10,11,14,14,16,14,14,9,1,12,19,20,15,20,17,M/AM RLC,526,1,1,8,17,20,15,1,1,1,1,1,19,1,12,1,1.44115e+17,0,0,0,0,0,0,0,0,0,1,0,0,0,0,0,0,0,0,0,0,0,0,0,0,0,1,0,0,0,0,0,0,0,0,0,0,0,0,0,0,0,0,0,0,0,0,0,0,Pablo Piatti,Â£5.40m ,31.0,163.0,Forward - Left Winger,both,Toronto FC,31.0,10.0,12.0,2475.0,31.0,2.0,4.0,1812.0,26.0,2.0,2.0,1237.0,25.0,4.0,4.0,1624.0,nan,nan,nan,nan,LaLiga,15-07-16,17.3.2.23,Pablo Piatti,14004181,1649,31-Mar-89,27,1,0,6,0,6000,6500,7150,150,143,23312652,163,63,M/AM RLC,2,2,1,1,3,4,2,2,2,4,2,16,14,13,12,14,13,6,13,6,5,14,14,10,13,10,13,15,13,13,13,13,18,13,9,15,9,14,16,16,17,16,5,20,13,13,7,14,10,10,10,15,13,11,10,11,14,14,16,14,14,9,Pablo Piatti,Â£5.40m ,LaLiga
19-06-17,18.3.4.28,JoaquÃ­n Correa,14042683,1649,13-Aug-94,22,2,1,0,0,5000,6300,6900,157,138,18029406,188,75,M/AM LC,1,2,2,3,3,2,2,4,3,2,3,12,12,16,11,15,9,10,12,6,4,14,12,8,16,12,14,10,12,12,15,11,12,17,10,15,8,10,14,14,14,12,8,12,14,15,20,12,12,12,10,14,8,15,12,14,10,10,15,15,10,2,1,1,18,20,13,19,20,M/AM LC,524,1,1,10,20,19,13,1,1,1,1,1,18,1,1,1,34363932676.0,0,0,1,0,0,0,0,0,0,0,0,0,0,0,0,0,0,0,0,0,0,0,1,0,0,0,0,0,0,0,0,0,0,0,0,1,0,0,0,0,0,0,0,0,0,0,0,0,JoaquÃ­n Correa,Â£9.00m ,26.0,188.0,Forward - Second Striker,right,SS Lazio,34.0,8.0,3.0,1759.0,39.0,7.0,7.0,2606.0,44.0,9.0,6.0,2710.0,35.0,10.0,5.0,2383.0,5.0,0.0,1.0,382.0,LaLiga,15-07-16,17.3.2.23,JoaquÃ­n Correa,14042683,1649,13-Aug-94,21,0,0,0,0,5000,6300,6750,156,135,16405246,176,75,M/AM LC,2,2,2,1,3,3,3,1,4,2,3,12,12,16,10,14,10,10,12,6,4,14,12,8,16,12,14,10,12,12,16,12,12,16,10,12,8,10,14,14,14,12,8,12,14,14,20,12,12,12,10,14,8,14,12,14,10,10,15,15,10,2,JoaquÃ­n Correa,Â£9.00m ,LaLiga
19-06-17,18.3.4.28,Ãngel Correa,14043349,1649,09-Mar-95,22,8,1,8,4,6550,7600,7600,165,153,70367555,172,67,AM/S LC,1,2,2,1,1,3,3,3,3,1,1,13,15,16,13,16,10,8,11,12,5,16,11,6,17,10,15,11,12,12,15,13,12,19,10,17,8,11,13,14,16,14,6,13,16,14,20,14,10,13,13,12,6,11,13,12,15,9,10,14,18,8,1,1,13,20,10,18,20,AM/S LC,514,1,1,18,20,18,10,1,1,1,1,1,13,7,1,1,2251800000000000.0,0,0,0,0,0,0,0,0,0,0,0,0,0,0,0,0,0,0,0,0,0,0,0,0,0,0,0,0,0,0,0,0,0,0,0,0,0,0,0,0,0,0,0,0,0,0,0,0,Ãngel Correa,Â£21.60m ,25.0,171.0,Forward - Right Winger,right,AtlÃ©tico Madrid,47.0,8.0,11.0,1919.0,56.0,9.0,9.0,3259.0,49.0,5.0,4.0,2590.0,44.0,7.0,8.0,2819.0,6.0,1.0,2.0,338.0,LaLiga,15-07-16,17.3.2.23,Ãngel Correa,14043349,1649,09-Mar-95,21,2,1,8,4,5750,7250,7250,164,146,40802228,174,67,AM/S LC,2,3,1,2,2,1,2,3,3,3,1,13,15,16,12,16,10,8,11,6,4,16,10,6,17,8,15,11,12,12,15,12,17,19,8,16,8,11,13,14,16,14,6,12,16,14,20,14,8,13,13,12,10,11,13,10,15,11,10,14,14,6,Ãngel Correa,Â£16.20m ,LaLiga
19-06-17,18.3.4.28,Lucas BoyÃ©,14110829,1649,28-Feb-96,21,0,0,0,0,3757,5761,6450,148,129,16643962,180,80,AM/S RL,1,2,2,3,1,2,2,1,3,1,2,9,10,15,12,16,11,13,10,6,7,12,12,7,16,13,12,12,8,12,11,11,11,15,7,12,6,14,10,13,13,15,12,20,12,14,10,14,15,9,3,9,6,12,11,10,10,7,12,14,13,6,1,1,1,18,15,18,1,AM/S RL,625,1,1,20,1,18,15,1,1,1,1,1,1,1,1,1,34359738368.0,0,0,0,0,0,0,0,0,0,0,0,0,0,0,0,0,0,0,0,0,0,0,0,0,0,0,0,0,0,0,0,0,0,0,0,1,0,0,0,0,0,0,0,0,0,0,0,0,Lucas BoyÃ©,Â£1.35m ,24.0,183.0,Forward - Centre-Forward,right,Elche CF,33.0,3.0,2.0,1607.0,27.0,0.0,1.0,456.0,36.0,6.0,2.0,1605.0,24.0,2.0,1.0,886.0,3.0,1.0,0.0,176.0,Serie A,15-07-16,17.3.2.23,Lucas BoyÃ©,14110829,1649,28-Feb-96,20,0,0,0,0,5000,5750,6150,145,124,8007640,185,83,S ,1,2,3,2,4,3,2,2,1,3,3,9,10,15,12,16,11,13,9,6,5,11,12,5,16,13,12,12,8,12,10,11,11,15,7,12,10,11,9,12,13,15,12,20,12,13,10,13,15,9,3,9,8,12,17,10,10,7,12,14,13,6,Lucas BoyÃ©,Â£2.25m ,Serie A
19-06-17,18.3.4.28,HernÃ¡n Toledo,14125301,1649,17-Jan-96,21,0,0,0,0,2250,6100,6100,145,122,7460522,180,72,M/AM RL,2,3,2,1,1,4,1,3,2,2,1,11,10,16,6,13,9,5,7,8,5,10,10,6,16,9,13,9,9,9,13,11,14,16,8,14,8,14,9,17,14,13,9,8,13,13,20,13,8,12,8,12,8,12,12,14,9,10,9,11,10,9,1,1,17,20,15,20,9,M/AM RL,525,1,1,14,9,20,15,1,1,1,1,1,17,8,1,1,70368700000000.0,0,0,0,0,0,0,0,0,0,0,0,0,0,0,0,0,0,0,0,0,0,0,0,0,0,0,0,0,0,0,0,0,0,0,0,0,0,0,0,0,0,0,0,0,0,0,1,0,HernÃ¡n Toledo,Â£900Th. ,24.0,180.0,Forward - Left Winger,right,Club Deportivo Maldonado,15.0,2.0,0.0,764.0,17.0,1.0,2.0,703.0,7.0,0.0,0.0,409.0,1.0,0.0,0.0,24.0,nan,nan,nan,nan,LaLiga
19-06-17,18.3.4.28,Eloi Amagat,1502077,796,21-May-85,32,0,0,0,0,3250,5550,5550,114,111,463803,180,72,M/AM LC,2,2,1,2,3,1,1,3,2,1,2,11,13,12,11,12,13,7,11,7,7,14,8,5,13,7,13,9,11,12,13,13,11,13,6,13,7,11,10,13,13,11,11,20,8,13,8,13,11,12,7,11,8,11,9,11,11,11,9,10,13,5,1,1,18,20,1,15,20,M/AM LC,524,1,1,10,20,15,1,1,1,1,1,18,14,1,1,1,0.0,0,0,0,0,0,0,0,0,0,0,0,0,0,0,0,0,0,0,0,0,0,0,0,0,0,0,0,0,0,0,0,0,0,0,0,0,0,0,0,0,0,0,0,0,0,0,0,0,Eloi Amagat,Â£180Th. ,35.0,181.0,Midfielder - Attacking Midfield,left,UE Olot,17.0,0.0,0.0,713.0,11.0,0.0,0.0,453.0,13.0,0.0,0.0,764.0,20.0,0.0,1.0,1186.0,nan,nan,nan,nan,LaLiga
19-06-17,18.3.4.28,Manu GarcÃ­a,1507537,796,26-Apr-86,31,0,0,0,0,3750,6250,6250,127,126,2540546,182,74,WB/DM/M/AM LC,1,1,1,2,2,2,2,1,3,3,1,11,13,11,12,13,6,11,13,12,12,13,11,12,12,13,12,13,11,13,12,13,14,11,14,12,13,14,14,13,11,10,8,20,13,12,8,12,13,13,8,15,7,15,11,10,15,9,15,14,6,5,15,16,18,16,1,17,18,WB/DM/M/AM LC,344,1,1,1,1,16,1,1,15,1,20,18,17,1,16,1,288.0,0,0,0,0,0,1,0,0,1,0,0,0,0,0,0,0,0,0,0,0,0,0,0,0,0,0,0,0,0,0,0,0,0,0,0,0,0,0,0,0,0,0,0,0,0,0,0,0,Manu GarcÃ­a,Â£1.62m ,34.0,183.0,Midfielder - Defensive Midfield,left,Deportivo AlavÃ©s,31.0,3.0,2.0,2439.0,32.0,3.0,0.0,2487.0,35.0,2.0,1.0,2415.0,30.0,0.0,0.0,1967.0,4.0,0.0,0.0,44.0,LaLiga,15-07-16,17.3.2.23,Manu GarcÃ­a,1507537,796,26-Apr-86,30,0,0,0,0,3750,6100,6100,127,123,1935522,182,74,WB/DM/M/AM LC,1,3,1,2,2,3,1,2,3,1,2,11,13,11,12,13,6,11,13,12,12,13,11,12,12,13,12,13,11,13,12,13,14,11,14,12,13,14,14,13,11,10,8,20,13,12,6,12,13,12,8,15,7,15,8,11,15,13,15,14,6,3,Manu GarcÃ­a,Â£1.35m ,LaLiga
19-06-17,18.3.4.28,AdriÃ¡n,1509231,796,08-Jan-88,29,2,1,19,9,5600,6700,6700,145,132,4648817,183,73,AM/S RL,3,4,1,4,3,2,3,2,2,4,3,10,11,15,13,16,7,11,10,5,5,14,14,5,15,7,11,8,15,11,13,13,14,15,7,15,7,9,7,12,14,13,11,14,8,13,20,12,11,10,6,14,13,7,15,13,9,9,13,11,12,9,1,1,5,18,18,15,12,AM/S RL,625,1,1,20,12,15,18,1,1,1,1,1,5,5,1,1,549756000000.0,0,0,0,0,1,0,0,0,0,0,0,0,0,0,0,0,0,0,0,1,0,0,0,0,0,0,0,0,0,0,0,0,0,0,0,0,0,0,0,1,0,0,0,0,0,0,0,0,AdriÃ¡n,Â£4.50m ,33.0,190.0,Goalkeeper,right,Liverpool FC,19.0,36.0,6.0,1710.0,22.0,31.0,8.0,1980.0,5.0,8.0,2.0,450.0,18.0,24.0,3.0,1563.0,5.0,11.0,2.0,450.0,Premier League,15-07-16,17.3.2.23,AdriÃ¡n,67006173,796,03-Jan-87,29,0,0,0,0,4500,7000,6750,139,132,11624725,190,80,GK ,15,13,15,17,12,14,15,16,8,17,15,10,1,3,2,10,12,2,1,3,1,7,4,1,4,12,15,14,12,12,12,14,17,2,12,1,14,12,12,6,15,13,17,5,14,6,20,12,13,16,7,10,9,12,18,14,13,15,16,8,12,8,AdriÃ¡n,Â£7.20m ,Premier League
19-06-17,18.3.4.28,Yahya Al-Shehri,155425,133,26-Jun-90,26,41,6,0,0,2900,5900,5700,142,113,4958697,164,60,M/AM RLC,1,2,2,1,1,2,3,3,1,1,1,14,11,17,12,14,15,2,13,9,3,17,8,3,15,4,10,11,11,14,16,10,8,16,5,9,7,12,6,14,12,12,5,20,5,11,10,7,5,11,4,5,11,13,20,12,11,11,11,12,15,5,1,1,17,20,16,18,20,M/AM RLC,526,1,1,1,20,18,16,1,1,1,1,17,15,13,1,1,0.0,0,0,0,0,0,0,0,0,0,0,0,0,0,0,0,0,0,0,0,0,0,0,0,0,0,0,0,0,0,0,0,0,0,0,0,0,0,0,0,0,0,0,0,0,0,0,0,0,Yahia Al-Shehri,Â£720Th. ,30.0,164.0,Forward - Right Winger,left,Al-Nassr FC,28.0,2.0,7.0,2070.0,17.0,4.0,6.0,1403.0,32.0,5.0,2.0,1587.0,21.0,4.0,1.0,1031.0,nan,nan,nan,nan,LaLiga
19-06-17,18.3.4.28,Maxime Lestienne,18018644,757,17-Jun-92,25,0,0,9,1,5250,6250,6000,129,122,1512067,176,65,AM LC,3,4,2,3,1,1,2,1,2,2,3,12,12,14,12,14,12,5,13,5,5,10,5,8,14,7,9,12,14,9,14,14,12,16,8,14,5,6,6,15,15,8,9,20,14,14,11,10,6,6,14,10,11,11,12,15,15,8,8,10,8,5,1,1,14,20,13,20,15,AM LC,504,1,1,15,15,20,13,1,1,1,1,13,14,10,1,1,16.0,0,0,0,0,1,0,0,0,0,0,0,0,0,0,0,0,0,0,0,0,0,0,0,0,0,0,0,0,0,0,0,0,0,0,0,0,0,0,0,0,0,0,0,0,0,0,0,0,Maxime Lestienne,Â£2.25m ,28.0,176.0,Forward - Left Winger,left,Standard LiÃ¨ge,16.0,3.0,2.0,849.0,24.0,3.0,2.0,1141.0,33.0,5.0,3.0,1800.0,34.0,10.0,5.0,2329.0,7.0,1.0,2.0,505.0,LaLiga
19-06-17,18.3.4.28,Adnan Januzaj,18054092,757,05-Feb-95,22,5,0,0,0,6000,6500,7200,155,139,37506998,180,75,M/AM RLC,2,3,2,1,1,2,2,1,3,3,1,12,13,17,12,15,13,5,12,3,4,15,12,6,16,10,12,8,13,11,16,13,10,17,5,12,4,10,9,15,15,15,9,20,12,14,11,12,7,10,5,12,6,15,18,15,10,12,10,7,17,11,1,1,18,20,20,18,19,M/AM RLC,526,1,1,14,19,18,20,1,1,1,1,12,18,16,1,1,2.8823e+17,0,0,0,0,0,0,0,0,0,0,0,0,0,0,0,0,0,0,0,0,0,0,0,0,1,0,0,1,0,0,0,0,0,0,1,0,0,0,0,0,0,0,0,0,0,0,0,0,Adnan Januzaj,Â£10.80m ,25.0,186.0,Forward - Right Winger,left,Real Sociedad,29.0,2.0,3.0,1956.0,35.0,4.0,6.0,2004.0,24.0,2.0,4.0,1475.0,29.0,8.0,4.0,1443.0,6.0,2.0,0.0,126.0,LaLiga,15-07-16,17.3.2.23,Adnan Januzaj,18054092,757,05-Feb-95,21,5,0,0,0,5350,6250,6800,155,136,19316225,180,75,M/AM RLC,2,3,2,3,2,3,1,4,2,2,1,12,13,16,12,15,13,5,12,3,4,16,12,6,17,11,11,8,14,9,14,10,10,17,5,10,4,9,9,16,15,15,9,20,12,13,11,11,7,8,5,11,6,15,18,15,10,12,10,7,17,11,Adnan Januzaj,Â£6.30m ,Premier League
19-06-17,18.3.4.28,Philippe Coutinho,19046041,1651,12-Jun-92,25,27,7,7,3,8250,8750,8700,179,174,232186002,172,71,AM RLC,1,3,1,3,2,1,3,1,3,1,1,13,14,18,14,17,15,8,16,3,11,15,12,11,18,11,14,12,17,15,17,15,16,18,13,16,13,15,15,14,17,16,8,13,13,13,20,14,12,15,8,15,9,13,16,16,12,13,14,13,14,4,1,1,15,20,15,20,18,AM RLC,506,1,1,8,18,20,15,1,1,1,1,15,14,10,1,1,1.46385e+17,0,0,0,0,0,0,0,0,1,0,0,0,0,0,0,0,0,0,0,0,1,0,0,0,0,0,0,0,0,0,0,0,0,0,0,0,0,0,0,0,0,0,0,0,1,0,0,0,Philippe Coutinho,Â£90.00m ,28.0,172.0,Midfielder - Attacking Midfield,right,FC Barcelona,36.0,14.0,9.0,2531.0,42.0,21.0,15.0,2992.0,54.0,11.0,5.0,3345.0,38.0,11.0,9.0,2145.0,6.0,2.0,2.0,405.0,Premier League,15-07-16,17.3.2.23,Philippe Coutinho,19046041,1651,12-Jun-92,24,17,4,7,3,7150,8400,8000,172,164,130624275,172,71,AM LC,4,3,3,3,2,2,1,1,2,3,1,11,13,18,13,16,12,5,15,3,8,15,10,11,18,11,14,12,17,13,17,14,15,18,6,15,13,15,15,15,17,15,6,12,13,13,20,14,11,14,8,14,9,11,14,16,12,13,17,13,15,4,Philippe Coutinho,Â£40.50m ,Premier League
19-06-17,18.3.4.28,Fahad Al-Muwallad,23167067,133,14-Sep-94,22,40,9,0,0,3300,6000,6000,143,120,11129029,167,59,M/AM RL,3,1,2,2,2,1,1,4,2,2,2,6,8,14,10,10,7,2,11,9,2,10,9,4,12,7,11,11,7,7,5,6,11,12,14,11,3,10,12,17,16,4,5,20,11,18,10,8,7,11,5,7,4,11,7,13,9,11,10,10,19,1,1,1,17,20,15,20,1,M/AM RL,525,1,1,15,1,20,15,1,1,1,1,1,17,1,1,1,0.0,0,0,0,0,0,0,0,0,0,0,0,0,0,0,0,0,0,0,0,0,0,0,0,0,0,0,0,0,0,0,0,0,0,0,0,0,0,0,0,0,0,0,0,0,0,0,0,0,Fahad Al-Muwallad,Â£900Th. ,26.0,167.0,Forward - Right Winger,right,Al-Ittihad Jeddah,24.0,14.0,4.0,2143.0,13.0,4.0,2.0,872.0,30.0,16.0,8.0,2519.0,8.0,4.0,1.0,662.0,2.0,1.0,0.0,180.0,LaLiga
19-06-17,18.3.4.28,Salem Al-Dawsari,23168001,133,19-Aug-91,25,26,4,0,0,2700,5700,5600,143,114,4263196,175,72,AM RLC,2,2,1,2,1,2,3,2,1,2,3,11,8,16,12,11,12,4,11,11,2,11,10,3,14,11,7,11,11,6,11,8,14,11,8,11,5,9,6,14,16,15,4,15,12,15,20,11,13,11,7,9,11,11,16,10,10,12,10,7,14,15,1,1,5,20,20,17,15,AM RLC,506,1,1,1,15,17,20,1,1,1,1,5,1,1,1,1,70918500000000.0,0,0,0,0,0,0,0,0,0,0,0,0,0,0,0,0,0,0,0,0,0,0,0,0,0,0,0,0,0,0,0,0,0,0,0,0,0,0,0,1,0,0,0,0,0,0,1,0,Salem Al-Dawsari,Â£720Th. ,29.0,171.0,Forward - Left Winger,right,Al-Hilal Riyadh,35.0,5.0,9.0,2292.0,15.0,4.0,1.0,1100.0,35.0,8.0,6.0,2983.0,27.0,5.0,9.0,2185.0,1.0,0.0,0.0,29.0,LaLiga
19-06-17,18.3.4.28,Riza Durmisi,27043476,764,08-Jan-94,23,20,0,9,1,6250,6750,6750,144,132,12947845,168,68,D/WB/M L,2,2,1,1,1,2,2,1,2,2,3,13,12,14,10,13,14,5,11,12,11,14,10,11,14,15,14,12,10,10,12,10,8,15,9,13,8,11,13,17,15,13,4,20,10,15,10,14,8,11,10,10,8,16,14,16,8,13,11,6,6,11,20,18,16,15,1,20,10,D/WB/M L,123,1,1,10,10,15,1,1,20,1,1,10,16,1,18,1,4295131168.0,0,0,0,0,0,1,0,0,0,0,0,0,0,0,0,1,0,1,0,0,0,0,0,0,0,0,0,0,0,0,0,0,1,0,0,0,0,0,0,0,0,0,0,0,0,0,0,0,Riza Durmisi,Â£4.50m ,26.0,168.0,Defender - Left-Back,left,SS Lazio,29.0,1.0,4.0,2568.0,25.0,2.0,3.0,2144.0,19.0,0.0,0.0,823.0,5.0,0.0,0.0,234.0,nan,nan,nan,nan,LaLiga,15-07-16,17.3.2.23,Riza Durmisi,27043476,764,08-Jan-94,22,11,0,9,1,6250,6750,6750,152,135,6364103,168,68,D/WB/M L,3,3,1,4,2,2,3,3,3,1,2,13,12,14,10,13,14,5,11,12,11,14,10,11,14,15,14,12,10,10,12,10,8,15,9,13,8,11,13,17,15,13,4,20,10,15,10,14,8,11,10,10,8,16,14,16,8,13,11,6,6,11,Riza Durmisi,Â£5.40m ,LaLiga
19-06-17,18.3.4.28,Pione Sisto,27058550,764,04-Feb-95,22,4,0,6,4,6000,7250,7250,155,145,27218652,171,64,M/AM RL,1,2,1,3,1,2,1,2,2,3,3,11,12,16,13,15,15,7,17,3,7,14,14,13,17,11,14,7,10,12,12,12,15,17,7,13,8,11,14,16,14,14,9,13,14,13,20,13,9,9,3,13,2,14,8,16,17,9,16,16,15,3,1,1,19,20,20,18,11,M/AM RL,525,1,1,10,11,18,20,1,1,1,1,8,17,19,1,1,1.46367e+17,0,0,0,0,0,0,0,0,1,0,0,1,0,0,0,0,0,0,0,0,0,0,0,0,0,0,0,0,0,0,0,0,0,0,0,1,0,0,0,0,0,0,0,0,0,0,0,0,Pione Sisto,Â£13.50m ,25.0,172.0,Forward - Left Winger,right,FC Midtjylland,56.0,12.0,4.0,3361.0,36.0,6.0,9.0,2658.0,27.0,2.0,1.0,968.0,23.0,4.0,0.0,1009.0,10.0,3.0,1.0,554.0,LaLiga,15-07-16,17.3.2.23,Pione Sisto,27058550,764,04-Feb-95,21,2,0,4,1,5100,6250,6500,150,135,11227613,171,64,M/AM RL,4,3,3,2,1,1,2,2,4,2,1,11,12,16,12,14,15,7,14,5,6,13,14,5,17,12,14,7,10,8,12,8,15,17,7,13,7,11,14,16,14,14,7,13,14,14,20,13,9,9,3,13,2,14,8,16,17,9,16,16,15,3,Pione Sisto,Â£4.50m ,LaLiga
19-06-17,18.3.4.28,Enis Bardhi,27102027,781,02-Jul-95,21,0,0,2,0,4500,6600,6600,150,132,14626390,172,70,M/AM LC,1,1,3,1,2,2,2,1,1,1,1,14,12,15,12,14,17,8,16,5,8,15,12,10,14,12,12,12,13,13,14,14,15,15,8,13,9,13,13,13,13,14,6,12,13,12,20,12,8,14,9,13,8,13,15,12,12,13,14,15,8,7,1,1,18,20,10,17,20,M/AM LC,524,1,1,10,20,17,10,1,1,1,10,18,13,1,1,1,35768500000000.0,0,0,0,0,0,0,0,0,1,0,0,0,0,0,0,0,0,0,0,0,0,0,0,0,0,0,0,0,0,0,0,0,0,0,0,1,0,0,0,1,0,0,0,0,0,1,0,0,Enis Bardhi,Â£5.40m ,25.0,172.0,Midfielder - Central Midfield,right,Levante UD,33.0,13.0,7.0,2315.0,30.0,9.0,2.0,1812.0,38.0,3.0,4.0,2935.0,32.0,7.0,4.0,2184.0,5.0,0.0,0.0,384.0,LaLiga
19-06-17,18.3.4.28,Emre Mor,27102375,799,24-Jul-97,19,12,1,1,0,5250,7250,6750,159,135,23193624,169,64,M/AM/S RLC,1,3,1,2,2,3,1,1,3,2,1,12,11,17,10,13,10,5,11,5,4,13,10,6,17,10,12,7,12,8,14,8,12,18,4,14,6,4,10,18,18,8,5,20,12,13,9,11,5,10,13,14,8,14,10,18,5,15,9,6,5,16,1,1,19,20,20,15,18,M/AM/S RLC,536,1,1,16,18,15,20,1,1,1,1,8,15,19,1,1,2.8823e+17,0,0,0,0,0,0,0,0,0,0,0,0,0,0,1,0,0,0,0,0,1,0,0,0,0,0,0,0,0,1,0,0,0,0,0,1,0,0,0,0,0,0,0,0,0,0,0,0,Emre Mor,Â£2.70m ,23.0,169.0,Forward - Right Winger,left,Celta de Vigo,19.0,1.0,2.0,694.0,27.0,1.0,3.0,940.0,12.0,0.0,0.0,468.0,19.0,0.0,0.0,639.0,6.0,0.0,0.0,333.0,LaLiga,15-07-16,17.3.2.23,Emre Mor,27102375,799,24-Jul-97,18,4,0,1,0,5500,7250,7000,144,135,61268808,169,64,M/AM/S RLC,2,3,1,2,3,2,2,1,1,1,3,12,12,18,10,13,10,5,11,5,4,13,10,6,17,10,12,7,12,8,14,8,12,18,4,13,5,7,9,18,18,9,5,20,12,13,9,10,5,10,13,14,8,14,14,17,6,15,10,7,6,16,Emre Mor,Â£4.50m ,Bundesliga
19-06-17,18.3.4.28,Andreas Pereira,28085588,1651,01-Jan-96,21,0,0,3,1,4945,5206,6750,155,134,48232947,178,71,M/AM RLC,1,3,1,1,3,3,3,4,3,2,1,17,12,14,10,15,17,4,15,4,2,15,14,6,16,12,10,7,12,9,14,10,12,19,3,14,3,9,9,15,14,11,6,16,12,15,20,12,7,6,8,9,9,6,11,17,13,9,12,10,14,7,1,1,18,20,16,18,20,M/AM RLC,526,1,1,1,20,18,16,1,1,1,1,18,15,15,1,1,103079000000.0,0,0,0,0,0,0,0,0,1,0,0,0,0,0,0,0,0,0,0,0,0,0,0,0,0,0,0,0,0,0,0,0,0,0,0,1,1,0,0,0,0,0,0,0,0,0,0,0,Andreas Pereira,Â£5.40m ,24.0,178.0,Midfielder - Attacking Midfield,right,SS Lazio,37.0,5.0,3.0,2881.0,29.0,1.0,5.0,1490.0,23.0,1.0,1.0,951.0,40.0,2.0,4.0,2327.0,1.0,0.0,0.0,11.0,LaLiga,15-07-16,17.3.2.23,Andreas Pereira,28085588,1651,01-Jan-96,20,0,0,0,0,4049,5062,6250,150,125,23503254,176,71,M/AM LC,2,1,1,2,2,1,3,2,4,1,2,17,12,14,10,15,17,4,15,4,2,15,14,6,16,10,10,7,12,9,14,10,12,19,3,12,3,9,12,14,14,11,6,16,7,13,20,12,7,6,6,11,10,6,11,17,10,9,12,10,14,1,Andreas Pereira,Â£4.50m ,Premier League
19-06-17,18.3.4.28,Claudio Beauvue,34011705,917498,16-Apr-88,29,2,1,0,0,6000,6550,6550,145,131,5200247,174,66,M/AM RL,3,3,1,2,2,2,1,1,3,1,3,6,11,13,15,13,11,14,11,6,5,10,12,5,13,8,14,10,13,14,8,12,12,12,5,14,8,12,11,15,14,11,12,7,14,15,20,13,10,12,8,14,8,8,9,15,12,10,11,13,13,12,1,1,16,20,20,17,11,M/AM RL,525,1,1,15,11,17,20,1,1,1,1,1,15,16,1,1,2251800000000000.0,0,0,0,0,1,0,0,0,0,0,0,0,0,0,0,0,0,0,0,0,0,0,0,0,0,0,0,0,0,0,0,0,0,0,0,0,0,0,0,0,0,0,0,0,0,0,0,0,Claudio Beauvue,Â£2.25m ,32.0,174.0,Forward - Centre-Forward,right,Deportivo de La CoruÃ±a,19.0,2.0,2.0,749.0,35.0,3.0,0.0,2151.0,28.0,3.0,0.0,1762.0,11.0,2.0,0.0,428.0,2.0,1.0,0.0,149.0,LaLiga,15-07-16,17.3.2.23,Claudio Beauvue,34011705,917498,16-Apr-88,28,2,1,0,0,6000,6650,6650,145,133,7655549,174,66,M/AM RL,2,1,3,1,3,3,2,1,1,1,3,6,11,13,15,13,11,14,11,6,5,10,12,5,13,8,14,10,13,14,8,12,12,12,5,14,8,12,11,17,15,11,12,7,14,15,20,13,10,12,8,14,8,8,11,15,12,10,11,13,13,12,Claudio Beauvue,Â£2.70m ,LaLiga
19-06-17,18.3.4.28,Nordin Amrabat,37001123,34,31-Mar-87,30,23,4,7,0,5500,7300,6750,156,134,31135199,179,77,AM/S RLC,1,1,3,3,1,2,2,1,1,1,3,11,10,16,6,13,11,7,9,8,7,12,15,7,14,14,6,12,8,12,12,7,17,14,5,13,9,8,14,16,15,12,7,12,16,15,20,14,13,11,13,11,4,13,12,19,16,9,14,7,11,8,1,13,14,20,17,20,15,AM/S RLC,516,1,1,17,15,20,17,1,1,1,1,1,14,14,1,13,2251800000000000.0,0,0,0,0,0,0,0,0,0,0,0,0,0,0,0,0,1,0,0,0,0,0,0,0,0,0,0,0,0,0,0,0,0,0,0,0,0,0,0,0,0,0,0,0,0,0,0,0,Nordin Amrabat,Â£2.70m ,33.0,179.0,Forward - Right Winger,right,Al-Nassr FC,29.0,0.0,3.0,2100.0,39.0,3.0,3.0,2160.0,30.0,5.0,10.0,2417.0,35.0,5.0,12.0,3013.0,1.0,0.0,0.0,90.0,Premier League,15-07-16,17.3.2.23,Nordin Amrabat,37001123,34,31-Mar-87,29,23,4,0,0,5497,7297,6747,156,136,19836307,179,77,WB/AM/S RLC,2,3,1,2,2,4,2,3,2,3,3,11,10,16,7,13,11,7,9,8,7,12,15,7,14,13,6,12,9,12,12,7,17,14,5,13,9,8,14,16,15,12,7,12,16,15,20,14,13,11,13,11,4,12,12,19,16,9,14,9,9,8,Nordin Amrabat,Â£4.05m ,Premier League
19-06-17,18.3.4.28,Zakaria Bakkali,37039258,757,26-Jan-96,21,2,0,6,1,5700,6500,6500,148,130,9098949,164,59,M/AM RL,3,3,1,1,1,1,1,2,1,1,3,7,14,17,12,15,12,6,13,6,3,12,11,7,16,6,12,14,15,9,12,11,14,17,3,15,5,11,7,16,17,14,4,14,14,13,20,6,9,9,7,13,13,13,10,17,4,12,8,7,7,12,1,1,16,20,19,20,13,M/AM RL,525,1,1,14,13,20,19,1,1,1,1,1,16,14,1,1,1.46367e+17,0,0,0,0,0,0,0,1,0,0,0,0,0,0,0,0,0,0,0,0,0,0,0,0,0,0,0,0,0,0,0,0,0,0,0,0,0,0,0,0,0,0,0,0,0,0,0,0,Zakaria Bakkali,Â£1.35m ,24.0,168.0,Forward - Left Winger,right,RSC Anderlecht,21.0,2.0,1.0,399.0,24.0,0.0,1.0,995.0,22.0,3.0,2.0,1420.0,4.0,1.0,0.0,54.0,2.0,0.0,0.0,120.0,LaLiga,15-07-16,17.3.2.23,Zakaria Bakkali,37039258,757,26-Jan-96,20,2,0,6,1,5700,6200,6500,156,136,10419436,164,59,M/AM RL,3,2,3,2,3,1,3,1,1,3,2,7,14,17,12,15,12,6,13,12,3,12,10,7,16,12,12,14,15,9,12,11,14,17,3,15,5,11,7,16,18,14,4,14,14,13,20,6,9,9,4,13,13,13,12,17,4,12,10,7,6,12,Zakaria Bakkali,Â£1.80m ,LaLiga
19-06-17,18.3.4.28,Roberto Soriano,43044387,776,08-Feb-91,26,8,0,14,2,6400,7150,7250,153,146,38261962,182,76,M/AM LC,4,2,3,2,2,3,2,2,3,1,3,11,11,14,13,14,10,9,14,5,9,15,9,10,16,10,14,13,13,13,15,14,13,14,10,14,13,14,14,14,14,13,10,12,12,13,20,14,13,13,12,12,7,12,16,14,12,13,10,12,8,8,1,1,20,17,7,18,20,M/AM LC,414,1,1,1,17,15,7,1,1,1,1,20,18,7,1,1,131072.0,0,0,0,0,0,0,0,0,0,0,0,0,0,0,0,0,0,1,0,0,0,0,0,0,0,0,0,0,0,0,0,0,0,0,0,0,0,0,0,0,0,0,0,0,0,0,0,0,Roberto Soriano,Â£6.75m ,29.0,182.0,Midfielder - Central Midfield,right,Bologna FC 1909,43.0,10.0,8.0,3098.0,30.0,0.0,0.0,1577.0,30.0,3.0,2.0,2124.0,30.0,5.0,10.0,2570.0,5.0,3.0,2.0,440.0,LaLiga,15-07-16,17.3.2.23,Roberto Soriano,43044387,776,08-Feb-91,25,8,0,14,2,6400,7400,7400,153,148,28240633,182,76,M/AM C,1,3,3,2,1,1,2,4,1,2,2,11,11,14,12,14,10,9,13,5,9,15,9,10,16,10,14,13,13,13,15,14,13,14,10,14,13,14,14,14,14,13,10,12,12,13,20,14,13,13,12,12,7,12,16,14,12,13,10,12,10,8,Roberto Soriano,Â£14.40m ,LaLiga
19-06-17,18.3.4.28,Takashi Inui,45005560,116,02-Jun-88,29,19,2,2,0,5350,6400,6700,138,132,8782030,169,59,M/AM LC,3,3,1,3,2,2,3,2,1,2,1,13,12,16,12,15,12,10,10,5,5,14,8,7,16,14,11,6,11,9,14,10,9,18,4,13,6,11,14,17,17,7,6,8,15,14,20,13,5,10,4,8,3,14,10,12,10,8,17,15,18,2,1,1,20,20,14,20,18,M/AM LC,414,1,1,12,18,20,14,1,1,1,9,10,20,14,1,1,1.44115e+17,0,0,0,0,0,0,0,0,0,0,1,1,0,0,0,0,0,0,0,0,1,0,0,0,0,0,0,0,0,0,0,0,0,0,0,0,0,0,0,0,0,0,0,0,0,0,0,0,Takashi Inui,Â£4.50m ,32.0,169.0,Forward - Left Winger,right,SD Eibar,30.0,3.0,4.0,2159.0,35.0,5.0,2.0,2657.0,26.0,2.0,1.0,1579.0,29.0,2.0,4.0,1964.0,7.0,0.0,0.0,555.0,LaLiga,15-07-16,17.3.2.23,Takashi Inui,45005560,116,02-Jun-88,28,19,2,2,0,5350,6400,6700,138,132,9459367,169,59,M/AM LC,3,1,3,1,1,2,2,2,3,2,3,13,12,16,10,15,12,10,10,5,5,14,8,7,16,14,11,6,11,9,14,10,9,18,4,13,6,11,14,17,17,7,6,8,15,14,20,13,5,8,4,8,3,14,10,12,10,8,17,15,18,2,Takashi Inui,Â£2.70m ,LaLiga
19-06-17,18.3.4.28,Gaku Shibasaki,45030130,116,28-May-92,25,13,3,0,0,4750,6650,6600,144,133,8030348,175,62,M/AM LC,1,3,2,3,1,1,4,2,3,1,3,13,13,14,9,15,14,8,10,7,6,16,12,6,15,7,14,8,14,13,16,13,12,13,9,13,11,14,13,12,12,9,6,15,14,13,20,13,8,10,5,13,9,14,8,12,9,11,12,14,15,4,1,1,20,18,10,16,20,M/AM LC,414,1,1,1,18,16,10,1,1,1,12,20,15,8,1,1,17592200000000.0,0,0,0,0,0,0,0,1,0,0,0,0,0,0,0,0,0,0,0,0,1,0,0,0,0,0,0,0,0,0,0,0,0,0,0,0,0,0,0,0,0,0,0,0,1,0,0,0,Gaku Shibasaki,Â£1.62m ,28.0,175.0,Midfielder - Central Midfield,right,CD LeganÃ©s,20.0,4.0,3.0,1502.0,22.0,1.0,0.0,1002.0,9.0,0.0,0.0,500.0,27.0,0.0,2.0,2072.0,7.0,1.0,2.0,426.0,LaLiga
19-06-17,18.3.4.28,Gareth Bale,5132312,801,16-Jul-89,27,66,26,13,3,9000,9300,9000,186,176,232186002,185,82,AM/S RLC,3,3,1,1,1,1,3,2,3,3,2,14,16,16,17,14,17,18,19,15,6,14,13,9,16,10,14,11,12,11,13,12,16,17,9,18,7,9,10,15,14,14,15,20,12,18,11,18,17,11,10,12,17,16,8,14,11,14,14,17,14,12,7,10,15,20,19,20,19,AM/S RLC,516,1,1,16,19,20,19,1,7,1,1,1,15,14,10,1,2286980000000000.0,0,0,0,0,0,0,0,0,1,0,0,1,0,0,0,0,0,0,0,0,0,0,0,0,0,0,0,1,0,0,0,0,0,0,0,0,0,0,0,0,0,0,0,0,0,1,0,0,Gareth Bale,Â£81.00m ,31.0,185.0,Forward - Right Winger,left,Tottenham Hotspur,27.0,9.0,6.0,1936.0,39.0,21.0,7.0,2362.0,42.0,14.0,7.0,2619.0,20.0,3.0,2.0,1260.0,2.0,0.0,1.0,80.0,LaLiga,15-07-16,17.3.2.23,Gareth Bale,5132312,801,16-Jul-89,27,61,22,13,3,9000,9300,9250,190,186,166154910,186,82,AM/S RLC,3,3,1,1,1,4,2,1,2,4,3,14,16,16,17,15,17,19,19,15,6,14,13,9,16,10,14,11,13,11,13,13,16,17,9,18,7,10,10,15,14,14,15,20,13,19,11,18,17,13,10,13,15,16,8,14,11,14,14,17,14,12,Gareth Bale,Â£72.00m ,LaLiga
19-06-17,18.3.4.28,Luisinho,55006171,788,05-May-85,32,0,0,0,0,4050,6650,6650,140,133,4250986,171,67,D/WB/M/AM L,1,3,1,2,3,1,1,3,3,3,1,13,15,15,15,14,12,7,11,9,7,10,13,11,15,13,12,12,10,12,10,11,14,16,10,15,9,8,13,15,14,13,8,20,13,14,8,12,10,10,9,11,11,13,10,14,9,14,8,10,9,12,20,19,18,17,10,20,7,D/WB/M/AM L,133,1,1,1,7,17,10,1,20,1,1,1,18,1,19,1,0.0,0,0,0,0,0,0,0,0,0,0,0,0,0,0,0,0,0,0,0,0,0,0,0,0,0,0,0,0,0,0,0,0,0,0,0,0,0,0,0,0,0,0,0,0,0,0,0,0,Luisinho,Â£1.08m ,35.0,171.0,Defender - Left-Back,left,SD Huesca,30.0,1.0,2.0,2267.0,30.0,1.0,1.0,2622.0,7.0,0.0,0.0,508.0,27.0,0.0,0.0,2179.0,3.0,0.0,0.0,88.0,LaLiga,15-07-16,17.3.2.23,Luisinho,55006171,788,05-May-85,31,0,0,0,0,4050,6050,6200,140,132,1102137,171,67,D/WB/M/AM L,1,4,3,1,3,2,3,1,1,1,3,13,15,15,15,14,12,7,11,9,7,10,13,11,15,13,12,12,10,12,10,11,14,16,10,15,9,8,13,15,14,13,8,20,13,14,8,12,10,10,9,11,11,13,10,14,9,14,8,10,9,12,Luisinho,Â£1.62m ,LaLiga
19-06-17,18.3.4.28,GonÃ§alo Guedes,55041710,788,29-Nov-96,20,2,0,3,1,5750,7650,7650,171,153,206186326,179,68,M/AM/S RL,3,3,1,1,1,2,1,2,1,1,2,10,12,14,12,13,12,8,15,12,7,12,13,7,13,13,13,14,11,12,12,11,16,15,7,14,9,10,14,17,13,13,10,12,16,16,20,16,12,10,11,12,3,11,13,14,17,12,17,15,13,7,1,1,19,20,18,20,7,M/AM/S RL,535,1,1,16,7,20,18,1,1,1,1,1,19,15,1,1,1.44115e+17,0,0,0,1,0,0,0,0,0,1,0,0,0,0,0,0,0,0,0,1,0,0,0,0,0,0,0,0,0,0,0,0,0,0,0,0,0,0,0,0,0,0,0,0,0,0,0,0,GonÃ§alo Guedes,Â£36.00m ,23.0,179.0,Forward - Left Winger,right,Valencia CF,39.0,7.0,8.0,2283.0,40.0,6.0,11.0,2727.0,39.0,8.0,4.0,2471.0,25.0,2.0,2.0,1486.0,6.0,1.0,0.0,414.0,LaLiga,15-07-16,17.3.2.23,GonÃ§alo Guedes,55041710,788,29-Nov-96,19,2,0,3,1,4500,7250,7250,167,145,59999998,179,74,M/AM/S RL,1,1,1,3,2,2,3,2,2,3,4,10,13,12,13,13,12,8,13,12,7,12,13,7,13,14,13,15,8,13,12,8,16,12,7,13,12,12,16,16,13,14,10,12,16,16,20,13,13,12,11,12,3,11,15,11,17,12,17,8,13,7,GonÃ§alo Guedes,Â£15.30m ,Ligue 1
19-06-17,18.3.4.28,Gonzalo Castro,5513024,1657,14-Sep-84,32,5,0,0,0,5750,6500,6700,138,134,232186002,178,77,M/AM L,2,3,1,3,2,4,3,1,2,1,2,14,14,15,13,15,13,10,13,18,3,11,12,6,15,10,15,11,15,8,14,12,14,12,10,15,7,10,11,14,15,12,10,20,12,14,10,10,11,14,9,12,9,13,12,10,15,14,9,15,14,4,1,1,18,20,13,20,14,M/AM L,523,1,1,12,14,20,13,1,1,1,1,5,18,11,1,1,134217729.0,1,0,0,0,0,0,0,0,0,0,0,0,0,0,0,0,0,0,0,0,0,0,0,0,0,0,0,1,0,0,0,0,0,0,0,0,0,0,0,0,0,0,0,0,0,0,0,0,Gonzalo Castro,Â£7.20m ,33.0,172.0,Midfielder - Central Midfield,right,VfB Stuttgart,42.0,4.0,8.0,2885.0,28.0,1.0,3.0,1840.0,28.0,2.0,4.0,1892.0,31.0,3.0,7.0,2321.0,6.0,1.0,1.0,466.0,Bundesliga,15-07-16,17.3.2.23,Gonzalo Castro,8723487,771,11-Jun-87,29,5,0,21,3,4989,6501,7450,150,149,52492005,172,74,M/AM RC,3,1,3,2,1,2,1,2,3,2,3,13,12,13,12,15,12,8,13,10,9,14,11,10,15,11,14,12,16,10,15,16,9,13,10,14,10,17,12,12,16,14,6,12,18,12,20,16,9,12,6,12,2,20,7,11,16,15,17,17,10,5,Gonzalo Castro,Â£13.50m ,Bundesliga
19-06-17,18.3.4.28,AndrÃ©s Guardado,5667723,379,28-Sep-86,30,136,24,0,0,6250,7000,7000,148,137,232186002,169,61,WB/DM/M/AM LC,3,1,3,2,2,1,1,3,3,3,1,13,13,12,10,14,12,6,15,10,9,16,17,10,14,12,11,15,13,12,14,12,17,15,14,15,9,12,15,14,15,14,6,20,14,13,8,10,8,13,8,12,13,13,11,14,12,18,18,12,14,5,14,16,20,16,1,20,20,WB/DM/M/AM LC,344,1,1,4,15,16,1,10,14,1,20,20,20,1,16,1,17180393984.0,0,0,0,0,0,0,0,0,0,1,0,0,0,0,0,0,0,0,0,1,0,0,0,0,0,0,0,0,0,0,0,0,0,0,1,0,0,0,0,0,0,0,0,0,0,0,0,0,AndrÃ©s Guardado,Â£4.50m ,34.0,169.0,Midfielder - Central Midfield,left,Real Betis BalompiÃ©,33.0,2.0,9.0,2784.0,30.0,2.0,8.0,2308.0,42.0,0.0,4.0,3133.0,30.0,0.0,3.0,2134.0,1.0,0.0,0.0,0.0,LaLiga
19-06-17,18.3.4.28,Dejan Drazic,62142788,802,26-Sep-95,21,0,0,1,0,3150,6150,6150,145,123,5651431,178,65,M/AM RLC,1,3,1,3,1,1,2,3,3,2,1,12,13,14,12,13,11,10,11,7,8,12,10,11,15,17,13,10,11,11,10,11,13,15,11,13,8,8,8,16,13,11,10,8,14,15,20,12,9,13,15,14,10,11,8,14,13,12,10,9,9,16,1,1,17,20,18,20,15,M/AM RLC,526,1,1,12,15,20,18,1,1,1,1,1,17,10,1,1,0.0,0,0,0,0,0,0,0,0,0,0,0,0,0,0,0,0,0,0,0,0,0,0,0,0,0,0,0,0,0,0,0,0,0,0,0,0,0,0,0,0,0,0,0,0,0,0,0,0,Dejan Drazic,Â£450Th. ,25.0,178.0,Forward - Left Winger,right,Zaglebie Lubin,15.0,2.0,0.0,323.0,40.0,8.0,0.0,2880.0,38.0,7.0,11.0,2272.0,38.0,9.0,7.0,2582.0,5.0,0.0,1.0,197.0,LaLiga
19-06-17,18.3.4.28,Omar,67009527,796,26-Jan-88,29,0,0,1,0,4000,6100,6100,129,122,1807842,172,61,AM RL,3,3,3,1,3,1,2,4,2,3,1,12,14,15,8,14,10,3,8,6,5,13,11,4,15,8,13,8,10,10,14,11,12,15,6,15,6,9,10,16,15,13,5,20,6,13,10,11,6,11,6,10,13,3,6,12,9,7,8,10,6,12,1,1,14,20,20,19,8,AM RL,505,1,1,10,8,19,20,1,1,1,1,1,14,14,1,1,2322190000000000.0,0,0,0,0,0,0,0,1,0,0,0,0,0,0,0,0,0,0,0,0,0,0,0,0,1,0,0,0,0,0,0,0,0,0,1,0,0,0,0,0,0,0,0,0,0,0,1,0,nan,nan,nan,nan,nan,nan,nan,nan,nan,nan,nan,nan,nan,nan,nan,nan,nan,nan,nan,nan,nan,nan,nan,nan,nan,nan,nan,nan,15-07-16,17.3.2.23,Omar,67009527,796,26-Jan-88,28,0,0,1,0,4000,6400,6400,129,128,1921292,172,61,AM RL,3,1,2,3,3,3,1,2,2,2,1,12,14,15,8,15,10,3,8,6,5,13,11,4,15,8,13,8,10,10,14,11,12,15,6,15,6,10,10,16,16,13,5,20,6,14,10,12,6,11,6,10,13,3,6,12,9,7,8,10,6,12,nan,nan,nan
19-06-17,18.3.4.28,Denis Cheryshev,67011250,791,26-Dec-90,26,9,0,18,7,5500,6350,6350,138,127,1285309,179,74,M/AM L,1,3,1,3,1,1,1,1,3,2,1,12,12,13,10,14,10,11,13,8,8,11,12,12,13,15,11,14,10,11,10,10,12,13,9,14,7,11,13,14,13,13,11,20,12,15,10,15,11,13,11,12,14,15,8,11,10,9,13,11,10,9,8,13,20,19,12,20,9,M/AM L,413,1,1,14,9,19,12,1,8,1,1,1,20,10,13,1,134217729.0,1,0,0,0,0,0,0,0,0,0,0,0,0,0,0,0,0,0,0,0,0,0,0,0,0,0,0,1,0,0,0,0,0,0,0,0,0,0,0,0,0,0,0,0,0,0,0,0,Denis Cheryshev,Â£2.70m ,29.0,179.0,Forward - Left Winger,left,Valencia CF,18.0,0.0,2.0,767.0,32.0,4.0,3.0,1277.0,41.0,4.0,5.0,2218.0,31.0,3.0,2.0,1202.0,2.0,0.0,1.0,56.0,LaLiga,15-07-16,17.3.2.23,Denis Cheryshev,67011250,791,26-Dec-90,25,9,0,18,7,6100,7250,7100,151,142,18173063,179,74,M/AM L,2,2,2,2,2,2,2,2,3,1,3,12,13,14,12,15,11,12,14,9,8,11,12,12,13,15,11,14,12,12,13,10,12,13,9,16,9,12,15,14,13,13,11,20,12,15,11,15,12,13,11,12,14,15,20,11,10,9,13,11,10,9,Denis Cheryshev,Â£2.70m ,LaLiga
19-06-17,18.3.4.28,Dani Castellano,67014275,796,02-Nov-87,29,0,0,0,0,4250,6200,6200,130,124,3205049,180,76,D/WB L,1,4,1,1,1,2,2,2,1,3,4,11,12,12,8,12,9,8,9,12,10,13,10,11,13,12,14,14,13,13,11,13,12,11,9,14,11,14,14,13,12,9,11,20,13,14,8,14,12,13,5,10,14,13,12,14,8,10,12,14,14,11,20,18,15,14,1,20,1,D/WB L,113,1,1,1,1,14,1,1,20,1,1,1,15,1,18,1,1099510000000.0,0,0,0,0,0,0,0,0,0,0,0,0,0,0,0,0,0,0,0,0,0,0,0,0,0,0,0,0,0,0,0,0,0,0,0,0,0,0,0,0,1,0,0,0,0,0,0,0,Dani Castellano,Â£1.80m ,32.0,180.0,Defender - Left-Back,left,UD Las Palmas,29.0,0.0,2.0,2290.0,26.0,0.0,2.0,2191.0,22.0,0.0,1.0,1682.0,9.0,0.0,1.0,394.0,5.0,0.0,0.0,450.0,LaLiga,15-07-16,17.3.2.23,Dani Castellano,67014275,796,02-Nov-87,28,0,0,0,0,4250,6300,6300,130,127,2222545,180,76,D/WB L,1,3,2,2,1,3,3,2,3,3,1,11,12,12,8,12,9,8,9,12,10,13,10,12,13,12,14,14,13,13,11,13,12,11,9,14,12,14,14,13,12,9,11,20,13,14,10,14,12,13,5,10,14,13,12,14,8,10,12,14,14,11,Dani Castellano,Â£3.60m ,LaLiga
19-06-17,18.3.4.28,Nolito,67017094,796,15-Oct-86,30,16,6,0,0,7143,7893,7250,164,143,232186002,175,69,AM/S L,1,3,1,2,2,2,2,1,1,2,1,15,12,15,14,15,12,9,13,6,4,13,15,10,15,14,13,12,14,13,13,13,10,16,14,15,10,12,10,14,15,13,9,12,12,13,20,14,13,12,14,14,7,12,12,14,12,10,10,7,10,12,1,1,14,20,12,20,13,AM/S L,513,1,1,16,13,20,12,1,1,1,1,1,14,9,1,1,2252350000000000.0,0,0,0,0,0,0,0,0,0,0,0,1,0,0,0,0,0,0,0,0,0,0,0,0,0,0,0,0,0,0,0,0,0,0,0,0,0,0,0,1,0,0,0,0,0,0,0,0,Nolito,Â£4.50m ,34.0,175.0,Forward - Left Winger,right,Celta de Vigo,30.0,6.0,5.0,1349.0,42.0,5.0,7.0,2128.0,17.0,5.0,3.0,963.0,27.0,7.0,4.0,1534.0,6.0,0.0,1.0,453.0,LaLiga,15-07-16,17.3.2.23,Nolito,67017094,796,15-Oct-86,29,13,5,0,0,7150,7900,7900,164,151,77773554,175,73,AM/S L,2,3,2,1,4,1,2,1,3,1,3,15,12,15,14,15,12,9,13,6,4,13,15,10,16,9,13,12,14,13,13,14,10,16,14,15,10,12,10,15,15,14,9,15,12,13,20,14,13,12,14,14,7,12,12,14,12,10,10,7,10,12,Nolito,Â£10.80m ,Premier League
19-06-17,18.3.4.28,Aday,67029382,796,16-Dec-87,29,0,0,0,0,3400,6250,6250,127,126,3131555,179,78,D/WB/M/AM RL,1,2,1,3,4,2,1,2,3,2,1,11,13,13,8,13,8,7,9,11,7,12,7,7,14,11,11,12,11,11,12,12,12,13,10,14,9,11,11,13,13,12,7,12,11,13,20,12,9,14,12,7,11,18,17,12,13,11,12,9,8,7,19,18,20,18,20,19,1,D/WB/M/AM RL,445,1,1,1,1,10,18,1,19,15,1,1,15,20,16,18,2.0,0,1,0,0,0,0,0,0,0,0,0,0,0,0,0,0,0,0,0,0,0,0,0,0,0,0,0,0,0,0,0,0,0,0,0,0,0,0,0,0,0,0,0,0,0,0,0,0,Aday,Â£1.80m ,32.0,178.0,Defender - Left-Back,right,Girona FC,35.0,0.0,9.0,2598.0,32.0,2.0,0.0,1840.0,10.0,0.0,2.0,647.0,33.0,2.0,2.0,2337.0,2.0,0.0,0.0,135.0,LaLiga
19-06-17,18.3.4.28,JosÃ© Morales,67030120,796,23-Jul-87,29,0,0,0,0,4250,7000,7000,143,141,17788810,180,70,M/AM RL,3,3,1,2,1,3,1,1,4,1,1,9,13,15,11,13,9,8,11,7,8,12,13,9,15,11,12,10,14,13,12,12,16,15,14,14,9,12,13,14,15,9,9,12,16,16,20,15,9,14,8,15,7,16,13,14,17,15,16,14,14,6,10,10,18,20,19,20,10,M/AM RL,525,1,1,5,10,20,19,1,5,10,1,8,17,18,5,10,2251800000000000.0,0,0,0,0,0,0,0,0,0,0,0,0,0,0,0,0,0,0,0,0,0,0,0,0,0,0,0,0,0,0,0,0,0,0,0,0,0,0,0,0,0,0,0,0,0,0,0,0,JosÃ© Luis Morales,Â£4.50m ,33.0,180.0,Forward - Centre-Forward,right,Levante UD,40.0,4.0,4.0,3087.0,39.0,12.0,10.0,3284.0,38.0,12.0,5.0,3224.0,41.0,4.0,3.0,2785.0,5.0,3.0,1.0,384.0,LaLiga
19-06-17,18.3.4.28,Keko,67037308,796,27-Dec-91,25,0,0,0,0,4500,7000,6800,142,136,9312138,172,66,M/AM RLC,4,3,1,2,1,3,2,1,2,2,3,14,15,15,13,13,9,5,12,7,3,14,10,7,14,10,14,11,13,10,15,10,12,11,8,14,11,9,11,15,15,15,7,12,13,15,20,11,10,12,6,10,6,12,13,16,14,14,13,15,11,7,1,1,19,20,20,17,16,M/AM RLC,526,1,1,7,16,17,20,1,1,1,1,5,16,19,1,1,1134020000000.0,0,0,0,0,0,0,0,0,0,0,0,0,0,0,0,0,0,0,0,0,0,0,0,0,1,0,0,1,0,0,0,0,0,0,0,1,0,0,0,0,1,0,0,0,0,0,0,0,Keko,Â£1.80m ,28.0,172.0,Forward - Right Winger,right,Deportivo de La CoruÃ±a,22.0,0.0,3.0,1052.0,21.0,0.0,2.0,1216.0,29.0,2.0,1.0,1702.0,14.0,0.0,3.0,465.0,2.0,0.0,0.0,173.0,LaLiga,15-07-16,17.3.2.23,Keko,67037308,796,27-Dec-91,24,0,0,0,0,4500,7050,7050,152,141,19493127,172,67,M/AM RLC,3,3,3,3,3,2,2,2,3,2,1,14,15,14,13,13,9,6,12,7,4,14,10,7,14,10,15,11,12,11,14,13,18,15,8,14,7,9,11,15,15,15,6,12,14,15,20,13,10,12,6,10,6,12,13,16,14,14,13,15,11,7,Keko,Â£2.70m ,LaLiga
19-06-17,18.3.4.28,Iker Muniain,67037570,796,19-Dec-92,24,1,0,26,6,5750,7150,7150,152,145,39685714,169,63,M/AM LC,4,1,2,2,1,1,3,2,3,3,2,10,11,17,12,15,8,4,12,2,4,14,10,8,16,12,15,15,13,11,14,11,14,18,12,15,8,11,14,17,17,16,5,10,12,14,20,14,6,12,7,14,6,14,13,14,14,11,11,8,8,14,1,1,17,20,14,20,19,M/AM LC,524,1,1,11,19,20,14,1,1,1,1,10,17,10,1,1,584116000000.0,0,0,1,0,0,0,0,0,0,0,0,0,0,0,0,0,0,0,0,1,0,0,0,0,0,0,0,0,0,0,0,0,0,0,0,1,0,0,0,1,0,0,0,0,0,0,0,0,Iker Muniain,Â£9.00m ,27.0,169.0,Forward - Left Winger,right,Athletic Bilbao,46.0,7.0,5.0,3150.0,20.0,5.0,4.0,1298.0,37.0,7.0,5.0,2543.0,37.0,6.0,2.0,2868.0,6.0,0.0,0.0,409.0,LaLiga,15-07-16,17.3.2.23,Iker Muniain,67037570,796,19-Dec-92,23,1,0,26,6,5750,7150,7150,152,144,30950199,169,63,M/AM LC,1,1,3,3,1,2,2,2,4,2,3,10,11,17,12,15,8,4,12,2,4,14,10,8,16,12,15,15,13,11,14,11,14,18,12,15,8,11,14,17,17,16,5,10,12,14,20,14,6,11,7,14,6,14,13,14,14,11,10,7,7,14,Iker Muniain,Â£13.50m ,LaLiga
19-06-17,18.3.4.28,Dani Pacheco,67039927,796,05-Jan-91,26,0,0,1,0,4000,6250,6250,135,125,4063866,168,61,AM/S LC,2,1,3,2,2,3,3,3,1,1,2,11,11,15,13,16,14,4,13,5,4,13,12,6,16,7,11,8,12,8,14,10,10,16,4,13,4,9,12,16,14,15,5,12,12,12,20,10,5,10,4,10,5,8,15,14,6,12,10,10,7,10,1,1,9,20,13,20,18,AM/S LC,514,1,1,19,18,20,13,1,1,1,1,1,9,6,1,1,17592200000000.0,0,0,0,0,0,0,0,0,0,0,0,0,0,0,0,0,0,0,0,1,0,0,0,0,0,0,0,0,0,0,0,0,0,0,0,0,0,0,0,0,0,0,0,0,1,0,0,0,Dani Pacheco,Â£720Th. ,29.0,168.0,Forward - Left Winger,both,Without Club,34.0,6.0,3.0,2534.0,12.0,0.0,0.0,196.0,24.0,1.0,3.0,1322.0,22.0,1.0,1.0,1371.0,nan,nan,nan,nan,LaLiga
19-06-17,18.3.4.28,Francisco Portillo,67044761,796,13-Jun-90,27,0,0,0,0,4300,6300,6300,130,126,4360368,169,63,AM LC,3,3,2,2,2,3,1,2,3,3,1,14,13,13,10,13,14,6,10,5,6,14,4,7,13,6,14,10,13,12,14,15,14,14,9,14,11,12,12,13,13,12,5,12,13,13,20,12,8,13,8,2,7,9,19,12,14,12,12,12,11,4,1,1,14,20,14,19,20,AM LC,504,1,1,1,20,19,14,1,1,1,1,12,14,10,1,1,0.0,0,0,0,0,0,0,0,0,0,0,0,0,0,0,0,0,0,0,0,0,0,0,0,0,0,0,0,0,0,0,0,0,0,0,0,0,0,0,0,0,0,0,0,0,0,0,0,0,Francisco Portillo,Â£1.80m ,30.0,169.0,Forward - Right Winger,right,Getafe CF,38.0,4.0,8.0,2873.0,35.0,2.0,3.0,2601.0,37.0,2.0,5.0,2342.0,23.0,0.0,2.0,834.0,1.0,0.0,0.0,4.0,LaLiga
19-06-17,18.3.4.28,Pablo Sarabia,67045428,796,11-May-92,25,0,0,13,2,5000,7300,7300,155,146,24430727,174,70,WB/M/AM RLC,2,3,3,2,2,1,3,2,2,3,2,14,15,16,11,15,16,8,13,5,8,15,12,6,16,10,11,10,12,14,15,12,9,16,8,14,5,12,13,15,16,9,7,20,12,14,9,13,9,12,9,15,10,14,19,12,10,12,13,14,10,10,8,16,18,20,20,19,18,WB/M/AM RLC,536,1,1,10,18,19,20,1,8,1,1,15,18,12,16,1,2192.0,0,0,0,0,1,0,0,1,0,0,0,1,0,0,0,0,0,0,0,0,0,0,0,0,0,0,0,0,0,0,0,0,0,0,0,0,0,0,0,0,0,0,0,0,0,0,0,0,Pablo Sarabia,Â£18.00m ,28.0,174.0,Forward - Right Winger,left,Paris Saint-Germain,46.0,11.0,12.0,2809.0,53.0,9.0,9.0,3753.0,52.0,23.0,17.0,3729.0,40.0,14.0,8.0,2409.0,9.0,1.0,4.0,464.0,LaLiga,15-07-16,17.3.2.23,Pablo Sarabia,67045428,796,11-May-92,24,0,0,13,2,5000,7300,7300,155,146,24999999,174,70,WB/M/AM RLC,2,2,1,3,1,1,3,2,2,2,2,14,15,16,11,16,16,8,12,5,8,16,12,6,17,10,11,10,12,11,15,12,9,16,8,14,5,11,10,15,16,9,7,20,12,14,8,13,9,12,9,15,10,14,7,12,10,12,13,14,10,10,Pablo Sarabia,Â£13.50m ,LaLiga
19-06-17,18.3.4.28,Cristian Tello,67046417,796,11-Aug-91,25,1,0,12,2,5850,7250,7250,153,146,27376978,178,66,M/AM RL,1,3,3,2,3,3,2,2,2,1,1,11,13,14,12,14,8,6,10,5,5,13,11,6,14,11,13,11,12,12,12,13,14,14,9,16,7,11,12,17,15,12,8,14,14,16,20,13,8,11,7,13,8,12,13,13,12,12,13,14,15,5,1,9,17,20,19,20,1,M/AM RL,525,1,1,13,1,20,19,1,1,1,1,1,14,17,7,9,2252350000000000.0,0,0,0,0,0,0,0,0,0,0,1,1,0,0,0,0,0,0,0,0,0,0,0,0,0,0,0,0,0,0,0,0,0,0,0,0,0,0,0,1,0,0,0,0,0,0,0,0,Cristian Tello,Â£5.40m ,29.0,178.0,Forward - Left Winger,both,Real Betis BalompiÃ©,42.0,4.0,8.0,2416.0,33.0,6.0,4.0,1773.0,41.0,5.0,9.0,2413.0,30.0,3.0,1.0,993.0,7.0,2.0,0.0,316.0,LaLiga,15-07-16,17.3.2.23,Cristian Tello,67046417,796,11-Aug-91,24,1,0,12,2,5850,7000,7050,149,141,27177917,178,66,AM RL,1,3,2,3,1,2,1,2,1,3,3,11,13,14,12,14,8,6,9,5,5,13,11,6,14,11,12,11,12,12,12,12,14,14,9,16,7,11,12,17,15,10,8,14,14,16,20,13,8,11,7,13,10,12,13,13,12,12,13,14,15,5,Cristian Tello,Â£7.20m ,Serie A
19-06-17,18.3.4.28,Koke,67047092,796,08-Jan-92,25,24,0,9,1,7400,8100,8100,169,163,155241911,177,73,M RLC,1,3,2,3,1,2,3,2,1,1,3,16,15,13,13,15,14,9,14,6,13,16,10,14,14,14,15,15,15,17,15,15,16,10,14,15,15,17,16,13,13,15,9,14,14,13,20,15,12,15,10,13,6,18,10,15,17,13,15,11,12,6,1,1,20,14,16,19,20,M RLC,406,1,1,1,14,11,9,1,1,1,12,20,19,16,1,1,4503600000000000.0,0,0,0,0,0,0,1,0,1,0,0,1,0,0,0,0,0,0,0,0,0,0,0,0,0,0,0,0,0,0,0,0,0,0,0,0,0,0,0,0,0,0,0,0,0,0,0,0,Koke,Â£63.00m ,28.0,176.0,Midfielder - Central Midfield,right,AtlÃ©tico Madrid,54.0,5.0,10.0,4694.0,51.0,6.0,7.0,4093.0,41.0,6.0,7.0,3511.0,42.0,5.0,6.0,3526.0,6.0,0.0,0.0,421.0,LaLiga,15-07-16,17.3.2.23,Koke,67047092,796,08-Jan-92,24,24,0,9,1,7500,8200,8200,174,165,59999998,178,73,M RLC,3,3,3,2,1,2,3,3,1,2,3,16,16,13,13,15,14,9,14,6,13,16,10,14,14,14,15,15,16,17,15,16,15,10,14,15,15,17,16,13,13,15,9,14,14,13,20,15,12,15,10,13,6,18,9,14,16,13,15,11,12,6,Koke,Â£54.00m ,LaLiga
19-06-17,18.3.4.28,Enric Saborit,67050445,796,27-Apr-92,25,0,0,0,0,3800,6100,6100,131,122,1390317,186,72,D/WB L,2,3,1,3,2,3,2,1,2,2,2,9,14,12,10,10,7,9,9,7,12,11,5,12,13,10,11,12,10,11,11,11,13,12,9,14,12,13,11,14,13,12,12,20,9,15,10,11,11,10,8,8,7,11,17,14,11,10,13,11,12,2,20,19,15,15,1,20,12,D/WB L,113,1,1,1,1,15,1,12,20,1,1,1,15,1,19,1,1099510000000.0,0,0,0,0,0,1,0,0,0,0,0,0,0,0,0,0,0,0,0,0,0,0,0,0,0,0,0,0,0,0,0,0,0,0,0,0,0,0,0,0,1,0,0,0,0,0,0,0,Enric Saborit,Â£720Th. ,28.0,187.0,Defender - Left-Back,left,Maccabi Tel Aviv,14.0,2.0,0.0,832.0,23.0,0.0,1.0,1747.0,41.0,3.0,5.0,3478.0,36.0,1.0,3.0,3104.0,6.0,0.0,0.0,462.0,LaLiga,15-07-16,17.3.2.23,Enric Saborit,67050445,796,27-Apr-92,24,0,0,0,0,3800,5900,5900,131,118,717699,186,72,D/WB L,1,1,2,1,1,3,4,2,2,1,4,9,14,12,10,10,7,9,5,7,12,11,5,12,13,10,11,12,10,11,11,11,13,12,9,14,12,13,11,14,13,12,12,20,9,15,7,11,11,10,8,11,5,11,8,14,11,10,12,13,14,6,Enric Saborit,Â£450Th. ,LaLiga
19-06-17,18.3.4.28,Jordi Alba,67052513,796,21-Mar-89,28,47,6,4,0,7600,8150,8150,166,161,174122197,170,68,D/WB/M L,2,4,3,4,3,4,1,1,3,3,2,12,14,13,12,16,10,5,10,12,11,13,10,14,15,15,15,15,12,12,14,15,16,13,10,18,12,15,16,17,15,15,6,20,13,15,9,17,9,14,14,15,12,12,15,18,14,14,16,6,7,10,20,19,19,15,1,20,1,D/WB/M L,123,1,1,1,1,15,1,1,20,1,1,1,19,1,19,1,4430233633.0,1,0,0,0,0,1,0,0,0,0,0,0,0,0,0,0,0,0,0,0,1,0,0,0,0,0,0,1,0,0,0,0,1,0,0,0,0,0,0,0,0,0,0,0,0,0,0,0,Jordi Alba,Â£54.00m ,31.0,170.0,Defender - Left-Back,left,FC Barcelona,39.0,1.0,6.0,2971.0,48.0,3.0,11.0,4000.0,54.0,3.0,17.0,4510.0,36.0,2.0,9.0,2819.0,4.0,0.0,2.0,342.0,LaLiga,15-07-16,17.3.2.23,Jordi Alba,67052513,796,21-Mar-89,27,47,6,4,0,7750,8250,8250,168,164,47698298,170,68,D/WB/M L,2,3,2,2,2,2,1,1,2,2,3,12,14,13,11,15,10,5,10,12,11,11,10,14,15,15,15,15,13,12,14,15,16,13,10,17,12,15,16,18,16,15,6,20,13,16,8,18,9,15,14,14,12,12,15,18,14,14,16,8,8,9,Jordi Alba,Â£28.80m ,LaLiga
19-06-17,18.3.4.28,Borja GarcÃ­a,67060845,796,02-Nov-90,26,0,0,0,0,4000,6450,6450,136,130,5927460,173,73,AM/S RLC,3,4,2,3,3,2,3,3,2,1,3,12,12,14,14,13,12,8,7,6,3,11,11,4,14,7,12,8,13,13,11,10,15,13,12,13,7,8,8,15,13,13,8,14,14,14,20,13,9,12,12,4,6,14,13,14,13,12,14,14,19,7,1,1,15,20,17,18,20,AM/S RLC,516,1,1,16,20,18,17,1,1,1,1,10,15,15,1,1,18141900000000.0,0,0,0,1,0,0,0,0,0,0,0,0,0,0,0,0,0,0,0,0,0,0,0,0,0,0,0,0,0,0,0,0,0,0,0,0,0,0,0,1,0,0,0,0,1,0,0,0,Borja GarcÃ­a,Â£3.15m ,29.0,175.0,Midfielder - Attacking Midfield,right,SD Huesca,40.0,7.0,9.0,2837.0,38.0,2.0,5.0,2853.0,37.0,1.0,4.0,2753.0,41.0,5.0,5.0,3168.0,6.0,0.0,0.0,367.0,LaLiga
19-06-17,18.3.4.28,Juankar,67063767,796,30-Mar-90,27,0,0,5,0,4650,6800,6800,138,136,7915316,179,70,D/WB/M/AM L,2,3,2,3,1,2,1,4,3,1,3,12,15,13,9,13,9,7,11,6,13,12,10,13,13,15,11,10,14,9,9,9,13,11,6,14,13,10,12,15,15,12,10,20,15,15,8,15,12,13,14,12,12,12,14,14,13,12,13,12,14,7,20,18,18,18,10,20,1,D/WB/M/AM L,133,1,1,1,1,18,10,1,20,1,1,1,18,5,18,1,1099650000000.0,1,0,0,0,0,0,0,0,0,0,0,0,0,0,0,0,0,0,0,0,0,0,0,0,0,0,0,1,0,0,0,0,0,0,0,0,0,0,0,0,1,0,0,0,0,0,0,0,Juankar,Â£1.35m ,30.0,179.0,Defender - Left-Back,left,Panathinaikos Athens,29.0,2.0,4.0,2158.0,10.0,0.0,0.0,784.0,8.0,1.0,0.0,513.0,37.0,0.0,1.0,2918.0,2.0,0.0,0.0,165.0,LaLiga,15-07-16,17.3.2.23,Juankar,67063767,796,30-Mar-90,26,0,0,1,0,4650,6700,6700,136,134,5031136,179,70,D/WB/M/AM L,4,2,4,2,3,2,1,2,3,3,1,12,15,14,9,13,9,7,11,6,12,12,10,13,13,13,11,10,11,9,9,9,16,13,6,12,12,10,12,15,15,12,10,20,14,16,8,13,12,11,14,12,12,12,19,14,13,12,13,12,14,7,Juankar,Â£2.25m ,LaLiga
19-06-17,18.3.4.28,Aleix Vidal,67064771,796,21-Aug-89,27,1,0,0,0,6500,7400,7400,153,149,27970874,177,70,D/WB/M/AM RL,3,1,3,1,2,1,2,1,3,1,3,11,12,15,11,14,8,7,10,13,11,13,12,13,15,12,12,14,11,13,12,13,15,16,9,15,11,13,16,15,13,12,8,12,15,14,20,13,9,14,10,12,7,16,11,16,8,14,13,11,9,10,18,18,18,20,20,16,1,D/WB/M/AM RL,545,1,1,1,1,16,20,1,1,18,1,1,15,18,1,18,2.0,0,1,0,0,0,0,0,0,0,0,0,0,0,0,0,0,0,0,0,0,0,0,0,0,0,0,0,0,0,0,0,0,0,0,0,0,0,0,0,0,0,0,0,0,0,0,0,0,Aleix Vidal,Â£6.75m ,31.0,177.0,Defender - Right-Back,right,Sevilla FC,12.0,2.0,5.0,886.0,25.0,2.0,3.0,1031.0,21.0,0.0,3.0,1298.0,29.0,2.0,5.0,2175.0,0.0,0.0,0.0,0.0,LaLiga,15-07-16,17.3.2.23,Aleix Vidal,67064771,796,21-Aug-89,26,1,0,0,0,6300,7350,7350,153,147,19582922,176,70,D/WB/M/AM RL,2,1,1,1,1,3,4,2,3,1,1,11,12,15,11,14,8,7,10,12,11,13,12,11,15,12,12,14,11,13,12,13,15,16,9,15,10,13,16,15,13,12,8,12,15,14,20,13,9,15,10,12,7,16,11,16,8,14,13,11,9,10,Aleix Vidal,Â£6.75m ,LaLiga
19-06-17,18.3.4.28,Sergio Escudero,67065536,796,02-Sep-89,27,0,0,0,0,6000,7250,7250,152,149,15524191,176,72,D/WB/M L,2,3,1,1,1,1,3,1,3,3,3,10,13,13,11,15,11,11,14,15,12,13,9,12,14,8,14,12,12,12,12,13,16,13,8,12,12,14,15,15,14,13,12,20,12,15,10,17,13,12,8,14,10,12,15,11,11,10,10,12,12,6,20,18,16,12,1,20,1,D/WB/M L,123,1,1,1,1,12,1,1,20,1,1,1,16,1,18,1,549757000000.0,0,0,0,1,0,0,0,0,0,0,0,0,0,0,0,0,0,0,0,0,1,0,0,0,0,0,0,0,0,0,0,0,0,0,0,0,0,0,0,1,0,0,0,0,0,0,0,0,Sergio Escudero,Â£6.75m ,31.0,176.0,Defender - Left-Back,left,Sevilla FC,37.0,1.0,5.0,3238.0,45.0,3.0,4.0,3952.0,31.0,0.0,2.0,2302.0,21.0,1.0,1.0,1667.0,3.0,0.0,0.0,228.0,LaLiga,15-07-16,17.3.2.23,Sergio Escudero,67065536,796,02-Sep-89,26,0,0,0,0,6000,7250,7250,147,146,17176422,176,72,D/WB/M L,2,2,2,3,2,1,3,4,2,2,1,10,13,12,11,14,11,11,13,17,12,13,9,12,14,8,12,12,12,12,12,13,10,13,8,12,12,14,15,15,14,13,12,20,12,15,10,17,13,12,8,14,10,12,9,9,13,9,14,11,10,2,Sergio Escudero,Â£6.75m ,LaLiga
19-06-17,18.3.4.28,Vitolo,67072243,796,02-Nov-89,27,11,4,0,0,6800,7800,7800,158,156,108918454,184,80,M/AM RLC,2,4,3,1,1,2,2,2,3,2,2,9,12,15,14,14,9,13,12,5,10,15,13,9,14,14,13,14,15,14,14,15,15,14,14,15,9,17,19,14,12,14,14,14,8,13,20,15,16,18,8,16,11,14,12,16,8,16,14,15,14,11,4,8,19,20,18,20,15,M/AM RLC,526,1,1,1,15,20,18,1,4,1,1,6,19,17,8,1,551921000000.0,0,0,0,0,0,0,0,0,0,0,0,0,0,0,0,0,0,0,0,0,1,0,0,0,1,0,0,0,0,0,0,1,0,0,0,0,0,0,0,1,0,0,0,0,0,0,0,0,Vitolo,Â£22.50m ,30.0,185.0,Forward - Left Winger,right,AtlÃ©tico Madrid,43.0,6.0,10.0,3390.0,34.0,4.0,2.0,1880.0,28.0,1.0,3.0,1084.0,35.0,3.0,3.0,1482.0,4.0,0.0,0.0,79.0,LaLiga,15-07-16,17.3.2.23,Vitolo,67072243,796,02-Nov-89,26,3,0,0,0,6800,7800,7800,158,156,34999999,184,80,M/AM RLC,2,1,3,1,1,1,2,4,3,1,1,9,12,15,14,14,9,13,12,5,10,15,13,9,14,14,13,14,15,14,14,15,15,14,14,15,9,17,19,14,12,14,14,14,8,13,20,15,16,18,8,16,9,14,12,16,14,16,14,15,14,11,Vitolo,Â£22.50m ,LaLiga
19-06-17,18.3.4.28,Alexander Szymanowski,67080642,1649,13-Oct-88,28,0,0,0,0,5447,5188,6600,138,132,7022103,174,70,M/AM RL,2,2,2,2,3,1,2,1,2,3,2,12,14,15,11,13,11,8,12,7,6,15,14,7,15,7,14,8,13,10,14,10,13,14,9,14,6,13,12,14,16,15,5,20,12,12,13,12,8,8,5,12,7,14,12,15,12,13,14,15,14,5,1,1,18,20,19,20,10,M/AM RL,525,1,1,14,10,20,19,1,1,1,1,1,18,17,1,1,0.0,0,0,0,0,0,0,0,0,0,0,0,0,0,0,0,0,0,0,0,0,0,0,0,0,0,0,0,0,0,0,0,0,0,0,0,0,0,0,0,0,0,0,0,0,0,0,0,0,Alexander Szymanowski,Â£1.80m ,32.0,174.0,Forward - Left Winger,left,Recreativo Huelva,28.0,8.0,2.0,2039.0,15.0,2.0,2.0,1102.0,1.0,0.0,0.0,9.0,0.0,0.0,0.0,0.0,2.0,0.0,0.0,71.0,LaLiga,15-07-16,17.3.2.23,Alexander Szymanowski,67080642,1649,13-Oct-88,27,0,0,0,0,5536,5273,6400,135,128,2134769,174,70,M/AM RL,2,3,3,1,1,2,2,3,3,3,1,12,14,15,11,13,11,8,12,7,6,15,14,7,15,7,14,8,12,8,14,9,13,14,8,13,6,13,12,14,16,15,5,20,12,12,13,12,8,8,5,12,7,14,12,15,10,13,14,15,14,5,Alexander Szymanowski,Â£4.50m ,LaLiga
19-06-17,18.3.4.28,Rodrigo,67086280,796,06-Mar-91,26,1,0,16,15,6000,7400,7400,157,148,48905680,182,77,S L,4,2,3,1,2,2,3,4,3,2,1,11,13,14,13,15,12,12,12,5,6,13,13,9,16,12,13,12,10,8,14,13,12,14,5,16,9,13,15,17,16,13,11,20,14,17,8,14,11,10,10,10,7,13,8,12,13,6,16,10,6,5,1,1,1,15,12,15,13,S L,603,1,1,20,13,15,12,1,1,1,1,1,1,1,1,1,2.90482e+17,0,0,0,0,1,0,0,0,0,0,0,0,0,0,0,0,0,0,0,0,0,0,0,0,0,0,0,0,0,0,0,0,0,0,0,1,0,0,0,0,0,0,0,0,0,0,0,0,Rodrigo,Â£36.00m ,29.0,182.0,Forward - Centre-Forward,left,Leeds United,21.0,7.0,5.0,1588.0,44.0,19.0,7.0,2994.0,51.0,15.0,10.0,3775.0,34.0,7.0,11.0,2506.0,7.0,1.0,0.0,410.0,LaLiga,15-07-16,17.3.2.23,Rodrigo,67086280,796,06-Mar-91,25,1,0,16,15,5250,7150,7150,154,142,19389146,181,77,AM/S RL,3,2,1,2,1,2,1,1,2,3,2,11,13,14,10,15,12,11,12,5,6,13,13,7,16,12,11,10,8,10,11,8,11,14,5,14,7,10,14,16,16,14,10,20,14,16,8,14,11,10,10,5,7,13,8,12,13,6,15,10,6,5,Rodrigo,Â£6.75m ,LaLiga
19-06-17,18.3.4.28,Antoine Griezmann,67086656,769,21-Mar-91,26,43,16,6,2,8750,8850,8850,181,177,103494607,175,71,AM/S LC,1,1,2,14,1,1,1,3,3,1,2,14,17,17,18,19,15,15,14,4,5,14,13,11,17,13,15,13,14,15,15,15,17,17,14,18,10,12,15,15,15,15,9,20,15,14,15,13,10,16,9,14,5,14,13,18,10,12,14,11,8,13,1,1,15,19,14,19,18,AM/S LC,624,1,1,20,18,19,14,1,1,1,1,1,15,9,1,1,276.0,0,0,1,0,1,0,0,0,1,0,0,0,0,0,0,0,0,0,0,0,0,0,0,0,0,0,0,0,0,0,0,0,0,0,0,0,0,0,0,0,0,0,0,0,0,0,0,0,Antoine Griezmann,Â£90.00m ,29.0,176.0,Forward - Centre-Forward,left,FC Barcelona,53.0,26.0,12.0,4559.0,49.0,29.0,15.0,3872.0,48.0,21.0,10.0,4068.0,48.0,15.0,4.0,3499.0,5.0,0.0,0.0,273.0,LaLiga,15-07-16,17.3.2.23,Antoine Griezmann,67086656,769,21-Mar-91,25,34,13,6,2,8500,8500,8800,181,177,99999994,175,72,AM/S LC,1,1,1,14,2,2,3,2,3,2,2,14,17,17,18,19,15,15,14,4,5,14,13,11,17,13,15,13,14,15,15,15,17,17,14,18,10,12,15,15,15,15,9,20,15,14,15,13,10,16,6,14,5,14,13,18,12,12,14,14,8,13,Antoine Griezmann,Â£72.00m ,LaLiga
19-06-17,18.3.4.28,Ibai GÃ³mez,67087553,796,11-Nov-89,27,0,0,0,0,4500,6600,6600,139,132,6060658,179,72,M/AM RL,1,1,3,3,3,2,2,4,4,3,4,16,17,13,13,14,17,8,16,2,6,13,13,8,16,12,12,13,12,11,11,9,15,14,9,14,7,10,12,14,14,13,9,13,11,14,20,11,10,10,7,12,12,13,15,14,18,14,18,18,14,8,1,1,18,20,17,20,14,M/AM RL,525,1,1,11,14,20,17,1,1,1,1,1,18,16,1,1,4415230000000.0,0,0,1,0,0,1,0,0,0,0,0,0,0,0,0,0,0,0,0,0,0,0,0,0,0,0,0,0,0,0,0,0,0,0,1,0,0,0,0,0,0,0,1,0,0,0,0,0,Ibai GÃ³mez,Â£3.15m ,30.0,178.0,Forward - Right Winger,right,Athletic Bilbao,35.0,7.0,3.0,2111.0,38.0,7.0,6.0,2560.0,34.0,3.0,4.0,2133.0,20.0,1.0,1.0,899.0,nan,nan,nan,nan,LaLiga,15-07-16,17.3.2.23,Ibai GÃ³mez,67087553,796,11-Nov-89,26,0,0,0,0,4500,6550,6550,139,131,7308454,179,72,M/AM L,2,3,1,2,2,3,2,1,2,1,3,16,17,13,13,13,17,8,16,2,6,12,11,8,16,12,12,13,12,11,11,9,15,14,9,14,7,10,12,14,14,13,9,13,11,14,20,11,10,10,7,12,12,13,15,14,18,14,18,18,14,8,Ibai GÃ³mez,Â£1.80m ,LaLiga
19-06-17,18.3.4.28,Samu,67093719,796,13-Jul-90,26,0,0,0,0,4400,6400,6400,138,128,4963338,179,73,M/AM RLC,1,1,3,1,1,3,1,1,4,3,1,12,14,12,11,11,11,8,13,8,6,13,12,6,15,16,13,13,12,10,14,11,13,15,9,14,6,10,12,13,14,13,9,10,12,15,20,13,9,11,12,12,7,15,12,11,12,13,12,11,9,8,1,1,18,20,20,17,17,M/AM RLC,526,1,1,13,17,17,20,1,1,1,1,1,15,18,1,1,0.0,0,0,0,0,0,0,0,0,0,0,0,0,0,0,0,0,0,0,0,0,0,0,0,0,0,0,0,0,0,0,0,0,0,0,0,0,0,0,0,0,0,0,0,0,0,0,0,0,Sami,Â£180Th. ,31.0,184.0,Forward - Left Winger,right,Without Club,12.0,2.0,0.0,570.0,9.0,0.0,0.0,465.0,15.0,0.0,1.0,898.0,12.0,0.0,0.0,817.0,nan,nan,nan,nan,Liga NOS,15-07-16,17.3.2.23,Samu,67093719,796,13-Jul-90,26,0,0,0,0,4400,6900,6150,136,126,2049053,179,73,M/AM RLC,1,2,1,3,2,3,4,1,2,2,2,12,13,12,9,11,11,8,13,8,6,12,12,6,15,16,13,13,12,10,14,11,11,15,9,14,6,10,12,13,14,13,9,10,12,15,20,13,9,10,12,11,7,15,9,11,8,9,11,9,9,1,Samu,Â£135Th. ,Liga NOS
19-06-17,18.3.4.28,Isco,67103537,796,21-Apr-92,25,20,3,18,9,8250,8750,8750,180,175,232186002,176,79,M/AM RLC,3,3,1,4,3,2,1,1,2,1,3,15,15,18,13,18,14,9,15,8,5,17,15,8,19,10,15,8,15,14,19,16,16,18,13,14,11,13,11,14,14,17,8,14,10,13,20,13,12,14,10,15,3,15,19,16,8,17,12,13,11,9,1,1,19,20,18,19,20,M/AM RLC,526,1,1,11,20,16,16,1,1,1,1,15,19,18,1,1,2269430000000000.0,0,0,0,0,0,0,0,1,0,0,0,0,0,0,0,0,0,0,0,1,0,0,0,0,0,0,0,0,0,0,0,0,0,0,0,1,0,0,0,0,0,0,0,0,1,0,0,0,Isco,Â£67.50m ,28.0,176.0,Midfielder - Attacking Midfield,right,Real Madrid,42.0,11.0,9.0,2338.0,49.0,9.0,10.0,2957.0,37.0,6.0,1.0,1738.0,30.0,3.0,2.0,1618.0,4.0,0.0,0.0,147.0,LaLiga,15-07-16,17.3.2.23,Isco,67103537,796,21-Apr-92,24,14,1,18,9,7700,8200,8200,172,164,61476393,175,74,M/AM RLC,1,2,2,2,3,1,3,3,1,3,1,15,15,18,13,18,14,9,15,8,5,17,15,8,18,10,15,8,15,13,18,15,16,18,13,13,8,10,10,14,14,17,8,14,10,12,20,13,10,12,10,15,3,15,9,16,8,17,12,13,11,9,Isco,Â£36.00m ,LaLiga
19-06-17,18.3.4.28,Carles Gil,67103542,796,22-Nov-92,24,0,0,0,0,4650,6250,6250,142,125,14230269,171,64,AM RLC,1,3,3,3,2,2,2,3,2,2,2,14,14,15,10,15,10,6,11,6,7,15,9,7,14,9,13,10,13,13,14,12,18,15,9,14,12,14,13,12,16,13,5,20,12,12,10,12,7,10,4,11,14,13,8,8,10,11,8,13,16,4,1,1,15,20,20,16,18,AM RLC,506,1,1,1,18,16,20,1,1,1,1,10,15,8,1,1,16777216.0,0,0,0,0,0,0,0,0,0,0,0,0,0,0,0,0,0,0,0,0,0,0,0,0,1,0,0,0,0,0,0,0,0,0,0,0,0,0,0,0,0,0,0,0,0,0,0,0,Carles Gil,Â£900Th. ,27.0,171.0,Midfielder - Attacking Midfield,left,New England Revolution,24.0,1.0,4.0,1500.0,11.0,0.0,2.0,540.0,55.0,10.0,14.0,4310.0,3.0,0.0,1.0,179.0,nan,nan,nan,nan,LaLiga,15-07-16,17.3.2.23,Carles Gil,67103542,796,22-Nov-92,23,0,0,0,0,4500,6100,6100,142,122,12792947,171,64,AM RLC,1,1,1,1,1,1,3,1,1,2,3,14,14,15,10,15,10,6,11,6,7,15,9,7,15,9,13,10,13,13,14,12,11,15,9,14,12,14,13,12,16,13,5,20,12,12,7,12,7,10,4,11,14,15,9,11,13,11,14,12,17,7,Carles Gil,Â£2.25m ,LaLiga
19-06-17,18.3.4.28,Juanmi,67106568,796,20-May-93,24,1,0,0,0,5500,7000,7000,148,140,19556561,170,63,AM/S L,1,2,2,1,2,1,4,2,2,1,2,7,11,14,14,15,13,9,11,6,6,13,10,8,15,6,14,9,13,13,14,13,15,14,9,14,10,12,14,16,15,12,6,11,12,15,20,13,5,12,7,14,8,7,11,15,16,12,12,14,12,5,1,1,8,20,11,20,13,AM/S L,513,1,1,20,13,20,11,1,1,1,1,1,8,6,1,1,18141900000000.0,0,0,0,1,1,0,0,0,0,0,0,0,0,0,0,0,0,0,0,0,0,0,0,0,0,0,0,0,0,0,0,0,0,0,0,0,0,0,0,1,0,0,0,0,1,0,0,0,Juanmi,Â£6.75m ,27.0,172.0,Forward - Right Winger,right,Real Betis BalompiÃ©,41.0,15.0,1.0,2097.0,39.0,10.0,3.0,1971.0,34.0,6.0,3.0,1722.0,8.0,1.0,0.0,261.0,3.0,0.0,0.0,81.0,LaLiga,15-07-16,17.3.2.23,Juanmi,67106568,796,20-May-93,23,1,0,0,0,5600,6900,6900,148,138,20081534,170,63,AM/S LC,3,1,4,2,3,2,2,2,1,1,1,7,11,13,14,15,13,9,11,6,6,13,10,8,15,6,14,9,12,13,14,12,15,14,9,13,10,12,14,16,15,12,6,11,12,15,20,12,5,11,7,14,8,7,17,15,16,12,12,14,12,5,Juanmi,Â£9.00m ,LaLiga
19-06-17,18.3.4.28,Denis SuÃ¡rez,67107819,796,06-Jan-94,23,1,0,7,0,6000,7500,7500,166,150,40106884,176,69,M/AM LC,1,2,2,1,2,1,3,3,3,3,3,13,14,15,12,17,13,7,13,9,7,15,12,9,16,10,16,9,15,14,18,14,11,15,9,14,7,12,13,12,13,13,10,14,12,13,20,13,11,12,8,16,8,14,12,12,10,13,12,13,18,3,1,1,18,20,13,19,20,M/AM LC,524,1,1,10,20,19,13,1,1,1,1,17,18,9,1,1,549757000000.0,0,0,0,0,0,0,0,0,0,0,0,0,0,0,0,0,0,0,0,0,1,0,0,0,0,0,0,0,0,0,0,0,0,0,0,0,0,0,0,1,0,0,0,0,0,0,0,0,Denis SuÃ¡rez,Â£13.50m ,26.0,176.0,Midfielder - Attacking Midfield,right,Celta de Vigo,36.0,3.0,5.0,1788.0,27.0,3.0,5.0,1130.0,14.0,2.0,1.0,352.0,28.0,1.0,5.0,1786.0,5.0,0.0,1.0,333.0,LaLiga,15-07-16,17.3.2.23,Denis SuÃ¡rez,67107819,796,06-Jan-94,22,1,0,7,0,6000,7500,7500,166,153,48735192,181,74,M/AM LC,1,2,2,2,3,2,2,1,1,3,2,13,14,15,13,17,13,7,13,9,7,16,12,9,16,12,16,9,15,14,18,14,20,15,9,14,7,12,13,12,14,13,10,13,12,13,20,13,11,13,8,16,8,14,16,11,12,10,12,10,13,4,Denis SuÃ¡rez,Â£16.20m ,LaLiga
19-06-17,18.3.4.28,David JuncÅ,67129804,796,16-Nov-93,23,0,0,0,0,4100,6250,6250,133,125,3631086,175,65,D/WB/M L,3,3,3,1,1,3,2,4,1,1,3,11,14,12,8,11,7,7,8,13,11,11,7,13,13,10,14,11,12,14,11,13,10,8,7,14,12,13,13,14,13,13,8,20,12,14,8,13,10,14,8,6,11,11,7,13,11,13,11,10,17,7,20,19,16,15,1,20,1,D/WB/M L,123,1,1,1,1,15,1,1,20,1,1,1,16,1,19,1,0.0,0,0,0,0,0,0,0,0,0,0,0,0,0,0,0,0,0,0,0,0,0,0,0,0,0,0,0,0,0,0,0,0,0,0,0,0,0,0,0,0,0,0,0,0,0,0,0,0,David JuncÃ ,Â£1.35m ,26.0,178.0,Defender - Left-Back,left,Celta de Vigo,12.0,0.0,3.0,874.0,16.0,0.0,3.0,990.0,21.0,0.0,3.0,1758.0,3.0,0.0,0.0,259.0,0.0,0.0,0.0,0.0,LaLiga,15-07-16,17.3.2.23,David JuncÅ,67129804,796,16-Nov-93,22,0,0,0,0,4100,6250,6250,133,125,5210924,175,65,D/WB/M L,2,3,1,2,2,3,2,2,1,2,2,11,14,12,8,11,7,7,8,13,11,11,7,13,13,10,14,11,12,14,11,13,11,8,7,14,12,13,13,14,13,13,8,20,12,14,8,13,10,14,8,11,6,11,11,12,12,10,10,13,14,4,David JuncÃ ,Â£1.35m ,LaLiga
19-06-17,18.3.4.28,Borja Valle,67129926,796,09-Jul-92,24,0,0,0,0,4000,6100,6100,136,122,2919198,177,72,AM/S RLC,1,2,3,1,3,1,3,4,1,3,3,9,12,14,12,12,9,10,8,11,4,13,12,9,13,7,10,8,10,12,13,11,20,13,6,14,10,11,11,15,14,8,8,12,9,13,20,10,9,13,11,6,12,11,17,11,11,13,11,11,14,6,1,1,1,19,17,19,17,AM/S RLC,626,1,1,20,17,19,17,1,1,1,1,1,1,1,1,1,70918500000000.0,0,0,0,0,0,0,0,0,0,0,0,0,0,0,0,0,0,0,0,0,0,0,0,0,0,0,0,0,0,0,0,0,0,0,0,0,0,0,0,1,0,0,0,0,0,0,1,0,Borja Valle,Â£1.08m ,28.0,177.0,Forward - Left Winger,right,Dinamo Bucharest,26.0,4.0,1.0,1739.0,18.0,5.0,2.0,555.0,35.0,8.0,3.0,2089.0,25.0,3.0,0.0,1581.0,5.0,2.0,0.0,328.0,LaLiga
19-06-17,18.3.4.28,Lucas VÃ¡zquez,67135344,796,01-Jul-91,25,3,0,0,0,6000,7500,7500,156,148,29518956,173,71,M/AM RL,3,3,4,3,3,1,2,1,1,4,1,14,14,14,12,14,11,10,11,8,8,13,12,12,14,15,13,13,11,13,12,13,14,14,11,15,10,13,16,16,15,15,7,12,14,14,20,15,9,14,8,12,6,15,10,10,14,13,15,14,16,4,11,12,20,19,20,17,1,M/AM RL,415,1,1,1,1,17,19,1,1,11,1,1,14,20,1,12,2.0,0,1,0,0,0,0,0,0,0,0,0,0,0,0,0,0,0,0,0,0,0,0,0,0,0,0,0,0,0,0,0,0,0,0,0,0,0,0,0,0,0,0,0,0,0,0,0,0,Lucas VÃ¡zquez,Â£22.50m ,29.0,173.0,Forward - Right Winger,right,Real Madrid,50.0,4.0,14.0,2279.0,53.0,8.0,16.0,2812.0,47.0,5.0,4.0,2654.0,23.0,3.0,2.0,1029.0,3.0,0.0,0.0,113.0,LaLiga,15-07-16,17.3.2.23,Lucas VÃ¡zquez,67135344,796,01-Jul-91,25,2,0,0,0,6000,7500,7500,156,148,29419775,173,70,M/AM RL,4,3,2,3,3,3,3,2,1,1,3,14,14,14,11,14,11,10,11,8,8,13,12,12,14,15,13,13,11,13,12,13,14,14,11,15,10,13,16,16,15,15,7,12,14,14,20,15,9,14,8,12,6,15,8,10,14,13,15,14,16,4,Lucas VÃ¡zquez,Â£13.50m ,LaLiga
19-06-17,18.3.4.28,Borja GalÃ¡n,67141801,796,24-Jun-93,23,0,0,0,0,3000,6000,6050,130,120,2781707,183,0,AM/S RL,2,3,2,2,2,1,2,1,2,3,2,10,11,13,12,12,10,9,10,8,5,12,10,9,13,14,12,11,12,12,13,12,9,10,12,14,10,10,10,13,14,11,9,10,7,13,20,13,11,13,9,11,8,15,12,11,13,11,11,14,19,3,1,1,1,20,20,20,1,AM/S RL,515,1,1,19,1,20,20,1,1,1,1,1,1,1,1,1,0.0,0,0,0,0,0,0,0,0,0,0,0,0,0,0,0,0,0,0,0,0,0,0,0,0,0,0,0,0,0,0,0,0,0,0,0,0,0,0,0,0,0,0,0,0,0,0,0,0,nan,nan,nan,nan,nan,nan,nan,nan,nan,nan,nan,nan,nan,nan,nan,nan,nan,nan,nan,nan,nan,nan,nan,nan,nan,nan,nan,nan,
19-06-17,18.3.4.28,Samu Castillejo,67142868,796,18-Jan-95,22,0,0,3,0,5750,7250,7250,159,146,36267454,179,67,M/AM RLC,2,4,2,1,2,1,1,2,3,1,2,9,14,16,11,14,9,10,12,11,8,14,10,6,15,9,14,9,13,13,15,12,11,15,10,15,8,11,13,15,15,13,11,20,13,13,12,13,11,13,7,12,8,10,20,17,9,12,13,11,10,5,1,1,18,20,19,20,16,M/AM RLC,526,1,1,14,16,20,19,1,1,1,1,14,18,16,1,1,70403100000000.0,0,0,0,0,0,0,0,0,0,0,0,0,0,0,0,0,0,0,0,0,0,0,0,0,0,0,0,0,0,0,0,0,0,0,0,1,0,0,0,0,0,0,0,0,0,0,1,0,Samu Castillejo,Â£13.50m ,25.0,182.0,Forward - Right Winger,left,AC Milan,44.0,3.0,4.0,2602.0,38.0,6.0,8.0,2481.0,40.0,4.0,4.0,1654.0,25.0,3.0,5.0,1479.0,8.0,0.0,2.0,397.0,LaLiga,15-07-16,17.3.2.23,Samu Castillejo,67142868,796,18-Jan-95,21,0,0,3,0,5750,7250,7250,159,145,36267454,179,61,M/AM RLC,3,2,2,1,3,1,1,3,3,2,1,9,14,16,11,13,9,10,12,11,8,14,10,6,15,9,14,9,13,13,14,12,11,15,10,15,8,11,13,15,15,13,11,20,13,13,12,12,11,12,7,12,8,10,16,17,9,12,15,11,10,5,Samu Castillejo,Â£6.30m ,LaLiga
19-06-17,18.3.4.28,Sandro,67149094,796,09-Jul-95,21,0,0,7,1,5800,7300,6900,158,143,69831468,175,72,AM/S RL,2,1,1,1,2,4,3,3,3,2,3,14,13,15,16,16,16,13,15,5,4,10,14,6,16,12,15,15,11,12,11,11,15,12,10,15,7,12,13,15,17,10,9,10,14,15,20,13,10,13,7,12,9,9,6,16,7,12,12,8,15,11,1,1,8,16,15,16,9,AM/S RL,625,1,1,20,9,16,15,1,1,1,1,1,8,8,1,1,256.0,0,0,0,0,0,0,0,0,1,0,0,0,0,0,0,0,0,0,0,0,0,0,0,0,0,0,0,0,0,0,0,0,0,0,0,0,0,0,0,0,0,0,0,0,0,0,0,0,Sandro,Â£2.25m ,31.0,187.0,Midfielder - Defensive Midfield,right,GoiÃ¡s Esporte Clube,20.0,3.0,0.0,1227.0,18.0,1.0,0.0,1328.0,26.0,0.0,1.0,1316.0,8.0,0.0,0.0,590.0,nan,nan,nan,nan,Serie A,15-07-16,17.3.2.23,Sandro,67149094,796,09-Jul-95,21,0,0,3,0,4700,7200,7200,158,144,25254750,175,72,AM/S RL,3,1,2,3,1,3,1,2,2,1,3,14,13,15,16,16,16,13,15,5,4,10,14,6,16,12,15,15,9,12,11,11,15,12,10,15,7,12,13,15,17,13,9,10,14,15,20,13,13,16,7,12,9,9,14,11,8,11,12,8,15,11,Evandro,Â£1.80m ,Premier League
19-06-17,18.3.4.28,Jairo,67150861,796,11-Jul-93,23,0,0,2,0,5250,6750,6750,143,135,9831582,173,65,M/AM RL,2,2,3,2,3,1,3,2,3,3,1,13,13,15,12,14,10,7,10,5,6,12,11,6,14,11,13,9,10,10,13,12,12,14,6,14,7,12,10,16,16,10,6,12,12,15,20,12,7,11,5,11,8,13,10,14,10,8,11,10,12,7,1,1,20,20,20,18,14,M/AM RL,415,1,1,12,14,18,20,1,1,1,1,1,18,20,1,1,134217728.0,0,0,0,0,0,0,0,0,0,0,0,0,0,0,0,0,0,0,0,0,0,0,0,0,0,0,0,1,0,0,0,0,0,0,0,0,0,0,0,0,0,0,0,0,0,0,0,0,nan,nan,nan,nan,nan,nan,nan,nan,nan,nan,nan,nan,nan,nan,nan,nan,nan,nan,nan,nan,nan,nan,nan,nan,nan,nan,nan,nan,15-07-16,17.3.2.23,Jairo,67150861,796,11-Jul-93,23,0,0,2,0,6050,6800,7050,147,141,25373766,173,65,M/AM RL,2,3,3,3,3,1,2,1,2,4,3,13,13,15,12,15,10,7,10,5,6,12,11,6,14,11,13,9,10,10,13,12,12,14,6,14,7,12,10,17,16,11,6,12,12,15,20,13,8,11,5,11,5,13,11,14,10,8,11,10,12,7,nan,nan,nan
19-06-17,18.3.4.28,Ager Aketxe,67150948,796,30-Dec-93,23,0,0,0,0,4050,6250,6250,138,125,3687679,174,70,M/AM RLC,3,2,1,2,1,1,1,1,3,3,1,14,14,12,13,14,17,8,12,6,4,15,14,7,15,10,13,10,13,12,14,13,11,13,9,15,7,13,9,13,13,13,8,20,9,13,8,12,10,13,8,3,11,11,7,13,11,11,10,10,12,6,1,1,18,20,17,18,20,M/AM RLC,526,1,1,10,20,18,17,1,1,1,1,18,18,13,1,1,4194304.0,0,0,0,0,0,0,0,0,0,0,0,0,0,0,0,0,0,0,0,0,0,0,1,0,0,0,0,0,0,0,0,0,0,0,0,0,0,0,0,0,0,0,0,0,0,0,0,0,Ager Aketxe,Â£2.25m ,26.0,174.0,Midfielder - Attacking Midfield,left,UD AlmerÃ­a,18.0,5.0,2.0,1185.0,26.0,0.0,1.0,1023.0,36.0,4.0,4.0,1970.0,41.0,7.0,4.0,3169.0,5.0,1.0,0.0,362.0,LaLiga
19-06-17,18.3.4.28,LÃ©o BaptistÄo,67153647,1651,26-Aug-92,24,0,0,0,0,6344,5287,7150,151,143,23312652,184,73,AM/S RLC,2,3,1,1,2,1,3,1,1,1,2,9,12,15,12,14,11,11,12,5,5,14,12,5,15,10,13,10,13,13,14,13,15,16,9,15,5,12,11,14,13,10,12,15,10,15,20,13,11,11,8,9,14,7,16,14,10,11,14,10,8,7,1,1,14,19,19,17,15,AM/S RLC,626,1,1,20,15,17,19,1,1,1,1,1,14,13,1,1,24.0,0,0,0,1,1,0,0,0,0,0,0,0,0,0,0,0,0,0,0,0,0,0,0,0,0,0,0,0,0,0,0,0,0,0,0,0,0,0,0,0,0,0,0,0,0,0,0,0,Leo BaptistÃ£o,Â£5.40m ,28.0,181.0,Forward - Right Winger,right,Wuhan Zall,22.0,6.0,7.0,1450.0,40.0,9.0,3.0,2877.0,51.0,10.0,4.0,3572.0,11.0,2.0,3.0,815.0,nan,nan,nan,nan,LaLiga,15-07-16,17.3.2.23,LÃ©o BaptistÄo,67153647,1651,26-Aug-92,23,0,0,0,0,6579,5484,7050,155,141,19493127,184,73,AM/S RLC,4,3,2,1,1,3,1,1,1,4,2,9,12,15,12,14,11,11,12,5,5,13,12,5,15,10,13,10,13,13,14,13,15,16,9,15,5,12,11,14,13,10,12,15,10,15,20,13,11,12,8,9,13,7,16,14,10,11,14,10,8,7,Leo BaptistÃ£o,Â£3.60m ,LaLiga
19-06-17,18.3.4.28,Sabin Merino,67154515,796,04-Jan-92,25,0,0,0,0,4250,6250,6250,139,125,2490756,186,79,AM/S L,2,3,3,2,1,1,1,1,2,1,3,8,14,15,14,12,6,13,9,5,6,11,11,5,13,9,10,13,12,12,11,12,10,8,11,14,5,11,12,12,10,9,13,12,11,15,20,13,13,13,7,3,11,2,14,10,12,11,11,12,13,3,1,1,15,20,14,20,14,AM/S L,513,1,1,19,14,20,14,1,1,1,1,1,15,12,1,1,70368700000000.0,0,0,0,0,0,0,0,0,0,0,0,0,0,0,0,0,0,0,0,0,0,0,0,0,0,0,0,0,0,0,0,0,0,0,0,0,0,0,0,0,0,0,0,0,0,0,1,0,Sabin Merino,Â£1.35m ,28.0,187.0,Forward - Centre-Forward,right,CD LeganÃ©s,19.0,1.0,2.0,668.0,18.0,0.0,0.0,531.0,15.0,0.0,0.0,548.0,21.0,5.0,0.0,1342.0,8.0,3.0,0.0,430.0,LaLiga
19-06-17,18.3.4.28,Fede Cartabia,67158060,1649,20-Jan-93,24,0,0,2,0,4750,6500,6600,148,132,9293010,170,69,M/AM RLC,2,3,3,1,2,2,2,2,1,3,1,14,14,17,13,15,15,7,13,7,5,15,8,5,16,5,11,8,12,9,15,11,10,16,8,15,7,8,8,15,17,15,5,20,14,13,7,12,7,10,9,2,4,13,8,12,3,12,5,7,6,12,1,1,16,20,20,19,16,M/AM RLC,526,1,1,12,16,19,20,1,1,1,1,1,16,16,1,1,70368700000000.0,0,0,0,0,0,0,0,1,0,0,0,0,0,0,0,0,0,0,0,0,1,0,0,0,0,0,0,0,0,0,0,0,0,0,0,0,0,0,0,0,0,0,0,0,0,0,1,0,Fede Cartabia,Â£1.80m ,27.0,169.0,Forward - Right Winger,left,FC Shabab Al-Ahli Dubai,17.0,3.0,3.0,872.0,20.0,2.0,1.0,1346.0,35.0,4.0,9.0,1906.0,17.0,4.0,4.0,1247.0,1.0,0.0,1.0,79.0,LaLiga,15-07-16,17.3.2.23,Fede Cartabia,67158060,1649,20-Jan-93,23,0,0,2,0,4750,6500,6500,148,132,5058818,170,69,M/AM RLC,1,3,3,3,3,2,2,2,2,2,2,14,14,17,13,15,15,7,13,7,5,15,9,5,16,5,11,8,12,9,15,11,10,16,8,15,7,8,8,15,17,15,5,20,14,13,7,12,7,10,9,5,12,13,19,10,3,12,5,7,6,12,Fede Cartabia,Â£1.35m ,LaLiga
19-06-17,18.3.4.28,Munir,67174735,796,01-Sep-95,21,1,0,5,3,5500,6750,6750,158,134,8323913,175,69,AM/S RL,3,1,3,3,1,3,1,1,2,1,1,13,12,14,14,15,12,9,13,8,4,12,13,7,15,8,15,11,13,10,14,11,12,16,8,14,6,12,13,14,16,11,8,20,11,13,10,13,9,9,9,17,6,14,12,17,16,10,15,17,11,7,1,1,9,17,15,17,14,AM/S RL,625,1,1,20,14,17,15,1,1,1,1,1,9,8,1,1,2320.0,0,0,0,0,1,0,0,0,1,0,0,1,0,0,0,0,0,0,0,0,0,0,0,0,0,0,0,0,0,0,0,0,0,0,0,0,0,0,0,0,0,0,0,0,0,0,0,0,nan,nan,nan,nan,nan,nan,nan,nan,nan,nan,nan,nan,nan,nan,nan,nan,nan,nan,nan,nan,nan,nan,nan,nan,nan,nan,nan,nan,15-07-16,17.3.2.23,Munir,67174735,796,01-Sep-95,20,1,0,5,3,5500,6750,6750,158,133,18676410,175,69,AM/S RL,1,2,2,3,2,1,2,4,3,1,1,13,12,14,13,15,12,9,13,8,4,12,13,7,15,8,15,11,12,9,13,11,12,16,8,14,6,12,13,14,16,13,8,20,11,13,10,13,9,9,9,17,6,14,12,17,16,11,15,17,14,7,nan,nan,nan
19-06-17,18.3.4.28,Burgui,67175184,796,29-Oct-93,23,0,0,0,0,4800,6300,6300,131,126,5485624,186,73,M/AM LC,1,1,1,2,3,2,3,1,3,2,4,11,13,14,11,14,11,8,10,8,9,13,12,9,14,9,12,8,13,10,12,11,11,17,9,14,10,11,9,13,15,10,12,10,12,15,20,12,10,11,8,12,6,11,19,10,12,9,10,9,19,5,1,1,16,20,13,20,19,M/AM LC,524,1,1,10,19,20,13,1,1,1,1,10,16,13,1,1,2252350000000000.0,0,0,0,0,0,0,0,0,0,0,0,0,0,0,0,0,0,0,0,0,0,0,0,0,0,0,0,0,0,0,0,0,0,0,0,0,0,0,0,1,0,0,0,0,0,0,0,0,Burgui,Â£1.62m ,26.0,184.0,Forward - Left Winger,right,Deportivo AlavÃ©s,34.0,2.0,4.0,2101.0,25.0,1.0,1.0,1145.0,18.0,1.0,2.0,730.0,21.0,1.0,2.0,1140.0,0.0,0.0,0.0,0.0,LaLiga,15-07-16,17.3.2.23,Burgui,67175184,796,29-Oct-93,22,0,0,0,0,4150,6150,6150,131,123,3744415,186,73,M/AM LC,2,1,1,1,1,1,2,1,1,3,2,12,13,14,11,14,11,8,10,8,8,12,12,9,14,9,12,8,13,9,12,10,8,17,8,13,9,10,8,13,15,10,12,10,12,15,20,12,9,9,8,10,6,11,17,9,11,10,9,12,18,4,Burgui,Â£1.35m ,LaLiga
19-06-17,18.3.4.28,IvÃ¡n Alejo,67176059,796,10-Feb-95,22,0,0,0,0,3900,6250,6250,136,126,6109282,184,76,AM RL,3,1,1,1,4,2,3,2,3,2,2,11,14,15,11,15,10,9,11,8,10,12,5,9,15,11,12,6,13,10,11,15,13,16,9,9,10,11,13,15,12,5,11,12,14,14,20,9,8,11,11,11,11,11,16,10,10,10,11,11,19,1,1,1,14,20,20,18,9,AM RL,505,1,1,1,9,18,20,1,1,1,1,1,11,14,1,1,0.0,0,0,0,0,0,0,0,0,0,0,0,0,0,0,0,0,0,0,0,0,0,0,0,0,0,0,0,0,0,0,0,0,0,0,0,0,0,0,0,0,0,0,0,0,0,0,0,0,IvÃ¡n Alejo,Â£1.80m ,25.0,186.0,Forward - Right Winger,right,CÃ¡diz CF,35.0,3.0,2.0,2045.0,22.0,1.0,3.0,1121.0,19.0,0.0,0.0,995.0,33.0,1.0,3.0,1323.0,4.0,1.0,0.0,114.0,LaLiga
19-06-17,18.3.4.28,RubÃ©n PeÅa,67177699,796,18-Jul-91,25,0,0,0,0,3900,6250,6250,129,126,2768954,170,67,WB/M/AM RL,2,3,1,1,1,2,2,3,1,2,3,8,13,13,9,10,8,8,10,10,9,10,10,10,11,10,10,11,10,10,12,10,9,10,7,13,8,11,11,14,13,13,8,9,11,13,20,12,9,12,10,10,7,14,9,13,12,12,11,9,19,6,15,16,17,20,20,17,14,WB/M/AM RL,535,1,1,15,14,17,20,1,1,15,1,1,14,17,1,16,0.0,0,0,0,0,0,0,0,0,0,0,0,0,0,0,0,0,0,0,0,0,0,0,0,0,0,0,0,0,0,0,0,0,0,0,0,0,0,0,0,0,0,0,0,0,0,0,0,0,RubÃ©n PÃ©rez,Â£6.75m ,31.0,178.0,Midfielder - Defensive Midfield,right,CD LeganÃ©s,32.0,0.0,1.0,2495.0,36.0,0.0,0.0,2895.0,32.0,0.0,0.0,2561.0,28.0,1.0,1.0,2376.0,8.0,0.0,0.0,720.0,LaLiga,15-07-16,17.3.2.23,RubÃ©n PeÅa,67177699,796,18-Jul-91,24,0,0,0,0,3900,6150,6150,127,123,4304070,170,67,WB/M/AM RL,3,1,3,3,1,2,2,3,1,1,1,8,13,13,9,10,8,8,10,10,9,10,10,10,11,10,10,11,10,10,11,10,15,10,7,13,8,10,10,14,13,13,8,7,11,13,20,12,9,12,10,10,7,14,18,13,14,13,11,11,18,4,RubÃ©n PÃ©rez,Â£2.25m ,LaLiga
19-06-17,18.3.4.28,Tana,67177834,796,20-Sep-90,26,0,0,0,0,4200,6300,6300,130,125,4335151,168,65,AM RLC,2,1,3,1,2,1,1,1,1,2,4,8,13,14,12,14,8,5,9,5,5,12,10,7,14,8,12,12,12,11,14,11,11,16,7,14,5,12,11,14,15,14,5,12,13,13,20,12,7,10,7,11,11,12,8,12,10,8,7,10,10,13,1,1,12,20,15,18,20,AM RLC,506,1,1,15,20,18,15,1,1,1,1,12,10,10,1,1,28.0,0,0,1,1,1,0,0,0,0,0,0,0,0,0,0,0,0,0,0,0,0,0,0,0,0,0,0,0,0,0,0,0,0,0,0,0,0,0,0,0,0,0,0,0,0,0,0,0,Tana,Â£2.25m ,30.0,169.0,Midfielder - Attacking Midfield,left,Without Club,34.0,4.0,4.0,2391.0,27.0,1.0,1.0,1739.0,24.0,1.0,6.0,1621.0,7.0,0.0,0.0,316.0,nan,nan,nan,nan,LaLiga,15-07-16,17.3.2.23,Tana,67177834,796,20-Sep-90,25,0,0,0,0,4200,6350,6350,132,127,4660183,168,65,AM RLC,1,3,1,2,1,1,3,3,1,2,2,8,13,14,12,14,8,5,9,5,5,12,10,7,14,8,12,13,12,12,14,12,12,16,7,14,5,12,12,14,15,14,5,11,13,13,20,12,7,12,7,11,8,12,8,12,10,10,11,10,10,10,Tana,Â£3.15m ,LaLiga
19-06-17,18.3.4.28,JosÃ© GayÅ,67178177,796,25-May-95,22,0,0,4,1,6100,7100,7100,159,145,38962007,172,66,D/WB L,2,2,4,2,3,3,1,1,2,3,3,10,15,13,8,15,10,5,9,8,11,13,8,14,15,13,14,13,13,13,14,14,14,14,11,16,14,14,15,17,16,14,7,20,13,16,6,15,8,12,8,14,12,13,17,14,16,14,14,14,12,6,20,17,15,8,1,20,1,D/WB L,113,1,1,1,1,8,1,1,20,1,1,1,15,1,17,1,33.0,1,0,0,0,0,1,0,0,0,0,0,0,0,0,0,0,0,0,0,0,0,0,0,0,0,0,0,0,0,0,0,0,0,0,0,0,0,0,0,0,0,0,0,0,0,0,0,0,JosÃ© GayÃ ,Â£31.50m ,25.0,172.0,Defender - Left-Back,left,Valencia CF,30.0,1.0,3.0,2215.0,38.0,0.0,5.0,3307.0,49.0,1.0,4.0,4398.0,32.0,0.0,2.0,2665.0,7.0,0.0,1.0,608.0,LaLiga,15-07-16,17.3.2.23,JosÃ© GayÅ,67178177,796,25-May-95,21,0,0,4,1,6150,7350,7350,162,143,53002903,172,64,D/WB L,4,2,3,2,1,4,3,1,2,3,2,10,15,13,8,14,10,5,9,8,12,13,9,13,15,13,14,13,13,13,13,14,14,14,11,16,11,14,15,17,16,14,7,20,13,16,6,15,8,10,8,14,15,13,19,14,16,14,14,14,12,6,JosÃ© GayÃ ,Â£16.20m ,LaLiga
19-06-17,18.3.4.28,Ivi,67179125,796,29-Jun-94,22,0,0,0,0,3500,6350,6350,142,128,8013756,173,74,M/AM RLC,1,2,1,3,1,2,1,2,3,2,3,9,12,15,13,14,15,9,12,5,6,13,13,7,15,12,12,14,13,12,14,12,13,15,12,14,8,12,11,14,13,13,8,10,12,13,20,12,9,14,5,12,10,10,12,13,11,16,14,9,9,15,1,1,17,20,16,20,17,M/AM RLC,526,1,1,12,17,20,16,1,1,1,1,5,17,14,1,1,0.0,0,0,0,0,0,0,0,0,0,0,0,0,0,0,0,0,0,0,0,0,0,0,0,0,0,0,0,0,0,0,0,0,0,0,0,0,0,0,0,0,0,0,0,0,0,0,0,0,nan,nan,nan,nan,nan,nan,nan,nan,nan,nan,nan,nan,nan,nan,nan,nan,nan,nan,nan,nan,nan,nan,nan,nan,nan,nan,nan,nan,
19-06-17,18.3.4.28,Jason,67184262,796,06-Jul-94,22,0,0,0,0,3750,6350,6350,140,127,6965221,178,65,M/AM RL,3,3,3,1,1,2,4,1,2,2,1,13,13,14,13,13,13,8,12,4,6,12,12,7,14,10,12,9,13,11,12,12,13,14,9,14,7,12,12,14,13,10,8,11,13,14,20,13,9,13,8,12,9,10,12,14,12,12,12,13,12,8,1,1,18,20,20,19,12,M/AM RL,525,1,1,8,12,19,20,1,1,1,1,1,18,18,1,1,512.0,0,0,0,0,0,0,0,0,0,1,0,0,0,0,0,0,0,0,0,0,0,0,0,0,0,0,0,0,0,0,0,0,0,0,0,0,0,0,0,0,0,0,0,0,0,0,0,0,Jason,Â£1.08m ,26.0,178.0,Forward - Right Winger,right,Valencia CF,39.0,10.0,1.0,2794.0,29.0,1.0,2.0,1968.0,34.0,2.0,5.0,2409.0,26.0,1.0,4.0,1412.0,6.0,0.0,0.0,192.0,LaLiga
19-06-17,18.3.4.28,IÅaki Williams,67184349,796,15-Jun-94,23,1,0,8,2,6250,7500,7500,166,150,71180687,186,76,AM/S RLC,2,1,1,2,2,2,1,3,1,4,2,7,11,14,12,13,9,12,9,4,5,10,9,7,14,10,11,15,13,12,11,11,15,11,7,14,5,11,16,17,12,11,12,9,13,19,20,12,10,12,11,12,7,13,8,14,14,12,12,10,8,11,1,1,15,20,20,19,17,AM/S RLC,516,1,1,18,17,19,20,1,1,1,1,1,15,15,1,1,16.0,0,0,0,0,1,0,0,0,0,0,0,0,0,0,0,0,0,0,0,0,0,0,0,0,0,0,0,0,0,0,0,0,0,0,0,0,0,0,0,0,0,0,0,0,0,0,0,0,IÃ±aki Williams,Â£27.00m ,26.0,186.0,Forward - Centre-Forward,right,Athletic Bilbao,49.0,8.0,9.0,3621.0,52.0,10.0,8.0,3805.0,41.0,15.0,5.0,3179.0,45.0,10.0,4.0,3538.0,6.0,1.0,1.0,429.0,LaLiga,15-07-16,17.3.2.23,IÅaki Williams,67184349,796,15-Jun-94,22,1,0,8,2,6250,7500,7500,166,150,49999997,186,76,M/AM/S RLC,2,3,3,3,1,3,2,1,4,3,3,7,10,14,13,13,8,10,9,4,5,10,9,7,14,10,11,15,13,12,10,11,15,11,7,14,5,11,16,17,12,11,12,9,13,19,20,12,10,12,11,12,5,13,8,14,14,12,12,10,8,11,IÃ±aki Williams,Â£22.50m ,LaLiga
19-06-17,18.3.4.28,JosÃ© Naranjo,67192945,796,28-Jul-94,22,0,0,0,0,4100,6200,6200,138,124,12850601,182,73,AM/S L,1,2,3,3,2,3,2,3,2,1,2,9,12,13,13,10,13,10,12,7,7,10,8,7,13,11,13,10,12,13,11,13,11,13,10,14,7,10,9,15,14,12,9,12,12,14,20,11,10,12,9,11,11,11,6,12,12,10,11,14,12,8,1,1,14,18,12,18,10,AM/S L,623,1,1,20,10,18,12,1,1,1,1,1,14,10,1,1,0.0,0,0,0,0,0,0,0,0,0,0,0,0,0,0,0,0,0,0,0,0,0,0,0,0,0,0,0,0,0,0,0,0,0,0,0,0,0,0,0,0,0,0,0,0,0,0,0,0,JosÃ© Naranjo,Â£1.35m ,26.0,186.0,Forward - Left Winger,right,AEK Larnaca,24.0,6.0,2.0,968.0,23.0,2.0,2.0,955.0,37.0,6.0,4.0,2271.0,17.0,3.0,1.0,1041.0,6.0,1.0,3.0,367.0,LaLiga
19-06-17,18.3.4.28,Nacho Gil,67196095,796,09-Sep-95,21,0,0,0,0,1750,6200,6200,145,125,5849952,184,0,M/AM RLC,3,3,1,1,2,1,3,2,3,3,4,10,10,14,12,12,10,10,12,10,9,12,6,10,15,10,14,9,11,10,13,11,12,15,7,13,10,12,12,15,16,12,7,8,15,13,20,11,8,11,9,11,10,11,10,11,12,12,12,10,13,4,1,1,20,18,20,17,18,M/AM RLC,416,1,1,12,18,17,17,1,1,1,1,14,14,20,1,1,0.0,0,0,0,0,0,0,0,0,0,0,0,0,0,0,0,0,0,0,0,0,0,0,0,0,0,0,0,0,0,0,0,0,0,0,0,0,0,0,0,0,0,0,0,0,0,0,0,0,Nacho Gil,Â£720Th. ,25.0,170.0,Forward - Left Winger,right,FC Cartagena,37.0,8.0,6.0,3002.0,25.0,0.0,2.0,1364.0,11.0,2.0,1.0,466.0,35.0,1.0,1.0,2351.0,8.0,0.0,1.0,410.0,LaLiga
19-06-17,18.3.4.28,Marco Asensio,67197125,796,21-Jan-96,21,2,0,14,0,6500,8000,8000,185,157,105973694,182,76,M/AM RLC,3,1,4,1,2,1,3,1,3,2,3,15,15,17,18,17,15,8,18,7,5,16,14,8,18,10,14,10,16,10,15,15,15,17,9,12,9,12,12,14,15,11,10,20,15,15,9,14,11,10,10,16,8,11,7,17,12,14,13,11,12,7,1,1,18,20,16,16,20,M/AM RLC,526,1,1,10,20,16,16,1,1,1,1,18,15,15,1,1,2252350000000000.0,0,0,0,0,0,0,0,0,1,0,0,1,0,0,0,0,0,0,0,0,0,0,0,0,0,0,0,0,0,0,0,0,0,0,0,0,0,0,0,1,0,0,0,0,0,0,0,0,Marco Asensio,Â£67.50m ,24.0,182.0,Forward - Left Winger,left,Real Madrid,38.0,10.0,4.0,1919.0,53.0,11.0,6.0,2864.0,44.0,6.0,9.0,2370.0,10.0,3.0,1.0,363.0,5.0,0.0,0.0,317.0,LaLiga,15-07-16,17.3.2.23,Marco Asensio,67197125,796,21-Jan-96,20,1,0,2,0,5600,7350,7350,171,146,52814275,181,70,M/AM RLC,3,2,4,3,2,3,2,3,1,3,2,16,15,17,13,17,15,8,14,7,5,16,14,8,18,8,14,9,14,9,15,13,15,17,9,12,8,8,10,15,15,11,10,20,15,15,8,12,10,9,10,16,8,10,20,17,11,14,13,11,12,7,Marco Asensio,Â£18.00m ,LaLiga
19-06-17,18.3.4.28,David Concha,67199081,796,20-Nov-96,20,0,0,0,0,3750,5750,5750,136,116,2944723,177,62,M/AM RL,3,2,3,1,2,1,1,3,2,1,2,11,12,13,9,13,8,8,9,6,5,12,11,6,14,8,13,9,11,10,13,11,13,15,5,15,8,10,11,15,14,14,7,20,9,14,12,8,6,10,6,8,11,11,7,11,10,9,9,12,11,2,1,1,19,20,20,20,14,M/AM RL,525,1,1,1,14,20,20,1,1,1,1,1,18,19,1,1,0.0,0,0,0,0,0,0,0,0,0,0,0,0,0,0,0,0,0,0,0,0,0,0,0,0,0,0,0,0,0,0,0,0,0,0,0,0,0,0,0,0,0,0,0,0,0,0,0,0,David Concha,Â£720Th. ,23.0,179.0,Forward - Right Winger,right,CD Badajoz,11.0,0.0,0.0,136.0,14.0,1.0,0.0,652.0,9.0,1.0,2.0,492.0,2.0,0.0,0.0,104.0,2.0,0.0,0.0,125.0,LaLiga,15-07-16,17.3.2.23,David Concha,67199081,796,20-Nov-96,19,0,0,0,0,4400,6250,6250,142,123,8422736,177,62,M/AM RL,2,3,3,2,1,1,1,2,2,3,2,11,13,14,12,14,8,8,9,6,5,12,11,6,15,8,13,11,12,11,14,12,2,15,5,15,10,11,12,15,14,14,7,20,9,14,12,8,6,11,6,8,11,11,14,10,13,13,13,12,13,5,David Concha,Â£720Th. ,LaLiga
19-06-17,18.3.4.28,IÅigo CÃ³rdoba,67200926,796,13-Mar-97,20,0,0,0,0,3750,6350,6350,141,127,8368287,178,75,AM/S L,2,2,3,1,4,3,3,3,1,1,1,11,14,14,11,13,10,8,7,7,5,12,11,7,14,4,14,12,12,11,13,12,7,11,12,15,9,11,13,14,14,13,8,20,9,13,12,12,10,12,7,10,7,10,11,9,9,11,11,12,17,7,7,9,10,20,12,20,1,AM/S L,513,1,1,18,1,20,12,1,7,1,1,1,10,10,9,1,0.0,0,0,0,0,0,0,0,0,0,0,0,0,0,0,0,0,0,0,0,0,0,0,0,0,0,0,0,0,0,0,0,0,0,0,0,0,0,0,0,0,0,0,0,0,0,0,0,0,IÃ±igo CÃ³rdoba,Â£4.50m ,23.0,180.0,Forward - Left Winger,left,Athletic Bilbao,32.0,4.0,7.0,2261.0,41.0,1.0,2.0,2098.0,26.0,0.0,5.0,1486.0,26.0,1.0,4.0,1526.0,2.0,0.0,0.0,63.0,LaLiga
19-06-17,18.3.4.28,Theo HernÃ¡ndez,67211695,769,06-Oct-97,19,0,0,0,0,4800,6500,6500,183,129,9624453,184,83,D/WB L,2,3,1,2,2,1,1,2,1,2,1,11,11,13,10,12,14,9,10,13,12,12,8,12,13,10,11,12,10,11,11,10,14,12,8,14,12,11,14,13,12,10,11,20,16,15,10,15,14,10,9,10,10,14,12,15,8,12,14,10,9,15,20,18,15,15,1,20,14,D/WB L,113,1,1,1,1,15,1,14,20,1,1,1,15,1,18,1,35184400000000.0,0,0,0,0,0,1,0,0,0,0,0,0,0,0,0,0,0,0,0,0,0,0,0,0,0,0,0,0,0,0,0,0,0,0,0,0,0,0,0,0,0,0,0,0,0,1,0,0,Theo HernÃ¡ndez,Â£13.50m ,23.0,184.0,Defender - Left-Back,left,AC Milan,38.0,2.0,4.0,3201.0,23.0,0.0,3.0,1648.0,28.0,1.0,2.0,2336.0,36.0,7.0,5.0,3099.0,9.0,1.0,2.0,840.0,LaLiga,15-07-16,17.3.2.23,Theo HernÃ¡ndez,67211695,769,06-Oct-97,18,0,0,0,0,4250,6100,6300,153,126,2602155,183,72,D/WB L,2,3,3,2,3,2,2,2,1,3,1,10,14,13,9,12,11,9,8,10,13,12,7,12,13,9,11,11,10,12,12,11,14,12,4,14,12,11,11,11,12,10,10,20,7,15,10,14,14,12,9,1,8,14,18,15,12,12,14,12,18,7,Theo HernÃ¡ndez,Â£13.50m ,LaLiga
19-06-17,18.3.4.28,Alfonso Pedraza,67212046,796,09-Apr-96,21,0,0,2,0,3000,6500,6500,142,130,9701529,184,73,M/AM L,2,1,2,3,1,2,1,2,3,2,3,12,14,13,12,13,9,11,13,13,10,13,11,9,14,16,14,12,12,13,13,13,11,12,9,16,12,13,15,13,13,12,10,20,14,13,8,13,12,12,13,8,5,12,16,11,10,7,10,15,14,6,1,1,18,20,11,20,10,M/AM L,523,1,1,1,10,20,11,1,1,1,1,1,18,11,1,1,0.0,0,0,0,0,0,0,0,0,0,0,0,0,0,0,0,0,0,0,0,0,0,0,0,0,0,0,0,0,0,0,0,0,0,0,0,0,0,0,0,0,0,0,0,0,0,0,0,0,Alfonso Pedraza,Â£4.50m ,24.0,184.0,Defender - Left-Back,left,Villarreal CF,37.0,7.0,8.0,2558.0,37.0,4.0,6.0,2685.0,45.0,4.0,5.0,2861.0,21.0,1.0,0.0,1350.0,5.0,0.0,1.0,348.0,LaLiga
19-06-17,18.3.4.28,Amath N'Diaye,67213756,41,16-Jul-96,20,0,0,0,0,4250,6350,6500,152,130,6266826,175,67,AM/S RL,4,3,1,1,3,3,1,2,3,3,2,9,12,13,13,12,7,7,11,9,4,9,7,4,13,11,12,13,10,9,11,8,17,14,9,14,4,10,12,16,15,11,9,8,13,17,20,14,11,11,7,11,6,12,11,11,12,12,11,9,11,5,1,1,12,20,20,17,14,AM/S RL,515,1,1,19,14,17,20,1,1,1,1,1,10,12,1,1,56.0,0,0,0,1,1,1,0,0,0,0,0,0,0,0,0,0,0,0,0,0,0,0,0,0,0,0,0,0,0,0,0,0,0,0,0,0,0,0,0,0,0,0,0,0,0,0,0,0,Amath Ndiaye,Â£4.50m ,24.0,173.0,Forward - Left Winger,right,RCD Mallorca,41.0,13.0,4.0,3189.0,39.0,3.0,3.0,2989.0,15.0,1.0,2.0,1009.0,7.0,0.0,0.0,59.0,2.0,0.0,0.0,152.0,LaLiga
19-06-17,18.3.4.28,JosÃ© ArnÃ¡iz,67215620,796,15-Apr-95,22,0,0,0,0,4250,6250,6250,145,125,5374790,175,70,M/AM/S RL,2,1,2,2,2,2,3,1,2,3,1,9,12,13,13,10,9,11,8,9,7,11,9,7,13,8,11,9,11,11,11,13,11,11,7,15,7,11,11,13,12,12,7,14,11,14,20,13,9,13,7,5,3,14,14,12,12,13,14,13,20,2,8,13,18,20,20,19,10,M/AM/S RL,535,1,1,17,10,19,20,1,5,8,1,1,15,18,11,13,0.0,0,0,0,0,0,0,0,0,0,0,0,0,0,0,0,0,0,0,0,0,0,0,0,0,0,0,0,0,0,0,0,0,0,0,0,0,0,0,0,0,0,0,0,0,0,0,0,0,JosÃ© Manuel ArnÃ¡iz,Â£4.50m ,25.0,175.0,Forward - Left Winger,right,CD LeganÃ©s,36.0,12.0,4.0,2755.0,26.0,9.0,4.0,2019.0,8.0,0.0,0.0,146.0,28.0,2.0,1.0,1275.0,6.0,1.0,0.0,419.0,LaLiga
19-06-17,18.3.4.28,Mikel OyarzÃ¡bal,67220143,796,21-Apr-97,20,0,0,0,0,5000,7000,7000,155,141,31301464,180,77,AM RLC,2,3,3,3,3,3,1,2,1,1,1,11,13,13,15,14,12,13,13,6,11,16,13,13,16,8,15,12,15,14,14,15,12,14,9,13,13,12,17,13,14,14,14,20,12,14,10,12,10,13,3,12,6,12,7,11,18,11,12,13,19,6,1,1,14,20,17,17,20,AM RLC,506,1,1,12,20,17,17,1,1,1,1,1,14,14,1,1,1.44115e+17,0,0,0,0,0,0,0,0,0,0,0,0,0,0,0,0,0,0,0,0,0,0,0,0,0,0,0,0,0,0,0,0,0,0,0,0,0,0,0,0,0,0,0,0,0,0,0,0,Mikel Oyarzabal,Â£31.50m ,23.0,181.0,Forward - Left Winger,left,Real Sociedad,43.0,4.0,9.0,3170.0,43.0,14.0,8.0,3323.0,41.0,14.0,4.0,3500.0,44.0,12.0,12.0,3583.0,8.0,4.0,2.0,526.0,LaLiga,15-07-16,17.3.2.23,Mikel OyarzÃ¡bal,67220143,796,21-Apr-97,19,0,0,0,0,5000,7000,7000,156,141,12828468,180,77,AM RLC,1,2,2,3,1,2,1,1,1,3,3,13,13,13,14,14,13,13,13,10,12,16,8,13,16,8,15,10,15,10,14,15,12,14,12,13,12,14,17,13,14,14,14,20,15,14,10,12,13,13,12,11,5,12,14,16,18,11,11,13,11,8,Mikel Oyarzabal,Â£13.50m ,LaLiga
19-06-17,18.3.4.28,Youssef En Nesyri,67229630,34,01-Jun-97,20,13,1,7,3,4200,6300,6300,142,126,8111223,189,73,AM/S RL,3,3,3,2,2,1,2,3,2,2,3,8,9,14,14,14,9,13,12,6,3,8,11,5,14,6,6,9,11,9,8,16,13,12,11,13,6,12,13,14,12,7,15,20,12,15,13,9,11,13,5,6,6,10,8,16,12,11,14,12,7,7,1,1,1,17,17,17,9,AM/S RL,625,1,1,20,9,17,17,1,1,1,1,1,1,1,1,1,0.0,0,0,0,0,0,0,0,0,0,0,0,0,0,0,0,0,0,0,0,0,0,0,0,0,0,0,0,0,0,0,0,0,0,0,0,0,0,0,0,0,0,0,0,0,0,0,0,0,Youssef En-Nesyri,Â£1.62m ,23.0,189.0,Forward - Centre-Forward,both,Sevilla FC,15.0,1.0,1.0,373.0,26.0,4.0,0.0,1609.0,34.0,11.0,2.0,2219.0,45.0,10.0,2.0,2564.0,7.0,1.0,0.0,273.0,LaLiga
19-06-17,18.3.4.28,Emre Ãolak,70002728,799,20-May-91,26,4,0,18,2,4250,6250,6550,138,131,6535445,169,65,M/AM LC,2,3,2,3,2,1,1,2,2,2,3,14,15,14,13,16,13,5,13,10,9,15,15,10,16,12,12,10,13,13,14,12,14,16,9,10,11,14,14,14,16,14,12,20,13,12,5,13,6,12,10,12,5,14,10,10,17,3,14,14,18,5,1,1,17,20,14,17,20,M/AM LC,524,1,1,1,20,17,14,1,1,1,5,16,17,14,1,1,140755000000000.0,0,0,0,0,0,0,0,0,0,0,0,0,0,0,0,0,0,0,0,0,1,0,0,0,0,0,0,0,0,0,0,0,0,0,1,0,0,0,0,0,0,0,0,0,0,0,0,1,Emre Colak,Â£1.80m ,29.0,169.0,Midfielder - Attacking Midfield,left,Without Club,36.0,3.0,10.0,2627.0,27.0,2.0,1.0,1544.0,14.0,1.0,0.0,897.0,17.0,2.0,0.0,985.0,nan,nan,nan,nan,LaLiga,15-07-16,17.3.2.23,Emre Ãolak,70002728,799,20-May-91,25,2,0,18,2,4250,6400,6400,135,128,4963338,169,65,M/AM LC,1,3,1,3,2,2,3,3,2,3,3,14,15,14,12,16,13,5,13,10,9,15,15,6,17,12,12,10,13,13,14,12,10,16,9,10,7,14,14,14,16,14,10,20,12,11,5,13,6,12,10,12,5,14,11,12,13,8,12,10,13,8,Emre Colak,Â£6.75m ,LaLiga
19-06-17,18.3.4.28,Cristiano Ronaldo,735216,788,05-Feb-85,32,138,71,10,3,9900,10000,9900,196,195,232186002,187,84,AM/S RL,3,3,2,4,1,1,3,1,2,3,2,13,15,14,19,17,15,19,20,7,3,15,20,9,15,6,18,16,14,16,14,17,20,17,15,19,6,8,8,14,13,14,17,15,19,16,20,17,17,17,12,15,7,10,18,20,13,19,20,7,7,12,1,1,12,18,16,18,8,AM/S RL,625,1,1,20,8,18,16,1,1,1,1,1,12,7,1,1,35734100000000.0,0,0,0,1,0,0,0,0,1,1,0,0,0,0,0,0,0,0,0,0,0,0,0,0,0,0,0,0,0,0,0,0,0,0,0,0,0,0,0,1,0,0,0,0,0,1,0,0,Cristiano Ronaldo,Â£90.00m ,35.0,187.0,Forward - Left Winger,both,Juventus FC,46.0,42.0,12.0,4126.0,44.0,44.0,8.0,3678.0,43.0,28.0,11.0,3646.0,46.0,37.0,7.0,4081.0,2.0,3.0,0.0,180.0,LaLiga,15-07-16,17.3.2.23,Cristiano Ronaldo,735216,788,05-Feb-85,31,133,61,10,3,9750,9950,9750,195,192,232186002,186,84,AM/S RL,2,2,3,3,3,2,3,2,2,3,2,12,14,15,19,16,14,18,19,6,2,14,19,8,15,6,17,16,13,16,13,17,20,18,15,18,5,6,7,13,12,13,16,15,19,17,20,17,16,17,12,14,7,10,18,20,13,19,20,7,7,12,Cristiano Ronaldo,Â£90.00m ,LaLiga
19-06-17,18.3.4.28,Sergio GarcÃ­a,7443839,796,09-Jun-83,34,2,0,12,5,6000,6950,6950,154,139,232186002,175,72,AM/S RLC,3,1,3,1,2,1,1,2,2,1,2,13,14,15,14,15,13,6,13,6,5,12,12,5,15,14,13,14,15,13,13,14,8,15,9,16,6,11,12,13,14,12,8,12,8,12,20,12,10,13,11,12,13,13,9,11,7,11,8,12,11,11,1,1,15,20,18,15,20,AM/S RLC,516,1,1,20,20,15,18,1,1,1,1,1,13,15,1,1,5144.0,0,0,0,1,1,0,0,0,0,0,1,0,1,0,0,0,0,0,0,0,0,0,0,0,0,0,0,0,0,0,0,0,0,0,0,0,0,0,0,0,0,0,0,0,0,0,0,0,Sergio GarcÃ­a,Â£1.35m ,37.0,174.0,Forward - Centre-Forward,right,Retired,25.0,13.0,6.0,2006.0,38.0,3.0,6.0,1839.0,31.0,2.0,1.0,1545.0,nan,nan,nan,nan,nan,nan,nan,nan,LaLiga
19-06-17,18.3.4.28,Momo,7450140,796,15-Jul-82,34,0,0,0,0,3800,6000,6000,132,119,148598,182,74,M/AM RL,3,2,1,2,2,2,3,2,2,3,1,15,15,15,12,15,14,4,12,8,5,14,15,6,16,8,13,11,14,13,15,14,12,16,11,13,7,14,12,10,11,8,9,20,8,11,10,10,9,12,7,12,12,12,11,11,11,12,13,13,13,7,1,1,19,20,17,20,13,M/AM RL,525,1,1,7,13,20,17,1,1,1,1,10,19,14,1,1,70385900000000.0,0,0,0,0,0,0,0,0,0,0,0,0,0,0,0,0,0,0,0,0,0,0,0,0,0,0,0,0,0,0,0,0,0,0,1,0,0,0,0,0,0,0,0,0,0,0,1,0,Momo,Â£90Th. ,38.0,178.0,Forward - Left Winger,left,Retired,25.0,3.0,0.0,1327.0,15.0,2.0,1.0,853.0,14.0,0.0,0.0,589.0,nan,nan,nan,nan,nan,nan,nan,nan,LaLiga,15-07-16,17.3.2.23,Momo,7450140,796,15-Jul-82,34,0,0,0,0,3800,6200,6200,132,125,294136,182,74,M/AM RL,1,2,1,2,2,2,2,2,3,2,2,15,15,15,12,15,14,4,12,8,5,14,15,7,16,8,13,12,14,13,15,14,12,16,11,14,7,14,13,11,12,8,9,20,8,12,10,10,9,12,7,12,12,12,11,11,11,12,13,13,13,7,Momo,Â£90Th. ,LaLiga
19-06-17,18.3.4.28,JosÃ© Manuel Jurado,7451707,796,29-Jun-86,30,0,0,13,5,5900,6850,6850,147,137,8601621,176,72,M/AM LC,4,2,2,2,2,2,2,2,3,1,1,15,14,15,12,16,15,6,14,6,5,17,13,6,16,7,13,7,11,7,15,13,10,17,5,14,6,11,10,14,14,12,8,16,13,13,20,11,8,10,4,12,10,13,14,8,10,12,12,11,14,7,1,1,19,20,14,15,20,M/AM LC,524,1,1,6,20,15,14,1,1,1,1,19,15,11,1,1,140737000000000.0,0,0,1,0,0,0,0,0,0,0,0,1,0,0,0,0,0,0,0,0,1,0,0,0,0,0,0,0,0,0,0,0,0,0,0,0,0,0,0,0,0,0,0,0,0,0,0,1,JosÃ© Manuel Jurado,Â£2.25m ,34.0,176.0,Midfielder - Attacking Midfield,right,Without Club,32.0,3.0,4.0,2579.0,31.0,0.0,3.0,1678.0,26.0,1.0,5.0,2061.0,15.0,0.0,0.0,479.0,nan,nan,nan,nan,LaLiga,15-07-16,17.3.2.23,JosÃ© Manuel Jurado,7451707,796,29-Jun-86,30,0,0,13,5,5850,7000,6750,147,135,6336253,176,72,M/AM LC,3,1,1,3,2,4,1,2,3,3,1,15,14,15,12,16,15,6,14,6,5,17,13,6,16,7,13,7,11,7,15,13,10,17,5,14,6,12,11,14,14,12,8,16,13,13,20,11,8,10,4,12,10,13,14,8,10,12,12,11,14,7,JosÃ© Manuel Jurado,Â£3.15m ,LaLiga
19-06-17,18.3.4.28,Johan Mojica,76020280,1653,21-Aug-92,24,1,1,0,0,4250,6000,6000,135,122,1966591,179,66,D/WB/M L,3,1,1,2,2,3,2,2,2,3,2,13,13,14,10,11,13,12,10,11,9,14,6,10,12,14,12,12,9,10,12,9,11,13,7,14,8,10,11,15,14,11,10,20,17,16,7,13,11,7,11,13,11,14,11,12,10,11,8,10,10,6,19,20,18,15,11,20,1,D/WB/M L,233,1,1,1,1,15,11,1,19,6,1,1,18,8,20,9,0.0,0,0,0,0,0,0,0,0,0,0,0,0,0,0,0,0,0,0,0,0,0,0,0,0,0,0,0,0,0,0,0,0,0,0,0,0,0,0,0,0,0,0,0,0,0,0,0,0,Johan Mojica,Â£3.60m ,28.0,185.0,Defender - Left-Back,left,Atalanta BC,17.0,0.0,2.0,951.0,32.0,1.0,4.0,2302.0,1.0,0.0,0.0,19.0,36.0,0.0,0.0,2811.0,5.0,0.0,0.0,110.0,LaLiga
19-06-17,18.3.4.28,Luis SuÃ¡rez,78000335,1657,24-Jan-87,30,84,46,4,2,8750,9750,9300,188,185,232186002,182,86,AM/S RLC,4,4,3,3,1,4,2,4,2,1,1,13,14,18,18,16,17,14,16,8,8,16,12,10,17,17,16,15,17,15,16,15,19,18,15,17,10,15,16,15,16,15,13,13,19,14,20,15,13,16,15,16,5,13,15,18,8,15,18,3,8,11,1,1,1,17,16,16,17,AM/S RLC,626,1,1,20,17,16,16,1,1,1,1,1,1,1,1,1,2251800000000000.0,0,0,0,0,0,0,0,0,0,0,0,0,0,1,0,0,1,1,0,0,0,0,0,0,0,0,0,0,0,0,0,0,0,0,0,0,0,0,0,0,0,0,0,0,0,0,0,0,Luis SuÃ¡rez,Â£63.00m ,33.0,182.0,Forward - Centre-Forward,right,AtlÃ©tico Madrid,51.0,36.0,19.0,4302.0,51.0,31.0,20.0,4447.0,49.0,23.0,15.0,4132.0,36.0,21.0,12.0,2658.0,6.0,4.0,1.0,382.0,LaLiga,15-07-16,17.3.2.23,Luis SuÃ¡rez,78000335,1657,24-Jan-87,29,84,46,4,2,8750,9750,9300,188,185,184166883,182,85,AM/S RLC,2,3,3,1,2,3,3,1,1,2,3,13,14,18,18,16,17,14,16,8,8,16,12,10,17,17,16,15,17,15,16,15,19,18,15,17,10,15,16,15,16,15,13,13,19,14,20,15,13,17,15,16,5,13,15,18,8,15,18,3,8,11,Luis SuÃ¡rez,Â£81.00m ,LaLiga
19-06-17,18.3.4.28,Cristhian Stuani,78000806,1657,12-Dec-86,30,35,5,6,0,5700,6600,6600,144,133,232186002,183,74,M/AM/S RL,3,2,1,1,1,3,3,1,2,3,3,7,11,11,14,12,8,14,11,6,7,12,15,8,12,12,14,14,14,13,10,13,14,10,12,15,10,13,13,12,11,14,12,12,14,13,20,13,13,13,7,14,6,12,14,13,11,12,14,14,13,7,1,1,16,19,19,16,12,M/AM/S RL,635,1,1,20,12,16,19,1,1,1,1,1,8,16,1,1,2147483648.0,0,0,0,0,0,0,0,0,0,0,0,0,0,0,0,0,0,0,0,0,0,0,0,0,0,0,0,0,0,0,0,1,0,0,0,0,0,0,0,0,0,0,0,0,0,0,0,0,Cristhian Stuani,Â£6.75m ,34.0,184.0,Forward - Centre-Forward,right,Girona FC,28.0,5.0,0.0,1607.0,33.0,21.0,0.0,2724.0,34.0,20.0,0.0,2872.0,40.0,31.0,3.0,3524.0,2.0,0.0,0.0,119.0,LaLiga,15-07-16,17.3.2.23,Cristhian Stuani,78000806,1657,12-Dec-86,29,22,4,6,0,5500,6900,6750,144,135,18188264,183,74,M/AM/S R,4,1,1,2,2,1,3,3,3,1,2,8,13,13,15,12,8,15,11,6,6,12,16,5,12,14,13,17,14,13,11,14,14,13,12,14,8,14,14,13,12,14,12,12,15,14,20,12,12,12,8,11,8,7,14,13,8,11,13,12,12,7,Cristhian Stuani,Â£3.15m ,Premier League
19-06-17,18.3.4.28,Diego Rolan,78045749,1657,24-Mar-93,24,25,4,9,4,5200,7350,6900,150,138,19850819,177,69,AM/S RL,2,3,3,1,2,1,3,3,3,1,1,9,14,15,15,14,10,13,12,3,5,11,14,6,14,12,13,9,13,10,12,12,14,14,10,16,5,8,8,15,15,10,10,10,14,16,20,13,10,14,8,13,11,13,7,14,12,13,8,14,13,8,1,1,8,19,19,15,12,AM/S RL,625,1,1,20,12,15,19,1,1,1,1,1,7,8,1,1,2098176.0,0,0,0,0,0,0,0,0,0,0,1,0,0,0,0,0,0,0,0,0,0,1,0,0,0,0,0,0,0,0,0,0,0,0,0,0,0,0,0,0,0,0,0,0,0,0,0,0,Diego RolÃ¡n,Â£3.15m ,27.0,177.0,Forward - Centre-Forward,right,Deportivo de La CoruÃ±a,33.0,10.0,0.0,2046.0,27.0,5.0,1.0,1968.0,17.0,0.0,0.0,666.0,21.0,8.0,0.0,1550.0,nan,nan,nan,nan,LaLiga,15-07-16,17.3.2.23,Diego Rolan,78045749,1657,24-Mar-93,23,21,3,9,4,5251,7227,6540,145,131,15878177,176,69,AM/S RL,3,1,2,1,2,3,3,2,2,1,2,9,9,14,13,14,10,10,9,3,5,12,14,6,15,9,13,9,11,10,12,12,13,14,10,13,8,8,10,16,15,10,8,10,12,15,20,13,10,9,8,13,11,13,7,14,12,13,8,14,13,8,Diego RolÃ¡n,Â£7.20m ,Ligue 1
19-06-17,18.3.4.28,HernÃ¡n PÃ©rez,79003362,1655,25-Feb-89,28,16,1,12,5,4900,6400,6800,150,136,12912832,180,77,M/AM RL,1,1,2,2,2,4,1,3,1,2,3,9,13,14,11,13,9,9,11,7,8,14,8,9,14,14,12,14,13,11,12,12,16,13,8,14,9,14,17,14,15,12,10,10,12,15,20,14,11,9,12,10,13,10,12,15,11,14,15,10,12,6,1,1,19,20,20,18,14,M/AM RL,525,1,1,10,14,18,20,1,1,1,1,1,17,19,1,1,0.0,0,0,0,0,0,0,0,0,0,0,0,0,0,0,0,0,0,0,0,0,0,0,0,0,0,0,0,0,0,0,0,0,0,0,0,0,0,0,0,0,0,0,0,0,0,0,0,0,HernÃ¡n PÃ©rez,Â£1.08m ,31.0,180.0,Forward - Right Winger,right,Al-Ahli SC,35.0,4.0,0.0,1977.0,17.0,0.0,0.0,701.0,21.0,2.0,2.0,892.0,20.0,4.0,3.0,1755.0,5.0,2.0,1.0,449.0,LaLiga,15-07-16,17.3.2.23,HernÃ¡n PÃ©rez,79003362,1655,25-Feb-89,27,16,1,12,5,4600,6400,6400,150,140,5321093,180,77,M/AM RL,4,2,3,1,3,3,1,1,3,3,2,10,12,14,11,14,10,10,11,8,11,15,9,10,14,14,13,14,13,13,12,13,16,12,8,14,10,13,17,15,16,13,11,7,12,16,20,15,11,10,12,10,13,10,12,15,11,14,15,10,12,6,HernÃ¡n PÃ©rez,Â£2.70m ,LaLiga
19-06-17,18.3.4.28,Jefferson Montero,80001392,1654,01-Sep-89,27,63,10,0,0,5800,7000,6250,139,128,8837443,170,70,M/AM L,1,1,3,1,1,4,1,2,1,2,1,8,13,14,12,10,9,8,10,8,5,10,11,7,13,7,9,4,13,8,9,9,7,15,5,9,6,11,9,17,15,17,7,18,10,17,20,8,6,7,11,12,13,5,11,16,10,8,13,12,8,9,1,1,18,20,14,20,11,M/AM L,523,1,1,14,11,20,14,1,1,1,1,1,18,11,1,1,2322170000000000.0,0,0,0,0,0,0,0,0,0,0,0,0,0,0,0,0,0,0,0,0,0,0,0,0,1,0,0,0,0,0,0,0,0,0,0,0,0,0,0,0,0,0,0,0,0,0,1,0,Jefferson Montero,Â£1.35m ,31.0,170.0,Forward - Left Winger,right,Without Club,15.0,0.0,1.0,523.0,18.0,1.0,3.0,655.0,17.0,1.0,3.0,505.0,18.0,0.0,1.0,568.0,nan,nan,nan,nan,LaLiga,15-07-16,17.3.2.23,Jefferson Montero,80001392,1654,01-Sep-89,26,49,9,0,0,5997,7097,6297,139,131,5079271,170,70,M/AM L,4,3,1,2,2,2,2,2,3,2,1,9,13,14,12,10,9,8,11,8,5,10,11,7,13,7,9,4,14,8,9,9,7,15,5,9,6,12,9,18,15,17,7,18,10,17,20,8,6,8,11,12,12,5,11,16,10,8,13,12,8,9,Jefferson Montero,Â£4.05m ,Premier League
19-06-17,18.3.4.28,Joel Campbell,80010074,366,26-Jun-92,24,70,14,13,10,5500,6750,6750,150,138,24179409,178,70,M/AM/S RL,2,1,1,3,2,1,1,4,1,3,3,10,12,16,13,14,10,7,13,4,6,13,14,7,14,10,13,13,11,9,13,12,13,14,6,14,7,13,14,15,14,12,9,20,14,15,8,12,10,12,9,12,6,10,14,13,14,13,12,15,15,6,1,1,16,20,20,20,11,M/AM/S RL,535,1,1,16,11,20,20,1,1,1,1,1,15,16,1,1,549756000000.0,0,0,0,0,0,0,0,0,0,0,0,0,0,0,0,0,0,0,0,0,0,0,0,0,0,0,0,0,0,0,0,0,0,0,0,0,0,0,0,1,0,0,0,0,0,0,0,0,Joel Campbell,Â£2.70m ,28.0,178.0,Forward - Right Winger,left,Club LeÃ³n FC,29.0,3.0,4.0,1246.0,9.0,2.0,1.0,232.0,38.0,4.0,4.0,2399.0,23.0,1.0,3.0,1210.0,14.0,0.0,0.0,525.0,LaLiga,15-07-16,17.3.2.23,Joel Campbell,80010074,366,26-Jun-92,24,42,10,13,10,5500,6750,6750,150,139,23757115,178,70,M/AM/S RL,3,3,3,2,1,3,3,3,2,2,3,10,12,16,13,14,10,7,13,4,6,13,14,7,14,10,13,13,11,9,13,12,13,14,6,14,7,13,14,15,14,12,9,20,14,15,10,12,10,12,9,12,6,10,14,13,14,13,12,15,15,6,Joel Campbell,Â£5.40m ,Premier League
19-06-17,18.3.4.28,Lucas,813076,796,10-Sep-88,28,0,0,0,0,6250,7250,7350,152,145,66034305,181,78,AM/S RLC,2,1,3,2,1,1,1,3,2,2,1,15,15,14,14,14,14,9,13,7,6,13,15,8,15,14,13,13,14,12,13,13,11,15,12,15,7,13,14,15,14,13,12,20,13,14,11,13,12,12,11,12,11,13,11,12,6,10,10,12,9,12,1,1,10,16,15,16,16,AM/S RLC,626,1,1,20,16,16,15,1,1,1,1,10,10,10,1,1,2251820000000000.0,0,0,0,0,0,0,0,0,0,0,0,0,0,0,0,0,0,0,0,0,1,0,0,0,0,0,0,0,0,0,0,0,0,0,1,0,0,0,0,0,0,0,0,0,0,0,0,0,nan,nan,nan,nan,nan,nan,nan,nan,nan,nan,nan,nan,nan,nan,nan,nan,nan,nan,nan,nan,nan,nan,nan,nan,nan,nan,nan,nan,15-07-16,17.3.2.23,Lucas,813076,796,10-Sep-88,27,0,0,0,0,6250,7250,7250,155,147,42225914,181,78,AM/S RLC,2,3,2,2,3,1,2,1,2,2,2,15,15,14,14,14,14,6,13,7,6,14,15,8,15,14,14,12,14,9,15,11,11,15,12,15,7,13,14,15,15,13,13,20,13,15,11,13,12,12,11,12,11,13,11,12,6,10,10,12,9,12,nan,nan,nan
19-06-17,18.3.4.28,AndrÃ©s Iniesta,824041,796,11-May-84,33,114,12,18,6,8500,8600,8600,183,168,232186002,171,68,M/AM LC,2,2,1,3,4,3,3,2,2,1,2,14,12,18,11,20,14,5,9,5,5,18,13,7,20,8,18,10,18,15,20,19,14,19,12,15,10,17,13,12,11,12,6,15,9,12,20,12,7,14,5,18,13,16,12,14,20,17,19,16,16,4,1,1,20,19,13,17,20,M/AM LC,414,1,1,1,19,17,13,1,1,1,9,20,16,12,1,1,158330000000000.0,0,0,0,0,0,0,0,1,0,0,0,0,0,0,0,0,0,0,0,0,0,0,1,0,1,0,0,0,0,0,0,0,0,0,0,0,0,0,0,0,0,0,0,0,1,0,0,1,AndrÃ©s Iniesta,Â£9.00m ,36.0,171.0,Midfielder - Central Midfield,both,Vissel Kobe,37.0,1.0,5.0,2288.0,59.0,5.0,6.0,4006.0,25.0,7.0,7.0,2108.0,25.0,4.0,9.0,1968.0,nan,nan,nan,nan,LaLiga,15-07-16,17.3.2.23,AndrÃ©s Iniesta,824041,796,11-May-84,32,114,12,18,6,8500,8750,8750,183,175,232186002,171,68,M/AM LC,4,2,1,1,2,1,1,4,2,3,4,14,13,19,11,20,14,5,10,5,5,18,13,7,20,8,18,10,18,15,20,19,14,19,12,15,11,17,13,13,13,13,6,15,10,12,20,13,7,14,5,18,13,16,19,14,16,17,19,16,16,4,AndrÃ©s Iniesta,Â£18.00m ,LaLiga
19-06-17,18.3.4.28,LoÄc RÃ©my,8444388,769,02-Jan-87,30,30,7,9,3,5750,6750,6750,151,142,232186002,185,81,AM/S L,2,3,2,1,1,1,1,1,2,3,2,7,12,14,14,15,10,15,13,4,5,12,17,4,15,7,15,12,14,15,12,14,15,13,6,14,6,11,11,14,13,14,13,10,12,14,20,14,14,14,6,14,15,8,13,16,11,12,13,15,15,8,1,1,12,19,14,19,1,AM/S L,623,1,1,20,1,19,14,1,1,1,1,1,10,12,1,1,1.44115e+17,0,0,0,0,1,0,0,0,0,0,1,0,0,1,0,0,0,0,0,0,0,0,0,0,0,0,0,0,0,0,0,0,0,0,0,0,0,0,0,0,0,0,0,0,0,0,0,0,LoÃ¯c RÃ©my,Â£5.40m ,33.0,185.0,Forward - Centre-Forward,right,Caykur Rizespor,8.0,0.0,0.0,283.0,24.0,9.0,0.0,1234.0,29.0,7.0,2.0,1396.0,30.0,14.0,0.0,1532.0,6.0,5.0,0.0,381.0,LaLiga,15-07-16,17.3.2.23,LoÄc RÃ©my,8444388,769,02-Jan-87,29,30,7,9,3,6150,7000,7000,159,140,15522667,185,81,AM/S L,3,2,3,3,2,1,4,2,1,2,1,7,12,14,14,15,10,15,13,4,5,12,17,4,15,7,15,12,14,15,12,14,15,13,6,14,6,11,11,14,13,14,13,10,12,14,20,14,14,14,6,14,12,8,13,16,11,12,13,15,15,8,LoÃ¯c RÃ©my,Â£8.10m ,Premier League
19-06-17,18.3.4.28,Ryad Boudebouz,8449112,5,19-Feb-90,27,25,2,0,0,5250,6750,6750,140,135,10521986,177,74,AM RLC,2,2,2,1,2,3,2,1,2,2,2,17,15,15,12,16,16,7,13,6,4,14,18,5,16,8,12,10,13,11,14,13,13,15,6,14,5,10,9,14,16,12,9,20,14,13,12,12,11,13,8,13,6,12,18,16,12,10,10,12,14,12,1,1,15,20,16,16,20,AM RLC,506,1,1,1,20,16,16,1,1,1,1,15,1,1,1,1,18176300000000.0,0,0,0,0,0,0,0,0,0,0,0,0,0,0,0,0,0,0,0,0,1,0,1,0,0,0,0,0,0,0,0,0,0,0,0,1,0,0,0,1,0,0,0,0,1,0,0,0,Ryad Boudebouz,Â£7.20m ,30.0,177.0,Midfielder - Attacking Midfield,left,AS Saint-Ãtienne,34.0,11.0,10.0,3015.0,29.0,3.0,3.0,1516.0,23.0,1.0,2.0,1340.0,30.0,2.0,4.0,1911.0,nan,nan,nan,nan,LaLiga,15-07-16,17.3.2.23,Ryad Boudebouz,8449112,5,19-Feb-90,26,17,1,0,0,4700,6300,6650,137,133,14161354,177,74,M/AM RLC,1,1,2,1,2,2,1,2,2,1,1,17,15,16,12,16,15,7,10,6,4,15,18,5,16,8,12,10,12,11,14,13,13,14,6,14,6,11,10,13,16,12,9,20,14,13,12,11,11,10,8,13,6,12,8,16,12,10,7,12,14,12,Ryad Boudebouz,Â£9.00m ,Ligue 1
19-06-17,18.3.4.28,FayÃ§al Fajr,85084000,34,01-Aug-88,28,1,0,0,0,5500,6800,6800,143,136,12912832,179,70,M/AM RLC,3,3,2,1,3,1,1,4,3,2,4,14,13,15,11,14,13,8,12,5,7,13,12,8,18,11,11,11,9,10,14,10,17,15,8,12,8,12,11,14,13,12,10,12,13,14,20,15,12,10,9,10,7,8,17,15,13,10,11,12,10,8,1,1,18,20,17,17,20,M/AM RLC,526,1,1,1,20,17,17,1,1,1,10,18,15,15,1,1,2233400000000.0,0,0,0,0,0,0,0,1,0,0,0,1,0,0,0,0,0,0,0,0,0,0,0,0,1,0,0,0,0,0,0,0,0,0,0,1,0,0,0,0,0,1,0,0,0,0,0,0,FayÃ§al Fajr,Â£2.25m ,32.0,179.0,Midfielder - Central Midfield,right,Sivasspor,26.0,0.0,3.0,1293.0,33.0,1.0,4.0,2564.0,40.0,5.0,9.0,3578.0,16.0,0.0,1.0,930.0,5.0,1.0,0.0,430.0,LaLiga,15-07-16,17.3.2.23,FayÃ§al Fajr,85084000,34,01-Aug-88,27,1,0,0,0,5500,6250,6800,145,138,13063493,179,70,M/AM RLC,1,3,1,1,1,2,4,1,2,2,2,14,15,15,11,15,14,8,12,5,8,13,12,9,18,11,11,11,9,10,16,10,17,15,8,12,8,12,11,14,13,12,10,12,13,14,20,16,12,10,9,10,7,8,11,15,13,10,11,12,10,8,FayÃ§al Fajr,Â£1.80m ,LaLiga
19-06-17,18.3.4.28,Ousmane DembÃ©lÃ©,85140178,769,15-May-97,20,7,1,4,0,7500,7750,8000,185,162,109091928,178,67,M/AM RLC,1,3,1,3,3,3,3,3,2,1,1,14,13,17,14,15,11,7,13,6,4,12,11,5,16,10,11,7,10,10,13,11,12,17,5,14,6,8,10,18,16,10,9,20,14,18,19,13,8,13,5,12,5,14,13,17,6,14,11,9,12,15,1,1,20,20,20,18,15,M/AM RLC,416,1,1,13,15,18,20,1,1,1,1,1,18,20,1,1,584116000000.0,0,0,0,0,0,0,0,0,0,0,1,0,0,0,0,0,0,0,0,0,0,0,0,0,0,0,0,0,0,0,0,0,0,0,0,1,0,0,0,1,0,0,0,0,0,0,0,0,Ousmane DembÃ©lÃ©,Â£72.00m ,23.0,178.0,Forward - Right Winger,both,FC Barcelona,49.0,10.0,21.0,3387.0,24.0,4.0,9.0,1250.0,42.0,14.0,8.0,2503.0,9.0,1.0,0.0,492.0,4.0,1.0,1.0,117.0,LaLiga,15-07-16,17.3.2.23,Ousmane DembÃ©lÃ©,85140178,769,15-May-97,19,0,0,2,0,6700,7450,7700,188,154,163696294,178,67,M/AM RLC,3,3,1,2,4,3,3,3,1,3,1,14,14,17,14,15,12,7,13,6,4,13,11,5,16,10,11,7,10,9,12,8,11,17,5,12,6,8,10,17,15,10,9,20,14,18,19,12,8,11,5,11,5,13,13,16,10,13,12,9,15,14,Ousmane DembÃ©lÃ©,Â£29.70m ,Bundesliga
19-06-17,18.3.4.28,Michael Krohn-Dehli,856650,764,06-Jun-83,34,56,6,8,2,6100,6750,7000,146,131,232186002,170,70,M/AM RLC,2,1,3,2,2,4,2,2,2,3,3,14,13,12,9,14,14,7,13,6,7,16,15,8,15,8,13,8,15,11,15,14,7,13,13,13,8,14,14,11,14,13,6,12,14,10,20,13,9,11,7,13,13,16,14,14,15,13,13,15,15,4,1,1,20,19,15,19,20,M/AM RLC,416,1,1,1,18,19,13,1,1,1,12,20,18,15,1,1,1.44133e+17,0,0,0,0,0,0,0,0,0,0,0,0,0,0,0,0,0,0,0,0,1,0,0,0,0,0,0,0,0,0,0,0,0,0,0,0,0,0,1,0,0,0,0,0,1,0,0,0,Michael Krohn-Dehli,Â£720Th. ,37.0,171.0,Midfielder - Central Midfield,both,Retired,2.0,0.0,0.0,172.0,30.0,1.0,1.0,1537.0,15.0,0.0,1.0,910.0,nan,nan,nan,nan,nan,nan,nan,nan,LaLiga,15-07-16,17.3.2.23,Michael Krohn-Dehli,856650,764,06-Jun-83,33,56,6,8,2,6100,7300,7300,146,141,1748551,170,70,M/AM RLC,1,4,1,3,2,3,2,2,3,2,2,15,15,14,9,14,15,7,13,6,7,16,15,8,15,8,13,8,15,11,15,15,7,13,13,13,8,15,14,13,14,13,6,12,16,13,20,13,9,11,7,13,13,16,14,14,15,13,13,15,15,4,Michael Krohn-Dehli,Â£1.35m ,LaLiga
19-06-17,18.3.4.28,Adalberto PeÅaranda,86040409,1658,31-May-97,20,11,0,8,1,4500,6900,6900,158,133,39161325,185,78,AM/S L,3,1,1,2,2,2,2,1,1,3,2,9,12,16,14,16,12,10,11,2,2,10,8,3,13,12,13,12,13,10,10,12,13,16,4,14,6,15,17,16,14,8,11,8,14,16,20,11,12,13,8,14,10,11,12,11,12,10,11,12,10,8,1,1,8,17,1,17,1,AM/S L,623,1,1,20,1,17,1,1,1,1,1,1,8,1,1,1,2251820000000000.0,0,0,0,0,0,0,0,0,0,0,0,0,0,0,0,0,0,0,0,0,0,0,0,0,0,0,0,0,0,0,0,0,0,0,1,0,0,0,0,0,0,0,0,0,0,0,0,0,Adalberto PeÃ±aranda,Â£1.80m ,23.0,186.0,Forward - Centre-Forward,right,CSKA Sofia,10.0,0.0,0.0,355.0,13.0,0.0,0.0,808.0,2.0,0.0,0.0,94.0,7.0,1.0,0.0,451.0,1.0,1.0,0.0,44.0,LaLiga,15-07-16,17.3.2.23,Adalberto PeÅaranda,86040409,1658,31-May-97,19,6,0,7,1,4250,6250,6250,148,125,26492107,185,79,AM/S L,2,1,1,1,3,3,1,3,1,2,1,9,11,12,15,14,12,10,11,2,3,10,8,3,13,14,13,12,12,10,10,12,15,16,4,14,7,15,17,16,14,11,11,8,13,15,20,13,12,13,8,14,10,11,12,9,12,10,11,12,10,8,Adalberto PeÃ±aranda,Â£2.70m ,Serie A
19-06-17,18.3.4.28,Marcelo,8832853,1651,12-May-88,29,47,5,4,0,8050,8500,8300,166,163,123169472,174,80,D/WB L,3,1,1,1,1,4,1,3,3,4,1,13,17,18,12,18,11,10,14,13,11,15,12,13,18,16,13,13,15,13,16,12,14,18,13,16,11,14,13,15,15,18,6,20,10,13,16,15,11,14,14,14,12,11,14,14,17,14,9,11,15,11,20,19,15,8,1,20,1,D/WB L,113,1,1,1,1,8,1,1,20,1,1,1,15,1,19,1,1.46367e+17,0,0,0,0,0,0,0,0,0,0,0,0,0,0,0,0,0,0,0,0,1,0,0,0,0,0,0,0,0,0,0,0,0,0,0,0,0,1,0,0,0,0,0,0,0,0,0,0,Marcelo,Â£54.00m ,32.0,174.0,Defender - Left-Back,left,Real Madrid,47.0,3.0,13.0,3878.0,44.0,5.0,11.0,3671.0,34.0,3.0,6.0,2858.0,23.0,2.0,7.0,1884.0,3.0,0.0,1.0,270.0,LaLiga,15-07-16,17.3.2.23,Marcelo,19080674,1651,27-Jul-89,26,0,0,0,0,5206,5206,6750,142,134,2842494,182,74,D C,2,1,1,2,3,2,4,3,1,1,3,7,7,8,8,11,6,13,5,6,15,15,8,15,13,13,14,15,13,14,11,13,15,7,12,8,14,14,14,12,14,14,13,8,14,13,20,14,13,13,10,13,13,8,15,14,13,12,15,13,12,7,Marcelo,Â£34.20m ,LaLiga
19-06-17,18.3.4.28,FabiÃ¡n Orellana,8835313,1652,27-Jan-86,31,39,2,0,0,6500,6900,6900,153,139,11258241,171,58,M/AM RLC,1,1,3,3,2,3,2,1,1,3,2,15,16,15,12,13,11,6,11,8,6,14,14,6,15,12,13,10,8,9,14,10,10,13,9,15,8,11,8,17,17,17,6,12,13,15,20,12,8,8,13,13,7,11,9,10,9,14,7,13,7,12,1,1,17,20,20,15,19,M/AM RLC,526,1,1,11,19,15,20,1,1,1,1,13,12,17,1,1,1099510000000.0,0,1,0,0,0,0,0,0,0,0,0,0,0,0,0,0,0,0,0,0,0,0,0,0,0,0,0,0,0,0,0,0,0,0,0,0,0,0,0,0,1,0,0,0,0,0,0,0,FabiÃ¡n Orellana,Â£1.80m ,34.0,171.0,Forward - Right Winger,right,Real Valladolid CF,25.0,5.0,3.0,1773.0,18.0,3.0,2.0,1261.0,33.0,3.0,5.0,2738.0,31.0,8.0,10.0,2578.0,6.0,0.0,0.0,456.0,LaLiga,15-07-16,17.3.2.23,FabiÃ¡n Orellana,8835313,1652,27-Jan-86,30,39,2,0,0,6500,7250,7500,157,150,232186002,171,58,M/AM RLC,1,3,1,2,3,1,3,2,2,2,2,15,16,15,12,14,11,8,11,8,7,13,14,8,14,12,13,11,8,12,13,11,11,13,9,16,9,13,13,17,17,17,6,12,13,15,20,12,8,11,13,13,7,7,10,10,9,14,10,13,7,12,FabiÃ¡n Orellana,Â£2.70m ,LaLiga
19-06-17,18.3.4.28,Antunes,8879120,788,01-Apr-87,30,1,0,14,0,4750,6000,6750,147,130,232186002,175,69,D/WB/M L,2,2,1,1,4,3,3,1,3,2,1,13,14,13,10,12,13,9,15,14,12,13,14,14,12,13,13,15,14,12,12,14,13,13,9,13,12,13,14,14,11,15,10,20,14,13,6,14,12,13,12,13,7,8,15,12,12,13,15,14,12,8,20,19,18,1,1,20,14,D/WB/M L,123,1,1,1,1,1,1,1,20,1,10,14,18,1,19,1,289.0,1,0,0,0,0,1,0,0,1,0,0,0,0,0,0,0,0,0,0,0,0,0,0,0,0,0,0,0,0,0,0,0,0,0,0,0,0,0,0,0,0,0,0,0,0,0,0,0,nan,nan,nan,nan,nan,nan,nan,nan,nan,nan,nan,nan,nan,nan,nan,nan,nan,nan,nan,nan,nan,nan,nan,nan,nan,nan,nan,nan,
19-06-17,18.3.4.28,Christian Santos,91017878,1658,24-Mar-88,29,12,1,0,0,5000,5950,5950,124,123,2544813,184,70,M/AM/S RL,3,2,3,2,1,2,3,1,1,2,3,13,12,13,13,13,12,17,12,8,5,14,11,6,13,11,10,11,13,11,12,11,14,13,11,10,7,15,15,13,12,12,12,20,11,14,5,11,13,11,10,14,10,8,12,14,9,12,12,11,12,1,5,8,16,19,16,19,14,M/AM/S RL,635,1,1,20,14,19,16,1,5,1,1,12,16,16,8,1,0.0,0,0,0,0,0,0,0,0,0,0,0,0,0,0,0,0,0,0,0,0,0,0,0,0,0,0,0,0,0,0,0,0,0,0,0,0,0,0,0,0,0,0,0,0,0,0,0,0,Christian Santos,Â£900Th. ,32.0,184.0,Forward - Centre-Forward,left,VfL OsnabrÃ¼ck,27.0,5.0,1.0,1367.0,12.0,3.0,0.0,484.0,21.0,3.0,0.0,692.0,28.0,6.0,2.0,1087.0,5.0,3.0,1.0,298.0,LaLiga,15-07-16,17.3.2.23,Christian Santos,91017878,1658,24-Mar-88,28,0,0,0,0,5000,5950,5950,124,123,2290330,184,70,M/AM/S RL,1,2,3,1,1,1,1,1,1,1,1,13,12,13,13,13,12,17,12,8,5,14,11,6,13,11,10,11,13,11,12,11,14,13,11,10,7,15,15,13,12,12,12,20,11,14,5,11,13,11,10,14,10,8,12,14,10,12,12,11,12,5,Christian Santos,Â£1.35m ,LaLiga
19-06-17,18.3.4.28,Nicola Sansone,92016695,776,10-Sep-91,25,3,0,8,0,6000,7050,7150,152,143,29813295,172,68,AM/S RL,3,3,1,1,2,2,2,2,3,1,1,12,14,14,13,12,14,7,14,4,5,13,14,6,16,12,12,11,13,14,12,13,13,15,11,15,6,11,12,16,16,11,7,15,15,14,20,12,8,14,9,15,8,14,12,14,11,12,11,11,12,7,1,1,1,20,16,20,13,AM/S RL,515,1,1,17,13,20,16,1,1,1,1,1,1,1,1,1,549756000000.0,0,0,0,0,0,0,1,0,0,0,0,0,0,0,0,0,0,0,0,0,0,0,0,0,0,0,0,0,0,0,0,0,0,0,0,0,0,0,0,1,0,0,0,0,0,0,0,0,Nicola Sansone,Â£6.75m ,29.0,173.0,Forward - Left Winger,right,Bologna FC 1909,44.0,9.0,4.0,2720.0,22.0,6.0,2.0,805.0,23.0,3.0,6.0,1588.0,34.0,4.0,4.0,2277.0,5.0,0.0,0.0,151.0,LaLiga,15-07-16,17.3.2.23,Nicola Sansone,92016695,776,10-Sep-91,24,1,0,8,0,6350,7150,7350,152,147,34513962,172,68,AM/S RL,1,4,2,1,2,3,1,3,1,1,1,12,14,14,13,14,14,7,14,4,5,13,14,6,16,12,12,11,13,15,12,14,13,15,11,15,6,11,12,16,16,11,7,16,15,14,20,12,8,14,9,15,8,14,12,14,11,12,11,11,12,7,Nicola Sansone,Â£14.40m ,Serie A
