GameDate_2018,FMRTEVersion_2018,Name_2018,UID_2018,NationID_2018,Born_2018,Age_2018,IntCaps_2018,IntGoals_2018,U21Caps_2018,U21Goals_2018,WorldReputation_2018,HomeReputation_2018,CurrentReputation_2018,PA_2018,CA_2018,Price_2018,Height_2018,Weight_2018,PositionsString_2018,GK.AerialAbility_2018,GK.CommandOfArea_2018,GK.Communication_2018,GK.Eccentricity_2018,GK.Handling_2018,GK.Kicking_2018,GK.OneOnOnes_2018,GK.Reflexes_2018,GK.RushingOut_2018,GK.TendencyToPunch_2018,GK.Throwing_2018,Tech.Corners_2018,Tech.Crossing_2018,Tech.Dribbling_2018,Tech.Finishing_2018,Tech.FirstTouch_2018,Tech.Freekicks_2018,Tech.Heading_2018,Tech.LongShots_2018,Tech.Longthrows_2018,Tech.Marking_2018,Tech.Passing_2018,Tech.PenaltyTaking_2018,Tech.Tackling_2018,Tech.Technique_2018,Mental.Aggression_2018,Mental.Anticipation_2018,Mental.Bravery_2018,Mental.Composure_2018,Mental.Concentration_2018,Mental.Vision_2018,Mental.Decisions_2018,Mental.Determination_2018,Mental.Flair_2018,Mental.Leadership_2018,Mental.OffTheBall_2018,Mental.Positioning_2018,Mental.Teamwork_2018,Mental.Workrate_2018,Phy.Acceleration_2018,Phy.Agility_2018,Phy.Balance_2018,Phy.Jumping_2018,Phy.LeftFoot_2018,Phy.NaturalFitness_2018,Phy.Pace_2018,Phy.RightFoot_2018,Phy.Stamina_2018,Phy.Strength_2018,Hidden.Consistency_2018,Hidden.Dirtiness_2018,Hidden.ImportantMatches_2018,Hidden.InjuryProness_2018,Hidden.Versatility_2018,Personality.Adaptability_2018,Personality.Ambition_2018,Personality.Loyalty_2018,Personality.Pressure_2018,Personality.Professional_2018,Personality.Sportsmanship_2018,Personality.Temperament_2018,Personality.Controversy_2018,Positions.Defender_2018,Positions.WingBack_2018,Positions.Midfielder_2018,Positions.AttackingMidfielder_2018,Positions.Right_2018,Positions.Left_2018,Positions.Centre_2018,Positions.PositionsDesc_2018,Positions.PositionsDescVal_2018,Positions.Goalkeeper_2018,Positions.Sweeper_2018,Positions.Striker_2018,Positions.AttackingMidCentral_2018,Positions.AttackingMidLeft_2018,Positions.AttackingMidRight_2018,Positions.DefenderCentral_2018,Positions.DefenderLeft_2018,Positions.DefenderRight_2018,Positions.DefensiveMidfielder_2018,Positions.MidfielderCentral_2018,Positions.MidfielderLeft_2018,Positions.MidfielderRight_2018,Positions.WingBackLeft_2018,Positions.WingBackRight_2018,PPMVal_2018,PPM0_2018,PPM1_2018,PPM2_2018,PPM3_2018,PPM4_2018,PPM5_2018,PPM6_2018,PPM7_2018,PPM8_2018,PPM9_2018,PPM10_2018,PPM11_2018,PPM12_2018,PPM13_2018,PPM14_2018,PPM15_2018,PPM16_2018,PPM17_2018,PPM18_2018,PPM19_2018,PPM20_2018,PPM21_2018,PPM22_2018,PPM23_2018,PPM24_2018,PPM25_2018,PPM26_2018,PPM27_2018,PPM28_2018,PPM29_2018,PPM30_2018,PPM31_2018,PPM32_2018,PPM33_2018,PPM34_2018,PPM35_2018,PPM36_2018,PPM37_2018,PPM38_2018,PPM39_2018,PPM40_2018,PPM41_2018,PPM42_2018,PPM43_2018,PPM44_2018,PPM45_2018,PPM46_2018,PPM47_2018,name_2018,Market Value_2018,age_2018,height_2018,position_2018,foot_2018,current club_2018,16/17 games_2018,16/17 goals/conceded_2018,16/17 assists/clean_2018,16/17 minutes_2018,17/18 games_2018,17/18 goals/conceded_2018,17/18 assists/clean_2018,17/18 minutes_2018,18/19 games_2018,18/19 goals/conceded_2018,18/19 assists/clean_2018,18/19 minutes_2018,19/20 games_2018,19/20 goals/conceded_2018,19/20 assists/clean_2018,19/20 minutes_2018,20/21 games_2018,20/21 goals/conceded_2018,20/21 assists/clean_2018,20/21 minutes_2018,current league_2018,GameDate_2017,FMRTEVersion_2017,Name_2017,UID_2017,NationID_2017,Born_2017,Age_2017,IntCaps_2017,IntGoals_2017,U21Caps_2017,U21Goals_2017,WorldReputation_2017,HomeReputation_2017,CurrentReputation_2017,PA_2017,CA_2017,Price_2017,Height_2017,Weight_2017,PositionsString_2017,GK.AerialAbility_2017,GK.CommandOfArea_2017,GK.Communication_2017,GK.Eccentricity_2017,GK.Handling_2017,GK.Kicking_2017,GK.OneOnOnes_2017,GK.Reflexes_2017,GK.RushingOut_2017,GK.TendencyToPunch_2017,GK.Throwing_2017,Tech.Corners_2017,Tech.Crossing_2017,Tech.Dribbling_2017,Tech.Finishing_2017,Tech.FirstTouch_2017,Tech.Freekicks_2017,Tech.Heading_2017,Tech.LongShots_2017,Tech.Longthrows_2017,Tech.Marking_2017,Tech.Passing_2017,Tech.PenaltyTaking_2017,Tech.Tackling_2017,Tech.Technique_2017,Mental.Aggression_2017,Mental.Anticipation_2017,Mental.Bravery_2017,Mental.Composure_2017,Mental.Concentration_2017,Mental.Vision_2017,Mental.Decisions_2017,Mental.Determination_2017,Mental.Flair_2017,Mental.Leadership_2017,Mental.OffTheBall_2017,Mental.Positioning_2017,Mental.Teamwork_2017,Mental.Workrate_2017,Phy.Acceleration_2017,Phy.Agility_2017,Phy.Balance_2017,Phy.Jumping_2017,Phy.LeftFoot_2017,Phy.NaturalFitness_2017,Phy.Pace_2017,Phy.RightFoot_2017,Phy.Stamina_2017,Phy.Strength_2017,Hidden.Consistency_2017,Hidden.Dirtiness_2017,Hidden.ImportantMatches_2017,Hidden.InjuryProness_2017,Hidden.Versatility_2017,Personality.Adaptability_2017,Personality.Ambition_2017,Personality.Loyalty_2017,Personality.Pressure_2017,Personality.Professional_2017,Personality.Sportsmanship_2017,Personality.Temperament_2017,Personality.Controversy_2017,name_2017,Market Value_2017,current league_2017
19-06-17,18.3.4.28,JesÃºs GÃ¡mez,1501035,796,10-Apr-85,32,0,0,4,2,5509,6800,6500,150,120,6074673,182,77,D/WB RL,4,2,3,1,4,2,2,2,3,1,3,5,11,11,5,12,5,11,7,12,12,12,7,13,14,12,13,13,14,13,10,13,12,6,12,13,13,14,12,11,12,13,12,12,12,12,20,12,12,13,8,12,16,10,6,16,15,11,12,12,8,5,20,18,1,1,20,16,1,D/WB RL,115,1,1,1,1,1,1,1,16,20,1,1,1,1,15,18,154619000000.0,0,0,0,0,0,1,0,0,0,0,0,0,0,0,0,0,0,0,0,0,0,0,0,0,0,0,0,0,0,0,0,0,0,0,1,0,0,1,0,0,0,0,0,0,0,0,0,0,JesÃºs GÃ¡mez,Â£1.80m ,35.0,177.0,Defender - Right-Back,right,Retired,7.0,0.0,0.0,381.0,3.0,0.0,0.0,217.0,nan,nan,nan,nan,nan,nan,nan,nan,nan,nan,nan,nan,Premier League
19-06-17,18.3.4.28,Matt Lowton,152936,765,09-Jun-89,28,0,0,0,0,4750,6650,6650,135,133,26534260,181,78,D/WB R,3,3,3,1,1,3,1,3,1,1,1,6,13,12,8,13,6,14,12,7,14,13,6,14,13,13,14,13,16,14,11,12,17,10,8,12,14,16,16,14,15,12,11,6,14,13,20,14,13,14,9,13,8,11,10,13,14,8,9,11,11,7,20,18,10,1,20,1,13,D/WB R,112,1,1,1,1,1,1,13,1,20,1,7,1,10,1,18,34.0,0,1,0,0,0,1,0,0,0,0,0,0,0,0,0,0,0,0,0,0,0,0,0,0,0,0,0,0,0,0,0,0,0,0,0,0,0,0,0,0,0,0,0,0,0,0,0,0,Matthew Lowton,Â£4.50m ,31.0,180.0,Defender - Right-Back,right,Burnley FC,36.0,0.0,2.0,3240.0,27.0,0.0,3.0,2384.0,24.0,0.0,0.0,2078.0,20.0,0.0,2.0,1722.0,3.0,0.0,1.0,259.0,Premier League,15-07-16,17.3.2.23,Matt Lowton,152936,765,09-Jun-89,27,0,0,0,0,4196,6246,6246,135,126,10573045,181,78,D/WB R,1,3,2,1,1,4,3,2,3,2,3,6,13,12,8,13,6,14,12,7,12,13,6,13,12,11,14,13,16,13,11,10,17,10,8,12,14,15,15,13,15,12,11,6,14,13,20,14,12,13,9,12,8,11,10,13,14,8,9,11,11,7,Matthew Lowton,Â£2.25m ,Premier League
19-06-17,18.3.4.28,Kyle Naughton,152937,765,17-Nov-88,28,0,0,9,0,5500,6350,6700,135,127,26931133,180,73,D/WB/M RL,3,1,3,3,3,3,3,2,3,2,1,6,11,10,5,13,7,10,12,10,11,11,5,12,12,8,12,11,15,11,10,11,14,11,8,11,12,14,13,14,14,13,10,12,18,14,20,15,11,12,9,12,5,14,12,15,18,14,16,16,13,4,20,18,16,1,20,15,5,D/WB/M RL,125,1,1,1,1,1,1,1,15,20,1,5,5,16,13,18,1125900000000000.0,0,0,0,0,0,0,1,0,0,1,0,0,0,0,0,0,0,0,0,0,0,0,0,0,0,0,0,0,0,0,0,0,0,0,0,0,0,0,0,0,0,0,0,0,0,0,0,0,Kyle Naughton,Â£4.50m ,31.0,181.0,Defender - Right-Back,right,Swansea City,34.0,1.0,0.0,2959.0,39.0,1.0,2.0,3399.0,38.0,1.0,2.0,3025.0,35.0,3.0,0.0,2720.0,2.0,0.0,0.0,171.0,Premier League,15-07-16,17.3.2.23,Kyle Naughton,152937,765,17-Nov-88,27,0,0,9,0,5400,6400,6400,135,130,12687171,180,73,D/WB/M RL,1,2,2,1,1,3,2,2,1,2,1,6,11,11,5,13,7,10,12,13,12,11,5,12,13,8,12,11,15,11,10,11,14,11,8,11,12,14,14,14,14,13,10,12,18,14,20,15,11,14,9,12,5,15,12,15,18,14,16,16,13,4,Kyle Naughton,Â£4.50m ,Premier League
19-06-17,18.3.4.28,Chancel Mbemba,18057323,53,08-Aug-94,22,25,1,0,0,5250,6750,6800,145,132,49225584,182,80,D RLC,3,1,2,2,1,2,1,2,2,2,1,4,10,12,8,12,4,14,10,4,13,12,7,15,13,10,13,14,14,12,8,11,13,10,10,11,15,15,15,15,11,14,13,8,14,15,20,14,14,12,8,13,6,14,14,12,12,14,14,14,16,5,20,1,1,1,17,15,20,D RLC,106,1,1,1,1,1,1,20,15,17,13,1,1,1,1,1,4294967296.0,0,0,0,0,0,0,0,0,0,0,0,0,0,0,0,0,0,0,0,0,0,0,0,0,0,0,0,0,0,0,0,0,1,0,0,0,0,0,0,0,0,0,0,0,0,0,0,0,Chancel Mbemba,Â£5.40m ,26.0,182.0,Defender - Centre-Back,right,FC Porto,13.0,1.0,0.0,1195.0,11.0,0.0,0.0,883.0,8.0,0.0,0.0,485.0,42.0,6.0,1.0,3301.0,6.0,0.0,0.0,531.0,Premier League
19-06-17,18.3.4.28,Danilo,19099575,1651,15-Jul-91,25,15,0,15,2,7000,7500,7250,152,150,44013283,184,78,D/WB RL,2,2,2,3,2,2,3,4,1,2,2,11,13,12,11,12,10,10,13,13,12,12,12,15,13,14,12,14,11,13,10,10,15,14,10,14,11,13,16,13,12,13,12,16,15,17,20,17,14,12,14,12,9,14,12,15,13,12,16,12,12,8,20,18,9,1,20,16,9,D/WB RL,115,1,1,1,1,1,1,1,16,20,11,9,1,9,15,18,2.8823e+17,0,0,0,0,0,1,0,0,0,0,0,0,0,0,0,0,0,0,0,0,0,0,0,0,0,0,0,1,0,0,0,0,0,0,0,0,0,0,0,0,0,0,0,0,0,0,0,0,Danilo,Â£18.00m ,29.0,184.0,Defender - Right-Back,right,Juventus FC,25.0,1.0,3.0,2117.0,38.0,3.0,2.0,2476.0,22.0,1.0,1.0,1479.0,32.0,2.0,0.0,2152.0,5.0,0.0,1.0,450.0,Premier League,15-07-16,17.3.2.23,Danilo,320236,1651,10-May-84,32,0,0,0,0,4500,6500,6650,143,133,232186002,185,75,D C,3,4,2,3,3,2,2,1,4,2,3,4,7,8,10,11,3,15,9,14,14,9,10,14,10,16,13,17,12,13,8,14,13,11,15,7,15,14,13,12,10,14,13,9,15,13,20,14,14,13,14,14,7,10,13,14,14,15,12,5,7,14,Danilo,Â£1.80m ,Serie A
19-06-17,18.3.4.28,Emerson,19158043,776,13-Mar-94,23,0,0,0,0,5000,6750,7250,158,145,64378562,176,77,D RL,3,4,3,2,4,2,2,4,1,2,2,12,15,16,7,16,10,9,14,10,12,13,4,14,15,11,13,12,12,12,12,13,14,14,5,15,12,13,14,16,15,15,9,20,13,16,10,14,13,13,11,9,5,13,8,12,13,10,14,13,12,9,20,15,14,1,15,20,10,D RL,105,1,1,1,1,1,1,1,20,15,1,10,14,10,15,12,1100180000000.0,1,0,0,0,0,0,0,0,1,0,0,0,0,0,0,0,0,0,0,0,0,0,0,0,0,0,0,1,0,1,0,0,0,0,0,0,0,0,0,0,1,0,0,0,0,0,0,0,Emerson,Â£18.00m ,26.0,181.0,Defender - Left-Back,left,Chelsea FC,36.0,1.0,1.0,2595.0,10.0,0.0,2.0,655.0,27.0,1.0,2.0,2250.0,21.0,0.0,1.0,1523.0,2.0,0.0,0.0,114.0,Premier League
19-06-17,18.3.4.28,Craig Cathcart,28000905,785,06-Feb-89,28,33,2,15,0,5750,6550,6600,138,135,26976197,188,73,D RC,2,1,1,1,2,1,1,3,2,2,1,3,4,8,10,12,4,15,4,7,14,12,4,16,12,11,14,13,14,14,8,15,16,5,11,11,14,13,14,11,9,13,15,13,15,12,20,15,13,15,6,13,13,8,9,12,15,13,18,17,17,3,20,1,1,1,15,9,20,D RC,103,1,1,1,1,1,1,20,9,15,1,1,1,1,1,1,274878000000.0,0,0,0,0,0,0,0,0,0,0,0,0,0,0,0,1,0,0,0,0,0,0,0,0,0,0,0,0,0,0,0,0,0,0,0,0,0,0,1,0,0,0,0,0,0,0,0,0,Craig Cathcart,Â£3.15m ,31.0,189.0,Defender - Centre-Back,right,Watford FC,16.0,0.0,1.0,1177.0,7.0,0.0,0.0,495.0,41.0,3.0,1.0,3578.0,30.0,0.0,0.0,2579.0,7.0,1.0,0.0,559.0,Premier League,15-07-16,17.3.2.23,Craig Cathcart,28000905,785,06-Feb-89,27,32,2,15,0,4600,6550,6500,138,135,19141387,188,73,D RC,1,3,4,3,2,1,3,3,4,3,1,3,4,8,10,12,4,15,4,7,14,12,4,16,12,11,14,13,14,14,8,15,16,5,11,11,14,13,14,11,9,13,15,13,15,12,20,15,13,15,6,13,13,8,9,12,15,13,18,17,17,3,Craig Cathcart,Â£3.60m ,Premier League
19-06-17,18.3.4.28,Joel Ward,28004100,765,29-Oct-89,27,0,0,0,0,5400,6650,6600,136,129,20559807,188,83,D RL,2,2,1,4,1,1,2,2,2,1,3,5,16,10,5,10,5,13,8,5,13,12,5,15,11,16,14,16,12,13,9,13,18,5,10,13,13,17,15,13,13,12,13,10,17,12,20,15,13,15,1,10,6,15,14,12,12,9,13,10,13,1,20,10,10,10,20,15,10,D RL,105,1,1,1,1,1,10,10,15,20,1,10,1,10,1,10,0.0,0,0,0,0,0,0,0,0,0,0,0,0,0,0,0,0,0,0,0,0,0,0,0,0,0,0,0,0,0,0,0,0,0,0,0,0,0,0,0,0,0,0,0,0,0,0,0,0,Joel Ward,Â£4.50m ,30.0,186.0,Defender - Right-Back,right,Crystal Palace,42.0,0.0,1.0,3778.0,20.0,0.0,1.0,1706.0,12.0,1.0,0.0,939.0,29.0,0.0,0.0,2383.0,5.0,0.0,0.0,450.0,Premier League,15-07-16,17.3.2.23,Joel Ward,28004100,765,29-Oct-89,26,0,0,0,0,5500,6650,6750,136,133,19453020,188,83,D RL,3,3,3,2,2,2,2,2,1,3,2,5,16,10,5,10,5,13,8,5,13,12,5,15,11,16,14,16,12,15,9,13,18,5,10,13,14,17,15,13,13,12,13,10,17,12,20,16,13,15,1,10,6,15,14,12,12,9,13,10,13,1,Joel Ward,Â£4.50m ,Premier League
19-06-17,18.3.4.28,Kyle Walker,28009441,765,28-May-90,27,27,0,7,0,7000,7750,7750,157,154,72250405,182,80,D/WB R,1,2,1,3,2,1,2,3,1,2,3,11,13,13,7,12,12,14,7,13,12,13,6,13,13,12,13,15,13,13,11,9,13,10,12,13,12,15,16,18,15,15,12,10,13,18,20,15,15,14,5,12,6,14,19,15,14,7,8,12,11,7,20,18,5,5,20,10,12,D/WB R,112,1,1,1,1,1,5,12,10,20,1,1,1,5,1,18,134217760.0,0,0,0,0,0,1,0,0,0,0,0,0,0,0,0,0,0,0,0,0,0,0,0,0,0,0,0,1,0,0,0,0,0,0,0,0,0,0,0,0,0,0,0,0,0,0,0,0,Kyle Walker,Â£45.00m ,30.0,183.0,Defender - Right-Back,right,Manchester City,39.0,0.0,5.0,3176.0,48.0,0.0,7.0,3842.0,52.0,2.0,1.0,4301.0,42.0,1.0,6.0,3454.0,8.0,0.0,0.0,684.0,Premier League,15-07-16,17.3.2.23,Kyle Walker,28009441,765,28-May-90,26,19,0,7,0,6000,7500,7500,151,148,76525627,183,74,D/WB R,1,2,3,3,3,1,2,2,2,4,2,13,13,14,7,12,12,15,7,14,12,12,6,13,12,11,13,15,13,13,11,9,13,10,12,12,12,15,16,18,15,15,12,10,13,18,20,15,15,13,5,12,6,14,10,15,14,7,8,12,11,7,Kyle Walker,Â£27.00m ,Premier League
19-06-17,18.3.4.28,Martin Kelly,28010835,765,27-Apr-90,27,1,0,8,3,4900,6500,6250,130,125,13042350,191,78,D RC,2,2,1,3,2,1,1,2,3,2,2,4,8,8,10,12,5,12,2,6,11,12,5,14,12,13,12,16,12,14,13,13,14,5,10,10,14,11,16,12,13,13,13,11,10,13,20,15,14,7,17,11,14,13,16,12,14,12,14,14,12,5,20,14,1,1,20,10,16,D RC,103,1,1,1,1,1,1,16,10,20,1,1,1,1,1,14,0.0,0,0,0,0,0,0,0,0,0,0,0,0,0,0,0,0,0,0,0,0,0,0,0,0,0,0,0,0,0,0,0,0,0,0,0,0,0,0,0,0,0,0,0,0,0,0,0,0,Martin Kelly,Â£2.70m ,30.0,191.0,Defender - Right-Back,right,Crystal Palace,34.0,0.0,2.0,2559.0,19.0,0.0,0.0,1554.0,20.0,0.0,0.0,1712.0,21.0,0.0,1.0,1685.0,2.0,0.0,0.0,151.0,Premier League,15-07-16,17.3.2.23,Martin Kelly,28010835,765,27-Apr-90,26,1,0,8,3,4900,6500,6500,130,125,11053229,191,78,D RC,1,3,3,1,1,3,1,3,3,3,2,4,8,8,10,12,5,12,2,6,11,12,5,14,12,13,12,16,12,14,13,13,14,5,10,10,14,11,16,12,13,13,13,11,10,13,20,15,14,7,17,11,14,13,19,12,14,12,14,14,12,5,Martin Kelly,Â£2.70m ,Premier League
19-06-17,18.3.4.28,Adam Smith,28011401,765,29-Apr-91,26,0,0,11,0,4900,6450,6650,139,133,26534260,180,79,D R,2,1,2,1,1,3,2,2,1,3,3,6,13,15,7,13,6,8,11,3,12,14,2,15,13,10,14,13,13,12,13,13,14,9,10,13,14,14,16,14,14,12,7,8,17,16,20,15,13,15,10,14,5,12,12,14,8,11,15,13,11,2,20,13,10,7,20,13,1,D R,102,1,1,1,1,1,7,1,13,20,1,1,1,10,1,13,2251800000000000.0,0,0,1,0,0,0,0,0,1,0,0,0,0,0,0,0,0,0,0,0,0,0,0,0,0,0,0,0,0,0,0,0,0,0,0,0,0,0,0,0,0,0,0,0,0,0,0,0,Adam Smith,Â£4.50m ,29.0,174.0,Defender - Right-Back,right,AFC Bournemouth,36.0,1.0,5.0,3099.0,32.0,1.0,4.0,2438.0,26.0,1.0,1.0,2163.0,25.0,0.0,1.0,2151.0,7.0,0.0,1.0,630.0,Premier League,15-07-16,17.3.2.23,Adam Smith,28011401,765,29-Apr-91,25,0,0,11,0,4650,6450,6450,132,129,15192484,180,79,D R,3,2,3,1,3,2,1,2,2,2,1,6,13,14,7,13,6,8,11,3,12,14,2,13,13,10,13,12,13,12,13,13,14,9,10,12,14,14,16,14,12,12,7,8,15,16,20,15,13,14,10,14,5,12,12,14,8,11,15,13,11,2,Adam Smith,Â£4.50m ,Premier League
19-06-17,18.3.4.28,Steve Cook,28014634,765,19-Apr-91,26,0,0,0,0,5100,6800,6800,148,140,33727050,186,82,D RC,2,4,1,2,1,3,2,3,3,4,1,6,9,8,8,12,6,14,6,14,14,14,1,16,14,9,14,13,14,13,12,14,14,6,14,7,14,13,16,14,13,13,14,11,16,14,20,15,14,14,6,13,2,12,12,14,13,12,13,16,11,8,20,1,1,1,17,1,20,D RC,103,1,1,1,1,1,1,20,1,17,1,1,1,1,1,1,4294967296.0,0,0,0,0,0,0,0,0,0,0,0,0,0,0,0,0,0,0,0,0,0,0,0,0,0,0,0,0,0,0,0,0,1,0,0,0,0,0,0,0,0,0,0,0,0,0,0,0,Steve Cook,Â£6.30m ,29.0,185.0,Defender - Centre-Back,right,AFC Bournemouth,38.0,2.0,1.0,3420.0,40.0,3.0,1.0,3336.0,35.0,2.0,1.0,3078.0,31.0,1.0,0.0,2532.0,8.0,0.0,0.0,656.0,Premier League,15-07-16,17.3.2.23,Steve Cook,28014634,765,19-Apr-91,25,0,0,0,0,4800,6300,6500,145,133,18920630,186,82,D RC,3,2,1,1,3,1,3,1,2,3,1,6,9,8,8,12,6,13,6,14,14,14,1,16,13,9,14,13,14,13,12,12,14,6,12,7,14,12,16,13,11,13,14,9,16,13,20,15,14,13,6,13,2,12,12,14,13,12,13,16,11,8,Steve Cook,Â£4.50m ,Premier League
19-06-17,18.3.4.28,Kieran Trippier,28018613,765,19-Sep-90,26,1,0,2,0,5750,7050,7050,146,142,22121658,178,72,D/WB R,2,3,1,3,1,3,3,3,3,1,3,11,16,11,8,15,13,9,10,10,11,13,5,14,14,12,13,13,13,12,13,14,14,8,11,14,13,16,16,13,13,14,9,6,14,14,20,18,13,14,8,10,7,13,11,12,12,13,14,14,14,4,20,17,13,1,20,1,1,D/WB R,112,1,1,1,1,1,1,1,1,20,1,1,1,13,1,17,34.0,0,1,0,0,0,1,0,0,0,0,0,0,0,0,0,0,0,0,0,0,0,0,0,0,0,0,0,0,0,0,0,0,0,0,0,0,0,0,0,0,0,0,0,0,0,0,0,0,Kieran Trippier,Â£18.00m ,30.0,173.0,Defender - Right-Back,right,AtlÃ©tico Madrid,22.0,0.0,7.0,1464.0,35.0,0.0,9.0,2904.0,38.0,1.0,5.0,3174.0,33.0,0.0,5.0,2730.0,6.0,0.0,0.0,540.0,Premier League,15-07-16,17.3.2.23,Kieran Trippier,28018613,765,19-Sep-90,25,0,0,2,0,5000,6700,6700,148,134,15899937,178,70,D R,1,1,2,3,1,2,3,1,3,2,1,4,15,12,6,15,13,9,10,10,11,14,5,14,12,12,12,13,11,12,10,13,13,8,11,12,14,14,15,14,14,13,10,6,13,15,20,17,13,13,8,10,7,13,11,10,11,13,12,12,13,4,Kieran Trippier,Â£9.00m ,Premier League
19-06-17,18.3.4.28,Nathaniel Clyne,28019851,765,05-Apr-91,26,14,0,8,0,6250,7400,7550,154,151,58295551,176,67,D/WB R,2,3,1,2,3,4,3,1,3,3,3,3,10,13,6,14,3,9,8,9,14,14,5,16,13,13,13,14,13,13,11,14,14,10,9,15,14,17,16,16,15,14,8,8,18,16,20,17,13,17,8,15,8,12,14,15,15,15,15,12,14,7,20,19,1,1,20,14,1,D/WB R,112,1,1,1,1,1,1,1,14,20,1,1,1,1,13,19,2252900000000000.0,0,1,0,0,0,1,0,0,0,0,0,0,0,0,0,0,0,0,0,0,0,0,0,0,0,0,0,1,0,0,0,0,0,0,0,0,0,0,0,0,1,0,0,0,0,0,0,0,Nathaniel Clyne,Â£18.00m ,29.0,175.0,Defender - Right-Back,right,Crystal Palace,41.0,0.0,3.0,3616.0,5.0,0.0,0.0,183.0,21.0,0.0,1.0,1523.0,nan,nan,nan,nan,2.0,0.0,0.0,117.0,Premier League,15-07-16,17.3.2.23,Nathaniel Clyne,28019851,765,05-Apr-91,25,13,0,8,0,6250,7350,7350,158,151,37134207,176,67,D/WB R,2,2,1,2,3,2,3,1,1,3,3,3,12,13,8,14,3,8,8,9,14,14,5,16,13,13,13,14,12,13,11,14,15,10,9,15,14,17,16,16,15,14,8,8,18,16,20,17,12,17,8,15,5,12,16,15,15,15,15,13,15,7,Nathaniel Clyne,Â£18.90m ,Premier League
19-06-17,18.3.4.28,Tommy Smith,28047506,765,14-Apr-92,25,0,0,0,0,4750,6500,6500,140,130,22147819,186,75,D RC,1,3,3,2,2,3,3,3,3,1,3,4,13,13,7,12,5,13,7,11,12,12,4,13,12,11,13,13,12,12,13,12,13,11,18,12,14,16,15,13,12,11,13,10,17,13,20,16,14,14,6,14,1,15,8,12,13,5,16,15,18,5,20,1,1,1,20,13,16,D RC,103,1,1,1,1,1,1,16,13,20,1,1,1,1,1,1,1048608.0,0,0,0,0,0,1,0,0,0,0,0,0,0,0,0,0,0,0,0,0,1,0,0,0,0,0,0,0,0,0,0,0,0,0,0,0,0,0,0,0,0,0,0,0,0,0,0,0,Tommy Smith,Â£2.70m ,28.0,185.0,Defender - Right-Back,right,Stoke City,47.0,4.0,8.0,3972.0,27.0,0.0,1.0,2062.0,16.0,0.0,0.0,1231.0,33.0,0.0,4.0,2780.0,11.0,1.0,0.0,920.0,Premier League
19-06-17,18.3.4.28,Michael Keane,28047558,765,11-Jan-93,24,2,0,16,3,5900,7350,7250,155,140,52569320,186,83,D RC,1,1,1,1,1,3,2,1,1,2,2,5,8,8,8,12,5,14,5,12,14,12,5,14,13,13,14,14,14,13,10,13,17,8,12,10,14,15,13,14,14,12,14,13,14,13,20,13,15,12,8,12,11,10,10,15,14,14,16,16,14,5,20,1,13,1,17,1,20,D RC,103,1,1,1,1,1,1,20,1,17,1,13,1,10,1,1,279173000000.0,0,0,0,0,0,0,0,0,0,0,0,0,0,0,0,0,0,0,0,0,0,0,0,0,0,0,0,0,0,0,0,0,1,0,0,0,0,0,1,0,0,0,0,0,0,0,0,0,Michael Keane,Â£18.00m ,27.0,188.0,Defender - Centre-Back,right,Everton FC,39.0,2.0,1.0,3510.0,38.0,1.0,1.0,3295.0,35.0,1.0,2.0,3150.0,34.0,2.0,0.0,2785.0,9.0,3.0,1.0,810.0,Premier League,15-07-16,17.3.2.23,Michael Keane,28047558,765,11-Jan-93,23,0,0,16,3,5250,7150,7150,155,143,35814915,186,83,D RC,2,1,1,3,3,2,2,1,3,3,3,5,8,8,8,12,5,15,5,12,14,13,5,14,13,13,14,15,15,13,10,12,17,8,11,10,14,14,14,16,13,11,14,12,14,16,20,13,14,14,8,14,12,10,10,15,12,14,16,16,14,5,Michael Keane,Â£16.20m ,Premier League
19-06-17,18.3.4.28,Sam Byram,28059134,765,16-Sep-93,23,0,0,0,0,4250,6250,6250,145,124,16313227,181,73,D/M R,3,2,4,3,3,2,2,2,3,2,2,5,14,12,11,14,3,13,8,13,12,13,5,12,13,11,13,11,15,12,12,10,11,12,9,13,14,14,15,13,12,13,11,10,14,13,20,14,10,14,8,10,15,13,13,11,12,12,11,12,12,2,20,14,18,15,20,1,1,D/M R,112,1,1,1,1,1,15,1,1,20,1,1,1,18,1,14,8.0,0,0,0,1,0,0,0,0,0,0,0,0,0,0,0,0,0,0,0,0,0,0,0,0,0,0,0,0,0,0,0,0,0,0,0,0,0,0,0,0,0,0,0,0,0,0,0,0,Sam Byram,Â£3.60m ,27.0,183.0,Defender - Right-Back,right,Norwich City,23.0,0.0,2.0,1664.0,13.0,0.0,0.0,924.0,8.0,0.0,1.0,654.0,20.0,0.0,0.0,1559.0,nan,nan,nan,nan,Premier League
19-06-17,18.3.4.28,John Stones,28060397,765,28-May-94,23,18,0,12,0,6750,7850,7850,172,155,138755427,188,70,D RC,2,2,1,4,2,4,3,3,4,1,3,5,11,13,8,13,5,15,5,8,15,15,12,15,14,10,14,16,17,15,14,13,13,12,13,15,14,13,15,14,13,16,14,12,19,15,20,13,15,15,8,12,5,10,12,20,15,16,14,13,16,5,20,1,1,1,16,1,20,D RC,103,1,1,1,1,1,1,20,1,16,1,1,1,1,1,1,1.15292e+18,0,0,0,0,0,0,0,0,0,0,0,0,0,0,0,0,0,0,0,0,0,0,0,0,0,0,0,0,0,0,0,0,1,0,0,0,0,0,0,0,0,0,0,0,0,0,0,0,John Stones,Â£45.00m ,26.0,188.0,Defender - Centre-Back,right,Manchester City,41.0,2.0,0.0,3170.0,29.0,3.0,0.0,2234.0,39.0,0.0,1.0,2820.0,24.0,0.0,1.0,1584.0,2.0,0.0,0.0,90.0,Premier League,15-07-16,17.3.2.23,John Stones,28060397,765,28-May-94,22,10,0,12,0,6500,7850,7850,172,146,124433565,189,77,D RC,3,4,3,3,3,3,2,2,3,2,3,5,11,12,8,13,5,15,5,8,15,14,15,16,12,10,12,15,17,12,12,13,13,10,12,11,14,12,14,13,12,16,14,12,19,15,20,13,14,12,9,12,5,10,11,20,15,16,14,13,16,5,John Stones,Â£31.50m ,Premier League
19-06-17,18.3.4.28,HÃ©ctor BellerÃ­n,28066082,796,19-Mar-95,22,3,0,12,0,6750,7250,7500,162,151,108585970,177,72,D/WB R,3,1,3,3,3,1,3,3,3,1,2,8,12,13,9,12,5,10,10,12,12,11,8,14,14,12,12,15,13,13,10,12,15,12,4,14,12,14,16,20,15,12,9,8,16,19,20,15,9,14,8,15,5,14,15,15,14,15,15,15,15,5,20,20,10,8,20,1,1,D/WB R,112,1,1,1,1,1,8,1,1,20,1,1,1,10,1,20,134217760.0,0,0,0,0,0,1,0,0,0,0,0,0,0,0,0,0,0,0,0,0,0,0,0,0,0,0,0,1,0,0,0,0,0,0,0,0,0,0,0,0,0,0,0,0,0,0,0,0,HÃ©ctor BellerÃ­n,Â£36.00m ,25.0,178.0,Defender - Right-Back,right,Arsenal FC,42.0,1.0,5.0,3233.0,47.0,3.0,5.0,4161.0,19.0,0.0,5.0,1533.0,25.0,1.0,2.0,1949.0,9.0,0.0,3.0,630.0,Premier League,15-07-16,17.3.2.23,HÃ©ctor BellerÃ­n,28066082,796,19-Mar-95,21,3,0,0,0,6500,7000,7500,165,152,89583731,177,72,D R,1,1,3,3,2,1,3,2,3,1,1,8,13,13,9,12,5,10,11,12,13,11,8,15,14,12,12,15,13,13,10,12,15,12,4,14,13,14,16,20,15,13,9,8,16,20,20,16,9,17,8,15,5,14,15,15,14,15,15,15,15,5,HÃ©ctor BellerÃ­n,Â£27.00m ,Premier League
19-06-17,18.3.4.28,Jonjoe Kenny,28090682,765,15-Mar-97,20,0,0,0,0,4250,5650,6100,132,122,17098216,176,64,D R,3,3,2,3,2,2,1,1,3,3,3,6,11,11,5,11,6,11,8,5,13,10,11,14,12,14,11,14,13,12,11,12,15,6,14,10,13,13,16,14,14,12,9,11,14,12,20,14,11,14,9,12,6,13,11,10,15,13,14,13,14,1,20,10,14,1,20,10,14,D R,102,1,1,1,1,1,1,14,10,20,14,14,1,7,1,10,0.0,0,0,0,0,0,0,0,0,0,0,0,0,0,0,0,0,0,0,0,0,0,0,0,0,0,0,0,0,0,0,0,0,0,0,0,0,0,0,0,0,0,0,0,0,0,0,0,0,Jonjoe Kenny,Â£4.50m ,23.0,176.0,Defender - Right-Back,right,Everton FC,22.0,0.0,4.0,1902.0,28.0,0.0,3.0,2377.0,15.0,0.0,1.0,1240.0,34.0,2.0,3.0,2994.0,3.0,0.0,0.0,222.0,Premier League
19-06-17,18.3.4.28,Ainsley Maitland-Niles,28095584,765,29-Aug-97,19,0,0,0,0,5250,6750,6750,149,130,58356008,177,0,D/WB/DM/M RLC,2,2,4,3,1,2,1,1,2,3,2,10,10,13,7,13,8,6,11,8,10,12,7,11,14,10,12,9,13,11,12,11,11,14,7,12,11,13,11,16,14,13,8,8,13,14,20,13,11,12,9,13,7,17,14,14,13,13,11,12,13,12,17,17,20,14,17,17,20,D/WB/DM/M RLC,446,1,1,1,8,10,14,8,17,17,16,20,12,14,17,17,0.0,0,0,0,0,0,0,0,0,0,0,0,0,0,0,0,0,0,0,0,0,0,0,0,0,0,0,0,0,0,0,0,0,0,0,0,0,0,0,0,0,0,0,0,0,0,0,0,0,Ainsley Maitland-Niles,Â£6.30m ,23.0,180.0,Midfielder - Right Midfield,right,Arsenal FC,20.0,0.0,2.0,1555.0,32.0,0.0,1.0,2310.0,31.0,2.0,3.0,2188.0,33.0,1.0,2.0,2106.0,6.0,0.0,0.0,367.0,Premier League
19-06-17,18.3.4.28,Trent Alexander-Arnold,28104124,765,07-Oct-98,18,0,0,0,0,5000,6600,6600,177,141,68321749,180,70,D/WB/DM/M RC,1,3,2,2,3,1,1,2,1,1,2,12,16,14,12,13,13,9,13,7,11,14,13,13,14,13,13,13,13,12,11,12,16,13,12,13,12,14,15,15,14,12,9,8,14,15,20,13,10,13,9,13,7,14,12,16,18,13,17,12,13,8,19,20,16,12,20,12,16,D/WB/DM/M RC,243,1,1,1,1,1,12,8,10,19,16,16,1,16,12,20,2.8823e+17,0,1,0,0,0,1,0,0,0,1,0,0,0,0,0,0,0,0,0,0,0,0,0,0,0,0,0,0,0,0,0,0,0,0,0,0,0,0,0,0,0,0,0,0,0,0,0,0,Trent Alexander-Arnold,Â£22.50m ,22.0,180.0,Defender - Right-Back,right,Liverpool FC,24.0,4.0,5.0,1663.0,34.0,3.0,3.0,2744.0,40.0,1.0,16.0,3388.0,49.0,4.0,15.0,3991.0,7.0,0.0,1.0,629.0,Premier League
19-06-17,18.3.4.28,Dujon Sterling,28108034,765,24-Oct-99,17,0,0,0,0,2506,4511,3750,144,105,342279,179,73,D/WB/M/AM RC,3,2,1,2,4,1,1,1,3,2,2,4,7,6,9,6,9,6,9,9,6,5,6,7,7,14,9,11,9,7,7,8,2,12,4,7,7,9,11,17,11,9,9,10,9,16,20,15,11,10,9,4,8,10,20,13,10,10,10,9,20,8,20,18,16,18,20,11,16,D/WB/M/AM RC,133,1,1,12,1,1,18,16,11,20,1,1,1,16,1,18,134217728.0,0,0,0,0,0,0,0,0,0,0,0,0,0,0,0,0,0,0,0,0,0,0,0,0,0,0,0,1,0,0,0,0,0,0,0,0,0,0,0,0,0,0,0,0,0,0,0,0,Dujon Sterling, ,21.0,186.0,Defender - Right-Back,right,Chelsea FC U23,32.0,5.0,6.0,2619.0,34.0,6.0,2.0,2764.0,40.0,0.0,5.0,3457.0,10.0,0.0,1.0,749.0,nan,nan,nan,nan,Premier League
19-06-17,18.3.4.28,Marc Albrighton,29010506,765,18-Nov-89,27,0,0,8,1,5100,6900,6900,142,137,27458989,174,68,WB/M/AM RL,2,1,1,3,3,3,2,2,3,2,4,15,15,12,11,13,12,5,10,7,8,13,10,12,12,14,12,14,12,16,14,10,13,12,7,13,14,17,18,14,13,11,6,8,15,13,20,15,9,10,10,13,5,11,11,12,15,10,16,16,17,3,11,17,20,17,19,20,4,WB/M/AM RL,435,1,1,5,4,17,17,1,10,11,1,1,20,19,15,17,150633000000000.0,0,1,0,0,0,0,0,1,0,0,0,0,0,0,0,0,0,0,0,0,0,0,0,0,0,0,0,0,0,0,0,0,0,0,0,0,0,0,0,0,1,0,0,1,0,0,0,1,Marc Albrighton,Â£9.00m ,30.0,175.0,Midfielder - Right Midfield,right,Leicester City,47.0,4.0,9.0,3522.0,42.0,2.0,7.0,2968.0,32.0,3.0,4.0,1936.0,28.0,0.0,5.0,1439.0,4.0,0.0,0.0,125.0,Premier League,15-07-16,17.3.2.23,Marc Albrighton,29010506,765,18-Nov-89,26,0,0,8,1,5100,6900,6900,142,137,24485546,174,68,WB/M/AM RL,3,2,3,2,1,3,1,2,2,4,1,15,15,12,11,13,12,5,10,7,8,13,10,12,12,14,12,14,12,16,14,10,13,12,7,13,14,17,18,14,13,11,6,8,15,13,20,15,9,10,10,13,5,11,16,12,15,10,16,16,17,3,Marc Albrighton,Â£5.40m ,Premier League
19-06-17,18.3.4.28,Molla WaguÃ©,29023789,31,21-Feb-91,26,19,3,0,0,4494,6742,6100,135,122,4949284,191,87,D RC,3,2,3,3,1,3,3,2,3,1,4,3,6,6,8,8,6,16,6,5,14,7,6,15,9,13,12,15,13,13,6,12,13,6,8,8,13,14,14,13,10,14,16,5,13,14,20,14,15,13,13,13,10,8,15,14,13,13,15,12,13,6,20,1,1,1,15,1,20,D RC,103,1,1,5,1,1,1,20,1,15,1,1,1,1,1,1,32.0,0,0,0,0,0,1,0,0,0,0,0,0,0,0,0,0,0,0,0,0,0,0,0,0,0,0,0,0,0,0,0,0,0,0,0,0,0,0,0,0,0,0,0,0,0,0,0,0,Molla WaguÃ©,Â£1.35m ,29.0,191.0,Defender - Centre-Back,right,Amiens SC,8.0,0.0,0.0,700.0,9.0,1.0,0.0,677.0,14.0,3.0,0.0,1044.0,11.0,0.0,0.0,862.0,2.0,0.0,0.0,180.0,Premier League,15-07-16,17.3.2.23,Molla WaguÃ©,29023789,31,21-Feb-91,25,19,3,0,0,4100,6750,6350,132,128,3984197,191,87,D RC,3,2,1,1,2,3,1,2,1,2,1,3,6,6,8,8,6,16,6,5,14,7,6,15,9,13,13,15,14,13,6,12,13,6,8,10,13,14,14,13,10,16,16,5,13,13,20,14,16,13,13,13,10,8,14,14,13,13,15,12,13,6,Molla WaguÃ©,Â£1.35m ,Premier League
19-06-17,18.3.4.28,Calum Chambers,29076103,765,20-Jan-95,22,3,0,22,0,5800,6700,6700,150,134,37977717,183,73,D RC,3,1,1,3,2,2,3,2,3,3,2,6,11,10,9,13,7,14,8,12,15,12,8,15,13,13,13,13,14,12,11,11,14,9,10,10,13,15,14,12,12,15,15,10,14,13,20,15,14,14,7,11,10,16,14,12,14,12,13,13,13,8,20,14,10,1,18,8,20,D RC,103,1,1,1,1,1,1,20,8,18,14,10,1,10,1,14,0.0,0,0,0,0,0,0,0,0,0,0,0,0,0,0,0,0,0,0,0,0,0,0,0,0,0,0,0,0,0,0,0,0,0,0,0,0,0,0,0,0,0,0,0,0,0,0,0,0,Calum Chambers,Â£12.60m ,25.0,182.0,Defender - Centre-Back,right,Arsenal FC,27.0,2.0,1.0,2430.0,25.0,0.0,0.0,1832.0,33.0,2.0,0.0,2766.0,18.0,1.0,4.0,1384.0,nan,nan,nan,nan,Premier League,15-07-16,17.3.2.23,Calum Chambers,29076103,765,20-Jan-95,21,3,0,14,0,5650,6700,6700,155,134,13524085,183,73,D RC,2,2,2,3,3,2,2,3,2,3,3,8,11,11,8,13,8,15,8,14,14,13,8,15,13,11,13,13,12,12,12,10,15,10,9,9,13,15,15,14,13,15,15,10,14,14,20,15,14,12,7,11,7,16,15,11,14,12,13,13,13,8,Calum Chambers,Â£12.60m ,Premier League
19-06-17,18.3.4.28,Joe Gomez,29115800,765,23-May-97,20,0,0,3,0,4600,6500,6500,163,142,42787941,188,87,D RLC,3,3,1,3,3,1,1,2,1,2,1,8,11,14,8,15,6,15,8,12,14,12,5,14,14,13,13,14,15,14,9,14,18,8,12,8,14,13,14,14,13,13,14,8,14,14,20,15,14,13,4,14,11,14,14,14,12,14,16,10,16,6,20,1,1,1,18,15,20,D RLC,106,1,1,1,1,1,1,20,15,18,1,1,1,1,1,1,4294967296.0,0,0,0,0,0,0,0,0,0,0,0,0,0,0,0,0,0,0,0,0,0,0,0,0,0,0,0,0,0,0,0,0,1,0,0,0,0,0,0,0,0,0,0,0,0,0,0,0,Joe Gomez,Â£19.80m ,23.0,188.0,Defender - Centre-Back,right,Liverpool FC,11.0,1.0,0.0,945.0,31.0,0.0,2.0,2463.0,26.0,0.0,0.0,1644.0,43.0,0.0,0.0,3319.0,8.0,0.0,0.0,619.0,Premier League,15-07-16,17.3.2.23,Joe Gomez,29115800,765,23-May-97,19,0,0,3,0,4350,5800,6300,169,129,24575936,188,87,D RLC,2,3,4,1,4,3,2,4,3,2,2,8,11,13,8,14,6,14,8,12,14,12,5,14,14,12,13,12,14,10,9,11,5,9,9,8,14,13,15,13,13,13,13,9,16,15,20,16,13,13,4,12,12,14,12,16,13,10,11,9,11,7,Joe Gomez,Â£3.60m ,Premier League
19-06-17,18.3.4.28,Kyle Walker-Peters,29126231,765,13-Apr-97,20,0,0,0,0,4300,6000,6000,129,120,12110110,174,64,D/WB RL,1,2,2,2,3,1,2,3,3,1,1,10,12,13,10,13,6,9,8,5,10,11,8,13,12,12,12,11,12,9,10,10,13,11,8,10,12,12,13,14,14,14,6,14,15,14,20,15,10,13,5,5,9,14,10,12,14,14,13,12,13,5,20,16,10,5,20,16,1,D/WB RL,115,1,1,11,1,5,1,1,16,20,1,1,10,1,11,16,0.0,0,0,0,0,0,0,0,0,0,0,0,0,0,0,0,0,0,0,0,0,0,0,0,0,0,0,0,0,0,0,0,0,0,0,0,0,0,0,0,0,0,0,0,0,0,0,0,0,Kyle Walker-Peters,Â£2.70m ,23.0,173.0,Defender - Right-Back,right,Southampton FC,21.0,2.0,0.0,1890.0,9.0,1.0,2.0,445.0,10.0,0.0,3.0,705.0,15.0,0.0,0.0,1123.0,7.0,0.0,1.0,630.0,Premier League,15-07-16,17.3.2.23,Kyle Walker-Peters,29126231,765,13-Apr-97,19,0,0,0,0,3600,5850,5850,160,110,6936416,168,63,D RL,3,1,3,2,2,2,1,1,3,1,3,10,13,14,11,13,6,9,8,5,9,6,8,12,12,12,12,11,12,9,10,10,18,12,8,9,12,12,12,17,15,13,5,14,15,15,20,11,10,13,5,5,11,13,14,10,10,11,11,13,13,5,Kyle Walker-Peters,Â£225Th. ,Premier League
19-06-17,18.3.4.28,Mason Holgate,29128167,765,22-Oct-96,20,0,0,6,0,4750,6600,6600,142,130,43591214,181,64,D RC,3,2,2,3,2,1,3,1,3,3,1,5,9,9,5,11,6,13,5,7,13,12,8,14,15,13,11,13,14,10,11,13,13,9,8,9,14,13,13,14,15,13,13,9,15,16,20,15,13,13,8,11,2,12,9,16,8,15,12,13,12,5,20,1,10,1,19,1,20,D RC,103,1,1,1,1,1,1,20,1,19,14,10,1,1,1,1,4294967296.0,0,0,0,0,0,0,0,0,0,0,0,0,0,0,0,0,0,0,0,0,0,0,0,0,0,0,0,0,0,0,0,0,1,0,0,0,0,0,0,0,0,0,0,0,0,0,0,0,Mason Holgate,Â£6.30m ,24.0,187.0,Defender - Centre-Back,right,Everton FC,28.0,0.0,1.0,2195.0,21.0,0.0,0.0,1722.0,30.0,1.0,4.0,2536.0,32.0,1.0,3.0,2503.0,nan,nan,nan,nan,Premier League,15-07-16,17.3.2.23,Mason Holgate,29128167,765,22-Oct-96,19,0,0,0,0,4247,6596,6596,141,133,37697874,181,76,D RC,3,1,1,2,1,1,2,2,1,3,2,5,9,13,5,10,6,13,5,7,13,13,8,14,15,13,12,13,14,13,10,13,13,9,8,9,14,13,13,14,15,13,12,9,15,16,20,15,13,13,8,12,8,11,18,16,8,15,12,13,12,5,Mason Holgate,Â£4.50m ,Premier League
19-06-17,18.3.4.28,Allan Nyom,34009070,11,10-May-88,29,16,0,0,0,5300,6000,6550,145,132,21189050,188,78,D R,3,2,3,1,1,2,1,2,4,1,2,5,10,12,6,10,5,12,6,12,14,12,7,15,12,13,13,17,13,10,9,12,16,10,9,14,11,15,15,14,12,12,14,5,16,16,20,18,17,11,13,15,5,10,14,14,15,14,16,12,13,12,20,14,1,1,20,14,14,D R,102,1,1,1,1,1,1,14,14,20,1,1,1,1,11,14,134217760.0,0,0,0,0,0,1,0,0,0,0,0,0,0,0,0,0,0,0,0,0,0,0,0,0,0,0,0,1,0,0,0,0,0,0,0,0,0,0,0,0,0,0,0,0,0,0,0,0,Allan Nyom,Â£4.05m ,32.0,189.0,Defender - Right-Back,right,Getafe CF,34.0,0.0,2.0,2802.0,34.0,0.0,1.0,2758.0,27.0,1.0,2.0,1986.0,44.0,2.0,1.0,3245.0,6.0,0.0,1.0,510.0,Premier League,15-07-16,17.3.2.23,Allan Nyom,34009070,11,10-May-88,28,14,0,0,0,5376,5579,6550,145,131,11053028,188,78,D R,1,3,1,2,2,2,3,3,3,3,3,5,10,13,6,10,5,12,6,12,15,12,7,15,12,13,13,17,13,10,9,12,16,10,9,14,11,15,15,14,12,12,14,5,16,15,20,18,17,11,13,15,5,10,14,14,15,14,16,12,13,12,Allan Nyom,Â£4.05m ,Premier League
19-06-17,18.3.4.28,Cuco Martina,37013420,380,25-Sep-89,27,25,0,0,0,4750,5550,6300,124,123,14107580,183,78,D/WB RLC,3,1,2,3,3,3,1,1,1,1,1,10,13,9,6,11,9,12,9,12,10,10,6,13,13,9,11,13,11,10,11,11,11,9,10,12,10,12,12,13,15,12,13,10,12,11,20,14,13,12,7,9,7,13,13,9,8,11,13,12,17,7,20,18,12,1,20,16,16,D/WB RLC,116,1,1,1,1,1,1,16,16,20,14,10,1,12,12,18,17179869184.0,0,0,0,0,0,0,0,0,0,0,0,0,0,0,0,0,0,0,0,0,0,0,0,0,0,0,0,0,0,0,0,0,0,0,1,0,0,0,0,0,0,0,0,0,0,0,0,0,Cuco Martina,Â£2.25m ,31.0,185.0,Defender - Right-Back,right,Without Club,20.0,0.0,1.0,1581.0,28.0,0.0,2.0,2413.0,31.0,0.0,1.0,2652.0,1.0,0.0,0.0,90.0,nan,nan,nan,nan,Premier League,15-07-16,17.3.2.23,Cuco Martina,37013420,380,25-Sep-89,26,24,0,0,0,4657,5560,5549,124,124,864614,183,78,D/WB RC,3,2,4,1,1,4,2,1,4,1,1,10,12,9,6,11,9,12,10,12,13,10,7,13,12,9,11,13,11,11,11,12,11,9,10,12,13,12,13,11,15,10,13,10,12,11,20,14,13,13,5,9,7,13,13,11,8,14,13,12,11,2,Cuco Martina,Â£1.80m ,Premier League
19-06-17,18.3.4.28,Timothy Fosu-Mensah,37051102,784,02-Jan-98,19,0,0,1,0,5350,6500,6700,153,130,21792868,190,0,D/DM/M RC,3,2,3,1,1,1,2,1,3,4,3,8,7,9,6,12,7,11,8,8,11,11,8,14,13,14,12,14,10,11,7,11,16,7,6,10,12,12,14,16,13,13,15,10,14,15,20,14,15,12,6,12,4,8,8,16,12,11,8,16,18,6,19,1,20,5,18,14,20,D/DM/M RC,433,1,1,1,5,1,1,19,14,18,19,20,1,1,1,1,0.0,0,0,0,0,0,0,0,0,0,0,0,0,0,0,0,0,0,0,0,0,0,0,0,0,0,0,0,0,0,0,0,0,0,0,0,0,0,0,0,0,0,0,0,0,0,0,0,0,Timothy Fosu-Mensah,Â£6.30m ,22.0,190.0,Defender - Right-Back,right,Manchester United,11.0,0.0,0.0,323.0,24.0,0.0,0.0,1818.0,13.0,0.0,0.0,884.0,8.0,0.0,0.0,441.0,1.0,0.0,0.0,81.0,Premier League
19-06-17,18.3.4.28,Ezequiel Schelotto,43048983,1649,23-May-89,28,0,0,0,0,5000,6350,6250,146,134,15366551,187,79,D/WB/M/AM R,1,3,3,3,1,1,1,3,3,3,1,7,12,11,8,8,7,11,8,13,10,11,5,11,11,17,10,14,11,11,9,13,19,13,10,13,11,14,16,15,14,14,14,8,17,16,20,15,14,13,11,14,5,16,17,18,11,6,15,13,10,6,20,18,17,19,20,13,1,D/WB/M/AM R,132,1,1,1,1,13,19,1,1,20,1,1,13,17,11,18,1099510000000.0,0,1,0,0,0,0,1,0,0,0,0,0,0,0,0,0,0,0,0,0,0,0,0,0,0,0,0,0,0,0,0,0,0,0,0,0,0,0,0,0,1,0,0,0,0,0,0,0,Ezequiel Schelotto,Â£4.05m ,31.0,187.0,Defender - Right-Back,right,Without Club,26.0,0.0,5.0,2148.0,24.0,0.0,1.0,1690.0,4.0,0.0,0.0,143.0,9.0,0.0,0.0,451.0,nan,nan,nan,nan,Premier League,15-07-16,17.3.2.23,Ezequiel Schelotto,43048983,776,23-May-89,27,1,0,7,0,5000,6350,7000,146,140,16804781,187,79,D/WB/M/AM R,2,4,4,2,1,3,3,4,3,3,2,7,12,11,12,8,7,11,8,13,11,11,5,11,12,17,10,15,12,12,9,13,19,13,10,14,11,14,16,15,14,15,14,10,17,16,20,15,14,13,11,14,5,16,17,18,11,6,15,13,10,6,Ezequiel Schelotto,Â£4.05m ,Liga NOS
19-06-17,18.3.4.28,Davide Zappacosta,43061433,776,11-Jun-92,25,4,0,17,0,4750,7000,7000,149,140,31417335,182,72,D/WB/M R,4,1,2,1,2,3,2,1,1,3,1,10,14,14,9,12,9,10,9,10,13,13,7,14,13,11,13,14,13,13,11,13,14,10,9,15,14,14,14,15,13,14,12,7,14,15,20,15,13,16,6,13,6,14,13,15,14,14,13,14,13,4,20,19,18,9,20,9,1,D/WB/M R,122,1,1,1,1,1,9,1,9,20,1,1,1,18,8,19,34.0,0,1,0,0,0,1,0,0,0,0,0,0,0,0,0,0,0,0,0,0,0,0,0,0,0,0,0,0,0,0,0,0,0,0,0,0,0,0,0,0,0,0,0,0,0,0,0,0,Davide Zappacosta,Â£18.00m ,28.0,182.0,Defender - Right-Back,right,Genoa CFC,29.0,1.0,4.0,2333.0,38.0,2.0,2.0,2305.0,17.0,0.0,2.0,1020.0,9.0,0.0,1.0,446.0,2.0,1.0,0.0,166.0,Premier League,15-07-16,17.3.2.23,Davide Zappacosta,43061433,776,11-Jun-92,24,0,0,17,0,4850,7100,6800,145,137,17741216,182,70,D/WB/M R,2,3,3,3,4,1,2,3,3,1,1,10,14,14,9,12,9,10,8,10,13,13,7,14,13,11,13,14,13,12,10,13,14,10,9,14,12,13,14,14,13,13,11,7,14,15,20,15,13,16,6,13,6,14,13,15,13,14,13,14,13,4,Davide Zappacosta,Â£7.65m ,Serie A
19-06-17,18.3.4.28,Victor Moses,5007466,38,12-Dec-90,26,27,9,0,0,6500,6950,7250,146,146,48063215,177,77,WB/M R,2,3,4,2,2,2,2,3,4,3,3,8,10,14,11,12,9,10,11,16,4,13,9,12,12,11,10,9,12,8,9,15,8,13,6,11,14,13,18,16,13,14,8,13,10,15,20,16,18,8,10,12,13,14,11,12,12,11,11,8,12,7,1,20,17,15,20,14,14,WB/M R,212,1,1,13,14,14,15,1,1,1,1,1,14,17,1,20,2252350000000000.0,0,0,0,0,1,0,0,0,0,1,0,0,0,0,0,0,0,0,0,0,0,0,0,0,0,0,0,1,0,0,0,0,0,0,0,0,0,0,0,1,0,0,0,0,0,0,0,0,Victor Moses,Â£18.00m ,29.0,177.0,Midfielder - Right Midfield,right,Spartak Moscow,40.0,4.0,4.0,3045.0,38.0,4.0,4.0,3038.0,22.0,4.0,1.0,1250.0,27.0,1.0,6.0,1243.0,2.0,1.0,0.0,102.0,Premier League,15-07-16,17.3.2.23,Victor Moses,5007466,38,12-Dec-90,25,24,7,0,0,6500,6950,7250,146,146,39882628,177,75,WB/M/AM RL,2,2,1,3,3,2,3,1,2,3,2,8,10,14,11,12,9,10,11,16,4,13,9,9,12,11,10,9,12,8,9,12,8,13,6,11,10,10,16,17,14,12,8,13,10,16,20,12,15,8,10,12,13,14,11,12,12,11,11,8,12,7,Victor Moses,Â£16.20m ,Premier League
19-06-17,18.3.4.28,Phil Bardsley,5107572,793,28-Jun-85,31,13,0,0,0,4600,6500,6500,132,132,13836614,180,74,D RL,3,2,1,2,1,4,3,3,1,4,3,13,12,11,9,12,8,13,14,13,15,11,6,16,11,18,14,17,10,16,6,14,8,8,15,12,15,15,14,12,12,13,10,5,8,11,20,16,13,10,13,10,12,7,7,10,14,8,8,6,7,15,20,7,3,1,20,17,5,D RL,105,1,1,1,1,1,1,5,17,20,3,1,1,3,1,7,17179869952.0,0,0,0,0,0,0,0,0,1,1,0,0,0,0,0,0,0,0,0,0,0,0,0,0,0,0,0,0,0,0,0,0,0,0,1,0,0,0,0,0,0,0,0,0,0,0,0,0,Phil Bardsley,Â£1.35m ,35.0,180.0,Defender - Right-Back,right,Burnley FC,17.0,1.0,0.0,1350.0,15.0,0.0,0.0,1335.0,23.0,0.0,0.0,2092.0,22.0,0.0,1.0,1968.0,4.0,0.0,0.0,281.0,Premier League,15-07-16,17.3.2.23,Phil Bardsley,5107572,793,28-Jun-85,31,13,0,0,0,4248,6248,6248,131,126,1049267,180,74,D RL,3,3,3,3,3,1,3,1,2,4,1,13,12,12,9,10,8,12,14,13,14,11,6,15,10,17,14,16,10,14,6,14,8,8,10,12,11,12,13,14,12,13,9,5,8,12,20,17,13,10,15,10,13,7,7,10,14,8,8,6,7,15,Phil Bardsley,Â£1.35m ,Premier League
19-06-17,18.3.4.28,Glen Johnson,5112082,765,23-Aug-84,32,54,1,14,0,5300,6150,6150,156,123,1390128,182,70,D/WB R,3,3,1,3,2,3,1,2,2,1,1,3,13,13,10,13,8,13,12,6,13,10,12,14,15,11,13,13,14,12,13,11,13,12,7,13,11,14,14,12,15,16,13,15,15,11,20,7,12,12,7,13,13,15,15,15,15,12,15,16,14,5,20,17,14,13,20,14,12,D/WB R,112,1,1,1,1,1,13,12,14,20,1,1,1,14,14,17,549756000000.0,0,1,0,0,0,0,0,0,0,0,0,0,0,0,0,0,0,0,0,0,0,0,0,0,0,0,0,0,0,0,0,0,0,0,0,0,0,0,0,1,0,0,0,0,0,0,0,0,Glen Johnson,Â£2.25m ,36.0,182.0,Defender - Right-Back,both,Retired,25.0,0.0,0.0,2135.0,10.0,0.0,0.0,639.0,nan,nan,nan,nan,nan,nan,nan,nan,nan,nan,nan,nan,Premier League,15-07-16,17.3.2.23,Glen Johnson,5112082,765,23-Aug-84,31,54,1,14,0,5500,6800,7000,156,140,232186002,182,70,D R,3,2,3,2,1,4,1,3,3,1,3,3,13,13,10,13,8,13,12,6,13,10,12,14,15,11,14,13,14,13,13,12,13,12,7,13,12,14,14,12,15,16,13,15,15,12,20,15,15,12,7,13,13,15,15,15,15,12,15,16,14,5,Glen Johnson,Â£4.50m ,Premier League
19-06-17,18.3.4.28,Liam Rosenior,5112276,765,09-Jul-84,32,0,0,7,0,4500,6250,6250,136,125,3672795,178,73,D/WB/M RL,2,3,1,1,3,3,3,1,3,2,3,9,10,10,6,11,6,8,6,12,14,12,7,13,11,11,13,13,11,13,11,12,15,11,15,11,13,16,17,13,11,10,10,12,17,12,20,15,12,16,10,15,13,14,15,18,8,14,18,16,13,14,20,18,17,1,20,15,6,D/WB/M RL,125,1,1,1,1,1,1,6,15,20,1,1,1,17,13,18,1099650000000.0,0,0,0,0,0,1,0,0,0,0,0,0,0,0,0,0,0,0,0,0,0,0,0,0,0,0,0,1,0,0,0,0,0,0,0,0,0,0,0,0,1,0,0,0,0,0,0,0,Liam Rosenior,Â£900Th. ,36.0,178.0,Defender - Right-Back,right,Retired,12.0,0.0,1.0,926.0,8.0,0.0,0.0,632.0,nan,nan,nan,nan,nan,nan,nan,nan,nan,nan,nan,nan,Premier League
19-06-17,18.3.4.28,Simon Francis,5112466,765,16-Feb-85,32,0,0,0,0,4750,6700,6950,145,132,232186002,188,90,D RC,2,1,3,2,1,3,3,2,3,2,2,10,15,11,6,13,5,14,9,10,14,13,6,15,13,9,14,12,13,12,10,12,13,4,15,11,14,13,15,14,10,14,12,9,15,11,20,15,15,14,3,13,2,14,12,14,13,11,15,15,14,2,20,13,1,1,20,1,20,D RC,103,1,1,1,1,1,1,20,1,20,1,1,1,1,1,13,9895600000000.0,0,0,0,0,0,1,0,0,0,0,0,1,0,0,0,0,0,0,0,0,0,0,0,0,0,0,0,0,0,0,0,0,0,0,0,0,0,0,0,0,1,0,0,1,0,0,0,0,Simon Francis,Â£2.25m ,35.0,191.0,Defender - Right-Back,right,Without Club,35.0,0.0,2.0,3030.0,34.0,0.0,1.0,2916.0,20.0,0.0,3.0,1492.0,18.0,0.0,1.0,1130.0,nan,nan,nan,nan,Premier League,15-07-16,17.3.2.23,Simon Francis,5112466,765,16-Feb-85,31,0,0,0,0,4750,6700,6950,145,139,232186002,188,90,D RC,2,2,2,2,4,1,3,1,2,1,1,10,15,11,6,13,5,16,9,10,14,14,6,15,13,9,15,12,13,12,10,12,13,4,15,11,14,13,15,14,10,14,12,9,15,15,20,16,15,15,3,13,2,14,12,14,13,11,15,15,14,2,Simon Francis,Â£2.25m ,Premier League
19-06-17,18.3.4.28,Ashley Young,5113149,765,09-Jul-85,31,30,7,10,0,6100,6750,6750,155,143,232186002,175,65,D/M RL,2,3,2,1,2,2,1,3,1,2,2,14,15,12,10,14,14,5,13,3,9,12,12,11,13,7,11,6,10,14,9,13,12,14,10,13,12,15,16,14,15,12,7,9,15,15,20,15,10,12,8,15,5,13,18,12,8,12,13,4,14,4,20,15,18,15,18,20,14,D/M RL,115,1,1,12,14,15,13,1,20,18,1,1,18,14,15,15,70918500000000.0,1,0,0,0,0,0,0,0,0,0,1,1,0,0,0,0,0,0,0,0,0,0,0,0,0,0,0,0,0,0,0,0,0,0,0,0,0,0,0,1,0,0,0,0,0,0,1,0,Ashley Young,Â£6.30m ,35.0,175.0,Midfielder - Left Midfield,both,Inter Milan,23.0,0.0,1.0,1469.0,39.0,2.0,7.0,3156.0,41.0,2.0,3.0,3509.0,43.0,5.0,6.0,3005.0,3.0,0.0,1.0,152.0,Premier League,15-07-16,17.3.2.23,Ashley Young,5113149,765,09-Jul-85,31,30,7,10,0,6100,6750,6750,155,138,2684630,175,65,M/AM RL,3,3,4,2,1,1,3,3,2,3,2,14,14,12,10,14,12,5,13,3,9,12,12,10,13,7,11,6,9,14,9,13,12,14,5,13,12,13,16,15,15,12,7,9,15,15,20,14,10,12,8,15,5,13,18,12,8,12,13,4,14,4,Ashley Young,Â£4.50m ,Premier League
19-06-17,18.3.4.28,Danny Simpson,5116936,765,04-Jan-87,30,0,0,0,0,5300,6800,6800,139,134,232186002,176,77,D R,1,1,1,1,1,1,1,1,1,1,1,8,9,12,6,12,1,15,6,8,12,10,6,15,10,15,15,15,12,15,9,14,13,7,4,10,15,15,14,14,12,13,7,14,15,14,20,15,14,13,14,13,5,7,15,11,12,11,14,13,13,6,20,12,5,1,20,13,10,D R,102,1,1,1,1,1,1,10,13,20,1,1,1,5,1,12,8589934592.0,0,0,0,0,0,0,0,0,0,0,0,0,0,0,0,0,0,0,0,0,0,0,0,0,0,0,0,0,0,0,0,0,0,1,0,0,0,0,0,0,0,0,0,0,0,0,0,0,Danny Simpson,Â£4.50m ,33.0,176.0,Defender - Right-Back,right,Without Club,45.0,0.0,2.0,3893.0,31.0,0.0,0.0,2597.0,13.0,0.0,0.0,907.0,25.0,0.0,0.0,2083.0,nan,nan,nan,nan,Premier League,15-07-16,17.3.2.23,Danny Simpson,5116936,765,04-Jan-87,29,0,0,0,0,5294,6794,6794,139,137,12881184,173,77,D R,1,1,1,1,1,1,1,1,1,1,1,8,9,12,6,12,1,15,6,8,12,10,6,15,10,15,15,15,12,15,9,13,13,7,4,10,15,15,15,15,13,13,7,14,15,15,20,15,14,13,14,13,5,7,7,11,12,11,14,13,13,6,Danny Simpson,Â£4.50m ,Premier League
19-06-17,18.3.4.28,James Tomkins,5129541,765,29-Mar-89,28,0,0,10,0,5500,6700,6700,138,134,29696861,191,79,D RC,3,2,1,2,1,3,2,1,1,4,1,6,4,11,4,9,4,16,4,6,14,10,2,15,10,12,13,16,15,11,6,13,13,4,14,8,14,18,16,13,11,14,16,10,15,13,20,13,14,13,7,15,11,14,10,15,13,11,14,18,17,5,20,1,1,1,15,1,20,D RC,103,1,1,1,1,1,1,20,1,15,12,1,1,1,1,1,0.0,0,0,0,0,0,0,0,0,0,0,0,0,0,0,0,0,0,0,0,0,0,0,0,0,0,0,0,0,0,0,0,0,0,0,0,0,0,0,0,0,0,0,0,0,0,0,0,0,James Tomkins,Â£7.20m ,31.0,192.0,Defender - Centre-Back,right,Crystal Palace,27.0,3.0,0.0,2184.0,30.0,3.0,0.0,2568.0,30.0,1.0,1.0,2653.0,19.0,1.0,1.0,1603.0,nan,nan,nan,nan,Premier League,15-07-16,17.3.2.23,James Tomkins,5129541,765,29-Mar-89,27,0,0,10,0,5500,6700,6700,138,134,21541066,191,79,D RC,1,2,3,3,2,3,3,3,2,2,1,6,4,11,4,9,4,16,4,6,14,10,2,15,10,12,13,16,15,11,6,13,13,4,14,8,14,18,16,13,11,14,16,10,15,13,20,13,14,13,7,15,11,14,10,15,13,11,14,18,17,5,James Tomkins,Â£6.30m ,Premier League
19-06-17,18.3.4.28,Mame Diouf,53016763,41,01-Dec-87,29,37,10,18,7,6400,6500,6750,151,133,34394597,185,77,D/WB/M/AM RLC,1,2,3,1,2,3,3,2,1,3,3,6,8,10,10,11,6,12,9,5,6,8,10,7,12,16,14,17,11,12,8,10,15,12,6,16,6,13,15,14,15,12,14,14,18,14,20,15,13,13,15,13,10,10,14,17,7,13,14,7,10,12,16,17,17,20,20,15,17,D/WB/M/AM RLC,546,1,1,14,17,15,20,1,1,16,1,1,14,17,1,17,8392704.0,0,0,0,0,0,0,0,0,0,0,0,0,1,0,0,0,0,0,0,0,0,0,0,1,0,0,0,0,0,0,0,0,0,0,0,0,0,0,0,0,0,0,0,0,0,0,0,0,Mame Diouf,Â£6.30m ,32.0,185.0,Forward - Centre-Forward,right,Hatayspor,29.0,1.0,2.0,1493.0,37.0,6.0,3.0,2701.0,18.0,2.0,2.0,878.0,11.0,2.0,0.0,292.0,4.0,1.0,1.0,283.0,Premier League,15-07-16,17.3.2.23,Mame Diouf,53016763,41,01-Dec-87,28,36,9,18,7,6750,6500,7250,151,139,42748992,185,77,M/AM/S RLC,1,1,3,1,2,1,2,2,3,1,2,6,8,10,10,11,6,12,9,5,6,8,10,7,12,16,14,17,11,12,8,10,15,12,6,16,6,13,15,15,15,12,14,14,18,16,20,15,14,13,15,13,10,10,14,17,7,13,14,7,10,12,Mame Diouf,Â£6.30m ,Premier League
19-06-17,18.3.4.28,CÃ©dric,55012984,788,31-Aug-91,25,17,0,10,0,5600,7000,6850,148,140,29741989,172,66,D/WB R,2,4,3,3,1,1,4,3,2,3,2,9,13,12,7,13,8,6,10,10,11,12,12,14,13,14,14,14,11,14,13,14,14,13,11,13,14,13,13,17,13,14,6,9,14,17,20,15,7,13,8,11,8,10,16,12,14,13,17,15,15,5,20,17,12,10,20,1,1,D/WB R,112,1,1,1,1,1,10,1,1,20,1,1,1,12,1,17,2.0,0,1,0,0,0,0,0,0,0,0,0,0,0,0,0,0,0,0,0,0,0,0,0,0,0,0,0,0,0,0,0,0,0,0,0,0,0,0,0,0,0,0,0,0,0,0,0,0,nan,nan,nan,nan,nan,nan,nan,nan,nan,nan,nan,nan,nan,nan,nan,nan,nan,nan,nan,nan,nan,nan,nan,nan,nan,nan,nan,nan,15-07-16,17.3.2.23,CÃ©dric,55012984,788,31-Aug-91,24,15,0,10,0,5600,7000,6850,145,141,23820447,172,66,D/WB R,3,1,3,1,2,1,2,1,4,1,3,9,13,13,7,13,8,6,10,10,11,12,12,14,13,14,14,14,11,14,13,12,14,13,11,13,13,13,13,17,14,14,6,9,14,17,20,15,8,13,8,11,8,10,16,12,14,13,17,15,15,5,nan,nan,nan
19-06-17,18.3.4.28,Seamus Coleman,56001681,789,11-Oct-88,28,43,1,13,1,6200,7450,7650,153,145,83420492,178,67,D/WB/M R,1,3,2,3,2,4,3,2,1,2,4,5,13,14,12,12,8,14,13,12,12,12,7,14,12,16,12,15,13,13,9,13,18,11,15,13,13,16,17,15,12,14,10,9,14,14,20,17,14,14,11,12,7,10,10,13,18,12,15,15,14,7,20,20,17,5,20,10,1,D/WB/M R,122,1,1,1,1,1,5,1,10,20,1,1,1,17,1,20,2199020000000.0,0,1,0,0,0,1,0,0,0,1,0,0,0,0,0,0,0,0,0,0,1,0,0,0,0,0,0,0,0,0,0,0,0,0,0,0,0,0,0,0,0,1,0,0,0,0,0,0,Seamus Coleman,Â£10.80m ,32.0,177.0,Defender - Right-Back,right,Everton FC,28.0,4.0,4.0,2497.0,12.0,0.0,1.0,1035.0,30.0,2.0,2.0,2650.0,30.0,0.0,1.0,2082.0,6.0,0.0,1.0,407.0,Premier League,15-07-16,17.3.2.23,Seamus Coleman,56001681,789,11-Oct-88,27,38,0,13,1,6200,7450,7650,153,144,67552618,178,67,D/WB/M R,2,1,1,1,2,3,2,4,1,2,1,5,13,14,10,12,8,14,13,12,12,12,7,14,12,14,14,15,13,13,8,13,16,11,10,13,13,15,15,15,12,15,10,9,14,14,20,17,14,12,11,12,7,10,10,13,18,12,15,15,12,7,Seamus Coleman,Â£15.30m ,Premier League
19-06-17,18.3.4.28,CÃ©sar Azpilicueta,67033300,796,28-Aug-89,27,19,0,22,1,6750,7750,8000,165,161,162130533,178,76,D/WB RLC,1,4,3,1,3,3,1,2,1,3,1,8,13,9,6,11,7,9,10,11,14,10,8,16,13,12,15,16,14,15,11,15,16,8,15,12,15,17,20,14,14,12,9,15,17,14,20,18,10,19,12,15,5,16,12,14,18,16,18,15,12,6,20,16,1,1,20,19,18,D/WB RLC,116,1,1,1,1,1,1,18,19,20,1,1,1,1,16,15,1.15292e+18,0,0,0,0,0,0,0,0,0,0,0,0,0,0,0,0,0,0,0,0,0,0,0,0,0,0,0,0,0,0,0,0,0,0,0,0,0,0,0,0,0,0,0,0,0,0,0,0,CÃ©sar Azpilicueta,Â£36.00m ,31.0,178.0,Defender - Right-Back,right,Chelsea FC,47.0,2.0,7.0,4098.0,52.0,3.0,7.0,4755.0,57.0,1.0,9.0,4867.0,49.0,4.0,7.0,4312.0,7.0,0.0,1.0,499.0,Premier League,15-07-16,17.3.2.23,CÃ©sar Azpilicueta,67033300,796,28-Aug-89,26,16,0,22,1,6750,7750,8000,165,160,95721509,178,78,D/WB RLC,1,2,3,2,3,3,2,1,1,3,1,8,10,10,6,11,7,9,10,11,14,10,8,16,13,12,15,16,14,15,9,15,16,8,13,12,15,17,20,15,14,12,9,15,17,15,20,20,9,19,12,15,5,16,12,14,18,16,18,15,12,6,CÃ©sar Azpilicueta,Â£27.00m ,Premier League
19-06-17,18.3.4.28,Kiko FemenÃ­a,67063051,796,02-Feb-91,26,0,0,1,0,5508,6260,7000,141,140,20698920,173,71,D/WB/M/AM RL,2,4,1,2,1,3,2,1,3,3,3,10,11,12,9,11,9,7,9,14,8,12,11,11,13,9,12,14,10,12,10,10,9,13,9,12,10,12,13,17,12,10,7,10,14,17,20,13,9,13,6,11,6,16,12,12,13,8,14,16,7,11,20,19,18,18,20,16,1,D/WB/M/AM RL,135,1,1,1,1,16,18,1,6,20,1,1,12,18,9,19,2.0,0,1,0,0,0,0,0,0,0,0,0,0,0,0,0,0,0,0,0,0,0,0,0,0,0,0,0,0,0,0,0,0,0,0,0,0,0,0,0,0,0,0,0,0,0,0,0,0,Kiko FemenÃ­a,Â£4.50m ,29.0,171.0,Defender - Right-Back,right,Watford FC,37.0,0.0,2.0,2986.0,23.0,1.0,0.0,1716.0,34.0,1.0,2.0,2491.0,29.0,0.0,1.0,2331.0,4.0,0.0,1.0,305.0,Premier League,15-07-16,17.3.2.23,Kiko FemenÃ­a,67063051,796,02-Feb-91,25,0,0,1,0,4200,6250,6250,131,126,3545045,173,71,D/WB/M/AM RL,2,1,3,1,1,3,1,1,2,2,2,10,12,13,9,11,9,7,10,14,8,13,11,11,13,9,12,13,11,12,11,12,9,13,9,13,10,13,13,14,12,10,7,10,14,14,20,13,8,13,6,11,6,16,16,12,13,8,14,16,7,11,Kiko FemenÃ­a,Â£3.60m ,LaLiga
19-06-17,18.3.4.28,Javi Manquillo,67141802,796,05-May-94,23,0,0,4,0,5250,6500,6550,135,126,25745477,180,63,D/WB R,3,4,2,1,1,3,1,3,3,1,2,5,12,12,5,12,7,8,8,12,13,11,7,13,12,13,13,13,14,14,9,13,16,11,9,13,14,14,15,13,14,9,11,8,12,14,20,15,11,12,7,12,8,13,8,14,15,11,15,11,13,2,20,19,13,10,20,9,1,D/WB R,112,1,1,1,1,1,10,1,9,20,1,1,1,13,7,19,32800.0,0,0,0,0,0,1,0,0,0,0,0,0,0,0,0,1,0,0,0,0,0,0,0,0,0,0,0,0,0,0,0,0,0,0,0,0,0,0,0,0,0,0,0,0,0,0,0,0,Javier Manquillo,Â£4.50m ,26.0,178.0,Defender - Right-Back,right,Newcastle United,22.0,1.0,0.0,1607.0,23.0,0.0,1.0,1926.0,21.0,0.0,3.0,1396.0,24.0,0.0,1.0,1819.0,6.0,0.0,0.0,485.0,Premier League,15-07-16,17.3.2.23,Javi Manquillo,67141802,796,05-May-94,22,0,0,4,0,5000,6500,6550,144,126,3788703,180,63,D/WB R,2,2,1,1,2,2,2,1,1,1,1,5,12,9,5,12,7,6,7,12,13,10,5,14,12,14,14,13,14,14,9,13,16,11,9,13,14,14,15,14,14,9,10,8,12,15,20,14,11,15,7,12,8,11,19,14,15,10,15,11,10,7,Javier Manquillo,Â£3.60m ,Premier League
19-06-17,18.3.4.28,Geoff Cameron,72006682,390,11-Jul-85,31,55,4,0,0,4700,6750,6500,137,129,232186002,191,84,D/DM/M RC,3,1,1,3,3,3,3,1,1,3,1,9,10,12,10,11,9,12,9,15,13,11,13,13,9,11,13,11,12,14,10,13,15,12,10,13,12,12,14,12,12,12,13,11,15,11,20,13,13,13,1,12,11,19,16,14,7,12,14,14,15,3,18,5,20,1,18,8,20,D/DM/M RC,433,1,1,1,1,1,1,18,8,18,18,20,1,15,1,5,274878000000.0,0,0,0,1,0,1,0,0,0,0,0,0,0,0,1,0,0,0,0,0,0,0,0,0,0,0,0,0,0,0,0,0,0,0,0,0,0,0,1,0,0,0,0,0,0,0,0,0,Geoff Cameron,Â£2.25m ,35.0,190.0,Midfielder - Defensive Midfield,right,Queens Park Rangers,21.0,0.0,2.0,1808.0,21.0,0.0,0.0,1576.0,19.0,1.0,1.0,1391.0,37.0,1.0,1.0,3147.0,7.0,0.0,0.0,630.0,Premier League,15-07-16,17.3.2.23,Geoff Cameron,72006682,390,11-Jul-85,31,40,4,0,0,4246,6296,6646,137,132,8422328,191,84,D/DM/M RC,3,1,2,2,2,1,1,3,3,3,1,9,10,12,10,11,9,12,9,15,13,12,13,13,9,11,13,11,12,14,10,13,15,12,10,13,13,13,14,12,12,12,13,11,15,12,20,13,13,13,1,12,9,19,16,14,7,12,14,14,15,3,Geoff Cameron,Â£2.70m ,Premier League
19-06-17,18.3.4.28,DeAndre Yedlin,72038776,390,09-Jul-93,23,46,0,4,0,5250,6500,6700,144,134,35265023,173,73,D/WB R,2,3,3,1,3,2,3,1,1,3,2,8,11,12,6,11,6,10,4,8,10,10,4,13,10,11,10,12,10,11,10,11,12,10,6,11,9,15,15,19,15,11,12,8,14,19,20,14,11,13,7,11,5,10,13,15,11,10,12,12,13,4,20,20,7,7,20,1,1,D/WB R,112,1,1,1,1,1,7,1,1,20,1,1,1,7,1,20,1048610.0,0,1,0,0,0,1,0,0,0,0,0,0,0,0,0,0,0,0,0,0,1,0,0,0,0,0,0,0,0,0,0,0,0,0,0,0,0,0,0,0,0,0,0,0,0,0,0,0,DeAndre Yedlin,Â£7.20m ,27.0,173.0,Defender - Right-Back,right,Newcastle United,32.0,1.0,6.0,2277.0,34.0,0.0,2.0,2842.0,29.0,1.0,2.0,2475.0,20.0,1.0,0.0,1250.0,2.0,0.0,1.0,180.0,Premier League
19-06-17,18.3.4.28,Ãngel Rangel,7448186,796,28-Oct-82,34,0,0,0,0,5100,6000,6250,133,120,1058613,180,81,D/WB R,2,2,3,2,1,1,3,2,1,3,1,8,12,14,11,13,7,11,11,11,13,12,6,15,12,15,12,14,14,13,13,12,14,11,14,15,13,17,16,10,10,13,11,11,13,10,20,11,14,15,11,15,8,12,20,15,18,14,14,12,12,2,20,19,1,1,20,10,1,D/WB R,112,1,1,1,1,1,1,1,10,20,1,1,1,1,1,19,1048608.0,0,0,0,0,0,1,0,0,0,0,0,0,0,0,0,0,0,0,0,0,1,0,0,0,0,0,0,0,0,0,0,0,0,0,0,0,0,0,0,0,0,0,0,0,0,0,0,0,Ãngel Rangel,Â£900Th. ,37.0,188.0,Defender - Right-Back,right,Without Club,21.0,1.0,0.0,1026.0,7.0,0.0,1.0,425.0,20.0,2.0,2.0,1736.0,21.0,0.0,0.0,1663.0,nan,nan,nan,nan,Premier League
19-06-17,18.3.4.28,Matteo Darmian,7990060,776,02-Dec-89,27,30,1,1,0,6300,7400,7250,150,140,27211362,183,70,D/WB RL,2,3,2,2,3,3,1,1,2,3,1,4,9,7,7,13,4,14,4,10,15,12,4,17,13,12,13,14,13,13,6,13,13,5,10,9,13,14,15,13,14,14,11,11,17,14,20,15,14,15,13,13,7,18,10,14,15,15,15,18,18,8,20,19,13,1,20,18,14,D/WB RL,115,1,1,1,1,1,1,14,18,20,1,1,10,13,17,19,137439000000.0,0,1,0,0,0,0,0,0,0,0,0,0,0,0,0,0,0,0,0,0,0,0,0,0,0,0,0,0,0,0,0,0,0,0,0,0,0,1,0,0,0,0,0,0,0,0,0,0,Matteo Darmian,Â£9.00m ,30.0,183.0,Defender - Right-Back,right,Inter Milan,29.0,0.0,1.0,2322.0,17.0,0.0,2.0,1105.0,7.0,0.0,0.0,533.0,34.0,1.0,1.0,2685.0,5.0,0.0,0.0,377.0,Premier League,15-07-16,17.3.2.23,Matteo Darmian,7990060,776,02-Dec-89,26,26,1,1,0,6300,7500,7200,150,142,28523556,183,70,D/WB RL,3,3,2,2,1,1,2,2,3,3,1,4,10,10,7,13,4,14,4,10,14,13,4,17,13,12,13,14,13,13,9,13,13,5,10,10,13,14,15,13,14,14,11,11,17,14,20,15,14,15,13,13,7,18,10,14,15,15,15,18,18,8,Matteo Darmian,Â£10.80m ,Premier League
19-06-17,18.3.4.28,Bruno,814310,796,01-Oct-80,36,0,0,0,0,4250,6550,6750,139,131,232186002,181,76,D/WB R,1,3,2,2,1,1,1,2,1,3,1,8,11,11,7,15,8,11,9,16,11,13,9,12,15,15,14,13,14,13,9,14,14,14,16,11,14,14,15,12,10,10,10,10,20,13,20,15,13,17,14,14,5,15,18,12,15,14,20,11,12,9,20,17,14,1,20,11,14,D/WB R,112,1,1,1,1,1,1,14,11,20,12,14,1,13,8,17,292058000000.0,0,0,0,0,0,1,1,0,0,0,0,0,0,0,0,0,0,0,0,0,0,0,0,0,0,0,0,0,0,0,0,0,0,0,1,0,0,0,1,0,0,0,0,0,0,0,0,0,Bruno,Â£675Th. ,40.0,180.0,Defender - Right-Back,right,Retired,42.0,0.0,5.0,3719.0,26.0,0.0,1.0,2107.0,18.0,0.0,1.0,1537.0,nan,nan,nan,nan,nan,nan,nan,nan,Premier League,15-07-16,17.3.2.23,Bruno,67107164,796,24-May-90,26,0,0,0,0,4250,6500,6500,140,130,4763390,184,82,D C,2,1,2,4,2,1,2,1,2,1,2,4,12,6,6,10,5,14,8,10,15,9,6,14,8,14,15,15,12,14,6,13,15,6,12,9,14,12,15,13,12,11,13,7,14,13,20,14,15,14,11,12,5,11,17,14,11,12,15,13,12,6,nan,nan,nan
19-06-17,18.3.4.28,Toby Alderweireld,8169242,757,02-Mar-89,28,67,3,5,0,7250,8500,8200,170,164,29023250,187,91,D RC,1,1,3,3,3,1,3,1,1,1,2,7,10,12,9,14,11,16,11,12,14,15,8,17,13,13,17,14,14,14,13,15,14,10,12,10,17,15,15,13,13,14,14,14,15,12,20,14,15,16,5,13,9,13,11,13,15,15,18,15,13,9,20,11,1,1,15,6,20,D RC,103,1,1,1,1,1,1,20,6,15,10,1,1,1,3,11,149534000000000.0,0,0,0,0,0,0,0,0,0,1,0,0,0,0,0,0,0,0,0,0,0,0,0,0,0,0,0,0,0,0,0,0,0,0,0,0,0,0,0,0,0,0,0,1,0,0,0,1,Toby Alderweireld,Â£36.00m ,31.0,186.0,Defender - Centre-Back,right,Tottenham Hotspur,39.0,2.0,0.0,3325.0,21.0,0.0,1.0,1741.0,50.0,0.0,0.0,4363.0,42.0,2.0,2.0,3798.0,5.0,0.0,0.0,450.0,Premier League,15-07-16,17.3.2.23,Toby Alderweireld,8169242,757,02-Mar-89,27,60,2,5,0,7100,8250,8200,166,164,119820745,186,81,D RC,4,1,3,3,1,1,2,2,2,4,2,6,7,9,6,13,11,16,15,12,16,15,6,16,15,11,17,15,15,14,11,15,12,8,16,8,17,15,15,13,13,13,14,12,16,12,20,14,15,16,5,14,4,12,11,13,15,12,18,15,9,9,Toby Alderweireld,Â£31.50m ,Premier League
19-06-17,18.3.4.28,Yohan Benalouane,8434244,51,28-Mar-87,30,0,0,0,0,5096,5606,6250,138,134,13094595,187,85,D RC,2,2,4,2,1,1,1,2,2,2,3,5,9,11,6,12,6,15,8,6,14,10,8,15,13,17,15,16,13,8,9,13,13,9,12,7,14,13,14,12,11,15,15,9,15,13,20,15,16,12,16,14,7,8,12,13,11,11,16,12,6,14,20,1,1,1,16,10,20,D RC,103,1,1,1,1,1,1,20,10,16,1,1,1,1,1,1,1.15292e+18,0,0,0,0,0,1,0,0,0,0,0,0,0,0,0,0,0,0,0,0,0,0,0,0,0,0,0,0,0,0,0,0,0,0,0,0,0,0,0,0,0,0,0,0,0,0,0,0,Yohan Benalouane,Â£900Th. ,33.0,185.0,Defender - Centre-Back,right,Aris Thessaloniki,25.0,1.0,0.0,2061.0,10.0,2.0,0.0,819.0,19.0,1.0,1.0,1636.0,2.0,0.0,0.0,49.0,nan,nan,nan,nan,Premier League,15-07-16,17.3.2.23,Yohan Benalouane,8434244,51,28-Mar-87,29,0,0,0,0,5107,5690,6247,136,131,5535562,187,85,D RC,3,2,4,1,1,2,2,1,3,2,2,5,9,11,6,12,6,15,8,6,14,10,8,14,13,16,15,14,13,8,9,13,13,9,12,7,14,13,14,12,11,15,14,9,15,13,20,15,16,12,16,14,7,8,12,13,11,11,16,12,6,14,Yohan Benalouane,Â£900Th. ,Premier League
19-06-17,18.3.4.28,JÃ©rÃ©my Pied,8440220,769,23-Feb-89,28,0,0,5,0,4750,6450,6550,136,131,20708517,173,69,WB/AM R,3,1,2,3,2,1,2,1,2,1,1,13,13,13,7,14,11,8,10,6,10,13,9,11,13,12,13,11,13,12,13,12,15,12,7,12,9,11,14,15,14,11,7,10,13,13,20,14,8,13,13,14,10,8,20,13,14,14,15,15,15,5,15,18,15,20,20,13,10,WB/AM R,522,1,1,1,1,12,20,1,10,15,1,10,13,15,10,18,2252350000000000.0,0,0,0,0,0,0,0,0,0,0,0,0,0,0,0,0,0,0,0,0,0,0,0,0,0,0,0,0,0,0,0,0,0,0,0,0,0,0,0,1,0,0,0,0,0,0,0,0,JÃ©rÃ©my Pied,Â£2.25m ,31.0,173.0,Defender - Right-Back,right,LOSC Lille,6.0,0.0,0.0,277.0,6.0,0.0,1.0,500.0,13.0,0.0,2.0,616.0,9.0,0.0,0.0,731.0,3.0,0.0,0.0,176.0,Premier League,15-07-16,17.3.2.23,JÃ©rÃ©my Pied,8440220,769,23-Feb-89,27,0,0,5,0,4750,6450,6550,136,131,20304821,173,69,WB/AM R,1,2,1,3,3,2,1,3,1,3,1,13,13,13,7,14,11,8,10,6,10,13,9,11,13,12,13,11,13,12,13,12,15,12,7,12,9,11,14,15,14,11,7,10,13,13,20,14,8,13,13,14,10,8,12,13,14,14,15,15,15,5,JÃ©rÃ©my Pied,Â£3.15m ,Premier League
19-06-17,18.3.4.28,Serge Aurier,85057643,24,24-Dec-92,24,41,1,0,0,6250,7250,7250,148,143,52949109,174,74,D/WB R,1,1,1,3,2,3,1,2,3,2,2,7,12,12,8,14,7,14,9,12,12,13,6,15,12,14,13,15,12,11,10,13,15,11,10,16,13,14,16,15,13,14,9,8,18,14,20,18,14,12,13,14,7,12,14,15,12,12,11,11,12,14,20,17,10,1,20,12,12,D/WB R,112,1,1,1,1,1,1,12,12,20,7,1,1,10,8,17,134348840.0,0,0,0,1,0,1,0,0,0,0,0,0,0,0,0,0,0,1,0,0,0,0,0,0,0,0,0,1,0,0,0,0,0,0,0,0,0,0,0,0,0,0,0,0,0,0,0,0,Serge Aurier,Â£18.00m ,27.0,176.0,Defender - Right-Back,right,Tottenham Hotspur,32.0,0.0,5.0,2561.0,24.0,2.0,3.0,2025.0,17.0,2.0,3.0,1358.0,42.0,2.0,8.0,3546.0,4.0,1.0,1.0,360.0,Premier League,15-07-16,17.3.2.23,Serge Aurier,85057643,24,24-Dec-92,23,25,0,0,0,6800,7450,7450,159,149,44967566,174,74,D/WB R,3,2,3,1,2,3,2,4,1,3,3,8,13,12,8,12,8,14,9,13,14,12,6,16,13,13,14,15,13,11,10,12,15,9,10,14,11,14,17,16,13,14,10,8,17,15,20,18,15,14,13,14,8,12,7,14,13,13,12,12,15,13,Serge Aurier,Â£13.50m ,Ligue 1
19-06-17,18.3.4.28,Kurt Zouma,85075595,769,27-Oct-94,22,2,0,7,1,5850,6750,7850,162,146,95115359,190,96,D RC,1,2,3,1,3,1,2,1,3,3,1,4,10,9,8,11,6,16,7,8,13,10,7,16,10,14,12,14,13,11,8,13,15,7,13,8,12,12,15,19,11,18,18,5,14,15,20,14,18,13,13,15,9,8,10,17,13,14,14,15,13,5,20,10,1,1,15,1,20,D RC,103,1,1,1,1,1,1,20,1,15,14,1,1,1,1,10,137439000000.0,0,0,0,0,0,1,0,0,0,0,0,0,0,0,0,0,0,0,0,0,0,0,0,0,0,0,0,0,0,0,0,0,0,0,0,0,0,1,0,0,0,0,0,0,0,0,0,0,Kurt Zouma,Â£13.50m ,25.0,190.0,Defender - Centre-Back,right,Chelsea FC,17.0,0.0,1.0,802.0,37.0,1.0,0.0,3127.0,36.0,2.0,2.0,2924.0,43.0,1.0,3.0,3704.0,8.0,2.0,0.0,659.0,Premier League,15-07-16,17.3.2.23,Kurt Zouma,85075595,769,27-Oct-94,21,2,0,7,1,5850,7100,7850,170,149,153340980,190,96,D RC,2,3,4,1,1,1,2,4,2,2,2,4,10,9,8,11,6,16,7,8,14,10,7,16,11,14,14,14,13,12,8,14,15,7,13,8,13,12,16,19,13,18,18,5,14,15,20,14,18,13,13,15,9,8,17,17,13,14,14,15,13,5,Kurt Zouma,Â£13.50m ,Premier League
19-06-17,18.3.4.28,Daryl Janmaat,860896,784,22-Jul-89,27,28,0,11,0,5750,6800,6800,147,137,34986677,185,80,D/WB R,1,3,3,3,1,2,1,2,3,2,2,5,14,14,7,13,7,12,14,10,14,13,7,15,13,15,13,13,13,12,12,13,13,12,14,14,10,15,15,13,13,13,12,12,14,13,20,15,12,12,11,13,9,14,13,15,11,14,13,13,12,5,18,20,11,1,20,14,14,D/WB R,222,1,1,1,1,1,1,14,10,18,8,1,1,11,14,20,288.0,0,0,0,0,0,1,0,0,1,0,0,0,0,0,0,0,0,0,0,0,0,0,0,0,0,0,0,0,0,0,0,0,0,0,0,0,0,0,0,0,0,0,0,0,0,0,0,0,Daryl Janmaat,Â£5.40m ,31.0,185.0,Defender - Right-Back,right,Without Club,30.0,2.0,1.0,1809.0,25.0,3.0,0.0,1986.0,22.0,0.0,2.0,1803.0,10.0,1.0,1.0,788.0,nan,nan,nan,nan,Premier League,15-07-16,17.3.2.23,Daryl Janmaat,860896,784,22-Jul-89,26,27,0,11,0,5750,6800,6800,147,136,25789769,185,82,D/WB R,1,1,2,1,1,4,3,1,3,3,3,5,13,13,6,13,7,12,11,10,15,13,7,15,13,15,13,13,13,13,12,13,13,12,14,14,12,15,15,13,13,13,12,12,14,13,20,15,11,12,11,13,6,14,13,15,11,14,13,13,12,5,Daryl Janmaat,Â£6.30m ,Premier League
19-06-17,18.3.4.28,Antonio Valencia,8830032,1654,04-Aug-85,31,88,10,0,0,6500,8000,7500,158,149,232186002,181,78,D/WB R,3,1,4,2,1,2,3,1,2,3,1,10,12,12,9,12,5,7,8,8,12,12,8,14,13,11,14,14,8,15,7,12,17,10,12,12,14,16,17,16,13,18,8,7,17,16,20,18,18,14,7,14,6,8,18,15,12,12,18,16,16,4,20,17,15,12,20,8,12,D/WB R,112,1,1,1,10,8,12,1,1,20,1,12,8,15,1,17,17314103298.0,0,1,0,0,0,0,0,0,0,0,0,0,0,0,1,0,0,0,0,0,0,0,0,0,0,0,0,1,0,0,0,0,0,0,1,0,0,0,0,0,0,0,0,0,0,0,0,0,Antonio D'Alena,Â£90Th. ,22.0,175.0,Midfielder - Defensive Midfield,left,Imolese Calcio 1919,35.0,10.0,11.0,2869.0,39.0,3.0,2.0,3282.0,3.0,0.0,0.0,48.0,5.0,0.0,1.0,183.0,3.0,0.0,0.0,83.0,Serie A,15-07-16,17.3.2.23,Antonio Valencia,8830032,1654,04-Aug-85,30,84,9,0,0,6496,7850,6996,158,146,10697001,181,78,D/WB/M/AM R,1,3,2,1,2,3,1,2,1,1,3,10,12,12,9,12,5,7,8,8,11,12,6,14,13,11,11,12,8,12,7,11,17,15,5,12,13,16,18,16,13,18,8,7,16,15,20,17,18,14,7,14,6,8,18,15,12,12,18,16,16,4,Antonio Valencia,Â£9.00m ,Premier League
19-06-17,18.3.4.28,Craig Dawson,90000708,765,06-May-90,27,0,0,15,7,5200,6750,6800,140,136,31122834,188,83,D RC,2,2,3,1,3,1,3,2,1,2,2,2,12,9,9,12,2,17,6,4,14,11,10,14,11,15,13,17,11,12,10,11,17,7,12,6,15,15,13,12,10,11,17,12,18,13,20,15,15,14,4,14,2,8,6,18,7,10,9,9,8,3,20,1,1,1,20,10,20,D RC,103,1,1,1,1,1,1,20,10,20,1,1,1,1,1,1,33792.0,0,0,0,0,0,0,0,0,0,0,1,0,0,0,0,1,0,0,0,0,0,0,0,0,0,0,0,0,0,0,0,0,0,0,0,0,0,0,0,0,0,0,0,0,0,0,0,0,Craig Dawson,Â£7.20m ,30.0,188.0,Defender - Centre-Back,right,West Ham United,39.0,4.0,1.0,3488.0,32.0,2.0,1.0,2869.0,45.0,3.0,3.0,3831.0,30.0,2.0,0.0,2449.0,1.0,0.0,0.0,90.0,Premier League,15-07-16,17.3.2.23,Craig Dawson,90000708,765,06-May-90,26,0,0,15,7,4500,6600,6600,140,132,17681812,188,83,D RC,2,1,1,1,3,3,2,2,1,2,2,2,12,9,9,12,2,15,6,4,14,11,12,14,11,13,13,17,11,12,10,11,17,7,12,6,14,15,13,13,10,11,16,14,18,13,20,15,14,14,4,14,2,8,6,18,7,10,9,9,8,3,Craig Dawson,Â£5.40m ,Premier League
19-06-17,18.3.4.28,Christopher Schindler,91012809,771,29-Apr-90,27,0,0,4,0,5250,6300,6900,140,138,36282268,188,77,D RLC,2,1,1,1,3,4,2,1,1,3,2,5,6,9,7,12,5,15,7,12,13,12,14,14,11,12,14,13,13,13,8,12,15,5,15,9,14,13,14,12,11,15,15,15,12,12,20,15,14,15,4,15,4,16,11,11,13,13,16,13,15,4,20,14,12,1,18,18,20,D RLC,106,1,1,1,1,1,1,20,18,18,12,12,1,1,14,14,0.0,0,0,0,0,0,0,0,0,0,0,0,0,0,0,0,0,0,0,0,0,0,0,0,0,0,0,0,0,0,0,0,0,0,0,0,0,0,0,0,0,0,0,0,0,0,0,0,0,Christopher Schindler,Â£5.40m ,30.0,188.0,Defender - Centre-Back,right,Huddersfield Town,48.0,2.0,3.0,4287.0,39.0,0.0,2.0,3401.0,38.0,1.0,0.0,3352.0,46.0,2.0,1.0,4140.0,6.0,0.0,0.0,378.0,Premier League
19-06-17,18.3.4.28,Antonio RÃ¼diger,92023410,771,03-Mar-93,24,17,0,10,1,6450,7450,7450,163,149,69451085,190,85,D RC,1,3,1,3,2,2,3,3,2,1,2,5,10,10,7,10,9,14,8,14,14,12,7,16,11,15,15,17,13,12,10,12,17,9,15,8,14,13,15,13,12,17,15,10,10,16,20,16,18,12,14,12,14,13,15,17,12,13,15,9,11,13,20,1,1,1,16,10,20,D RC,103,1,1,1,1,1,1,20,10,16,1,1,1,1,1,1,137439000000.0,0,0,0,0,0,0,0,0,0,0,0,0,0,0,0,0,0,0,0,0,0,0,0,0,0,0,0,0,0,0,0,0,0,0,0,0,0,1,0,0,0,0,0,0,0,0,0,0,Antonio RÃ¼diger,Â£36.00m ,27.0,190.0,Defender - Centre-Back,right,Chelsea FC,36.0,1.0,4.0,3025.0,45.0,3.0,2.0,3785.0,44.0,1.0,0.0,3894.0,28.0,2.0,0.0,2417.0,0.0,0.0,0.0,0.0,Premier League,15-07-16,17.3.2.23,Antonio RÃ¼diger,92023410,771,03-Mar-93,23,11,0,10,1,6250,7250,7300,166,147,49142071,190,85,D RC,3,2,4,2,1,3,1,3,3,1,3,5,9,10,7,10,9,15,10,14,13,12,7,16,11,16,15,17,12,10,10,12,16,9,11,8,12,10,14,14,13,18,15,11,10,18,20,16,17,12,13,12,14,13,14,16,8,13,12,7,11,14,Antonio RÃ¼diger,Â£22.50m ,Serie A
19-06-17,18.3.4.28,Victor LindelÃ¶f,93023425,797,17-Jul-94,22,12,1,13,0,6000,7000,7250,168,149,81481802,187,0,D/DM RC,1,1,2,2,2,3,3,3,1,1,1,3,10,12,7,13,3,11,6,11,15,14,10,14,14,12,15,12,14,12,13,13,14,14,13,14,15,14,15,16,15,14,13,12,16,15,20,14,13,15,8,15,3,16,14,13,18,16,17,15,12,6,20,13,3,1,16,5,20,D/DM RC,113,1,1,1,1,1,1,20,5,16,16,3,1,1,1,13,0.0,0,0,0,0,0,0,0,0,0,0,0,0,0,0,0,0,0,0,0,0,0,0,0,0,0,0,0,0,0,0,0,0,0,0,0,0,0,0,0,0,0,0,0,0,0,0,0,0,Victor LindelÃ¶f,Â£22.50m ,26.0,187.0,Defender - Centre-Back,right,Manchester United,47.0,1.0,0.0,4090.0,29.0,0.0,0.0,2361.0,40.0,1.0,1.0,3502.0,47.0,1.0,1.0,4108.0,6.0,0.0,0.0,540.0,Premier League,15-07-16,17.3.2.23,Victor LindelÃ¶f,93023425,797,17-Jul-94,21,6,0,13,0,6007,6358,7100,160,142,22861243,187,81,D/DM RC,1,1,1,1,3,1,2,4,1,2,2,3,10,12,7,13,3,11,6,11,14,12,10,13,13,8,15,11,13,14,13,14,14,10,13,13,14,14,14,15,14,13,13,11,16,15,20,14,12,16,8,15,3,16,14,12,18,15,17,15,12,6,Victor LindelÃ¶f,Â£19.80m ,Liga NOS
19-06-17,18.3.4.28,Daniel Amartey,93034815,21,21-Dec-94,22,19,0,0,0,5300,6500,6500,150,128,29260020,183,76,D/WB/DM/M RC,2,1,1,2,2,1,3,2,3,1,3,6,7,7,6,12,8,14,10,8,15,12,9,14,11,16,13,15,13,13,8,11,16,5,8,11,13,13,16,12,12,13,13,9,15,12,20,15,14,8,10,14,7,15,7,15,15,15,15,14,11,5,20,17,16,1,20,1,16,D/WB/DM/M RC,133,1,1,1,1,1,1,15,1,20,17,16,1,14,1,17,137439000000.0,0,0,0,0,0,0,0,0,0,1,0,0,0,0,0,0,0,0,0,0,0,0,0,0,0,0,0,0,0,0,0,0,0,0,0,0,0,1,0,0,0,0,0,0,0,0,0,0,Daniel Amartey,Â£4.50m ,25.0,186.0,Midfielder - Defensive Midfield,right,Leicester City,35.0,1.0,1.0,2196.0,15.0,0.0,0.0,1150.0,10.0,0.0,0.0,730.0,1.0,0.0,0.0,90.0,3.0,0.0,0.0,235.0,Premier League,15-07-16,17.3.2.23,Daniel Amartey,93034815,21,21-Dec-94,21,9,0,0,0,5241,6491,6491,150,130,31721746,183,76,D/DM/M C,3,1,3,2,3,1,4,2,1,2,3,6,7,7,6,12,8,14,10,8,15,12,9,14,11,16,13,15,13,13,8,11,16,5,8,11,13,13,16,12,12,13,13,9,15,12,20,15,14,8,10,14,7,15,7,15,15,15,15,14,11,5,Daniel Amartey,Â£4.50m ,Premier League
19-06-17,18.3.4.28,Pablo Zabaleta,951034,1649,16-Jan-85,32,58,0,43,5,6650,7250,7150,163,135,232186002,176,74,D/WB R,3,3,1,3,1,2,2,2,2,2,2,8,12,10,10,13,6,11,9,9,15,12,10,18,12,17,14,19,13,14,10,12,17,4,16,16,15,19,19,9,10,13,9,9,15,9,20,16,13,19,8,14,13,20,18,16,18,18,20,15,14,6,20,18,14,13,20,13,14,D/WB R,112,1,1,1,1,1,13,10,13,20,13,14,1,14,12,18,2199020000000.0,0,0,0,0,0,0,0,0,0,0,0,0,0,0,0,0,0,0,0,0,0,0,0,0,0,0,0,0,0,0,0,0,0,0,0,0,0,0,0,0,0,1,0,0,0,0,0,0,Pablo Zabaleta,Â£4.50m ,35.0,176.0,Defender - Right-Back,right,Retired,32.0,2.0,2.0,2055.0,39.0,0.0,1.0,3366.0,27.0,0.0,1.0,2181.0,13.0,0.0,0.0,859.0,nan,nan,nan,nan,Premier League,15-07-16,17.3.2.23,Pablo Zabaleta,951034,1649,16-Jan-85,31,53,0,43,5,7250,7850,7850,163,147,232186002,177,76,D/WB R,1,2,3,1,1,2,1,2,1,3,2,8,13,11,10,13,7,11,10,10,15,12,11,18,12,17,14,19,13,14,10,12,17,4,16,16,15,19,19,12,11,13,9,11,15,10,20,16,13,19,8,14,13,20,18,16,18,18,20,15,14,6,Pablo Zabaleta,Â£6.30m ,Premier League
19-06-17,18.3.4.28,Moritz Bauer,98009418,755,25-Jan-92,25,0,0,0,0,4250,5900,6000,135,129,7105337,181,73,D/WB R,1,2,1,3,1,1,1,2,2,1,2,11,12,13,6,12,10,12,8,14,13,11,5,13,12,13,13,12,12,14,9,13,7,9,9,12,10,16,17,13,13,12,10,12,12,14,20,16,9,16,10,10,5,9,16,8,13,7,15,12,11,8,20,17,10,1,20,13,1,D/WB R,112,1,1,1,1,1,1,1,13,20,1,1,1,10,1,17,32.0,0,0,0,0,0,1,0,0,0,0,0,0,0,0,0,0,0,0,0,0,0,0,0,0,0,0,0,0,0,0,0,0,0,0,0,0,0,0,0,0,0,0,0,0,0,0,0,0,Moritz Bauer,Â£4.50m ,28.0,181.0,Defender - Right-Back,right,Stoke City,23.0,0.0,4.0,1824.0,33.0,0.0,1.0,2805.0,16.0,0.0,1.0,1234.0,13.0,0.0,3.0,870.0,nan,nan,nan,nan,Premier League
19-06-17,18.3.4.28,Florent Hadergjonaj,98031298,798,31-Jul-94,22,1,0,11,0,4750,6300,6400,140,128,7834442,182,73,D/WB R,3,2,2,1,2,1,3,2,2,4,1,9,14,12,7,12,8,10,7,14,10,13,8,13,12,16,12,13,10,10,11,11,13,13,8,13,11,14,16,15,13,10,10,12,17,14,20,15,9,12,9,11,8,13,11,14,9,14,15,12,16,8,20,20,13,12,20,1,13,D/WB R,112,1,1,1,1,1,12,10,1,20,13,13,1,12,1,20,1099510000000.0,0,0,0,0,0,0,0,0,0,0,0,0,0,0,0,0,0,0,0,0,0,0,0,0,0,0,0,0,0,0,0,0,0,0,0,0,0,0,0,0,1,0,0,0,0,0,0,0,Florent Hadergjonaj,Â£4.50m ,26.0,182.0,Defender - Right-Back,right,Kasimpasa,29.0,1.0,3.0,2444.0,29.0,0.0,2.0,2109.0,24.0,0.0,0.0,1841.0,35.0,0.0,2.0,2626.0,4.0,0.0,0.0,340.0,Premier League,15-07-16,17.3.2.23,Florent Hadergjonaj,98031298,798,31-Jul-94,21,0,0,8,0,4200,6200,6200,140,124,5750853,182,73,D/WB R,1,3,2,4,3,4,1,4,1,3,2,9,14,11,7,12,8,10,7,14,10,13,8,13,12,16,12,13,10,10,11,11,13,13,8,13,10,14,16,15,13,9,10,12,17,14,20,15,7,12,9,11,8,13,10,12,10,14,15,12,16,6,Florent Hadergjonaj,Â£2.25m ,Bundesliga
19-06-17,18.3.4.28,Jean-Eudes Aholou,13112746,50,20-Mar-94,23,0,0,0,0,3800,6250,6250,131,124,7052613,186,79,D/DM/M RC,2,2,1,1,4,1,2,3,1,1,3,7,10,11,7,11,7,12,10,8,10,12,10,13,11,12,12,14,13,12,10,12,14,8,8,12,12,14,12,14,12,14,14,20,15,13,8,15,14,13,11,14,6,16,13,14,12,11,13,11,19,5,17,12,18,1,17,1,18,D/DM/M RC,333,1,1,1,1,1,1,1,1,17,20,18,1,15,1,12,0.0,0,0,0,0,0,0,0,0,0,0,0,0,0,0,0,0,0,0,0,0,0,0,0,0,0,0,0,0,0,0,0,0,0,0,0,0,0,0,0,0,0,0,0,0,0,0,0,0,Jean-Eudes Aholou,Â£2.70m ,26.0,187.0,Midfielder - Defensive Midfield,left,RC Strasbourg Alsace,39.0,3.0,2.0,3403.0,40.0,5.0,0.0,3275.0,21.0,0.0,1.0,1339.0,17.0,1.0,1.0,1012.0,5.0,1.0,0.0,295.0,Ligue 1
19-06-17,18.3.4.28,Yves Bissouma,13174979,31,30-Aug-96,20,10,3,0,0,4250,6150,6450,136,123,17462375,180,78,WB/M RC,2,3,2,1,1,2,2,3,2,3,2,11,11,14,12,13,13,10,15,2,8,12,6,8,13,8,10,10,12,11,9,10,10,13,8,14,9,11,14,15,14,12,10,8,14,14,20,15,12,13,11,8,7,11,20,13,12,12,10,11,14,1,1,16,20,1,16,1,20,WB/M RC,423,1,1,1,1,1,1,1,1,1,1,20,1,1,1,16,2251800000000000.0,0,0,0,0,0,0,0,0,0,0,0,0,0,0,0,0,0,0,0,0,0,0,0,0,0,0,0,0,0,0,0,0,0,0,0,0,0,0,0,0,0,0,0,0,0,0,0,0,Yves Bissouma,Â£7.20m ,24.0,182.0,Midfielder - Central Midfield,right,Brighton & Hove Albion,27.0,1.0,1.0,1032.0,28.0,3.0,1.0,1858.0,34.0,1.0,1.0,2295.0,23.0,1.0,0.0,1325.0,5.0,1.0,0.0,449.0,Ligue 1
19-06-17,18.3.4.28,Djibril SidibÃ©,167575,769,29-Jul-92,24,10,1,1,0,6550,7350,7300,154,146,65371496,182,71,D RL,2,2,1,1,3,3,2,4,2,2,2,10,13,14,9,14,13,12,10,13,14,14,12,15,13,13,14,13,11,12,13,13,15,14,12,15,13,14,15,14,13,14,12,10,14,15,20,15,15,12,10,14,9,13,10,15,13,16,15,15,16,7,20,14,13,1,20,17,1,D RL,105,1,1,1,1,1,1,1,17,20,1,1,10,13,12,14,135266338.0,0,1,0,0,0,1,0,0,0,0,0,0,0,0,0,0,0,0,0,0,1,0,0,0,0,0,0,1,0,0,0,0,0,0,0,0,0,0,0,0,0,0,0,0,0,0,0,0,Djibril SidibÃ©,Â£20.70m ,28.0,182.0,Defender - Right-Back,right,AS Monaco,47.0,3.0,8.0,3847.0,35.0,3.0,9.0,2847.0,32.0,0.0,4.0,2543.0,28.0,0.0,5.0,2090.0,4.0,0.0,0.0,284.0,Ligue 1,15-07-16,17.3.2.23,Djibril SidibÃ©,167575,769,29-Jul-92,23,0,0,1,0,6550,7200,7250,152,145,50507472,182,71,D RL,1,3,3,2,3,1,1,3,3,1,4,9,13,14,8,14,13,12,10,13,14,14,13,15,13,14,14,13,11,12,12,13,16,12,12,15,13,14,15,15,13,14,12,9,16,15,20,15,15,15,10,14,6,12,14,15,14,16,15,15,16,6,Djibril SidibÃ©,Â£16.20m ,Ligue 1
19-06-17,18.3.4.28,Thomas Meunier,18043393,757,12-Sep-91,25,15,1,7,1,6250,7500,7250,147,145,29604326,190,82,D/WB RC,1,2,1,3,2,1,1,4,2,3,1,8,14,13,10,13,10,12,12,11,12,14,7,13,14,10,14,14,14,15,12,14,16,11,8,13,13,16,16,12,11,14,14,8,14,14,20,15,14,15,8,14,8,14,14,16,15,14,17,14,15,6,20,18,15,13,20,12,15,D/WB RC,113,1,1,10,12,10,13,10,1,20,14,15,12,15,1,18,0.0,0,0,0,0,0,0,0,0,0,0,0,0,0,0,0,0,0,0,0,0,0,0,0,0,0,0,0,0,0,0,0,0,0,0,0,0,0,0,0,0,0,0,0,0,0,0,0,0,Thomas Meunier,Â£13.50m ,29.0,190.0,Defender - Right-Back,right,Borussia Dortmund,36.0,2.0,7.0,2789.0,34.0,5.0,5.0,2308.0,31.0,5.0,7.0,2368.0,27.0,1.0,2.0,2135.0,8.0,0.0,0.0,612.0,Ligue 1,15-07-16,17.3.2.23,Thomas Meunier,18043393,757,12-Sep-91,24,9,0,7,1,6246,7096,7096,145,142,20946897,190,82,D/WB/M RC,2,1,1,3,3,2,1,1,3,1,3,8,14,13,11,12,10,12,11,8,11,13,9,13,13,10,14,14,13,13,14,14,16,11,6,12,12,16,16,12,11,11,14,8,14,14,20,15,13,14,7,13,8,14,13,14,11,14,16,10,15,1,Thomas Meunier,Â£8.10m ,Ligue 1
19-06-17,18.3.4.28,SomÃ¡lia,19081040,1651,28-Sep-88,28,0,0,0,0,3800,5750,6400,135,127,9411773,180,73,M/AM RC,1,1,1,1,2,2,2,1,3,2,3,6,10,12,10,7,5,11,5,10,11,10,12,9,11,10,12,14,11,10,9,10,14,10,5,10,9,13,13,16,14,13,11,5,13,18,20,13,12,12,8,7,7,12,14,13,11,14,14,12,16,7,15,15,20,18,18,13,20,M/AM RC,413,1,1,10,15,13,18,1,7,15,15,20,13,15,1,15,0.0,0,0,0,0,0,0,0,0,0,0,0,0,0,0,0,0,0,0,0,0,0,0,0,0,0,0,0,0,0,0,0,0,0,0,0,0,0,0,0,0,0,0,0,0,0,0,0,0,SomÃ¡lia,Â£1.80m ,32.0,181.0,Midfielder - Central Midfield,both,FerencvÃ¡rosi TC,31.0,0.0,1.0,2111.0,31.0,2.0,0.0,2352.0,17.0,1.0,1.0,1016.0,12.0,0.0,0.0,789.0,10.0,1.0,2.0,646.0,Ligue 1,15-07-16,17.3.2.23,SomÃ¡lia,19081040,1651,28-Sep-88,27,0,0,0,0,3901,5754,5950,130,128,3008728,180,73,M/AM RC,1,1,3,3,2,1,2,2,3,1,3,6,10,12,10,7,5,11,5,10,11,10,12,9,12,10,12,14,11,10,10,10,14,10,5,10,9,13,13,16,14,13,11,5,13,18,20,13,10,9,8,7,7,12,18,13,11,14,14,12,10,7,SomÃ¡lia,Â£1.80m ,Ligue 1
19-06-17,18.3.4.28,Marquinhos,19163495,1651,14-May-94,23,19,0,0,0,7000,8000,7800,175,156,172709061,183,72,D RC,1,3,3,1,1,2,2,2,1,3,1,4,11,10,8,14,4,15,10,7,15,13,8,16,14,14,15,15,15,16,12,15,18,10,12,8,16,17,15,14,13,16,13,10,14,15,20,15,13,16,8,15,8,15,15,15,12,14,17,15,16,7,20,1,1,1,15,1,20,D RC,103,1,1,1,1,1,1,20,1,15,10,1,1,1,1,1,8589967360.0,0,0,0,0,0,0,0,0,0,0,0,0,0,0,0,1,0,0,0,0,0,0,0,0,0,0,0,0,0,0,0,0,0,1,0,0,0,0,0,0,0,0,0,0,0,0,0,0,Marquinhos,Â£49.50m ,26.0,183.0,Defender - Centre-Back,right,Paris Saint-Germain,44.0,4.0,0.0,3849.0,41.0,2.0,3.0,3613.0,44.0,4.0,2.0,3861.0,37.0,6.0,1.0,3043.0,5.0,1.0,0.0,433.0,Ligue 1,15-07-16,17.3.2.23,Marquinhos,19163495,1651,14-May-94,22,11,0,0,0,6800,7500,7700,175,154,107363733,183,72,D RC,2,1,2,3,1,3,3,3,3,1,1,4,11,9,8,13,4,14,10,7,15,12,8,16,14,14,15,15,14,16,12,14,18,10,12,8,16,18,15,14,13,15,13,12,14,15,20,15,13,15,8,15,8,15,14,14,12,14,16,15,15,7,Marquinhos,Â£31.50m ,Ligue 1
19-06-17,18.3.4.28,Rafael,2107500,1651,09-Jul-90,26,2,0,6,1,5750,6500,6950,148,139,29243991,172,74,D/WB R,1,1,1,3,1,3,1,3,3,1,3,6,14,13,7,13,6,10,7,11,11,13,6,12,14,16,14,15,10,10,11,12,17,13,11,14,10,15,15,16,16,13,8,10,13,16,20,13,11,12,14,14,12,12,15,17,15,14,16,10,12,5,20,20,12,1,20,13,1,D/WB R,112,1,1,1,1,1,1,1,13,20,1,1,1,12,13,20,137439000000.0,0,1,0,0,0,1,0,0,0,0,0,0,0,0,0,0,0,0,0,0,0,0,0,0,0,0,0,0,0,0,0,0,0,0,0,0,0,1,0,0,0,0,0,0,0,0,0,0,Rafael,Â£720Th. ,30.0,186.0,Goalkeeper,right,Reading FC,2.0,2.0,0.0,180.0,0.0,0.0,0.0,0.0,4.0,3.0,2.0,390.0,46.0,56.0,13.0,4170.0,7.0,1.0,6.0,630.0,Serie A,15-07-16,17.3.2.23,Rafael,19016415,1651,20-May-90,26,3,0,0,0,4500,6500,6450,145,128,3074868,186,83,GK ,12,13,13,8,15,13,14,14,11,12,11,6,3,3,3,12,8,4,3,3,1,11,2,1,8,7,13,13,13,11,12,10,13,2,10,5,14,13,13,13,15,13,14,7,14,13,20,14,12,13,5,13,10,11,11,12,13,14,13,14,12,6,Rafael,Â£1.53m ,Serie A
19-06-17,18.3.4.28,Mehdi Zeffane,29114944,5,19-May-92,25,11,0,0,0,3000,5450,5450,119,109,25215,176,71,D R,1,2,2,3,3,3,2,2,2,1,1,5,12,10,6,11,5,6,9,11,8,9,6,11,12,12,11,11,9,10,8,10,12,9,8,12,10,12,13,16,13,12,8,10,16,14,20,15,10,13,12,8,5,15,19,13,12,10,10,14,14,10,20,15,7,10,20,12,1,D R,102,1,1,1,1,10,10,1,12,20,1,1,7,7,12,15,2.0,0,1,0,0,0,0,0,0,0,0,0,0,0,0,0,0,0,0,0,0,0,0,0,0,0,0,0,0,0,0,0,0,0,0,0,0,0,0,0,0,0,0,0,0,0,0,0,0,Mehdi Zeffane,Â£900Th. ,28.0,176.0,Defender - Right-Back,right,Krylya Sovetov Samara,2.0,0.0,0.0,165.0,15.0,0.0,1.0,988.0,31.0,1.0,3.0,2110.0,6.0,0.0,0.0,489.0,13.0,0.0,1.0,891.0,Ligue 1
19-06-17,18.3.4.28,Hamari TraorÃ©,30035411,31,27-Jan-92,25,10,0,0,0,3800,6300,6300,129,126,6301369,174,59,D R,1,2,2,3,2,2,3,3,3,1,1,10,13,12,8,11,8,12,8,15,13,12,10,13,12,15,13,13,11,12,10,12,12,12,7,13,11,13,14,15,13,12,8,10,16,15,20,15,8,12,13,12,5,13,14,10,10,13,14,13,19,8,20,15,10,10,20,1,1,D R,102,1,1,1,1,1,10,1,1,20,1,1,1,10,1,15,2251800000000000.0,0,0,0,1,0,0,0,0,0,0,0,0,0,0,0,0,0,0,0,0,0,0,0,0,0,0,0,0,0,0,0,0,0,0,0,0,0,0,0,0,0,0,0,0,0,0,0,0,Hamari TraorÃ©,Â£5.40m ,28.0,175.0,Defender - Right-Back,right,Stade Rennais FC,32.0,2.0,2.0,2779.0,33.0,0.0,2.0,2910.0,49.0,0.0,2.0,4294.0,37.0,1.0,5.0,3327.0,7.0,0.0,1.0,619.0,Ligue 1
19-06-17,18.3.4.28,Daniel Alves,315542,1651,06-May-83,34,99,7,0,0,7750,8300,8050,174,161,232186002,172,70,D/WB/M R,3,1,4,2,2,2,1,1,2,2,2,14,17,14,12,16,14,9,14,12,13,16,14,15,16,17,14,17,15,13,15,14,20,15,15,17,13,15,17,15,14,14,7,10,18,14,20,15,10,16,14,18,9,14,18,20,11,20,15,8,8,17,20,19,17,10,20,8,6,D/WB/M R,122,1,1,1,1,1,10,6,7,20,1,1,5,17,8,19,1236950000000.0,0,1,0,0,0,1,0,0,0,1,0,0,0,0,0,0,0,0,0,0,0,0,0,0,0,0,0,0,0,0,0,0,0,0,0,0,0,1,0,0,1,0,0,0,0,0,0,0,Dani Alves,Â£3.60m ,37.0,172.0,Defender - Right-Back,right,SÃ£o Paulo Futebol Clube,33.0,6.0,7.0,2543.0,41.0,5.0,10.0,3263.0,52.0,5.0,11.0,4003.0,27.0,5.0,1.0,2425.0,nan,nan,nan,nan,Ligue 1,15-07-16,17.3.2.23,Daniel Alves,315542,1651,06-May-83,33,82,6,0,0,7500,7700,7800,174,155,232186002,172,70,D/WB/M R,1,2,3,3,3,1,3,1,3,2,3,14,14,14,10,14,14,8,13,14,11,14,14,15,15,17,13,15,12,14,15,12,16,15,12,17,14,15,17,15,14,14,7,10,18,14,20,17,9,15,13,12,7,14,18,16,11,14,12,8,8,15,Dani Alves,Â£5.40m ,Serie A
19-06-17,18.3.4.28,Oualid El Hajjam,34002344,769,19-Feb-91,26,0,0,0,0,3500,6250,6250,128,125,6346937,181,76,D/DM/M RC,1,2,2,4,2,3,2,2,2,3,1,6,14,13,6,11,6,11,10,10,13,13,6,13,12,12,13,13,11,12,10,12,16,11,8,13,14,12,15,15,11,14,12,6,14,12,20,14,12,15,8,8,6,14,10,13,15,14,14,15,15,6,20,15,17,1,20,13,15,D/DM/M RC,123,1,1,1,1,1,1,10,13,20,17,15,1,17,13,15,32.0,0,0,0,0,0,1,0,0,0,0,0,0,0,0,0,0,0,0,0,0,0,0,0,0,0,0,0,0,0,0,0,0,0,0,0,0,0,0,0,0,0,0,0,0,0,0,0,0,Oualid El Hajjam,Â£900Th. ,29.0,181.0,Defender - Right-Back,right,ES Troyes AC,28.0,1.0,2.0,2435.0,29.0,1.0,1.0,2385.0,15.0,0.0,0.0,904.0,23.0,1.0,1.0,1907.0,7.0,0.0,0.0,513.0,Ligue 1
19-06-17,18.3.4.28,Vincent Manceau,34011263,769,24-Jul-89,27,0,0,0,0,3800,6250,6250,125,125,5675627,175,69,D/DM RC,1,2,2,2,2,2,4,1,1,2,2,6,12,10,5,11,6,10,10,10,13,12,9,13,12,13,13,14,12,13,12,11,15,11,13,10,13,14,14,15,13,12,7,9,13,13,20,14,11,13,12,12,10,15,8,13,18,12,8,8,14,3,20,15,15,1,20,12,15,D/DM RC,113,1,1,1,1,1,1,1,12,20,17,15,1,12,1,15,0.0,0,0,0,0,0,0,0,0,0,0,0,0,0,0,0,0,0,0,0,0,0,0,0,0,0,0,0,0,0,0,0,0,0,0,0,0,0,0,0,0,0,0,0,0,0,0,0,0,Vincent Manceau,Â£1.80m ,31.0,176.0,Defender - Right-Back,right,SCO Angers,38.0,1.0,0.0,3315.0,35.0,0.0,0.0,3150.0,33.0,1.0,1.0,3000.0,24.0,0.0,0.0,2165.0,3.0,0.0,0.0,147.0,Ligue 1,15-07-16,17.3.2.23,Vincent Manceau,34011263,769,24-Jul-89,26,0,0,0,0,3498,6248,6248,125,124,6068404,175,69,D/DM RC,4,2,1,1,3,1,3,1,1,1,3,6,12,10,5,11,6,10,10,10,13,12,9,13,12,12,13,14,12,13,12,11,15,11,13,12,13,14,14,15,13,12,7,9,13,13,20,14,11,14,12,12,11,15,14,12,17,11,8,11,15,3,Vincent Manceau,Â£1.80m ,Ligue 1
19-06-17,18.3.4.28,Junior Sambia,36515152,769,07-Sep-96,20,0,0,0,0,3600,5600,5600,114,112,2785844,181,68,D/DM RL,2,2,3,1,1,3,4,3,3,3,3,8,12,14,9,11,14,9,11,6,10,12,9,12,12,12,11,7,10,11,12,9,4,13,7,11,12,13,14,13,13,14,10,12,15,14,20,14,11,10,12,8,11,14,12,12,10,12,9,11,20,1,20,1,1,1,20,17,1,D/DM RL,115,1,1,1,1,1,1,1,17,20,20,1,1,1,1,1,0.0,0,0,0,0,0,0,0,0,0,0,0,0,0,0,0,0,0,0,0,0,0,0,0,0,0,0,0,0,0,0,0,0,0,0,0,0,0,0,0,0,0,0,0,0,0,0,0,0,Junior Sambia,Â£2.25m ,24.0,185.0,Midfielder - Defensive Midfield,right,Montpellier HSC,41.0,4.0,3.0,3610.0,38.0,3.0,7.0,2411.0,32.0,0.0,1.0,1079.0,22.0,1.0,1.0,912.0,7.0,0.0,1.0,170.0,Ligue 1
19-06-17,18.3.4.28,Kenny Tete,37039829,784,09-Oct-95,21,6,0,0,0,5250,6500,6850,155,137,41362585,180,73,D/WB R,3,2,2,3,2,1,3,2,1,2,1,7,11,10,5,12,5,12,7,11,15,12,6,18,12,15,11,15,12,11,10,13,14,9,7,12,14,14,14,14,13,15,12,10,14,14,20,15,14,14,10,15,5,14,13,12,12,11,12,4,8,10,20,20,1,1,20,12,14,D/WB R,112,1,1,1,1,1,1,14,12,20,1,1,1,1,12,20,137439000000.0,0,0,0,0,0,0,0,0,0,0,0,0,0,0,0,0,0,0,0,0,0,0,0,0,0,0,0,0,0,0,0,0,0,0,0,0,0,1,0,0,0,0,0,0,0,0,0,0,Kenny Tete,Â£7.20m ,25.0,180.0,Defender - Right-Back,right,Fulham FC,23.0,3.0,2.0,1907.0,31.0,1.0,5.0,2406.0,22.0,0.0,3.0,1725.0,28.0,0.0,1.0,1654.0,4.0,0.0,2.0,229.0,Ligue 1
19-06-17,18.3.4.28,Benjamin Angoua,38001740,24,28-Nov-86,30,17,1,4,0,3950,5550,5900,121,118,1883934,183,73,D RC,1,1,1,1,1,1,1,1,1,1,1,4,8,6,6,8,5,14,7,10,15,7,6,14,8,14,12,16,10,12,10,11,13,9,8,8,12,15,14,11,12,14,11,10,13,14,20,15,14,14,13,13,8,12,14,12,13,13,14,11,11,7,20,14,7,1,15,13,20,D RC,103,1,1,1,1,1,1,20,13,15,14,7,1,1,12,14,32832.0,0,0,0,0,0,0,1,0,0,0,0,0,0,0,0,1,0,0,0,0,0,0,0,0,0,0,0,0,0,0,0,0,0,0,0,0,0,0,0,0,0,0,0,0,0,0,0,0,Benjamin Angoua,Â£900Th. ,33.0,183.0,Defender - Centre-Back,right,Stade Briochin,39.0,1.0,2.0,3434.0,nan,nan,nan,nan,7.0,0.0,0.0,532.0,17.0,1.0,0.0,1487.0,9.0,1.0,0.0,810.0,Ligue 1
19-06-17,18.3.4.28,Abdoulaye Bamba,43013866,24,25-Apr-90,27,0,0,0,0,3250,5500,5600,115,112,451423,182,68,D/WB R,2,1,2,2,2,4,4,2,2,1,1,7,12,9,5,10,6,12,7,15,12,9,6,12,10,11,13,12,11,10,9,9,13,7,6,10,10,14,15,16,13,13,11,5,15,15,20,14,10,12,10,13,7,12,12,13,12,15,12,14,14,7,20,18,10,1,20,14,1,D/WB R,112,1,1,1,1,1,1,1,14,20,1,1,1,10,1,18,8.0,0,0,0,1,0,0,0,0,0,0,0,0,0,0,0,0,0,0,0,0,0,0,0,0,0,0,0,0,0,0,0,0,0,0,0,0,0,0,0,0,0,0,0,0,0,0,0,0,Abdoulaye Bamba,Â£900Th. ,30.0,182.0,Defender - Right-Back,right,SCO Angers,12.0,0.0,2.0,791.0,21.0,0.0,0.0,1803.0,30.0,0.0,4.0,2574.0,11.0,0.0,1.0,943.0,7.0,0.0,0.0,572.0,Ligue 1,15-07-16,17.3.2.23,Abdoulaye Bamba,43013866,24,25-Apr-90,26,0,0,0,0,3250,5500,5600,115,112,1298080,182,68,D/WB R,3,2,1,1,4,3,1,1,1,2,1,7,12,9,5,10,6,12,7,15,12,9,6,12,10,12,13,14,11,10,9,9,13,7,6,10,10,14,15,16,13,13,11,5,15,15,20,14,10,12,12,13,7,12,12,14,14,15,13,14,14,7,Abdoulaye Bamba,Â£900Th. ,Ligue 1
19-06-17,18.3.4.28,Hiroki Sakai,45015208,116,12-Apr-90,27,36,0,0,0,5250,6600,6600,134,132,10376373,183,70,D/WB R,1,3,2,3,3,3,2,3,1,3,2,9,12,12,8,12,8,10,13,14,10,12,7,14,11,14,11,15,11,14,9,12,16,10,9,12,10,13,16,14,12,12,12,10,16,15,20,16,13,16,10,14,6,15,12,15,15,10,17,13,14,4,20,19,13,12,20,10,13,D/WB R,112,1,1,1,1,1,12,13,10,20,1,1,1,13,10,19,134217728.0,0,0,0,0,0,0,0,0,0,0,0,0,0,0,0,0,0,0,0,0,0,0,0,0,0,0,0,1,0,0,0,0,0,0,0,0,0,0,0,0,0,0,0,0,0,0,0,0,Hiroki Sakai,Â£5.40m ,30.0,183.0,Defender - Right-Back,right,Olympique Marseille,40.0,0.0,3.0,3422.0,50.0,1.0,4.0,3950.0,32.0,1.0,5.0,2808.0,25.0,0.0,0.0,1959.0,9.0,0.0,1.0,799.0,Ligue 1,15-07-16,17.3.2.23,Hiroki Sakai,45015208,116,12-Apr-90,26,27,0,0,0,5194,6544,6444,134,128,8749267,183,70,D/WB R,3,3,3,3,2,1,3,3,2,1,3,9,14,12,8,10,8,12,13,14,9,12,7,13,11,14,9,15,10,12,9,10,16,10,9,12,8,12,17,14,11,13,12,10,16,16,20,16,13,13,10,14,6,15,10,15,14,10,16,13,13,4,Hiroki Sakai,Â£2.25m ,Ligue 1
19-06-17,18.3.4.28,Kelvin Amian,48031443,769,08-Feb-98,19,0,0,2,0,2001,5004,5000,144,112,899166,180,78,D RC,4,1,3,2,3,3,1,4,1,1,3,8,11,9,7,13,3,11,10,13,13,11,5,13,11,12,13,11,13,12,12,13,11,1,7,11,12,12,12,13,13,13,9,6,16,13,20,13,12,13,4,12,5,10,12,8,10,11,12,13,15,3,20,1,1,1,20,14,18,D RC,103,1,1,1,1,1,1,18,14,20,11,1,1,1,1,1,0.0,0,0,0,0,0,0,0,0,0,0,0,0,0,0,0,0,0,0,0,0,0,0,0,0,0,0,0,0,0,0,0,0,0,0,0,0,0,0,0,0,0,0,0,0,0,0,0,0,Kelvin Amian,Â£4.50m ,22.0,180.0,Defender - Right-Back,right,FC Toulouse,24.0,0.0,0.0,2015.0,40.0,1.0,1.0,3514.0,34.0,0.0,1.0,3002.0,22.0,0.0,2.0,1810.0,8.0,1.0,0.0,720.0,Ligue 1
19-06-17,18.3.4.28,Nordi Mukiele,48034615,769,01-Nov-97,19,0,0,0,0,3600,6200,6200,136,124,11802666,185,74,D RC,2,4,2,1,4,1,3,3,3,2,1,8,10,8,6,11,6,13,5,11,15,12,9,14,10,12,13,14,11,13,10,11,12,8,8,10,13,14,15,13,14,15,12,6,14,14,20,14,13,13,7,13,5,12,19,13,12,12,13,13,15,7,20,1,1,1,19,1,20,D RC,103,1,1,1,1,1,1,20,1,19,13,1,1,1,1,1,0.0,0,0,0,0,0,0,0,0,0,0,0,0,0,0,0,0,0,0,0,0,0,0,0,0,0,0,0,0,0,0,0,0,0,0,0,0,0,0,0,0,0,0,0,0,0,0,0,0,Nordi Mukiele,Â£12.60m ,22.0,187.0,Defender - Right-Back,right,RB Leipzig,37.0,0.0,1.0,3273.0,39.0,0.0,1.0,3321.0,31.0,1.0,1.0,1901.0,37.0,3.0,3.0,2659.0,6.0,0.0,0.0,429.0,Ligue 1,15-07-16,17.3.2.23,Nordi Mukiele,48034615,769,01-Nov-97,18,0,0,0,0,3000,5250,5450,141,105,2213976,185,74,D RC,1,1,2,2,2,2,3,2,2,1,3,4,6,8,6,10,6,13,5,5,12,10,9,13,10,12,12,13,11,12,8,11,12,1,8,8,11,10,13,13,11,12,12,6,12,12,20,13,14,11,7,10,5,10,10,13,12,12,13,9,15,7,Nordi Mukiele,Â£1.35m ,Ligue 1
19-06-17,18.3.4.28,Alexander Djiku,48036760,769,09-Dec-94,22,0,0,0,0,3800,6250,6250,131,125,4846362,182,74,D RC,1,1,1,3,1,3,2,3,1,2,3,7,11,10,7,11,7,13,7,11,14,12,8,13,12,15,12,15,13,14,8,12,13,10,9,10,13,13,14,13,12,15,11,10,14,12,20,14,14,12,12,11,7,11,10,14,14,12,13,12,14,7,20,1,1,1,15,1,20,D RC,103,1,1,1,1,1,1,20,1,15,13,1,1,1,1,1,0.0,0,0,0,0,0,0,0,0,0,0,0,0,0,0,0,0,0,0,0,0,0,0,0,0,0,0,0,0,0,0,0,0,0,0,0,0,0,0,0,0,0,0,0,0,0,0,0,0,Alexander Djiku,Â£7.20m ,26.0,182.0,Defender - Centre-Back,right,RC Strasbourg Alsace,24.0,1.0,0.0,1939.0,33.0,0.0,0.0,3000.0,35.0,1.0,0.0,3137.0,33.0,2.0,1.0,2737.0,7.0,0.0,0.0,506.0,Ligue 1,15-07-16,17.3.2.23,Alexander Djiku,48036760,769,09-Dec-94,21,0,0,0,0,3000,5250,5250,138,105,1063213,182,74,D RC,3,1,1,1,4,1,2,3,1,1,2,9,11,12,7,9,8,12,7,11,12,7,8,13,11,12,12,14,12,13,7,12,13,1,4,11,9,10,12,14,10,13,11,9,10,12,20,13,11,10,13,10,10,10,13,11,11,13,12,13,15,5,Alexander Djiku,Â£1.13m ,Ligue 1
19-06-17,18.3.4.28,Patrick Burner,48036808,769,11-Apr-96,21,0,0,0,0,2250,5000,5000,129,100,613692,170,65,D R,3,2,1,1,2,1,1,3,2,2,2,6,10,10,6,11,3,11,10,10,9,10,6,11,12,10,9,9,10,12,10,9,4,8,6,12,9,13,14,14,14,12,7,8,12,13,20,13,8,10,9,10,10,10,13,10,11,9,10,12,16,1,20,13,12,10,20,1,1,D R,102,1,1,1,1,1,10,1,1,20,1,1,1,12,1,13,0.0,0,0,0,0,0,0,0,0,0,0,0,0,0,0,0,0,0,0,0,0,0,0,0,0,0,0,0,0,0,0,0,0,0,0,0,0,0,0,0,0,0,0,0,0,0,0,0,0,Patrick Burner,Â£1.80m ,24.0,170.0,Defender - Right-Back,right,NÃ®mes Olympique,7.0,0.0,0.0,447.0,23.0,0.0,0.0,1527.0,21.0,0.0,0.0,1702.0,22.0,1.0,1.0,1612.0,5.0,0.0,0.0,293.0,Ligue 1
19-06-17,18.3.4.28,AloÄs Confais,48037139,769,07-Sep-96,20,0,0,0,0,3250,5800,5800,131,116,5070967,174,61,D/DM/M RC,3,1,3,3,1,2,2,1,1,2,1,10,11,12,9,12,8,9,10,8,11,13,9,10,12,10,12,13,12,13,13,12,12,11,9,12,13,14,13,12,13,10,10,11,13,12,20,12,11,12,9,12,8,14,10,11,10,10,12,11,12,4,17,10,20,1,17,1,20,D/DM/M RC,433,1,1,1,1,1,1,1,1,17,18,20,1,1,1,10,0.0,0,0,0,0,0,0,0,0,0,0,0,0,0,0,0,0,0,0,0,0,0,0,0,0,0,0,0,0,0,0,0,0,0,0,0,0,0,0,0,0,0,0,0,0,0,0,0,0,AloÃ¯s Confais,Â£810Th. ,24.0,174.0,Midfielder - Defensive Midfield,right,Nea Salamina Famagusta,34.0,1.0,0.0,2299.0,19.0,0.0,0.0,834.0,29.0,1.0,0.0,2238.0,26.0,1.0,0.0,1892.0,4.0,0.0,0.0,305.0,Ligue 1
19-06-17,18.3.4.28,RonaÃ«l Pierre-Gabriel,48038032,769,03-Jun-98,19,0,0,0,0,2250,5000,5000,126,100,838712,177,0,D R,1,4,4,2,1,3,2,3,4,4,1,7,10,12,7,11,7,10,8,10,10,10,6,12,11,7,11,11,10,9,10,10,12,9,6,12,9,13,14,15,13,12,8,5,10,13,20,12,10,10,10,10,10,10,13,12,12,11,13,10,16,8,20,1,1,1,20,12,1,D R,102,1,1,1,1,1,1,1,12,20,1,1,1,1,1,1,2.0,0,1,0,0,0,0,0,0,0,0,0,0,0,0,0,0,0,0,0,0,0,0,0,0,0,0,0,0,0,0,0,0,0,0,0,0,0,0,0,0,0,0,0,0,0,0,0,0,RonaÃ«l Pierre-Gabriel,Â£3.60m ,22.0,177.0,Defender - Right-Back,right,Stade Brest 29,14.0,0.0,0.0,963.0,17.0,0.0,0.0,1260.0,5.0,0.0,0.0,416.0,8.0,0.0,1.0,578.0,5.0,0.0,0.0,381.0,Ligue 1
19-06-17,18.3.4.28,ClÃ©ment Michelin,48042718,769,11-May-97,20,0,0,0,0,3000,5150,5150,117,103,1066063,178,63,D/WB RL,3,3,2,1,3,2,1,2,1,1,2,10,14,10,6,14,7,10,6,17,8,11,3,12,11,10,12,12,8,11,10,11,6,8,6,13,10,12,11,12,15,10,7,5,11,15,20,12,7,10,10,10,8,10,16,13,15,11,10,12,14,7,20,17,13,1,20,15,10,D/WB RL,115,1,1,1,1,1,1,10,15,20,1,1,1,13,1,17,0.0,0,0,0,0,0,0,0,0,0,0,0,0,0,0,0,0,0,0,0,0,0,0,0,0,0,0,0,0,0,0,0,0,0,0,0,0,0,0,0,0,0,0,0,0,0,0,0,0,ClÃ©ment Michelin,Â£1.13m ,23.0,178.0,Defender - Right-Back,right,RC Lens,10.0,0.0,0.0,721.0,10.0,0.0,0.0,346.0,15.0,0.0,0.0,901.0,26.0,1.0,3.0,2238.0,4.0,0.0,0.0,217.0,Ligue 1
19-06-17,18.3.4.28,Valentin Rosier,50047466,769,19-Aug-96,20,0,0,0,0,3500,6000,6000,129,120,5261792,175,70,D R,1,1,1,3,3,3,2,1,2,1,2,8,12,14,10,13,5,9,10,10,14,14,4,13,12,8,12,10,10,12,14,14,11,13,7,14,12,15,14,14,13,12,7,8,14,13,20,12,11,13,10,16,5,14,9,12,12,9,13,12,14,7,20,10,1,1,20,12,1,D R,102,1,1,1,1,1,1,1,12,20,1,1,1,1,1,10,0.0,0,0,0,0,0,0,0,0,0,0,0,0,0,0,0,0,0,0,0,0,0,0,0,0,0,0,0,0,0,0,0,0,0,0,0,0,0,0,0,0,0,0,0,0,0,0,0,0,Valentin Rosier,Â£4.05m ,24.0,175.0,Defender - Right-Back,right,Besiktas JK,4.0,0.0,0.0,360.0,37.0,0.0,3.0,2914.0,19.0,0.0,4.0,1537.0,17.0,0.0,0.0,1419.0,1.0,0.0,1.0,90.0,Ligue 1
19-06-17,18.3.4.28,Edgar IÃ©,55060508,788,01-May-94,23,0,0,3,1,3700,5750,6200,129,124,7887635,180,80,D RC,2,2,1,3,1,1,3,2,1,2,2,7,9,10,6,11,8,13,8,10,12,10,9,14,12,13,12,11,11,12,8,11,11,9,9,9,12,13,12,14,15,10,10,10,12,13,20,14,13,13,12,10,10,16,14,15,10,12,12,11,11,6,20,10,1,1,16,13,20,D RC,103,1,11,1,1,1,1,20,13,16,9,1,1,1,8,10,4294967296.0,0,0,0,0,0,0,0,0,0,0,0,0,0,0,0,0,0,0,0,0,0,0,0,0,0,0,0,0,0,0,0,0,1,0,0,0,0,0,0,0,0,0,0,0,0,0,0,0,Edgar IÃ©,Â£2.70m ,26.0,182.0,Defender - Centre-Back,right,Trabzonspor,26.0,0.0,0.0,2111.0,37.0,1.0,1.0,3342.0,21.0,0.0,0.0,1380.0,21.0,0.0,0.0,1661.0,6.0,0.0,0.0,399.0,Ligue 1,15-07-16,17.3.2.23,Edgar IÃ©,55060508,788,01-May-94,22,0,0,3,1,3250,5500,5250,124,103,196044,180,80,D RC,3,1,3,2,2,1,4,1,3,3,1,7,9,10,6,10,8,12,8,10,11,10,9,14,12,13,11,11,11,10,8,10,10,9,9,9,10,12,11,14,15,10,10,8,12,12,20,11,9,13,12,10,10,16,14,15,10,12,12,11,11,4,Edgar IÃ©,Â£450Th. ,Liga NOS
19-06-17,18.3.4.28,Milan Gajic,62124118,802,28-Jan-96,21,0,0,18,1,3950,5950,5950,140,119,4078901,178,74,D R,2,2,1,2,2,3,3,1,3,3,2,11,12,11,9,12,11,10,13,9,13,11,9,13,13,12,10,12,13,14,10,11,14,12,11,11,11,15,14,13,13,13,12,8,12,12,20,14,11,14,10,14,9,16,12,13,13,14,13,12,13,9,20,15,8,8,20,13,5,D R,102,1,1,1,1,1,8,1,13,20,8,5,1,8,10,15,800.0,0,0,0,0,0,1,0,0,1,1,0,0,0,0,0,0,0,0,0,0,0,0,0,0,0,0,0,0,0,0,0,0,0,0,0,0,0,0,0,0,0,0,0,0,0,0,0,0,Milan Gajic,Â£1.58m ,24.0,178.0,Defender - Right-Back,both,Red Star Belgrade,21.0,0.0,0.0,1764.0,5.0,0.0,1.0,450.0,14.0,1.0,4.0,1149.0,16.0,1.0,4.0,1237.0,15.0,0.0,2.0,923.0,Ligue 1,15-07-16,17.3.2.23,Milan Gajic,62124118,802,28-Jan-96,20,0,0,9,0,3744,5743,5993,139,119,4164689,178,74,D/WB R,2,2,4,1,3,3,3,1,3,1,2,11,12,11,9,11,11,10,13,9,13,11,9,13,12,12,10,12,13,12,10,11,14,12,11,11,9,14,13,13,12,12,12,8,12,12,20,14,11,14,10,14,9,16,11,13,13,14,13,12,13,9,Milan Gajic,Â£1.58m ,Ligue 1
19-06-17,18.3.4.28,IvÃ¡n Balliu,67053461,752,01-Jan-92,25,0,0,0,0,4000,6200,6200,130,123,5027669,175,68,D/WB R,1,1,3,4,2,1,3,3,2,3,1,8,12,11,7,13,8,9,11,13,10,13,7,12,14,12,11,14,12,11,12,12,14,6,8,13,12,14,14,14,13,10,6,12,14,13,20,15,10,12,6,12,5,15,15,13,10,13,14,15,13,4,20,17,7,1,20,10,1,D/WB R,112,1,1,1,1,1,1,1,10,20,1,1,1,7,7,17,1048584.0,0,0,0,1,0,0,0,0,0,0,0,0,0,0,0,0,0,0,0,0,1,0,0,0,0,0,0,0,0,0,0,0,0,0,0,0,0,0,0,0,0,0,0,0,0,0,0,0,IvÃ¡n Balliu,Â£900Th. ,28.0,172.0,Defender - Right-Back,right,UD AlmerÃ­a,30.0,0.0,5.0,2644.0,28.0,0.0,1.0,2278.0,32.0,1.0,1.0,2496.0,32.0,1.0,4.0,2444.0,6.0,0.0,0.0,540.0,Ligue 1,15-07-16,17.3.2.23,IvÃ¡n Balliu,67053461,796,01-Jan-92,24,0,0,0,0,3246,5696,5696,125,114,1461256,175,68,D/WB R,1,1,1,1,3,3,1,1,1,2,1,8,12,11,7,11,8,9,12,13,11,11,7,12,13,12,11,14,12,11,10,12,14,6,8,13,12,14,14,13,13,10,6,12,14,13,20,14,9,13,6,12,5,15,15,10,10,13,14,15,13,4,IvÃ¡n Balliu,Â£1.80m ,Ligue 1
19-06-17,18.3.4.28,Vincent RÃ¼fli,69004837,798,22-Jan-88,29,1,0,0,0,3250,5500,5700,120,114,1017416,183,76,D RL,1,3,2,2,1,3,2,2,2,2,3,12,13,10,6,12,7,9,11,12,10,11,4,13,11,16,11,13,11,12,10,11,5,6,11,10,12,14,14,12,10,12,9,16,11,13,20,14,12,12,10,12,6,10,12,10,10,11,12,7,8,14,20,14,14,9,20,15,13,D RL,105,1,1,1,1,1,9,13,15,20,1,1,1,14,1,14,0.0,0,0,0,0,0,0,0,0,0,0,0,0,0,0,0,0,0,0,0,0,0,0,0,0,0,0,0,0,0,0,0,0,0,0,0,0,0,0,0,0,0,0,0,0,0,0,0,0,Vincent RÃ¼fli,Â£810Th. ,32.0,183.0,Defender - Right-Back,right,FC St. Gallen 1879,20.0,0.0,3.0,1538.0,3.0,0.0,0.0,22.0,17.0,1.0,1.0,1345.0,18.0,1.0,0.0,697.0,4.0,0.0,0.0,87.0,Ligue 1,15-07-16,17.3.2.23,Vincent RÃ¼fli,69004837,798,22-Jan-88,28,1,0,0,0,3250,5600,5900,120,118,1815477,183,76,D RL,2,2,4,3,1,1,3,1,3,3,3,12,13,10,6,12,7,11,11,12,10,11,4,13,12,16,11,13,11,12,10,11,4,6,11,10,12,14,14,12,10,12,9,16,11,13,20,14,12,10,10,12,6,10,13,13,11,10,13,7,8,14,Vincent RÃ¼fli,Â£810Th. ,Ligue 1
19-06-17,18.3.4.28,Andrea Raggi,837002,776,24-Jun-84,32,0,0,3,0,5750,6500,6600,136,132,4268860,187,82,D RLC,2,3,3,3,1,1,3,3,2,1,3,5,11,8,7,10,6,15,9,14,15,10,8,16,9,16,14,17,12,15,8,12,17,9,17,11,13,15,13,11,11,16,14,6,13,12,20,13,15,13,14,15,8,14,14,14,16,16,16,12,11,7,20,10,1,1,17,16,20,D RLC,106,1,1,1,1,1,1,20,16,17,1,1,1,1,9,10,562967000000000.0,0,0,0,0,0,0,1,0,0,0,0,0,0,0,0,1,0,1,0,0,0,0,0,0,0,0,0,0,0,0,0,0,0,0,1,0,0,0,0,0,0,0,0,0,0,0,0,0,Andrea Raggi,Â£450Th. ,36.0,187.0,Defender - Centre-Back,right,Without Club,37.0,0.0,2.0,2611.0,28.0,1.0,0.0,2300.0,11.0,0.0,0.0,945.0,nan,nan,nan,nan,nan,nan,nan,nan,Ligue 1,15-07-16,17.3.2.23,Andrea Raggi,837002,776,24-Jun-84,32,0,0,3,0,6050,6500,6750,136,135,3507989,187,82,D RC,3,3,2,3,2,3,3,2,4,1,2,5,11,8,7,10,6,15,9,13,15,10,8,16,9,16,14,17,12,15,8,12,17,9,14,11,13,15,13,12,11,16,14,6,13,14,20,13,16,15,14,14,8,14,14,14,15,16,15,12,10,7,Andrea Raggi,Â£1.35m ,Ligue 1
19-06-17,18.3.4.28,Christophe Jallet,8427430,769,31-Oct-83,33,14,1,0,0,3900,6350,6350,141,127,232186002,176,70,D/WB RL,3,1,4,3,3,3,1,3,1,3,2,8,12,10,7,11,8,12,10,12,11,12,12,14,12,10,14,15,14,14,10,13,17,8,10,12,12,15,14,12,12,15,10,9,14,13,20,14,12,15,9,13,8,14,11,15,15,16,17,17,16,5,20,19,1,1,20,16,1,D/WB RL,115,1,1,1,1,1,1,1,16,20,1,1,1,1,15,19,137439000000.0,0,1,0,0,0,0,0,0,0,0,0,0,0,0,0,0,0,0,0,0,0,0,0,0,0,0,0,0,0,0,0,0,0,0,0,0,0,1,0,0,0,0,0,0,0,0,0,0,Christophe Jallet,Â£450Th. ,36.0,178.0,Defender - Right-Back,right,Retired,22.0,1.0,5.0,1778.0,22.0,0.0,0.0,1801.0,17.0,1.0,0.0,1185.0,13.0,1.0,2.0,945.0,nan,nan,nan,nan,Ligue 1,15-07-16,17.3.2.23,Christophe Jallet,8427430,769,31-Oct-83,32,11,1,0,0,5394,6894,6894,141,138,2316830,176,68,D/WB R,2,2,2,2,2,2,4,3,1,2,1,8,10,10,7,11,8,10,11,12,11,13,12,14,12,9,14,15,13,12,11,12,17,8,14,14,11,18,18,14,14,12,10,10,14,13,20,17,13,15,9,13,8,13,15,13,15,16,16,16,18,5,Christophe Jallet,Â£900Th. ,Ligue 1
19-06-17,18.3.4.28,Romain DanzÃ©,8428673,769,03-Jul-86,30,0,0,4,0,3800,6350,6350,133,127,232186002,184,72,D/WB R,1,1,3,3,1,1,3,3,1,2,1,8,13,10,6,11,7,12,8,10,12,11,9,13,11,9,14,14,11,15,10,12,16,9,14,12,14,15,16,12,12,14,12,8,13,13,20,16,12,14,9,16,8,15,7,14,18,14,16,16,16,5,20,17,13,10,20,12,1,D/WB R,112,1,1,1,1,1,10,1,12,20,12,1,8,13,10,17,32.0,0,0,0,0,0,1,0,0,0,0,0,0,0,0,0,0,0,0,0,0,0,0,0,0,0,0,0,0,0,0,0,0,0,0,0,0,0,0,0,0,0,0,0,0,0,0,0,0,Romain DanzÃ©,Â£675Th. ,34.0,184.0,Defender - Right-Back,right,Retired,36.0,0.0,2.0,3181.0,16.0,0.0,0.0,1042.0,0.0,0.0,0.0,0.0,nan,nan,nan,nan,nan,nan,nan,nan,Ligue 1,15-07-16,17.3.2.23,Romain DanzÃ©,8428673,769,03-Jul-86,30,0,0,4,0,4600,6550,6650,134,132,232186002,184,72,D/WB R,4,3,3,2,1,2,3,3,2,2,1,8,13,10,6,11,7,12,8,10,12,11,9,13,11,9,14,14,11,14,10,12,16,9,14,12,13,15,16,15,12,14,12,8,13,14,20,16,12,13,9,16,8,15,12,13,17,14,16,16,16,5,Romain DanzÃ©,Â£1.80m ,Ligue 1
19-06-17,18.3.4.28,Issa Cissokho,8431681,41,23-Feb-85,32,5,0,0,0,3000,5900,5900,125,118,232186002,173,73,D/WB RL,2,1,3,1,4,3,1,1,1,3,1,7,13,9,6,11,10,6,8,11,12,13,8,13,11,11,12,13,10,12,8,8,16,11,6,12,8,12,14,14,13,12,7,8,15,14,20,14,14,12,11,13,8,16,10,13,14,12,14,16,16,6,20,17,15,14,20,15,1,D/WB RL,115,1,1,8,1,14,14,1,15,20,1,1,14,15,15,17,2251800000000000.0,0,0,0,1,0,0,0,0,0,0,0,0,0,0,0,0,0,0,0,0,0,0,0,0,0,0,0,0,0,0,0,0,0,0,0,0,0,0,0,0,0,0,0,0,0,0,0,0,Issa Cissokho,Â£450Th. ,35.0,173.0,Defender - Right-Back,right,Without Club,15.0,0.0,2.0,1339.0,22.0,0.0,0.0,1792.0,26.0,1.0,1.0,2128.0,5.0,0.0,0.0,428.0,nan,nan,nan,nan,Ligue 1,15-07-16,17.3.2.23,Issa Cissokho,8431681,41,23-Feb-85,31,4,0,0,0,2752,5204,5850,132,116,232186002,173,73,D/WB RL,2,3,2,2,1,2,1,1,1,2,1,7,13,9,6,11,10,6,8,11,12,13,8,13,11,11,12,13,10,12,8,8,16,11,6,12,8,12,14,14,13,12,7,8,15,14,20,14,14,12,11,13,8,16,16,13,14,12,14,16,16,6,Issa Cissokho,Â£450Th. ,Serie A
19-06-17,18.3.4.28,Jonathan Martins Pereira,8434189,769,30-Jan-86,31,0,0,0,0,3700,6050,6050,121,121,1993637,182,78,D R,1,3,3,3,3,1,3,1,4,2,2,5,12,12,7,13,7,13,7,12,12,11,6,13,13,14,13,15,11,12,9,11,14,11,9,10,11,13,15,14,13,14,11,8,12,13,20,14,14,13,14,14,13,8,12,13,13,12,14,11,11,7,20,12,1,1,20,7,1,D R,102,1,1,1,1,1,1,1,7,20,1,1,1,1,1,12,10.0,0,1,0,1,0,0,0,0,0,0,0,0,0,0,0,0,0,0,0,0,0,0,0,0,0,0,0,0,0,0,0,0,0,0,0,0,0,0,0,0,0,0,0,0,0,0,0,0,Jonathan Martins Pereira,Â£1.35m ,34.0,182.0,Defender - Right-Back,right,Retired,17.0,0.0,0.0,1268.0,14.0,0.0,0.0,1137.0,1.0,0.0,0.0,12.0,nan,nan,nan,nan,nan,nan,nan,nan,Ligue 1,15-07-16,17.3.2.23,Jonathan Martins Pereira,8434189,769,30-Jan-86,30,0,0,0,0,3700,5950,6050,124,121,1114805,182,71,D R,2,3,1,3,1,4,3,3,2,3,1,5,12,12,7,12,7,13,7,11,12,11,6,13,13,14,13,14,8,12,9,11,14,11,9,11,10,13,15,14,13,14,11,8,13,13,20,14,14,13,14,14,10,8,9,13,13,12,14,11,11,7,Jonathan Martins Pereira,Â£900Th. ,Ligue 1
19-06-17,18.3.4.28,Romain Genevois,8443040,375,28-Oct-87,29,10,0,1,0,3850,6250,6250,127,125,4846362,182,79,D RC,4,1,3,4,3,1,4,1,1,2,2,5,9,9,9,11,6,13,8,12,14,9,8,14,11,14,14,15,11,13,7,12,16,8,8,9,13,13,14,15,12,13,11,6,14,14,20,15,15,12,14,13,7,15,11,13,10,11,8,13,16,5,20,15,12,1,15,1,20,D RC,103,1,1,8,1,1,1,20,1,15,10,1,1,12,1,15,32.0,0,0,0,0,0,1,0,0,0,0,0,0,0,0,0,0,0,0,0,0,0,0,0,0,0,0,0,0,0,0,0,0,0,0,0,0,0,0,0,0,0,0,0,0,0,0,0,0,Romain Genevois,Â£1.80m ,32.0,182.0,Defender - Centre-Back,right,Without Club,16.0,0.0,0.0,1129.0,26.0,1.0,1.0,2024.0,6.0,0.0,0.0,358.0,nan,nan,nan,nan,nan,nan,nan,nan,Ligue 1,15-07-16,17.3.2.23,Romain Genevois,8443040,375,28-Oct-87,28,8,0,1,0,3995,6295,6295,126,124,5177752,182,79,D RC,1,3,1,1,1,1,1,1,3,2,1,5,9,9,9,11,6,13,8,12,14,9,8,14,11,14,14,15,10,13,7,12,16,8,8,9,14,13,14,15,12,13,11,5,13,14,20,15,14,12,14,13,7,15,13,13,11,10,11,11,13,5,Romain Genevois,Â£1.35m ,Ligue 1
19-06-17,18.3.4.28,Paul Baysse,8448625,769,18-May-88,29,0,0,6,1,4500,6550,6550,144,131,10187001,185,82,D RC,1,2,2,2,3,1,2,3,4,3,2,4,12,7,7,11,6,15,9,13,14,13,6,14,11,15,14,17,13,14,11,13,13,7,12,8,14,16,15,12,12,8,13,8,12,11,20,14,15,13,6,15,10,8,12,15,12,12,13,14,14,5,20,10,1,1,16,8,20,D RC,103,1,1,1,1,1,1,20,8,16,1,1,1,1,8,10,0.0,0,0,0,0,0,0,0,0,0,0,0,0,0,0,0,0,0,0,0,0,0,0,0,0,0,0,0,0,0,0,0,0,0,0,0,0,0,0,0,0,0,0,0,0,0,0,0,0,Paul Baysse,Â£2.25m ,32.0,185.0,Defender - Centre-Back,right,FC Girondins Bordeaux,25.0,2.0,1.0,2126.0,24.0,1.0,0.0,1896.0,26.0,0.0,0.0,2273.0,0.0,0.0,0.0,0.0,7.0,0.0,0.0,512.0,LaLiga,15-07-16,17.3.2.23,Paul Baysse,8448625,769,18-May-88,28,0,0,9,1,4395,6345,6545,134,132,6479320,187,85,D RC,2,3,2,1,1,2,2,1,2,3,4,4,10,7,7,11,8,16,11,13,14,10,6,14,11,14,14,17,11,14,8,13,14,7,12,7,13,16,15,12,12,15,13,8,14,11,20,14,15,15,6,15,8,8,20,15,12,12,13,14,14,5,Paul Baysse,Â£3.15m ,Ligue 1
19-06-17,18.3.4.28,KÃ©vin ThÃ©ophile-Catherine,8449438,769,28-Oct-89,27,0,0,1,0,3950,6300,6300,135,126,5265144,180,77,D RC,2,2,1,3,3,3,3,1,2,1,1,7,12,12,6,11,7,13,11,11,13,10,7,12,11,12,13,14,12,11,10,11,15,9,8,8,13,13,14,16,12,14,12,8,14,14,20,15,14,12,12,13,5,14,11,8,14,9,12,13,14,6,20,15,1,1,20,13,16,D RC,103,1,1,1,1,1,1,16,13,20,8,1,1,1,10,15,1099510000000.0,0,1,0,0,0,1,0,0,0,0,0,0,0,0,0,0,0,0,0,0,0,0,0,0,0,0,0,0,0,0,0,0,0,0,0,0,0,0,0,0,1,0,0,0,0,0,0,0,KÃ©vin ThÃ©ophile-Catherine,Â£3.60m ,30.0,183.0,Defender - Centre-Back,right,GNK Dinamo Zagreb,42.0,0.0,2.0,3719.0,27.0,0.0,1.0,2374.0,32.0,1.0,0.0,2898.0,26.0,1.0,2.0,2307.0,9.0,0.0,0.0,689.0,Ligue 1,15-07-16,17.3.2.23,KÃ©vin ThÃ©ophile-Catherine,8449438,769,28-Oct-89,26,0,0,1,0,4450,6350,6350,135,127,5911812,180,77,D RC,3,4,1,4,2,2,2,2,2,1,3,7,12,12,6,11,7,13,11,11,13,10,7,12,11,12,13,14,12,11,10,11,15,9,8,8,13,13,14,16,12,14,12,8,14,14,20,15,14,13,12,13,5,14,11,8,14,9,12,13,14,6,KÃ©vin ThÃ©ophile-Catherine,Â£3.60m ,Ligue 1
19-06-17,18.3.4.28,Arnaud Souquet,85014379,769,12-Feb-92,25,0,0,2,0,4000,6400,6400,131,128,7574176,179,72,D/WB RC,2,1,2,3,3,1,3,3,2,3,4,12,13,12,7,13,12,6,10,6,9,14,10,10,13,9,12,12,13,14,12,13,17,10,9,14,10,15,14,14,14,12,7,8,14,13,20,14,11,14,12,13,7,15,14,14,13,13,15,14,15,7,20,19,15,12,20,1,15,D/WB RC,113,1,1,1,10,1,12,1,1,20,13,15,1,15,1,19,8796090000000.0,0,0,0,0,0,0,0,0,0,0,0,0,0,0,0,0,0,0,0,0,0,0,0,0,0,0,0,0,0,0,0,0,0,0,0,0,0,0,0,0,0,0,0,1,0,0,0,0,Arnaud Souquet,Â£4.05m ,28.0,179.0,Defender - Right-Back,right,Montpellier HSC,31.0,1.0,5.0,2768.0,39.0,1.0,4.0,3299.0,36.0,0.0,3.0,3090.0,28.0,2.0,2.0,2315.0,7.0,1.0,0.0,570.0,Ligue 1,15-07-16,17.3.2.23,Arnaud Souquet,85014379,769,12-Feb-92,24,0,0,2,0,3750,5850,6350,131,127,7310305,179,72,D/M RC,4,3,3,3,2,1,1,2,3,1,2,12,14,12,7,13,12,6,10,5,10,13,10,12,13,12,13,11,12,12,12,12,17,8,9,13,11,14,15,14,13,12,7,8,14,13,20,15,10,14,12,14,8,15,19,14,13,9,14,15,15,7,Arnaud Souquet,Â£3.15m ,Ligue 1
19-06-17,18.3.4.28,Yoann Andreu,85016145,769,03-May-89,28,0,0,0,0,3800,6250,6250,125,125,5675627,175,64,D RL,1,1,3,4,1,1,2,2,1,2,1,7,13,9,6,12,6,12,10,10,14,13,6,13,12,14,13,13,12,12,10,12,14,7,9,11,12,13,15,14,13,15,11,10,12,12,20,14,12,12,12,13,10,10,20,12,14,13,14,15,15,6,20,15,1,1,20,16,1,D RL,105,1,1,1,1,1,1,1,16,20,10,1,1,1,15,15,0.0,0,0,0,0,0,0,0,0,0,0,0,0,0,0,0,0,0,0,0,0,0,0,0,0,0,0,0,0,0,0,0,0,0,0,0,0,0,0,0,0,0,0,0,0,0,0,0,0,Yoann Andreu,Â£1.58m ,31.0,178.0,Defender - Left-Back,right,Retired,17.0,0.0,1.0,1458.0,23.0,1.0,2.0,2070.0,2.0,0.0,0.0,123.0,nan,nan,nan,nan,nan,nan,nan,nan,Ligue 1,15-07-16,17.3.2.23,Yoann Andreu,85016145,769,03-May-89,27,0,0,0,0,3800,6250,6250,125,125,3902265,175,64,D RL,1,2,3,2,1,3,3,2,2,3,1,7,13,9,6,12,6,12,10,10,14,13,6,13,12,14,13,13,12,12,10,12,14,7,9,11,12,13,15,14,13,15,11,10,12,12,20,14,12,12,12,13,10,10,11,12,14,13,14,15,15,6,Yoann Andreu,Â£1.58m ,Ligue 1
19-06-17,18.3.4.28,Dimitri Foulquier,85045661,769,23-Mar-93,24,0,0,8,0,3950,6150,6150,138,123,5061599,183,77,D RL,3,1,2,1,3,1,1,2,4,4,1,7,13,12,7,12,6,8,9,11,12,9,7,12,12,10,12,14,13,12,11,10,14,11,7,13,12,12,13,16,13,14,11,8,15,15,20,13,13,11,10,13,7,8,11,13,14,10,14,15,15,5,20,15,12,10,20,18,1,D RL,105,1,1,1,1,9,10,1,18,20,1,1,10,12,14,15,2251800000000000.0,0,0,0,1,0,0,0,0,0,0,0,0,0,0,0,0,0,0,0,0,0,0,0,0,0,0,0,0,0,0,0,0,0,0,0,0,0,0,0,0,0,0,0,0,0,0,0,0,Dimitri Foulquier,Â£1.80m ,27.0,183.0,Defender - Right-Back,right,Granada CF,22.0,0.0,2.0,1868.0,19.0,0.0,2.0,1563.0,29.0,3.0,3.0,2093.0,27.0,1.0,0.0,1857.0,8.0,0.0,1.0,631.0,Ligue 1,15-07-16,17.3.2.23,Dimitri Foulquier,85045661,769,23-Mar-93,23,0,0,8,0,4250,5700,6250,141,125,4489915,183,77,D RL,2,3,2,3,2,2,4,3,1,1,2,7,13,12,7,12,6,8,9,11,12,9,7,12,12,10,12,14,13,12,11,11,15,11,7,13,12,12,13,16,13,14,11,8,15,15,20,13,13,11,10,13,7,8,11,13,14,11,14,15,15,5,Dimitri Foulquier,Â£1.80m ,LaLiga
19-06-17,18.3.4.28,Ruben Aguilar,85046582,769,26-Apr-93,24,0,0,0,0,3800,6350,6350,131,127,8574545,172,70,D/WB R,3,2,1,3,3,1,2,2,3,1,3,5,15,11,7,12,6,9,7,11,15,13,8,14,13,14,13,15,12,14,12,13,16,10,8,12,10,14,16,13,13,15,6,7,14,14,20,15,12,14,12,12,10,11,12,14,14,12,15,12,10,6,20,17,1,1,20,13,1,D/WB R,112,1,1,1,1,1,1,1,13,20,1,1,1,1,10,17,32.0,0,0,0,0,0,1,0,0,0,0,0,0,0,0,0,0,0,0,0,0,0,0,0,0,0,0,0,0,0,0,0,0,0,0,0,0,0,0,0,0,0,0,0,0,0,0,0,0,Ruben Aguilar,Â£5.40m ,27.0,172.0,Defender - Right-Back,right,AS Monaco,34.0,0.0,0.0,3073.0,38.0,0.0,2.0,3030.0,30.0,1.0,5.0,2622.0,23.0,1.0,4.0,1415.0,8.0,1.0,1.0,720.0,Ligue 1
19-06-17,18.3.4.28,Kenny Lala,85051366,769,03-Oct-91,25,0,0,0,0,3800,6400,6400,129,128,8470046,178,77,D/WB RC,2,2,2,1,3,3,3,1,3,3,3,5,13,11,7,12,6,12,8,12,10,11,13,12,12,12,12,14,13,12,11,12,15,10,10,13,11,14,15,14,12,15,10,7,16,15,20,16,14,14,11,13,5,8,18,15,12,13,13,12,14,6,20,16,1,1,20,13,15,D/WB RC,113,1,1,1,1,1,1,15,13,20,1,1,1,1,13,16,134217728.0,0,0,0,0,0,0,0,0,0,0,0,0,0,0,0,0,0,0,0,0,0,0,0,0,0,0,0,1,0,0,0,0,0,0,0,0,0,0,0,0,0,0,0,0,0,0,0,0,Kenny Lala,Â£4.50m ,29.0,178.0,Defender - Right-Back,right,RC Strasbourg Alsace,40.0,1.0,3.0,3600.0,37.0,3.0,6.0,3166.0,40.0,5.0,10.0,3460.0,33.0,2.0,1.0,2540.0,8.0,1.0,0.0,694.0,Ligue 1
19-06-17,18.3.4.28,Jonathan Rivierez,85055657,769,18-May-89,28,0,0,0,0,3600,5500,5500,116,109,847791,181,79,D/WB RC,2,2,3,1,3,3,1,3,1,4,3,5,12,10,5,10,6,11,7,8,12,9,7,12,11,13,13,14,13,12,9,9,13,9,7,8,13,13,13,15,12,13,10,5,13,13,20,15,14,14,13,5,6,10,10,13,13,13,14,14,14,5,20,16,1,1,20,10,17,D/WB RC,113,1,1,1,1,1,1,17,10,20,1,1,1,1,10,16,0.0,0,0,0,0,0,0,0,0,0,0,0,0,0,0,0,0,0,0,0,0,0,0,0,0,0,0,0,0,0,0,0,0,0,0,0,0,0,0,0,0,0,0,0,0,0,0,0,0,Jonathan Rivierez,Â£720Th. ,31.0,182.0,Defender - Centre-Back,right,SM Caen,18.0,0.0,1.0,1418.0,28.0,0.0,2.0,2271.0,20.0,0.0,0.0,1129.0,33.0,2.0,0.0,2924.0,8.0,0.0,0.0,720.0,Ligue 1,15-07-16,17.3.2.23,Jonathan Rivierez,85055657,769,18-May-89,27,0,0,0,0,3597,5697,5697,116,110,1156271,181,79,D/WB RC,3,3,1,3,4,3,2,2,2,3,2,5,12,10,5,10,6,11,7,8,12,9,7,12,11,13,13,14,13,12,9,9,13,9,7,8,13,13,13,15,12,13,10,5,13,13,20,15,14,15,13,10,6,10,17,13,13,13,14,14,14,5,Jonathan Rivierez,Â£720Th. ,Ligue 1
19-06-17,18.3.4.28,Youssouf Sabaly,85057304,41,05-Mar-93,24,0,0,0,0,4250,6500,6550,135,131,11897004,174,70,D/WB R,3,3,3,1,1,3,1,1,4,2,1,8,12,12,8,11,7,10,9,12,12,10,10,14,12,13,13,12,12,13,10,13,13,12,10,14,11,14,15,15,14,15,10,8,16,14,20,15,13,14,12,12,8,13,14,14,15,12,13,11,10,6,20,17,1,1,20,14,1,D/WB R,112,1,1,1,1,1,1,1,14,20,1,1,1,1,12,17,134217760.0,0,0,0,0,0,1,0,0,0,0,0,0,0,0,0,0,0,0,0,0,0,0,0,0,0,0,0,1,0,0,0,0,0,0,0,0,0,0,0,0,0,0,0,0,0,0,0,0,Youssouf Sabaly,Â£6.30m ,27.0,174.0,Defender - Right-Back,right,FC Girondins Bordeaux,33.0,0.0,5.0,2739.0,39.0,0.0,6.0,3406.0,31.0,0.0,3.0,2630.0,14.0,0.0,1.0,1067.0,8.0,0.0,0.0,711.0,Ligue 1,15-07-16,17.3.2.23,Youssouf Sabaly,85057304,769,05-Mar-93,23,0,0,0,0,4234,6134,6334,136,127,6614632,174,64,D/WB RL,3,1,1,4,3,3,2,1,2,2,2,8,12,10,8,11,7,10,9,12,14,9,10,13,12,12,12,12,11,12,10,12,13,8,9,12,11,13,14,15,14,11,10,10,14,14,20,15,10,14,12,12,8,13,10,12,15,12,13,14,18,7,Youssouf Sabaly,Â£4.05m ,Ligue 1
19-06-17,18.3.4.28,JÃ©rÃ©my Cordoval,85058781,769,12-Jan-90,27,0,0,0,0,2750,5500,5500,111,110,852722,167,67,D RL,1,3,1,2,2,3,1,3,3,1,3,7,11,11,5,12,6,6,7,10,12,12,6,12,13,11,11,10,12,12,9,11,13,7,5,8,11,13,13,15,14,10,6,7,15,15,20,14,8,12,8,13,7,10,10,13,13,14,14,16,16,6,20,15,12,1,20,15,1,D RL,105,1,1,1,1,1,1,1,15,20,10,1,1,12,15,15,0.0,0,0,0,0,0,0,0,0,0,0,0,0,0,0,0,0,0,0,0,0,0,0,0,0,0,0,0,0,0,0,0,0,0,0,0,0,0,0,0,0,0,0,0,0,0,0,0,0,JÃ©rÃ©my Cordoval,Â£900Th. ,30.0,169.0,Defender - Right-Back,right,LB ChÃ¢teauroux,32.0,0.0,1.0,2456.0,13.0,0.0,1.0,1098.0,30.0,1.0,0.0,2329.0,16.0,0.0,1.0,1237.0,5.0,0.0,0.0,349.0,Ligue 1
19-06-17,18.3.4.28,KÃ©vin Malcuit,85067228,769,31-Jul-91,25,0,0,0,0,4100,6550,6550,134,132,9677020,181,73,D/WB/M R,4,3,1,2,3,1,2,2,3,2,2,6,13,13,9,12,6,9,9,5,11,12,9,12,12,13,13,14,12,12,8,12,14,13,6,14,10,13,15,15,13,14,12,6,14,16,20,15,14,14,9,13,12,12,13,15,12,12,13,15,15,8,20,18,16,15,20,1,1,D/WB/M R,122,1,1,1,1,1,15,1,1,20,1,1,1,16,1,18,2251800000000000.0,0,0,0,1,0,0,0,0,0,0,0,0,0,0,0,0,0,0,0,0,0,0,0,0,0,0,0,0,0,0,0,0,0,0,0,0,0,0,0,0,0,0,0,0,0,0,0,0,KÃ©vin Malcuit,Â£6.75m ,29.0,178.0,Defender - Right-Back,right,SSC Napoli,34.0,0.0,4.0,2935.0,25.0,0.0,5.0,1932.0,27.0,0.0,3.0,1992.0,6.0,0.0,1.0,403.0,1.0,0.0,0.0,15.0,Ligue 1,15-07-16,17.3.2.23,KÃ©vin Malcuit,85067228,34,31-Jul-91,24,0,0,0,0,3798,6498,6448,136,130,8692123,181,73,D/WB/M/AM R,1,1,1,2,4,1,1,1,1,1,2,6,12,13,9,12,6,9,9,5,11,12,9,12,13,13,11,14,10,11,8,10,14,13,6,12,8,10,13,16,13,13,12,5,14,17,20,13,14,12,9,13,12,12,16,14,13,12,11,15,15,8,KÃ©vin Malcuit,Â£2.70m ,Ligue 1
19-06-17,18.3.4.28,Jordan Ikoko,85072032,53,03-Feb-94,23,4,0,0,0,3900,6150,6150,131,123,6548254,177,60,D R,1,3,1,1,3,1,3,1,2,2,4,6,12,12,8,13,7,8,10,10,11,11,8,13,12,11,12,12,11,12,10,12,13,6,7,13,9,13,15,16,14,14,9,8,14,14,20,15,12,12,8,13,6,14,12,13,14,13,15,14,15,6,20,15,1,1,20,10,1,D R,102,1,1,1,1,1,1,1,10,20,1,1,1,1,7,15,1048578.0,0,1,0,0,0,0,0,0,0,0,0,0,0,0,0,0,0,0,0,0,1,0,0,0,0,0,0,0,0,0,0,0,0,0,0,0,0,0,0,0,0,0,0,0,0,0,0,0,Jordan Ikoko,Â£1.35m ,26.0,178.0,Defender - Right-Back,right,PFK Ludogorets Razgrad,32.0,0.0,1.0,2672.0,30.0,0.0,3.0,2598.0,21.0,0.0,0.0,1737.0,23.0,2.0,1.0,1660.0,2.0,0.0,0.0,6.0,Ligue 1,15-07-16,17.3.2.23,Jordan Ikoko,85072032,769,03-Feb-94,22,0,0,0,0,3700,5700,6200,134,119,7160276,178,73,D R,2,2,3,1,4,3,1,2,2,1,3,6,12,12,6,11,7,8,8,11,12,10,8,13,11,12,12,13,11,10,11,11,13,6,7,12,9,13,14,16,14,13,9,6,14,15,20,15,14,12,12,13,6,14,8,15,13,13,14,14,14,6,Jordan Ikoko,Â£1.35m ,Ligue 1
19-06-17,18.3.4.28,Bouna Sarr,85072773,22,31-Jan-92,25,0,0,0,0,3800,6300,6300,127,126,7413376,177,65,D/AM RL,4,1,3,2,2,3,4,2,2,1,2,8,11,13,10,13,8,10,11,7,5,12,13,8,13,8,11,9,10,9,9,10,12,12,5,13,8,7,10,16,15,12,8,10,15,15,20,14,11,12,8,13,7,12,10,14,13,13,9,9,11,10,16,1,10,20,20,15,12,D/AM RL,525,1,1,1,12,15,20,1,1,16,8,10,10,10,1,1,2251830000000000.0,0,0,0,0,0,0,0,0,0,0,0,0,0,0,0,0,0,0,0,0,0,0,0,0,0,0,0,0,0,0,0,0,0,0,0,1,0,0,0,0,0,0,0,0,0,0,0,0,Bouna Sarr,Â£5.40m ,28.0,177.0,Defender - Right-Back,right,Bayern Munich,29.0,1.0,2.0,1270.0,48.0,1.0,4.0,3109.0,37.0,1.0,1.0,2654.0,32.0,2.0,3.0,2535.0,5.0,0.0,3.0,271.0,Ligue 1,15-07-16,17.3.2.23,Bouna Sarr,85072773,22,31-Jan-92,24,0,0,0,0,4100,6250,6200,134,124,7108269,177,65,AM RL,1,2,1,2,2,2,2,4,1,3,2,8,11,13,10,13,8,10,11,7,5,12,13,6,13,8,11,9,10,9,9,11,13,12,5,12,8,7,9,16,15,12,8,10,15,15,20,14,12,11,8,13,7,12,7,14,13,13,9,8,11,10,Bouna Sarr,Â£1.80m ,Ligue 1
19-06-17,18.3.4.28,Christophe HÃ©relle,85076637,769,22-Aug-92,24,0,0,0,0,3500,6250,6250,129,125,6720288,188,75,D/DM RC,2,2,4,1,3,2,3,3,1,3,1,4,10,7,5,10,7,13,10,5,14,11,6,14,13,14,14,15,12,12,8,13,12,5,6,10,14,13,14,13,13,15,14,5,15,12,20,14,14,12,10,12,7,12,9,13,10,7,12,10,10,8,20,13,1,1,16,1,20,D/DM RC,113,1,1,1,1,1,1,20,1,16,16,1,1,1,1,13,0.0,0,0,0,0,0,0,0,0,0,0,0,0,0,0,0,0,0,0,0,0,0,0,0,0,0,0,0,0,0,0,0,0,0,0,0,0,0,0,0,0,0,0,0,0,0,0,0,0,Christophe HÃ©relle,Â£5.40m ,28.0,188.0,Defender - Centre-Back,right,Stade Brest 29,36.0,0.0,0.0,2829.0,35.0,0.0,0.0,3049.0,34.0,0.0,0.0,3028.0,18.0,3.0,0.0,1363.0,5.0,0.0,0.0,433.0,Ligue 1
19-06-17,18.3.4.28,Mathieu Deplagne,85077401,769,01-Oct-91,25,0,0,0,0,3750,6050,6050,127,121,3242331,183,78,D R,3,1,1,3,2,3,4,1,3,3,2,5,10,9,5,12,11,12,11,11,13,13,11,15,10,15,14,14,13,15,10,14,14,6,6,9,14,13,14,12,12,14,11,5,15,11,20,14,14,13,13,12,7,10,7,13,16,13,15,15,15,5,20,15,1,1,20,10,1,D R,102,1,1,5,1,1,1,1,10,20,1,1,1,1,10,15,32.0,0,0,0,0,0,1,0,0,0,0,0,0,0,0,0,0,0,0,0,0,0,0,0,0,0,0,0,0,0,0,0,0,0,0,0,0,0,0,0,0,0,0,0,0,0,0,0,0,Mathieu Deplagne,Â£1.13m ,29.0,183.0,Defender - Right-Back,right,FC Cincinnati,21.0,0.0,0.0,1288.0,31.0,0.0,2.0,2622.0,39.0,1.0,1.0,3448.0,16.0,0.0,0.0,1264.0,nan,nan,nan,nan,Ligue 1,15-07-16,17.3.2.23,Mathieu Deplagne,85077401,769,01-Oct-91,24,0,0,0,0,3318,6200,6200,131,120,5208941,183,78,D R,3,2,4,1,3,3,3,4,1,1,2,5,10,9,5,12,11,12,11,8,13,13,11,14,10,15,14,14,13,15,10,14,14,6,6,9,14,13,14,12,12,14,11,5,15,11,20,14,14,14,13,12,7,10,7,13,16,13,15,15,15,5,Mathieu Deplagne,Â£1.13m ,Ligue 1
19-06-17,18.3.4.28,LÃ©o Dubois,85085148,769,14-Sep-94,22,0,0,0,0,3900,6550,6550,141,131,8989770,178,65,D/WB R,1,2,3,2,1,3,2,3,2,2,2,14,14,11,7,13,12,9,10,11,13,12,7,14,13,8,12,13,13,14,13,13,13,9,13,13,13,14,15,12,14,13,11,10,15,12,20,14,11,15,8,11,7,10,10,14,13,12,12,15,16,6,20,16,1,1,20,14,1,D/WB R,112,1,1,1,1,1,1,1,14,20,10,1,1,1,13,16,72.0,0,0,0,1,0,0,1,0,0,0,0,0,0,0,0,0,0,0,0,0,0,0,0,0,0,0,0,0,0,0,0,0,0,0,0,0,0,0,0,0,0,0,0,0,0,0,0,0,LÃ©o Dubois,Â£9.00m ,26.0,178.0,Defender - Right-Back,right,Olympique Lyon,41.0,0.0,8.0,3478.0,35.0,4.0,5.0,3114.0,34.0,3.0,6.0,2642.0,28.0,0.0,2.0,2312.0,8.0,1.0,0.0,641.0,Ligue 1,15-07-16,17.3.2.23,LÃ©o Dubois,85085148,769,14-Sep-94,21,0,0,0,0,2940,5796,5796,138,116,2862938,178,65,D/WB R,2,4,1,1,3,2,1,1,2,2,1,9,13,11,6,12,7,9,8,8,13,12,7,13,12,8,12,13,12,12,13,13,14,9,8,12,12,13,13,12,14,13,11,8,15,12,20,13,12,14,8,11,7,10,12,10,13,10,9,15,15,6,LÃ©o Dubois,Â£1.80m ,Ligue 1
19-06-17,18.3.4.28,Jordan Leborgne,85093003,769,29-Sep-95,21,0,0,0,0,2500,5200,5200,107,105,939361,173,64,WB/M RC,3,2,1,1,2,2,3,1,3,1,1,12,11,13,9,12,11,10,10,7,12,14,11,11,11,10,8,12,10,10,10,11,10,11,1,12,11,12,16,13,13,15,7,7,14,12,20,11,8,6,11,5,10,10,20,11,11,10,11,8,17,2,15,17,20,5,17,1,20,WB/M RC,423,1,1,1,1,1,5,1,1,15,15,20,1,13,1,17,0.0,0,0,0,0,0,0,0,0,0,0,0,0,0,0,0,0,0,0,0,0,0,0,0,0,0,0,0,0,0,0,0,0,0,0,0,0,0,0,0,0,0,0,0,0,0,0,0,0,Jordan Leborgne,Â£360Th. ,25.0,173.0,Midfielder - Central Midfield,right,Rodez AF,8.0,0.0,0.0,347.0,0.0,0.0,0.0,0.0,nan,nan,nan,nan,2.0,0.0,0.0,180.0,4.0,0.0,0.0,189.0,Ligue 1,15-07-16,17.3.2.23,Jordan Leborgne,85093003,769,29-Sep-95,20,0,0,0,0,1744,4944,4944,114,99,733055,173,64,M C,3,3,2,3,3,2,1,3,4,1,1,12,11,13,9,12,11,10,10,4,12,14,11,11,11,10,8,12,10,10,10,11,6,11,13,12,11,12,16,13,13,15,7,5,14,12,20,11,8,10,11,4,6,10,15,11,11,12,9,10,13,2,Jordan Leborgne,Â£630Th. ,Ligue 1
19-06-17,18.3.4.28,FrÃ©dÃ©ric Guilbert,85096693,769,24-Dec-94,22,0,0,1,0,4000,6200,6200,136,124,9154263,177,68,D RC,2,1,2,1,1,2,3,3,3,2,1,5,12,9,7,12,8,13,10,16,11,12,8,14,12,12,13,12,12,12,10,13,14,11,13,11,12,13,14,13,14,13,11,10,14,12,20,12,14,12,11,12,8,14,13,12,14,12,14,12,12,5,20,12,1,1,18,1,20,D RC,103,1,13,1,1,1,1,20,1,18,11,1,1,1,1,12,0.0,0,0,0,0,0,0,0,0,0,0,0,0,0,0,0,0,0,0,0,0,0,0,0,0,0,0,0,0,0,0,0,0,0,0,0,0,0,0,0,0,0,0,0,0,0,0,0,0,FrÃ©dÃ©ric Guilbert,Â£5.40m ,25.0,178.0,Defender - Right-Back,right,Aston Villa,29.0,0.0,1.0,2458.0,42.0,1.0,3.0,3840.0,38.0,1.0,2.0,3291.0,29.0,2.0,2.0,2352.0,2.0,0.0,0.0,180.0,Ligue 1,15-07-16,17.3.2.23,FrÃ©dÃ©ric Guilbert,85096693,769,24-Dec-94,21,0,0,1,0,4002,5796,6196,145,123,9366999,177,68,D RC,2,4,2,3,1,3,3,1,1,1,1,5,12,9,7,12,8,13,10,16,13,12,8,14,12,12,13,12,12,12,10,13,15,11,13,11,13,13,14,13,14,13,11,10,14,12,20,12,14,12,11,12,8,14,13,10,14,12,14,12,11,5,FrÃ©dÃ©ric Guilbert,Â£2.25m ,Ligue 1
19-06-17,18.3.4.28,BaÄssama Sankoh,85097012,22,20-Mar-92,25,14,0,0,0,3250,5800,5800,121,116,2200882,180,73,D RC,2,2,3,1,1,2,3,2,2,1,3,5,10,8,5,11,6,13,9,6,14,12,5,13,11,10,12,13,11,13,9,11,14,8,7,8,11,13,14,15,12,14,10,6,15,14,20,13,14,12,7,7,8,11,10,12,15,9,13,10,13,6,20,10,1,1,19,1,20,D RC,103,1,1,1,1,1,1,20,1,19,14,1,1,1,1,10,0.0,0,0,0,0,0,0,0,0,0,0,0,0,0,0,0,0,0,0,0,0,0,0,0,0,0,0,0,0,0,0,0,0,0,0,0,0,0,0,0,0,0,0,0,0,0,0,0,0,Baissama Sankoh,Â£720Th. ,28.0,180.0,Midfielder - Defensive Midfield,right,Nea Salamina Famagusta,21.0,0.0,0.0,1462.0,30.0,0.0,0.0,1922.0,19.0,0.0,0.0,927.0,10.0,4.0,0.0,805.0,3.0,0.0,0.0,158.0,Ligue 1,15-07-16,17.3.2.23,BaÄssama Sankoh,85097012,22,20-Mar-92,24,10,0,0,0,3000,5650,5650,122,113,1982490,180,73,D RC,4,3,1,2,1,2,4,2,4,3,3,5,10,8,5,8,6,13,11,6,14,12,8,13,10,12,13,13,11,12,9,12,14,1,7,7,12,12,13,15,11,13,10,5,15,14,20,12,14,12,12,6,8,11,13,9,9,11,12,12,10,7,Baissama Sankoh,Â£720Th. ,Ligue 1
19-06-17,18.3.4.28,Steeve Yago,85100394,9,16-Dec-92,24,36,0,0,0,3750,6100,6000,129,119,3287468,180,77,D RC,3,2,3,3,3,3,3,3,2,3,1,6,11,11,6,13,7,11,5,8,14,10,9,12,9,15,14,17,10,12,8,13,14,7,8,7,10,13,15,15,13,13,10,5,14,14,20,15,14,10,15,11,7,11,12,12,14,15,13,12,14,2,20,15,1,1,20,10,19,D RC,103,1,1,1,1,1,1,19,10,20,1,1,1,1,10,15,0.0,0,0,0,0,0,0,0,0,0,0,0,0,0,0,0,0,0,0,0,0,0,0,0,0,0,0,0,0,0,0,0,0,0,0,0,0,0,0,0,0,0,0,0,0,0,0,0,0,Steeve Yago,Â£1.80m ,27.0,178.0,Defender - Centre-Back,right,SM Caen,24.0,0.0,1.0,2072.0,27.0,0.0,0.0,2076.0,14.0,0.0,1.0,1206.0,18.0,0.0,0.0,1492.0,6.0,0.0,0.0,405.0,Ligue 1,15-07-16,17.3.2.23,Steeve Yago,85100394,769,16-Dec-92,23,0,0,0,0,3966,5950,6300,130,122,7732528,180,77,D RC,1,3,3,2,1,3,1,1,1,4,3,6,11,11,6,13,7,11,5,8,14,12,9,12,9,15,14,17,10,14,8,13,14,7,8,7,10,13,15,15,13,13,10,5,14,14,20,15,14,14,15,10,7,11,10,9,14,15,13,12,14,2,Steeve Yago,Â£1.80m ,Ligue 1
19-06-17,18.3.4.28,Fouad Chafik,85116902,34,16-Oct-86,30,9,0,0,0,3750,6150,6150,127,123,232186002,183,72,D R,2,3,1,3,2,1,3,3,1,3,2,2,13,11,7,14,8,8,10,10,13,13,8,14,11,14,13,10,12,13,10,12,11,12,4,14,12,13,15,14,13,13,11,8,14,15,20,14,12,13,2,13,7,8,19,14,12,12,12,9,11,1,20,15,15,12,20,10,1,D R,102,1,1,1,1,1,12,1,10,20,1,1,1,15,8,15,2251800000000000.0,0,0,0,0,0,0,0,0,0,0,0,0,0,0,0,0,0,0,0,0,0,0,0,0,0,0,0,0,0,0,0,0,0,0,0,0,0,0,0,0,0,0,0,0,0,0,0,0,Fouad Chafik,Â£1.35m ,34.0,183.0,Defender - Right-Back,right,Dijon FCO,28.0,0.0,1.0,2519.0,23.0,0.0,2.0,1695.0,26.0,0.0,2.0,2206.0,23.0,0.0,3.0,1830.0,7.0,0.0,0.0,551.0,Ligue 1,15-07-16,17.3.2.23,Fouad Chafik,85116902,34,16-Oct-86,29,6,0,0,0,3056,5900,5900,120,118,1335218,183,72,D R,2,1,3,2,2,1,1,1,2,3,2,2,13,13,8,14,8,10,12,10,12,13,8,14,10,14,13,10,12,12,10,12,5,12,4,14,12,13,14,14,13,13,11,5,14,15,20,14,11,13,2,12,7,8,18,11,9,12,10,2,14,8,Fouad Chafik,Â£1.35m ,Ligue 1
19-06-17,18.3.4.28,Almamy TourÃ©,85122415,31,28-Apr-96,21,0,0,0,0,5550,6000,6550,156,131,15000571,184,80,D RC,1,2,2,3,2,1,1,3,1,1,4,8,15,13,8,13,8,16,9,12,13,13,10,13,13,12,13,12,12,13,12,12,14,12,9,14,13,14,13,14,13,14,12,7,13,14,20,14,14,13,7,15,11,13,15,15,16,14,16,17,17,5,20,14,1,1,20,12,16,D RC,103,1,1,1,1,1,1,16,12,20,10,1,1,1,10,14,279174000000.0,0,1,0,0,0,1,0,0,0,0,0,0,0,0,0,0,0,0,0,0,1,0,0,0,0,0,0,0,0,0,0,0,1,0,0,0,0,0,1,0,0,0,0,0,0,0,0,0,Almamy TourÃ©,Â£7.20m ,24.0,183.0,Defender - Right-Back,right,Eintracht Frankfurt,27.0,0.0,5.0,1981.0,27.0,1.0,6.0,1872.0,12.0,0.0,0.0,880.0,29.0,1.0,4.0,2370.0,4.0,0.0,0.0,317.0,Ligue 1,15-07-16,17.3.2.23,Almamy TourÃ©,85122415,31,28-Apr-96,20,0,0,0,0,5650,6000,6250,155,125,8689045,184,80,D RC,1,1,3,1,2,1,3,3,3,2,2,7,14,13,8,12,7,16,7,12,13,13,11,12,13,12,13,14,13,12,12,12,15,12,10,14,13,14,13,14,12,14,12,6,13,14,20,13,14,14,8,15,10,13,18,16,15,14,16,16,17,5,Almamy TourÃ©,Â£3.60m ,Ligue 1
19-06-17,18.3.4.28,Angelo Fulgini,85133890,769,20-Aug-96,20,0,0,0,0,3750,5900,5900,130,118,5203514,183,71,D/DM/M RC,3,4,2,1,2,3,3,2,1,4,1,14,12,13,10,12,13,12,11,6,9,13,9,10,13,12,12,11,13,11,13,12,11,13,8,13,8,12,14,13,14,12,11,6,15,14,20,14,12,13,10,10,8,15,11,14,12,11,12,9,12,5,17,13,20,13,17,12,20,D/DM/M RC,433,1,1,1,13,1,1,12,1,17,19,20,12,12,1,13,0.0,0,0,0,0,0,0,0,0,0,0,0,0,0,0,0,0,0,0,0,0,0,0,0,0,0,0,0,0,0,0,0,0,0,0,0,0,0,0,0,0,0,0,0,0,0,0,0,0,Angelo Fulgini,Â£3.15m ,24.0,183.0,Midfielder - Central Midfield,right,SCO Angers,36.0,6.0,2.0,2797.0,32.0,4.0,5.0,1695.0,33.0,4.0,2.0,1842.0,23.0,1.0,2.0,1837.0,8.0,2.0,1.0,720.0,Ligue 1
19-06-17,18.3.4.28,Matthieu Udol,85138174,769,20-Mar-96,21,0,0,0,0,2750,5300,5300,116,106,1331997,175,66,D RL,3,3,1,3,2,2,3,1,1,2,3,11,11,11,4,12,7,12,5,5,12,13,6,13,12,15,12,13,11,13,7,10,5,5,6,11,12,15,12,13,14,11,9,20,14,14,6,12,17,10,10,10,4,10,7,10,13,10,11,12,20,3,20,13,10,7,15,20,1,D RL,105,1,1,1,1,7,1,1,20,15,1,1,10,1,13,13,0.0,0,0,0,0,0,0,0,0,0,0,0,0,0,0,0,0,0,0,0,0,0,0,0,0,0,0,0,0,0,0,0,0,0,0,0,0,0,0,0,0,0,0,0,0,0,0,0,0,Matthieu Udol,Â£360Th. ,24.0,178.0,Defender - Left-Back,left,FC Metz,3.0,0.0,0.0,270.0,6.0,0.0,0.0,353.0,5.0,0.0,1.0,343.0,14.0,0.0,1.0,1192.0,7.0,0.0,1.0,630.0,Ligue 1
19-06-17,18.3.4.28,Bryan Passi,85140255,769,05-Aug-97,19,0,0,0,0,1750,4700,4700,111,94,597723,189,78,D RC,1,2,3,3,3,2,1,1,3,2,1,5,7,10,8,9,10,11,6,2,11,11,5,10,11,10,10,11,5,11,10,11,10,2,7,11,13,11,12,12,11,13,14,5,14,12,20,10,11,10,10,6,7,10,15,12,11,12,10,11,19,6,20,1,1,1,17,1,20,D RC,103,1,1,1,1,1,1,20,1,17,15,1,1,1,1,1,0.0,0,0,0,0,0,0,0,0,0,0,0,0,0,0,0,0,0,0,0,0,0,0,0,0,0,0,0,0,0,0,0,0,0,0,0,0,0,0,0,0,0,0,0,0,0,0,0,0,Bryan Passi, ,23.0,189.0,Defender - Centre-Back,right,Chamois Niortais FC,3.0,0.0,0.0,143.0,1.0,0.0,0.0,90.0,0.0,0.0,0.0,0.0,17.0,0.0,1.0,1501.0,3.0,0.0,0.0,260.0,Ligue 1
19-06-17,18.3.4.28,Mathieu Debuchy,915351,769,28-Jul-85,31,27,2,2,0,6000,6500,6500,150,131,232186002,178,78,D/WB R,1,3,3,3,2,3,1,4,1,3,1,8,12,12,8,12,7,13,9,12,14,11,8,15,11,14,14,16,12,14,12,13,15,11,12,13,15,14,14,13,13,13,12,9,12,13,20,13,11,14,14,14,14,16,14,13,13,14,16,13,12,8,20,18,10,8,20,11,14,D/WB R,112,1,1,1,1,1,8,14,11,20,10,1,1,10,10,18,2251800000000000.0,0,0,0,0,0,0,0,0,0,0,0,0,0,0,0,0,0,0,0,0,0,0,0,0,0,0,0,0,0,0,0,0,0,0,0,0,0,0,0,0,0,0,0,0,0,0,0,0,Mathieu Debuchy,Â£4.05m ,35.0,177.0,Defender - Right-Back,right,AS Saint-Ãtienne,4.0,2.0,0.0,266.0,23.0,5.0,1.0,2012.0,24.0,4.0,3.0,1947.0,32.0,2.0,3.0,2693.0,3.0,0.0,0.0,189.0,Premier League,15-07-16,17.3.2.23,Mathieu Debuchy,915351,769,28-Jul-85,30,27,2,2,0,6100,6500,6500,155,134,5872789,178,78,D R,2,3,2,2,2,2,3,1,1,2,3,8,13,13,8,12,7,14,9,12,14,11,8,16,11,14,14,17,12,14,12,13,17,11,12,13,15,14,15,13,13,13,12,9,12,13,20,13,11,14,14,14,13,18,14,13,13,15,16,13,12,8,Mathieu Debuchy,Â£3.15m ,Premier League
19-06-17,18.3.4.28,Mouhamadou Dabo,919771,769,28-Nov-86,30,0,0,8,0,3700,6000,6000,138,120,2406623,176,67,D/WB RL,1,2,2,4,1,2,2,3,3,1,2,8,11,10,5,9,8,9,7,11,10,11,8,12,10,12,11,13,12,10,9,10,15,11,8,10,12,13,14,14,13,14,8,10,12,14,20,15,11,12,12,15,8,16,8,15,10,14,10,14,14,9,20,18,13,10,18,20,1,D/WB RL,115,1,1,1,1,10,10,1,20,18,10,1,12,13,18,18,2251800000000000.0,0,0,0,1,0,0,1,0,0,0,0,0,0,0,0,0,0,0,0,0,0,0,0,0,0,0,0,0,0,0,0,0,0,0,0,0,0,0,0,0,0,0,0,0,0,0,0,0,Mouhamadou Dabo,Â£450Th. ,33.0,176.0,Defender - Right-Back,right,Retired,3.0,0.0,0.0,192.0,0.0,0.0,0.0,0.0,0.0,0.0,0.0,0.0,nan,nan,nan,nan,nan,nan,nan,nan,Ligue 1,15-07-16,17.3.2.23,Mouhamadou Dabo,919771,769,28-Nov-86,29,0,0,8,0,3768,6048,6048,128,121,1881396,176,67,D/WB RL,1,3,2,2,1,3,1,3,3,2,3,8,11,10,5,9,8,9,7,11,11,11,8,12,10,12,11,13,12,11,9,10,16,11,8,9,11,13,14,14,13,13,8,10,12,14,20,15,11,14,12,15,8,16,8,16,11,14,15,14,14,9,Mouhamadou Dabo,Â£720Th. ,Ligue 1
19-06-17,18.3.4.28,Saidy Janko,98030722,798,22-Oct-95,21,0,0,4,0,2500,5700,5700,128,112,2884839,180,80,D/WB/M R,1,1,3,2,2,2,1,2,1,2,1,5,10,13,7,12,5,9,9,6,10,11,4,11,13,11,13,10,11,10,11,10,8,11,4,13,11,13,12,15,12,12,10,7,10,15,20,13,12,12,4,5,17,13,7,12,11,13,9,13,14,5,20,16,16,15,20,1,1,D/WB/M R,122,1,1,1,1,1,15,1,1,20,1,1,1,16,1,16,2.0,0,1,0,0,0,0,0,0,0,0,0,0,0,0,0,0,0,0,0,0,0,0,0,0,0,0,0,0,0,0,0,0,0,0,0,0,0,0,0,0,0,0,0,0,0,0,0,0,Saidy Janko,Â£2.70m ,25.0,181.0,Defender - Right-Back,right,Real Valladolid CF,21.0,1.0,1.0,1163.0,22.0,0.0,0.0,1499.0,17.0,0.0,1.0,1365.0,46.0,1.0,6.0,3414.0,1.0,0.0,0.0,80.0,Ligue 1
19-06-17,18.3.4.28,Alessandro SchÃ¶pf,16047316,755,07-Feb-94,23,12,2,19,8,4750,6750,6750,147,140,21987316,178,75,WB/M/AM RC,1,2,3,3,2,1,3,2,3,1,2,11,11,14,12,13,10,8,14,10,7,13,12,11,13,16,13,10,10,12,12,10,13,13,8,15,9,12,18,14,15,10,8,15,18,12,20,17,7,13,6,11,5,18,12,16,10,10,15,12,17,4,10,19,17,20,19,12,20,WB/M/AM RC,533,1,1,1,20,12,17,1,1,10,8,12,12,17,1,19,549756000000.0,0,0,0,0,0,0,0,0,0,0,1,0,0,0,0,0,0,0,0,0,0,0,0,0,0,0,0,0,0,0,0,0,0,0,0,0,0,0,0,1,0,0,0,0,0,0,0,0,Alessandro SchÃ¶pf,Â£4.50m ,26.0,178.0,Midfielder - Right Midfield,right,FC Schalke 04,42.0,8.0,4.0,2761.0,20.0,1.0,0.0,1157.0,21.0,2.0,1.0,1399.0,27.0,1.0,1.0,1843.0,3.0,0.0,0.0,158.0,Bundesliga,15-07-16,17.3.2.23,Alessandro SchÃ¶pf,16047316,755,07-Feb-94,22,7,2,19,8,4800,6550,6800,151,136,22797985,178,75,M/AM RC,3,1,3,1,1,1,1,3,4,2,3,12,11,15,13,14,10,8,15,7,7,13,12,10,14,16,13,10,12,9,12,10,11,15,10,15,9,13,16,14,15,10,8,15,16,12,20,16,8,11,6,11,5,17,12,16,10,11,15,13,17,4,Alessandro SchÃ¶pf,Â£6.75m ,Bundesliga
19-06-17,18.3.4.28,Stefan Posch,16147386,755,14-May-97,20,0,0,4,0,2750,6000,6250,131,120,9819982,188,76,D RC,1,3,3,3,2,3,3,2,1,2,2,3,7,7,6,9,4,13,6,10,13,11,9,12,10,10,12,14,16,13,8,12,12,5,10,6,13,15,10,12,11,11,16,10,13,15,20,12,13,15,7,16,6,10,12,15,10,16,13,15,18,5,20,11,10,1,15,1,20,D RC,103,1,1,1,1,1,1,20,1,15,10,10,1,1,1,11,0.0,0,0,0,0,0,0,0,0,0,0,0,0,0,0,0,0,0,0,0,0,0,0,0,0,0,0,0,0,0,0,0,0,0,0,0,0,0,0,0,0,0,0,0,0,0,0,0,0,Stefan Posch,Â£2.25m ,23.0,188.0,Defender - Centre-Back,right,TSG 1899 Hoffenheim,30.0,1.0,0.0,2681.0,17.0,0.0,0.0,1423.0,24.0,2.0,0.0,2034.0,30.0,0.0,1.0,2526.0,6.0,0.0,0.0,509.0,Bundesliga
19-06-17,18.3.4.28,Konrad Laimer,16147659,755,27-May-97,20,0,0,6,0,4050,6300,6550,151,131,17744343,180,72,D/DM/M RC,2,1,2,2,2,1,1,3,3,1,2,8,10,12,10,11,8,6,9,7,13,12,9,15,11,18,15,17,10,14,12,11,17,9,10,15,13,16,18,13,12,10,9,12,17,12,20,17,9,12,10,14,4,15,13,16,12,12,14,16,9,8,16,10,20,12,16,1,20,D/DM/M RC,433,1,1,1,10,1,12,1,1,16,18,20,1,12,1,10,0.0,0,0,0,0,0,0,0,0,0,0,0,0,0,0,0,0,0,0,0,0,0,0,0,0,0,0,0,0,0,0,0,0,0,0,0,0,0,0,0,0,0,0,0,0,0,0,0,0,Konrad Laimer,Â£7.20m ,23.0,180.0,Midfielder - Central Midfield,right,RB Leipzig,43.0,4.0,4.0,3263.0,29.0,0.0,2.0,1701.0,43.0,2.0,3.0,2956.0,42.0,4.0,7.0,3060.0,nan,nan,nan,nan,Bundesliga
19-06-17,18.3.4.28,William,19225946,1651,03-Apr-95,22,0,0,1,0,4650,6650,6650,148,133,19437392,176,71,D/WB R,3,2,4,1,3,3,1,1,2,1,4,14,14,11,8,13,11,8,10,12,13,12,10,15,13,17,11,14,10,12,12,11,14,13,11,13,12,10,16,16,14,12,8,10,16,14,20,13,9,14,10,10,7,10,8,12,12,13,11,6,10,10,20,20,14,14,20,12,1,D/WB R,112,1,1,1,1,1,14,1,12,20,1,1,1,14,12,20,2199160000000.0,0,0,0,0,0,0,0,0,0,0,0,0,0,0,0,0,0,0,0,0,0,0,0,0,0,0,0,1,0,0,0,0,0,0,0,0,0,0,0,0,0,1,0,0,0,0,0,0,William,Â£3.60m ,25.0,176.0,Defender - Right-Back,right,VfL Wolfsburg,2.0,0.0,0.0,180.0,26.0,0.0,2.0,1941.0,33.0,2.0,3.0,2857.0,22.0,3.0,2.0,1862.0,nan,nan,nan,nan,Bundesliga,15-07-16,17.3.2.23,William,19119116,1651,07-Dec-91,24,0,0,0,0,2000,5500,5850,128,117,210593,183,83,S ,3,1,1,2,1,3,2,1,3,3,1,6,6,11,13,12,7,12,8,8,7,11,9,8,11,10,12,10,11,10,11,11,10,12,9,14,13,11,14,14,12,11,11,10,12,13,20,13,16,11,11,11,10,10,18,12,9,9,11,6,11,6,William,Â£360Th. ,Liga NOS
19-06-17,18.3.4.28,Bernardo,19270959,1651,14-May-95,22,0,0,0,0,4100,6100,6600,146,132,7350320,186,76,D/DM/M RLC,3,1,2,3,2,1,3,2,2,1,3,5,10,9,7,11,7,10,11,14,14,12,8,16,12,16,15,17,9,12,8,9,15,7,10,9,13,15,16,12,11,14,14,20,17,16,10,15,13,13,10,11,3,17,14,17,7,12,14,10,12,8,20,14,17,10,20,18,17,D/DM/M RLC,126,1,1,1,10,1,1,12,18,20,17,17,1,1,12,14,0.0,0,0,0,0,0,0,0,0,0,0,0,0,0,0,0,0,0,0,0,0,0,0,0,0,0,0,0,0,0,0,0,0,0,0,0,0,0,0,0,0,0,0,0,0,0,0,0,0,Bernardo,Â£5.40m ,25.0,186.0,Defender - Left-Back,left,Brighton & Hove Albion,32.0,3.0,1.0,2820.0,27.0,1.0,1.0,1846.0,27.0,0.0,1.0,2260.0,16.0,0.0,0.0,784.0,3.0,1.0,2.0,270.0,Bundesliga,15-07-16,17.3.2.23,Bernardo,67010361,1653,11-Jul-89,27,0,0,0,0,5650,6150,6650,134,133,20786222,192,85,D C,1,2,3,3,3,1,2,1,3,1,1,4,5,5,8,10,4,18,5,8,15,12,5,14,11,14,14,13,13,12,9,11,11,14,11,7,14,15,14,11,11,5,16,9,15,10,20,17,18,16,12,12,7,5,16,11,12,10,11,3,8,3,Bernardo,Â£4.50m ,Bundesliga
19-06-17,18.3.4.28,Tin Jedvaj,24026928,761,28-Nov-95,21,9,0,5,1,5350,6600,6350,155,132,11105628,184,81,D RLC,1,3,2,4,2,4,1,1,1,2,2,5,11,9,10,12,5,11,9,17,15,13,8,16,12,16,15,17,15,9,10,12,16,9,10,13,11,12,14,12,11,15,12,10,16,14,20,13,13,12,14,12,10,17,14,17,8,12,12,8,10,13,20,15,10,1,17,15,20,D RLC,106,1,1,1,1,1,1,20,15,17,10,10,1,1,13,15,4294967296.0,0,0,0,0,0,0,0,0,0,0,0,0,0,0,0,0,0,0,0,0,0,0,0,0,0,0,0,0,0,0,0,0,1,0,0,0,0,0,0,0,0,0,0,0,0,0,0,0,Tin Jedvaj,Â£4.50m ,24.0,188.0,Defender - Centre-Back,right,Bayer 04 Leverkusen,23.0,1.0,0.0,1828.0,10.0,0.0,0.0,597.0,21.0,2.0,0.0,1470.0,31.0,2.0,0.0,2642.0,0.0,0.0,0.0,0.0,Bundesliga,15-07-16,17.3.2.23,Tin Jedvaj,24026928,761,28-Nov-95,20,4,0,3,1,5800,6800,6800,155,136,25512421,184,80,D RLC,2,3,1,3,1,1,2,1,3,2,3,5,11,9,10,12,5,11,9,17,16,13,8,16,12,16,15,17,14,9,10,12,16,9,10,13,11,12,14,12,11,15,12,10,16,14,20,13,13,12,14,12,8,17,14,17,8,12,12,8,10,13,Tin Jedvaj,Â£5.85m ,Bundesliga
19-06-17,18.3.4.28,Theodor Gebre Selassie,25006446,763,24-Dec-86,30,43,3,6,0,5100,6600,6600,132,132,232186002,181,71,D/WB R,2,1,4,4,1,3,2,1,1,2,1,7,11,12,8,12,6,14,10,13,9,10,7,10,11,10,10,14,12,14,8,12,12,9,10,14,9,14,16,16,14,12,11,9,18,15,20,17,9,15,5,13,10,13,14,11,15,12,16,18,16,2,20,20,14,14,20,10,1,D/WB R,112,1,1,1,1,1,14,1,10,20,1,1,1,14,10,20,274878000000.0,0,0,0,0,0,0,0,0,0,0,0,0,0,0,0,0,0,0,0,0,0,0,0,0,0,0,0,0,0,0,0,0,0,0,0,0,0,0,1,0,0,0,0,0,0,0,0,0,Theodor Gebre Selassie,Â£2.25m ,33.0,181.0,Defender - Right-Back,right,SV Werder Bremen,31.0,5.0,2.0,2428.0,36.0,3.0,0.0,3218.0,36.0,3.0,5.0,3199.0,32.0,2.0,4.0,2789.0,6.0,0.0,1.0,540.0,Bundesliga,15-07-16,17.3.2.23,Theodor Gebre Selassie,25006446,763,24-Dec-86,29,37,1,6,0,5350,6600,6350,132,132,4578168,181,71,D/WB R,3,4,1,3,1,1,2,2,3,3,2,7,11,12,8,12,6,13,10,13,9,10,7,10,11,10,10,14,12,14,8,12,12,9,10,14,9,14,16,16,14,12,11,9,18,15,20,17,9,15,5,13,10,13,14,11,15,12,16,18,16,2,Theodor Gebre Selassie,Â£2.70m ,Bundesliga
19-06-17,18.3.4.28,Pavel Kaderabek,25019787,763,25-Apr-92,25,28,2,7,1,4700,6700,6700,136,134,12564813,182,81,D/WB R,1,2,3,3,2,1,1,1,2,2,1,8,12,9,10,10,8,13,12,15,11,10,11,13,11,17,10,15,8,13,9,9,15,10,11,13,11,14,17,14,11,16,11,10,18,16,20,17,14,14,12,14,6,10,12,15,13,12,16,14,17,3,20,20,15,15,20,12,1,D/WB R,112,1,1,1,1,1,15,1,12,20,1,1,1,15,10,20,134217728.0,0,0,0,0,0,0,0,0,0,0,0,0,0,0,0,0,0,0,0,0,0,0,0,0,0,0,0,1,0,0,0,0,0,0,0,0,0,0,0,0,0,0,0,0,0,0,0,0,Pavel Kaderabek,Â£9.90m ,28.0,182.0,Defender - Right-Back,right,TSG 1899 Hoffenheim,26.0,1.0,3.0,2197.0,34.0,3.0,4.0,2631.0,36.0,5.0,5.0,3140.0,33.0,3.0,7.0,2776.0,4.0,0.0,0.0,291.0,Bundesliga,15-07-16,17.3.2.23,Pavel Kaderabek,25019787,763,25-Apr-92,24,21,2,7,1,5100,6600,6600,139,132,6266584,182,81,D/WB R,4,3,1,2,1,3,3,2,2,1,2,8,12,9,10,10,8,13,12,15,11,10,11,13,11,17,10,15,8,13,9,9,15,11,11,13,10,14,17,14,11,16,11,10,18,16,20,17,13,14,12,14,6,10,12,15,13,12,16,14,17,3,Pavel Kaderabek,Â£4.05m ,Bundesliga
19-06-17,18.3.4.28,Frederik SÅrensen,27020708,764,14-Apr-92,25,1,0,17,0,5500,6250,6500,138,130,7489782,194,88,D RC,1,3,2,2,3,2,1,2,3,1,2,5,8,6,6,8,6,12,9,17,13,10,5,13,8,10,16,13,15,15,9,12,12,6,10,7,15,17,10,11,7,14,18,9,13,15,20,13,16,14,7,14,10,13,16,15,10,17,14,14,18,5,20,12,1,1,18,7,20,D RC,103,1,10,1,1,1,1,20,7,18,1,1,1,1,1,12,279173000000.0,0,0,0,0,0,0,0,0,0,0,0,0,0,0,0,0,0,0,0,0,0,0,0,0,0,0,0,0,0,0,0,0,1,0,0,0,0,0,1,0,0,0,0,0,0,0,0,0,Frederik SÃ¶rensen,Â£4.05m ,28.0,194.0,Defender - Centre-Back,right,1. FC KÃ¶ln,33.0,0.0,3.0,2890.0,35.0,3.0,2.0,2632.0,6.0,0.0,0.0,136.0,25.0,1.0,1.0,1976.0,3.0,0.0,0.0,97.0,Bundesliga,15-07-16,17.3.2.23,Frederik SÅrensen,27020708,764,14-Apr-92,24,0,0,17,0,5735,5937,6700,138,134,12147420,194,88,D RC,3,3,3,2,1,3,2,1,1,2,2,5,8,6,6,8,6,12,9,17,14,10,5,14,8,9,16,13,15,16,11,13,12,6,10,6,15,17,10,11,7,14,18,9,13,15,20,13,16,15,7,14,10,13,16,15,10,17,14,14,18,5,Frederik SÃ¶rensen,Â£6.75m ,Bundesliga
19-06-17,18.3.4.28,Tony Jantschke,29022529,771,07-Apr-90,27,0,0,18,0,4750,6500,6750,139,135,12324205,177,72,D/WB RC,2,3,2,4,4,3,2,1,2,2,2,5,9,7,5,11,5,12,5,10,14,12,6,15,11,10,17,12,14,17,9,13,12,4,11,7,16,18,12,11,13,11,11,12,14,12,20,14,10,16,5,14,8,16,6,11,17,12,16,16,18,3,20,16,11,1,20,1,18,D/WB RC,113,1,1,1,1,1,1,18,1,20,11,11,1,1,1,16,279173000000.0,0,0,0,0,0,0,0,0,0,0,0,0,0,0,0,0,0,0,0,0,0,0,0,0,0,0,0,0,0,0,0,0,1,0,0,0,0,0,1,0,0,0,0,0,0,0,0,0,Tony Jantschke,Â£3.15m ,30.0,177.0,Defender - Centre-Back,right,Borussia MÃ¶nchengladbach,35.0,0.0,0.0,2533.0,14.0,0.0,1.0,804.0,15.0,0.0,2.0,1020.0,19.0,0.0,0.0,1128.0,3.0,0.0,0.0,112.0,Bundesliga,15-07-16,17.3.2.23,Tony Jantschke,29022529,771,07-Apr-90,26,0,0,18,0,4945,6945,6945,140,139,14213274,177,72,D/WB RC,3,3,3,3,1,1,2,3,3,2,2,5,9,7,5,11,5,12,5,10,14,12,6,16,11,10,17,12,14,17,9,14,12,4,10,7,16,18,11,11,13,12,11,12,14,12,20,15,10,16,5,14,8,16,6,11,17,12,16,16,18,3,Tony Jantschke,Â£5.40m ,Bundesliga
19-06-17,18.3.4.28,Daniel Opare,29022535,21,18-Oct-90,26,17,0,2,0,4600,6100,6100,127,127,3877763,175,74,D/WB R,3,3,1,2,2,2,1,2,2,2,1,8,14,12,7,12,6,8,10,15,10,11,7,13,13,16,8,14,9,11,10,9,14,14,8,12,9,10,16,16,14,14,10,9,16,17,20,15,11,11,14,12,11,11,15,18,7,12,10,8,7,16,20,20,10,10,20,13,8,D/WB R,112,1,1,1,1,1,10,8,13,20,1,1,1,10,11,20,134217728.0,0,0,0,0,0,0,0,0,0,0,0,0,0,0,0,0,0,0,0,0,0,0,0,0,0,0,0,1,0,0,0,0,0,0,0,0,0,0,0,0,0,0,0,0,0,0,0,0,Daniel Opare,Â£900Th. ,30.0,174.0,Defender - Right-Back,right,SV Zulte Waregem,8.0,0.0,0.0,586.0,17.0,0.0,0.0,1418.0,24.0,0.0,0.0,1847.0,nan,nan,nan,nan,8.0,0.0,2.0,627.0,Bundesliga
19-06-17,18.3.4.28,Sebastian Rudy,29022542,771,28-Feb-90,27,20,0,23,5,6500,7500,7500,150,150,49787611,180,74,D/WB/DM/M RC,2,3,3,1,3,3,2,3,3,3,2,12,12,10,9,15,10,7,13,8,11,16,11,13,15,11,16,10,17,13,14,16,9,8,10,9,15,18,12,12,14,10,9,12,13,12,20,16,9,13,4,10,7,14,7,13,13,11,15,17,19,3,16,16,20,12,16,10,20,D/WB/DM/M RC,343,1,1,1,12,10,11,1,1,16,20,20,10,11,1,16,17200840704.0,0,0,0,0,0,0,0,0,0,0,0,0,0,0,0,0,0,0,0,0,0,0,1,0,1,0,0,0,0,0,0,0,0,0,1,0,0,0,0,0,0,0,0,0,0,0,0,0,Sebastian Rudy,Â£13.50m ,30.0,180.0,Midfielder - Defensive Midfield,right,TSG 1899 Hoffenheim,34.0,3.0,10.0,2998.0,35.0,1.0,5.0,2133.0,28.0,0.0,0.0,1853.0,35.0,1.0,4.0,2993.0,5.0,0.0,2.0,450.0,Bundesliga,15-07-16,17.3.2.23,Sebastian Rudy,29022542,771,28-Feb-90,26,11,0,23,5,6246,7246,7246,146,145,26479174,180,74,D/WB/DM/M RC,1,3,2,3,3,2,3,2,2,1,2,12,12,10,9,15,10,7,11,8,11,16,11,13,15,11,15,10,16,13,14,16,8,8,9,9,14,18,12,12,14,10,7,12,13,12,20,15,9,13,4,10,7,14,7,13,13,11,15,17,19,3,Sebastian Rudy,Â£7.20m ,Bundesliga
19-06-17,18.3.4.28,Jonas Strifler,29022546,771,30-Jan-90,27,0,0,0,0,1363,4653,4950,68,63,88209,173,71,D/WB/DM/M RC,2,3,3,1,2,1,1,2,3,1,1,6,10,7,6,8,6,6,7,11,10,8,7,11,9,11,9,9,7,9,6,9,13,8,8,7,11,10,11,10,10,8,5,8,11,10,20,10,7,12,5,12,9,7,6,14,13,9,12,14,16,7,17,17,18,1,17,1,18,D/WB/DM/M RC,343,1,1,1,1,1,1,14,1,17,20,18,1,10,1,17,32.0,0,0,0,0,0,1,0,0,0,0,0,0,0,0,0,0,0,0,0,0,0,0,0,0,0,0,0,0,0,0,0,0,0,0,0,0,0,0,0,0,0,0,0,0,0,0,0,0,nan,nan,nan,nan,nan,nan,nan,nan,nan,nan,nan,nan,nan,nan,nan,nan,nan,nan,nan,nan,nan,nan,nan,nan,nan,nan,nan,nan,
19-06-17,18.3.4.28,Jean-Philippe Gbamin,29114927,24,25-Sep-95,21,2,0,0,0,6250,6250,6750,140,130,23163918,186,83,D/DM/M RC,3,1,3,2,1,4,2,3,1,3,1,6,10,11,8,10,6,12,7,14,14,12,7,15,11,16,12,17,9,13,10,10,14,8,11,8,12,14,16,13,12,15,14,9,17,16,20,16,15,13,10,13,8,17,11,13,13,10,10,15,15,11,17,11,20,1,15,10,20,D/DM/M RC,333,1,1,1,1,1,1,17,10,15,20,20,1,1,6,11,0.0,0,0,0,0,0,0,0,0,0,0,0,0,0,0,0,0,0,0,0,0,0,0,0,0,0,0,0,0,0,0,0,0,0,0,0,0,0,0,0,0,0,0,0,0,0,0,0,0,Jean-Philippe Gbamin,Â£13.50m ,25.0,186.0,Midfielder - Defensive Midfield,right,Everton FC,31.0,0.0,0.0,2365.0,31.0,1.0,3.0,2710.0,33.0,2.0,1.0,2869.0,2.0,0.0,0.0,135.0,nan,nan,nan,nan,Bundesliga,15-07-16,17.3.2.23,Jean-Philippe Gbamin,29114927,769,25-Sep-95,20,0,0,7,0,5046,6296,6546,140,126,16491084,186,83,D/DM/M RC,2,4,2,2,3,1,3,1,2,2,2,6,10,11,8,10,6,12,7,14,14,12,7,15,10,16,12,17,9,13,10,9,14,8,10,8,11,14,16,14,12,15,14,9,17,16,20,16,14,13,10,13,8,17,11,13,13,10,10,15,15,11,Jean-Philippe Gbamin,Â£4.50m ,Bundesliga
19-06-17,18.3.4.28,Lars Bender,35007385,771,27-Apr-89,28,19,4,1,0,6800,7050,7300,154,146,44042058,185,81,D/DM/M RC,3,1,3,3,1,1,4,1,2,2,2,7,10,8,9,12,7,12,11,13,15,13,8,17,11,15,16,18,12,17,10,14,17,5,14,12,14,19,17,11,11,14,12,10,18,12,20,17,13,18,6,18,13,15,9,14,14,16,19,15,18,2,16,12,20,10,16,1,20,D/DM/M RC,333,1,1,1,8,1,10,10,1,16,20,20,1,10,1,12,274928000000.0,0,0,0,0,0,0,0,0,0,0,0,0,0,0,0,0,0,0,0,0,0,0,0,0,1,1,0,0,0,0,0,0,0,0,0,0,0,0,1,0,0,0,0,0,0,0,0,0,Lars Bender,Â£11.70m ,31.0,185.0,Defender - Right-Back,right,Bayer 04 Leverkusen,12.0,0.0,1.0,823.0,24.0,3.0,7.0,1792.0,27.0,1.0,5.0,1814.0,28.0,2.0,1.0,2043.0,6.0,1.0,1.0,461.0,Bundesliga,15-07-16,17.3.2.23,Lars Bender,35007385,771,27-Apr-89,27,19,4,1,0,6247,6997,7247,154,145,30574219,184,77,DM/M C,1,1,2,2,2,2,3,2,1,1,1,7,10,8,9,12,7,12,11,13,15,13,8,17,11,15,16,18,12,17,10,14,17,5,13,13,14,19,18,11,11,14,12,10,20,13,20,17,13,18,6,18,10,15,9,14,14,16,19,15,18,2,Lars Bender,Â£9.00m ,Bundesliga
19-06-17,18.3.4.28,Daniel Brosinski,35008235,771,17-Jul-88,28,0,0,4,1,4150,6400,6650,136,133,11369040,178,70,D/WB R,1,2,2,2,3,3,1,4,2,2,4,12,14,11,9,11,14,7,13,17,9,13,11,12,11,14,9,12,13,12,12,11,15,12,8,13,8,10,17,15,14,10,9,15,16,14,20,16,8,13,6,13,5,16,7,12,11,13,13,12,10,8,20,20,14,14,20,13,10,D/WB R,112,1,1,1,1,11,14,1,13,20,10,10,11,14,13,20,134217728.0,0,0,0,0,0,0,0,0,0,0,0,0,0,0,0,0,0,0,0,0,0,0,0,0,0,0,0,1,0,0,0,0,0,0,0,0,0,0,0,0,0,0,0,0,0,0,0,0,Daniel Brosinski,Â£2.70m ,32.0,178.0,Defender - Right-Back,right,1.FSV Mainz 05,35.0,1.0,3.0,2965.0,33.0,3.0,9.0,2892.0,28.0,3.0,6.0,2414.0,27.0,2.0,4.0,1791.0,6.0,0.0,1.0,532.0,Bundesliga,15-07-16,17.3.2.23,Daniel Brosinski,35008235,771,17-Jul-88,27,0,0,4,1,4147,6397,6647,136,133,10920042,178,70,D/WB R,3,1,1,1,2,2,3,2,1,1,1,12,14,11,9,11,14,7,13,17,9,13,11,12,11,14,9,12,13,12,12,11,15,12,8,13,8,10,17,15,14,10,9,15,16,14,20,16,8,13,6,13,5,16,7,12,11,13,13,12,10,8,Daniel Brosinski,Â£2.25m ,Bundesliga
19-06-17,18.3.4.28,Ermin Bicakcic,35013742,759,24-Jan-90,27,19,3,0,0,4928,7219,6450,130,129,7046965,185,81,D RC,3,1,3,3,3,3,1,2,3,2,1,3,6,5,8,8,4,13,4,14,16,9,5,15,8,14,11,18,10,14,7,11,16,5,12,8,13,15,12,11,8,14,14,15,14,16,20,13,17,15,13,13,7,10,11,15,9,13,17,9,14,7,20,11,1,1,15,1,20,D RC,103,1,1,1,1,1,1,20,1,15,1,1,1,1,1,11,32768.0,0,0,0,0,0,0,0,0,0,0,0,0,0,0,0,1,0,0,0,0,0,0,0,0,0,0,0,0,0,0,0,0,0,0,0,0,0,0,0,0,0,0,0,0,0,0,0,0,Ermin Bicakcic,Â£1.80m ,30.0,185.0,Defender - Centre-Back,right,TSG 1899 Hoffenheim,19.0,1.0,1.0,1171.0,13.0,0.0,1.0,825.0,30.0,1.0,3.0,2198.0,22.0,2.0,0.0,1289.0,3.0,1.0,0.0,249.0,Bundesliga,15-07-16,17.3.2.23,Ermin Bicakcic,35013742,759,24-Jan-90,26,14,2,0,0,4417,7188,6447,131,129,6410408,185,81,D RC,3,3,1,3,2,1,2,1,3,2,2,3,6,5,8,8,4,13,4,14,16,9,5,15,8,14,11,18,10,14,7,11,16,5,12,8,13,15,12,11,8,14,14,15,14,16,20,13,17,15,13,13,7,10,11,15,9,13,17,9,14,7,Ermin Bicakcic,Â£2.03m ,Bundesliga
19-06-17,18.3.4.28,Dennis Diekmeier,35016422,771,20-Oct-89,27,0,0,1,0,4100,6600,6600,133,132,9518279,188,80,D/WB R,2,1,1,3,1,3,1,2,3,1,2,10,16,12,7,10,6,8,9,17,11,11,6,13,10,16,9,16,8,12,9,10,14,10,9,12,8,10,18,15,11,17,13,7,13,18,20,16,14,13,13,13,10,8,7,18,10,12,9,10,8,15,20,20,15,15,20,1,1,D/WB R,112,1,1,1,1,1,15,1,1,20,1,1,1,15,1,20,134217728.0,0,0,0,0,0,0,0,0,0,0,0,0,0,0,0,0,0,0,0,0,0,0,0,0,0,0,0,1,0,0,0,0,0,0,0,0,0,0,0,0,0,0,0,0,0,0,0,0,Dennis Diekmeier,Â£1.35m ,31.0,188.0,Defender - Right-Back,right,SV Sandhausen,26.0,0.0,1.0,1883.0,22.0,0.0,3.0,1869.0,16.0,0.0,6.0,1440.0,34.0,2.0,4.0,2974.0,6.0,0.0,1.0,540.0,Bundesliga,15-07-16,17.3.2.23,Dennis Diekmeier,35016422,771,20-Oct-89,26,0,0,1,0,4100,6600,6600,133,132,11006910,188,80,D/WB R,3,2,2,1,1,2,1,2,2,2,2,10,16,12,7,10,6,8,9,17,11,11,6,13,10,16,9,16,8,12,9,10,14,10,9,12,8,10,18,15,11,17,13,7,13,18,20,16,14,13,13,13,10,8,7,18,7,12,9,10,8,15,Dennis Diekmeier,Â£1.35m ,Bundesliga
19-06-17,18.3.4.28,Sebastian Jung,35017378,771,22-Jun-90,26,1,0,19,0,4550,6550,6550,139,131,8068394,179,72,D/WB R,3,2,1,2,1,1,1,2,3,3,3,8,14,11,7,11,6,8,10,16,13,12,7,13,12,16,14,14,13,13,11,12,16,9,9,11,12,15,16,13,13,12,8,10,14,16,20,15,10,15,8,15,10,10,7,12,14,10,17,15,18,4,20,18,10,10,20,1,14,D/WB R,112,1,1,1,1,1,10,14,1,20,8,8,1,10,1,18,0.0,0,0,0,0,0,0,0,0,0,0,0,0,0,0,0,0,0,0,0,0,0,0,0,0,0,0,0,0,0,0,0,0,0,0,0,0,0,0,0,0,0,0,0,0,0,0,0,0,Sebastian Jung,Â£450Th. ,30.0,179.0,Defender - Right-Back,right,Karlsruher SC,7.0,0.0,1.0,535.0,7.0,0.0,0.0,411.0,2.0,0.0,0.0,147.0,10.0,0.0,1.0,766.0,0.0,0.0,0.0,0.0,Bundesliga,15-07-16,17.3.2.23,Sebastian Jung,35017378,771,22-Jun-90,26,1,0,19,0,4450,6700,6450,139,134,5841142,179,72,D/WB R,3,1,1,1,2,2,1,1,2,4,1,8,14,11,7,11,6,8,10,16,14,12,7,13,12,16,14,14,13,13,11,12,16,9,9,13,12,15,16,14,13,13,8,10,14,16,20,15,10,15,8,15,10,10,7,13,14,10,17,15,18,4,Sebastian Jung,Â£1.80m ,Bundesliga
19-06-17,18.3.4.28,Julian Korb,35017439,771,21-Mar-92,25,0,0,10,0,4500,6500,6500,139,130,8840985,177,69,D/WB RC,1,1,1,3,2,3,2,1,3,2,1,6,10,11,6,12,6,8,7,10,11,13,6,12,13,10,15,9,15,13,10,14,10,8,7,10,12,17,12,16,16,8,8,9,12,13,20,14,7,14,6,12,10,17,7,10,16,9,14,15,17,3,20,20,15,12,20,10,15,D/WB RC,113,1,1,1,8,1,12,13,10,20,15,15,1,12,10,20,0.0,0,0,0,0,0,0,0,0,0,0,0,0,0,0,0,0,0,0,0,0,0,0,0,0,0,0,0,0,0,0,0,0,0,0,0,0,0,0,0,0,0,0,0,0,0,0,0,0,Julian Korb,Â£2.70m ,28.0,177.0,Defender - Right-Back,right,Without Club,21.0,1.0,1.0,1322.0,29.0,1.0,2.0,2431.0,12.0,0.0,0.0,1007.0,27.0,1.0,4.0,2111.0,nan,nan,nan,nan,Bundesliga,15-07-16,17.3.2.23,Julian Korb,35017439,771,21-Mar-92,24,0,0,10,0,4600,6600,6600,139,132,12171102,177,69,D/WB RC,1,1,1,3,3,1,1,2,1,4,3,6,10,11,6,12,6,8,7,10,11,13,6,12,13,10,15,9,15,13,10,14,10,8,7,10,13,17,12,16,16,8,8,9,12,14,20,14,7,14,6,12,10,17,7,10,16,9,14,15,17,3,Julian Korb,Â£2.70m ,Bundesliga
19-06-17,18.3.4.28,Matthias Zimmermann,35017462,771,16-Jun-92,25,0,0,0,0,2800,5800,5800,120,116,1494444,177,77,D/WB/DM/M RC,3,1,2,2,3,1,4,2,1,2,3,8,10,9,7,11,6,8,9,10,11,13,7,13,12,11,14,9,12,13,10,14,10,7,10,8,13,16,12,12,13,9,8,9,14,12,20,14,10,12,7,10,6,17,7,13,12,8,15,15,17,5,20,16,17,10,20,12,17,D/WB/DM/M RC,133,1,1,1,1,1,10,1,12,20,18,17,1,10,10,16,0.0,0,0,0,0,0,0,0,0,0,0,0,0,0,0,0,0,0,0,0,0,0,0,0,0,0,0,0,0,0,0,0,0,0,0,0,0,0,0,0,0,0,0,0,0,0,0,0,0,Matthias Zimmermann,Â£900Th. ,28.0,177.0,Defender - Right-Back,right,Fortuna DÃ¼sseldorf,30.0,1.0,0.0,1726.0,7.0,0.0,0.0,427.0,36.0,1.0,3.0,3230.0,38.0,2.0,4.0,3250.0,5.0,1.0,0.0,288.0,Bundesliga
19-06-17,18.3.4.28,Panagiotis Retsos,36105386,772,09-Aug-98,18,0,0,0,0,5650,6400,6650,155,128,25538249,185,76,D RLC,2,2,2,1,3,2,1,3,2,1,3,3,9,9,6,11,6,14,7,12,14,13,7,15,13,14,14,16,15,11,10,11,15,8,12,7,11,15,12,12,13,15,14,10,13,16,20,15,11,13,9,16,6,17,13,17,12,16,14,9,14,5,20,12,10,1,16,16,20,D RLC,106,1,1,1,1,1,1,20,16,16,14,10,1,1,12,12,1.15292e+18,0,0,0,0,0,0,0,0,0,0,0,0,0,0,0,0,0,0,0,0,0,0,0,0,0,0,0,0,0,0,0,0,0,0,0,0,0,0,0,0,0,0,0,0,0,0,0,0,Panagiotis Retsos,Â£16.20m ,22.0,186.0,Defender - Centre-Back,right,AS Saint-Ãtienne,34.0,0.0,0.0,2712.0,34.0,1.0,3.0,2437.0,1.0,0.0,0.0,31.0,7.0,0.0,0.0,285.0,2.0,0.0,0.0,138.0,Bundesliga
19-06-17,18.3.4.28,Giulio Donati,43036529,776,05-Feb-90,27,0,0,25,0,5000,6500,6500,132,130,7905881,179,82,D/WB R,2,1,2,3,2,3,1,2,1,3,3,7,12,9,6,10,5,9,7,15,14,11,6,16,10,16,15,13,10,12,8,11,17,6,12,10,14,16,13,13,12,14,9,9,16,15,20,17,12,13,14,13,7,12,12,15,13,13,15,8,8,10,20,20,12,12,20,10,14,D/WB R,112,1,1,1,1,1,12,14,10,20,1,1,1,12,10,20,274878000000.0,0,0,0,0,0,0,0,0,0,0,0,0,0,0,0,0,0,0,0,0,0,0,0,0,0,0,0,0,0,0,0,0,0,0,0,0,0,0,1,0,0,0,0,0,0,0,0,0,Giulio Donati,Â£3.15m ,30.0,178.0,Defender - Right-Back,right,AC Monza,37.0,0.0,2.0,3267.0,31.0,0.0,3.0,2495.0,9.0,0.0,0.0,624.0,20.0,1.0,0.0,1762.0,4.0,0.0,0.0,360.0,Bundesliga,15-07-16,17.3.2.23,Giulio Donati,43036529,776,05-Feb-90,26,0,0,25,0,5047,6547,6547,132,131,8648765,179,82,D/WB R,3,2,3,4,1,4,3,2,2,1,2,7,12,9,6,10,5,9,7,15,14,11,6,16,10,16,15,13,10,12,8,10,17,6,12,10,14,16,14,13,12,14,9,9,16,16,20,17,12,13,14,13,7,12,12,15,13,13,15,9,8,9,Giulio Donati,Â£3.15m ,Bundesliga
19-06-17,18.3.4.28,GÃ´toku Sakai,45015318,116,14-Mar-91,26,34,0,7,2,4700,6700,6700,139,139,12085826,175,72,D/WB/DM RL,2,2,2,3,1,3,1,1,1,3,1,12,15,11,7,11,10,8,8,14,12,13,7,14,12,16,13,15,10,10,12,12,15,13,13,11,12,14,16,12,14,11,9,18,14,12,20,15,9,11,10,11,4,16,10,14,14,9,17,11,13,4,20,20,14,10,20,18,14,D/WB/DM RL,125,1,1,1,1,10,10,1,18,20,16,14,10,10,18,20,140875000000000.0,0,0,0,0,0,0,0,0,0,0,0,0,0,0,0,0,0,0,0,0,0,0,0,0,0,0,0,0,0,0,0,0,0,0,0,0,0,1,0,0,0,0,0,0,0,0,0,1,Gotoku Sakai,Â£1.35m ,29.0,176.0,Defender - Left-Back,right,Vissel Kobe,37.0,1.0,3.0,3052.0,29.0,0.0,0.0,2379.0,51.0,0.0,4.0,4297.0,30.0,1.0,7.0,2406.0,nan,nan,nan,nan,Bundesliga,15-07-16,17.3.2.23,GÃ´toku Sakai,45015318,116,14-Mar-91,25,27,0,7,2,5300,6800,6800,139,136,16204611,175,72,D/WB RL,3,1,3,4,2,1,1,1,1,2,1,11,15,12,7,12,10,8,8,14,11,13,7,12,13,16,11,14,10,10,12,12,15,13,13,12,10,14,16,12,15,11,9,18,14,12,20,15,9,11,10,11,4,14,10,14,14,9,17,11,13,4,Gotoku Sakai,Â£2.70m ,Bundesliga
19-06-17,18.3.4.28,Aleksandar Ignjovski,62013411,802,27-Jan-91,26,12,0,10,1,4200,6200,6200,128,124,4762059,175,71,D/WB/DM/M RC,1,3,1,1,2,4,1,4,3,2,2,8,10,12,6,9,6,8,7,12,14,11,10,15,10,18,10,16,8,12,9,8,18,6,11,10,12,13,17,14,15,12,8,14,16,13,20,16,8,13,14,11,4,19,14,16,12,14,17,12,10,5,20,16,18,12,20,14,18,D/WB/DM/M RC,133,1,1,1,10,12,12,1,14,20,18,18,12,12,10,16,0.0,0,0,0,0,0,0,0,0,0,0,0,0,0,0,0,0,0,0,0,0,0,0,0,0,0,0,0,0,0,0,0,0,0,0,0,0,0,0,0,0,0,0,0,0,0,0,0,0,Aleksandar Ignjovski,Â£450Th. ,29.0,175.0,Midfielder - Defensive Midfield,right,Holstein Kiel,21.0,0.0,0.0,1243.0,1.0,0.0,0.0,55.0,17.0,0.0,0.0,1059.0,22.0,0.0,0.0,1261.0,5.0,0.0,0.0,224.0,Bundesliga,15-07-16,17.3.2.23,Aleksandar Ignjovski,62013411,802,27-Jan-91,25,11,0,10,1,3446,6196,5946,128,124,2648542,175,68,D/WB/DM/M RC,2,3,1,3,3,2,4,2,2,3,2,8,11,12,6,10,6,8,7,12,14,11,10,15,10,18,10,16,8,12,9,8,18,6,11,10,11,14,18,14,15,12,8,14,16,13,20,16,7,13,14,11,4,19,14,16,12,14,17,12,10,5,Aleksandar Ignjovski,Â£1.35m ,Bundesliga
19-06-17,18.3.4.28,Lukasz Piszczek,719130,787,03-Jun-85,32,55,3,8,2,5250,7250,7250,161,145,232186002,184,79,D/WB R,2,3,3,1,2,2,2,1,1,2,2,9,14,11,10,12,8,10,12,17,11,13,9,13,12,16,12,14,12,15,11,13,14,10,10,14,11,17,14,13,11,14,11,12,18,15,20,16,13,17,8,16,10,18,15,10,16,13,18,16,18,4,20,20,14,14,20,14,1,D/WB R,112,1,1,8,1,12,14,1,14,20,1,1,12,14,14,20,2.8823e+17,0,0,0,0,0,0,0,0,0,0,0,0,0,0,0,0,0,0,0,0,1,0,0,0,0,0,0,0,0,0,0,0,0,0,0,0,0,0,0,0,0,0,0,0,0,0,0,0,Lukasz Piszczek,Â£3.60m ,35.0,184.0,Defender - Right-Back,right,Borussia Dortmund,39.0,5.0,4.0,3134.0,31.0,0.0,5.0,2800.0,26.0,1.0,6.0,2329.0,38.0,1.0,4.0,2731.0,4.0,0.0,0.0,132.0,Bundesliga,15-07-16,17.3.2.23,Lukasz Piszczek,719130,787,03-Jun-85,31,50,2,8,2,5250,7250,7250,161,145,232186002,184,79,D/WB R,2,3,1,2,2,2,3,1,4,3,1,9,14,11,10,12,8,10,12,17,11,13,9,13,12,16,12,14,12,15,11,13,14,10,10,14,11,17,14,13,11,14,11,12,18,15,20,16,13,17,8,16,10,18,15,10,16,13,18,16,18,4,Lukasz Piszczek,Â£4.50m ,Bundesliga
19-06-17,18.3.4.28,Carlos Salcedo,72039283,379,29-Sep-93,23,13,0,0,0,4500,6750,6500,137,130,7524540,188,77,D RC,3,4,1,2,2,1,4,1,3,2,3,5,8,9,6,12,5,12,8,14,15,10,9,16,10,15,13,18,10,13,9,10,17,5,11,7,14,12,14,14,12,16,14,11,13,12,20,13,14,12,14,13,5,12,12,14,7,14,10,8,10,12,20,11,1,1,15,10,20,D RC,103,1,1,1,1,1,1,20,10,15,1,1,1,1,6,11,0.0,0,0,0,0,0,0,0,0,0,0,0,0,0,0,0,0,0,0,0,0,0,0,0,0,0,0,0,0,0,0,0,0,0,0,0,0,0,0,0,0,0,0,0,0,0,0,0,0,Carlos Salcedo,Â£6.30m ,27.0,184.0,Defender - Centre-Back,right,Tigres UANL,23.0,0.0,1.0,1749.0,24.0,0.0,0.0,1996.0,32.0,2.0,0.0,2595.0,23.0,1.0,0.0,1822.0,10.0,0.0,0.0,708.0,Bundesliga,15-07-16,17.3.2.23,Carlos Salcedo,72039283,379,29-Sep-93,22,6,0,0,0,2500,6400,6550,148,131,8640621,186,89,D C,3,1,2,2,2,2,2,1,1,2,1,7,9,12,5,12,7,12,8,11,13,10,11,14,10,11,13,13,12,15,11,14,11,5,11,8,13,12,13,11,12,15,13,10,14,11,20,14,13,12,8,13,5,11,14,14,5,10,10,9,15,12,Carlos Salcedo,Â£3.15m ,Serie A
19-06-17,18.3.4.28,Peter Pekarik,7563749,794,30-Oct-86,30,75,2,7,0,4500,6750,6500,130,130,6263601,176,72,D/WB R,1,2,1,2,3,2,2,1,3,3,3,8,14,10,5,11,5,10,6,13,12,12,6,14,11,12,16,10,13,16,9,13,12,6,12,10,14,18,13,14,15,10,8,10,15,13,20,16,8,18,8,17,5,10,14,14,16,13,15,17,18,3,20,18,8,8,20,14,10,D/WB R,112,1,1,1,1,1,8,10,14,20,1,1,1,8,12,18,0.0,0,0,0,0,0,0,0,0,0,0,0,0,0,0,0,0,0,0,0,0,0,0,0,0,0,0,0,0,0,0,0,0,0,0,0,0,0,0,0,0,0,0,0,0,0,0,0,0,Peter Pekarik,Â£1.58m ,33.0,177.0,Defender - Right-Back,right,Hertha BSC,36.0,1.0,2.0,3215.0,23.0,1.0,2.0,1887.0,4.0,0.0,1.0,288.0,12.0,0.0,2.0,1040.0,6.0,2.0,0.0,371.0,Bundesliga,15-07-16,17.3.2.23,Peter Pekarik,7563749,794,30-Oct-86,29,71,2,7,0,4500,6750,6500,130,130,4038114,176,72,D/WB R,3,3,2,3,4,1,1,3,2,3,1,8,14,10,5,11,5,10,6,13,12,12,6,14,11,12,16,10,13,16,9,13,12,6,12,10,14,18,13,14,15,10,8,10,15,13,20,16,8,18,8,17,5,10,14,14,16,13,15,17,18,3,Peter Pekarik,Â£2.25m ,Bundesliga
19-06-17,18.3.4.28,Miiko Albornoz,8109538,1652,30-Nov-90,26,8,1,0,0,3700,5950,6200,135,129,6126951,180,80,D/WB RL,2,3,3,2,2,3,4,4,2,3,2,11,14,12,8,14,9,8,11,15,10,13,10,11,15,14,11,10,15,12,12,14,12,14,7,11,10,14,12,12,13,13,10,20,16,14,9,14,12,13,8,13,5,14,10,13,15,11,14,12,13,11,20,20,12,12,16,20,1,D/WB RL,115,1,1,1,1,12,10,1,20,16,1,1,12,10,20,16,140759000000000.0,0,0,0,0,0,0,0,0,0,0,0,0,0,0,1,0,0,0,0,0,0,0,0,0,0,0,0,0,0,0,0,0,1,0,1,0,0,0,0,0,0,0,0,0,0,0,0,1,Miiko Albornoz,Â£1.35m ,29.0,180.0,Defender - Left-Back,left,Without Club,27.0,0.0,2.0,2174.0,11.0,0.0,2.0,790.0,23.0,1.0,3.0,1705.0,19.0,0.0,1.0,1343.0,nan,nan,nan,nan,Bundesliga
19-06-17,18.3.4.28,Marcel Tisserand,85095880,53,10-Jan-93,24,10,0,4,0,5000,6500,6500,138,130,9261558,190,80,D RLC,1,3,2,1,2,1,2,3,1,1,3,6,11,13,7,13,6,11,8,10,15,12,5,15,12,14,14,16,9,11,10,10,16,12,12,9,12,10,14,14,12,15,17,8,15,16,20,13,14,13,8,13,6,14,12,14,7,13,16,14,12,11,20,12,8,8,16,15,20,D RLC,106,1,1,5,1,1,8,20,15,16,1,1,1,8,11,12,34359738368.0,0,0,0,0,0,0,0,0,0,0,0,0,0,0,0,0,0,0,0,0,0,0,0,0,0,0,0,0,0,0,0,0,0,0,0,1,0,0,0,0,0,0,0,0,0,0,0,0,Marcel Tisserand,Â£6.75m ,27.0,190.0,Defender - Centre-Back,right,Fenerbahce SK,29.0,0.0,2.0,2479.0,19.0,0.0,1.0,1519.0,12.0,1.0,0.0,1068.0,23.0,1.0,2.0,1905.0,4.0,0.0,0.0,360.0,Bundesliga,15-07-16,17.3.2.23,Marcel Tisserand,85095880,53,10-Jan-93,23,1,0,4,0,5500,6500,6500,146,130,7643252,190,80,D RC,3,3,2,2,2,1,3,2,3,1,2,6,11,13,7,13,6,11,8,10,15,12,5,15,12,14,14,16,9,11,10,10,16,12,12,9,12,10,14,14,12,15,17,8,15,16,20,13,14,13,8,13,6,14,11,14,12,13,16,14,12,6,Marcel Tisserand,Â£2.70m ,Bundesliga
19-06-17,18.3.4.28,Benjamin Pavard,85120944,769,28-Mar-96,21,0,0,11,0,4950,6200,6450,165,129,7880477,186,76,D RC,2,3,2,3,1,2,2,2,4,1,1,5,9,10,7,12,5,13,9,10,14,14,10,13,14,14,16,14,17,11,13,14,13,9,11,7,15,16,9,9,11,13,14,10,12,11,20,13,12,12,8,15,6,15,12,14,12,10,14,15,17,6,20,11,12,1,16,12,20,D RC,103,1,1,1,1,1,1,20,12,16,14,12,1,1,7,11,1.15306e+18,0,0,0,0,0,0,0,0,0,0,0,0,0,0,0,0,0,0,0,0,0,0,0,0,0,0,0,0,0,0,0,0,1,0,0,0,0,0,0,0,0,0,0,0,0,0,0,1,Benjamin Pavard,Â£27.00m ,24.0,186.0,Defender - Right-Back,right,Bayern Munich,21.0,1.0,2.0,1699.0,36.0,1.0,0.0,3270.0,31.0,0.0,0.0,2786.0,47.0,4.0,7.0,3978.0,7.0,0.0,0.0,531.0,Bundesliga
19-06-17,18.3.4.28,Paul Verhaegh,857021,784,01-Sep-83,33,3,0,15,0,4750,6500,6750,141,135,232186002,178,74,D/WB R,2,1,3,2,2,4,3,2,3,3,1,9,13,9,6,12,6,10,7,12,14,12,18,14,13,11,16,12,17,18,10,16,12,8,15,10,14,18,12,11,13,10,8,12,15,11,20,13,9,18,8,18,3,8,15,11,15,13,18,16,18,5,20,18,8,8,20,1,1,D/WB R,112,1,1,1,1,1,8,1,1,20,1,1,1,8,1,18,5.76461e+17,0,0,0,0,0,0,0,0,0,0,0,0,0,0,0,0,0,0,0,0,0,0,0,0,0,0,0,0,0,0,0,0,0,0,0,0,0,0,1,0,0,0,0,0,0,0,0,0,Paul Verhaegh,Â£900Th. ,37.0,178.0,Defender - Right-Back,right,Retired,31.0,3.0,2.0,2764.0,33.0,2.0,2.0,2797.0,3.0,0.0,0.0,270.0,8.0,0.0,0.0,452.0,nan,nan,nan,nan,Bundesliga,15-07-16,17.3.2.23,Paul Verhaegh,857021,784,01-Sep-83,32,3,0,15,0,6000,6750,7000,141,140,232186002,178,72,D/WB R,1,1,3,2,2,3,2,2,1,4,1,9,13,9,6,13,6,11,7,12,14,12,18,14,13,11,16,12,17,18,10,16,12,8,15,11,14,18,12,11,13,11,8,12,15,12,20,15,9,18,8,18,3,8,15,11,15,13,18,16,18,5,Paul Verhaegh,Â£900Th. ,Bundesliga
19-06-17,18.3.4.28,Christoph Janker,8713751,771,14-Feb-85,32,0,0,13,0,3050,6050,6050,125,121,1769370,185,78,D RC,2,3,4,1,3,2,3,1,1,2,1,10,9,7,7,10,7,11,8,12,14,11,10,14,10,10,12,13,10,15,8,12,13,7,11,8,14,18,12,10,10,13,12,15,14,11,20,14,13,16,8,15,10,16,6,10,15,12,17,14,16,4,20,14,12,1,16,10,20,D RC,103,1,1,1,1,1,1,20,10,16,12,12,1,1,8,14,0.0,0,0,0,0,0,0,0,0,0,0,0,0,0,0,0,0,0,0,0,0,0,0,0,0,0,0,0,0,0,0,0,0,0,0,0,0,0,0,0,0,0,0,0,0,0,0,0,0,Christoph Janker,Â£135Th. ,35.0,185.0,Defender - Centre-Back,right,Retired,17.0,0.0,0.0,1265.0,5.0,0.0,0.0,73.0,4.0,0.0,0.0,69.0,nan,nan,nan,nan,nan,nan,nan,nan,Bundesliga,15-07-16,17.3.2.23,Christoph Janker,8713751,771,14-Feb-85,31,0,0,13,0,2650,6150,6150,125,123,944382,185,78,D RC,2,1,2,3,2,1,3,1,3,1,2,10,9,7,7,10,7,11,8,12,14,11,10,14,10,10,12,13,10,15,8,12,13,7,11,8,14,18,13,11,10,12,12,15,14,11,20,15,13,16,8,15,10,16,6,10,15,12,17,14,16,4,Christoph Janker,Â£270Th. ,Bundesliga
19-06-17,18.3.4.28,Andreas Beck,8723862,771,13-Mar-87,30,9,0,27,2,4500,6500,6500,142,130,232186002,180,74,D/WB RL,1,1,2,2,1,4,4,2,4,2,2,6,11,9,5,11,5,8,8,13,13,12,7,14,12,11,15,10,12,15,10,14,11,6,13,10,13,17,14,13,14,10,9,12,17,13,20,16,9,16,8,11,6,15,14,12,15,10,17,15,17,5,20,18,9,1,20,15,9,D/WB RL,115,1,1,1,1,1,1,8,15,20,1,9,1,1,13,18,274878000000.0,0,0,0,0,0,0,0,0,0,0,0,0,0,0,0,0,0,0,0,0,0,0,0,0,0,0,0,0,0,0,0,0,0,0,0,0,0,0,1,0,0,0,0,0,0,0,0,0,Andreas Beck,Â£2.70m ,33.0,nan,Defender - Right-Back,nan,KAS Eupen,30.0,1.0,3.0,1926.0,29.0,1.0,2.0,2363.0,24.0,0.0,2.0,1777.0,28.0,1.0,1.0,2490.0,3.0,0.0,0.0,89.0,Bundesliga
19-06-17,18.3.4.28,Fabian Johnson,8726381,390,11-Dec-87,29,56,2,0,0,5400,6900,6900,149,143,18946115,183,70,D/WB/M/AM RL,3,3,1,3,3,2,1,1,2,3,3,10,13,12,11,12,10,8,11,16,9,10,9,10,11,16,9,13,10,12,10,9,13,11,8,14,8,13,16,14,13,11,11,20,17,17,15,14,9,12,9,13,5,18,10,15,12,12,15,16,18,5,17,18,20,20,16,20,10,D/WB/M/AM RL,445,1,1,1,1,20,12,1,17,16,10,10,20,12,18,16,135266304.0,0,0,0,0,0,0,0,0,0,0,0,0,0,0,0,0,0,0,0,0,1,0,0,0,0,0,0,1,0,0,0,0,0,0,0,0,0,0,0,0,0,0,0,0,0,0,0,0,Fabian Johnson,Â£4.05m ,32.0,183.0,Forward - Left Winger,right,Without Club,35.0,4.0,4.0,2038.0,12.0,1.0,0.0,479.0,18.0,1.0,1.0,1008.0,7.0,0.0,0.0,298.0,nan,nan,nan,nan,Bundesliga,15-07-16,17.3.2.23,Fabian Johnson,8726381,390,11-Dec-87,28,49,2,0,0,6700,7450,7200,149,149,27448186,183,70,D/WB/M/AM RL,1,3,1,2,2,3,2,2,1,1,1,10,13,12,11,12,10,8,11,16,9,10,9,10,11,16,9,13,10,12,10,9,13,11,8,14,8,13,16,15,13,11,11,20,17,17,15,16,9,12,9,13,5,18,10,15,12,12,15,16,18,5,Fabian Johnson,Â£5.40m ,Bundesliga
19-06-17,18.3.4.28,Rafinha,8833533,1651,07-Sep-85,31,4,0,15,3,6500,7250,7500,151,145,26527483,172,68,D/WB RL,4,2,1,3,3,2,2,1,1,1,2,10,15,13,10,14,8,7,11,10,12,13,17,16,14,16,13,10,14,11,12,14,15,13,7,13,12,10,16,15,16,8,6,14,14,13,20,16,7,13,16,13,3,12,14,10,12,12,10,6,8,17,20,20,12,12,20,16,10,D/WB RL,115,1,1,1,1,1,12,1,16,20,10,10,1,12,16,20,196608.0,0,0,0,0,0,0,0,0,0,0,0,0,0,0,0,0,1,1,0,0,0,0,0,0,0,0,0,0,0,0,0,0,0,0,0,0,0,0,0,0,0,0,0,0,0,0,0,0,Rafinha,Â£25.20m ,27.0,174.0,Midfielder - Attacking Midfield,left,Paris Saint-Germain,28.0,7.0,5.0,1567.0,18.0,2.0,3.0,1062.0,8.0,1.0,0.0,348.0,33.0,4.0,2.0,2344.0,3.0,0.0,1.0,154.0,Serie A,15-07-16,17.3.2.23,Rafinha,67100016,1651,12-Feb-93,23,2,1,5,0,6800,7200,7550,167,153,42867644,174,71,M/AM RLC,1,1,1,2,2,2,1,2,1,3,2,14,15,16,11,15,13,11,12,8,8,15,13,12,15,16,12,14,12,13,14,13,14,13,11,13,12,14,17,15,13,14,8,20,14,13,8,16,12,13,11,14,6,14,13,13,12,12,13,12,13,7,Rafinha,Â£13.50m ,LaLiga
19-06-17,18.3.4.28,Markus Feulner,883735,771,12-Feb-82,35,0,0,13,1,2900,5900,4900,135,118,11629,183,82,DM/M RLC,3,1,3,2,1,3,1,1,2,1,1,12,11,9,10,12,11,7,14,12,10,14,10,12,13,11,15,13,15,14,13,14,13,10,15,8,12,17,10,8,9,14,10,12,13,8,20,10,12,16,8,16,15,18,18,16,8,12,17,14,12,10,15,11,20,10,15,15,20,DM/M RLC,316,1,1,1,10,8,8,1,15,15,20,20,8,8,11,11,2048.0,0,0,0,0,0,0,0,0,0,0,0,1,0,0,0,0,0,0,0,0,0,0,0,0,0,0,0,0,0,0,0,0,0,0,0,0,0,0,0,0,0,0,0,0,0,0,0,0,Markus Suttner,Â£2.25m ,33.0,179.0,Defender - Left-Back,left,Austria Vienna,33.0,4.0,5.0,2856.0,17.0,0.0,1.0,1447.0,9.0,1.0,1.0,761.0,22.0,0.0,1.0,1489.0,6.0,0.0,1.0,508.0,Premier League,15-07-16,17.3.2.23,Markus Feulner,883735,771,12-Feb-82,34,0,0,13,1,4346,6346,6346,135,127,490604,183,82,DM/M RLC,1,1,3,3,3,3,3,3,2,3,2,12,12,9,10,13,11,7,14,12,10,14,10,11,13,11,15,13,15,16,13,14,13,10,14,8,11,17,12,9,10,14,9,12,13,10,20,12,13,16,8,16,15,18,20,16,8,12,17,14,12,10,Markus Feulner,Â£270Th. ,Bundesliga
19-06-17,18.3.4.28,Sascha Riether,890204,771,23-Mar-83,34,2,0,20,0,4750,6250,6250,136,125,702591,174,71,D/WB R,4,1,1,2,3,3,3,2,1,3,1,8,11,10,6,13,7,10,6,14,13,12,9,14,12,11,16,12,14,15,9,14,16,7,13,10,12,18,12,12,13,12,8,10,17,14,20,13,9,17,6,17,9,17,11,11,15,13,18,15,13,4,20,16,14,10,20,8,14,D/WB R,112,1,1,1,1,1,10,13,8,20,14,14,1,10,8,16,274895000000.0,0,0,0,0,0,0,0,0,0,0,0,0,0,0,0,0,0,0,0,0,0,0,0,0,1,0,0,0,0,0,0,0,0,0,0,0,0,0,1,0,0,0,0,0,0,0,0,0,Sascha Riether,Â£450Th. ,37.0,174.0,Defender - Right-Back,right,Retired,9.0,0.0,0.0,582.0,0.0,0.0,0.0,0.0,1.0,0.0,0.0,1.0,nan,nan,nan,nan,nan,nan,nan,nan,Bundesliga,15-07-16,17.3.2.23,Sascha Riether,890204,771,23-Mar-83,33,2,0,20,0,4200,6450,6700,136,129,489161,174,71,D/WB R,2,1,2,1,1,3,3,3,1,2,3,9,11,10,6,13,7,10,6,14,13,12,9,14,12,11,16,12,14,16,8,14,16,7,13,10,12,18,12,12,13,12,8,10,17,15,20,13,9,17,6,17,9,17,11,11,15,13,18,15,13,4,Sascha Riether,Â£450Th. ,Bundesliga
19-06-17,18.3.4.28,Timothy Chandler,91001071,390,29-Mar-90,27,29,1,0,0,4550,6050,6550,133,131,9017617,186,80,D/WB RL,2,2,3,3,4,3,2,2,4,3,1,8,13,10,7,11,7,10,9,17,12,10,6,12,11,14,10,14,8,13,9,10,15,9,10,12,11,12,16,14,11,15,13,8,13,16,20,16,14,13,8,13,9,15,10,12,10,11,14,13,11,6,20,20,14,14,20,16,10,D/WB RL,115,1,1,1,1,1,14,10,16,20,8,8,1,14,16,20,0.0,0,0,0,0,0,0,0,0,0,0,0,0,0,0,0,0,0,0,0,0,0,0,0,0,0,0,0,0,0,0,0,0,0,0,0,0,0,0,0,0,0,0,0,0,0,0,0,0,Timothy Chandler,Â£4.50m ,30.0,186.0,Defender - Right-Back,right,Eintracht Frankfurt,38.0,0.0,6.0,3237.0,25.0,3.0,4.0,1983.0,1.0,0.0,0.0,16.0,33.0,5.0,1.0,1575.0,4.0,0.0,0.0,66.0,Bundesliga,15-07-16,17.3.2.23,Timothy Chandler,91001071,390,29-Mar-90,26,26,1,0,0,5050,6550,6550,133,131,7692404,186,80,D/WB R,1,1,1,2,1,2,2,1,3,2,1,8,13,10,8,11,7,10,9,17,12,10,6,12,11,14,10,14,8,12,9,10,15,9,9,14,10,12,16,16,11,15,13,8,13,15,20,16,14,13,8,13,9,15,10,12,10,11,14,13,11,6,Timothy Chandler,Â£3.15m ,Bundesliga
19-06-17,18.3.4.28,Daniel Caligiuri,91003264,771,15-Jan-89,28,0,0,0,0,5050,6550,7050,141,141,23132297,182,79,WB/M/AM RL,4,4,1,2,2,1,3,2,3,2,2,10,12,13,11,12,10,8,12,12,9,11,14,14,12,16,11,13,11,12,12,10,12,14,7,12,10,14,16,13,12,15,9,10,14,16,20,16,12,13,8,13,8,16,9,14,12,11,15,13,10,8,12,20,18,18,20,16,10,WB/M/AM RL,225,1,1,10,10,16,18,1,1,12,1,1,16,18,1,20,1.44115e+17,0,0,0,0,0,0,0,0,0,0,1,0,0,0,0,0,0,0,0,0,0,0,0,0,0,0,0,0,0,0,0,0,0,0,0,0,0,0,0,0,0,0,0,0,0,0,0,0,Daniel Caligiuri,Â£6.75m ,32.0,182.0,Midfielder - Right Midfield,right,FC Augsburg,41.0,6.0,6.0,2969.0,37.0,6.0,11.0,3187.0,40.0,7.0,5.0,3516.0,30.0,4.0,5.0,2466.0,6.0,3.0,1.0,511.0,Bundesliga,15-07-16,17.3.2.23,Daniel Caligiuri,91003264,771,15-Jan-89,27,0,0,0,0,4400,6900,6900,141,138,17783119,182,79,M/AM RL,2,1,3,2,3,2,2,3,2,3,1,10,12,14,13,12,10,8,14,11,7,11,14,9,13,16,11,13,9,12,10,10,12,14,7,12,9,14,16,15,13,15,9,9,14,17,20,14,12,13,8,13,8,15,9,14,12,11,15,13,10,8,Daniel Caligiuri,Â£4.50m ,Bundesliga
19-06-17,18.3.4.28,Oliver Sorg,91004882,771,29-May-90,27,1,0,5,0,4600,6600,6600,133,132,10192445,175,69,D/WB RL,4,1,2,2,2,1,3,1,3,2,3,6,10,10,8,12,8,9,14,15,13,11,5,15,11,11,16,14,10,14,8,12,13,7,11,10,13,16,12,12,15,13,8,15,14,12,20,15,9,13,10,13,6,14,7,12,15,12,15,13,11,3,20,18,12,8,20,17,12,D/WB RL,115,1,1,1,1,1,8,10,17,20,12,12,1,8,15,18,0.0,0,0,0,0,0,0,0,0,0,0,0,0,0,0,0,0,0,0,0,0,0,0,0,0,0,0,0,0,0,0,0,0,0,0,0,0,0,0,0,0,0,0,0,0,0,0,0,0,Oliver Sorg,Â£2.25m ,30.0,175.0,Defender - Right-Back,right,1.FC Nuremberg,28.0,0.0,0.0,2443.0,23.0,0.0,1.0,1780.0,20.0,0.0,0.0,1670.0,28.0,0.0,1.0,2061.0,1.0,0.0,0.0,0.0,Bundesliga
19-06-17,18.3.4.28,Matthias Ginter,91107789,771,19-Jan-94,23,14,0,18,1,6950,7450,7450,160,144,51026341,190,88,D/DM/M RC,2,3,2,3,3,2,1,1,2,2,3,6,12,7,10,13,7,15,10,14,14,13,11,14,12,11,15,12,16,15,12,16,12,6,10,9,14,17,12,10,9,13,14,12,16,12,20,14,15,13,8,13,7,16,8,15,13,13,16,16,18,3,20,11,17,10,15,1,20,D/DM/M RC,123,1,1,8,10,1,1,20,1,15,17,17,1,1,1,11,1.15292e+18,0,0,0,0,0,0,0,0,0,0,0,0,0,0,0,0,0,0,0,0,0,0,0,0,0,0,0,0,0,0,0,0,1,0,0,0,0,0,1,0,0,0,0,0,0,0,0,0,Matthias Ginter,Â£22.50m ,26.0,191.0,Defender - Centre-Back,right,Borussia MÃ¶nchengladbach,42.0,0.0,1.0,3382.0,37.0,5.0,2.0,3330.0,29.0,2.0,0.0,2560.0,36.0,1.0,2.0,3231.0,7.0,1.0,0.0,630.0,Bundesliga,15-07-16,17.3.2.23,Matthias Ginter,91107789,771,19-Jan-94,22,9,0,14,1,5200,7200,7200,162,144,54331288,190,88,D/DM/M RC,1,3,1,2,3,2,3,3,2,3,1,6,12,7,10,13,7,15,10,14,14,13,11,14,12,11,15,12,16,15,12,16,12,6,10,9,14,17,12,10,9,13,14,12,16,12,20,14,15,13,8,13,7,16,10,14,13,15,15,16,18,3,Matthias Ginter,Â£13.50m ,Bundesliga
19-06-17,18.3.4.28,Kevin Akpoguma,91109389,771,19-Apr-95,22,0,0,7,0,3750,6250,6250,142,125,7537873,192,83,D RLC,3,1,1,2,3,3,2,2,1,1,1,5,9,9,10,11,8,13,11,15,13,10,10,14,11,14,11,15,11,10,9,10,14,11,9,12,11,15,13,13,12,15,17,10,16,16,20,13,14,12,12,12,4,18,9,15,7,11,13,10,11,8,20,14,11,1,16,15,20,D RLC,106,1,1,8,1,1,1,20,15,16,11,11,1,1,13,14,1.15292e+18,0,0,0,0,0,0,0,0,0,0,0,0,0,0,0,0,0,0,0,0,0,0,0,0,0,0,0,0,0,0,0,0,0,0,0,0,0,0,0,0,0,0,0,0,0,0,0,0,Kevin Akpoguma,Â£7.20m ,25.0,192.0,Defender - Centre-Back,right,TSG 1899 Hoffenheim,30.0,1.0,0.0,2611.0,27.0,0.0,1.0,2126.0,14.0,0.0,0.0,992.0,20.0,0.0,0.0,1346.0,7.0,0.0,0.0,660.0,Bundesliga
19-06-17,18.3.4.28,Jonathan Tah,91119700,771,11-Feb-96,21,3,0,4,0,5600,7100,7100,171,142,48509716,192,90,D RC,4,1,1,1,2,3,1,1,3,3,1,6,10,9,5,12,5,12,5,13,15,12,7,14,13,10,14,13,16,10,11,12,10,8,10,5,13,15,9,13,11,16,17,12,14,17,20,13,17,14,6,14,4,10,8,13,7,14,14,16,16,11,20,11,10,1,15,1,20,D RC,103,1,1,1,1,1,1,20,1,15,10,10,1,1,1,11,4294967296.0,0,0,0,0,0,0,0,0,0,0,0,0,0,0,0,0,0,0,0,0,0,0,0,0,0,0,0,0,0,0,0,0,1,0,0,0,0,0,0,0,0,0,0,0,0,0,0,0,Jonathan Tah,Â£27.00m ,24.0,195.0,Defender - Centre-Back,right,Bayer 04 Leverkusen,26.0,1.0,1.0,2296.0,33.0,0.0,2.0,2936.0,38.0,3.0,1.0,3389.0,39.0,0.0,1.0,3136.0,2.0,0.0,0.0,41.0,Bundesliga,15-07-16,17.3.2.23,Jonathan Tah,91119700,771,11-Feb-96,20,1,0,3,0,5850,7100,7350,175,142,60601827,192,90,D RC,3,1,3,2,2,2,3,1,3,1,3,6,10,9,5,12,5,12,5,13,15,12,7,14,13,10,14,13,16,10,11,12,10,8,10,5,13,15,9,13,11,16,17,12,14,17,20,13,17,14,6,14,4,10,8,13,7,14,12,16,16,11,Jonathan Tah,Â£19.80m ,Bundesliga
19-06-17,18.3.4.28,Raphael Framberger,91122823,771,06-Sep-95,21,0,0,0,0,4200,5950,6200,129,119,8950512,179,0,D/WB R,3,3,1,1,1,4,3,1,1,3,3,10,12,11,7,9,4,7,10,15,13,10,6,13,10,14,12,10,9,13,8,9,12,7,8,11,13,13,16,14,12,11,8,9,13,17,20,15,10,12,9,14,14,10,7,10,14,10,16,14,16,4,20,20,12,12,20,1,10,D/WB R,112,1,1,1,1,1,12,1,1,20,10,10,1,12,1,20,0.0,0,0,0,0,0,0,0,0,0,0,0,0,0,0,0,0,0,0,0,0,0,0,0,0,0,0,0,0,0,0,0,0,0,0,0,0,0,0,0,0,0,0,0,0,0,0,0,0,Raphael Framberger,Â£675Th. ,25.0,179.0,Defender - Right-Back,right,FC Augsburg,5.0,0.0,1.0,233.0,12.0,0.0,0.0,893.0,8.0,0.0,0.0,667.0,18.0,0.0,2.0,1171.0,6.0,0.0,1.0,513.0,Bundesliga
19-06-17,18.3.4.28,Marius Wolf,91124151,771,27-May-95,22,0,0,0,0,4250,6500,6750,141,135,23549289,187,73,WB/M/AM RL,3,3,3,3,1,2,1,1,1,3,3,12,10,13,11,11,9,10,13,12,9,10,13,11,12,15,10,14,8,12,11,8,17,13,9,14,10,12,16,15,11,13,13,10,16,17,20,15,9,12,4,11,6,17,7,16,9,10,11,11,13,9,10,20,19,19,20,15,1,WB/M/AM RL,225,1,1,11,1,15,19,1,1,10,1,1,15,19,1,20,0.0,0,0,0,0,0,0,0,0,0,0,0,0,0,0,0,0,0,0,0,0,0,0,0,0,0,0,0,0,0,0,0,0,0,0,0,0,0,0,0,0,0,0,0,0,0,0,0,0,Marius Wolf,Â£9.00m ,25.0,187.0,Forward - Right Winger,right,1. FC KÃ¶ln,13.0,1.0,1.0,803.0,34.0,6.0,11.0,2790.0,22.0,1.0,0.0,1258.0,24.0,1.0,5.0,1615.0,3.0,0.0,0.0,224.0,Bundesliga,15-07-16,17.3.2.23,Marius Wolf,91124151,771,27-May-95,21,0,0,0,0,2800,5800,5800,130,116,4071736,185,68,M/AM RL,3,2,3,1,2,3,1,3,2,1,2,8,10,12,9,12,7,11,8,10,6,9,13,7,11,14,10,13,8,10,8,8,15,14,7,12,7,12,11,16,12,10,12,10,14,16,20,13,9,12,4,11,6,13,8,14,12,10,13,11,14,8,Marius Wolf,Â£450Th. ,Bundesliga
19-06-17,18.3.4.28,Benno Schmitz,91126210,771,17-Nov-94,22,0,0,0,0,2400,6150,5900,130,123,3938463,182,75,D/WB RC,2,2,3,3,1,2,2,3,2,1,2,12,11,8,7,11,10,8,10,14,12,13,9,13,11,12,14,12,13,14,9,13,12,6,8,10,12,16,14,12,10,13,10,10,16,12,20,15,11,15,7,14,4,17,9,15,12,13,16,14,16,7,20,18,15,1,20,14,15,D/WB RC,113,1,1,1,1,1,1,10,14,20,15,15,1,1,12,18,0.0,0,0,0,0,0,0,0,0,0,0,0,0,0,0,0,0,0,0,0,0,0,0,0,0,0,0,0,0,0,0,0,0,0,0,0,0,0,0,0,0,0,0,0,0,0,0,0,0,Benno Schmitz,Â£900Th. ,25.0,182.0,Defender - Right-Back,right,1. FC KÃ¶ln,17.0,0.0,2.0,1108.0,2.0,0.0,0.0,82.0,16.0,0.0,1.0,1322.0,20.0,0.0,0.0,1348.0,2.0,0.0,1.0,37.0,Bundesliga,15-07-16,17.3.2.23,Benno Schmitz,91126210,771,17-Nov-94,21,0,0,0,0,2947,5947,5947,135,119,3187049,182,75,D/WB RC,1,2,2,3,1,3,1,2,2,1,3,11,11,9,7,11,10,7,9,13,12,13,9,14,11,12,13,13,12,11,9,13,12,7,8,10,10,16,14,12,10,13,10,10,16,12,20,15,11,15,7,14,4,17,9,15,12,13,16,14,16,7,Benno Schmitz,Â£1.58m ,Bundesliga
19-06-17,18.3.4.28,Benjamin Henrichs,91132680,771,23-Feb-97,20,3,0,2,0,5050,7300,7050,167,141,45178016,183,77,D/WB/M RLC,2,4,2,1,3,3,1,1,2,4,3,9,11,12,9,15,10,8,11,13,10,14,11,13,15,12,14,15,15,10,12,13,14,9,13,10,10,16,12,12,14,14,12,14,15,12,20,15,11,13,8,16,4,18,11,16,12,15,14,14,12,8,20,16,17,14,20,18,17,D/WB/M RLC,126,1,1,1,14,10,10,1,18,20,13,17,10,10,14,16,4299161600.0,0,0,0,0,0,0,0,0,0,0,0,0,0,0,0,0,0,0,0,0,0,0,1,0,0,0,0,0,0,0,0,0,1,0,0,0,0,0,0,0,0,0,0,0,0,0,0,0,Benjamin Henrichs,Â£10.80m ,23.0,183.0,Defender - Right-Back,right,RB Leipzig,37.0,0.0,3.0,3069.0,28.0,0.0,1.0,1531.0,30.0,1.0,3.0,2517.0,15.0,0.0,0.0,1069.0,7.0,0.0,0.0,242.0,Bundesliga,15-07-16,17.3.2.23,Benjamin Henrichs,91132680,771,23-Feb-97,19,0,0,0,0,5491,6991,6991,167,140,36572894,183,77,D/WB/M RLC,3,1,2,3,3,3,1,3,1,2,3,9,11,12,9,15,10,8,11,13,10,14,11,12,15,14,13,15,15,10,12,13,14,9,13,10,10,16,12,12,14,14,12,14,15,12,20,15,11,13,8,14,4,18,11,16,12,15,14,14,12,8,Benjamin Henrichs,Â£9.00m ,Bundesliga
19-06-17,18.3.4.28,Lukas Klostermann,91134708,771,03-Jun-96,21,0,0,5,0,4700,6700,6700,151,129,12212575,189,83,D/WB RLC,3,2,3,3,1,1,1,3,3,3,1,7,11,8,8,9,6,12,6,15,13,10,5,14,10,12,14,16,9,12,9,10,14,7,11,10,11,13,14,14,10,15,15,12,16,18,20,14,14,13,8,13,8,16,12,16,7,13,13,15,17,6,20,16,10,10,20,15,18,D/WB RLC,116,1,1,1,1,8,10,18,15,20,8,8,8,10,11,16,0.0,0,0,0,0,0,0,0,0,0,0,0,0,0,0,0,0,0,0,0,0,0,0,0,0,0,0,0,0,0,0,0,0,0,0,0,0,0,0,0,0,0,0,0,0,0,0,0,0,Lukas Klostermann,Â£10.80m ,24.0,189.0,Defender - Centre-Back,right,RB Leipzig,1.0,0.0,0.0,90.0,39.0,1.0,0.0,3205.0,40.0,5.0,3.0,2965.0,43.0,4.0,2.0,3634.0,5.0,0.0,0.0,334.0,Bundesliga,15-07-16,17.3.2.23,Lukas Klostermann,91134708,771,03-Jun-96,20,0,0,5,0,4848,6348,6348,151,127,2153077,189,83,D/WB RC,2,3,2,2,4,2,1,4,1,1,3,7,11,8,8,9,6,12,6,15,13,10,5,14,10,12,14,16,9,12,8,10,14,7,11,10,11,13,14,14,9,15,15,12,16,18,20,14,14,13,8,13,6,16,12,16,7,13,13,15,17,6,Lukas Klostermann,Â£2.70m ,Bundesliga
19-06-17,18.3.4.28,Patrick Kammerbauer,91138634,771,11-Feb-97,20,0,0,0,0,2500,5750,6000,127,115,6374607,174,73,D/DM/M RC,2,1,2,3,3,2,2,2,1,1,2,6,9,10,7,11,6,8,9,12,14,12,7,14,11,15,12,16,10,12,9,11,14,7,9,9,11,14,15,12,14,14,9,12,17,12,20,13,9,14,10,13,3,16,8,13,12,11,13,15,15,6,20,14,18,1,20,1,18,D/DM/M RC,123,1,1,1,1,1,1,12,1,20,18,18,1,1,1,14,0.0,0,0,0,0,0,0,0,0,0,0,0,0,0,0,0,0,0,0,0,0,0,0,0,0,0,0,0,0,0,0,0,0,0,0,0,0,0,0,0,0,0,0,0,0,0,0,0,0,Patrick Kammerbauer,Â£630Th. ,23.0,174.0,Midfielder - Defensive Midfield,right,Eintracht Braunschweig,24.0,1.0,0.0,1358.0,19.0,2.0,1.0,1251.0,8.0,0.0,0.0,364.0,23.0,0.0,1.0,1642.0,1.0,0.0,0.0,14.0,Bundesliga
19-06-17,18.3.4.28,Yanni RegÃ¤sel,91138642,771,13-Jan-96,21,0,0,0,0,2250,5750,5750,124,115,2496359,180,72,D/WB R,1,1,2,4,3,2,2,2,3,3,3,8,12,9,6,10,7,10,6,13,14,10,7,14,11,14,11,16,10,13,8,11,15,7,10,9,12,14,13,14,12,14,10,8,16,13,20,15,10,16,10,15,6,9,6,16,9,14,13,8,8,14,20,18,1,1,20,1,14,D/WB R,112,1,1,1,1,1,1,14,1,20,12,1,1,1,1,18,17179869184.0,0,0,0,0,0,0,0,0,0,0,0,0,0,0,0,0,0,0,0,0,0,0,0,0,0,0,0,0,0,0,0,0,0,0,1,0,0,0,0,0,0,0,0,0,0,0,0,0,nan,nan,nan,nan,nan,nan,nan,nan,nan,nan,nan,nan,nan,nan,nan,nan,nan,nan,nan,nan,nan,nan,nan,nan,nan,nan,nan,nan,15-07-16,17.3.2.23,Yanni RegÃ¤sel,91138642,771,13-Jan-96,20,0,0,0,0,2700,5700,6200,128,119,7336488,180,72,D/WB R,2,1,2,2,1,1,2,3,1,1,1,8,12,9,6,11,7,10,6,13,14,10,7,14,11,14,12,16,11,14,9,12,15,7,11,10,12,14,13,14,12,14,10,8,16,13,20,15,10,16,10,15,6,9,6,16,9,14,13,8,8,14,Yanni RegÃ¤sel,Â£450Th. ,Bundesliga
19-06-17,18.3.4.28,Lukas KlÃ¼nter,91143017,771,26-May-96,21,0,0,0,0,3750,6250,6250,139,125,11163974,184,73,D/WB R,1,1,1,1,4,1,3,1,1,1,1,8,11,10,9,10,7,12,9,14,13,10,9,14,11,13,10,13,9,12,9,9,12,7,8,10,12,15,13,15,11,13,12,10,16,17,20,15,10,14,8,13,7,15,8,13,13,12,14,16,14,5,20,20,13,13,20,10,14,D/WB R,112,1,7,8,1,1,13,14,10,20,8,1,1,13,8,20,0.0,0,0,0,0,0,0,0,0,0,0,0,0,0,0,0,0,0,0,0,0,0,0,0,0,0,0,0,0,0,0,0,0,0,0,0,0,0,0,0,0,0,0,0,0,0,0,0,0,Lukas KlÃ¼nter,Â£2.70m ,24.0,184.0,Defender - Right-Back,right,Hertha BSC,25.0,2.0,6.0,2236.0,28.0,1.0,0.0,2047.0,12.0,0.0,0.0,720.0,24.0,0.0,2.0,1905.0,0.0,0.0,0.0,0.0,Bundesliga,15-07-16,17.3.2.23,Lukas KlÃ¼nter,91143017,771,26-May-96,20,0,0,0,0,2400,5400,5400,113,108,563531,184,73,D/WB R,4,1,1,2,3,2,2,1,3,2,1,7,11,10,9,9,7,12,9,13,12,10,9,13,10,13,9,13,10,10,9,9,12,7,8,10,10,15,12,15,10,13,13,10,12,14,20,12,11,14,8,13,7,15,8,13,13,12,14,16,14,5,Lukas KlÃ¼nter,Â£1.35m ,Bundesliga
19-06-17,18.3.4.28,Florian Baak,91151070,771,18-Mar-99,18,0,0,0,0,2050,4800,5050,113,96,673305,185,75,D RC,2,2,2,1,1,1,3,3,1,2,3,4,6,6,7,8,5,15,6,10,13,9,5,13,8,14,10,16,8,10,7,8,15,5,11,7,10,12,13,11,10,14,14,10,13,13,20,10,13,14,10,12,6,4,10,12,13,14,13,15,12,8,20,11,1,1,15,1,20,D RC,103,1,1,1,1,1,1,20,1,15,1,1,1,1,1,11,0.0,0,0,0,0,0,0,0,0,0,0,0,0,0,0,0,0,0,0,0,0,0,0,0,0,0,0,0,0,0,0,0,0,0,0,0,0,0,0,0,0,0,0,0,0,0,0,0,0,Florian Baak,Â£360Th. ,21.0,191.0,Defender - Centre-Back,right,FC Winterthur,23.0,3.0,0.0,1857.0,23.0,1.0,1.0,2023.0,27.0,5.0,2.0,2325.0,18.0,0.0,0.0,1567.0,9.0,0.0,0.0,810.0,Bundesliga
19-06-17,18.3.4.28,Leon Balogun,92002651,38,28-Jun-88,28,10,0,0,0,4200,6450,6200,126,124,4213024,190,81,D/WB RC,1,3,2,3,1,1,3,3,1,2,2,5,11,9,6,10,5,14,7,18,12,9,6,13,9,14,10,15,9,14,7,10,14,7,11,9,12,13,14,12,10,17,16,13,12,16,20,14,15,16,12,12,12,12,8,14,8,13,12,13,13,7,20,16,9,1,18,1,20,D/WB RC,113,1,1,1,1,1,1,20,1,18,10,9,1,1,1,16,0.0,0,0,0,0,0,0,0,0,0,0,0,0,0,0,0,0,0,0,0,0,0,0,0,0,0,0,0,0,0,0,0,0,0,0,0,0,0,0,0,0,0,0,0,0,0,0,0,0,Leon Balogun,Â£1.80m ,32.0,190.0,Defender - Centre-Back,right,Rangers FC,21.0,0.0,0.0,1317.0,15.0,0.0,0.0,1198.0,10.0,1.0,0.0,801.0,13.0,0.0,0.0,944.0,6.0,0.0,0.0,435.0,Bundesliga,15-07-16,17.3.2.23,Leon Balogun,92002651,38,28-Jun-88,28,7,0,0,0,4350,6350,6350,127,127,5686753,190,81,D/WB RC,3,2,1,2,3,3,2,2,3,2,2,5,11,9,6,10,5,14,7,18,13,9,6,13,9,14,11,15,9,14,7,10,14,7,10,9,12,13,14,12,10,17,16,13,12,16,20,15,15,16,12,12,12,12,8,14,8,13,12,13,13,7,Leon Balogun,Â£1.80m ,Bundesliga
19-06-17,18.3.4.28,Mitchell Weiser,92016244,771,21-Apr-94,23,0,0,12,1,6100,7100,7100,159,147,30287200,176,67,D/WB R,1,3,1,2,3,2,1,1,2,1,2,10,14,15,11,14,12,6,11,12,11,12,12,12,13,14,11,10,13,10,13,12,12,14,8,12,10,11,14,16,15,10,8,14,13,16,20,14,8,12,8,13,11,18,7,11,12,14,10,8,8,15,20,20,15,15,20,14,1,D/WB R,112,1,1,1,1,13,15,1,14,20,1,1,13,15,12,20,65536.0,0,0,0,0,0,0,0,0,0,0,0,0,0,0,0,0,1,0,0,0,0,0,0,0,0,0,0,0,0,0,0,0,0,0,0,0,0,0,0,0,0,0,0,0,0,0,0,0,Mitchell Weiser,Â£10.80m ,26.0,177.0,Defender - Right-Back,right,Bayer 04 Leverkusen,21.0,4.0,6.0,1450.0,31.0,2.0,2.0,2531.0,41.0,2.0,4.0,3056.0,28.0,1.0,0.0,1895.0,0.0,0.0,0.0,0.0,Bundesliga,15-07-16,17.3.2.23,Mitchell Weiser,92016244,771,21-Apr-94,22,0,0,2,0,5750,7000,7300,159,146,36965436,176,67,D/WB R,3,1,2,1,1,1,3,1,1,3,2,10,14,15,11,14,12,6,11,12,11,12,9,12,13,14,10,10,13,10,13,12,12,14,8,12,11,11,14,16,15,10,8,14,13,16,20,14,8,12,8,13,9,18,7,11,12,13,10,11,8,15,Mitchell Weiser,Â£8.10m ,Bundesliga
19-06-17,18.3.4.28,Erik Durm,92021444,771,12-May-92,25,7,0,5,0,4350,6850,6850,139,137,15186418,183,72,D/WB RL,2,2,1,3,2,1,3,2,4,3,2,7,11,12,10,11,7,9,9,13,10,12,10,11,13,16,11,8,12,12,10,11,13,11,7,12,10,14,16,16,15,9,11,10,13,15,20,16,8,13,8,12,14,18,8,15,8,12,13,9,14,5,20,20,14,14,20,17,1,D/WB RL,115,1,1,10,1,13,14,1,17,20,1,1,13,14,17,20,0.0,0,0,0,0,0,0,0,0,0,0,0,0,0,0,0,0,0,0,0,0,0,0,0,0,0,0,0,0,0,0,0,0,0,0,0,0,0,0,0,0,0,0,0,0,0,0,0,0,Erik Durm,Â£900Th. ,28.0,183.0,Defender - Left-Back,right,Eintracht Frankfurt,20.0,0.0,3.0,1387.0,0.0,0.0,0.0,0.0,30.0,0.0,1.0,2217.0,15.0,0.0,0.0,821.0,nan,nan,nan,nan,Bundesliga,15-07-16,17.3.2.23,Erik Durm,92021444,771,12-May-92,24,7,0,5,0,4450,6950,6950,146,139,19868990,183,72,D/WB RL,3,1,2,3,3,2,3,2,3,2,2,7,11,12,10,11,7,9,9,13,10,12,10,11,13,16,11,8,12,12,10,11,13,11,7,12,9,14,16,17,15,9,11,10,13,15,20,16,8,13,8,12,14,18,8,15,8,12,13,9,14,5,Erik Durm,Â£4.50m ,Bundesliga
19-06-17,18.3.4.28,Danny da Costa,92028423,771,13-Jul-93,23,0,0,5,1,3200,6200,6200,131,124,6695799,187,85,D/WB R,1,2,2,3,1,2,1,3,2,3,1,6,11,12,6,11,7,10,6,15,13,10,8,13,11,15,10,15,9,11,8,9,15,8,7,11,10,12,15,14,13,15,13,10,16,18,20,14,13,13,8,11,10,14,10,13,11,12,15,14,14,4,20,20,12,12,20,1,14,D/WB R,112,1,1,1,1,1,12,14,1,20,1,1,1,12,1,20,0.0,0,0,0,0,0,0,0,0,0,0,0,0,0,0,0,0,0,0,0,0,0,0,0,0,0,0,0,0,0,0,0,0,0,0,0,0,0,0,0,0,0,0,0,0,0,0,0,0,Danny da Costa,Â£3.15m ,27.0,187.0,Defender - Right-Back,right,Eintracht Frankfurt,4.0,0.0,1.0,198.0,21.0,1.0,5.0,1417.0,50.0,4.0,5.0,4472.0,37.0,4.0,10.0,2496.0,4.0,0.0,0.0,178.0,Bundesliga,15-07-16,17.3.2.23,Danny da Costa,92028423,771,13-Jul-93,23,0,0,5,1,3297,6297,6297,138,126,4841569,186,84,D/WB R,1,1,4,1,2,1,3,2,3,2,1,6,11,12,7,11,7,10,6,15,13,10,9,14,11,15,10,15,10,11,9,9,15,8,7,11,10,13,15,14,13,15,13,10,16,18,20,14,13,13,8,11,10,14,10,13,11,12,15,14,14,4,Danny da Costa,Â£900Th. ,Bundesliga
19-06-17,18.3.4.28,Jeremy Toljan,92029806,771,08-Aug-94,22,0,0,18,1,4550,7050,7050,149,141,38056360,182,76,D/WB RL,1,1,3,2,2,1,1,4,1,4,2,6,10,11,8,11,6,10,9,14,12,10,8,12,13,15,14,12,10,12,8,10,11,9,6,14,11,13,15,15,13,12,13,12,16,18,20,16,10,11,6,12,5,17,9,12,11,10,13,15,18,5,20,20,12,12,20,18,13,D/WB RL,115,1,1,1,1,11,12,13,18,20,1,1,11,12,18,20,134217728.0,0,0,0,0,0,0,0,0,0,0,0,0,0,0,0,0,0,0,0,0,0,0,0,0,0,0,0,1,0,0,0,0,0,0,0,0,0,0,0,0,0,0,0,0,0,0,0,0,Jeremy Toljan,Â£4.50m ,26.0,182.0,Defender - Right-Back,right,US Sassuolo,21.0,1.0,1.0,1368.0,27.0,1.0,2.0,1998.0,15.0,0.0,1.0,1031.0,30.0,1.0,2.0,2275.0,3.0,0.0,0.0,255.0,Bundesliga,15-07-16,17.3.2.23,Jeremy Toljan,92029806,771,08-Aug-94,21,0,0,8,0,4195,6695,6695,149,134,13454468,182,76,D/WB RL,3,3,2,1,2,1,4,1,1,3,1,6,10,11,8,11,6,10,9,14,12,10,8,13,12,15,13,12,10,10,8,9,11,9,6,10,11,13,15,15,13,12,13,12,16,18,20,15,10,11,6,12,5,17,8,12,11,10,13,15,15,5,Jeremy Toljan,Â£3.15m ,Bundesliga
19-06-17,18.3.4.28,Joshua Kimmich,92039023,771,08-Feb-95,22,20,2,14,2,6900,7900,7900,169,153,79337526,176,70,D/WB/DM/M RC,3,3,2,1,1,2,3,1,3,3,2,10,12,11,12,13,8,10,11,10,12,14,12,13,14,17,16,12,15,12,13,15,16,9,10,14,12,18,17,13,16,10,10,14,14,11,20,17,8,13,8,15,5,18,12,18,10,14,13,15,12,8,20,16,18,12,20,11,18,D/WB/DM/M RC,133,1,1,1,12,11,11,14,1,20,18,18,11,11,1,16,4718592.0,0,0,0,0,0,0,0,0,0,0,0,0,0,0,0,0,0,0,0,1,0,0,1,0,0,0,0,0,0,0,0,0,0,0,0,0,0,0,0,0,0,0,0,0,0,0,0,0,Joshua Kimmich,Â£49.50m ,25.0,176.0,Midfielder - Defensive Midfield,right,Bayern Munich,40.0,9.0,2.0,2092.0,47.0,6.0,17.0,3918.0,48.0,2.0,19.0,4281.0,51.0,7.0,17.0,4354.0,7.0,2.0,4.0,635.0,Bundesliga,15-07-16,17.3.2.23,Joshua Kimmich,92039023,771,08-Feb-95,21,5,0,14,2,6750,7750,7750,169,150,85488341,176,70,D/WB/DM/M RC,3,3,3,3,3,1,1,1,2,2,3,10,12,11,12,13,8,10,11,10,12,14,12,13,14,17,16,13,15,12,13,15,16,9,10,14,10,18,17,13,15,11,10,14,14,10,20,16,8,13,8,15,5,18,11,18,10,14,13,15,12,8,Joshua Kimmich,Â£22.50m ,Bundesliga
19-06-17,18.3.4.28,Pascal Stenzel,92065838,771,20-Mar-96,21,0,0,0,0,4300,6300,6300,138,126,10717610,183,72,D/WB/DM/M RC,3,3,1,3,1,1,2,1,2,2,2,6,10,8,9,12,8,10,11,12,11,14,11,11,14,12,14,16,15,13,11,15,15,6,12,10,13,18,13,10,11,11,10,10,16,12,20,15,9,14,8,13,10,15,10,14,10,12,15,13,13,5,20,16,18,1,20,1,18,D/WB/DM/M RC,133,1,1,1,1,1,1,1,1,20,18,18,1,1,1,16,0.0,0,0,0,0,0,0,0,0,0,0,0,0,0,0,0,0,0,0,0,0,0,0,0,0,0,0,0,0,0,0,0,0,0,0,0,0,0,0,0,0,0,0,0,0,0,0,0,0,Pascal Stenzel,Â£4.50m ,24.0,183.0,Defender - Right-Back,right,VfB Stuttgart,21.0,1.0,1.0,1482.0,30.0,1.0,0.0,2374.0,24.0,0.0,3.0,1737.0,37.0,0.0,2.0,3142.0,3.0,0.0,0.0,270.0,Bundesliga,15-07-16,17.3.2.23,Pascal Stenzel,92065838,771,20-Mar-96,20,0,0,0,0,3796,6046,6296,138,121,8441430,180,70,D/WB/DM/M RC,1,2,1,3,2,3,4,2,1,2,3,6,10,8,9,12,8,10,11,12,11,13,11,11,13,12,14,16,15,13,10,14,15,6,12,10,12,18,13,10,11,10,10,10,16,12,20,15,9,14,8,13,10,15,10,14,10,12,15,13,13,5,Pascal Stenzel,Â£2.70m ,Bundesliga
19-06-17,18.3.4.28,Felix Passlack,92071494,771,29-May-98,19,0,0,0,0,4400,6400,6400,161,128,14689581,170,74,D/WB/M/AM R,1,3,2,4,1,2,2,4,2,2,3,12,13,11,13,9,12,8,11,14,10,10,14,11,12,15,11,17,10,10,9,9,17,12,14,14,10,13,17,14,14,17,7,12,17,13,20,13,11,11,7,17,4,17,9,16,13,13,14,15,12,8,20,20,16,16,20,14,10,D/WB/M/AM R,132,1,1,1,10,13,16,1,14,20,8,10,13,16,14,20,1.44115e+17,0,0,0,0,0,0,0,0,0,0,1,0,0,0,0,0,0,0,0,0,0,0,0,0,0,0,0,1,0,0,0,0,0,0,0,0,0,0,0,0,0,0,0,0,0,0,0,0,Felix Passlack,Â£1.35m ,22.0,170.0,Defender - Right-Back,right,Borussia Dortmund,23.0,1.0,3.0,1708.0,19.0,2.0,1.0,1281.0,8.0,0.0,0.0,628.0,28.0,3.0,4.0,2477.0,5.0,1.0,0.0,276.0,Bundesliga,15-07-16,17.3.2.23,Felix Passlack,92071494,771,29-May-98,18,0,0,0,0,3800,6550,6800,162,131,31936932,170,74,D/WB/M/AM R,2,3,3,2,3,3,3,4,3,1,3,12,13,11,13,9,12,8,11,14,9,9,14,10,12,14,10,17,10,10,9,8,17,12,14,15,8,13,17,14,14,16,7,12,17,13,20,15,11,12,7,13,4,17,9,16,12,13,14,14,12,8,Felix Passlack,Â£2.70m ,Bundesliga
19-06-17,18.3.4.28,Robert Bauer,92071550,771,09-Apr-95,22,0,0,0,0,4550,6300,6550,136,126,11714518,183,76,D/WB/DM/M RLC,2,2,3,2,3,3,1,1,2,1,3,6,9,7,7,10,6,10,11,16,14,12,8,15,10,15,13,16,10,11,8,10,15,7,11,8,12,13,15,11,10,15,12,12,17,14,20,16,13,14,10,14,7,18,12,17,9,13,15,10,8,8,20,16,18,1,20,16,18,D/WB/DM/M RLC,136,1,1,1,1,1,1,15,16,20,18,18,1,1,12,16,0.0,0,0,0,0,0,0,0,0,0,0,0,0,0,0,0,0,0,0,0,0,0,0,0,0,0,0,0,0,0,0,0,0,0,0,0,0,0,0,0,0,0,0,0,0,0,0,0,0,Robert Bauer,Â£2.25m ,25.0,183.0,Defender - Right-Back,right,Arsenal Tula,27.0,1.0,3.0,2124.0,19.0,0.0,0.0,1162.0,24.0,0.0,0.0,1888.0,16.0,1.0,2.0,1226.0,12.0,0.0,0.0,1080.0,Bundesliga,15-07-16,17.3.2.23,Robert Bauer,92071550,771,09-Apr-95,21,0,0,0,0,4550,6300,6550,136,126,7472528,183,76,D/WB/DM/M RLC,3,1,2,3,3,3,2,1,3,2,3,6,9,7,7,10,6,10,11,16,14,12,8,15,10,15,13,16,10,11,8,10,15,7,11,8,12,13,15,11,10,15,12,12,17,14,20,16,13,14,10,14,7,18,12,17,9,13,15,10,8,8,Robert Bauer,Â£3.15m ,Bundesliga
19-06-17,18.3.4.28,Pawel Olkowski,96017865,787,13-Feb-90,27,13,0,8,0,3800,6050,6300,131,126,6154702,184,75,D/WB R,2,4,3,1,2,4,3,2,1,1,1,7,12,10,8,11,6,9,13,16,10,12,9,11,12,13,12,14,10,11,11,11,13,10,8,11,10,14,16,13,11,14,10,10,17,16,20,16,12,8,8,12,10,12,12,14,6,14,15,11,11,8,20,20,15,10,20,10,1,D/WB R,112,1,1,1,1,1,10,1,10,20,1,1,7,15,10,20,134217728.0,0,0,0,0,0,0,0,0,0,0,0,0,0,0,0,0,0,0,0,0,0,0,0,0,0,0,0,1,0,0,0,0,0,0,0,0,0,0,0,0,0,0,0,0,0,0,0,0,Pawel Olkowski,Â£900Th. ,30.0,184.0,Defender - Right-Back,right,Gaziantep FK,16.0,0.0,3.0,1315.0,14.0,0.0,0.0,1031.0,39.0,2.0,3.0,3279.0,13.0,0.0,0.0,861.0,3.0,0.0,0.0,219.0,Bundesliga,15-07-16,17.3.2.23,Pawel Olkowski,96017865,787,13-Feb-90,26,13,0,8,0,4548,6298,6548,134,131,9695730,184,75,D/WB R,2,3,3,1,4,3,1,2,1,3,2,7,12,10,8,11,6,9,14,16,10,13,9,11,12,15,12,14,10,11,11,12,13,10,8,13,10,14,16,13,11,14,10,10,17,16,20,16,13,10,8,12,4,12,12,14,6,14,15,11,11,8,Pawel Olkowski,Â£2.03m ,Bundesliga
19-06-17,18.3.4.28,Nico Elvedi,98033057,798,30-Sep-96,20,4,0,1,0,4650,6650,6650,150,133,21193900,188,83,D RC,3,1,4,3,1,1,2,3,1,2,2,5,9,8,6,13,5,12,6,14,14,12,8,15,11,12,15,13,16,12,10,13,12,7,10,9,12,17,12,12,10,14,15,12,14,17,20,13,13,13,8,13,5,17,12,14,10,16,13,15,17,6,20,14,10,1,18,14,20,D RC,103,1,10,1,1,1,1,20,14,18,10,10,1,1,12,14,0.0,0,0,0,0,0,0,0,0,0,0,0,0,0,0,0,0,0,0,0,0,0,0,0,0,0,0,0,0,0,0,0,0,0,0,0,0,0,0,0,0,0,0,0,0,0,0,0,0,Nico Elvedi,Â£15.30m ,24.0,189.0,Defender - Centre-Back,right,Borussia MÃ¶nchengladbach,36.0,0.0,0.0,3116.0,36.0,2.0,3.0,3184.0,31.0,2.0,1.0,2715.0,39.0,1.0,0.0,3249.0,7.0,1.0,0.0,585.0,Bundesliga,15-07-16,17.3.2.23,Nico Elvedi,98033057,798,30-Sep-96,19,1,0,1,0,4650,6650,6650,150,133,21665685,188,83,D RC,1,1,2,3,1,3,3,1,1,2,3,5,9,8,6,11,5,12,6,13,14,12,8,15,11,12,15,13,16,12,10,13,12,7,10,9,12,17,12,13,10,14,15,12,14,16,20,13,13,13,8,13,5,16,12,14,10,16,13,15,17,6,Nico Elvedi,Â£6.30m ,Bundesliga
19-06-17,18.3.4.28,Daniele Dessena,1400695,776,10-May-87,30,0,0,25,6,4250,6300,6300,134,126,6678568,183,80,DM/M RC,1,1,1,4,2,3,2,3,1,3,4,9,11,11,9,12,9,11,11,10,12,12,8,13,11,14,13,14,8,14,11,13,16,10,13,11,13,14,14,14,12,12,10,10,13,13,20,15,13,13,13,12,9,13,10,12,11,10,11,10,10,6,15,12,20,1,15,1,20,DM/M RC,423,1,1,1,1,1,1,1,1,15,18,20,1,10,1,12,137439000000.0,0,0,0,0,0,0,0,0,1,0,0,0,0,0,0,0,0,0,0,0,0,0,0,0,0,0,0,0,0,0,0,0,0,0,0,0,0,1,0,0,0,0,0,0,0,0,0,0,Daniele Dessena,Â£630Th. ,33.0,182.0,Midfielder - Central Midfield,right,Brescia Calcio,21.0,2.0,0.0,1463.0,18.0,1.0,0.0,686.0,23.0,1.0,2.0,1104.0,24.0,2.0,2.0,1875.0,4.0,0.0,0.0,329.0,Serie A,15-07-16,17.3.2.23,Daniele Dessena,1400695,776,10-May-87,29,0,0,25,6,5250,6100,6200,130,125,3586278,183,80,DM/M RC,2,1,3,1,2,3,1,1,2,3,1,9,11,11,9,12,9,11,11,10,12,11,8,13,11,13,13,12,8,12,11,13,16,10,12,11,13,13,13,14,12,12,10,10,13,13,20,15,13,13,13,12,9,13,10,8,11,10,11,10,10,6,Daniele Dessena,Â£1.35m ,Serie A
19-06-17,18.3.4.28,Lorenzo De Silvestri,1401054,776,23-May-88,29,6,0,18,0,4750,6550,6550,143,131,9768428,186,84,D/WB/M R,1,1,1,1,1,1,1,1,1,1,1,8,12,10,8,12,4,15,8,14,12,12,4,13,10,14,11,16,12,12,7,12,15,4,10,14,12,15,16,14,11,13,13,8,16,15,20,17,14,14,10,13,11,12,13,13,11,12,15,14,14,13,20,18,17,1,20,9,10,D/WB/M R,122,1,1,1,1,1,1,10,9,20,1,1,8,17,8,18,275012000000.0,0,1,0,0,0,1,0,0,0,0,0,0,0,0,0,0,0,0,0,0,0,0,0,0,0,0,0,1,0,0,0,0,0,0,0,0,0,0,1,0,0,0,0,0,0,0,0,0,Lorenzo De Silvestri,Â£3.60m ,32.0,186.0,Defender - Right-Back,right,Bologna FC 1909,19.0,1.0,3.0,1557.0,39.0,7.0,2.0,3253.0,34.0,2.0,4.0,2606.0,37.0,3.0,1.0,2984.0,5.0,1.0,0.0,411.0,Serie A,15-07-16,17.3.2.23,Lorenzo De Silvestri,1401054,776,23-May-88,28,6,0,18,0,5000,6900,6700,143,133,8553670,186,84,D/WB/M R,1,1,1,1,1,1,1,1,1,1,1,6,12,10,8,12,4,15,8,14,13,12,4,13,10,13,12,16,12,14,9,12,15,4,10,14,13,16,17,14,12,14,14,8,16,15,20,17,14,14,10,14,11,12,13,13,11,12,15,14,14,13,Lorenzo De Silvestri,Â£3.15m ,Serie A
19-06-17,18.3.4.28,Danilo D'Ambrosio,1414241,776,09-Sep-88,28,1,0,3,0,5250,7100,7050,144,141,20945745,180,75,D/WB/M RL,2,3,2,2,3,1,3,2,2,2,2,7,13,12,11,13,7,12,9,12,12,12,6,13,12,17,12,15,12,13,10,13,12,7,6,13,12,14,15,14,13,12,10,10,14,15,20,14,12,12,12,10,10,16,13,14,11,12,15,15,14,8,20,19,18,1,20,19,13,D/WB/M RL,125,1,1,1,1,1,1,13,19,20,1,1,17,18,18,19,1099510000000.0,0,0,0,0,0,1,0,0,0,0,0,0,0,0,0,0,0,0,0,0,0,0,0,0,0,0,0,0,0,0,0,0,0,0,0,0,0,0,0,0,1,0,0,0,0,0,0,0,Danilo D'Ambrosio,Â£10.80m ,32.0,180.0,Defender - Right-Back,right,Inter Milan,39.0,3.0,3.0,3366.0,34.0,2.0,4.0,2986.0,38.0,2.0,6.0,3250.0,32.0,5.0,0.0,2095.0,5.0,2.0,0.0,371.0,Serie A,15-07-16,17.3.2.23,Danilo D'Ambrosio,1414241,776,09-Sep-88,27,0,0,3,0,4500,6850,6800,144,138,10657647,180,75,D/WB/M RL,2,3,3,1,1,3,3,1,2,2,2,7,12,13,10,13,7,12,9,12,12,12,6,12,13,14,12,14,12,13,12,13,12,7,6,13,12,13,14,14,14,12,10,10,14,14,20,14,12,12,11,10,10,16,13,14,11,12,15,15,14,8,Danilo D'Ambrosio,Â£9.00m ,Serie A
19-06-17,18.3.4.28,Timothy Castagne,18074558,757,05-Dec-95,21,0,0,7,1,4950,6100,6500,145,128,16784002,185,80,D/WB RC,2,1,2,2,1,1,3,3,1,1,4,8,14,10,10,12,9,8,9,12,12,12,7,12,11,14,12,12,14,14,8,13,18,12,12,11,14,15,14,14,11,10,9,8,14,14,20,14,13,13,14,14,11,12,14,12,13,10,14,11,12,1,20,19,12,1,20,13,15,D/WB RC,113,1,1,1,1,1,1,15,13,20,10,1,10,12,12,19,0.0,0,0,0,0,0,0,0,0,0,0,0,0,0,0,0,0,0,0,0,0,0,0,0,0,0,0,0,0,0,0,0,0,0,0,0,0,0,0,0,0,0,0,0,0,0,0,0,0,Timothy Castagne,Â£4.50m ,24.0,180.0,Defender - Right-Back,right,Leicester City,49.0,2.0,1.0,4289.0,26.0,1.0,3.0,1995.0,37.0,5.0,4.0,2671.0,33.0,2.0,3.0,2157.0,7.0,1.0,2.0,622.0,Serie A
19-06-17,18.3.4.28,Thiago Cionek,19050795,787,21-Apr-86,31,12,0,0,0,3000,6050,6050,124,121,232186002,183,82,D RC,1,2,2,2,2,3,2,1,3,3,1,4,9,9,9,10,6,13,4,9,14,11,9,14,11,14,13,13,13,14,6,13,15,5,12,4,14,11,14,12,11,13,12,8,14,12,20,14,13,14,10,12,5,11,14,15,15,11,17,14,11,2,20,1,1,1,16,1,20,D RC,103,1,1,1,1,1,1,20,1,16,10,1,1,1,1,1,0.0,0,0,0,0,0,0,0,0,0,0,0,0,0,0,0,0,0,0,0,0,0,0,0,0,0,0,0,0,0,0,0,0,0,0,0,0,0,0,0,0,0,0,0,0,0,0,0,0,Thiago Cionek,Â£720Th. ,34.0,183.0,Defender - Centre-Back,right,Reggina 1914,30.0,0.0,0.0,2387.0,33.0,2.0,0.0,2862.0,33.0,0.0,2.0,2727.0,30.0,1.0,2.0,2345.0,5.0,0.0,0.0,344.0,Serie A,15-07-16,17.3.2.23,Thiago Cionek,19050795,787,21-Apr-86,30,7,0,0,0,3000,6100,6250,125,122,2552847,182,82,D RC,2,3,1,3,3,1,3,2,1,1,3,4,9,9,9,10,6,13,4,9,14,11,9,14,11,14,13,13,13,14,6,13,15,5,12,4,14,11,14,12,11,13,12,9,14,12,20,14,13,15,10,12,5,9,14,15,15,11,17,14,11,2,Thiago Cionek,Â£540Th. ,Serie A
19-06-17,18.3.4.28,Bruno Peres,19138183,1651,01-Mar-90,27,0,0,0,0,5250,6500,7000,144,139,18757606,178,72,D/WB/M RL,3,1,1,3,1,2,2,1,1,2,2,12,12,16,9,15,10,9,12,12,7,13,8,11,16,13,8,9,8,11,11,9,12,17,8,14,6,10,11,17,16,12,8,10,13,17,20,14,11,12,12,9,4,12,10,12,9,8,10,12,11,8,20,19,17,1,20,15,1,D/WB/M RL,125,1,1,1,1,1,1,1,15,20,1,1,12,17,15,19,2393090000000000.0,0,1,0,0,0,0,0,0,0,0,0,0,0,0,0,0,0,0,0,0,0,0,0,0,0,0,0,1,0,0,0,0,0,0,0,0,0,0,0,1,0,0,0,0,0,0,0,1,Bruno Peres,Â£7.20m ,30.0,178.0,Defender - Right-Back,right,AS Roma,45.0,3.0,4.0,3458.0,43.0,1.0,1.0,3102.0,3.0,0.0,0.0,167.0,19.0,2.0,3.0,1173.0,4.0,1.0,0.0,153.0,Serie A,15-07-16,17.3.2.23,Bruno Peres,19138183,1651,01-Mar-90,26,0,0,0,0,3250,7150,7200,149,144,41607805,176,72,D/WB/M RL,3,2,1,2,3,3,3,4,3,2,3,8,12,16,9,15,8,9,12,12,9,13,8,12,15,13,13,12,12,11,11,11,15,13,8,14,8,13,14,17,14,12,7,10,14,17,20,14,11,12,12,14,12,12,10,12,9,11,11,12,11,8,Bruno Peres,Â£9.90m ,Serie A
19-06-17,18.3.4.28,Jens Stryger Larsen,27013107,764,21-Feb-91,26,4,1,7,0,3750,6500,5950,123,119,2334898,180,81,D RL,3,1,2,2,1,2,4,3,1,1,2,10,12,11,8,10,9,6,10,7,13,11,7,9,10,17,13,14,11,7,12,11,14,11,9,11,8,12,12,14,9,11,9,10,10,15,20,14,11,8,13,11,6,17,9,18,9,8,10,10,14,14,20,15,15,15,20,15,14,D RL,105,1,1,1,13,14,15,13,15,20,14,14,13,15,12,15,268435496.0,0,0,0,1,0,1,0,0,0,0,0,0,0,0,0,0,0,0,0,0,0,0,0,0,0,0,0,0,1,0,0,0,0,0,0,0,0,0,0,0,0,0,0,0,0,0,0,0,Jens Stryger Larsen,Â£1.80m ,29.0,180.0,Defender - Right-Back,both,Udinese Calcio,43.0,0.0,3.0,3856.0,40.0,1.0,1.0,3430.0,37.0,1.0,4.0,3332.0,36.0,1.0,3.0,2930.0,nan,nan,nan,nan,Serie A
19-06-17,18.3.4.28,LoÄck Landre,29022617,769,05-May-92,25,0,0,5,2,3750,5300,5300,132,106,17842,182,78,D RC,1,3,3,1,1,2,4,3,2,1,3,5,10,8,7,10,6,13,11,8,13,8,7,12,9,14,13,17,11,10,6,9,14,8,10,8,11,13,14,13,12,14,11,6,14,14,20,14,15,12,14,14,8,8,11,14,13,11,13,12,13,6,20,10,1,1,18,8,20,D RC,103,1,1,1,1,1,1,20,8,18,12,1,1,1,8,10,8796090000000.0,0,0,0,1,0,0,0,0,0,0,0,0,0,0,0,1,0,0,0,0,0,0,0,0,0,0,0,0,0,0,0,0,0,0,0,0,0,0,0,0,0,0,0,1,0,0,0,0,LoÃ¯ck Landre,Â£180Th. ,28.0,182.0,Defender - Centre-Back,right,NÃ®mes Olympique,6.0,0.0,0.0,437.0,1.0,0.0,0.0,90.0,24.0,3.0,0.0,1726.0,14.0,1.0,0.0,1229.0,7.0,0.0,0.0,552.0,Serie A
19-06-17,18.3.4.28,Jacopo Sala,29024855,776,05-Dec-91,25,0,0,5,1,4400,6250,6500,141,130,8724442,181,75,D/WB/M RC,1,2,4,4,2,1,2,2,1,1,2,11,13,12,10,12,10,6,13,8,10,13,9,11,14,16,12,12,13,11,15,13,11,13,8,12,9,15,16,13,14,10,10,10,13,13,20,12,11,15,6,13,5,14,13,17,10,12,12,13,15,5,20,19,19,13,20,1,18,D/WB/M RC,123,1,1,1,1,1,13,1,1,20,1,18,1,19,1,19,4644890000000000.0,0,0,0,0,0,0,0,0,0,0,1,0,0,0,0,0,0,0,0,0,0,0,0,0,0,0,0,0,0,0,0,0,0,0,0,0,0,0,0,1,0,0,0,0,0,0,0,1,Jacopo Sala,Â£1.35m ,28.0,181.0,Defender - Right-Back,right,Spezia Calcio,21.0,0.0,0.0,1658.0,16.0,0.0,1.0,1263.0,24.0,0.0,1.0,1816.0,16.0,0.0,0.0,851.0,4.0,0.0,0.0,288.0,Serie A,15-07-16,17.3.2.23,Jacopo Sala,29024855,776,05-Dec-91,24,0,0,5,1,4400,6600,6550,145,130,8700642,184,75,D/WB/M RC,2,4,3,1,1,2,2,4,3,3,3,11,13,13,10,13,14,6,13,8,8,13,9,9,14,14,13,13,13,11,14,13,11,13,8,13,11,15,16,13,14,10,10,10,13,13,20,12,11,15,6,13,5,14,13,17,10,12,12,13,15,5,Jacopo Sala,Â£2.25m ,Serie A
19-06-17,18.3.4.28,Benedikt HÃ¶wedes,35015879,771,29-Feb-88,29,44,2,22,3,7000,7500,7500,154,150,47167208,188,77,D RC,1,2,1,1,1,1,1,1,4,1,2,4,8,6,8,10,4,16,5,12,18,10,8,18,9,16,14,17,10,18,8,12,17,3,14,8,15,18,12,11,10,15,15,12,16,13,20,16,14,17,10,17,12,14,10,13,17,15,18,16,13,3,20,10,8,1,16,13,20,D RC,103,1,1,1,1,1,1,20,13,16,8,8,1,1,10,10,137439000000.0,0,0,0,0,0,0,0,0,0,0,0,0,0,0,0,1,0,0,0,0,0,0,0,0,0,0,0,0,0,0,0,0,0,0,0,0,0,1,0,0,0,0,0,0,0,0,0,0,Benedikt HÃ¶wedes,Â£8.10m ,32.0,188.0,Defender - Centre-Back,right,Retired,46.0,2.0,4.0,4170.0,3.0,1.0,0.0,248.0,26.0,4.0,0.0,2000.0,24.0,0.0,0.0,2104.0,nan,nan,nan,nan,Serie A,15-07-16,17.3.2.23,Benedikt HÃ¶wedes,35015879,771,29-Feb-88,28,40,2,22,3,7000,7500,7500,150,150,17999999,187,82,D RC,3,3,3,1,1,3,3,3,3,2,3,4,8,6,8,10,4,16,5,12,18,10,8,18,9,16,14,17,10,18,8,12,17,3,14,8,15,18,12,11,10,15,15,12,16,13,20,16,14,17,10,17,12,14,10,13,17,15,18,16,13,3,Benedikt HÃ¶wedes,Â£16.20m ,Bundesliga
19-06-17,18.3.4.28,Rick Karsdorp,37039938,784,11-Feb-95,22,3,0,0,0,5400,6750,6750,156,138,23827135,182,80,D/WB R,2,1,1,1,2,3,2,1,1,3,1,9,14,11,6,12,8,9,7,11,13,13,9,12,13,13,13,15,13,11,13,11,15,8,8,16,11,17,18,13,13,14,11,10,13,15,20,17,13,14,6,11,13,14,11,13,13,14,13,12,10,11,20,17,12,1,20,8,10,D/WB R,112,1,1,1,1,1,1,10,8,20,14,10,6,12,7,17,1048586.0,0,1,0,1,0,0,0,0,0,0,0,0,0,0,0,0,0,0,0,0,1,0,0,0,0,0,0,0,0,0,0,0,0,0,0,0,0,0,0,0,0,0,0,0,0,0,0,0,Rick Karsdorp,Â£8.10m ,25.0,184.0,Defender - Right-Back,right,AS Roma,42.0,1.0,7.0,3580.0,1.0,0.0,0.0,82.0,14.0,0.0,0.0,761.0,24.0,2.0,5.0,1818.0,3.0,0.0,0.0,183.0,Serie A
19-06-17,18.3.4.28,Hans Hateboer,37046941,784,09-Jan-94,23,0,0,8,2,4250,5750,6200,134,124,7102905,187,74,D/WB RC,2,1,2,3,2,1,1,2,3,2,3,8,12,9,4,12,7,12,5,8,12,11,7,14,11,16,13,13,13,13,9,13,16,10,10,13,12,14,15,12,13,15,11,7,13,14,20,14,15,12,7,11,5,11,15,14,13,12,13,10,12,7,20,19,13,5,20,1,15,D/WB RC,113,1,1,1,1,1,5,15,1,20,10,1,1,13,1,19,8796090000000.0,0,1,0,0,0,1,0,0,0,0,0,0,0,0,0,0,0,0,0,0,0,0,0,0,0,0,0,0,0,0,0,0,0,0,0,0,0,0,0,0,0,0,0,1,0,0,0,0,Hans Hateboer,Â£6.30m ,26.0,185.0,Defender - Right-Back,right,Atalanta BC,27.0,2.0,5.0,2178.0,43.0,0.0,2.0,3275.0,43.0,6.0,6.0,3723.0,42.0,2.0,6.0,3033.0,5.0,2.0,0.0,390.0,Serie A,15-07-16,17.3.2.23,Hans Hateboer,37046941,784,09-Jan-94,22,0,0,0,0,4400,5750,5750,130,118,2029762,187,81,D/WB RC,2,1,1,1,1,1,3,2,3,2,1,8,11,9,4,12,7,12,5,9,12,13,7,13,12,16,13,13,13,13,9,12,16,10,10,13,12,14,14,12,13,14,11,6,8,13,20,13,15,12,7,11,11,11,12,14,13,12,13,10,12,4,Hans Hateboer,Â£900Th. ,Serie A
19-06-17,18.3.4.28,Davide Faraoni,43008971,776,25-Oct-91,25,0,0,7,0,3500,6000,6000,128,120,4182600,180,80,D/WB/M R,1,1,1,1,1,1,1,1,1,1,1,13,13,13,6,11,8,10,12,11,12,12,8,13,11,10,11,11,11,10,10,10,14,9,8,13,13,14,14,13,12,12,10,13,14,14,20,13,12,14,13,13,8,7,11,15,11,13,14,12,10,8,19,19,20,9,20,8,3,D/WB/M R,432,1,1,1,1,1,9,3,8,19,1,1,8,20,7,19,0.0,0,0,0,0,0,0,0,0,0,0,0,0,0,0,0,0,0,0,0,0,0,0,0,0,0,0,0,0,0,0,0,0,0,0,0,0,0,0,0,0,0,0,0,0,0,0,0,0,Davide Faraoni,Â£900Th. ,29.0,180.0,Defender - Right-Back,right,Hellas Verona,7.0,1.0,0.0,464.0,30.0,2.0,3.0,1918.0,39.0,4.0,4.0,3104.0,37.0,5.0,3.0,3317.0,5.0,0.0,1.0,450.0,Serie A,15-07-16,17.3.2.23,Davide Faraoni,43008971,776,25-Oct-91,24,0,0,7,0,3500,6050,5950,133,120,2171495,180,80,D/WB/M R,1,1,1,1,1,1,1,1,1,1,1,13,14,13,6,11,8,10,12,11,12,12,8,13,11,10,11,11,11,10,10,10,14,9,8,13,13,14,14,13,12,12,10,12,14,14,20,13,12,14,13,13,6,7,11,15,11,13,14,12,10,8,Davide Faraoni,Â£900Th. ,Serie A
19-06-17,18.3.4.28,Davide Santon,43016424,776,02-Jan-91,26,8,0,17,0,5300,6500,6750,144,135,11125467,186,83,D/WB RL,2,3,1,2,1,3,3,1,3,2,1,11,13,12,8,12,8,11,10,11,12,11,10,13,13,13,14,12,12,10,11,11,14,10,9,13,12,13,15,15,13,14,12,12,13,14,20,14,13,10,11,13,10,14,13,13,12,11,14,14,17,5,20,17,7,1,19,20,12,D/WB RL,115,1,1,1,1,1,1,12,20,19,1,1,7,7,17,15,549756000000.0,0,0,0,0,0,1,0,0,0,0,0,0,0,0,0,0,0,0,0,0,0,0,0,0,0,0,0,0,0,0,0,0,0,0,0,0,0,0,0,1,0,0,0,0,0,0,0,0,Davide Santon,Â£2.70m ,29.0,187.0,Defender - Right-Back,right,AS Roma,15.0,0.0,1.0,1108.0,15.0,0.0,1.0,834.0,21.0,0.0,2.0,1293.0,21.0,0.0,0.0,973.0,4.0,0.0,0.0,249.0,Serie A,15-07-16,17.3.2.23,Davide Santon,43016424,776,02-Jan-91,25,8,0,17,0,5400,6800,6800,147,135,10473808,186,83,D RL,1,1,1,1,1,1,1,1,1,1,1,11,14,12,8,13,8,11,10,10,13,13,10,14,14,13,13,13,14,12,11,12,14,10,9,13,12,13,15,15,13,14,12,12,13,15,20,14,13,13,14,13,10,14,13,13,13,13,14,14,17,5,Davide Santon,Â£4.50m ,Serie A
19-06-17,18.3.4.28,Antonio Caracciolo,43020293,776,30-Jun-90,26,0,0,0,0,1750,5800,5800,130,116,2775466,185,73,D/WB RC,2,1,3,1,3,2,2,2,3,3,3,6,12,10,7,10,7,12,8,11,12,11,7,13,12,12,12,10,13,11,9,13,8,11,7,12,12,10,11,12,12,12,13,10,13,14,20,14,13,16,10,13,14,13,10,10,10,5,8,7,5,4,20,17,1,1,17,1,20,D/WB RC,113,1,1,1,1,1,1,20,1,17,1,1,1,1,1,17,2.0,0,1,0,0,0,0,0,0,0,0,0,0,0,0,0,0,0,0,0,0,0,0,0,0,0,0,0,0,0,0,0,0,0,0,0,0,0,0,0,0,0,0,0,0,0,0,0,0,Antonio Caracciolo,Â£720Th. ,30.0,185.0,Defender - Centre-Back,right,AC Pisa 1909,35.0,0.0,0.0,2870.0,33.0,2.0,0.0,2855.0,29.0,3.0,0.0,2472.0,33.0,0.0,0.0,2911.0,5.0,1.0,0.0,450.0,Serie A
19-06-17,18.3.4.28,Leonardo Spinazzola,43036586,776,25-Mar-93,24,3,0,0,0,4500,7350,7150,154,143,33856104,186,75,D/WB/M RL,1,3,2,1,1,3,2,3,3,3,1,6,13,13,7,13,6,10,8,8,11,11,8,12,13,9,13,11,9,9,11,11,12,14,7,13,11,12,13,16,13,12,12,12,16,17,20,15,12,12,7,12,5,18,15,15,10,12,12,12,7,5,20,20,19,13,15,20,10,D/WB/M RL,125,1,1,1,1,13,12,1,20,13,1,10,19,15,20,15,134234112.0,0,0,0,0,0,0,0,0,0,0,0,0,0,0,1,0,0,0,0,0,0,0,0,0,0,0,0,1,0,0,0,0,0,0,0,0,0,0,0,0,0,0,0,0,0,0,0,0,Leonardo Spinazzola,Â£10.80m ,27.0,186.0,Defender - Left-Back,right,AS Roma,32.0,0.0,4.0,2680.0,25.0,0.0,4.0,2137.0,14.0,1.0,1.0,912.0,32.0,2.0,3.0,2160.0,6.0,0.0,0.0,494.0,Serie A,15-07-16,17.3.2.23,Leonardo Spinazzola,43036586,776,25-Mar-93,23,0,0,0,0,2257,5770,6500,144,130,3860618,186,79,D/WB/M RL,1,1,2,3,2,4,2,2,3,1,1,6,12,13,7,10,7,9,8,8,10,11,8,9,12,9,10,9,8,10,12,10,12,14,7,12,11,12,11,16,13,12,11,11,15,17,20,13,10,9,7,12,5,18,15,15,10,10,12,9,7,5,Leonardo Spinazzola,Â£7.20m ,Serie A
19-06-17,18.3.4.28,Mattia De Sciglio,43037008,776,20-Oct-92,24,31,0,5,0,5750,7050,7150,151,142,22877426,182,78,D/WB RL,4,3,1,2,1,1,2,3,3,3,1,6,13,12,2,13,5,12,6,12,14,13,8,14,13,12,13,12,13,14,11,12,13,5,10,12,14,15,13,15,14,13,12,12,12,15,20,13,11,12,11,10,14,15,9,14,14,11,12,19,17,9,20,18,13,1,20,20,8,D/WB RL,115,1,1,1,1,1,1,8,20,20,1,1,13,13,17,18,1099510000000.0,0,0,0,0,0,0,0,0,0,0,0,0,0,0,0,0,0,0,0,0,0,0,0,0,0,0,0,0,0,0,0,0,0,0,0,0,0,0,0,0,1,0,0,0,0,0,0,0,Mattia De Sciglio,Â£12.60m ,28.0,183.0,Defender - Right-Back,right,Olympique Lyon,27.0,0.0,1.0,2301.0,20.0,1.0,0.0,1484.0,28.0,0.0,1.0,2231.0,13.0,0.0,0.0,774.0,3.0,0.0,0.0,49.0,Serie A,15-07-16,17.3.2.23,Mattia De Sciglio,43037008,776,20-Oct-92,23,30,0,5,0,5900,7150,7050,151,140,22477572,183,74,D/WB RL,3,1,1,2,2,1,3,1,1,1,2,6,13,12,2,13,5,12,6,12,14,13,8,14,13,12,13,12,13,14,11,12,13,5,11,12,14,15,13,15,14,13,11,12,10,15,20,13,11,12,11,11,14,15,8,14,17,12,15,19,17,9,Mattia De Sciglio,Â£7.65m ,Serie A
19-06-17,18.3.4.28,Alessandro Florenzi,43041177,776,11-Mar-91,26,24,2,18,5,6100,7700,7700,162,154,119548505,173,67,D/WB/M/AM RC,3,3,3,1,1,3,1,2,3,1,2,14,14,12,13,14,12,10,16,6,8,13,12,9,14,14,13,14,13,13,12,12,18,16,12,15,9,15,16,16,15,11,8,10,16,15,20,15,9,15,8,16,14,20,5,16,19,16,18,20,18,3,18,16,20,17,20,14,18,D/WB/M/AM RC,443,1,1,1,12,14,17,1,10,18,5,18,10,20,10,16,4398180000000.0,0,1,0,0,0,0,0,0,1,0,0,1,0,0,1,0,0,0,0,0,0,0,0,0,0,0,0,1,0,0,0,0,0,0,0,0,0,0,0,0,0,0,1,0,0,0,0,0,Alessandro Florenzi,Â£27.00m ,29.0,173.0,Defender - Right-Back,right,Paris Saint-Germain,13.0,1.0,3.0,955.0,42.0,1.0,4.0,3095.0,38.0,3.0,3.0,2891.0,32.0,0.0,1.0,2014.0,6.0,2.0,0.0,499.0,Serie A,15-07-16,17.3.2.23,Alessandro Florenzi,43041177,776,11-Mar-91,25,21,2,18,5,6100,7700,7700,161,154,74175187,173,67,D/WB/M/AM RC,1,1,3,2,3,1,2,3,1,4,2,15,13,12,13,13,12,11,16,5,9,13,12,12,14,14,12,15,12,9,13,10,18,16,9,15,9,15,17,16,15,11,8,9,16,15,20,16,9,15,8,16,5,20,5,14,19,13,18,19,13,3,Alessandro Florenzi,Â£18.00m ,Serie A
19-06-17,18.3.4.28,Gaetano Letizia,43049523,776,29-Jun-90,26,0,0,0,0,2250,6200,6200,136,124,2428344,173,63,D/WB RL,3,3,1,3,2,2,2,2,4,1,1,6,14,12,6,11,8,7,8,9,11,11,6,12,11,13,13,12,12,10,15,11,12,8,12,13,11,13,12,15,15,12,7,8,10,13,20,14,11,13,6,12,5,17,11,16,12,11,13,7,12,11,20,18,13,1,20,17,11,D/WB RL,115,1,1,1,1,1,1,11,17,20,1,1,11,13,13,18,70368700000000.0,0,0,0,0,0,1,0,0,0,0,0,0,0,0,0,0,0,0,0,0,0,0,0,0,0,0,0,0,0,0,0,0,0,0,0,0,0,0,0,0,0,0,0,0,0,0,1,0,Gaetano Letizia,Â£1.35m ,30.0,173.0,Defender - Right-Back,both,Benevento Calcio,46.0,2.0,3.0,4031.0,30.0,1.0,0.0,2233.0,32.0,1.0,1.0,2567.0,32.0,1.0,5.0,2789.0,5.0,1.0,0.0,413.0,Serie A
19-06-17,18.3.4.28,Matteo Bianchetti,43055102,776,17-Mar-93,24,0,0,21,0,4000,5950,5950,135,119,4512829,189,82,D RC,3,3,1,1,1,3,3,1,2,3,3,7,8,4,6,9,7,14,7,12,14,12,5,14,8,13,14,15,12,15,8,12,15,3,14,5,14,12,13,12,10,11,13,7,12,10,20,12,14,15,13,13,12,10,12,13,14,12,15,12,12,5,20,15,1,1,17,1,20,D RC,103,1,1,1,1,1,1,20,1,17,1,1,1,1,1,15,8796090000000.0,0,0,0,0,0,0,0,0,0,0,0,0,0,0,0,0,0,0,0,0,0,0,0,0,0,0,0,0,0,0,0,0,0,0,0,0,0,0,0,0,0,0,0,1,0,0,0,0,Matteo Bianchetti,Â£720Th. ,27.0,189.0,Defender - Centre-Back,right,US Cremonese,37.0,0.0,2.0,3326.0,4.0,0.0,0.0,293.0,21.0,1.0,0.0,1747.0,36.0,1.0,2.0,3123.0,4.0,0.0,0.0,360.0,Serie A
19-06-17,18.3.4.28,Mario Sampirisi,43061338,776,31-Oct-92,24,0,0,1,0,3750,5900,5900,130,118,3918038,188,75,D/WB RC,2,2,3,1,3,2,2,3,3,2,1,6,14,10,8,10,6,13,6,10,14,12,6,13,12,11,11,11,14,12,7,10,14,7,8,6,12,14,14,13,13,13,15,8,15,13,20,14,13,12,8,8,6,14,11,13,12,13,12,11,10,5,20,16,1,1,20,10,18,D/WB RC,113,1,1,1,1,1,1,18,10,20,1,1,1,1,9,16,0.0,0,0,0,0,0,0,0,0,0,0,0,0,0,0,0,0,0,0,0,0,0,0,0,0,0,0,0,0,0,0,0,0,0,0,0,0,0,0,0,0,0,0,0,0,0,0,0,0,Mario Sampirisi,Â£810Th. ,27.0,188.0,Defender - Right-Back,right,AC Monza,23.0,1.0,1.0,1193.0,31.0,0.0,0.0,2192.0,36.0,0.0,1.0,3066.0,19.0,1.0,1.0,1292.0,3.0,0.0,0.0,240.0,Serie A,15-07-16,17.3.2.23,Mario Sampirisi,43061338,776,31-Oct-92,23,0,0,1,0,3750,5900,5950,135,118,219296,185,75,D/WB RC,1,2,2,1,2,1,3,2,3,1,1,6,14,10,8,10,6,13,7,10,13,12,6,13,12,11,13,13,14,12,10,10,10,7,8,11,12,14,14,13,13,13,15,7,14,13,20,14,13,12,8,8,7,14,11,13,12,13,12,11,10,5,Mario Sampirisi,Â£720Th. ,Serie A
19-06-17,18.3.4.28,Francesco Zampano,43072156,776,30-Sep-93,23,0,0,0,0,3500,5950,5950,132,119,5077477,177,68,D/WB/M RL,3,1,3,2,3,3,2,3,2,3,4,9,12,11,6,12,7,6,11,13,10,10,7,12,13,10,9,13,12,9,10,10,15,10,12,12,10,12,14,15,12,14,8,7,14,14,20,14,12,16,6,14,5,15,12,16,15,12,16,16,12,2,20,18,17,1,20,15,1,D/WB/M RL,125,1,1,1,1,1,1,1,15,20,1,1,13,17,14,18,0.0,0,0,0,0,0,0,0,0,0,0,0,0,0,0,0,0,0,0,0,0,0,0,0,0,0,0,0,0,0,0,0,0,0,0,0,0,0,0,0,0,0,0,0,0,0,0,0,0,Francesco Zampano,Â£1.62m ,27.0,177.0,Defender - Right-Back,right,Frosinone Calcio,36.0,0.0,6.0,3060.0,19.0,0.0,8.0,1579.0,28.0,0.0,2.0,2225.0,25.0,1.0,0.0,1393.0,5.0,0.0,0.0,320.0,Serie A,15-07-16,17.3.2.23,Francesco Zampano,43072156,776,30-Sep-93,22,0,0,0,0,4000,6400,6050,137,121,4064980,177,74,D/WB/M RL,1,1,1,2,4,4,2,3,2,2,2,9,12,10,6,11,7,6,11,13,12,11,7,12,12,12,11,13,12,11,10,11,14,10,13,11,12,13,14,13,12,13,8,6,12,14,20,14,12,12,6,14,6,13,10,16,15,12,16,15,12,1,Francesco Zampano,Â£2.25m ,Serie A
19-06-17,18.3.4.28,Vincent Laurini,43073457,769,10-Jun-89,28,0,0,0,0,3500,6150,6150,131,123,4824646,173,72,D/WB R,2,1,3,2,2,3,3,1,2,1,2,5,13,11,5,12,5,10,7,11,11,9,7,13,10,12,13,13,13,12,11,13,13,9,10,12,11,15,15,14,14,12,9,10,13,15,20,14,12,15,10,11,13,11,15,12,14,13,15,14,12,7,20,17,10,1,20,9,5,D/WB R,112,1,1,1,1,1,1,5,9,20,1,1,1,10,1,17,0.0,0,0,0,0,0,0,0,0,0,0,0,0,0,0,0,0,0,0,0,0,0,0,0,0,0,0,0,0,0,0,0,0,0,0,0,0,0,0,0,0,0,0,0,0,0,0,0,0,Vincent Laurini,Â£1.80m ,31.0,173.0,Defender - Right-Back,right,Parma Calcio 1913,25.0,0.0,0.0,2009.0,23.0,0.0,1.0,1707.0,17.0,0.0,0.0,998.0,18.0,0.0,3.0,1129.0,3.0,0.0,0.0,243.0,Serie A,15-07-16,17.3.2.23,Vincent Laurini,43073457,769,10-Jun-89,27,0,0,0,0,3250,6400,6300,133,125,3603292,173,72,D R,1,1,2,1,1,1,2,2,3,1,3,5,13,12,6,12,5,11,7,11,12,12,7,14,11,13,13,13,14,12,11,13,13,9,10,13,11,15,15,14,14,12,7,10,13,15,20,15,12,15,10,13,13,10,15,12,14,13,15,14,12,7,Vincent Laurini,Â£1.17m ,Serie A
19-06-17,18.3.4.28,Ibrahima Mbaye,43078377,41,19-Nov-94,22,1,0,6,0,3500,6100,6100,140,122,6986355,188,70,D/WB/M RL,1,2,1,1,3,2,1,1,3,1,3,7,11,11,8,11,4,11,7,12,12,11,8,16,11,14,12,11,10,11,9,10,13,6,7,10,12,10,12,14,11,13,14,10,13,13,20,14,14,13,14,11,9,16,13,13,11,15,14,12,12,9,20,19,17,1,20,17,10,D/WB/M RL,125,1,1,1,1,1,1,10,17,20,1,1,15,17,16,19,0.0,0,0,0,0,0,0,0,0,0,0,0,0,0,0,0,0,0,0,0,0,0,0,0,0,0,0,0,0,0,0,0,0,0,0,0,0,0,0,0,0,0,0,0,0,0,0,0,0,Ibrahima Mbaye,Â£2.97m ,25.0,188.0,Defender - Right-Back,right,Bologna FC 1909,17.0,0.0,1.0,1186.0,25.0,1.0,0.0,1748.0,25.0,2.0,0.0,2102.0,21.0,0.0,4.0,1596.0,1.0,0.0,0.0,26.0,Serie A,15-07-16,17.3.2.23,Ibrahima Mbaye,43078377,41,19-Nov-94,21,1,0,6,0,3500,6100,6000,143,120,3221972,188,70,D/WB/M RL,2,3,1,1,4,3,1,2,2,3,3,6,11,11,8,10,4,11,7,11,12,10,8,16,11,14,12,11,10,11,10,9,13,6,8,10,12,10,12,14,11,13,14,10,13,13,20,13,14,13,14,11,9,16,13,13,11,15,14,12,12,9,Ibrahima Mbaye,Â£2.70m ,Serie A
19-06-17,18.3.4.28,Edoardo Goldaniga,43080121,776,02-Nov-93,23,0,0,2,0,4000,6400,6400,150,128,11940900,188,80,D RC,1,3,1,3,1,1,1,1,1,2,1,4,6,11,6,12,4,15,5,10,13,12,8,14,12,15,16,13,12,10,11,13,15,7,15,6,14,12,12,13,12,15,12,10,13,13,20,12,13,12,10,18,6,10,13,14,15,15,17,14,10,7,20,14,1,1,15,12,20,D RC,103,1,1,1,1,1,1,20,12,15,1,1,1,1,1,14,17592200000000.0,0,0,0,0,0,0,0,0,0,0,0,0,0,0,0,1,0,0,0,0,0,0,0,0,0,0,0,0,0,0,0,0,0,0,0,0,0,0,0,0,0,0,0,0,1,0,0,0,Edoardo Goldaniga,Â£2.70m ,26.0,193.0,Defender - Centre-Back,both,Genoa CFC,30.0,2.0,0.0,2568.0,14.0,1.0,0.0,1246.0,30.0,1.0,1.0,2700.0,14.0,1.0,0.0,900.0,4.0,0.0,1.0,291.0,Serie A,15-07-16,17.3.2.23,Edoardo Goldaniga,43080121,776,02-Nov-93,22,0,0,2,0,4000,6500,6500,165,130,12204970,188,80,D RC,1,3,1,2,2,2,1,1,2,2,3,3,6,7,6,11,2,14,5,10,15,11,8,14,12,15,16,13,12,13,11,13,15,7,15,6,14,12,12,12,12,15,12,10,13,13,20,12,13,15,10,18,6,10,13,14,15,15,17,14,10,7,Edoardo Goldaniga,Â£1.35m ,Serie A
19-06-17,18.3.4.28,Andrea Conti,43081379,776,02-Mar-94,23,0,0,17,1,5000,7150,7150,158,143,38156654,184,76,D/WB/M R,2,3,2,1,3,3,1,1,1,4,2,6,13,11,12,13,5,14,9,13,12,13,7,14,14,10,15,14,13,13,12,12,15,12,10,15,14,14,13,14,13,15,13,12,15,15,20,15,12,15,13,15,5,13,12,17,9,12,13,12,8,8,20,19,18,5,20,5,1,D/WB/M R,122,1,1,1,1,1,5,1,5,20,1,1,5,18,5,19,34.0,0,1,0,0,0,1,0,0,0,0,0,0,0,0,0,0,0,0,0,0,0,0,0,0,0,0,0,0,0,0,0,0,0,0,0,0,0,0,0,0,0,0,0,0,0,0,0,0,Andrea Conti,Â£13.50m ,26.0,184.0,Defender - Right-Back,right,AC Milan,35.0,8.0,5.0,2767.0,5.0,0.0,0.0,333.0,16.0,0.0,3.0,635.0,26.0,0.0,2.0,2025.0,0.0,0.0,0.0,0.0,Serie A,15-07-16,17.3.2.23,Andrea Conti,43081379,776,02-Mar-94,22,0,0,8,0,4250,6500,6450,145,132,8855032,184,76,D/WB/M R,2,2,2,2,4,3,2,3,3,3,2,5,13,8,7,11,5,13,7,12,11,10,7,13,12,10,13,12,11,12,12,12,15,12,10,14,13,11,11,14,13,14,12,10,16,15,20,13,12,15,13,15,5,14,12,13,13,11,13,12,8,8,Andrea Conti,Â£9.00m ,Serie A
19-06-17,18.3.4.28,Elseid Hysaj,43083951,752,02-Feb-94,23,29,0,4,0,5000,7300,7300,154,146,72732763,182,70,D RL,1,1,2,4,3,1,3,1,2,1,2,8,13,10,5,13,5,11,9,11,14,13,7,15,12,15,12,15,13,13,12,13,12,8,10,14,14,15,15,15,15,14,11,10,16,15,20,17,14,15,6,13,6,13,15,14,13,14,14,13,13,7,20,15,9,1,20,16,1,D RL,105,1,1,1,1,1,1,1,16,20,1,1,5,9,10,15,0.0,0,0,0,0,0,0,0,0,0,0,0,0,0,0,0,0,0,0,0,0,0,0,0,0,0,0,0,0,0,0,0,0,0,0,0,0,0,0,0,0,0,0,0,0,0,0,0,0,Elseid Hysaj,Â£22.50m ,26.0,182.0,Defender - Right-Back,right,SSC Napoli,45.0,0.0,0.0,3854.0,47.0,0.0,1.0,4087.0,35.0,0.0,2.0,2707.0,24.0,1.0,2.0,1692.0,4.0,0.0,1.0,329.0,Serie A,15-07-16,17.3.2.23,Elseid Hysaj,43083951,752,20-Feb-94,22,22,0,4,0,5000,7150,7200,161,145,47291605,180,75,D RL,3,3,3,1,1,1,3,2,2,2,3,8,13,10,5,14,5,11,9,11,14,13,7,14,13,15,12,15,13,13,12,13,12,8,10,12,14,15,14,15,14,14,11,10,16,15,20,17,14,15,6,13,6,13,15,14,13,14,14,13,13,7,Elseid Hysaj,Â£16.20m ,Serie A
19-06-17,18.3.4.28,Federico Mattiello,43085786,776,14-Jul-95,21,0,0,0,0,2750,5750,6000,143,120,4627607,182,77,D/WB/M RL,1,1,2,1,2,1,2,1,1,2,3,7,12,12,6,11,6,10,9,13,12,12,5,12,12,13,12,13,13,13,5,11,16,11,6,12,12,14,14,14,13,12,10,20,9,14,7,13,10,15,6,8,15,16,9,13,11,12,14,13,13,5,20,19,18,8,20,17,1,D/WB/M RL,125,1,1,1,1,7,8,1,17,20,1,1,15,18,16,19,0.0,0,0,0,0,0,0,0,0,0,0,0,0,0,0,0,0,0,0,0,0,0,0,0,0,0,0,0,0,0,0,0,0,0,0,0,0,0,0,0,0,0,0,0,0,0,0,0,0,Federico Mattiello,Â£2.25m ,25.0,184.0,Defender - Right-Back,right,Spezia Calcio,7.0,2.0,4.0,630.0,31.0,0.0,0.0,2259.0,19.0,1.0,2.0,1495.0,18.0,0.0,1.0,925.0,nan,nan,nan,nan,Serie A,15-07-16,17.3.2.23,Federico Mattiello,43085786,776,14-Jul-95,21,0,0,0,0,1700,5500,5750,145,115,2242160,182,77,D/WB/M RL,1,1,3,3,1,2,3,1,2,2,1,6,12,11,5,10,5,10,8,12,11,11,4,11,11,13,12,14,12,12,7,10,16,11,6,11,11,13,14,14,11,11,9,20,9,14,7,11,9,15,6,12,9,16,19,13,11,12,14,13,13,5,Federico Mattiello,Â£360Th. ,Serie A
19-06-17,18.3.4.28,Mattia Bani,43091093,776,10-Dec-93,23,0,0,0,0,1250,5600,5750,132,115,2865546,188,81,D RC,2,1,1,2,4,2,3,3,1,1,1,8,10,9,8,11,7,12,8,10,13,11,8,14,12,10,13,12,12,12,11,12,12,8,10,11,13,14,12,12,12,11,12,8,12,12,20,14,12,12,10,13,8,12,10,13,14,12,14,15,12,8,20,15,1,1,16,1,20,D RC,103,1,1,1,1,1,1,20,1,16,1,1,1,1,1,15,0.0,0,0,0,0,0,0,0,0,0,0,0,0,0,0,0,0,0,0,0,0,0,0,0,0,0,0,0,0,0,0,0,0,0,0,0,0,0,0,0,0,0,0,0,0,0,0,0,0,Mattia Bani,Â£2.25m ,26.0,188.0,Defender - Centre-Back,right,Genoa CFC,38.0,0.0,1.0,3336.0,18.0,0.0,0.0,1526.0,31.0,0.0,0.0,2627.0,27.0,4.0,0.0,2211.0,2.0,0.0,0.0,159.0,Serie A
19-06-17,18.3.4.28,Alex Ferrari,43093049,776,01-Jul-94,22,0,0,7,0,1350,6550,6000,136,120,5496321,191,80,D/WB RC,1,3,3,2,3,2,2,3,3,1,2,10,10,13,9,11,11,14,9,9,14,12,8,13,12,11,14,12,13,11,10,12,13,12,9,10,13,11,11,13,11,12,13,6,12,13,20,13,13,11,10,10,7,11,11,12,11,12,8,8,10,8,20,16,1,1,18,1,20,D/WB RC,113,1,1,1,1,1,1,20,1,18,1,1,1,1,1,16,0.0,0,0,0,0,0,0,0,0,0,0,0,0,0,0,0,0,0,0,0,0,0,0,0,0,0,0,0,0,0,0,0,0,0,0,0,0,0,0,0,0,0,0,0,0,0,0,0,0,Alex Ferrari,Â£1.35m ,26.0,191.0,Defender - Centre-Back,right,UC Sampdoria,14.0,0.0,1.0,1219.0,27.0,1.0,0.0,2295.0,7.0,0.0,0.0,660.0,13.0,0.0,0.0,1050.0,0.0,0.0,0.0,0.0,Serie A
19-06-17,18.3.4.28,Lorenzo Venuti,43093519,776,12-Apr-95,22,0,0,1,0,1750,6000,6000,140,120,402400,176,66,D/WB RL,4,3,4,3,2,1,4,1,3,1,2,8,14,9,6,10,7,10,10,12,13,11,9,13,12,11,10,13,12,10,10,11,14,7,10,10,10,14,12,14,14,12,10,14,11,13,20,14,12,13,8,11,12,12,10,14,12,10,13,14,10,2,20,16,10,1,20,15,13,D/WB RL,115,1,1,1,1,1,1,13,15,20,1,1,10,10,13,16,0.0,0,0,0,0,0,0,0,0,0,0,0,0,0,0,0,0,0,0,0,0,0,0,0,0,0,0,0,0,0,0,0,0,0,0,0,0,0,0,0,0,0,0,0,0,0,0,0,0,Lorenzo Venuti,Â£1.35m ,25.0,179.0,Defender - Right-Back,right,ACF Fiorentina,41.0,0.0,2.0,3396.0,32.0,0.0,1.0,2405.0,32.0,3.0,3.0,2369.0,18.0,0.0,2.0,895.0,2.0,0.0,0.0,12.0,Serie A
19-06-17,18.3.4.28,Paolo FaragÅ,43094009,776,12-Feb-93,24,0,0,0,0,2250,5900,5900,130,118,4378982,187,84,M RC,3,3,1,3,3,2,3,1,1,1,1,4,12,12,11,14,7,13,10,5,7,12,6,10,11,8,13,14,13,13,12,13,13,12,7,13,10,13,13,13,11,12,16,9,12,13,20,13,13,15,5,12,7,14,14,15,13,12,13,15,13,5,14,15,20,14,18,10,20,M RC,403,1,1,1,14,8,13,1,1,14,12,20,10,18,1,15,7.20579e+16,0,0,0,1,0,0,1,0,0,0,0,0,0,0,0,0,0,0,0,0,1,0,0,0,0,0,0,0,0,0,0,0,0,0,0,0,0,0,1,0,0,0,0,0,0,0,0,0,Paolo FaragÃ²,Â£5.40m ,27.0,187.0,Midfielder - Right Midfield,right,Cagliari Calcio,32.0,5.0,1.0,2439.0,36.0,2.0,6.0,2568.0,29.0,1.0,3.0,1967.0,22.0,1.0,1.0,1428.0,4.0,0.0,0.0,176.0,Serie A,15-07-16,17.3.2.23,Paolo FaragÅ,43094009,776,12-Feb-93,23,0,0,0,0,2250,5500,5900,130,122,3177686,187,80,M/AM RC,3,3,1,1,3,1,1,2,2,2,1,6,11,11,10,14,6,13,11,6,7,14,11,8,13,8,13,14,13,13,12,13,13,12,7,13,9,13,13,13,10,12,16,8,12,13,20,14,13,15,5,12,5,12,10,12,12,11,13,14,11,2,Paolo FaragÃ²,Â£2.25m ,Serie A
19-06-17,18.3.4.28,Kevin Bonifazi,43094128,776,19-May-96,21,0,0,0,0,2600,6300,6300,149,126,11414416,187,84,D RC,3,2,2,1,3,3,2,1,1,2,2,5,5,10,10,6,8,12,7,13,13,11,4,13,12,12,14,10,13,13,10,14,12,9,9,12,14,10,11,14,13,12,15,8,14,13,20,12,14,13,13,12,6,6,12,11,14,13,12,13,11,7,20,1,1,1,17,1,20,D RC,103,1,1,1,1,1,1,20,1,17,1,1,1,1,1,1,0.0,0,0,0,0,0,0,0,0,0,0,0,0,0,0,0,0,0,0,0,0,0,0,0,0,0,0,0,0,0,0,0,0,0,0,0,0,0,0,0,0,0,0,0,0,0,0,0,0,Kevin Bonifazi,Â£1.35m ,24.0,187.0,Defender - Centre-Back,right,Udinese Calcio,20.0,3.0,0.0,1648.0,7.0,0.0,0.0,497.0,28.0,2.0,0.0,2393.0,21.0,3.0,0.0,1753.0,1.0,0.0,0.0,8.0,Serie A
19-06-17,18.3.4.28,Davide Biraschi,43094277,776,02-Jul-94,22,0,0,3,0,3250,5900,5900,135,118,4653547,182,73,D RC,4,2,2,1,1,2,1,3,1,1,4,5,7,5,5,7,7,15,4,8,14,10,7,14,9,14,14,13,12,11,9,11,12,1,10,11,13,14,14,13,12,12,11,6,11,12,20,13,17,11,14,11,8,8,8,11,11,10,13,9,13,7,20,11,1,1,15,8,20,D RC,103,1,1,1,1,1,1,20,8,15,12,1,1,1,1,11,32768.0,0,0,0,0,0,0,0,0,0,0,0,0,0,0,0,1,0,0,0,0,0,0,0,0,0,0,0,0,0,0,0,0,0,0,0,0,0,0,0,0,0,0,0,0,0,0,0,0,Davide Biraschi,Â£1.08m ,26.0,182.0,Defender - Centre-Back,right,Genoa CFC,10.0,0.0,0.0,646.0,26.0,0.0,1.0,2046.0,36.0,0.0,2.0,3053.0,26.0,0.0,1.0,2181.0,2.0,0.0,0.0,180.0,Serie A,15-07-16,17.3.2.23,Davide Biraschi,43094277,776,02-Jul-94,22,0,0,3,0,1750,5900,5650,140,114,1739214,182,73,D RC,2,2,2,2,2,3,2,1,3,4,3,9,7,9,6,12,4,14,11,12,14,14,10,14,13,10,14,13,13,12,7,11,10,3,10,12,13,12,14,14,13,13,13,4,13,13,20,14,13,11,7,10,4,11,16,10,12,12,12,11,14,2,Davide Biraschi,Â£720Th. ,Serie A
19-06-17,18.3.4.28,Manuel Lazzari,43096538,776,29-Nov-93,23,0,0,0,0,3500,6300,6400,145,128,3680082,174,65,WB/M R,2,1,1,1,3,1,4,2,2,1,1,10,13,14,6,12,6,4,8,5,9,13,7,12,11,11,14,16,12,10,13,14,15,13,8,11,11,13,14,18,14,9,7,8,15,12,20,15,9,17,5,13,6,15,13,15,16,12,13,10,13,8,10,19,20,13,20,1,1,WB/M R,422,1,1,1,1,1,13,1,1,10,1,1,1,20,1,19,2.0,0,1,0,0,0,0,0,0,0,0,0,0,0,0,0,0,0,0,0,0,0,0,0,0,0,0,0,0,0,0,0,0,0,0,0,0,0,0,0,0,0,0,0,0,0,0,0,0,Manuel Lazzari,Â£5.40m ,26.0,174.0,Midfielder - Right Midfield,right,SS Lazio,41.0,0.0,7.0,3490.0,38.0,2.0,1.0,3178.0,34.0,0.0,9.0,2932.0,40.0,1.0,4.0,3275.0,4.0,1.0,0.0,299.0,Serie A
19-06-17,18.3.4.28,Cristian Barillari,43122938,776,27-Aug-95,21,0,0,0,0,500,3750,3750,90,75,111171,168,66,D/WB R,2,2,1,1,1,1,1,2,3,3,1,4,9,9,7,9,8,9,7,11,9,8,4,9,8,10,10,9,9,8,7,9,11,7,4,9,10,11,12,11,12,11,9,20,15,12,6,11,10,12,8,5,9,12,9,8,8,9,10,11,8,9,20,18,15,1,20,1,1,D/WB R,112,1,1,1,1,1,1,1,1,20,1,1,1,15,1,18,0.0,0,0,0,0,0,0,0,0,0,0,0,0,0,0,0,0,0,0,0,0,0,0,0,0,0,0,0,0,0,0,0,0,0,0,0,0,0,0,0,0,0,0,0,0,0,0,0,0,nan,nan,nan,nan,nan,nan,nan,nan,nan,nan,nan,nan,nan,nan,nan,nan,nan,nan,nan,nan,nan,nan,nan,nan,nan,nan,nan,nan,15-07-16,17.3.2.23,Cristian Barillari,43122938,776,27-Aug-95,20,0,0,0,0,300,3500,3500,90,70,32131,168,66,D/WB L,3,3,3,1,1,1,1,3,4,2,2,4,9,9,7,9,8,9,7,11,9,8,4,9,8,10,10,9,9,8,7,9,11,7,4,9,10,11,12,11,12,11,9,20,15,12,6,11,10,12,8,5,9,12,9,8,8,9,10,11,8,9,nan,nan,nan
19-06-17,18.3.4.28,Davide Calabria,43123020,776,06-Dec-96,20,0,0,1,0,3250,6600,6550,153,130,17439714,177,70,D/WB RL,3,3,2,3,1,1,2,2,2,3,3,6,13,12,4,12,2,7,8,7,13,12,6,13,12,13,14,14,12,13,11,11,15,5,9,13,12,16,13,15,16,12,9,12,16,14,20,12,10,13,8,7,10,14,19,14,17,12,14,17,14,4,20,18,14,1,20,16,1,D/WB RL,115,1,1,1,1,1,1,1,16,20,1,1,10,14,12,18,1099510000000.0,0,0,0,0,0,0,0,0,0,0,0,0,0,0,0,0,0,0,0,0,0,0,0,0,0,0,0,0,0,0,0,0,0,0,0,0,0,0,0,0,1,0,0,0,0,0,0,0,Davide Calabria,Â£11.70m ,23.0,176.0,Defender - Right-Back,right,AC Milan,13.0,0.0,1.0,999.0,30.0,1.0,3.0,2368.0,33.0,1.0,1.0,2535.0,27.0,1.0,1.0,1827.0,8.0,0.0,0.0,750.0,Serie A
19-06-17,18.3.4.28,Claud Adjapong,43202413,776,06-May-98,19,0,0,0,0,2750,5650,5950,142,119,8077310,180,74,D/WB R,3,1,1,3,3,2,1,3,1,1,2,11,13,11,7,8,10,11,7,11,12,12,5,11,10,11,11,11,11,12,10,12,14,11,8,9,11,9,10,14,12,11,11,9,13,15,20,14,14,11,12,9,5,10,13,14,13,13,13,12,14,3,20,20,15,15,20,12,8,D/WB R,112,1,1,1,3,1,15,1,12,20,8,8,10,15,11,20,0.0,0,0,0,0,0,0,0,0,0,0,0,0,0,0,0,0,0,0,0,0,0,0,0,0,0,0,0,0,0,0,0,0,0,0,0,0,0,0,0,0,0,0,0,0,0,0,0,0,Claud Adjapong,Â£3.60m ,22.0,180.0,Defender - Right-Back,right,US Lecce,21.0,3.0,1.0,1532.0,17.0,0.0,1.0,1311.0,6.0,1.0,0.0,315.0,5.0,0.0,0.0,228.0,5.0,0.0,0.0,365.0,Serie A
19-06-17,18.3.4.28,Bright Gyamfi,43207789,21,20-Jan-96,21,0,0,0,0,1600,5650,5650,138,113,2293757,178,0,D/WB RC,3,3,1,3,1,1,2,3,2,2,2,7,13,11,9,11,9,9,9,13,12,12,9,12,10,13,12,11,12,13,10,11,11,12,9,13,11,11,11,14,12,11,9,10,12,13,20,11,13,12,10,11,10,11,12,10,10,9,11,10,10,10,20,18,7,1,20,10,15,D/WB RC,113,1,1,1,1,1,1,15,10,20,7,7,1,1,1,18,0.0,0,0,0,0,0,0,0,0,0,0,0,0,0,0,0,0,0,0,0,0,0,0,0,0,0,0,0,0,0,0,0,0,0,0,0,0,0,0,0,0,0,0,0,0,0,0,0,0,Bright Gyamfi,Â£360Th. ,24.0,178.0,Defender - Right-Back,right,AC Reggiana 1919,23.0,0.0,1.0,1258.0,9.0,0.0,0.0,318.0,10.0,0.0,0.0,836.0,4.0,0.0,0.0,326.0,5.0,0.0,0.0,375.0,Serie A
19-06-17,18.3.4.28,Bruno Gaspar,55027972,788,21-Apr-93,24,0,0,1,0,4500,6100,6100,134,122,3970662,180,70,D/WB RL,3,3,2,1,1,1,2,1,3,1,2,8,14,10,8,11,6,10,7,11,11,11,8,13,13,14,12,13,11,11,10,12,14,11,12,13,12,12,14,14,13,11,8,12,12,14,20,13,10,13,14,10,12,14,7,12,12,12,15,12,14,6,20,18,10,7,20,18,1,D/WB RL,115,1,1,1,1,1,7,1,18,20,1,1,1,10,13,18,0.0,0,0,0,0,0,0,0,0,0,0,0,0,0,0,0,0,0,0,0,0,0,0,0,0,0,0,0,0,0,0,0,0,0,0,0,0,0,0,0,0,0,0,0,0,0,0,0,0,Bruno Gaspar,Â£2.70m ,27.0,180.0,Defender - Right-Back,right,Sporting CP,36.0,0.0,6.0,2989.0,17.0,0.0,2.0,935.0,30.0,1.0,0.0,2062.0,21.0,0.0,1.0,1258.0,nan,nan,nan,nan,Serie A,15-07-16,17.3.2.23,Bruno Gaspar,55027972,788,21-Apr-93,23,0,0,1,0,4500,6050,6050,134,121,550548,176,71,D/WB RL,2,3,3,3,3,1,3,2,2,1,2,8,14,10,8,11,6,10,7,11,11,11,8,13,13,14,12,13,11,11,10,12,14,11,12,13,12,12,14,14,13,11,8,12,12,14,20,13,10,13,14,10,12,14,11,12,12,12,15,12,14,6,Bruno Gaspar,Â£2.70m ,Liga NOS
19-06-17,18.3.4.28,JoÄo Cancelo,55041623,788,27-May-94,23,0,0,8,1,6000,7100,7300,164,146,47022132,182,72,D/WB/M/AM R,3,1,3,3,3,1,1,3,3,3,2,10,14,14,12,14,11,8,14,10,8,14,12,11,14,12,12,11,9,7,13,9,7,15,6,13,8,10,11,18,15,12,12,12,15,15,20,13,12,5,12,10,7,14,10,12,12,10,12,12,10,11,20,18,17,17,20,10,1,D/WB/M/AM R,132,1,1,1,1,1,17,1,10,20,1,1,5,17,9,18,8864950000000.0,0,1,0,0,0,1,0,0,0,0,0,0,0,0,0,0,0,0,0,0,0,0,0,0,0,0,0,1,0,0,0,0,0,0,0,0,1,0,0,0,0,0,0,1,0,0,0,0,JoÃ£o Cancelo,Â£31.50m ,26.0,182.0,Defender - Right-Back,right,Manchester City,38.0,1.0,4.0,2695.0,29.0,1.0,4.0,2178.0,34.0,1.0,5.0,2599.0,33.0,1.0,1.0,2356.0,3.0,0.0,1.0,270.0,Serie A,15-07-16,17.3.2.23,JoÄo Cancelo,55041623,788,27-May-94,22,0,0,8,1,6250,7100,7300,164,147,46391823,182,72,D/WB/M/AM R,3,3,2,1,2,2,3,1,1,1,1,10,15,15,12,14,12,8,14,10,7,14,12,10,15,12,12,10,9,7,13,8,9,16,6,14,9,12,12,18,15,12,12,13,15,15,20,14,12,7,12,12,7,14,10,12,12,12,13,12,12,11,JoÃ£o Cancelo,Â£18.00m ,LaLiga
19-06-17,18.3.4.28,Pedro Pereira,55082273,788,22-Jan-98,19,0,0,0,0,2500,5650,5650,122,113,731499,182,69,D/WB R,1,3,3,3,1,2,1,3,1,2,3,8,13,12,8,12,8,12,10,14,10,10,8,11,10,12,12,14,10,12,10,12,14,8,6,8,11,12,14,14,12,10,11,7,15,14,20,15,11,15,12,10,8,16,10,16,12,8,16,12,16,5,20,17,9,1,20,13,1,D/WB R,112,1,1,1,1,1,1,1,13,20,1,1,5,9,10,17,0.0,0,0,0,0,0,0,0,0,0,0,0,0,0,0,0,0,0,0,0,0,0,0,0,0,0,0,0,0,0,0,0,0,0,0,0,0,0,0,0,0,0,0,0,0,0,0,0,0,Pedro Pereira,Â£1.80m ,22.0,185.0,Midfielder - Right Midfield,right,FC Crotone,13.0,0.0,0.0,876.0,7.0,0.0,0.0,471.0,27.0,0.0,0.0,1436.0,22.0,2.0,1.0,1342.0,4.0,0.0,0.0,307.0,Serie A
19-06-17,18.3.4.28,Stephan Lichtsteiner,5723486,798,16-Jan-84,33,90,6,30,1,6000,7750,7250,159,145,8168538,182,76,D/WB/M R,3,4,1,2,3,3,1,4,2,2,1,4,12,12,10,11,2,12,10,10,15,14,5,14,12,19,14,20,16,16,11,14,20,8,13,15,16,16,17,13,13,14,11,9,15,14,20,14,14,16,16,14,7,11,15,13,15,15,14,6,7,12,20,19,18,6,20,1,7,D/WB/M R,122,1,1,1,1,1,6,7,1,20,1,1,1,18,1,19,229410.0,0,1,0,0,0,1,0,0,0,0,0,0,0,0,0,1,1,1,0,0,0,0,0,0,0,0,0,0,0,0,0,0,0,0,0,0,0,0,0,0,0,0,0,0,0,0,0,0,Stephan Lichtsteiner,Â£1.35m ,36.0,182.0,Defender - Right-Back,right,Retired,30.0,1.0,3.0,2196.0,32.0,0.0,3.0,2018.0,23.0,1.0,1.0,1732.0,20.0,0.0,1.0,1346.0,nan,nan,nan,nan,Serie A,15-07-16,17.3.2.23,Stephan Lichtsteiner,5723486,798,16-Jan-84,32,85,5,30,1,6000,7850,7700,163,153,4710407,182,75,D/WB/M R,3,2,3,3,1,2,2,3,2,3,2,4,12,12,10,11,2,12,10,12,14,14,5,12,13,19,14,19,16,16,11,14,18,8,13,16,16,16,19,14,13,14,11,9,15,15,20,17,14,16,14,14,7,11,15,16,13,15,14,6,7,12,Stephan Lichtsteiner,Â£2.70m ,Serie A
19-06-17,18.3.4.28,Darko Lazovic,5747078,802,15-Sep-90,26,6,0,10,5,4500,6350,6350,137,127,5694068,181,66,WB/M/AM RL,2,1,3,2,1,4,1,3,2,3,3,13,12,13,10,13,12,9,13,5,5,13,11,9,13,10,12,8,11,11,13,11,10,15,11,13,8,11,12,14,13,12,10,10,12,14,20,13,10,13,7,11,8,14,12,13,12,8,10,11,10,12,1,17,18,20,20,16,14,WB/M/AM RL,535,1,1,5,14,16,20,1,1,1,1,1,8,18,1,17,549756000000.0,0,0,0,0,0,0,0,0,0,0,1,1,0,0,0,0,0,0,0,0,0,0,0,0,0,0,0,0,0,0,0,0,0,0,0,0,0,0,0,1,0,0,0,0,0,0,0,0,Darko Lazovic,Â£1.62m ,30.0,181.0,Midfielder - Left Midfield,right,Hellas Verona,36.0,2.0,5.0,2624.0,24.0,0.0,0.0,1457.0,34.0,3.0,4.0,2667.0,39.0,3.0,7.0,3314.0,3.0,0.0,0.0,225.0,Serie A,15-07-16,17.3.2.23,Darko Lazovic,5747078,802,15-Sep-90,25,6,0,10,5,4750,6300,6450,137,130,7808348,181,66,AM RL,2,3,3,2,1,1,2,2,2,2,4,13,13,14,13,13,12,9,14,5,5,13,11,9,16,10,12,12,11,12,13,11,10,15,11,12,8,10,12,14,13,12,9,10,12,14,20,12,10,13,7,11,14,15,12,13,12,8,10,11,10,12,Darko Lazovic,Â£2.25m ,Serie A
19-06-17,18.3.4.28,Dusan Basta,5754424,802,18-Aug-84,32,19,2,28,1,5250,6500,6750,147,138,9226984,183,76,D/WB/M R,3,1,3,3,2,1,2,3,3,2,1,8,13,12,9,12,10,12,12,15,14,12,11,14,13,15,15,13,12,12,11,13,13,12,9,14,14,17,17,13,12,14,10,9,16,13,20,15,13,13,10,12,14,16,17,13,14,15,17,16,17,2,20,19,17,7,20,8,14,D/WB/M R,122,1,1,1,1,1,7,14,8,20,1,1,4,17,6,19,150994994.0,0,1,0,0,1,1,0,0,0,0,0,0,0,0,0,0,0,0,0,0,0,0,0,0,1,0,0,1,0,0,0,0,0,0,0,0,0,0,0,0,0,0,0,0,0,0,0,0,Dusan Basta,Â£900Th. ,36.0,183.0,Defender - Right-Back,right,Retired,30.0,1.0,2.0,2393.0,22.0,0.0,3.0,1707.0,2.0,0.0,0.0,135.0,nan,nan,nan,nan,nan,nan,nan,nan,Serie A,15-07-16,17.3.2.23,Dusan Basta,5754424,802,18-Aug-84,31,19,2,28,1,5350,7000,7000,149,140,232186002,185,75,D/WB/M R,1,2,4,2,2,2,3,1,4,4,4,8,13,10,9,12,10,9,11,15,14,12,11,15,13,16,15,12,12,12,13,12,13,10,6,13,14,16,15,13,13,12,10,12,16,13,20,16,13,12,11,12,14,16,16,14,14,15,17,16,17,2,Dusan Basta,Â£2.70m ,Serie A
19-06-17,18.3.4.28,Nenad Tomovic,5768029,802,30-Aug-87,29,22,0,9,1,5100,6350,6700,145,134,15509107,184,79,D/WB RC,3,2,3,2,1,3,2,3,1,1,2,6,11,10,8,12,7,13,8,12,14,12,8,13,11,16,12,15,13,10,11,13,14,10,11,10,15,15,14,14,13,13,11,9,15,14,20,14,15,14,14,13,7,13,13,13,14,12,13,12,15,6,20,17,5,1,19,10,20,D/WB RC,113,1,1,1,1,1,1,20,10,19,1,1,1,5,1,17,0.0,0,0,0,0,0,0,0,0,0,0,0,0,0,0,0,0,0,0,0,0,0,0,0,0,0,0,0,0,0,0,0,0,0,0,0,0,0,0,0,0,0,0,0,0,0,0,0,0,Nenad TomoviÄ,Â£1.35m ,33.0,184.0,Defender - Centre-Back,right,SPAL,35.0,0.0,1.0,2559.0,29.0,0.0,0.0,2437.0,11.0,1.0,0.0,831.0,25.0,0.0,1.0,1911.0,6.0,0.0,1.0,524.0,Serie A,15-07-16,17.3.2.23,Nenad Tomovic,5768029,802,30-Aug-87,28,22,0,9,1,5250,6600,6800,145,135,15401695,184,79,D RC,2,1,1,4,2,3,3,2,1,1,3,6,12,11,8,13,7,13,8,12,14,12,8,13,12,15,14,15,15,13,11,13,14,10,11,10,15,15,15,14,13,14,12,9,15,14,20,15,15,14,13,13,7,13,13,14,15,14,13,11,13,6,Nenad TomoviÄ,Â£2.97m ,Serie A
19-06-17,18.3.4.28,Christian Maggio,6100081,776,11-Feb-82,35,34,0,2,0,5500,6450,6450,154,129,638769,184,79,D/WB/M R,3,3,3,1,1,3,3,2,2,3,3,8,12,12,10,12,4,13,8,13,12,12,2,15,13,13,14,15,11,13,12,12,11,7,10,14,14,13,15,12,13,15,13,9,15,14,20,12,14,12,9,15,12,14,10,12,15,14,15,18,10,7,20,19,19,10,20,1,1,D/WB/M R,122,1,1,1,1,1,10,1,1,20,1,1,1,19,1,19,134217762.0,0,1,0,0,0,1,0,0,0,0,0,0,0,0,0,0,0,0,0,0,0,0,0,0,0,0,0,1,0,0,0,0,0,0,0,0,0,0,0,0,0,0,0,0,0,0,0,0,Christian Maggio,Â£450Th. ,38.0,184.0,Defender - Right-Back,right,Benevento Calcio,11.0,0.0,0.0,691.0,20.0,0.0,0.0,1133.0,20.0,2.0,0.0,1687.0,35.0,3.0,7.0,2995.0,3.0,0.0,0.0,75.0,Serie A,15-07-16,17.3.2.23,Christian Maggio,6100081,776,11-Feb-82,34,34,0,2,0,5500,6550,6550,154,131,662051,184,79,D/WB/M R,3,1,3,3,3,2,3,1,1,1,1,8,12,12,10,12,4,13,8,13,12,12,2,15,13,13,14,15,11,13,12,12,11,7,10,14,15,13,15,12,13,15,13,9,15,14,20,13,14,12,9,15,12,14,10,12,15,14,15,18,10,7,Christian Maggio,Â£450Th. ,Serie A
19-06-17,18.3.4.28,Andrea Barzagli,6100324,776,08-May-81,36,68,0,15,0,6900,8300,7900,167,158,232186002,187,87,D RC,3,2,2,3,2,1,2,3,1,1,1,2,2,8,3,11,2,14,3,3,20,12,10,16,11,8,18,14,16,19,11,18,18,3,12,5,19,17,14,8,8,18,14,9,10,9,20,11,15,20,3,12,14,5,9,19,15,17,18,18,20,7,20,1,1,1,15,1,20,D RC,103,1,11,1,1,1,1,20,1,15,1,1,1,1,1,1,8589934656.0,0,0,0,0,0,0,1,0,0,0,0,0,0,0,0,0,0,0,0,0,0,0,0,0,0,0,0,0,0,0,0,0,0,1,0,0,0,0,0,0,0,0,0,0,0,0,0,0,Andrea Barzagli,Â£900Th. ,39.0,187.0,Defender - Centre-Back,right,Retired,39.0,0.0,0.0,2618.0,38.0,0.0,1.0,2372.0,10.0,0.0,0.0,367.0,nan,nan,nan,nan,nan,nan,nan,nan,Serie A,15-07-16,17.3.2.23,Andrea Barzagli,6100324,776,08-May-81,35,61,0,15,0,6750,8200,8200,167,163,232186002,187,87,D C,1,1,1,2,2,1,2,3,3,3,1,2,2,8,3,11,2,13,3,3,18,12,10,16,11,8,18,14,16,19,10,18,16,3,12,5,19,17,12,11,10,18,13,10,8,12,20,13,14,20,3,12,14,5,9,13,13,17,18,18,20,7,Andrea Barzagli,Â£900Th. ,Serie A
19-06-17,18.3.4.28,Adam Marusic,62095383,62002127,17-Oct-92,24,15,0,0,0,6000,6500,6900,146,133,32383021,185,81,D/WB/M R,2,3,3,3,2,2,1,1,2,2,2,5,12,12,11,12,6,7,12,4,10,13,12,11,12,13,11,13,12,12,9,13,15,13,9,16,12,14,16,15,12,15,13,8,14,16,20,14,14,14,10,11,7,14,15,13,14,13,16,13,11,9,20,19,17,14,20,8,5,D/WB/M R,122,1,1,1,1,4,14,5,8,20,1,1,6,17,8,19,134217776.0,0,0,0,0,1,1,0,0,0,0,0,0,0,0,0,0,0,0,0,0,0,0,0,0,0,0,0,1,0,0,0,0,0,0,0,0,0,0,0,0,0,0,0,0,0,0,0,0,Adam Marusic,Â£9.00m ,28.0,185.0,Defender - Right-Back,right,SS Lazio,40.0,5.0,6.0,3477.0,39.0,3.0,5.0,2942.0,34.0,2.0,1.0,2693.0,15.0,2.0,1.0,939.0,6.0,0.0,2.0,391.0,Serie A
19-06-17,18.3.4.28,Patric,67100019,796,17-Apr-93,24,0,0,0,0,4500,6600,6500,140,130,10225423,184,74,D/WB RLC,1,1,1,1,3,2,3,3,1,2,2,12,12,10,7,11,10,12,10,8,12,12,11,13,10,18,13,16,10,11,10,11,16,7,11,15,12,17,18,13,12,13,10,9,15,13,20,14,13,16,13,12,8,16,14,14,12,8,16,16,16,2,20,16,14,9,20,17,17,D/WB RLC,116,1,1,1,1,1,9,17,17,20,9,7,14,14,16,16,0.0,0,0,0,0,0,0,0,0,0,0,0,0,0,0,0,0,0,0,0,0,0,0,0,0,0,0,0,0,0,0,0,0,0,0,0,0,0,0,0,0,0,0,0,0,0,0,0,0,Patric,Â£1.62m ,27.0,184.0,Defender - Centre-Back,right,SS Lazio,21.0,0.0,2.0,1187.0,21.0,0.0,1.0,1267.0,17.0,0.0,0.0,1224.0,24.0,1.0,0.0,1795.0,6.0,0.0,0.0,540.0,Serie A,15-07-16,17.3.2.23,Patric,67100019,796,17-Apr-93,23,0,0,0,0,4250,6100,6450,141,132,6752757,184,74,D/WB RL,1,2,2,3,1,3,3,1,1,1,2,12,11,9,7,10,10,6,10,8,11,13,11,11,9,16,14,17,9,12,8,11,13,9,11,13,11,18,18,13,11,10,10,10,15,13,20,15,13,16,14,14,9,16,14,14,12,8,18,18,18,2,Patric,Â£1.62m ,Serie A
19-06-17,18.3.4.28,Pol Lirola,67211095,796,13-Aug-97,19,0,0,0,0,3258,5715,6500,158,130,21107523,183,78,D/WB/M R,3,3,1,3,2,3,2,3,3,1,3,10,13,12,7,11,10,11,9,11,11,11,8,12,11,12,12,11,13,12,12,11,13,11,8,11,10,11,11,16,13,13,10,12,13,15,20,14,13,12,8,9,7,10,15,13,11,12,13,13,12,8,20,19,16,8,20,1,1,D/WB/M R,122,1,1,1,1,1,8,1,1,20,1,1,1,16,1,19,402653186.0,0,1,0,0,0,0,0,0,0,0,0,0,0,0,0,0,0,0,0,0,0,0,0,0,0,0,0,1,1,0,0,0,0,0,0,0,0,0,0,0,0,0,0,0,0,0,0,0,Pol Lirola,Â£6.75m ,23.0,183.0,Defender - Right-Back,right,ACF Fiorentina,29.0,1.0,3.0,2175.0,26.0,0.0,1.0,2203.0,38.0,2.0,7.0,3180.0,39.0,1.0,2.0,2933.0,4.0,0.0,1.0,198.0,Serie A,15-07-16,17.3.2.23,Pol Lirola,67211095,796,13-Aug-97,18,0,0,0,0,2803,5192,5991,162,124,4672850,175,70,D/WB/M R,1,1,1,3,2,1,1,3,2,4,2,10,13,9,7,9,10,11,10,11,13,10,8,11,11,12,13,11,13,13,12,11,19,11,8,11,10,11,10,12,13,12,10,12,13,14,20,14,14,12,8,9,7,10,16,10,11,9,12,12,18,1,Pol Lirola,Â£3.60m ,Serie A
19-06-17,18.3.4.28,Vasilis Torosidis,688241,772,10-Jun-85,32,91,9,16,0,5250,7000,6400,144,128,3887048,186,82,D/WB RL,3,2,3,2,3,2,3,3,3,2,4,10,12,12,11,11,9,14,11,14,8,12,7,13,11,14,13,15,12,12,11,11,14,12,9,14,9,14,15,14,11,15,13,10,12,14,20,13,14,13,12,14,11,15,14,13,15,14,14,8,7,8,20,18,14,1,20,17,14,D/WB RL,115,1,1,1,1,1,1,14,17,20,8,6,1,14,10,18,549756000000.0,0,0,0,0,0,1,0,0,0,0,0,0,0,0,0,0,0,0,0,0,0,0,0,0,0,0,0,0,0,0,0,0,0,0,0,0,0,0,0,1,0,0,0,0,0,0,0,0,Vasilios Torosidis,Â£630Th. ,35.0,186.0,Defender - Right-Back,right,Retired,28.0,1.0,1.0,1939.0,17.0,0.0,0.0,907.0,25.0,3.0,4.0,1206.0,10.0,0.0,1.0,560.0,nan,nan,nan,nan,Serie A,15-07-16,17.3.2.23,Vasilis Torosidis,688241,772,10-Jun-85,31,83,7,16,0,5500,7000,6550,144,130,232186002,185,80,D/WB RL,3,3,2,4,3,2,1,1,1,2,3,10,12,12,11,11,9,14,11,14,8,12,7,13,11,14,11,15,12,11,11,11,14,12,9,14,9,14,15,14,12,15,13,11,12,15,20,15,14,13,12,15,11,18,14,13,15,14,14,8,7,8,Vasilios Torosidis,Â£720Th. ,Serie A
19-06-17,18.3.4.28,Juan Cuadrado,76010707,1653,26-May-88,29,64,7,0,0,6400,8000,7950,165,159,178467284,179,72,M/AM R,3,4,1,1,3,1,1,1,2,2,1,11,13,16,12,16,10,11,13,8,8,14,9,13,16,16,14,10,12,10,12,10,15,14,8,16,7,8,14,17,17,10,8,10,15,17,20,16,9,12,15,12,10,18,15,16,13,16,15,13,14,6,13,15,19,20,20,11,10,M/AM R,522,1,1,13,10,11,20,1,1,13,1,5,8,19,1,15,88545000000000.0,0,0,0,0,1,0,0,0,0,0,0,0,0,0,0,0,0,0,0,0,0,0,0,0,0,0,0,0,0,0,0,0,0,0,0,1,0,0,0,1,0,0,0,0,1,0,1,0,Juan Cuadrado,Â£25.20m ,32.0,176.0,Defender - Right-Back,right,Juventus FC,45.0,3.0,10.0,2907.0,29.0,5.0,9.0,1915.0,23.0,1.0,3.0,1552.0,45.0,3.0,7.0,3441.0,5.0,0.0,1.0,382.0,Serie A,15-07-16,17.3.2.23,Juan Cuadrado,76010707,1653,26-May-88,28,55,6,0,0,7500,8050,8150,170,163,123798608,176,66,WB/M/AM R,2,2,3,3,3,1,2,3,2,3,3,11,14,17,12,16,10,13,14,10,8,14,9,13,15,12,14,11,13,11,12,11,15,14,8,16,7,8,10,17,16,10,8,10,15,18,20,16,8,14,13,15,10,18,15,16,13,16,15,13,14,6,Juan Cuadrado,Â£22.50m ,Premier League
19-06-17,18.3.4.28,MartÃ­n CÃ¡ceres,78010878,1657,07-Apr-87,30,69,3,11,0,5931,7958,6800,155,138,16734565,180,78,D/WB RC,3,3,3,3,3,2,3,1,1,1,3,3,10,10,7,11,2,14,9,12,13,10,5,15,11,16,14,18,13,14,9,12,15,10,11,11,15,14,15,11,13,16,13,12,6,11,20,15,15,14,12,14,17,16,17,12,12,13,10,13,12,5,20,17,8,1,20,13,18,D/WB RC,113,1,1,1,1,1,1,18,13,20,1,1,1,8,8,17,137439000000.0,0,0,0,0,0,0,0,0,0,0,0,0,0,0,0,0,0,0,0,0,0,0,0,0,0,0,0,0,0,0,0,0,0,0,0,0,0,1,0,0,0,0,0,0,0,0,0,0,MartÃ­n CÃ¡ceres,Â£2.25m ,33.0,180.0,Defender - Centre-Back,right,ACF Fiorentina,4.0,0.0,0.0,360.0,25.0,4.0,1.0,2001.0,17.0,0.0,0.0,1278.0,30.0,2.0,0.0,2480.0,5.0,0.0,0.0,450.0,Serie A,15-07-16,17.3.2.23,MartÃ­n CÃ¡ceres,78010878,1657,07-Apr-87,29,69,3,11,0,5915,7936,6800,155,136,12109777,180,78,D RC,2,4,3,3,1,3,1,3,2,1,2,2,11,10,6,10,1,14,8,11,13,10,4,15,10,16,14,18,11,13,8,11,15,10,11,10,14,13,15,10,12,15,12,12,6,13,20,14,14,14,12,14,17,16,17,12,12,13,10,13,12,5,MartÃ­n CÃ¡ceres,Â£3.60m ,Premier League
19-06-17,18.3.4.28,Luca Rossettini,7980318,776,09-May-85,32,0,0,1,0,4000,6550,6550,137,131,232186002,187,82,D RC,3,1,1,2,3,2,4,2,2,3,1,7,11,6,5,10,7,13,8,13,14,12,7,13,10,13,13,12,13,13,11,13,10,9,11,11,13,12,13,14,12,13,14,10,16,15,20,13,14,13,12,12,8,13,10,9,14,11,11,12,12,6,20,15,1,1,16,1,20,D RC,103,1,10,1,1,1,1,20,1,16,1,1,1,1,1,15,0.0,0,0,0,0,0,0,0,0,0,0,0,0,0,0,0,0,0,0,0,0,0,0,0,0,0,0,0,0,0,0,0,0,0,0,0,0,0,0,0,0,0,0,0,0,0,0,0,0,Luca Rossettini,Â£1.26m ,35.0,187.0,Defender - Centre-Back,right,US Lecce,31.0,1.0,0.0,2774.0,25.0,0.0,0.0,2206.0,23.0,0.0,0.0,2002.0,27.0,0.0,2.0,2351.0,1.0,0.0,0.0,90.0,Serie A,15-07-16,17.3.2.23,Luca Rossettini,7980318,776,09-May-85,31,0,0,1,0,4000,6550,6550,133,131,3001726,187,82,D RC,2,1,2,3,2,3,2,4,1,1,3,7,11,6,5,10,7,13,8,13,14,12,7,13,10,13,13,12,13,13,11,13,10,9,11,11,13,12,13,14,12,13,14,10,16,15,20,13,14,13,12,12,8,13,10,9,14,11,11,12,12,6,Luca Rossettini,Â£2.25m ,Serie A
19-06-17,18.3.4.28,Ignazio Abate,7983987,776,12-Nov-86,30,22,1,18,2,5750,6600,6950,152,139,15783837,180,73,D/WB R,1,2,1,3,2,2,1,2,2,1,4,5,12,13,4,11,2,10,6,14,13,12,4,13,11,15,14,14,10,11,9,12,15,6,15,13,13,15,14,17,16,13,10,7,12,17,20,15,12,13,13,12,13,8,18,13,18,13,16,15,12,7,20,18,12,7,20,1,1,D/WB R,112,1,1,1,1,1,7,1,1,20,1,1,1,12,1,18,1099510000000.0,0,1,0,0,0,1,0,0,0,0,0,0,0,0,0,0,0,0,0,0,0,0,0,0,0,0,0,0,0,0,0,0,0,0,0,0,0,0,0,0,1,0,0,0,0,0,0,0,Ignazio Abate,Â£2.70m ,33.0,180.0,Defender - Right-Back,right,Without Club,26.0,0.0,2.0,2170.0,27.0,1.0,1.0,1713.0,24.0,0.0,0.0,1688.0,nan,nan,nan,nan,nan,nan,nan,nan,Serie A,15-07-16,17.3.2.23,Ignazio Abate,7983987,776,12-Nov-86,29,22,1,18,2,5800,6900,7000,152,140,9382441,180,73,D/WB R,2,3,2,2,2,3,3,1,3,1,3,3,12,13,4,11,2,10,6,14,13,12,4,13,11,15,14,14,11,13,9,12,14,6,13,13,13,15,14,17,16,13,10,7,12,17,20,15,12,13,13,12,14,8,14,13,18,13,16,15,12,7,Ignazio Abate,Â£5.40m ,Serie A
19-06-17,18.3.4.28,Aleandro Rosi,7984127,776,17-May-87,30,0,0,0,0,4000,6050,6050,132,121,2137870,184,80,D/WB/M R,3,3,2,3,1,1,2,1,3,1,1,3,12,12,10,9,4,11,8,12,10,12,5,12,11,15,12,13,11,11,8,12,11,12,8,13,12,12,16,14,13,11,12,10,14,15,20,13,12,10,15,14,5,18,16,11,12,12,15,13,11,5,20,19,18,8,20,13,1,D/WB/M R,122,1,1,1,1,1,8,1,13,20,1,1,12,18,12,19,1099510000000.0,0,0,0,0,0,0,0,0,0,0,0,0,0,0,0,1,0,0,0,0,1,0,0,0,0,0,0,0,0,0,0,0,0,0,0,0,0,0,0,0,1,0,0,0,0,0,0,0,Aleandro Rosi,Â£810Th. ,33.0,180.0,Defender - Right-Back,right,AC Perugia Calcio,31.0,1.0,1.0,2565.0,25.0,0.0,1.0,1826.0,14.0,0.0,0.0,1109.0,38.0,0.0,3.0,3150.0,7.0,1.0,2.0,397.0,Serie A,15-07-16,17.3.2.23,Aleandro Rosi,7984127,776,17-May-87,29,0,0,0,0,4000,5950,6000,130,121,167107,184,80,D/WB/M RL,2,2,2,3,2,3,2,1,4,3,3,3,11,12,10,9,4,9,8,10,11,12,5,11,11,15,12,12,11,11,10,12,11,12,8,13,11,12,16,14,13,11,11,9,14,15,20,12,12,10,15,14,8,18,20,11,12,12,15,13,11,5,Aleandro Rosi,Â£900Th. ,Serie A
19-06-17,18.3.4.28,Andrea Masiello,7984549,776,05-Feb-86,31,0,0,0,0,4000,6550,6900,138,138,232186002,184,82,D RC,2,1,1,3,3,2,3,4,2,3,3,3,8,7,6,11,4,14,7,7,15,10,4,14,11,13,16,13,14,15,7,14,16,5,12,7,15,14,13,13,14,13,12,10,14,13,20,13,14,14,8,14,7,10,13,15,13,15,15,13,16,7,20,10,1,1,18,1,20,D RC,103,1,13,1,1,1,1,20,1,18,1,1,1,1,1,10,32768.0,0,0,0,0,0,0,0,0,0,0,0,0,0,0,0,1,0,0,0,0,0,0,0,0,0,0,0,0,0,0,0,0,0,0,0,0,0,0,0,0,0,0,0,0,0,0,0,0,Andrea Masiello,Â£2.70m ,34.0,184.0,Defender - Centre-Back,right,Genoa CFC,38.0,3.0,0.0,3137.0,41.0,5.0,0.0,3565.0,33.0,1.0,3.0,2593.0,27.0,0.0,1.0,2149.0,2.0,0.0,0.0,180.0,Serie A,15-07-16,17.3.2.23,Andrea Masiello,7984549,776,05-Feb-86,30,0,0,0,0,3500,6500,6650,135,134,232186002,185,79,D RC,3,1,1,1,1,1,2,1,3,1,2,3,8,7,4,11,4,13,7,7,15,10,4,14,11,13,15,13,14,15,7,13,16,5,12,7,15,13,13,13,14,13,12,9,14,13,20,13,14,14,8,14,7,10,18,15,4,15,15,13,16,7,Andrea Masiello,Â£2.25m ,Serie A
19-06-17,18.3.4.28,Fabrizio Cacciatore,7988563,776,08-Oct-86,30,0,0,0,0,4000,6400,6650,133,133,232186002,182,85,D/WB RLC,3,1,1,1,3,3,3,3,3,2,2,7,12,10,8,8,7,13,8,14,13,12,9,14,8,16,13,14,8,14,8,13,14,11,13,8,15,14,16,13,12,13,12,11,13,14,20,15,13,15,10,15,7,14,16,12,11,15,12,12,17,7,20,19,1,1,20,16,15,D/WB RLC,116,1,1,1,1,1,1,15,16,20,1,1,1,1,15,19,131074.0,0,1,0,0,0,0,0,0,0,0,0,0,0,0,0,0,0,1,0,0,0,0,0,0,0,0,0,0,0,0,0,0,0,0,0,0,0,0,0,0,0,0,0,0,0,0,0,0,Fabrizio Cacciatore,Â£1.08m ,34.0,182.0,Defender - Right-Back,right,Without Club,31.0,1.0,1.0,2689.0,35.0,3.0,3.0,3080.0,16.0,0.0,2.0,1257.0,17.0,0.0,0.0,1245.0,nan,nan,nan,nan,Serie A,15-07-16,17.3.2.23,Fabrizio Cacciatore,7988563,776,08-Oct-86,29,0,0,0,0,4000,6500,6550,132,132,5234113,182,85,D/WB RLC,2,2,2,1,1,1,1,2,1,2,2,7,12,10,8,8,7,12,8,14,13,10,9,14,8,16,13,14,8,14,8,13,12,11,13,8,15,14,16,13,12,13,14,9,13,13,20,14,13,15,10,15,7,14,14,12,11,15,11,11,15,7,Fabrizio Cacciatore,Â£1.62m ,Serie A
19-06-17,18.3.4.28,Fabio Pisacane,7990939,776,28-Jan-86,31,0,0,0,0,3250,6250,6250,134,125,232186002,178,77,D/WB RLC,3,1,3,2,1,2,1,1,2,3,3,5,9,7,6,10,6,12,7,11,14,11,6,14,9,12,14,13,12,13,10,13,12,7,11,11,14,12,14,13,13,12,10,9,14,12,20,13,11,12,8,11,7,13,12,16,10,11,14,14,12,5,20,16,1,1,20,15,19,D/WB RLC,116,1,1,1,1,1,1,19,15,20,1,1,1,1,13,16,2.0,0,1,0,0,0,0,0,0,0,0,0,0,0,0,0,0,0,0,0,0,0,0,0,0,0,0,0,0,0,0,0,0,0,0,0,0,0,0,0,0,0,0,0,0,0,0,0,0,Fabio Pisacane,Â£630Th. ,34.0,178.0,Defender - Centre-Back,right,Cagliari Calcio,29.0,1.0,1.0,2553.0,26.0,0.0,0.0,2140.0,28.0,2.0,1.0,2350.0,32.0,1.0,0.0,2541.0,1.0,0.0,0.0,44.0,Serie A,15-07-16,17.3.2.23,Fabio Pisacane,7990939,776,28-Jan-86,30,0,0,0,0,1750,5900,6050,125,122,1406397,178,77,D RC,3,3,3,1,1,3,1,3,2,1,2,5,8,7,6,10,6,13,7,9,14,11,6,14,9,12,14,13,13,13,10,14,12,7,11,10,14,12,14,13,13,12,9,6,14,12,20,13,11,12,8,11,7,13,12,16,10,10,14,14,11,5,Fabio Pisacane,Â£810Th. ,Serie A
19-06-17,18.3.4.28,Simone Padoin,836918,776,18-Mar-84,33,0,0,6,0,5250,6550,6550,145,131,232186002,177,74,M RLC,3,3,1,3,2,2,1,3,2,1,1,8,11,9,8,11,8,9,11,14,12,14,8,13,12,15,13,15,10,14,11,14,17,6,7,11,15,18,18,12,12,12,9,10,14,13,20,17,11,15,10,13,6,20,6,12,17,14,18,16,18,5,14,15,20,8,20,16,19,M RLC,406,1,1,1,5,8,8,1,13,14,11,19,16,20,14,15,140737000000000.0,0,0,0,0,0,0,0,0,0,0,0,0,0,0,0,1,0,0,0,0,0,0,0,0,0,0,0,0,0,0,0,0,0,0,0,0,0,0,0,0,0,0,0,0,0,0,0,1,Simone Padoin,Â£450Th. ,36.0,177.0,Midfielder - Left Midfield,right,Retired,32.0,1.0,2.0,2262.0,37.0,1.0,0.0,3117.0,32.0,0.0,1.0,2016.0,31.0,0.0,3.0,2436.0,1.0,0.0,0.0,9.0,Serie A,15-07-16,17.3.2.23,Simone Padoin,836918,776,18-Mar-84,32,0,0,7,0,5250,6750,6700,145,133,232186002,177,74,M RLC,1,1,1,3,3,3,2,2,3,2,1,8,11,10,8,11,8,10,11,15,12,14,8,13,12,15,13,15,10,13,10,15,17,6,7,11,15,18,18,14,13,13,9,12,15,13,20,18,12,16,10,13,6,19,6,11,17,14,18,15,18,5,Simone Padoin,Â£720Th. ,Serie A
19-06-17,18.3.4.28,Bacary Sagna,8430030,769,14-Feb-83,34,65,0,12,0,5200,6650,6650,160,133,232186002,176,72,D/WB RC,1,1,3,1,3,3,1,1,1,1,1,11,13,11,5,13,7,15,8,8,14,12,5,15,14,12,14,14,15,13,13,14,15,10,8,13,14,15,16,10,11,13,12,10,16,12,20,14,15,15,8,14,9,10,16,16,16,14,14,14,17,9,20,18,1,1,20,14,15,D/WB RC,113,1,1,1,1,1,1,15,14,20,1,1,1,1,11,18,1081376.0,0,0,0,0,0,1,0,0,0,0,0,0,0,0,0,1,0,0,0,0,1,0,0,0,0,0,0,0,0,0,0,0,0,0,0,0,0,0,0,0,0,0,0,0,0,0,0,0,Bacary Sagna,Â£720Th. ,37.0,176.0,Defender - Right-Back,right,Without Club,25.0,0.0,2.0,1848.0,22.0,2.0,0.0,1764.0,31.0,1.0,4.0,2660.0,nan,nan,nan,nan,nan,nan,nan,nan,Serie A,15-07-16,17.3.2.23,Bacary Sagna,8430030,769,14-Feb-83,33,64,0,12,0,6750,7000,7500,160,144,3297403,181,73,D/WB RC,1,2,2,3,1,3,1,1,2,1,3,11,13,11,5,13,7,16,8,8,14,12,5,15,14,12,14,14,15,13,13,15,15,10,8,13,14,15,16,12,12,13,12,10,18,13,20,16,15,15,8,14,9,10,16,16,16,14,14,14,17,9,Bacary Sagna,Â£3.60m ,Premier League
19-06-17,18.3.4.28,Bryan Dabo,85059761,769,18-Feb-92,25,0,0,1,0,4250,6350,6350,130,127,7470075,187,79,D/DM/M RC,3,2,1,3,3,1,3,2,2,1,1,5,13,12,8,12,10,12,8,6,13,12,10,14,12,13,13,14,11,9,10,11,13,12,8,9,11,13,15,15,14,14,11,5,16,14,20,15,14,10,13,11,7,13,6,15,10,10,12,11,10,8,19,15,20,1,20,1,15,D/DM/M RC,433,1,1,1,1,1,1,12,1,19,18,15,1,20,1,15,0.0,0,0,0,0,0,0,0,0,0,0,0,0,0,0,0,0,0,0,0,0,0,0,0,0,0,0,0,0,0,0,0,0,0,0,0,0,0,0,0,0,0,0,0,0,0,0,0,0,Bryan Dabo,Â£4.05m ,28.0,187.0,Midfielder - Central Midfield,right,Benevento Calcio,22.0,0.0,1.0,1099.0,27.0,3.0,1.0,1965.0,26.0,1.0,2.0,918.0,17.0,1.0,4.0,1209.0,5.0,0.0,0.0,296.0,Serie A,15-07-16,17.3.2.23,Bryan Dabo,85059761,769,18-Feb-92,24,0,0,1,0,4003,6250,6350,135,129,9367761,187,79,D/DM/M RC,1,2,3,1,3,1,2,1,2,3,2,5,13,13,8,12,10,12,8,6,13,12,10,14,12,13,13,14,11,10,10,11,13,12,8,9,12,13,15,15,14,14,11,5,16,14,20,15,14,11,13,11,7,13,3,15,11,10,11,11,12,9,Bryan Dabo,Â£3.15m ,Ligue 1
19-06-17,18.3.4.28,RÃ´mulo,8833765,1651,22-May-87,30,0,0,0,0,5250,6450,6550,140,131,232186002,178,72,WB/M RC,3,4,1,1,3,3,3,2,2,1,1,8,13,13,11,13,7,12,15,6,10,13,12,14,13,16,12,13,12,15,12,14,12,14,13,14,10,13,14,12,13,12,10,9,9,13,20,15,12,15,12,15,16,17,14,15,11,10,13,8,9,11,15,16,20,13,17,12,20,WB/M RC,423,1,1,1,1,1,13,1,12,15,1,20,5,17,8,16,0.0,0,0,0,0,0,0,0,0,0,0,0,0,0,0,0,0,0,0,0,0,0,0,0,0,0,0,0,0,0,0,0,0,0,0,0,0,0,0,0,0,0,0,0,0,0,0,0,0,RÃ´mulo,Â£2.70m ,33.0,178.0,Midfielder - Central Midfield,right,Without Club,41.0,4.0,10.0,3565.0,41.0,3.0,6.0,3562.0,32.0,1.0,3.0,2560.0,24.0,1.0,3.0,1755.0,nan,nan,nan,nan,Serie A
19-06-17,18.3.4.28,Emil Krafth,93031462,797,02-Aug-94,22,9,0,16,1,3500,6250,6150,141,123,8817457,185,79,D/WB R,1,1,4,2,1,3,2,3,2,1,2,10,14,10,4,12,9,10,10,9,13,12,8,13,12,11,13,11,12,13,12,13,13,8,6,14,13,13,13,13,13,12,12,8,12,14,20,14,12,13,6,11,10,9,10,12,12,13,13,14,15,2,20,16,10,5,20,12,2,D/WB R,112,1,1,1,1,1,5,2,12,20,1,1,1,10,10,16,1099510000000.0,0,0,0,0,0,0,0,0,0,0,0,0,0,0,0,0,0,0,0,0,0,0,0,0,0,0,0,0,0,0,0,0,0,0,0,0,0,0,0,0,1,0,0,0,0,0,0,0,Emil Krafth,Â£1.35m ,26.0,184.0,Defender - Right-Back,right,Newcastle United,29.0,1.0,1.0,1951.0,12.0,0.0,0.0,946.0,36.0,1.0,1.0,3062.0,20.0,0.0,1.0,1248.0,5.0,0.0,0.0,432.0,Serie A,15-07-16,17.3.2.23,Emil Krafth,93031462,797,02-Aug-94,21,4,0,16,1,2000,6150,6000,140,121,3455331,181,79,D/WB R,3,2,3,2,3,3,1,1,1,2,1,8,14,9,4,12,9,9,9,9,13,12,8,13,12,11,13,11,12,13,12,13,13,8,6,14,13,13,13,13,11,11,9,7,12,14,20,14,11,13,6,11,10,7,10,12,12,13,13,14,15,2,Emil Krafth,Â£1.62m ,Serie A
19-06-17,18.3.4.28,Bartosz Bereszynski,96011201,787,12-Jul-92,24,3,0,4,0,4000,5950,6200,126,124,6981488,183,77,D/WB R,2,3,3,1,2,1,3,3,4,3,3,8,12,13,8,12,8,12,7,12,12,13,12,13,12,12,10,14,11,12,10,10,13,11,5,14,12,13,14,14,12,11,10,9,10,15,20,15,11,13,7,12,10,12,14,16,5,14,15,12,9,10,20,18,15,1,20,1,1,D/WB R,112,1,1,1,1,1,1,1,1,20,1,1,1,15,1,18,2.0,0,1,0,0,0,0,0,0,0,0,0,0,0,0,0,0,0,0,0,0,0,0,0,0,0,0,0,0,0,0,0,0,0,0,0,0,0,0,0,0,0,0,0,0,0,0,0,0,Bartosz Bereszynski,Â£10.80m ,28.0,183.0,Defender - Right-Back,right,UC Sampdoria,35.0,0.0,4.0,2855.0,31.0,0.0,1.0,2483.0,28.0,0.0,2.0,2270.0,29.0,0.0,1.0,2495.0,5.0,0.0,0.0,450.0,Serie A,15-07-16,17.3.2.23,Bartosz Bereszynski,96011201,787,12-Jul-92,24,2,0,4,0,4499,5999,6000,125,109,1701593,182,72,D R,3,3,3,1,3,3,2,2,1,2,3,7,11,13,7,11,8,12,6,8,12,11,12,13,11,9,9,14,11,10,10,10,13,11,5,13,12,13,14,14,11,12,10,6,10,15,20,15,11,13,7,12,10,12,14,16,5,14,15,12,9,10,Bartosz Bereszynski,Â£1.80m ,Serie A
19-06-17,18.3.4.28,Cristian Ansaldi,964420,1649,20-Sep-86,30,5,1,0,0,5300,6600,6850,146,137,232186002,181,76,D/WB RL,3,2,1,2,3,1,4,3,1,3,2,13,12,13,6,13,12,10,10,13,13,12,10,15,13,15,12,12,12,13,11,12,18,11,9,11,12,12,14,13,14,16,11,20,14,13,15,14,13,13,12,10,11,14,17,13,13,12,16,13,12,8,20,17,14,1,16,20,12,D/WB RL,115,1,1,1,1,1,1,12,20,16,1,1,14,8,17,10,141837000000000.0,0,0,0,0,0,0,0,0,0,0,0,0,0,0,0,0,0,0,0,0,0,0,0,0,0,0,0,0,0,0,0,0,0,0,0,0,0,0,0,0,1,0,0,0,0,0,0,1,Cristian Ansaldi,Â£4.50m ,34.0,181.0,Defender - Left-Back,both,Torino FC,26.0,0.0,2.0,1814.0,25.0,1.0,3.0,1869.0,25.0,3.0,2.0,1906.0,32.0,5.0,7.0,2176.0,3.0,0.0,0.0,93.0,Serie A,15-07-16,17.3.2.23,Cristian Ansaldi,964420,1649,20-Sep-86,29,5,1,0,0,5750,7000,7050,150,141,9724579,181,76,D/WB RL,4,3,2,3,3,1,3,3,3,3,1,13,15,12,6,13,12,8,13,10,13,14,14,14,14,13,12,12,13,14,12,12,18,12,9,10,12,12,14,13,15,12,11,20,14,13,11,15,14,13,8,10,13,14,17,13,16,13,16,15,12,8,Cristian Ansaldi,Â£4.95m ,Serie A
19-06-17,18.3.4.28,Silvan Widmer,98010781,798,05-Mar-93,24,9,0,17,1,4500,6850,6850,147,137,18498494,183,81,D/WB/M R,2,3,2,3,3,4,3,3,1,1,2,7,13,13,8,13,6,12,11,13,12,12,7,13,14,13,13,12,11,11,11,11,14,11,10,11,12,14,13,16,14,14,11,8,14,16,20,15,12,14,12,12,5,13,14,13,15,11,15,12,12,8,20,19,18,1,20,9,7,D/WB/M R,122,1,1,1,1,1,1,7,9,20,1,1,8,18,9,19,134217728.0,0,0,0,0,0,0,0,0,0,0,0,0,0,0,0,0,0,0,0,0,0,0,0,0,0,0,0,1,0,0,0,0,0,0,0,0,0,0,0,0,0,0,0,0,0,0,0,0,Silvan Widmer,Â£7.65m ,27.0,182.0,Defender - Right-Back,right,FC Basel 1893,29.0,0.0,4.0,2581.0,26.0,3.0,2.0,1732.0,41.0,2.0,7.0,3588.0,50.0,6.0,8.0,4485.0,6.0,1.0,0.0,540.0,Serie A,15-07-16,17.3.2.23,Silvan Widmer,98010781,798,05-Mar-93,23,7,0,17,1,4400,6750,6750,154,135,11178195,183,81,D/WB/M R,3,2,3,1,2,3,2,3,1,2,3,7,13,13,8,13,7,12,11,13,10,12,7,12,13,13,12,12,11,11,11,11,14,11,10,11,12,12,13,16,14,14,12,7,14,16,20,15,12,12,12,10,5,13,14,13,15,11,15,12,12,8,Silvan Widmer,Â£8.10m ,Serie A
19-06-17,18.3.4.28,Berat Djimsiti,98015432,752,19-Feb-93,24,13,1,5,0,3500,5950,5900,131,118,360739,190,83,D RLC,3,2,3,1,3,1,1,2,3,3,3,5,7,7,6,11,4,14,8,10,14,10,4,14,11,9,13,15,9,11,8,10,12,6,10,8,14,13,11,11,10,17,14,12,12,12,20,13,14,9,5,10,5,8,12,13,14,7,13,12,14,5,20,13,1,1,16,15,20,D RLC,106,1,1,1,1,1,1,20,15,16,1,1,1,1,13,13,0.0,0,0,0,0,0,0,0,0,0,0,0,0,0,0,0,0,0,0,0,0,0,0,0,0,0,0,0,0,0,0,0,0,0,0,0,0,0,0,0,0,0,0,0,0,0,0,0,0,Berat Djimsiti,Â£900Th. ,27.0,190.0,Defender - Centre-Back,right,Atalanta BC,35.0,0.0,0.0,3124.0,30.0,0.0,1.0,2700.0,29.0,1.0,1.0,2283.0,41.0,2.0,1.0,3388.0,5.0,0.0,0.0,359.0,Serie A
19-06-17,18.3.4.28,Zainadine JÃºnior,13104485,35,24-Jun-88,28,44,0,0,0,4000,6550,6550,132,131,3590529,178,75,D RC,2,2,3,4,1,1,2,3,1,3,3,6,9,10,8,11,5,15,7,15,13,11,8,15,12,14,15,14,11,13,8,13,17,11,12,9,14,14,15,14,14,14,12,6,16,13,20,14,13,14,11,12,8,14,16,14,12,13,16,16,12,7,20,1,1,1,19,1,20,D RC,103,1,1,1,1,1,1,20,1,19,1,1,1,1,1,1,1.15405e+18,0,0,0,0,0,0,0,0,0,0,0,0,0,0,0,0,0,0,0,0,0,0,0,0,0,0,0,0,0,0,0,0,0,0,0,0,0,0,0,0,0,0,0,0,0,0,0,0,Zainadine JÃºnior,Â£1.35m ,32.0,180.0,Defender - Centre-Back,right,CS MarÃ­timo,15.0,1.0,0.0,1041.0,38.0,1.0,1.0,3437.0,33.0,1.0,3.0,2970.0,33.0,3.0,1.0,3000.0,5.0,1.0,0.0,444.0,Liga NOS,15-07-16,17.3.2.23,Zainadine JÃºnior,13104485,35,24-Jun-88,28,36,0,0,0,4000,6500,6250,142,132,14474121,178,75,D RC,2,1,2,2,2,4,1,1,3,3,2,6,9,10,8,11,5,15,7,15,13,11,11,15,12,14,15,14,11,14,8,13,17,11,12,9,14,14,15,14,14,15,12,7,15,13,20,14,13,14,11,12,8,14,16,14,12,13,16,16,12,8,Zainadine JÃºnior,Â£900Th. ,Liga NOS
19-06-17,18.3.4.28,Douglas,19068564,1651,06-Aug-90,26,0,0,8,0,5250,6000,6350,136,127,2713429,171,67,D/WB R,1,2,3,2,1,1,1,3,4,3,2,12,12,15,9,14,12,7,11,10,9,12,12,11,15,13,11,13,12,9,13,11,15,13,8,12,8,13,13,14,15,12,6,14,14,14,20,14,10,11,10,9,10,15,11,17,6,12,14,13,12,12,19,20,11,11,20,12,5,D/WB R,222,1,1,1,5,5,11,1,12,19,1,5,5,11,12,20,2.8823e+17,0,1,0,0,0,1,0,0,0,0,0,0,0,0,0,0,0,0,0,0,0,0,0,0,0,0,0,0,0,0,0,0,0,0,0,0,0,0,0,0,0,0,0,0,0,0,0,0,Douglas,Â£360Th. ,32.0,192.0,Defender - Centre-Back,right,WÃ¼rzburger Kickers,8.0,0.0,0.0,674.0,nan,nan,nan,nan,nan,nan,nan,nan,0.0,0.0,0.0,0.0,4.0,0.0,0.0,275.0,Liga NOS,15-07-16,17.3.2.23,Douglas,37007329,784,12-Jan-88,28,0,0,0,0,5747,6997,6250,145,127,737481,192,80,D C,3,2,2,1,2,2,1,2,3,2,2,6,7,8,8,11,10,16,7,12,15,10,8,14,12,15,14,15,13,11,12,13,12,9,10,12,12,13,12,10,9,14,16,11,17,10,20,12,14,12,13,16,5,4,16,10,14,11,13,11,13,10,Douglas,Â£1.35m ,LaLiga
19-06-17,18.3.4.28,LuÃ­s Felipe,19084261,1651,08-Apr-91,26,0,0,0,0,2500,5300,5300,112,106,95904,178,73,D/WB R,1,3,2,3,2,4,1,3,2,3,1,11,13,12,7,12,12,7,12,13,9,12,13,9,12,13,12,12,11,11,11,11,11,13,6,13,10,12,13,14,13,10,8,5,12,14,20,11,9,13,11,12,6,16,12,11,8,14,10,9,13,13,20,19,12,10,20,12,11,D/WB R,112,1,1,1,8,3,10,1,12,20,7,11,6,12,11,19,2286980000000000.0,0,0,0,0,0,1,0,0,0,1,0,0,0,0,0,0,0,0,0,0,0,0,0,0,0,0,0,0,0,0,0,0,0,0,0,0,0,0,0,0,0,0,0,0,0,1,0,0,LuÃ­s Felipe,Â£180Th. ,29.0,178.0,Defender - Right-Back,right,AssociaÃ§Ã£o AtlÃ©tica Portuguesa (SP),2.0,0.0,0.0,81.0,3.0,0.0,1.0,69.0,nan,nan,nan,nan,nan,nan,nan,nan,nan,nan,nan,nan,Liga NOS,15-07-16,17.3.2.23,LuÃ­s Felipe,19084261,1651,08-Apr-91,25,0,0,0,0,2500,5850,5750,122,117,417724,178,73,D/WB R,3,2,3,2,4,3,4,1,2,2,2,10,12,12,9,11,11,6,11,12,8,11,12,8,12,13,11,12,10,11,10,11,14,13,6,12,9,11,12,14,14,7,7,16,16,14,20,11,8,13,11,12,6,16,12,14,8,14,11,9,13,13,LuÃ­s Felipe,Â£270Th. ,Liga NOS
19-06-17,18.3.4.28,Bebeto,19088884,1651,01-Jan-90,27,0,0,0,0,2014,5035,5750,120,115,541295,174,70,D/WB R,1,3,2,2,1,2,2,1,2,2,2,10,11,13,8,11,13,9,8,10,10,10,11,12,12,12,12,12,10,12,8,9,13,10,9,13,11,13,13,14,14,12,7,10,13,14,20,14,9,10,8,11,5,9,12,12,9,10,14,12,13,4,19,20,11,7,20,1,1,D/WB R,222,1,1,1,1,1,7,1,1,19,1,1,1,11,1,20,34.0,0,1,0,0,0,1,0,0,0,0,0,0,0,0,0,0,0,0,0,0,0,0,0,0,0,0,0,0,0,0,0,0,0,0,0,0,0,0,0,0,0,0,0,0,0,0,0,0,Bebeto,Â£1.80m ,30.0,174.0,Defender - Right-Back,right,CD Tondela,nan,nan,nan,nan,41.0,2.0,3.0,3681.0,26.0,0.0,1.0,2192.0,19.0,0.0,1.0,1574.0,4.0,0.0,0.0,264.0,Liga NOS
19-06-17,18.3.4.28,Patrick,19117305,1651,22-Jan-91,26,0,0,0,0,3300,5500,5750,118,115,208308,178,73,D/WB RL,2,2,1,3,1,1,3,1,3,3,3,10,12,9,8,10,8,8,10,12,13,11,10,14,11,10,12,14,9,14,8,10,15,7,8,10,11,14,15,12,11,12,7,12,13,12,20,15,10,12,9,12,9,15,13,12,13,10,14,7,11,9,20,19,13,1,20,20,1,D/WB RL,115,1,1,1,1,1,1,1,20,20,1,1,1,13,11,19,0.0,0,0,0,0,0,0,0,0,0,0,0,0,0,0,0,0,0,0,0,0,0,0,0,0,0,0,0,0,0,0,0,0,0,0,0,0,0,0,0,0,0,0,0,0,0,0,0,0,Patrick,Â£900Th. ,29.0,173.0,Defender - Right-Back,right,Coritiba Foot Ball Club,35.0,0.0,8.0,3006.0,19.0,2.0,3.0,1323.0,34.0,0.0,4.0,2815.0,20.0,0.0,1.0,1737.0,nan,nan,nan,nan,Liga NOS,15-07-16,17.3.2.23,Patrick,19117305,1651,22-Jan-91,25,0,0,0,0,3300,5500,5650,120,113,185801,178,73,D/WB RL,3,4,1,1,2,4,1,1,2,2,3,10,11,9,8,10,8,8,10,12,13,10,10,14,10,10,12,14,9,14,8,10,15,7,8,10,11,14,15,12,11,12,7,11,13,12,20,15,10,12,9,12,9,15,13,12,13,10,14,7,11,10,Patrick,Â£1.35m ,Liga NOS
19-06-17,18.3.4.28,Lionn,2108018,1651,29-Jan-89,28,0,0,0,0,3042,5071,5950,126,119,225705,184,77,D R,2,2,3,3,2,1,2,3,3,2,3,11,12,10,8,12,11,10,12,14,10,10,12,12,13,14,12,14,11,11,9,11,16,12,9,13,11,14,14,13,13,13,12,8,11,14,20,15,12,12,10,10,8,7,14,14,12,11,13,10,5,10,20,12,1,1,20,1,1,D R,102,1,1,1,1,1,1,1,1,20,1,1,1,1,1,12,32802.0,0,1,0,0,0,1,0,0,0,0,0,0,0,0,0,1,0,0,0,0,0,0,0,0,0,0,0,0,0,0,0,0,0,0,0,0,0,0,0,0,0,0,0,0,0,0,0,0,Lionn,Â£1.35m ,31.0,184.0,Defender - Right-Back,right,Without Club,15.0,0.0,1.0,961.0,33.0,1.0,2.0,2773.0,14.0,0.0,2.0,1156.0,13.0,0.0,0.0,1138.0,nan,nan,nan,nan,Liga NOS,15-07-16,17.3.2.23,Lionn,2108018,1651,29-Jan-89,27,0,0,0,0,2431,4053,5850,126,117,203653,184,77,D R,1,3,4,3,3,2,1,3,1,3,1,11,12,10,8,12,11,10,12,14,10,10,12,12,13,14,11,13,11,11,9,11,16,12,9,13,11,13,13,13,13,13,12,8,11,14,20,15,12,12,10,10,8,7,14,14,12,11,13,10,5,6,Lionn,Â£675Th. ,Liga NOS
19-06-17,18.3.4.28,Vincent Sasso,34009250,769,16-Feb-91,26,0,0,2,0,3000,5250,5700,116,114,148368,190,82,D RC,1,1,2,1,4,1,3,3,3,1,1,4,9,8,5,10,6,14,8,7,12,10,6,13,10,14,14,14,12,12,10,13,16,6,8,8,12,14,13,10,9,16,15,8,13,10,20,14,15,12,10,14,5,15,13,13,15,9,13,15,15,8,20,1,1,1,15,5,20,D RC,103,1,1,1,1,1,1,20,5,15,1,1,1,1,1,1,274878000000.0,0,0,0,0,0,0,0,0,0,0,0,0,0,0,0,0,0,0,0,0,0,0,0,0,0,0,0,0,0,0,0,0,0,0,0,0,0,0,1,0,0,0,0,0,0,0,0,0,Vincent Sasso,Â£900Th. ,29.0,190.0,Defender - Centre-Back,right,Servette FC,14.0,2.0,0.0,1110.0,19.0,1.0,1.0,1330.0,34.0,3.0,1.0,2980.0,33.0,1.0,0.0,2891.0,6.0,0.0,0.0,540.0,Liga NOS
19-06-17,18.3.4.28,Cristiano Piccini,43052618,776,26-Sep-92,24,0,0,1,0,4250,6250,6800,140,136,14807331,189,79,D/WB R,2,3,2,3,2,2,2,3,3,4,1,8,12,12,9,13,6,12,10,12,11,13,10,12,12,10,14,13,13,10,11,12,14,12,9,12,12,15,15,15,15,14,13,12,13,14,20,14,13,14,8,11,15,13,13,13,9,9,10,10,11,14,20,19,14,7,20,1,1,D/WB R,112,1,1,1,1,1,7,1,1,20,1,1,1,14,1,19,34359738368.0,0,0,0,0,0,0,0,0,0,0,0,0,0,0,0,0,0,0,0,0,0,0,0,0,0,0,0,0,0,0,0,0,0,0,0,1,0,0,0,0,0,0,0,0,0,0,0,0,Cristiano Piccini,Â£6.75m ,28.0,189.0,Defender - Right-Back,right,Atalanta BC,25.0,3.0,3.0,1922.0,40.0,0.0,3.0,3462.0,38.0,1.0,0.0,2891.0,2.0,0.0,0.0,75.0,nan,nan,nan,nan,Liga NOS,15-07-16,17.3.2.23,Cristiano Piccini,43052618,776,26-Sep-92,23,0,0,1,0,4250,6250,6500,145,131,6227520,183,77,D/WB R,3,3,1,1,3,3,3,3,4,1,1,8,13,13,9,13,6,12,10,12,11,13,10,12,13,10,14,10,13,12,11,12,11,12,10,12,13,13,13,14,14,14,13,9,13,14,20,14,13,14,8,11,15,13,10,16,10,10,10,12,8,14,Cristiano Piccini,Â£2.70m ,LaLiga
19-06-17,18.3.4.28,Bruno Pereirinha,55001512,788,02-Mar-88,29,0,0,19,0,4750,5800,5800,133,116,51356,174,68,D/WB/M RL,3,2,1,3,3,2,1,3,1,1,2,12,12,12,9,13,8,7,10,10,10,12,10,12,13,10,12,13,13,11,11,12,13,13,9,13,11,13,12,12,13,10,8,9,12,12,20,11,8,12,8,12,14,17,14,13,15,13,18,17,17,4,20,19,18,10,20,18,1,D/WB/M RL,125,1,1,1,1,7,10,1,18,20,1,1,16,18,17,19,18.0,0,1,0,0,1,0,0,0,0,0,0,0,0,0,0,0,0,0,0,0,0,0,0,0,0,0,0,0,0,0,0,0,0,0,0,0,0,0,0,0,0,0,0,0,0,0,0,0,Bruno Pereirinha,Â£360Th. ,32.0,174.0,Forward - Right Winger,right,Without Club,nan,nan,nan,nan,18.0,0.0,0.0,960.0,18.0,0.0,0.0,1167.0,nan,nan,nan,nan,nan,nan,nan,nan,Liga NOS
19-06-17,18.3.4.28,Mano,55003642,788,09-Apr-87,30,0,0,2,0,3250,5750,5500,115,115,232186002,170,64,D/WB R,1,3,3,3,2,1,1,3,3,1,1,11,12,11,9,11,8,13,8,11,12,11,10,12,12,14,13,13,8,10,11,11,13,7,10,13,9,13,13,14,14,11,6,10,14,15,20,14,7,10,12,10,13,14,8,12,15,12,14,12,13,8,20,17,1,1,20,10,1,D/WB R,112,1,1,1,1,1,1,1,10,20,1,1,1,1,1,17,0.0,0,0,0,0,0,0,0,0,0,0,0,0,0,0,0,0,0,0,0,0,0,0,0,0,0,0,0,0,0,0,0,0,0,0,0,0,0,0,0,0,0,0,0,0,0,0,0,0,Mano,Â£180Th. ,33.0,170.0,Defender - Right-Back,right,VitÃ³ria SetÃºbal FC,23.0,0.0,2.0,1845.0,16.0,0.0,0.0,1349.0,34.0,0.0,1.0,2828.0,12.0,0.0,1.0,991.0,nan,nan,nan,nan,Liga NOS,15-07-16,17.3.2.23,Mano,55003642,788,09-Apr-87,29,0,0,2,0,3250,5750,5500,115,115,50617,170,64,D/WB/DM RL,2,1,3,3,3,2,3,2,1,3,1,10,12,10,9,10,8,9,8,11,10,10,10,12,12,14,12,13,8,10,11,9,13,7,10,13,9,13,13,15,13,11,6,9,14,15,20,14,7,10,12,10,7,14,6,12,15,12,14,12,11,10,Mano,Â£540Th. ,Liga NOS
19-06-17,18.3.4.28,Pedro QueirÃ³s,55011074,788,08-Aug-84,32,0,0,0,0,4000,5400,5400,115,108,30701,182,75,D R,2,3,3,3,3,4,1,4,1,2,1,10,11,12,7,10,9,9,10,15,12,11,10,13,10,11,13,13,12,14,11,14,13,8,13,11,14,12,13,11,11,12,10,5,12,11,20,11,12,13,10,11,8,11,13,10,13,11,12,13,13,6,20,10,1,1,20,10,1,D R,102,1,1,1,1,1,1,1,10,20,1,1,1,1,1,10,0.0,0,0,0,0,0,0,0,0,0,0,0,0,0,0,0,0,0,0,0,0,0,0,0,0,0,0,0,0,0,0,0,0,0,0,0,0,0,0,0,0,0,0,0,0,0,0,0,0,Pedro QueirÃ³s,Â£90Th. ,36.0,180.0,Defender - Right-Back,right,FC Tirsense,17.0,0.0,0.0,1483.0,3.0,0.0,0.0,114.0,21.0,1.0,0.0,1348.0,nan,nan,nan,nan,1.0,0.0,0.0,90.0,Liga NOS,15-07-16,17.3.2.23,Pedro QueirÃ³s,55011074,788,08-Aug-84,31,0,0,0,0,3850,5500,5500,115,113,14832,182,75,D R,2,1,3,2,2,1,3,1,2,1,3,10,11,12,7,10,9,9,10,15,14,11,10,14,10,11,14,13,12,14,11,14,13,8,13,11,15,12,13,11,11,12,10,5,12,11,20,12,12,13,10,11,8,11,13,10,13,11,12,13,13,6,Pedro QueirÃ³s,Â£180Th. ,Liga NOS
19-06-17,18.3.4.28,AndrÃ© Almeida,55011100,788,10-Sep-90,26,8,0,17,0,4500,6800,6800,137,135,7318787,186,80,D/DM/M RLC,3,2,4,2,2,4,3,1,1,3,2,8,11,11,8,11,8,10,11,12,13,12,7,15,11,15,14,15,12,15,11,12,14,6,12,12,14,15,15,13,12,13,13,8,15,13,20,16,12,15,12,13,8,17,12,14,14,12,16,14,16,6,20,12,16,5,20,17,16,D/DM/M RLC,126,1,1,1,5,1,1,1,17,20,18,16,1,10,1,12,0.0,0,0,0,0,0,0,0,0,0,0,0,0,0,0,0,0,0,0,0,0,0,0,0,0,0,0,0,0,0,0,0,0,0,0,0,0,0,0,0,0,0,0,0,0,0,0,0,0,AndrÃ© Almeida,Â£6.75m ,30.0,186.0,Defender - Right-Back,right,SL Benfica,25.0,2.0,3.0,1851.0,40.0,2.0,8.0,3354.0,53.0,2.0,12.0,4727.0,27.0,4.0,5.0,2366.0,5.0,0.0,2.0,374.0,Liga NOS,15-07-16,17.3.2.23,AndrÃ© Almeida,55011100,788,10-Sep-90,25,8,0,17,0,4500,6850,6850,140,137,7074175,186,80,D/DM/M RLC,2,2,3,2,1,1,1,1,1,1,1,8,12,11,8,11,8,10,11,12,13,12,7,14,11,15,14,15,12,15,11,12,14,6,12,12,15,15,15,13,12,14,14,8,15,13,20,16,13,15,12,13,8,17,12,15,14,12,16,14,14,5,AndrÃ© Almeida,Â£4.50m ,Liga NOS
19-06-17,18.3.4.28,JoÄo AurÃ©lio,55011464,788,17-Aug-88,28,0,0,11,1,4400,6100,6100,132,122,633459,182,74,D/WB/M RC,2,1,1,3,3,2,2,3,3,1,2,11,11,12,9,12,9,8,8,12,9,12,11,14,13,12,12,13,8,13,10,10,14,13,14,15,11,13,14,14,12,13,11,7,14,14,20,14,12,13,7,12,9,12,12,11,13,13,14,12,12,6,20,16,18,15,20,5,15,D/WB/M RC,123,1,1,1,12,5,15,1,1,20,1,15,1,18,1,16,32.0,0,0,0,0,0,1,0,0,0,0,0,0,0,0,0,0,0,0,0,0,0,0,0,0,0,0,0,0,0,0,0,0,0,0,0,0,0,0,0,0,0,0,0,0,0,0,0,0,JoÃ£o AurÃ©lio,Â£1.13m ,32.0,182.0,Defender - Right-Back,right,Pafos FC,31.0,0.0,5.0,1923.0,32.0,0.0,3.0,2429.0,21.0,2.0,5.0,1860.0,30.0,2.0,3.0,2515.0,7.0,0.0,0.0,491.0,Liga NOS,15-07-16,17.3.2.23,JoÄo AurÃ©lio,55011464,788,17-Aug-88,27,0,0,11,1,4400,6300,6300,133,126,1442987,185,75,D/WB/M RC,3,3,1,3,3,4,1,3,1,1,3,11,11,13,9,12,10,10,8,12,9,12,11,15,14,12,12,13,8,13,10,10,14,13,9,15,10,13,13,14,12,13,12,11,14,14,20,15,12,13,7,12,9,12,13,12,12,13,14,12,12,5,JoÃ£o AurÃ©lio,Â£1.58m ,Liga NOS
19-06-17,18.3.4.28,SÃ­lvio,55011718,788,28-Sep-87,29,8,0,0,0,5500,5750,5750,135,115,404674,178,70,D/WB RL,2,3,3,3,3,3,1,2,2,1,1,9,13,12,8,13,9,9,11,12,12,11,11,13,13,12,14,12,13,13,12,12,14,12,9,12,12,13,12,11,12,11,9,12,9,11,20,10,10,13,11,12,18,15,13,11,10,14,12,14,15,8,20,19,1,1,20,19,1,D/WB RL,115,1,1,1,1,1,1,1,19,20,1,1,1,1,16,19,32.0,0,0,0,0,0,1,0,0,0,0,0,0,0,0,0,0,0,0,0,0,0,0,0,0,0,0,0,0,0,0,0,0,0,0,0,0,0,0,0,0,0,0,0,0,0,0,0,0,nan,nan,nan,nan,nan,nan,nan,nan,nan,nan,nan,nan,nan,nan,nan,nan,nan,nan,nan,nan,nan,nan,nan,nan,nan,nan,nan,nan,
19-06-17,18.3.4.28,Paulinho,55013000,788,13-Jul-91,25,0,0,0,0,3500,6100,6100,138,122,404336,176,69,D R,1,2,1,2,2,1,1,1,2,4,3,9,12,12,6,10,8,10,8,12,12,11,8,13,13,12,12,13,12,12,11,12,15,10,10,14,12,15,15,14,13,13,8,8,14,15,20,15,10,15,9,13,2,11,13,14,11,14,14,10,12,6,20,15,1,1,20,1,1,D R,102,1,1,1,1,1,1,1,1,20,1,1,1,1,1,15,34.0,0,1,0,0,0,1,0,0,0,0,0,0,0,0,0,0,0,0,0,0,0,0,0,0,0,0,0,0,0,0,0,0,0,0,0,0,0,0,0,0,0,0,0,0,0,0,0,0,Paulinho,Â£36.00m ,32.0,183.0,Midfielder - Central Midfield,right,Guangzhou Evergrande Taobao,29.0,12.0,5.0,2610.0,68.0,22.0,10.0,4263.0,42.0,22.0,8.0,3632.0,16.0,10.0,4.0,1406.0,nan,nan,nan,nan,LaLiga,15-07-16,17.3.2.23,Paulinho,55013000,788,13-Jul-91,25,0,0,0,0,3500,6100,6100,138,122,801471,176,69,D R,3,2,1,2,1,3,2,1,3,1,4,9,12,12,6,10,8,10,8,12,12,11,8,13,13,12,12,13,12,11,11,12,15,10,10,14,13,15,15,14,13,13,8,8,14,15,20,15,10,15,9,13,2,11,13,14,11,14,14,10,12,4,Paulinho, ,Premier League
19-06-17,18.3.4.28,Diogo Figueiras,55013024,788,01-Jul-91,25,0,0,0,0,3000,6250,6250,135,130,1407963,171,62,D/WB/M R,2,2,3,3,4,2,2,3,3,1,3,9,13,12,8,13,8,5,8,11,11,12,9,12,12,15,13,14,9,9,11,10,14,9,6,13,10,13,15,16,14,12,6,10,14,15,20,16,9,11,13,10,5,13,12,13,9,10,12,9,6,12,20,19,16,7,20,14,1,D/WB/M R,122,1,1,1,1,1,7,1,14,20,1,1,1,16,10,19,131106.0,0,1,0,0,0,1,0,0,0,0,0,0,0,0,0,0,0,1,0,0,0,0,0,0,0,0,0,0,0,0,0,0,0,0,0,0,0,0,0,0,0,0,0,0,0,0,0,0,Diogo Figueiras,Â£1.58m ,29.0,169.0,Defender - Right-Back,right,SC Braga,43.0,3.0,8.0,3751.0,28.0,1.0,4.0,2219.0,4.0,0.0,1.0,270.0,23.0,0.0,2.0,1778.0,nan,nan,nan,nan,Liga NOS
19-06-17,18.3.4.28,Jean-Sony,55017618,375,23-Jan-86,31,61,8,0,0,3750,5700,5700,122,114,232186002,175,67,D/WB R,3,1,1,2,3,3,1,4,1,1,1,8,13,11,7,9,11,9,7,14,12,10,9,12,12,13,13,11,12,13,10,12,15,12,8,13,12,13,13,14,13,11,10,6,14,14,20,12,13,12,8,11,10,14,17,14,11,13,15,14,10,6,20,17,10,10,20,1,1,D/WB R,112,1,1,1,1,1,10,1,1,20,1,1,1,10,1,17,2251800000000000.0,0,0,0,0,0,1,0,0,0,0,0,1,0,0,0,0,0,0,0,0,0,0,0,0,0,0,0,0,0,0,0,0,0,0,0,0,0,0,0,0,0,0,0,0,0,0,0,0,nan,nan,nan,nan,nan,nan,nan,nan,nan,nan,nan,nan,nan,nan,nan,nan,nan,nan,nan,nan,nan,nan,nan,nan,nan,nan,nan,nan,
19-06-17,18.3.4.28,Edu Machado,55022047,788,26-Apr-90,27,0,0,5,0,3250,5850,5850,122,117,54888,175,70,D/AM R,2,3,1,2,2,1,1,2,1,1,4,7,12,12,8,11,5,5,8,12,10,12,6,11,12,10,11,11,10,10,9,11,13,12,8,13,11,12,13,15,13,11,8,8,10,15,20,13,10,12,11,10,4,14,9,10,14,14,11,12,11,5,20,12,13,17,20,14,1,D/AM R,112,1,1,1,1,14,17,1,1,20,1,1,5,13,1,12,0.0,0,0,0,0,0,0,0,0,0,0,0,0,0,0,0,0,0,0,0,0,0,0,0,0,0,0,0,0,0,0,0,0,0,0,0,0,0,0,0,0,0,0,0,0,0,0,0,0,Edu Machado,Â£630Th. ,30.0,175.0,Defender - Right-Back,right,LeixÃµes SC,26.0,0.0,1.0,2226.0,6.0,0.0,0.0,513.0,21.0,0.0,3.0,1808.0,5.0,0.0,0.0,370.0,6.0,0.0,0.0,461.0,Liga NOS,15-07-16,17.3.2.23,Edu Machado,55022047,788,26-Apr-90,26,0,0,5,0,3300,5750,5750,122,115,128755,175,70,D/AM R,2,3,1,1,2,3,3,1,1,3,3,7,12,11,8,10,5,5,8,12,10,12,8,11,12,10,11,11,10,10,9,11,13,12,8,13,10,12,13,15,13,11,8,8,10,15,20,13,10,12,11,10,8,14,20,8,14,14,11,10,17,5,Edu Machado,Â£720Th. ,Liga NOS
19-06-17,18.3.4.28,Ricardo Esgaio,55022375,788,16-May-93,24,0,0,18,3,4250,6700,6700,142,134,6599210,173,65,D/WB/M/AM RL,2,3,3,1,3,3,3,3,1,2,2,12,16,12,11,12,10,7,11,11,10,13,14,12,13,13,11,12,13,12,12,13,16,12,7,15,12,13,14,13,13,12,9,6,13,13,20,14,8,14,7,12,6,18,13,16,13,12,17,12,12,9,20,17,18,19,20,15,13,D/WB/M/AM RL,135,1,1,1,13,13,19,1,15,20,13,13,14,18,12,17,1048672.0,0,0,0,0,0,1,1,0,0,0,0,0,0,0,0,0,0,0,0,0,1,0,0,0,0,0,0,0,0,0,0,0,0,0,0,0,0,0,0,0,0,0,0,0,0,0,0,0,Ricardo Esgaio,Â£3.60m ,27.0,173.0,Defender - Right-Back,right,SC Braga,25.0,1.0,3.0,1963.0,48.0,4.0,13.0,4161.0,34.0,0.0,5.0,2759.0,49.0,1.0,7.0,4234.0,6.0,1.0,1.0,540.0,Liga NOS,15-07-16,17.3.2.23,Ricardo Esgaio,55022375,788,16-May-93,23,0,0,18,3,4250,6550,6550,140,131,3085667,173,65,D/WB/M/AM RL,3,1,3,2,3,1,2,1,3,3,3,12,13,11,11,12,10,7,11,11,9,12,13,12,13,13,11,13,10,11,11,11,16,10,7,15,11,14,15,13,13,12,9,9,13,13,20,14,9,14,7,12,6,18,13,16,13,12,17,12,12,10,Ricardo Esgaio,Â£1.35m ,Liga NOS
19-06-17,18.3.4.28,David Bruno,55022402,788,14-Feb-92,25,0,0,4,0,3000,5700,5700,118,114,216015,176,72,D/WB RL,2,2,2,3,1,1,1,3,2,1,3,7,10,11,7,12,7,9,7,14,12,13,6,12,12,12,12,13,10,13,9,11,15,8,10,13,13,11,13,13,12,12,11,8,14,13,20,14,10,14,9,11,6,13,15,14,16,13,15,10,13,6,20,20,1,1,20,16,1,D/WB RL,115,1,1,1,1,1,1,1,16,20,1,1,1,1,1,20,2251800000000000.0,0,1,0,0,0,0,0,0,0,0,0,0,0,0,0,0,0,0,0,0,0,0,0,0,0,0,0,0,0,0,0,0,0,0,0,0,0,0,0,0,0,0,0,0,0,0,0,0,David Bruno,Â£675Th. ,28.0,175.0,Defender - Right-Back,right,Astra Giurgiu,22.0,0.0,1.0,1948.0,33.0,0.0,4.0,2752.0,27.0,1.0,3.0,2286.0,22.0,0.0,0.0,1490.0,6.0,0.0,1.0,494.0,Liga NOS,15-07-16,17.3.2.23,David Bruno,55022402,788,14-Feb-92,24,0,0,4,0,3000,5900,5900,115,110,65570,176,72,D/WB RL,1,1,3,2,1,3,2,3,2,3,1,7,10,11,7,12,7,9,9,14,12,13,7,12,12,12,12,11,10,13,9,10,15,8,10,13,13,11,13,13,12,10,11,8,14,13,20,13,10,14,9,11,6,10,18,14,16,10,15,10,13,7,David Bruno,Â£540Th. ,Liga NOS
19-06-17,18.3.4.28,AndrÃ© Geraldes,55027820,788,02-May-91,26,0,0,0,0,4750,6000,6000,126,120,71860,181,74,D RL,2,2,1,2,2,4,1,3,1,1,2,9,12,12,7,12,9,11,9,12,10,11,10,13,13,11,11,12,11,12,8,12,14,11,11,13,12,13,13,14,13,12,12,9,14,14,20,14,11,13,11,11,7,14,13,13,11,9,13,12,13,6,20,14,10,5,20,15,1,D RL,105,1,1,1,1,1,5,1,15,20,1,1,1,10,10,14,32.0,0,0,0,0,0,1,0,0,0,0,0,0,0,0,0,0,0,0,0,0,0,0,0,0,0,0,0,0,0,0,0,0,0,0,0,0,0,0,0,0,0,0,0,0,0,0,0,0,AndrÃ© Geraldes,Â£540Th. ,29.0,181.0,Defender - Right-Back,right,APOEL Nicosia,33.0,0.0,2.0,2970.0,25.0,0.0,0.0,1807.0,35.0,0.0,1.0,2885.0,35.0,0.0,3.0,2982.0,6.0,0.0,1.0,494.0,Liga NOS
19-06-17,18.3.4.28,JoÄo GÃ³is,55029619,788,05-May-90,27,0,0,0,0,3250,5650,5650,125,113,108079,174,68,D RL,3,2,3,3,1,3,2,2,3,3,3,9,11,12,6,10,4,9,10,18,11,11,7,14,12,12,13,14,11,13,9,11,14,12,7,13,12,13,14,13,12,13,7,9,13,13,20,12,11,12,2,11,11,6,11,14,9,12,13,12,11,5,20,15,12,1,20,15,1,D RL,105,1,1,1,1,1,1,1,15,20,1,1,1,12,10,15,1125900000000000.0,0,0,0,0,0,0,0,0,0,0,0,0,0,0,0,0,0,0,0,0,0,0,0,0,0,0,0,0,0,0,0,0,0,0,0,0,0,0,0,0,0,0,0,0,0,0,0,0,JoÃ£o GÃ³is,Â£360Th. ,30.0,174.0,Defender - Right-Back,right,Without Club,11.0,0.0,0.0,852.0,18.0,1.0,0.0,1490.0,26.0,0.0,2.0,2206.0,10.0,0.0,1.0,872.0,nan,nan,nan,nan,Liga NOS,15-07-16,17.3.2.23,JoÄo GÃ³is,55029619,788,05-May-90,26,0,0,0,0,3250,5800,5800,125,116,107143,174,68,D RL,1,3,3,3,2,4,1,2,3,2,2,9,12,13,6,10,6,9,10,18,11,11,7,14,12,12,13,14,12,13,9,12,14,12,7,13,12,14,14,13,12,13,7,10,12,13,20,12,11,12,2,11,11,6,11,14,9,12,13,12,14,4,JoÃ£o GÃ³is,Â£450Th. ,Liga NOS
19-06-17,18.3.4.28,Eliseu Nadjack,55033299,788,06-Feb-94,23,0,0,0,0,2750,5300,5300,120,106,103098,179,70,D R,2,1,3,3,3,1,2,2,3,4,1,5,10,12,8,10,6,5,7,11,8,10,8,11,12,12,12,13,8,7,9,8,12,15,5,14,9,13,14,16,15,10,8,11,13,16,20,15,8,10,12,8,5,8,13,7,8,7,14,14,10,6,20,13,7,10,20,1,1,D R,102,1,1,1,1,1,10,1,1,20,1,1,1,7,1,13,0.0,0,0,0,0,0,0,0,0,0,0,0,0,0,0,0,0,0,0,0,0,0,0,0,0,0,0,0,0,0,0,0,0,0,0,0,0,0,0,0,0,0,0,0,0,0,0,0,0,nan,nan,nan,nan,nan,nan,nan,nan,nan,nan,nan,nan,nan,nan,nan,nan,nan,nan,nan,nan,nan,nan,nan,nan,nan,nan,nan,nan,15-07-16,17.3.2.23,Eliseu Nadjack,55033299,788,06-Feb-94,22,0,0,0,0,2750,5300,5300,120,102,129819,179,70,D R,1,3,2,3,1,3,2,3,1,2,1,5,9,11,8,8,6,5,6,11,8,10,7,10,12,12,11,13,7,7,9,8,12,15,5,14,8,13,14,16,15,10,8,11,13,16,20,15,8,10,12,8,5,8,8,7,8,7,14,14,10,5,nan,nan,nan
19-06-17,18.3.4.28,Joel Ferreira,55045964,788,10-Jan-92,25,0,0,0,0,2250,5500,5500,118,110,135352,180,74,D RL,3,3,1,2,3,3,2,2,2,3,2,8,11,10,6,9,9,10,7,10,12,11,4,13,11,10,12,12,11,14,10,11,14,7,11,10,13,14,13,11,12,11,10,20,13,11,14,14,11,11,10,11,12,13,13,12,13,12,16,16,15,7,20,13,1,1,15,20,7,D RL,105,1,1,1,1,1,1,7,20,15,1,1,1,1,13,1,0.0,0,0,0,0,0,0,0,0,0,0,0,0,0,0,0,0,0,0,0,0,0,0,0,0,0,0,0,0,0,0,0,0,0,0,0,0,0,0,0,0,0,0,0,0,0,0,0,0,Joel Pereira,Â£900Th. ,24.0,189.0,Goalkeeper,right,Huddersfield Town,16.0,17.0,7.0,1360.0,3.0,5.0,0.0,192.0,15.0,20.0,4.0,1329.0,25.0,43.0,5.0,2280.0,0.0,0.0,0.0,0.0,Premier League,15-07-16,17.3.2.23,Joel Ferreira,55045964,788,10-Jan-92,24,0,0,0,0,2250,5500,5500,117,110,147128,180,74,D RL,1,3,2,3,3,2,2,3,2,3,2,8,12,10,6,8,12,10,7,12,12,12,4,13,11,10,13,12,12,15,10,12,13,8,11,10,14,14,13,11,12,12,11,20,13,11,7,14,12,11,10,11,12,8,10,12,13,12,16,16,14,9,Joel Pereira,Â£90Th. ,Premier League
19-06-17,18.3.4.28,Wilson ManafÃ¡,55061773,788,23-Jul-94,22,0,0,0,0,2750,5000,5000,115,109,102501,173,70,D/M/AM RL,2,3,2,4,3,3,2,2,2,3,3,6,10,9,8,8,8,11,9,10,8,10,8,12,12,13,10,12,11,10,9,7,11,10,7,13,11,12,10,16,12,10,11,6,14,16,20,12,10,8,8,9,6,14,14,9,9,7,13,11,11,3,20,12,16,19,20,17,10,D/M/AM RL,125,1,1,1,10,17,19,1,1,20,1,1,1,16,1,12,0.0,0,0,0,0,0,0,0,0,0,0,0,0,0,0,0,0,0,0,0,0,0,0,0,0,0,0,0,0,0,0,0,0,0,0,0,0,0,0,0,0,0,0,0,0,0,0,0,0,Wilson ManafÃ¡,Â£270Th. ,26.0,177.0,Defender - Right-Back,right,FC Porto,39.0,3.0,3.0,1958.0,22.0,0.0,3.0,685.0,34.0,3.0,5.0,2522.0,45.0,1.0,1.0,3190.0,6.0,0.0,1.0,467.0,Liga NOS
19-06-17,18.3.4.28,Ricardo Pereira,55062009,788,06-Oct-93,23,2,0,18,7,5000,6650,7250,160,147,32577088,175,70,D/WB/AM R,2,2,1,1,2,1,2,1,3,3,3,9,14,14,10,13,8,6,12,7,12,12,12,14,15,11,14,13,12,12,12,13,15,15,7,14,10,13,14,16,15,10,9,10,15,15,20,14,9,14,9,12,10,16,12,14,13,14,15,15,12,6,20,16,13,20,20,14,1,D/WB/AM R,122,1,1,7,1,14,20,1,13,20,1,1,1,13,1,16,549756000000.0,0,1,0,0,0,0,0,0,0,0,0,0,0,0,0,0,0,0,0,0,0,0,0,0,0,0,0,0,0,0,0,0,0,0,0,0,0,0,0,1,0,0,0,0,0,0,0,0,Ricardo Pereira,Â£18.00m ,27.0,175.0,Defender - Right-Back,right,Leicester City,30.0,2.0,4.0,2574.0,43.0,2.0,7.0,3563.0,37.0,2.0,7.0,3224.0,33.0,4.0,3.0,2970.0,nan,nan,nan,nan,Liga NOS,15-07-16,17.3.2.23,Ricardo Pereira,55062009,788,06-Oct-93,22,0,0,18,7,4450,6300,6600,145,132,6272001,175,70,D/AM R,2,1,3,2,2,1,4,2,1,4,1,9,13,13,10,11,8,4,10,8,9,11,12,11,12,11,13,14,11,11,10,10,15,13,7,14,9,12,14,16,15,8,9,10,14,15,20,13,9,13,12,11,7,14,12,12,14,14,14,15,15,6,Ricardo Pereira,Â£8.10m ,Ligue 1
19-06-17,18.3.4.28,Marcelo Goiano,55062043,1651,13-Oct-87,29,0,0,0,0,3612,5161,6450,137,129,1638418,176,69,D/WB RL,3,3,2,3,2,2,2,2,1,3,1,8,13,12,6,12,11,7,12,11,11,12,12,13,13,11,13,12,12,14,10,13,14,11,14,15,12,12,14,14,14,10,7,12,14,14,20,14,8,15,8,15,6,14,14,10,13,14,15,12,15,6,20,17,1,1,20,20,1,D/WB RL,115,1,1,1,1,1,1,1,20,20,1,1,1,1,15,17,1.44115e+17,0,0,0,0,0,0,0,0,1,0,0,0,0,0,0,0,0,0,0,0,0,0,0,0,0,0,0,0,0,0,0,0,0,0,0,0,0,0,0,0,0,0,0,0,0,0,0,0,Marcelo Goiano,Â£1.80m ,33.0,176.0,Defender - Right-Back,right,Sivasspor,36.0,0.0,3.0,2853.0,38.0,1.0,2.0,3249.0,38.0,1.0,1.0,3283.0,30.0,0.0,2.0,2617.0,2.0,0.0,0.0,155.0,Liga NOS,15-07-16,17.3.2.23,Marcelo Goiano,55062043,1651,13-Oct-87,28,0,0,0,0,5000,6250,6800,137,136,6454067,176,69,D/WB RL,3,2,4,3,2,2,2,3,3,1,4,8,14,12,6,13,12,7,13,11,11,13,12,13,14,11,13,12,12,14,10,13,14,11,8,15,11,12,14,15,14,10,7,12,14,14,20,15,8,15,8,13,6,14,14,10,13,14,15,12,15,5,Marcelo Goiano,Â£1.80m ,Liga NOS
19-06-17,18.3.4.28,Arnold Issoko,55062785,53,06-Apr-92,25,1,0,0,0,3500,5600,5750,116,115,148456,185,76,D/AM RL,4,2,2,2,2,1,3,3,3,2,3,3,10,8,11,7,3,9,11,4,3,9,9,4,7,13,12,14,6,11,7,8,15,14,7,16,9,11,14,18,11,11,14,5,18,17,20,16,14,12,4,10,8,9,13,10,12,10,17,15,14,7,19,13,15,20,20,16,12,D/AM RL,525,1,1,12,12,16,20,1,1,19,1,1,12,15,1,13,2251800000000000.0,0,0,0,0,0,0,0,0,0,0,0,0,0,1,0,0,0,0,0,0,0,0,0,0,0,0,0,1,0,0,0,1,0,0,0,0,0,0,0,0,0,0,0,0,0,0,0,0,Arnold Issoko,Â£720Th. ,28.0,185.0,Forward - Right Winger,right,CD Cova Piedade,30.0,0.0,1.0,1348.0,37.0,1.0,1.0,2603.0,18.0,3.0,8.0,1599.0,7.0,1.0,0.0,310.0,6.0,2.0,0.0,397.0,Liga NOS,15-07-16,17.3.2.23,Arnold Issoko,55062785,53,06-Apr-92,24,1,0,0,0,3900,5600,5550,115,111,279482,185,76,AM RL,3,4,3,3,1,3,3,2,2,3,2,3,10,8,11,7,3,9,11,4,3,9,9,4,7,13,12,14,6,11,7,8,14,14,7,15,9,11,14,18,16,15,7,6,10,17,20,13,13,12,4,10,8,9,13,10,12,10,13,14,13,8,Arnold Issoko,Â£585Th. ,Liga NOS
19-06-17,18.3.4.28,Mama BaldÃ©,55070279,23,06-Nov-95,21,0,0,0,0,2250,5650,5650,135,113,334527,181,75,D R,2,1,2,1,3,2,3,2,3,3,2,8,11,11,8,11,5,8,7,13,10,10,5,13,12,12,12,12,9,11,11,9,13,13,10,14,9,11,13,16,14,13,10,8,16,16,20,12,11,13,8,10,4,13,9,12,15,13,14,12,13,6,20,15,7,10,20,1,1,D R,102,1,1,1,1,1,10,1,1,20,1,1,1,7,1,15,134217762.0,0,1,0,0,0,1,0,0,0,0,0,0,0,0,0,0,0,0,0,0,0,0,0,0,0,0,0,1,0,0,0,0,0,0,0,0,0,0,0,0,0,0,0,0,0,0,0,0,Mama BaldÃ©,Â£450Th. ,24.0,181.0,Forward - Right Winger,right,Dijon FCO,17.0,0.0,3.0,1392.0,17.0,3.0,2.0,1095.0,35.0,10.0,3.0,2783.0,28.0,6.0,2.0,1918.0,4.0,1.0,0.0,316.0,Liga NOS
19-06-17,18.3.4.28,Bruno Santos,55074152,1651,07-Feb-93,24,0,0,0,0,3196,4262,6300,126,118,621461,183,79,D R,3,1,2,3,1,2,2,1,2,4,1,7,11,11,7,12,8,7,5,11,10,11,8,13,13,13,12,12,11,12,10,11,12,8,8,13,11,11,13,15,14,13,12,11,12,15,20,12,12,11,9,10,14,11,12,8,11,12,13,10,13,5,20,12,12,1,20,1,12,D R,102,1,1,1,1,1,1,1,1,20,1,12,1,1,1,12,0.0,0,0,0,0,0,0,0,0,0,0,0,0,0,0,0,0,0,0,0,0,0,0,0,0,0,0,0,0,0,0,0,0,0,0,0,0,0,0,0,0,0,0,0,0,0,0,0,0,Bruno Santos,Â£540Th. ,27.0,183.0,Defender - Right-Back,right,AEL Limassol,32.0,0.0,1.0,2624.0,27.0,0.0,0.0,2269.0,32.0,1.0,7.0,2843.0,25.0,3.0,1.0,2112.0,4.0,0.0,0.0,327.0,Liga NOS,15-07-16,17.3.2.23,Bruno Santos,55074152,1651,07-Feb-93,23,0,0,0,0,2879,4083,5350,118,107,96681,183,79,D R,3,2,4,1,1,2,2,1,2,3,1,7,11,12,7,12,8,7,5,11,9,11,7,11,13,13,12,13,11,10,10,11,12,8,8,12,9,11,13,15,14,10,8,8,12,15,20,12,10,11,9,10,14,11,8,8,11,12,13,10,13,5,Bruno Santos,Â£900Th. ,Liga NOS
19-06-17,18.3.4.28,NÃ©lson Monte,55078869,788,20-Jul-95,21,0,0,0,0,2800,5950,5950,136,119,286015,187,82,D RC,2,3,2,3,1,3,1,3,1,1,2,4,10,10,5,10,3,11,6,10,13,12,3,13,12,14,13,12,13,13,12,12,12,4,10,8,14,14,14,13,13,12,13,10,13,13,20,13,11,12,12,10,5,10,17,11,13,14,14,13,16,5,20,1,1,1,16,1,20,D RC,103,1,1,1,1,1,1,20,1,16,1,1,1,1,1,1,32832.0,0,0,0,0,0,0,1,0,0,0,0,0,0,0,0,1,0,0,0,0,0,0,0,0,0,0,0,0,0,0,0,0,0,0,0,0,0,0,0,0,0,0,0,0,0,0,0,0,NÃ©lson Monte,Â£1.80m ,25.0,187.0,Defender - Centre-Back,right,Rio Ave FC,12.0,0.0,0.0,1031.0,33.0,0.0,1.0,2806.0,18.0,0.0,1.0,1446.0,25.0,0.0,0.0,2009.0,6.0,0.0,0.0,539.0,Liga NOS,15-07-16,17.3.2.23,NÃ©lson Monte,55078869,788,20-Jul-95,20,0,0,0,0,2800,5350,5350,136,107,277754,187,82,D RC,2,1,1,3,2,2,4,1,3,3,2,4,8,7,5,9,3,11,6,10,13,12,3,13,11,14,13,12,12,13,9,10,7,4,3,5,13,13,13,13,13,12,13,10,13,13,20,13,11,12,12,10,9,10,17,11,12,10,11,10,17,6,NÃ©lson Monte,Â£450Th. ,Liga NOS
19-06-17,18.3.4.28,Fernando Fonseca,55082104,788,14-Mar-97,20,0,0,8,0,2500,5500,5500,135,110,368833,182,66,D R,3,3,3,1,1,2,3,1,2,3,4,10,14,12,9,12,8,9,8,12,10,11,11,12,13,13,13,13,10,11,9,10,15,7,7,13,11,13,13,14,14,12,9,7,14,14,20,14,7,13,8,10,8,12,15,13,15,13,13,9,9,12,20,10,10,1,20,1,1,D R,102,1,1,1,1,1,1,1,1,20,7,1,1,10,1,10,32.0,0,0,0,0,0,1,0,0,0,0,0,0,0,0,0,0,0,0,0,0,0,0,0,0,0,0,0,0,0,0,0,0,0,0,0,0,0,0,0,0,0,0,0,0,0,0,0,0,Fernando Fonseca,Â£630Th. ,23.0,183.0,Defender - Right-Back,right,FC PaÃ§os de Ferreira,30.0,0.0,0.0,2527.0,19.0,0.0,2.0,1555.0,3.0,0.0,1.0,270.0,23.0,0.0,2.0,1943.0,5.0,0.0,0.0,294.0,Liga NOS
19-06-17,18.3.4.28,Maxi Pereira,5512991,1657,08-Jun-84,33,121,3,3,0,6000,6900,6900,144,138,232186002,173,70,D R,3,2,2,2,2,1,3,1,2,1,4,11,12,11,10,13,11,8,12,17,12,12,12,15,12,18,15,18,14,15,12,15,19,8,15,16,11,15,18,12,12,14,7,11,14,12,20,13,12,18,18,15,3,16,16,16,6,16,16,6,8,9,20,15,10,1,20,1,1,D R,102,1,1,1,1,1,1,1,1,20,5,1,1,10,1,15,1125900000000000.0,0,0,0,0,0,1,0,0,0,0,0,0,0,0,0,0,0,1,0,0,0,0,0,0,0,0,0,0,0,0,0,1,0,0,0,0,0,0,0,0,0,0,0,0,0,0,0,0,Maxi Pereira,Â£900Th. ,36.0,173.0,Defender - Right-Back,right,Retired,35.0,2.0,4.0,2984.0,23.0,1.0,4.0,1635.0,30.0,1.0,2.0,2157.0,nan,nan,nan,nan,nan,nan,nan,nan,Liga NOS,15-07-16,17.3.2.23,Maxi Pereira,5512991,1657,08-Jun-84,32,114,3,3,0,6500,7200,7200,152,144,232186002,173,70,D R,2,3,2,1,1,2,1,2,3,3,2,11,12,11,10,13,11,8,12,17,12,12,12,15,12,18,15,18,14,15,12,15,18,8,15,16,11,14,18,13,12,14,7,12,16,13,20,15,13,18,18,14,3,16,16,16,6,16,15,6,8,10,Maxi Pereira,Â£3.60m ,Liga NOS
19-06-17,18.3.4.28,Stefan Ristovski,62092056,781,12-Feb-92,25,35,1,12,0,4750,6500,6450,135,129,1834363,180,73,D/WB R,3,1,3,2,3,3,1,1,3,2,3,8,15,12,8,12,6,12,11,10,12,13,7,13,12,12,14,12,10,13,11,12,16,9,9,14,13,15,17,14,13,12,11,8,13,14,20,15,13,15,10,14,8,10,13,16,11,10,15,14,11,4,20,16,14,1,20,10,1,D/WB R,112,1,1,1,1,1,1,1,10,20,1,1,1,14,1,16,1048610.0,0,1,0,0,0,1,0,0,0,0,0,0,0,0,0,0,0,0,0,0,1,0,0,0,0,0,0,0,0,0,0,0,0,0,0,0,0,0,0,0,0,0,0,0,0,0,0,0,Stefan Ristovski,Â£2.25m ,28.0,180.0,Defender - Right-Back,right,Sporting CP,41.0,1.0,9.0,3530.0,30.0,1.0,4.0,2409.0,33.0,0.0,4.0,2639.0,26.0,0.0,4.0,2008.0,nan,nan,nan,nan,Liga NOS
19-06-17,18.3.4.28,Tiago Mesquita,67092626,788,23-Nov-90,26,0,0,0,0,3500,5650,5650,116,113,149075,180,75,D R,3,1,2,3,3,2,1,1,2,1,1,8,12,11,7,11,4,7,6,12,12,11,8,13,12,14,13,13,10,13,10,12,12,9,8,13,12,12,14,14,12,13,10,8,13,13,20,13,12,13,11,11,6,10,18,11,11,11,14,12,12,7,20,13,1,1,20,1,10,D R,102,1,1,1,1,1,1,10,1,20,1,1,1,1,1,13,2.0,0,1,0,0,0,0,0,0,0,0,0,0,0,0,0,0,0,0,0,0,0,0,0,0,0,0,0,0,0,0,0,0,0,0,0,0,0,0,0,0,0,0,0,0,0,0,0,0,Tiago Mesquita,Â£270Th. ,29.0,180.0,Defender - Right-Back,right,AcadÃ©mico Viseu FC,16.0,0.0,2.0,1149.0,6.0,0.0,1.0,459.0,12.0,0.0,1.0,981.0,16.0,0.0,2.0,1311.0,5.0,0.0,0.0,358.0,Liga NOS,15-07-16,17.3.2.23,Tiago Mesquita,67092626,788,23-Nov-90,25,0,0,0,0,3400,5550,5550,116,111,92210,180,75,D R,1,3,3,1,1,2,2,2,1,4,1,8,12,11,7,11,4,7,6,12,12,11,8,13,12,14,13,12,8,13,10,11,12,9,8,13,12,12,14,14,12,13,10,8,13,13,20,13,12,13,11,11,6,10,19,11,11,11,14,12,12,8,Tiago Mesquita,Â£540Th. ,Liga NOS
19-06-17,18.3.4.28,Vasco Fernandes,727458,788,12-Nov-86,30,0,0,11,0,4400,5900,5900,123,118,232186002,182,79,D RC,4,2,2,2,2,1,2,1,3,1,2,7,9,9,6,10,8,10,9,8,13,11,10,14,11,12,15,14,11,10,8,12,15,12,15,10,12,14,13,13,13,13,12,8,16,14,20,14,12,12,14,12,6,12,13,14,10,12,15,14,15,6,20,1,1,1,18,1,20,D RC,103,1,1,1,1,1,1,20,1,18,14,1,1,1,1,1,34.0,0,1,0,0,0,1,0,0,0,0,0,0,0,0,0,0,0,0,0,0,0,0,0,0,0,0,0,0,0,0,0,0,0,0,0,0,0,0,0,0,0,0,0,0,0,0,0,0,Vasco Fernandes,Â£720Th. ,33.0,182.0,Defender - Centre-Back,right,Ãmraniyespor,34.0,2.0,0.0,2901.0,27.0,2.0,2.0,2366.0,37.0,1.0,1.0,3360.0,20.0,1.0,1.0,1770.0,5.0,1.0,0.0,377.0,Liga NOS,15-07-16,17.3.2.23,Vasco Fernandes,727458,788,12-Nov-86,29,0,0,11,0,5000,6050,6250,123,121,977142,182,79,D RC,3,1,1,3,1,3,3,2,3,1,3,7,9,8,6,10,8,10,9,8,13,11,10,15,11,12,15,14,12,10,8,13,15,12,11,8,13,14,13,13,13,13,12,8,16,14,20,15,12,12,14,12,6,12,13,14,10,12,15,14,15,7,Vasco Fernandes,Â£900Th. ,Liga NOS
19-06-17,18.3.4.28,Ricardo Pessoa,729932,788,05-Feb-82,35,0,0,1,0,3000,5200,5200,110,108,7886,173,69,D/WB R,1,3,1,1,1,2,2,1,3,3,3,10,14,10,7,8,18,9,11,12,11,12,15,13,11,10,12,12,12,11,11,13,15,7,17,12,13,15,12,11,11,13,10,5,11,12,20,13,11,13,8,13,6,13,9,12,18,12,15,13,13,4,20,18,12,8,20,10,1,D/WB R,112,1,1,1,1,1,8,1,10,20,1,1,1,12,1,18,2.0,0,1,0,0,0,0,0,0,0,0,0,0,0,0,0,0,0,0,0,0,0,0,0,0,0,0,0,0,0,0,0,0,0,0,0,0,0,0,0,0,0,0,0,0,0,0,0,0,Ricardo Pessoa,Â£68Th. ,38.0,177.0,Defender - Right-Back,right,Retired,30.0,4.0,5.0,2664.0,11.0,1.0,0.0,895.0,nan,nan,nan,nan,nan,nan,nan,nan,nan,nan,nan,nan,Liga NOS
19-06-17,18.3.4.28,Ricardo,735107,12,19-Aug-80,36,17,1,0,0,4750,6000,6000,128,120,25430,185,80,D RC,2,1,1,2,2,3,1,1,2,3,3,7,7,6,5,9,9,14,9,11,14,9,8,14,9,14,12,14,10,14,7,12,15,7,17,6,14,13,15,10,12,14,15,7,16,10,20,12,13,12,11,8,8,12,12,12,14,11,15,12,14,6,20,1,1,1,15,1,20,D RC,103,1,5,1,1,1,1,20,1,15,13,1,1,1,1,1,64.0,0,0,0,0,0,0,1,0,0,0,0,0,0,0,0,0,0,0,0,0,0,0,0,0,0,0,0,0,0,0,0,0,0,0,0,0,0,0,0,0,0,0,0,0,0,0,0,0,Ricardo,Â£90Th. ,40.0,186.0,Defender - Centre-Back,right,Retired,16.0,2.0,0.0,1440.0,20.0,0.0,0.0,1568.0,33.0,0.0,0.0,2969.0,16.0,0.0,0.0,1165.0,nan,nan,nan,nan,Liga NOS,15-07-16,17.3.2.23,Ricardo,735107,12,19-Aug-80,35,14,1,0,0,4750,5750,6000,128,120,232186002,185,80,D RC,1,3,1,4,2,3,3,1,2,2,2,7,7,6,5,9,9,14,9,11,14,9,8,14,9,14,12,14,10,14,7,12,15,7,16,6,14,13,15,10,12,14,15,7,16,10,20,12,13,12,11,8,8,12,11,12,14,11,15,12,14,5,Ricardo,Â£90Th. ,Liga NOS
19-06-17,18.3.4.28,Pedrinho,743337,788,06-Mar-85,32,0,0,0,0,4250,5300,5300,120,107,53543,177,71,D R,3,1,1,1,1,1,1,2,3,3,3,9,11,11,6,11,8,9,10,11,10,10,8,12,11,11,13,13,12,12,11,12,14,12,13,13,11,12,13,13,13,11,8,8,12,13,20,12,11,12,9,13,8,11,9,13,13,11,15,15,15,6,20,15,12,12,20,13,5,D R,102,1,1,1,5,1,12,1,13,20,1,1,1,12,10,15,2251800000000000.0,0,0,0,0,1,0,0,0,0,0,0,0,0,0,0,0,0,0,0,0,0,0,0,0,0,0,0,0,0,0,0,0,0,0,0,0,0,0,0,0,0,0,0,0,0,0,0,0,Pedrinho,Â£720Th. ,27.0,170.0,Midfielder - Attacking Midfield,right,Riga FC,34.0,5.0,3.0,2827.0,35.0,4.0,3.0,3112.0,36.0,1.0,5.0,2457.0,49.0,4.0,5.0,3916.0,1.0,1.0,0.0,85.0,Liga NOS,15-07-16,17.3.2.23,Pedrinho,55045472,788,20-Dec-92,23,0,0,0,0,3400,6250,6250,138,125,635274,170,63,M C,2,1,1,2,3,4,1,2,1,3,1,13,13,13,11,13,14,5,13,5,8,15,9,11,15,12,11,14,15,11,15,14,16,10,12,12,11,14,15,12,12,11,6,11,12,11,20,13,7,17,7,13,7,17,16,10,14,15,17,13,13,2,Pedrinho,Â£270Th. ,Liga NOS
19-06-17,18.3.4.28,Barge,748235,788,04-Jan-84,33,0,0,0,0,3500,5500,5500,119,110,36315,174,69,D/M/AM R,3,2,1,2,1,3,2,3,3,3,3,13,12,9,8,9,10,8,9,10,11,11,6,12,11,13,12,12,13,12,8,13,14,9,13,12,13,13,13,12,11,11,9,8,13,12,20,12,11,13,8,15,10,14,12,10,12,12,14,12,10,7,20,15,18,17,20,12,13,D/M/AM R,122,1,1,1,7,12,17,1,10,20,1,13,12,18,1,15,1048640.0,0,0,0,0,0,0,1,0,0,0,0,0,0,0,0,0,0,0,0,0,1,0,0,0,0,0,0,0,0,0,0,0,0,0,0,0,0,0,0,0,0,0,0,0,0,0,0,0,Barge,Â£90Th. ,36.0,174.0,Defender - Right-Back,right,Retired,28.0,0.0,2.0,2279.0,3.0,0.0,0.0,219.0,nan,nan,nan,nan,nan,nan,nan,nan,nan,nan,nan,nan,Liga NOS,15-07-16,17.3.2.23,Barge,748235,788,04-Jan-84,32,0,0,0,0,3556,4318,4250,119,102,811,174,69,D/M/AM R,1,2,3,3,3,3,2,3,4,2,1,11,10,8,6,8,10,5,6,10,11,11,6,12,11,13,12,12,12,12,8,12,14,9,13,12,13,13,13,12,12,12,9,6,13,12,20,12,11,13,8,15,10,14,12,10,12,12,14,12,10,8,Barge,Â£270Th. ,Liga NOS
19-06-17,18.3.4.28,Koffi Kouao,83177137,24,20-May-98,19,0,0,0,0,1750,4750,5250,120,105,177378,171,66,D R,2,4,2,3,1,4,2,3,1,3,2,8,10,11,5,11,11,6,8,12,10,11,7,12,12,11,11,13,7,10,7,9,13,11,8,13,10,13,15,15,14,10,7,10,14,15,20,14,8,14,11,11,5,11,12,11,8,10,11,10,12,7,20,13,1,1,20,1,1,D R,102,1,1,1,1,1,1,1,1,20,1,1,1,1,1,13,2286980000000000.0,0,0,0,0,0,0,0,0,0,1,0,0,0,0,0,0,0,0,0,0,0,0,0,0,0,0,0,0,0,0,0,0,0,0,0,0,0,0,0,0,0,0,0,0,0,1,0,0,Koffi Kouao,Â£270Th. ,22.0,173.0,Defender - Right-Back,right,FC Vizela,8.0,0.0,2.0,720.0,15.0,0.0,0.0,833.0,9.0,0.0,1.0,685.0,1.0,0.0,1.0,90.0,7.0,1.0,0.0,630.0,Liga NOS
19-06-17,18.3.4.28,Jacob Adebanjo,84100406,38,05-Sep-93,23,0,0,0,0,1264,4300,4250,110,100,3840,184,78,D/DM RC,1,3,1,1,1,3,2,4,2,2,1,7,7,10,8,12,7,12,8,10,11,12,11,12,12,16,12,14,10,11,11,10,12,10,9,10,12,13,12,12,12,10,13,4,14,13,20,13,13,10,9,4,10,16,13,11,13,12,13,12,10,5,17,1,10,1,15,1,17,D/DM RC,323,1,1,1,1,1,1,17,1,15,20,10,1,1,1,1,0.0,0,0,0,0,0,0,0,0,0,0,0,0,0,0,0,0,0,0,0,0,0,0,0,0,0,0,0,0,0,0,0,0,0,0,0,0,0,0,0,0,0,0,0,0,0,0,0,0,Jacob Adebanjo,Â£90Th. ,27.0,184.0,Midfielder - Defensive Midfield,right,Without Club,1.0,0.0,0.0,90.0,1.0,0.0,0.0,10.0,2.0,0.0,0.0,180.0,3.0,1.0,0.0,77.0,nan,nan,nan,nan,Liga NOS
19-06-17,18.3.4.28,Emmanuel Hackman,84102962,21,14-May-95,22,0,0,0,0,2783,4554,5250,128,106,86929,180,72,D RL,1,3,3,3,1,1,3,1,2,2,1,5,9,8,6,8,6,13,6,14,12,9,8,14,7,15,14,15,9,12,6,6,14,7,8,13,12,13,15,14,14,14,11,8,14,14,20,15,11,11,8,9,4,15,15,13,11,15,16,14,14,11,20,1,1,1,20,18,10,D RL,105,1,1,1,1,1,1,10,18,20,14,1,1,1,1,1,0.0,0,0,0,0,0,0,0,0,0,0,0,0,0,0,0,0,0,0,0,0,0,0,0,0,0,0,0,0,0,0,0,0,0,0,0,0,0,0,0,0,0,0,0,0,0,0,0,0,Emmanuel Hackman,Â£720Th. ,25.0,187.0,Defender - Right-Back,right,Portimonense SC,24.0,2.0,0.0,2012.0,31.0,0.0,2.0,2657.0,16.0,0.0,1.0,1004.0,22.0,2.0,2.0,1683.0,nan,nan,nan,nan,Liga NOS
19-06-17,18.3.4.28,Rodrigo Soares,84125466,1651,26-Dec-92,24,0,0,0,0,2306,4100,5000,122,100,53140,176,71,D/WB RL,3,1,1,3,3,4,2,2,2,3,4,6,10,10,6,10,8,7,7,11,10,11,4,11,13,8,11,9,8,13,8,10,15,8,7,13,9,11,11,15,13,10,8,5,12,15,20,12,8,14,10,9,4,6,8,11,8,10,14,12,13,6,20,18,1,1,20,16,1,D/WB RL,115,1,1,1,1,1,1,1,16,20,1,1,1,1,10,18,0.0,0,0,0,0,0,0,0,0,0,0,0,0,0,0,0,0,0,0,0,0,0,0,0,0,0,0,0,0,0,0,0,0,0,0,0,0,0,0,0,0,0,0,0,0,0,0,0,0,nan,nan,nan,nan,nan,nan,nan,nan,nan,nan,nan,nan,nan,nan,nan,nan,nan,nan,nan,nan,nan,nan,nan,nan,nan,nan,nan,nan,15-07-16,17.3.2.23,Rodrigo Soares,84125466,1651,26-Dec-92,23,0,0,0,0,1295,4145,5250,122,105,146240,176,71,D/WB RL,3,1,1,1,2,2,2,2,2,2,2,6,10,10,6,10,8,7,7,11,11,11,7,13,13,8,11,9,9,14,8,10,15,8,7,13,9,11,11,15,13,11,8,5,12,15,20,13,9,14,5,9,10,6,8,11,8,10,14,12,13,5,nan,nan,nan
19-06-17,18.3.4.28,Pierre Sagna,85042904,769,21-Aug-90,26,0,0,0,0,3647,4689,6050,128,121,287769,183,76,D R,1,3,1,2,3,3,3,1,2,3,2,5,12,11,6,10,5,9,7,11,9,9,8,14,12,11,13,12,8,14,8,13,12,8,10,12,13,13,14,15,14,14,12,7,15,15,20,14,12,12,12,13,7,12,13,14,14,12,13,13,10,8,20,15,5,1,20,10,1,D R,102,1,1,1,1,1,1,1,10,20,1,1,1,5,1,15,32.0,0,0,0,0,0,1,0,0,0,0,0,0,0,0,0,0,0,0,0,0,0,0,0,0,0,0,0,0,0,0,0,0,0,0,0,0,0,0,0,0,0,0,0,0,0,0,0,0,Pierre Sagna,Â£720Th. ,30.0,183.0,Defender - Right-Back,right,CD Santa Clara,32.0,0.0,1.0,2704.0,33.0,0.0,3.0,2811.0,16.0,0.0,0.0,803.0,29.0,1.0,0.0,2426.0,3.0,0.0,1.0,118.0,Liga NOS,15-07-16,17.3.2.23,Pierre Sagna,85042904,769,21-Aug-90,25,0,0,0,0,3584,4888,6200,128,124,448667,183,76,D R,1,3,1,1,1,3,2,2,2,1,3,5,12,11,6,10,5,9,7,11,9,8,8,15,12,11,13,12,8,14,8,13,12,8,10,12,13,13,15,16,14,14,10,7,15,15,20,14,13,12,12,13,7,12,13,14,14,12,13,13,10,9,Pierre Sagna,Â£720Th. ,Liga NOS
19-06-17,18.3.4.28,Fahd Moufi,85137119,34,05-May-96,21,0,0,1,0,2000,4750,4750,119,95,59141,176,71,D R,1,2,2,2,3,1,1,3,2,1,2,7,12,9,5,9,5,8,5,11,10,12,5,12,11,14,11,10,9,10,9,9,7,2,7,12,11,13,13,13,13,11,9,8,12,13,20,13,12,10,12,4,8,8,12,10,12,10,12,7,13,6,20,15,13,10,20,1,1,D R,102,1,1,1,1,1,10,1,1,20,1,1,1,13,1,15,0.0,0,0,0,0,0,0,0,0,0,0,0,0,0,0,0,0,0,0,0,0,0,0,0,0,0,0,0,0,0,0,0,0,0,0,0,0,0,0,0,0,0,0,0,0,0,0,0,0,Fahd Moufi,Â£180Th. ,24.0,177.0,Defender - Right-Back,right,Portimonense SC,19.0,0.0,0.0,1557.0,3.0,0.0,0.0,200.0,16.0,1.0,0.0,1262.0,28.0,0.0,1.0,2403.0,0.0,0.0,0.0,0.0,Liga NOS
19-06-17,18.3.4.28,VÃ­ctor GarcÃ­a,86017958,1658,11-Jun-94,23,7,0,6,1,4500,6100,6200,146,124,1368277,178,71,D/WB/M R,1,2,1,2,3,3,1,1,4,1,2,11,12,12,8,12,9,9,6,12,11,12,12,12,13,12,12,13,10,11,8,11,16,11,7,16,11,13,13,17,14,12,7,6,14,16,20,15,8,14,9,10,7,10,14,12,15,14,15,11,11,11,20,16,18,10,20,1,10,D/WB/M R,122,1,1,1,1,1,10,1,1,20,5,10,1,18,1,16,32.0,0,0,0,0,0,1,0,0,0,0,0,0,0,0,0,0,0,0,0,0,0,0,0,0,0,0,0,0,0,0,0,0,0,0,0,0,0,0,0,0,0,0,0,0,0,0,0,0,VÃ­ctor GarcÃ­a,Â£1.13m ,26.0,178.0,Defender - Right-Back,right,AD AlcorcÃ³n,22.0,0.0,3.0,1967.0,21.0,0.0,1.0,1681.0,9.0,0.0,1.0,810.0,17.0,0.0,1.0,1459.0,3.0,0.0,0.0,52.0,Liga NOS,15-07-16,17.3.2.23,VÃ­ctor GarcÃ­a,86017958,1658,11-Jun-94,22,1,0,6,1,4422,5779,6550,144,131,1111952,175,67,D/WB/M R,1,3,1,2,1,2,2,1,3,1,1,11,11,12,8,12,9,9,6,12,11,12,12,12,13,12,13,13,10,12,8,12,16,11,7,16,11,13,13,17,14,12,7,9,14,16,20,16,8,14,9,10,7,10,14,6,15,13,15,11,11,12,VÃ­ctor GarcÃ­a,Â£900Th. ,Liga NOS
19-06-17,18.3.4.28,Gabriel Mercado,14000758,1649,18-Mar-87,30,14,3,20,1,5250,7200,7200,144,142,232186002,180,83,D RC,2,1,3,1,1,2,3,2,1,3,4,6,12,11,9,13,6,15,7,14,14,12,10,15,11,16,15,15,13,14,12,14,16,5,14,15,15,15,16,12,12,15,13,9,15,13,20,15,14,16,14,18,13,17,12,13,17,12,17,8,7,2,20,15,1,1,20,9,16,D RC,103,1,1,1,1,1,1,16,9,20,1,1,1,1,1,15,2147614752.0,0,0,0,0,0,1,0,0,0,0,0,0,0,0,0,0,0,1,0,0,0,0,0,0,0,0,0,0,0,0,0,1,0,0,0,0,0,0,0,0,0,0,0,0,0,0,0,0,Gabriel Mercado,Â£4.50m ,33.0,181.0,Defender - Centre-Back,right,Al-Rayyan SC,40.0,3.0,1.0,3103.0,43.0,0.0,2.0,3626.0,34.0,3.0,2.0,2753.0,21.0,3.0,0.0,1890.0,4.0,0.0,0.0,360.0,LaLiga,15-07-16,17.3.2.23,Gabriel Mercado,14000758,1649,18-Mar-87,29,10,2,20,1,5250,7200,7200,144,144,11816409,180,83,D/WB RC,1,2,1,1,2,3,3,2,4,3,1,6,12,12,9,13,6,15,7,14,15,12,10,15,11,16,15,15,13,14,12,14,16,5,14,15,15,15,16,12,12,15,13,9,15,14,20,15,15,16,14,18,13,15,12,13,17,12,17,8,7,2,Gabriel Mercado,Â£4.50m ,LaLiga
19-06-17,18.3.4.28,Facundo Roncaglia,14001537,1649,10-Feb-87,30,14,0,0,0,6000,6850,6850,150,137,10192786,179,76,D RC,3,3,3,3,1,1,2,4,2,2,3,6,10,10,11,12,6,15,12,13,15,13,9,14,12,15,14,13,13,10,11,12,16,6,10,10,14,15,15,13,12,14,13,9,14,12,20,15,16,12,13,13,7,13,14,13,12,10,11,9,12,12,20,1,1,1,19,14,20,D RC,103,1,1,1,1,1,1,20,14,19,1,1,1,1,1,1,137439000000.0,0,0,0,0,0,1,0,0,1,0,0,0,0,0,0,0,0,0,0,0,0,0,0,0,0,0,0,0,0,0,0,0,0,0,0,0,0,1,0,0,0,0,0,0,0,0,0,0,Facundo Roncaglia,Â£2.70m ,33.0,179.0,Defender - Centre-Back,right,CA Osasuna,48.0,3.0,1.0,3942.0,22.0,0.0,0.0,1500.0,24.0,0.0,0.0,2092.0,19.0,1.0,0.0,1580.0,4.0,1.0,1.0,334.0,LaLiga,15-07-16,17.3.2.23,Facundo Roncaglia,14001537,1649,10-Feb-87,29,12,0,0,0,5500,6750,7000,150,142,11041746,179,76,D RC,1,2,2,3,2,3,2,1,1,4,2,6,10,10,10,12,6,15,12,13,15,13,9,15,12,16,16,15,14,10,11,12,16,6,10,10,14,16,15,13,12,16,11,9,14,12,20,15,18,12,14,13,7,12,14,13,12,10,11,9,12,12,Facundo Roncaglia,Â£4.50m ,LaLiga
19-06-17,18.3.4.28,Antonio BarragÃ¡n,1504803,796,12-Jun-87,30,0,0,1,0,5250,6750,6750,144,126,232186002,186,83,D/WB R,4,2,1,4,3,4,3,3,3,1,4,6,10,9,6,13,6,12,8,12,13,11,8,14,12,11,12,13,11,12,12,12,12,9,10,14,13,15,14,13,13,13,13,10,13,14,20,14,13,13,7,13,10,13,12,12,9,12,14,13,12,8,20,18,12,1,20,9,10,D/WB R,112,1,1,1,1,1,1,10,9,20,1,1,1,12,8,18,1125900000000000.0,0,0,0,0,0,0,0,0,0,0,0,0,0,0,0,0,0,0,0,0,0,0,0,0,0,0,0,0,0,0,0,0,0,0,0,0,0,0,0,0,0,0,0,0,0,0,0,0,Antonio BarragÃ¡n,Â£2.25m ,33.0,186.0,Defender - Right-Back,right,Elche CF,27.0,0.0,0.0,2286.0,31.0,0.0,6.0,2426.0,24.0,0.0,1.0,1699.0,14.0,0.0,2.0,847.0,2.0,0.0,0.0,180.0,LaLiga,15-07-16,17.3.2.23,Antonio BarragÃ¡n,1504803,796,12-Jun-87,29,0,0,1,0,5250,6750,6750,144,136,15694572,186,83,D/WB R,2,1,3,1,3,2,2,1,1,3,3,9,13,12,7,12,8,12,11,16,14,11,8,12,12,12,13,13,12,13,11,13,12,11,9,15,13,16,16,13,12,10,14,10,13,15,20,15,14,14,9,12,12,13,11,13,6,14,16,14,14,8,Antonio BarragÃ¡n,Â£2.70m ,Premier League
19-06-17,18.3.4.28,Sergio SÃ¡nchez,1507596,796,03-Apr-86,31,0,0,4,0,4900,6250,6250,140,123,232186002,185,78,D RC,1,2,4,3,3,3,1,1,2,3,3,6,12,8,8,12,6,14,7,10,15,13,8,13,12,16,14,14,12,14,8,13,16,7,13,10,13,12,13,11,11,12,12,10,12,11,20,12,11,15,16,10,9,13,8,13,14,12,11,8,9,12,20,7,1,1,15,1,20,D RC,103,1,1,1,1,1,1,20,1,15,10,1,1,1,1,7,131072.0,0,0,0,0,0,0,0,0,0,0,0,0,0,0,0,0,0,1,0,0,0,0,0,0,0,0,0,0,0,0,0,0,0,0,0,0,0,0,0,0,0,0,0,0,0,0,0,0,Sergio SÃ¡nchez,Â£900Th. ,34.0,185.0,Defender - Centre-Back,right,Without Club,20.0,0.0,0.0,1736.0,4.0,0.0,0.0,236.0,22.0,1.0,1.0,1918.0,2.0,0.0,0.0,180.0,nan,nan,nan,nan,LaLiga
19-06-17,18.3.4.28,Anaitz Arbilla,1509367,796,15-May-87,30,0,0,0,0,4250,6450,6450,132,130,232186002,177,75,D/WB RLC,3,1,2,3,2,1,4,2,3,2,3,10,11,12,9,10,14,10,15,12,11,10,9,13,10,12,11,14,9,14,9,12,10,9,7,12,13,15,14,13,13,10,9,15,12,12,20,14,10,14,7,4,8,17,12,11,8,8,10,11,10,7,20,20,15,15,20,19,15,D/WB RLC,116,1,1,1,15,1,1,10,19,20,1,10,9,15,15,20,4672930000000.0,0,0,0,0,0,0,0,0,1,1,0,0,0,0,0,0,0,0,0,0,1,0,0,0,0,0,0,0,0,0,0,0,0,0,0,0,0,0,1,0,0,0,1,0,0,0,0,0,Anaitz Arbilla,Â£1.80m ,33.0,178.0,Defender - Centre-Back,right,SD Eibar,23.0,0.0,2.0,1662.0,31.0,2.0,1.0,2452.0,27.0,1.0,3.0,2123.0,24.0,1.0,0.0,2007.0,5.0,0.0,1.0,278.0,LaLiga,15-07-16,17.3.2.23,Anaitz Arbilla,1509367,796,15-May-87,29,0,0,0,0,4250,6450,6450,132,130,4378363,177,75,D/WB RLC,3,2,2,3,1,2,3,2,2,3,3,10,11,12,9,10,14,10,15,12,11,10,9,13,10,12,11,14,9,14,9,12,10,9,7,12,13,15,14,13,13,10,9,15,12,12,20,14,10,14,7,4,8,17,12,11,8,8,10,11,10,7,Anaitz Arbilla,Â£1.35m ,LaLiga
19-06-17,18.3.4.28,Carlos MartÃ­nez,1511410,796,09-Apr-86,31,0,0,0,0,4000,6400,6400,138,128,2727346,189,79,D R,2,2,3,2,1,3,3,1,1,1,2,5,10,10,6,12,2,10,3,10,12,10,4,14,12,16,14,18,15,14,12,11,12,13,10,13,15,16,17,11,9,11,15,13,11,14,20,17,14,14,10,11,15,13,13,10,15,11,14,14,10,8,20,15,1,1,20,1,10,D R,102,1,1,1,1,1,1,10,1,20,1,1,1,1,1,15,1099510000000.0,0,0,0,0,0,1,0,0,0,0,0,0,0,0,0,0,0,0,0,0,0,0,0,0,0,0,0,0,0,0,0,0,0,0,0,0,0,0,0,0,1,0,0,0,0,0,0,0,Carlos MartÃ­nez,Â£450Th. ,34.0,189.0,Defender - Right-Back,right,Retired,11.0,0.0,3.0,959.0,2.0,0.0,0.0,92.0,15.0,0.0,1.0,1085.0,17.0,0.0,0.0,1027.0,nan,nan,nan,nan,LaLiga,15-07-16,17.3.2.23,Carlos MartÃ­nez,1511410,796,09-Apr-86,30,0,0,0,0,4000,6250,6250,138,128,1729985,189,79,D R,2,1,3,2,3,2,1,3,1,1,1,5,10,10,6,12,2,10,3,10,12,10,4,14,12,16,14,18,15,14,12,11,12,13,10,13,15,16,17,11,9,11,15,13,11,14,20,17,14,14,10,11,14,13,13,12,15,11,14,14,10,8,Carlos MartÃ­nez,Â£900Th. ,LaLiga
19-06-17,18.3.4.28,Coke,1511783,796,26-Apr-87,30,0,0,0,0,5200,6700,6700,139,134,232186002,177,74,D/WB R,1,2,2,3,2,2,1,3,1,3,2,8,14,10,11,13,8,15,12,14,10,12,12,13,12,17,14,16,15,16,11,12,18,11,18,15,10,13,17,11,13,15,11,12,14,12,20,14,10,16,9,18,8,15,8,15,15,16,18,14,10,5,20,20,15,15,20,1,10,D/WB R,112,1,1,1,1,1,15,10,1,20,10,10,1,15,1,20,1024.0,0,0,0,0,0,0,0,0,0,0,1,0,0,0,0,0,0,0,0,0,0,0,0,0,0,0,0,0,0,0,0,0,0,0,0,0,0,0,0,0,0,0,0,0,0,0,0,0,Coke,Â£1.80m ,33.0,176.0,Defender - Right-Back,right,Levante UD,8.0,1.0,0.0,629.0,20.0,3.0,0.0,1566.0,30.0,5.0,1.0,2084.0,20.0,3.0,0.0,1288.0,1.0,0.0,0.0,5.0,LaLiga,15-07-16,17.3.2.23,Coke,1511783,796,26-Apr-87,29,0,0,0,0,5350,6850,6850,139,137,12032793,177,74,D/WB R,2,2,2,4,2,4,2,2,2,1,1,8,12,10,13,11,8,15,12,14,10,10,12,13,11,17,13,16,12,14,10,11,18,11,18,15,10,13,17,14,13,15,11,12,14,13,20,16,11,16,9,18,8,15,10,15,15,16,18,14,10,5,Coke,Â£3.60m ,Bundesliga
19-06-17,18.3.4.28,Roberto Rosales,18011736,1658,20-Nov-88,28,68,0,4,0,5900,7300,6900,146,138,12957719,175,71,D/WB R,1,3,2,2,2,2,3,3,2,4,2,13,15,15,7,14,10,11,12,12,12,13,8,15,14,12,12,16,14,10,9,10,12,9,8,13,14,11,14,15,15,12,9,8,15,15,20,16,12,12,12,15,10,12,14,12,13,11,14,12,13,4,20,19,12,8,20,5,1,D/WB R,112,1,1,1,1,1,8,1,5,20,1,1,1,12,1,19,32.0,0,0,0,0,0,1,0,0,0,0,0,0,0,0,0,0,0,0,0,0,0,0,0,0,0,0,0,0,0,0,0,0,0,0,0,0,0,0,0,0,0,0,0,0,0,0,0,0,Roberto Rosales,Â£2.25m ,31.0,174.0,Defender - Right-Back,right,CD LeganÃ©s,34.0,1.0,2.0,3041.0,36.0,1.0,0.0,3130.0,26.0,3.0,2.0,2230.0,28.0,0.0,1.0,2173.0,3.0,1.0,0.0,252.0,LaLiga,15-07-16,17.3.2.23,Roberto Rosales,18011736,1658,20-Nov-88,27,66,0,0,0,6300,7300,7300,146,146,21903412,175,72,D/WB R,1,3,2,2,3,3,1,2,2,1,2,13,15,15,7,14,10,12,12,12,13,13,9,16,14,12,12,16,14,11,9,14,12,10,8,13,14,11,14,15,15,12,9,8,15,15,20,16,12,14,12,15,10,12,14,12,13,11,14,12,13,4,Roberto Rosales,Â£4.50m ,LaLiga
19-06-17,18.3.4.28,Michel,19019226,1651,15-Feb-90,27,0,0,3,0,5250,6300,6450,141,129,3742775,174,67,D/WB R,1,3,1,1,2,2,1,2,3,2,3,12,14,13,12,12,10,7,10,11,12,12,11,12,12,11,13,12,12,11,11,12,14,12,7,15,12,11,12,15,15,11,7,11,14,14,20,15,8,12,8,8,12,13,19,14,10,12,11,12,14,10,20,19,11,1,20,1,1,D/WB R,112,1,1,1,1,1,1,1,1,20,1,1,1,11,1,19,32.0,0,0,0,0,0,1,0,0,0,0,0,0,0,0,0,0,0,0,0,0,0,0,0,0,0,0,0,0,0,0,0,0,0,0,0,0,0,0,0,0,0,0,0,0,0,0,0,0,MÃ­chel,Â£1.62m ,30.0,177.0,Defender - Right-Back,right,Sport Club Corinthians Paulista,26.0,0.0,4.0,2149.0,28.0,0.0,2.0,2136.0,11.0,1.0,0.0,718.0,7.0,0.0,0.0,426.0,nan,nan,nan,nan,LaLiga,15-07-16,17.3.2.23,Michel,19019226,1651,15-Feb-90,26,0,0,3,0,4750,6300,6600,145,132,6303085,174,67,D/WB R,3,1,2,1,2,2,2,3,4,2,3,12,14,13,12,12,10,7,10,11,12,12,11,12,12,11,13,12,12,11,11,12,14,12,7,15,13,11,12,15,15,11,7,11,14,14,20,16,9,13,8,8,12,13,19,16,12,11,13,12,14,9,MÃ­chel,Â£2.25m ,LaLiga
19-06-17,18.3.4.28,Djene Dakonam,211232,50,31-Dec-91,25,30,0,0,0,5200,6450,6450,135,130,3847149,176,71,D/DM RC,3,2,3,2,4,3,2,3,3,2,1,9,11,9,5,11,7,7,8,11,14,9,8,13,10,11,12,13,12,14,11,12,10,8,9,11,12,12,15,15,14,11,7,11,15,14,20,14,12,12,10,6,11,15,6,14,11,12,11,11,16,3,20,15,12,1,19,14,20,D/DM RC,113,1,1,1,1,1,1,20,14,19,18,12,1,1,14,15,0.0,0,0,0,0,0,0,0,0,0,0,0,0,0,0,0,0,0,0,0,0,0,0,0,0,0,0,0,0,0,0,0,0,0,0,0,0,0,0,0,0,0,0,0,0,0,0,0,0,nan,nan,nan,nan,nan,nan,nan,nan,nan,nan,nan,nan,nan,nan,nan,nan,nan,nan,nan,nan,nan,nan,nan,nan,nan,nan,nan,nan,
19-06-17,18.3.4.28,Sime Vrsaljko,24004437,761,10-Jan-92,25,26,0,12,0,5950,7300,7300,156,146,20766118,181,76,D/WB/M R,3,1,2,3,1,1,4,2,1,3,2,9,14,10,4,11,3,13,7,12,15,11,8,15,12,15,14,15,9,10,10,13,17,8,10,12,13,12,15,14,14,14,13,9,18,16,20,19,13,10,10,10,8,18,18,18,12,15,14,4,7,8,20,19,18,1,20,14,1,D/WB/M R,122,1,1,1,1,1,1,1,14,20,1,1,12,18,13,19,134217826.0,0,1,0,0,0,1,1,0,0,0,0,0,0,0,0,0,0,0,0,0,0,0,0,0,0,0,0,1,0,0,0,0,0,0,0,0,0,0,0,0,0,0,0,0,0,0,0,0,Sime Vrsaljko,Â£22.50m ,28.0,181.0,Defender - Right-Back,right,AtlÃ©tico Madrid,25.0,1.0,2.0,1794.0,29.0,0.0,5.0,2134.0,13.0,0.0,2.0,912.0,7.0,0.0,1.0,482.0,nan,nan,nan,nan,LaLiga,15-07-16,17.3.2.23,Sime Vrsaljko,24004437,761,10-Jan-92,24,21,0,12,0,5950,7450,7450,162,149,27744767,183,75,D/WB/M R,1,3,2,3,1,3,4,1,3,1,3,9,14,10,4,12,3,13,7,12,15,12,8,15,13,15,14,15,9,11,10,13,17,8,10,12,13,12,15,14,14,14,13,9,18,16,20,19,13,11,10,10,8,18,18,18,12,15,14,4,7,8,Sime Vrsaljko,Â£14.40m ,LaLiga
19-06-17,18.3.4.28,Pablo Maffeo,28095341,796,12-Jul-97,19,0,0,0,0,4500,6250,6250,131,125,15426436,173,0,D/WB R,3,1,2,2,2,3,1,3,1,2,3,6,11,13,7,10,7,13,9,10,12,12,4,13,13,13,12,14,10,12,9,13,14,13,10,13,12,14,14,14,13,13,12,12,18,13,20,13,13,14,12,11,11,8,16,11,12,12,12,8,11,8,20,17,10,1,20,1,1,D/WB R,112,1,1,1,1,1,1,1,1,20,1,1,1,10,1,17,0.0,0,0,0,0,0,0,0,0,0,0,0,0,0,0,0,0,0,0,0,0,0,0,0,0,0,0,0,0,0,0,0,0,0,0,0,0,0,0,0,0,0,0,0,0,0,0,0,0,Pablo Maffeo,Â£9.00m ,23.0,172.0,Defender - Right-Back,right,SD Huesca,20.0,1.0,2.0,1624.0,34.0,0.0,2.0,2713.0,9.0,0.0,0.0,691.0,35.0,0.0,2.0,2762.0,4.0,1.0,0.0,340.0,LaLiga
19-06-17,18.3.4.28,SÃ©bastien Corchia,34002343,769,01-Nov-90,26,1,0,26,3,5500,6750,6750,139,135,8366675,176,64,D/WB R,2,1,2,1,2,3,1,1,2,3,1,12,13,12,7,13,13,11,11,11,14,13,11,14,13,13,13,14,13,13,11,13,17,12,11,10,12,14,14,14,14,12,8,8,17,14,20,15,12,14,12,13,5,12,16,15,15,14,17,15,14,7,20,16,15,14,20,12,1,D/WB R,112,1,1,1,1,1,14,1,12,20,1,1,1,15,12,16,2251800000000000.0,0,0,0,0,0,0,0,0,0,0,0,0,0,0,0,0,0,0,0,0,0,0,0,0,0,0,0,0,0,0,0,0,0,0,0,0,0,0,0,0,0,0,0,0,0,0,0,0,SÃ©bastien Corchia,Â£3.60m ,29.0,176.0,Defender - Right-Back,right,FC Nantes,42.0,2.0,4.0,3778.0,20.0,0.0,3.0,1377.0,12.0,0.0,0.0,906.0,7.0,0.0,1.0,630.0,1.0,0.0,0.0,90.0,LaLiga,15-07-16,17.3.2.23,SÃ©bastien Corchia,34002343,769,01-Nov-90,25,0,0,26,3,5193,6793,6793,139,136,11409610,176,64,D/WB R,2,2,3,1,4,2,1,1,2,2,3,12,13,12,7,13,13,11,11,11,14,13,11,14,13,13,13,14,13,13,11,13,17,12,11,10,12,14,14,14,14,12,8,8,17,14,20,15,12,14,12,13,5,12,20,15,15,14,16,15,15,7,SÃ©bastien Corchia,Â£6.75m ,Ligue 1
19-06-17,18.3.4.28,Daniele Bonera,3801706,776,31-May-81,36,16,0,34,0,5500,6500,6250,142,127,289222,183,74,D RC,1,2,1,1,1,1,1,3,2,3,3,2,9,8,4,10,2,14,8,13,16,11,5,14,11,13,14,13,15,14,9,13,14,5,15,10,16,15,14,10,9,10,11,9,9,11,20,13,13,13,15,8,15,12,13,13,17,13,16,15,16,8,20,2,1,1,18,10,20,D RC,103,1,1,1,1,1,1,20,10,18,1,1,1,1,1,2,0.0,0,0,0,0,0,0,0,0,0,0,0,0,0,0,0,0,0,0,0,0,0,0,0,0,0,0,0,0,0,0,0,0,0,0,0,0,0,0,0,0,0,0,0,0,0,0,0,0,Daniele Bonera,Â£180Th. ,39.0,183.0,Defender - Centre-Back,right,Retired,10.0,0.0,0.0,900.0,21.0,0.0,2.0,1730.0,11.0,0.0,0.0,726.0,nan,nan,nan,nan,nan,nan,nan,nan,LaLiga,15-07-16,17.3.2.23,Daniele Bonera,3801706,776,31-May-81,35,16,0,34,0,5500,6500,6500,142,131,299658,183,74,D RC,3,2,2,3,1,1,1,3,3,1,1,2,9,8,4,10,2,14,8,13,16,11,5,14,11,13,14,13,15,14,9,13,14,5,15,10,16,15,14,11,11,10,11,9,9,11,20,13,13,13,15,8,15,12,13,13,17,13,16,15,16,8,Daniele Bonera,Â£180Th. ,LaLiga
19-06-17,18.3.4.28,Miguel LayÃºn,51000344,379,25-Jun-88,28,55,4,0,0,4750,6550,6950,149,139,10202024,179,73,D/WB RL,1,1,2,2,3,2,4,3,2,1,1,16,16,12,11,13,14,8,13,10,11,14,15,12,14,14,11,13,14,12,13,13,17,12,14,13,12,13,13,14,13,12,8,10,14,14,20,14,9,15,9,12,4,18,16,16,13,15,17,15,16,8,20,18,12,12,20,20,12,D/WB RL,115,1,1,1,1,12,9,10,20,20,1,12,8,12,18,15,2251800000000000.0,0,0,0,0,0,1,0,0,0,0,0,0,0,0,0,0,0,0,0,0,0,0,0,0,0,0,0,0,0,0,0,0,0,0,0,0,0,0,0,0,0,0,0,0,0,0,0,0,Miguel LayÃºn,Â£4.50m ,32.0,178.0,Midfielder - Right Midfield,right,CF Monterrey,25.0,3.0,4.0,1607.0,32.0,4.0,0.0,1786.0,34.0,1.0,3.0,2607.0,36.0,5.0,2.0,2567.0,15.0,0.0,2.0,772.0,LaLiga,15-07-16,17.3.2.23,Miguel LayÃºn,51000344,379,25-Jun-88,28,43,3,0,0,4500,6550,7250,149,145,16205240,179,73,D/WB RL,1,2,3,1,4,3,3,2,2,3,3,16,17,12,11,13,12,8,13,10,11,15,15,12,14,10,12,11,14,12,15,13,17,12,9,14,11,13,13,15,13,12,8,11,14,15,20,14,9,15,9,12,4,18,15,16,13,15,17,15,16,8,Miguel LayÃºn,Â£5.40m ,Liga NOS
19-06-17,18.3.4.28,NÃ©lson Semedo,55061470,788,16-Nov-93,23,6,0,0,0,5500,7050,7500,164,150,34090851,177,67,D R,1,3,2,2,3,1,1,2,2,2,2,8,12,15,11,15,8,7,12,11,11,12,8,14,16,13,14,14,14,13,11,13,15,14,6,16,13,14,15,17,16,13,8,12,15,16,20,15,11,14,11,15,7,15,16,13,14,15,17,13,10,10,20,15,14,11,20,1,14,D R,102,1,1,1,1,1,11,1,1,20,13,14,1,14,1,15,34.0,0,1,0,0,0,1,0,0,0,0,0,0,0,0,0,0,0,0,0,0,0,0,0,0,0,0,0,0,0,0,0,0,0,0,0,0,0,0,0,0,0,0,0,0,0,0,0,0,NÃ©lson Semedo,Â£27.00m ,26.0,177.0,Defender - Right-Back,right,Wolverhampton Wanderers,47.0,2.0,12.0,4217.0,36.0,0.0,2.0,2494.0,46.0,1.0,3.0,2886.0,42.0,1.0,6.0,2993.0,4.0,0.0,0.0,331.0,LaLiga,15-07-16,17.3.2.23,NÃ©lson Semedo,55061470,788,16-Nov-93,22,1,0,0,0,4500,7050,7250,159,145,26900699,177,69,D R,4,3,1,1,1,1,1,2,2,1,2,8,12,15,11,14,8,7,12,11,11,12,8,14,16,15,13,14,14,13,11,12,14,14,6,16,12,13,15,17,16,13,8,12,15,16,20,14,11,11,11,15,9,15,16,13,14,12,15,13,10,10,NÃ©lson Semedo,Â£18.00m ,Liga NOS
19-06-17,18.3.4.28,RÃºben Vezo,55067158,788,25-Apr-94,23,0,0,5,2,4768,6024,6750,148,136,9498924,182,80,D RC,2,2,3,3,1,2,1,3,1,3,3,6,10,11,6,12,7,13,7,12,13,12,10,13,13,9,13,14,14,10,12,13,13,6,11,11,14,15,15,15,15,12,14,11,15,14,20,16,11,11,8,10,7,12,11,12,14,10,17,13,14,5,20,1,1,1,16,7,20,D RC,103,1,1,1,1,1,1,20,7,16,10,1,1,1,1,1,0.0,0,0,0,0,0,0,0,0,0,0,0,0,0,0,0,0,0,0,0,0,0,0,0,0,0,0,0,0,0,0,0,0,0,0,0,0,0,0,0,0,0,0,0,0,0,0,0,0,RÃºben Vezo,Â£5.40m ,26.0,182.0,Defender - Centre-Back,right,Levante UD,20.0,0.0,1.0,1624.0,26.0,1.0,0.0,2142.0,27.0,2.0,1.0,2082.0,30.0,0.0,1.0,2700.0,4.0,0.0,0.0,360.0,LaLiga,15-07-16,17.3.2.23,RÃºben Vezo,55067158,788,25-Apr-94,22,0,0,5,2,5200,6000,6550,142,133,7795405,184,76,D RC,1,1,1,3,3,3,2,2,3,3,4,6,10,11,6,12,7,14,7,12,13,12,10,11,12,9,13,13,16,11,11,12,12,6,11,10,13,14,14,15,15,12,14,11,15,14,20,16,12,11,8,10,7,12,11,12,14,10,16,13,14,5,RÃºben Vezo,Â£1.35m ,LaLiga
19-06-17,18.3.4.28,Antonio Rukavina,5754526,802,26-Jan-84,33,39,0,8,0,5300,6850,6450,135,129,1166463,177,73,D/WB R,1,2,3,1,1,2,1,3,3,3,2,11,12,12,8,12,8,6,11,12,13,12,14,13,11,13,13,16,11,15,8,13,12,8,11,15,14,16,17,14,10,11,9,8,13,15,20,14,12,13,9,13,6,12,14,12,13,11,14,13,15,5,20,18,13,1,20,12,1,D/WB R,112,1,1,1,1,1,1,1,12,20,1,1,1,13,10,18,274878000000.0,0,0,0,0,0,0,0,0,0,0,0,0,0,0,0,0,0,0,0,0,0,0,0,0,0,0,0,0,0,0,0,0,0,0,0,0,0,0,1,0,0,0,0,0,0,0,0,0,Antonio Rukavina,Â£900Th. ,36.0,177.0,Defender - Right-Back,right,FC Astana,12.0,0.0,1.0,991.0,27.0,0.0,0.0,2169.0,43.0,0.0,2.0,3900.0,19.0,0.0,4.0,1603.0,nan,nan,nan,nan,LaLiga,15-07-16,17.3.2.23,Antonio Rukavina,5754526,802,26-Jan-84,32,33,0,8,0,5300,6650,6600,135,132,664015,177,73,D/WB R,3,2,3,4,2,1,3,2,2,3,1,11,12,12,8,12,8,6,11,12,13,12,14,13,11,13,13,16,11,15,8,13,12,8,11,15,14,16,17,15,10,11,9,8,13,15,20,14,12,13,9,13,6,12,14,12,13,11,14,13,15,5,Antonio Rukavina,Â£1.35m ,LaLiga
19-06-17,18.3.4.28,Javi LÃ³pez,67006184,796,21-Jan-86,31,0,0,0,0,4000,6250,6250,141,125,1429170,179,74,D/WB/M RC,2,2,3,2,3,3,1,3,1,2,1,9,12,11,8,11,8,7,10,11,12,13,6,13,11,13,12,14,11,13,11,11,9,8,13,14,14,15,16,12,12,13,8,12,13,12,20,13,11,15,9,10,11,17,13,11,11,12,12,12,17,2,20,18,19,14,20,10,15,D/WB/M RC,123,1,1,1,1,8,14,1,5,20,14,15,10,19,8,18,0.0,0,0,0,0,0,0,0,0,0,0,0,0,0,0,0,0,0,0,0,0,0,0,0,0,0,0,0,0,0,0,0,0,0,0,0,0,0,0,0,0,0,0,0,0,0,0,0,0,Javi LÃ³pez,Â£900Th. ,34.0,180.0,Defender - Right-Back,right,Without Club,20.0,0.0,1.0,1614.0,15.0,0.0,0.0,1039.0,25.0,0.0,0.0,2159.0,28.0,1.0,1.0,2375.0,nan,nan,nan,nan,LaLiga,15-07-16,17.3.2.23,Javi LÃ³pez,67006184,796,21-Jan-86,30,0,0,0,0,4000,6500,6500,141,131,232186002,179,74,D/WB/M RC,3,3,1,2,3,1,2,3,3,1,1,9,12,11,8,11,8,7,10,11,12,13,7,13,11,13,12,14,12,13,11,12,6,8,13,14,14,15,16,13,13,13,8,12,13,12,20,14,11,15,9,11,5,17,15,14,14,13,14,11,15,5,Javi LÃ³pez,Â£1.80m ,LaLiga
19-06-17,18.3.4.28,Diego Llorente,67011217,796,16-Aug-93,23,1,0,6,0,5150,7100,7100,153,145,25807228,186,75,D RC,2,2,3,1,1,3,1,2,2,3,3,8,10,9,6,14,6,14,6,13,15,13,9,16,14,15,14,18,12,15,9,15,8,6,11,7,16,15,16,12,11,8,13,10,12,13,20,14,13,13,12,10,8,15,9,9,13,12,9,12,18,6,20,10,1,1,17,12,20,D RC,103,1,1,1,1,1,1,20,12,17,12,1,1,1,1,10,32.0,0,0,0,0,0,1,0,0,0,0,0,0,0,0,0,0,0,0,0,0,0,0,0,0,0,0,0,0,0,0,0,0,0,0,0,0,0,0,0,0,0,0,0,0,0,0,0,0,Diego Llorente,Â£15.75m ,27.0,186.0,Defender - Centre-Back,right,Leeds United,27.0,2.0,0.0,2209.0,34.0,7.0,0.0,2912.0,23.0,0.0,0.0,1931.0,30.0,1.0,2.0,2418.0,1.0,0.0,0.0,90.0,LaLiga,15-07-16,17.3.2.23,Diego Llorente,67011217,796,16-Aug-93,22,1,0,7,0,4500,7100,7100,160,142,10034255,186,75,D RC,2,2,2,3,3,1,2,1,2,2,3,8,10,9,6,14,6,14,6,13,15,13,9,16,14,15,14,18,11,15,9,15,11,6,11,7,16,15,16,12,10,8,13,10,12,12,20,14,13,11,12,10,9,15,9,12,13,11,11,12,10,2,Diego Llorente,Â£6.75m ,LaLiga
19-06-17,18.3.4.28,Miguel Torres,67011252,796,28-Jan-86,31,0,0,12,0,4250,6700,6300,134,126,232186002,185,81,D RLC,2,1,2,3,1,1,1,2,1,1,2,12,14,11,3,14,11,13,9,16,14,12,7,15,14,14,14,16,13,16,10,12,10,5,11,7,13,17,16,11,11,8,12,10,11,12,20,11,11,10,13,14,12,19,9,10,18,14,16,13,17,3,20,14,8,1,20,19,17,D RLC,106,1,1,1,1,1,1,17,19,20,8,3,8,8,10,14,4294967296.0,0,0,0,0,0,0,0,0,0,0,0,0,0,0,0,0,0,0,0,0,0,0,0,0,0,0,0,0,0,0,0,0,1,0,0,0,0,0,0,0,0,0,0,0,0,0,0,0,Miguel Torres,Â£720Th. ,34.0,184.0,Defender - Right-Back,right,Retired,23.0,0.0,0.0,1654.0,8.0,0.0,0.0,676.0,1.0,0.0,0.0,22.0,nan,nan,nan,nan,nan,nan,nan,nan,LaLiga,15-07-16,17.3.2.23,Miguel Torres,67011252,796,28-Jan-86,30,0,0,12,0,4250,6750,6750,138,135,4094926,185,81,D RLC,3,2,2,3,1,2,3,1,2,2,1,12,14,11,4,14,11,13,9,16,15,11,7,16,14,15,14,16,13,16,10,12,12,4,11,8,15,17,16,11,11,8,12,10,12,12,20,15,11,12,13,14,12,19,9,10,18,14,16,13,17,3,Miguel Torres,Â£1.80m ,LaLiga
19-06-17,18.3.4.28,Eneko BÃ³veda,67018261,796,14-Dec-88,28,0,0,0,0,4400,6500,6500,134,132,4818967,180,78,D/WB RLC,3,2,2,3,2,2,1,3,2,3,2,4,11,11,3,10,6,12,8,14,12,12,4,14,12,11,14,14,13,14,10,13,15,9,11,13,14,14,15,13,12,13,11,10,11,14,20,15,13,13,10,11,13,14,11,11,14,11,15,10,16,6,20,18,14,9,20,15,18,D/WB RLC,116,1,1,1,1,1,9,18,15,20,1,1,1,14,11,18,0.0,0,0,0,0,0,0,0,0,0,0,0,0,0,0,0,0,0,0,0,0,0,0,0,0,0,0,0,0,0,0,0,0,0,0,0,0,0,0,0,0,0,0,0,0,0,0,0,0,Eneko BÃ³veda,Â£1.35m ,31.0,182.0,Defender - Right-Back,right,Deportivo de La CoruÃ±a,23.0,0.0,0.0,1839.0,16.0,0.0,1.0,1326.0,24.0,0.0,1.0,1907.0,32.0,1.0,4.0,2725.0,2.0,1.0,0.0,149.0,LaLiga,15-07-16,17.3.2.23,Eneko BÃ³veda,67018261,796,14-Dec-88,27,0,0,0,0,4400,6500,6500,134,132,3977706,180,78,D/WB RL,1,1,1,2,4,1,3,4,1,4,3,4,11,11,3,10,6,12,8,14,12,12,4,14,12,11,14,14,13,14,10,13,15,9,11,13,14,14,15,13,12,13,11,10,11,14,20,15,13,13,10,11,13,14,16,10,14,12,15,8,18,5,Eneko BÃ³veda,Â£2.70m ,LaLiga
19-06-17,18.3.4.28,Aday,67029382,796,16-Dec-87,29,0,0,0,0,3400,6250,6250,127,126,3131555,179,78,D/WB/M/AM RL,1,2,1,3,4,2,1,2,3,2,1,11,13,13,8,13,8,7,9,11,7,12,7,7,14,11,11,12,11,11,12,12,12,13,10,14,9,11,11,13,13,12,7,12,11,13,20,12,9,14,12,7,11,18,17,12,13,11,12,9,8,7,19,18,20,18,20,19,1,D/WB/M/AM RL,445,1,1,1,1,10,18,1,19,15,1,1,15,20,16,18,2.0,0,1,0,0,0,0,0,0,0,0,0,0,0,0,0,0,0,0,0,0,0,0,0,0,0,0,0,0,0,0,0,0,0,0,0,0,0,0,0,0,0,0,0,0,0,0,0,0,Aday,Â£1.80m ,32.0,178.0,Defender - Left-Back,right,Girona FC,35.0,0.0,9.0,2598.0,32.0,2.0,0.0,1840.0,10.0,0.0,2.0,647.0,33.0,2.0,2.0,2337.0,2.0,0.0,0.0,135.0,LaLiga
19-06-17,18.3.4.28,Nacho,67030696,796,18-Jan-90,27,8,0,6,0,6500,7750,7750,158,154,61125395,180,77,D RLC,1,2,2,4,3,3,3,3,3,3,4,7,12,10,10,13,8,14,8,12,14,13,7,16,10,15,15,13,13,17,11,14,14,9,13,12,15,17,16,16,12,14,11,13,15,15,20,15,14,19,8,15,3,20,19,10,20,13,18,16,16,1,20,12,1,1,18,18,20,D RLC,106,1,13,1,1,1,1,20,18,18,1,1,1,1,12,12,0.0,0,0,0,0,0,0,0,0,0,0,0,0,0,0,0,0,0,0,0,0,0,0,0,0,0,0,0,0,0,0,0,0,0,0,0,0,0,0,0,0,0,0,0,0,0,0,0,0,nan,nan,nan,nan,nan,nan,nan,nan,nan,nan,nan,nan,nan,nan,nan,nan,nan,nan,nan,nan,nan,nan,nan,nan,nan,nan,nan,nan,15-07-16,17.3.2.23,Nacho,67030696,796,18-Jan-90,26,4,0,6,0,6250,7500,7500,155,150,26630080,179,75,D RLC,3,3,3,2,1,2,1,2,1,3,1,7,12,10,9,13,8,14,8,12,14,13,7,16,10,15,15,13,13,17,11,13,14,9,13,11,15,17,16,15,12,14,11,13,14,14,20,15,14,19,8,14,3,19,10,10,20,13,18,16,16,1,nan,nan,nan
19-06-17,18.3.4.28,Luis HernÃ¡ndez,67030712,796,14-Apr-89,28,0,0,0,0,5000,6900,6900,144,138,13719938,183,75,D RC,3,1,2,2,3,2,1,2,2,3,1,11,13,11,6,11,7,13,10,20,14,13,10,16,14,13,15,14,13,11,10,11,12,9,12,10,16,14,13,14,13,10,12,10,14,14,20,16,12,12,8,16,5,14,15,13,11,9,14,12,12,2,20,10,1,1,19,1,20,D RC,103,1,1,1,1,1,1,20,1,19,1,1,1,1,1,10,1125900000000000.0,0,0,0,0,0,0,0,0,0,0,0,0,0,0,0,0,0,0,0,0,0,0,0,0,0,0,0,0,0,0,0,0,0,0,0,0,0,0,0,0,0,0,0,0,0,0,0,0,Luis HernÃ¡ndez,Â£2.25m ,31.0,182.0,Defender - Centre-Back,right,Maccabi Tel Aviv,29.0,1.0,1.0,2512.0,38.0,0.0,1.0,3420.0,26.0,1.0,1.0,2250.0,29.0,0.0,1.0,2399.0,2.0,0.0,0.0,96.0,LaLiga,15-07-16,17.3.2.23,Luis HernÃ¡ndez,67030712,796,14-Apr-89,27,0,0,0,0,5000,6500,6500,131,130,4763390,183,75,D RC,1,3,1,1,3,2,1,1,2,3,1,11,13,11,9,11,8,11,9,20,13,12,8,14,14,12,13,14,14,14,12,13,12,9,12,13,14,14,13,13,12,9,11,10,14,12,20,14,12,15,8,16,5,14,10,12,9,14,17,11,16,2,Luis HernÃ¡ndez,Â£2.70m ,Premier League
19-06-17,18.3.4.28,VÃ­ctor SÃ¡nchez,67046419,796,08-Aug-87,29,0,0,0,0,4750,7000,7000,148,142,16997670,174,73,D/DM/M RC,3,3,3,2,3,3,2,2,3,1,1,7,11,10,8,13,6,10,8,11,12,14,8,12,13,15,12,15,13,16,13,15,18,8,14,14,16,18,18,14,12,10,8,12,14,12,20,15,11,14,11,10,5,18,14,10,15,10,17,13,12,3,16,15,19,11,16,13,19,D/DM/M RC,333,1,1,1,10,1,11,9,13,16,20,19,1,12,10,15,64.0,0,0,0,0,0,0,1,0,0,0,0,0,0,0,0,0,0,0,0,0,0,0,0,0,0,0,0,0,0,0,0,0,0,0,0,0,0,0,0,0,0,0,0,0,0,0,0,0,VÃ­ctor SÃ¡nchez,Â£3.15m ,33.0,174.0,Midfielder - Central Midfield,right,Without Club,27.0,1.0,1.0,2288.0,33.0,0.0,2.0,2728.0,28.0,0.0,3.0,1467.0,34.0,0.0,3.0,2241.0,nan,nan,nan,nan,LaLiga,15-07-16,17.3.2.23,VÃ­ctor SÃ¡nchez,67046419,796,08-Aug-87,28,0,0,0,0,4750,7000,7000,148,142,14007944,174,73,D/DM/M RC,2,1,3,3,4,2,2,1,1,1,1,7,11,10,8,13,6,10,8,11,12,14,8,12,13,15,12,15,13,16,13,15,18,8,14,14,16,18,18,14,12,10,8,13,14,12,20,15,11,14,11,10,5,18,14,10,15,10,17,13,12,3,VÃ­ctor SÃ¡nchez,Â£3.60m ,LaLiga
19-06-17,18.3.4.28,MartÃ­n Montoya,67053464,796,14-Apr-91,26,0,0,22,1,5750,6750,6750,153,137,8464294,175,73,D/WB RL,3,1,1,3,3,3,1,4,3,3,3,8,13,13,9,12,5,11,11,13,12,13,8,14,12,13,12,15,12,12,11,12,12,10,11,14,13,15,15,15,12,13,9,10,14,15,20,16,12,12,10,13,4,10,12,11,12,11,13,13,13,10,20,17,11,1,20,16,1,D/WB RL,115,1,1,1,1,1,1,1,16,20,1,1,1,11,11,17,32.0,0,0,0,0,0,1,0,0,0,0,0,0,0,0,0,0,0,0,0,0,0,0,0,0,0,0,0,0,0,0,0,0,0,0,0,0,0,0,0,0,0,0,0,0,0,0,0,0,MartÃ­n Montoya,Â£7.20m ,29.0,175.0,Defender - Right-Back,right,Real Betis BalompiÃ©,31.0,2.0,3.0,2400.0,31.0,0.0,4.0,2722.0,29.0,0.0,1.0,2470.0,27.0,0.0,1.0,1901.0,2.0,0.0,0.0,96.0,LaLiga,15-07-16,17.3.2.23,MartÃ­n Montoya,67053464,796,14-Apr-91,25,0,0,22,1,6250,7150,7150,158,142,14541859,174,72,D/WB RL,2,1,2,3,3,3,1,2,1,3,3,8,13,13,9,12,5,9,9,13,13,13,8,14,12,13,13,15,12,15,11,13,12,10,11,14,14,15,15,15,12,13,7,10,14,15,20,16,12,14,10,13,4,10,12,11,12,10,11,12,11,10,MartÃ­n Montoya,Â£9.00m ,LaLiga
19-06-17,18.3.4.28,JonÃ¡s Ramalho,67054790,796,10-Jun-93,24,0,0,0,0,4000,6200,6200,137,125,4220774,181,70,D RC,1,2,3,4,2,1,2,1,2,2,2,3,8,9,4,10,5,13,7,11,13,11,5,13,11,14,13,13,12,12,10,12,11,10,13,9,15,14,15,12,12,11,11,12,14,14,20,14,14,12,9,13,11,12,11,14,12,13,12,10,13,6,20,13,8,1,18,8,20,D RC,103,1,1,1,1,1,1,20,8,18,13,1,1,8,6,13,0.0,0,0,0,0,0,0,0,0,0,0,0,0,0,0,0,0,0,0,0,0,0,0,0,0,0,0,0,0,0,0,0,0,0,0,0,0,0,0,0,0,0,0,0,0,0,0,0,0,JonÃ¡s Ramalho,Â£3.60m ,27.0,185.0,Defender - Centre-Back,right,Girona FC,32.0,2.0,1.0,2836.0,28.0,0.0,0.0,2477.0,27.0,1.0,0.0,2070.0,23.0,0.0,0.0,1735.0,5.0,0.0,0.0,358.0,LaLiga
19-06-17,18.3.4.28,Juanfran,67055268,796,11-Sep-88,28,0,0,0,0,5500,7150,7150,145,143,19815755,179,69,D/WB/M/AM R,3,3,2,2,3,2,4,1,1,2,3,12,16,14,10,13,11,6,13,14,9,13,8,5,14,7,13,14,11,13,13,12,12,14,13,14,12,14,10,15,14,13,12,11,12,16,20,13,9,12,8,11,6,17,12,14,13,10,15,15,8,7,20,18,18,16,20,10,1,D/WB/M/AM R,132,1,1,1,1,10,16,1,1,20,1,1,5,18,1,18,18.0,0,1,0,0,1,0,0,0,0,0,0,0,0,0,0,0,0,0,0,0,0,0,0,0,0,0,0,0,0,0,0,0,0,0,0,0,0,0,0,0,0,0,0,0,0,0,0,0,Juanfran,Â£4.50m ,35.0,181.0,Defender - Right-Back,right,SÃ£o Paulo Futebol Clube,36.0,2.0,3.0,3009.0,30.0,0.0,4.0,2387.0,47.0,0.0,4.0,3498.0,18.0,0.0,0.0,1382.0,nan,nan,nan,nan,LaLiga,15-07-16,17.3.2.23,Juanfran,67055268,796,11-Sep-88,27,0,0,0,0,5500,6900,6900,142,142,11701635,180,69,D/WB/M/AM R,3,2,2,3,2,3,3,2,2,1,3,12,16,14,10,13,11,6,13,14,9,13,8,5,14,7,13,14,11,13,13,12,12,14,13,14,12,14,10,15,14,11,9,11,12,16,20,13,9,12,8,11,6,17,12,14,13,10,15,15,8,7,Juanfran,Â£10.80m ,LaLiga
19-06-17,18.3.4.28,Sergi Roberto,67063007,796,07-Feb-92,25,1,0,13,1,6900,7900,7900,167,160,88071917,178,68,D/WB/DM/M RC,2,3,1,1,1,2,2,1,2,3,2,10,14,13,10,16,8,10,11,10,12,15,12,12,15,11,13,13,15,16,15,14,12,13,9,16,13,17,17,15,12,12,9,12,14,15,20,17,11,15,9,14,8,19,17,13,18,12,17,16,16,4,18,17,20,12,18,1,20,D/WB/DM/M RC,443,1,1,1,12,1,10,1,1,18,17,20,1,15,1,17,2147483748.0,0,0,1,0,0,1,1,0,0,0,0,0,0,0,0,0,0,0,0,0,0,0,0,0,0,0,0,0,0,0,0,1,0,0,0,0,0,0,0,0,0,0,0,0,0,0,0,0,Sergi Roberto,Â£49.50m ,28.0,178.0,Defender - Right-Back,right,FC Barcelona,47.0,1.0,6.0,3567.0,48.0,1.0,8.0,3439.0,44.0,1.0,7.0,3215.0,39.0,1.0,2.0,3020.0,5.0,1.0,0.0,419.0,LaLiga,15-07-16,17.3.2.23,Sergi Roberto,67063007,796,07-Feb-92,24,1,0,13,1,6400,7700,7700,165,156,47200503,178,71,D/WB/DM/M RC,1,2,3,1,2,1,3,4,3,3,1,10,12,13,10,16,8,12,13,10,12,15,12,12,14,11,13,13,15,16,14,14,12,11,9,15,13,18,18,15,13,12,9,12,14,15,20,17,10,15,10,12,9,19,20,13,20,12,17,16,16,4,Sergi Roberto,Â£22.50m ,LaLiga
19-06-17,18.3.4.28,Aleix Vidal,67064771,796,21-Aug-89,27,1,0,0,0,6500,7400,7400,153,149,27970874,177,70,D/WB/M/AM RL,3,1,3,1,2,1,2,1,3,1,3,11,12,15,11,14,8,7,10,13,11,13,12,13,15,12,12,14,11,13,12,13,15,16,9,15,11,13,16,15,13,12,8,12,15,14,20,13,9,14,10,12,7,16,11,16,8,14,13,11,9,10,18,18,18,20,20,16,1,D/WB/M/AM RL,545,1,1,1,1,16,20,1,1,18,1,1,15,18,1,18,2.0,0,1,0,0,0,0,0,0,0,0,0,0,0,0,0,0,0,0,0,0,0,0,0,0,0,0,0,0,0,0,0,0,0,0,0,0,0,0,0,0,0,0,0,0,0,0,0,0,Aleix Vidal,Â£6.75m ,31.0,177.0,Defender - Right-Back,right,Sevilla FC,12.0,2.0,5.0,886.0,25.0,2.0,3.0,1031.0,21.0,0.0,3.0,1298.0,29.0,2.0,5.0,2175.0,0.0,0.0,0.0,0.0,LaLiga,15-07-16,17.3.2.23,Aleix Vidal,67064771,796,21-Aug-89,26,1,0,0,0,6300,7350,7350,153,147,19582922,176,70,D/WB/M/AM RL,2,1,1,1,1,3,4,2,3,1,1,11,12,15,11,14,8,7,10,12,11,13,12,11,15,12,12,14,11,13,12,13,15,16,9,15,10,13,16,15,13,12,8,12,15,14,20,13,9,15,10,12,7,16,11,16,8,14,13,11,9,10,Aleix Vidal,Â£6.75m ,LaLiga
19-06-17,18.3.4.28,Ãscar De Marcos,67065930,796,14-Apr-89,28,0,0,4,0,5750,7250,7250,152,147,40510026,180,76,D/WB/M/AM RC,1,1,2,3,2,3,1,1,2,1,1,10,12,11,11,10,10,11,12,4,11,12,7,12,12,12,12,15,12,13,11,11,13,12,9,15,13,14,16,13,12,11,10,12,14,14,20,18,13,15,5,11,6,20,11,15,12,12,14,11,8,7,20,19,16,20,20,14,20,D/WB/M/AM RC,133,1,1,10,20,12,14,1,12,20,1,16,14,15,13,19,2147483680.0,0,0,0,0,0,1,0,0,0,0,0,0,0,0,0,0,0,0,0,0,0,0,0,0,0,0,0,0,0,0,0,1,0,0,0,0,0,0,0,0,0,0,0,0,0,0,0,0,Ãscar de Marcos,Â£5.40m ,31.0,182.0,Defender - Right-Back,right,Athletic Bilbao,32.0,1.0,4.0,2588.0,28.0,2.0,5.0,2293.0,34.0,1.0,3.0,2650.0,13.0,0.0,2.0,538.0,1.0,0.0,0.0,90.0,LaLiga,15-07-16,17.3.2.23,Ãscar De Marcos,67065930,796,14-Apr-89,27,0,0,4,0,5750,7250,7250,153,147,40510026,180,76,D/WB/M/AM RC,3,2,3,3,2,2,1,2,2,2,2,10,13,11,11,10,10,11,13,4,11,12,7,12,13,12,12,15,12,14,11,11,13,13,9,15,13,14,16,13,12,11,10,12,14,14,20,18,13,15,5,11,4,20,19,15,12,12,14,11,8,7,Ãscar de Marcos,Â£7.20m ,LaLiga
19-06-17,18.3.4.28,Mario,67066949,796,24-Nov-90,26,2,2,2,0,6000,7350,7350,153,147,33511406,178,71,D/WB R,3,1,2,2,3,3,1,2,2,3,2,8,13,12,9,12,6,7,9,13,15,12,8,16,12,13,15,17,13,16,11,14,15,9,14,15,14,16,17,14,14,13,9,12,13,14,20,15,12,17,10,13,8,7,17,12,17,13,16,11,12,4,20,17,10,1,20,1,1,D/WB R,112,1,1,1,1,1,1,1,1,20,1,1,1,10,1,17,64.0,0,0,0,0,0,0,1,0,0,0,0,0,0,0,0,0,0,0,0,0,0,0,0,0,0,0,0,0,0,0,0,0,0,0,0,0,0,0,0,0,0,0,0,0,0,0,0,0,Mauro,Â£900Th. ,29.0,178.0,Midfielder - Defensive Midfield,right,Retired,14.0,0.0,0.0,1163.0,nan,nan,nan,nan,nan,nan,nan,nan,nan,nan,nan,nan,nan,nan,nan,nan,Liga NOS,15-07-16,17.3.2.23,Mario,67009720,796,30-Apr-88,28,0,0,0,0,4000,6000,6000,134,118,891346,184,74,GK ,15,12,13,7,11,5,15,15,10,13,10,4,2,2,3,7,6,8,2,1,3,7,5,1,7,7,12,12,11,12,10,12,11,9,14,10,12,13,13,13,15,12,13,5,14,13,20,13,12,9,5,11,10,11,14,13,11,11,14,14,14,8,Mariano,Â£7.20m ,LaLiga
19-06-17,18.3.4.28,Sergio Postigo,67072387,796,04-Nov-88,28,0,0,0,0,4250,6500,6500,135,130,5043590,185,75,D RC,1,2,3,3,2,3,2,2,1,3,2,5,5,5,5,10,5,14,8,8,15,10,5,14,9,14,14,15,12,15,9,14,15,6,14,7,14,15,15,11,9,11,13,10,14,13,20,14,15,15,13,13,9,10,14,12,12,13,15,14,12,8,20,1,1,1,15,1,20,D RC,103,1,10,1,1,1,1,20,1,15,1,1,1,1,1,1,32768.0,0,0,0,0,0,0,0,0,0,0,0,0,0,0,0,1,0,0,0,0,0,0,0,0,0,0,0,0,0,0,0,0,0,0,0,0,0,0,0,0,0,0,0,0,0,0,0,0,Sergio Postigo,Â£1.80m ,31.0,185.0,Defender - Centre-Back,right,Levante UD,36.0,2.0,1.0,3169.0,32.0,1.0,0.0,2603.0,23.0,1.0,1.0,1611.0,28.0,1.0,1.0,2375.0,5.0,0.0,0.0,288.0,LaLiga
19-06-17,18.3.4.28,Hugo Mallo,67086276,796,22-Jun-91,25,0,0,12,0,5200,7300,7300,157,146,24823866,174,75,D/WB RC,3,1,1,3,2,1,1,2,3,3,1,4,13,11,9,12,7,10,6,14,13,12,9,15,12,16,14,16,14,16,10,13,15,7,12,13,15,15,16,15,13,13,9,12,13,14,20,15,14,15,9,13,7,8,16,13,15,11,11,8,6,3,20,17,8,1,20,9,18,D/WB RC,113,1,1,1,1,1,1,18,9,20,1,1,1,8,6,17,0.0,0,0,0,0,0,0,0,0,0,0,0,0,0,0,0,0,0,0,0,0,0,0,0,0,0,0,0,0,0,0,0,0,0,0,0,0,0,0,0,0,0,0,0,0,0,0,0,0,Hugo Mallo,Â£10.80m ,29.0,174.0,Defender - Right-Back,right,Celta de Vigo,41.0,3.0,4.0,3638.0,38.0,0.0,7.0,3364.0,35.0,1.0,4.0,3094.0,29.0,0.0,1.0,2117.0,5.0,0.0,0.0,450.0,LaLiga,15-07-16,17.3.2.23,Hugo Mallo,67086276,796,22-Jun-91,25,0,0,12,0,5200,7200,7200,156,144,18941062,174,75,D/WB RC,1,4,1,3,2,2,2,2,2,3,1,4,13,10,6,12,7,9,6,14,13,12,9,15,12,16,14,16,14,16,10,13,15,7,12,13,15,15,16,15,13,13,9,12,13,14,20,15,14,15,9,13,7,8,20,13,15,11,11,8,6,3,Hugo Mallo,Â£7.20m ,LaLiga
19-06-17,18.3.4.28,Ãlvaro,67093060,796,08-Jan-90,27,0,0,0,0,4500,7000,7000,145,141,23553068,183,76,D RC,1,4,2,1,3,3,3,1,1,2,3,5,7,10,6,12,6,14,9,13,16,12,8,14,11,14,14,15,14,15,11,14,14,7,14,7,14,12,14,13,11,13,13,12,12,13,20,14,13,13,12,13,6,12,10,16,11,13,13,10,7,9,20,1,1,1,15,1,20,D RC,103,1,1,1,1,1,1,20,1,15,9,1,1,1,1,1,32768.0,0,0,0,0,0,0,0,0,0,0,0,0,0,0,0,1,0,0,0,0,0,0,0,0,0,0,0,0,0,0,0,0,0,0,0,0,0,0,0,0,0,0,0,0,0,0,0,0,nan,nan,nan,nan,nan,nan,nan,nan,nan,nan,nan,nan,nan,nan,nan,nan,nan,nan,nan,nan,nan,nan,nan,nan,nan,nan,nan,nan,15-07-16,17.3.2.23,Ãlvaro,67093060,796,08-Jan-90,26,0,0,0,0,4750,6750,6750,140,135,8943688,183,76,D RC,1,1,2,3,2,1,2,3,2,3,4,5,7,10,6,11,5,14,8,13,16,11,8,14,11,14,14,15,14,15,10,14,14,7,13,7,14,12,14,13,11,13,13,9,12,13,20,14,13,13,12,13,6,12,10,16,11,13,13,10,7,9,nan,nan,nan
19-06-17,18.3.4.28,Ximo Navarro,67100203,796,23-Jan-90,27,0,0,0,0,4250,6350,6350,135,127,3961155,178,71,D/WB RC,1,3,3,3,3,2,1,2,3,2,2,9,12,11,9,10,8,12,8,6,13,11,7,14,11,13,12,13,11,13,10,12,11,9,13,12,12,12,13,15,12,13,11,9,13,15,20,13,11,14,11,8,2,14,19,11,14,11,9,13,10,2,20,18,7,1,20,14,19,D/WB RC,113,1,1,1,1,1,1,19,14,20,1,1,1,7,1,18,32.0,0,0,0,0,0,1,0,0,0,0,0,0,0,0,0,0,0,0,0,0,0,0,0,0,0,0,0,0,0,0,0,0,0,0,0,0,0,0,0,0,0,0,0,0,0,0,0,0,Ximo Navarro,Â£1.80m ,30.0,176.0,Defender - Right-Back,right,Deportivo AlavÃ©s,37.0,2.0,1.0,3324.0,33.0,0.0,0.0,2713.0,31.0,2.0,2.0,2532.0,23.0,0.0,0.0,1906.0,6.0,0.0,0.0,494.0,LaLiga
19-06-17,18.3.4.28,David SimÃ³n,67127964,796,16-Dec-88,28,0,0,0,0,4000,6050,6050,126,120,1666141,179,73,D/WB R,3,3,2,2,1,1,2,2,4,3,2,6,9,10,7,9,6,5,8,13,12,9,10,12,9,14,13,16,12,12,9,12,15,8,13,15,10,16,16,14,13,12,9,8,15,14,20,16,12,14,5,10,6,12,12,13,15,10,16,12,12,6,20,19,12,9,20,1,1,D/WB R,112,1,1,1,1,1,9,1,1,20,1,1,1,12,1,19,32800.0,0,0,0,0,0,1,0,0,0,0,0,0,0,0,0,1,0,0,0,0,0,0,0,0,0,0,0,0,0,0,0,0,0,0,0,0,0,0,0,0,0,0,0,0,0,0,0,0,David SimÃ³n,Â£720Th. ,31.0,179.0,Defender - Right-Back,right,FC Cartagena,19.0,0.0,1.0,1591.0,15.0,0.0,0.0,1077.0,30.0,0.0,1.0,2469.0,10.0,1.0,0.0,696.0,6.0,0.0,0.0,413.0,LaLiga,15-07-16,17.3.2.23,David SimÃ³n,67127964,796,16-Dec-88,27,0,0,0,0,4000,6150,6150,127,122,2595415,179,73,D/WB R,2,3,1,2,2,2,1,3,3,2,4,6,10,10,7,9,6,5,8,13,12,9,10,14,9,14,14,16,12,13,9,12,15,8,13,14,10,16,16,14,13,12,9,8,15,14,20,16,12,14,5,10,6,12,12,13,15,10,16,12,12,6,David SimÃ³n,Â£1.35m ,LaLiga
19-06-17,18.3.4.28,Joseba Zaldua,67131394,796,24-Jun-92,24,0,0,0,0,4250,6600,6600,139,132,5082872,176,71,D R,3,3,4,4,1,2,2,2,3,2,3,6,12,12,6,11,10,14,9,13,14,13,3,14,13,13,14,15,14,14,12,13,13,9,11,13,14,13,14,13,13,14,6,10,12,13,20,14,14,13,11,12,12,12,14,12,10,12,14,16,13,13,20,10,1,1,20,1,1,D R,102,1,1,1,1,1,1,1,1,20,1,1,1,1,1,10,0.0,0,0,0,0,0,0,0,0,0,0,0,0,0,0,0,0,0,0,0,0,0,0,0,0,0,0,0,0,0,0,0,0,0,0,0,0,0,0,0,0,0,0,0,0,0,0,0,0,Joseba Zaldua,Â£3.60m ,28.0,176.0,Defender - Right-Back,right,Real Sociedad,17.0,0.0,2.0,1376.0,30.0,1.0,1.0,2559.0,29.0,1.0,2.0,2411.0,33.0,0.0,2.0,2822.0,0.0,0.0,0.0,0.0,LaLiga,15-07-16,17.3.2.23,Joseba Zaldua,67131394,796,24-Jun-92,24,0,0,0,0,4250,6600,6600,139,132,6969757,176,71,D R,3,3,2,1,3,3,1,2,2,3,1,6,12,12,6,11,10,14,9,13,14,13,3,14,13,13,14,15,14,14,12,13,13,9,11,13,14,13,14,13,13,14,6,10,12,13,20,14,14,13,11,12,12,12,14,12,12,12,14,16,13,13,Joseba Zaldua,Â£1.35m ,LaLiga
19-06-17,18.3.4.28,Unai Bustinza,67132476,796,02-Feb-92,25,0,0,0,0,3250,6200,6200,130,124,950256,175,76,D RC,3,3,1,3,3,3,2,2,1,2,2,9,7,5,3,10,6,13,5,11,15,12,11,14,9,13,15,13,12,11,7,10,12,6,15,9,13,12,15,13,10,12,10,10,16,14,20,16,15,12,13,5,11,14,7,8,9,14,14,15,13,12,20,1,1,1,20,12,17,D RC,103,1,1,1,1,1,1,17,12,20,1,1,1,1,1,1,0.0,0,0,0,0,0,0,0,0,0,0,0,0,0,0,0,0,0,0,0,0,0,0,0,0,0,0,0,0,0,0,0,0,0,0,0,0,0,0,0,0,0,0,0,0,0,0,0,0,Unai Bustinza,Â£1.62m ,28.0,175.0,Defender - Centre-Back,right,CD LeganÃ©s,22.0,0.0,1.0,1790.0,26.0,2.0,1.0,2176.0,28.0,0.0,1.0,2278.0,35.0,0.0,2.0,2870.0,4.0,0.0,0.0,33.0,LaLiga,15-07-16,17.3.2.23,Unai Bustinza,67132476,796,02-Feb-92,24,0,0,0,0,3250,6200,6200,130,124,304084,175,76,D RC,1,2,3,3,3,4,1,1,1,3,2,7,7,5,3,10,5,13,5,11,15,12,6,14,9,13,15,13,12,11,7,10,12,6,15,9,13,12,15,13,10,12,10,10,16,14,20,16,15,12,13,9,11,14,13,10,12,14,14,15,13,12,Unai Bustinza,Â£900Th. ,LaLiga
19-06-17,18.3.4.28,IvÃ¡n,67134757,796,23-Aug-93,23,0,0,0,0,3950,6200,6200,136,124,2653643,178,72,D/WB R,1,2,2,3,2,2,2,2,3,2,3,7,11,11,7,11,7,9,10,14,13,12,8,14,11,11,13,13,13,15,9,13,14,9,12,10,13,14,14,14,12,13,9,8,15,14,20,14,12,14,11,14,11,10,14,12,14,15,14,14,12,8,20,18,10,5,20,5,1,D/WB R,112,1,1,1,1,1,5,1,5,20,1,1,1,10,1,18,288.0,0,0,0,0,0,1,0,0,1,0,0,0,0,0,0,0,0,0,0,0,0,0,0,0,0,0,0,0,0,0,0,0,0,0,0,0,0,0,0,0,0,0,0,0,0,0,0,0,nan,nan,nan,nan,nan,nan,nan,nan,nan,nan,nan,nan,nan,nan,nan,nan,nan,nan,nan,nan,nan,nan,nan,nan,nan,nan,nan,nan,
19-06-17,18.3.4.28,Dani Carvajal,67139735,796,11-Jan-92,25,12,0,9,1,7450,8050,8050,162,159,93314620,173,74,D/WB RL,2,2,2,3,3,3,2,1,1,2,3,11,14,12,8,13,8,10,9,13,14,13,9,15,12,17,14,18,13,15,12,12,16,12,13,17,12,17,19,16,14,17,8,10,16,14,20,18,12,15,12,11,5,13,15,15,17,14,19,8,9,5,20,18,11,1,20,15,1,D/WB RL,115,1,1,1,1,1,1,1,15,20,1,1,1,11,10,18,1048576.0,0,0,0,0,0,0,0,0,0,0,0,0,0,0,0,0,0,0,0,0,1,0,0,0,0,0,0,0,0,0,0,0,0,0,0,0,0,0,0,0,0,0,0,0,0,0,0,0,Daniel Carvajal,Â£54.00m ,28.0,173.0,Defender - Right-Back,right,Real Madrid,41.0,1.0,12.0,3549.0,41.0,0.0,7.0,3473.0,37.0,1.0,6.0,3140.0,42.0,1.0,8.0,3752.0,3.0,0.0,1.0,213.0,LaLiga,15-07-16,17.3.2.23,Dani Carvajal,67139735,796,11-Jan-92,24,5,0,10,1,7100,7950,7950,162,159,37219391,173,73,D/WB RL,1,3,2,3,2,2,3,2,1,4,2,11,14,12,8,13,8,10,9,13,14,13,9,15,12,17,14,18,13,16,12,13,16,12,13,17,13,17,19,16,14,17,8,10,16,14,20,18,12,16,12,11,5,13,15,15,17,14,19,8,9,5,Daniel Carvajal,Â£28.80m ,LaLiga
19-06-17,18.3.4.28,Jonny,67144651,796,03-Mar-94,23,0,0,20,0,4750,7250,7250,157,145,23135854,170,70,D/WB RLC,3,3,3,2,2,3,3,2,1,2,1,6,12,13,10,10,7,10,7,13,14,12,8,14,11,14,14,16,13,16,9,13,17,8,12,11,14,15,16,15,14,12,10,8,15,15,20,15,12,17,14,14,6,14,13,19,9,12,10,9,10,6,20,17,1,1,20,19,18,D/WB RLC,116,1,1,1,1,1,1,18,19,20,1,1,1,1,17,17,0.0,0,0,0,0,0,0,0,0,0,0,0,0,0,0,0,0,0,0,0,0,0,0,0,0,0,0,0,0,0,0,0,0,0,0,0,0,0,0,0,0,0,0,0,0,0,0,0,0,Jony,Â£1.80m ,29.0,179.0,Forward - Left Winger,left,CA Osasuna,26.0,2.0,1.0,1372.0,30.0,6.0,5.0,2163.0,37.0,4.0,11.0,2993.0,32.0,0.0,4.0,1659.0,4.0,0.0,0.0,187.0,LaLiga,15-07-16,17.3.2.23,Jonny,67144651,796,03-Mar-94,22,0,0,20,0,4750,7000,7000,155,141,13341607,170,70,D/WB RLC,4,3,1,1,1,4,2,2,2,1,2,6,10,11,6,10,5,8,7,13,14,12,8,14,11,14,14,16,13,16,9,13,12,8,12,11,14,15,16,15,14,12,10,8,15,15,20,15,12,17,14,14,6,14,9,12,11,13,12,10,17,8,Jony,Â£2.25m ,LaLiga
19-06-17,18.3.4.28,RubÃ©n PeÅa,67177699,796,18-Jul-91,25,0,0,0,0,3900,6250,6250,129,126,2768954,170,67,WB/M/AM RL,2,3,1,1,1,2,2,3,1,2,3,8,13,13,9,10,8,8,10,10,9,10,10,10,11,10,10,11,10,10,12,10,9,10,7,13,8,11,11,14,13,13,8,9,11,13,20,12,9,12,10,10,7,14,9,13,12,12,11,9,19,6,15,16,17,20,20,17,14,WB/M/AM RL,535,1,1,15,14,17,20,1,1,15,1,1,14,17,1,16,0.0,0,0,0,0,0,0,0,0,0,0,0,0,0,0,0,0,0,0,0,0,0,0,0,0,0,0,0,0,0,0,0,0,0,0,0,0,0,0,0,0,0,0,0,0,0,0,0,0,RubÃ©n PÃ©rez,Â£6.75m ,31.0,178.0,Midfielder - Defensive Midfield,right,CD LeganÃ©s,32.0,0.0,1.0,2495.0,36.0,0.0,0.0,2895.0,32.0,0.0,0.0,2561.0,28.0,1.0,1.0,2376.0,8.0,0.0,0.0,720.0,LaLiga,15-07-16,17.3.2.23,RubÃ©n PeÅa,67177699,796,18-Jul-91,24,0,0,0,0,3900,6150,6150,127,123,4304070,170,67,WB/M/AM RL,3,1,3,3,1,2,2,3,1,1,1,8,13,13,9,10,8,8,10,10,9,10,10,10,11,10,10,11,10,10,11,10,15,10,7,13,8,10,10,14,13,13,8,7,11,13,20,12,9,12,10,10,7,14,18,13,14,13,11,11,18,4,RubÃ©n PÃ©rez,Â£2.25m ,LaLiga
19-06-17,18.3.4.28,IÅigo Lekue,67184347,796,04-May-93,24,0,0,0,0,4550,6600,6600,152,133,7530484,179,71,D/WB RL,4,1,3,2,1,3,2,1,3,1,1,9,12,13,6,11,5,10,6,8,12,11,3,13,12,10,12,13,10,11,11,11,15,12,8,14,12,13,14,14,12,13,10,10,13,15,20,16,13,14,12,3,11,15,11,14,14,9,14,10,11,7,20,19,15,13,20,16,1,D/WB RL,115,1,1,1,1,1,13,1,16,20,1,1,10,15,15,19,32.0,0,0,0,0,0,1,0,0,0,0,0,0,0,0,0,0,0,0,0,0,0,0,0,0,0,0,0,0,0,0,0,0,0,0,0,0,0,0,0,0,0,0,0,0,0,0,0,0,IÃ±igo Lekue,Â£6.75m ,27.0,180.0,Defender - Right-Back,right,Athletic Bilbao,31.0,3.0,1.0,1977.0,46.0,0.0,1.0,3194.0,4.0,0.0,1.0,209.0,18.0,0.0,2.0,935.0,1.0,0.0,0.0,4.0,LaLiga,15-07-16,17.3.2.23,IÅigo Lekue,67184347,796,04-May-93,23,0,0,0,0,4550,6600,6600,152,133,6766463,179,71,D/WB RL,3,2,2,1,3,2,3,2,2,3,3,9,12,13,6,11,5,10,6,8,12,11,8,13,12,10,12,13,10,11,11,11,15,12,8,14,12,13,14,14,12,13,10,10,13,15,20,16,13,14,12,10,11,15,7,14,14,9,14,10,17,7,IÃ±igo Lekue,Â£3.60m ,LaLiga
19-06-17,18.3.4.28,Nacho Vidal,67184889,796,24-Jan-95,22,0,0,0,0,1000,5500,5500,142,120,1484265,180,0,D/WB R,3,3,3,1,3,1,4,1,1,2,1,5,8,8,4,13,1,12,11,11,15,10,9,14,12,11,14,13,12,13,10,13,15,7,4,13,12,12,14,14,13,12,11,7,13,14,20,13,10,11,11,8,8,11,13,12,11,11,11,10,18,1,20,18,1,1,20,1,12,D/WB R,112,1,1,1,1,1,1,12,1,20,1,1,1,1,1,18,0.0,0,0,0,0,0,0,0,0,0,0,0,0,0,0,0,0,0,0,0,0,0,0,0,0,0,0,0,0,0,0,0,0,0,0,0,0,0,0,0,0,0,0,0,0,0,0,0,0,Nacho Vidal,Â£900Th. ,25.0,180.0,Defender - Right-Back,right,CA Osasuna,42.0,4.0,2.0,3770.0,9.0,1.0,0.0,626.0,38.0,0.0,5.0,2858.0,33.0,1.0,0.0,2567.0,6.0,0.0,0.0,324.0,LaLiga
19-06-17,18.3.4.28,Carlos Vigaray,67186783,796,07-Sep-94,22,0,0,0,0,3500,6100,6100,134,122,4641526,183,70,D RLC,1,2,3,3,2,2,3,2,1,2,2,8,11,12,7,12,8,11,8,8,13,9,7,13,10,12,13,12,12,13,9,12,11,1,8,13,12,14,14,13,12,10,13,12,9,14,20,14,13,12,4,2,11,14,9,12,10,10,12,10,14,4,20,14,1,1,20,16,18,D RLC,106,1,1,1,1,1,1,18,16,20,1,1,1,1,14,14,0.0,0,0,0,0,0,0,0,0,0,0,0,0,0,0,0,0,0,0,0,0,0,0,0,0,0,0,0,0,0,0,0,0,0,0,0,0,0,0,0,0,0,0,0,0,0,0,0,0,Carlos Vigaray,Â£720Th. ,26.0,182.0,Defender - Right-Back,right,Real Zaragoza,26.0,0.0,3.0,1408.0,13.0,0.0,0.0,983.0,10.0,0.0,0.0,826.0,26.0,1.0,0.0,2149.0,2.0,0.0,0.0,143.0,LaLiga,15-07-16,17.3.2.23,Carlos Vigaray,67186783,796,07-Sep-94,21,0,0,0,0,3500,6000,6000,134,119,1587892,183,70,D RLC,2,3,1,1,3,2,2,2,3,3,2,8,11,12,7,12,8,11,8,8,13,9,4,13,10,12,12,10,12,12,9,12,9,8,8,13,12,13,13,13,12,10,13,12,10,14,20,14,12,12,9,8,11,14,19,11,12,11,11,10,17,2,Carlos Vigaray,Â£900Th. ,LaLiga
19-06-17,18.3.4.28,Ander Capa,67187680,796,08-Feb-92,25,0,0,0,0,4250,6750,6750,144,134,9943702,176,68,D/WB/M R,1,3,2,1,1,3,2,2,3,3,4,10,13,13,10,11,8,8,9,11,11,12,11,11,12,11,14,12,13,13,9,13,17,13,11,14,12,15,12,15,13,10,8,10,13,14,20,14,13,13,8,15,7,14,14,12,10,12,12,11,19,3,20,19,16,15,20,12,1,D/WB/M R,122,1,1,1,1,12,15,1,1,20,1,1,10,16,1,19,0.0,0,0,0,0,0,0,0,0,0,0,0,0,0,0,0,0,0,0,0,0,0,0,0,0,0,0,0,0,0,0,0,0,0,0,0,0,0,0,0,0,0,0,0,0,0,0,0,0,Ander Capa,Â£2.70m ,28.0,175.0,Defender - Right-Back,right,Athletic Bilbao,37.0,0.0,3.0,3013.0,34.0,0.0,1.0,2321.0,28.0,0.0,0.0,1796.0,41.0,3.0,5.0,3339.0,6.0,0.0,1.0,502.0,LaLiga,15-07-16,17.3.2.23,Ander Capa,67187680,796,08-Feb-92,24,0,0,0,0,4100,6500,6500,140,132,4754959,176,68,D/WB/M R,1,3,2,1,2,1,2,3,1,3,1,10,13,13,10,11,8,8,9,11,11,12,11,11,12,11,14,12,13,13,9,13,12,13,11,14,12,15,12,15,13,10,8,10,13,14,20,14,13,13,8,15,7,14,15,9,10,12,12,12,17,7,Ander Capa,Â£4.50m ,LaLiga
19-06-17,18.3.4.28,Aritz Elustondo,67190072,796,28-Mar-94,23,0,0,0,0,4350,6500,6500,145,134,5609093,182,72,D RC,3,2,2,2,1,2,3,1,3,3,2,4,12,9,5,12,7,15,12,12,14,12,6,14,13,13,12,16,13,14,14,13,12,4,7,9,13,17,14,12,12,12,13,10,8,14,20,13,12,11,11,8,10,12,10,13,10,10,10,13,17,3,20,1,1,1,20,1,17,D RC,103,1,1,1,1,1,1,17,1,20,1,1,1,1,1,1,0.0,0,0,0,0,0,0,0,0,0,0,0,0,0,0,0,0,0,0,0,0,0,0,0,0,0,0,0,0,0,0,0,0,0,0,0,0,0,0,0,0,0,0,0,0,0,0,0,0,Aritz Elustondo,Â£4.50m ,26.0,182.0,Defender - Centre-Back,right,Real Sociedad,12.0,0.0,1.0,714.0,24.0,3.0,2.0,1972.0,29.0,1.0,1.0,2362.0,26.0,0.0,1.0,1762.0,8.0,0.0,0.0,720.0,LaLiga,15-07-16,17.3.2.23,Aritz Elustondo,67190072,796,28-Mar-94,22,0,0,0,0,4350,6500,6500,145,130,7185762,182,72,D RC,3,2,1,3,2,3,1,1,3,2,3,4,12,9,7,12,7,15,12,12,12,12,6,14,13,13,12,16,13,14,14,14,16,4,11,9,13,17,14,12,10,12,13,10,13,14,20,10,12,12,11,12,9,12,14,11,12,10,12,10,11,3,Aritz Elustondo,Â£2.25m ,LaLiga
19-06-17,18.3.4.28,Yeray,67192475,796,24-Jan-95,22,0,0,0,0,4250,6950,6950,147,139,31137695,182,77,D RC,3,3,1,2,2,2,1,1,2,1,1,7,12,9,7,11,8,15,9,6,15,13,8,14,10,13,14,16,15,14,11,13,13,8,13,5,14,15,16,13,12,12,13,9,12,13,20,14,14,13,13,12,8,12,18,12,15,12,15,14,10,7,20,13,1,1,17,1,20,D RC,103,1,1,1,1,1,1,20,1,17,1,1,1,1,1,13,8796090000000.0,0,0,0,0,0,0,0,0,0,0,0,0,0,0,0,0,0,0,0,0,0,0,0,0,0,0,0,0,0,0,0,0,0,0,0,0,0,0,0,0,0,0,0,1,0,0,0,0,nan,nan,nan,nan,nan,nan,nan,nan,nan,nan,nan,nan,nan,nan,nan,nan,nan,nan,nan,nan,nan,nan,nan,nan,nan,nan,nan,nan,
19-06-17,18.3.4.28,RÃ³ber,67194879,796,16-Feb-95,22,0,0,0,0,3850,6200,6200,135,125,4734607,182,74,D/DM RC,1,2,3,3,2,2,1,1,3,2,2,6,7,8,7,10,7,13,7,10,14,11,8,13,10,13,12,14,13,14,8,13,12,9,10,8,13,14,14,12,12,11,12,10,13,13,20,14,14,14,11,12,7,12,14,13,14,13,14,14,8,7,20,12,5,1,16,12,20,D/DM RC,113,1,1,1,1,1,1,20,12,16,17,5,1,1,5,12,0.0,0,0,0,0,0,0,0,0,0,0,0,0,0,0,0,0,0,0,0,0,0,0,0,0,0,0,0,0,0,0,0,0,0,0,0,0,0,0,0,0,0,0,0,0,0,0,0,0,nan,nan,nan,nan,nan,nan,nan,nan,nan,nan,nan,nan,nan,nan,nan,nan,nan,nan,nan,nan,nan,nan,nan,nan,nan,nan,nan,nan,
19-06-17,18.3.4.28,Ãlvaro Odriozola,67199408,796,14-Dec-95,21,0,0,0,0,4700,7200,7200,163,144,37360032,175,66,D R,3,2,2,3,1,1,2,3,4,3,1,12,15,15,8,13,10,9,11,10,13,14,7,13,16,11,12,14,12,14,13,13,13,11,10,11,12,13,12,16,13,14,10,8,14,17,20,15,12,14,12,12,12,12,19,11,11,10,11,10,17,3,20,14,1,1,20,1,1,D R,102,1,1,1,1,1,1,1,1,20,1,1,1,1,1,14,1099510000000.0,0,0,0,0,0,1,0,0,0,0,0,0,0,0,0,0,0,0,0,0,0,0,0,0,0,0,0,0,0,0,0,0,0,0,0,0,0,0,0,0,1,0,0,0,0,0,0,0,Ãlvaro Odriozola,Â£22.50m ,24.0,176.0,Defender - Right-Back,right,Real Madrid,34.0,0.0,8.0,2852.0,41.0,1.0,4.0,3435.0,22.0,1.0,9.0,1856.0,10.0,0.0,2.0,613.0,1.0,0.0,0.0,57.0,LaLiga
19-06-17,18.3.4.28,Rafa Navarro,67208294,796,24-Feb-94,23,0,0,0,0,3250,5850,5850,130,117,1527332,173,61,D R,3,1,2,3,2,2,3,1,1,3,3,10,12,12,7,11,9,10,12,12,12,11,10,12,12,11,13,12,10,10,12,11,8,10,10,12,12,12,13,14,13,13,10,10,12,13,20,14,11,13,8,10,7,12,15,10,14,13,11,12,18,2,20,12,10,1,20,1,1,D R,102,1,1,1,1,1,1,1,1,20,1,1,1,10,1,12,0.0,0,0,0,0,0,0,0,0,0,0,0,0,0,0,0,0,0,0,0,0,0,0,0,0,0,0,0,0,0,0,0,0,0,0,0,0,0,0,0,0,0,0,0,0,0,0,0,0,Rafa Navarro,Â£450Th. ,26.0,173.0,Defender - Right-Back,right,NK Istra 1961,18.0,2.0,2.0,1288.0,5.0,0.0,0.0,263.0,26.0,1.0,1.0,2321.0,0.0,0.0,0.0,0.0,nan,nan,nan,nan,LaLiga,15-07-16,17.3.2.23,Rafa Navarro,67208294,796,24-Feb-94,22,0,0,0,0,3000,5250,5250,125,105,667079,173,61,D R,2,3,3,3,1,3,3,3,3,2,1,10,11,11,7,10,9,8,11,11,11,11,10,12,11,10,12,11,10,10,10,11,10,10,10,11,12,12,13,13,12,13,10,10,11,12,20,13,11,13,8,10,7,10,10,12,12,11,11,10,13,3,Rafa Navarro,Â£1.35m ,LaLiga
19-06-17,18.3.4.28,Unai NÃºÅez,67214595,796,30-Jan-97,20,0,0,0,0,4250,6850,6850,155,137,32027508,186,80,D RC,1,4,2,3,3,1,4,2,3,2,2,6,6,7,8,11,8,14,9,10,15,11,10,15,11,13,15,15,13,14,10,14,17,7,10,8,14,14,15,12,13,11,13,8,14,13,20,13,14,14,8,11,8,11,13,10,13,12,10,11,20,1,20,14,1,1,16,1,20,D RC,103,1,1,1,1,1,1,20,1,16,1,1,1,1,1,14,0.0,0,0,0,0,0,0,0,0,0,0,0,0,0,0,0,0,0,0,0,0,0,0,0,0,0,0,0,0,0,0,0,0,0,0,0,0,0,0,0,0,0,0,0,0,0,0,0,0,Unai NÃºÃ±ez,Â£13.50m ,23.0,186.0,Defender - Centre-Back,right,Athletic Bilbao,33.0,3.0,0.0,2806.0,36.0,1.0,0.0,3167.0,15.0,0.0,0.0,1276.0,26.0,0.0,0.0,2053.0,3.0,0.0,0.0,270.0,LaLiga
19-06-17,18.3.4.28,Marc Navarro,67222733,796,02-Jul-95,21,0,0,0,0,2500,5750,5750,133,115,2350403,183,0,D/WB/AM R,3,4,3,1,2,2,3,1,1,2,1,11,13,12,9,11,8,9,9,12,12,10,6,13,13,9,9,11,10,12,11,9,20,9,8,13,12,13,11,14,13,11,10,8,13,12,20,13,10,12,9,3,7,14,12,11,11,11,10,11,19,2,19,20,15,18,20,1,1,D/WB/AM R,232,1,1,1,1,1,18,1,1,19,1,1,1,15,1,20,0.0,0,0,0,0,0,0,0,0,0,0,0,0,0,0,0,0,0,0,0,0,0,0,0,0,0,0,0,0,0,0,0,0,0,0,0,0,0,0,0,0,0,0,0,0,0,0,0,0,Marc Navarro,Â£1.80m ,25.0,188.0,Defender - Right-Back,right,Watford FC,26.0,5.0,2.0,1678.0,24.0,1.0,2.0,1469.0,5.0,0.0,0.0,261.0,6.0,0.0,0.0,243.0,2.0,0.0,0.0,90.0,LaLiga
19-06-17,18.3.4.28,Tito,7451317,796,11-Jul-85,31,0,0,0,0,4350,6350,6350,138,127,232186002,174,62,D/WB R,2,1,3,3,3,3,2,2,3,3,1,8,11,9,6,12,11,9,8,14,13,12,7,14,12,15,14,17,14,15,10,15,15,9,13,13,15,17,17,13,11,11,7,9,14,12,20,14,8,17,6,14,10,12,15,10,15,12,19,14,12,4,20,18,10,1,20,13,1,D/WB R,112,1,1,1,1,1,1,1,13,20,1,1,1,10,11,18,1116690000000.0,0,0,0,0,0,0,0,0,0,0,0,0,0,0,0,0,0,0,0,0,0,0,0,0,0,0,0,0,0,0,0,0,0,0,1,0,0,0,0,0,1,0,0,0,0,0,0,0,Tito,Â£720Th. ,35.0,174.0,Defender - Right-Back,right,Without Club,23.0,0.0,3.0,1876.0,17.0,1.0,0.0,1322.0,16.0,0.0,0.0,1182.0,28.0,0.0,0.0,2177.0,nan,nan,nan,nan,LaLiga,15-07-16,17.3.2.23,Tito,7451317,796,11-Jul-85,31,0,0,0,0,4800,6600,6600,138,132,232186002,174,62,D/WB R,2,3,1,2,1,2,2,3,1,3,2,8,11,9,6,12,11,9,8,14,13,12,7,14,12,15,14,17,14,15,10,15,15,9,13,14,15,17,17,14,12,12,7,9,14,13,20,15,8,17,6,14,10,12,15,10,15,12,19,14,12,4,Tito,Â£2.25m ,LaLiga
19-06-17,18.3.4.28,Francisco Molinero,7451371,796,26-Jul-85,31,0,0,2,0,4500,6100,6100,133,122,1435626,175,72,D/WB R,2,2,3,1,3,1,3,3,3,1,3,9,14,11,7,11,6,7,8,15,14,11,5,14,14,14,12,16,10,13,7,9,13,10,11,12,12,13,15,16,12,12,8,9,14,14,20,14,12,15,13,13,7,14,11,10,12,10,10,11,20,7,20,16,8,1,20,13,1,D/WB R,112,1,1,1,1,1,1,1,13,20,1,1,1,8,9,16,0.0,0,0,0,0,0,0,0,0,0,0,0,0,0,0,0,0,0,0,0,0,0,0,0,0,0,0,0,0,0,0,0,0,0,0,0,0,0,0,0,0,0,0,0,0,0,0,0,0,Francisco Molinero,Â£540Th. ,35.0,177.0,Defender - Right-Back,right,Without Club,38.0,0.0,2.0,3280.0,12.0,0.0,0.0,754.0,31.0,0.0,0.0,2711.0,32.0,0.0,1.0,2645.0,nan,nan,nan,nan,LaLiga
19-06-17,18.3.4.28,Juanfran,7451701,796,09-Jan-85,32,13,1,9,0,6500,7500,7500,153,149,232186002,180,71,D/WB R,3,3,1,3,1,3,1,1,4,3,3,15,15,14,11,14,8,7,12,11,13,13,12,13,14,13,13,14,14,14,13,13,16,11,12,15,15,15,16,14,14,13,11,12,12,15,20,14,11,15,10,13,9,14,15,17,15,14,15,14,10,8,20,18,13,1,20,1,1,D/WB R,112,1,1,1,1,1,1,1,1,20,1,1,1,13,1,18,70918500000000.0,0,0,0,0,0,1,0,0,0,0,0,0,0,0,0,0,0,0,0,0,0,0,0,0,0,0,0,0,0,0,0,0,0,0,0,0,0,0,0,1,0,0,0,0,0,0,1,0,Juanfran,Â£4.50m ,35.0,181.0,Defender - Right-Back,right,SÃ£o Paulo Futebol Clube,36.0,2.0,3.0,3009.0,30.0,0.0,4.0,2387.0,47.0,0.0,4.0,3498.0,18.0,0.0,0.0,1382.0,nan,nan,nan,nan,LaLiga,15-07-16,17.3.2.23,Juanfran,67055268,796,11-Sep-88,27,0,0,0,0,5500,6900,6900,142,142,11701635,180,69,D/WB/M/AM R,3,2,2,3,2,3,3,2,2,1,3,12,16,14,10,13,11,6,13,14,9,13,8,5,14,7,13,14,11,13,13,12,12,14,13,14,12,14,10,15,14,11,9,11,12,16,20,13,9,12,8,11,6,17,12,14,13,10,15,15,8,7,Juanfran,Â£10.80m ,LaLiga
19-06-17,18.3.4.28,Pedro LÃ³pez,7452446,796,01-Nov-83,33,0,0,0,0,4400,6350,6350,135,127,946684,174,75,D/WB R,2,3,3,3,1,2,4,3,3,3,1,11,13,11,9,14,9,10,12,15,12,12,12,13,14,13,13,15,14,15,10,14,17,14,15,13,14,14,14,13,12,12,9,7,14,13,20,13,9,15,9,12,9,12,10,14,15,14,18,16,15,6,20,19,13,1,20,5,5,D/WB R,112,1,1,1,1,1,1,1,5,20,10,5,1,13,1,19,802.0,0,1,0,0,0,1,0,0,1,1,0,0,0,0,0,0,0,0,0,0,0,0,0,0,0,0,0,0,0,0,0,0,0,0,0,0,0,0,0,0,0,0,0,0,0,0,0,0,Pedro LÃ³pez,Â£225Th. ,25.0,189.0,Goalkeeper,right,CF Villanovense,10.0,15.0,3.0,900.0,34.0,48.0,11.0,3021.0,13.0,19.0,3.0,1170.0,11.0,12.0,6.0,990.0,2.0,0.0,2.0,180.0,LaLiga
19-06-17,18.3.4.28,DamiÃ¡n SuÃ¡rez,78001192,1657,27-Apr-88,29,0,0,26,0,4250,6400,6400,134,129,3545580,173,74,D/WB R,4,2,1,2,1,2,1,3,1,1,2,15,13,12,7,12,12,7,12,14,12,12,7,13,12,17,12,18,10,13,9,11,12,9,12,14,12,16,17,14,14,15,9,8,15,11,20,16,10,13,16,13,4,15,14,12,7,8,12,7,9,5,20,18,10,1,20,14,1,D/WB R,112,1,1,1,1,1,1,1,14,20,8,1,1,10,12,18,196896.0,0,0,0,0,0,1,0,0,1,0,0,0,0,0,0,0,1,1,0,0,0,0,0,0,0,0,0,0,0,0,0,0,0,0,0,0,0,0,0,0,0,0,0,0,0,0,0,0,DamiÃ¡n SuÃ¡rez,Â£2.25m ,32.0,173.0,Defender - Right-Back,right,Getafe CF,42.0,0.0,6.0,3780.0,33.0,1.0,4.0,2878.0,42.0,0.0,3.0,3709.0,34.0,1.0,4.0,2958.0,6.0,0.0,0.0,523.0,LaLiga
19-06-17,18.3.4.28,MatÃ­as Aguirregaray,78020879,1657,01-Apr-89,28,6,0,20,2,2750,6000,6050,135,122,2242105,183,78,D/WB/M R,2,3,1,1,3,2,1,3,2,2,2,11,11,13,9,11,8,11,9,14,13,11,10,14,12,14,12,18,8,9,9,9,16,12,11,15,8,12,15,12,13,13,10,10,14,14,20,15,14,10,14,14,5,18,15,12,10,9,10,9,12,5,18,20,19,10,20,13,1,D/WB/M R,232,1,1,1,1,1,10,1,10,18,1,1,13,19,12,20,2322200000000000.0,0,0,0,1,0,1,0,0,0,0,0,0,0,0,0,0,0,0,0,0,0,0,0,0,0,0,0,0,0,0,0,0,0,0,0,1,0,0,0,0,0,0,0,0,0,0,1,0,MatÃÂ­as Aguirregaray,Â£1.80m ,31.0,174.0,Defender - Right-Back,right,Without Club,28.0,6.0,0.0,2124.0,30.0,0.0,0.0,2373.0,26.0,1.0,3.0,2300.0,25.0,2.0,0.0,1893.0,nan,nan,nan,nan,LaLiga
19-06-17,18.3.4.28,David GarcÃ­a,824480,796,25-Feb-82,35,0,0,0,0,3850,6200,6200,132,124,283554,182,79,D RC,2,1,2,1,2,2,2,2,1,3,2,5,7,9,6,9,5,14,11,12,14,10,7,15,9,15,12,18,13,15,8,14,15,7,18,7,14,18,18,10,10,12,11,8,15,10,20,13,13,15,11,13,14,15,12,12,20,14,19,12,12,5,20,8,1,1,17,1,20,D RC,103,1,5,1,1,1,1,20,1,17,1,1,1,1,1,8,8800390000000.0,0,0,0,0,0,0,0,0,0,0,0,0,0,0,0,1,0,0,0,0,0,0,0,0,0,0,0,0,0,0,0,0,1,0,0,0,0,0,0,0,0,0,0,1,0,0,0,0,David GarcÃ­a,Â£90Th. ,38.0,183.0,Defender - Centre-Back,right,UD Tamaraceite,25.0,1.0,1.0,1915.0,12.0,1.0,0.0,948.0,22.0,1.0,0.0,1851.0,4.0,1.0,0.0,390.0,2.0,0.0,0.0,180.0,LaLiga,15-07-16,17.3.2.23,David GarcÃ­a,67215230,796,14-Feb-94,22,0,0,0,0,3500,6250,6250,144,126,5940066,185,75,D C,2,4,4,2,2,1,3,1,1,3,1,4,5,10,6,10,4,13,11,3,15,11,7,14,11,13,13,14,13,14,11,13,14,7,11,6,14,14,14,11,11,10,14,8,18,13,20,13,14,12,12,7,9,11,7,13,10,9,12,11,12,3,David GarcÃ­a,Â£90Th. ,LaLiga
19-06-17,18.3.4.28,AÄssa Mandi,85079680,5,22-Oct-91,25,24,1,0,0,6000,6500,6500,142,132,5102436,184,78,D RLC,3,3,3,2,1,1,4,3,1,3,2,6,13,9,5,10,6,14,5,12,13,12,6,15,12,14,15,16,12,12,11,13,16,7,12,12,12,14,14,14,13,14,13,9,15,14,20,13,14,13,13,14,8,15,8,13,16,13,15,14,14,7,20,10,1,1,19,15,20,D RLC,106,1,1,1,1,1,1,20,15,19,1,1,1,1,10,10,137439000000.0,0,0,0,1,0,0,0,0,0,0,0,0,0,0,0,0,0,0,0,0,0,0,0,0,0,0,0,0,0,0,0,0,0,0,0,0,0,1,0,0,0,0,0,0,0,0,0,0,AÃ¯ssa Mandi,Â£8.10m ,29.0,184.0,Defender - Centre-Back,right,Real Betis BalompiÃ©,28.0,2.0,1.0,2373.0,35.0,1.0,0.0,3115.0,48.0,2.0,1.0,4260.0,30.0,0.0,0.0,2698.0,5.0,1.0,0.0,442.0,LaLiga,15-07-16,17.3.2.23,AÄssa Mandi,85079680,5,22-Oct-91,24,24,1,0,0,6000,6500,6500,142,132,5958938,184,78,D RLC,3,3,2,2,1,2,3,2,3,1,1,6,13,9,5,10,6,14,5,12,13,12,6,15,12,14,15,16,12,12,11,13,16,7,12,12,12,14,14,14,13,14,13,9,15,14,20,13,14,13,13,14,8,15,17,13,16,13,15,14,14,7,AÃ¯ssa Mandi,Â£5.40m ,LaLiga
19-06-17,18.3.4.28,Daniel Wass,936891,764,31-May-89,28,16,0,14,0,6250,7500,7500,160,150,25873652,178,70,D/WB/DM/M/AM RC,3,1,1,2,2,2,2,2,2,1,2,13,13,13,11,15,16,11,11,14,11,15,9,13,14,12,14,12,11,14,13,14,13,11,8,11,10,12,13,14,13,12,13,9,13,13,20,13,11,15,10,14,7,19,17,16,13,17,15,13,10,7,19,19,20,19,19,14,20,D/WB/DM/M/AM RC,453,1,1,8,15,12,19,10,14,19,17,20,12,18,14,19,137439000000.0,0,0,0,1,0,0,0,0,0,0,0,0,0,0,0,0,0,0,0,0,0,0,0,0,0,0,0,0,0,0,0,0,0,0,0,0,0,1,0,0,0,0,0,0,0,0,0,0,Daniel Wass,Â£13.50m ,31.0,178.0,Defender - Right-Back,right,Valencia CF,54.0,7.0,5.0,3722.0,39.0,4.0,9.0,3081.0,50.0,2.0,7.0,3742.0,45.0,2.0,6.0,3632.0,7.0,1.0,1.0,619.0,LaLiga,15-07-16,17.3.2.23,Daniel Wass,936891,764,31-May-89,27,14,0,14,0,6000,6500,6750,145,140,10290010,178,70,D/WB/DM/M/AM RC,1,1,1,2,1,3,3,3,1,1,1,13,13,12,9,14,16,11,11,14,11,13,9,13,14,14,13,12,11,13,11,11,13,11,8,11,10,12,13,14,12,12,11,9,12,13,20,13,11,15,10,14,7,19,17,16,13,17,15,13,10,7,Daniel Wass,Â£9.00m ,LaLiga
