GameDate,Name,UID,NationID,Born,Age,IntCaps,IntGoals,U21Caps,U21Goals,WorldReputation,HomeReputation,CurrentReputation,PA,CA,Price,Height,Weight,PositionsString,GK.AerialAbility,GK.CommandOfArea,GK.Communication,GK.Eccentricity,GK.Handling,GK.Kicking,GK.OneOnOnes,GK.Reflexes,GK.RushingOut,GK.TendencyToPunch,GK.Throwing,Tech.Corners,Tech.Crossing,Tech.Dribbling,Tech.Finishing,Tech.FirstTouch,Tech.Freekicks,Tech.Heading,Tech.LongShots,Tech.Longthrows,Tech.Marking,Tech.Passing,Tech.PenaltyTaking,Tech.Tackling,Tech.Technique,Mental.Aggression,Mental.Anticipation,Mental.Bravery,Mental.Composure,Mental.Concentration,Mental.Vision,Mental.Decisions,Mental.Determination,Mental.Flair,Mental.Leadership,Mental.OffTheBall,Mental.Positioning,Mental.Teamwork,Mental.Workrate,Phy.Acceleration,Phy.Agility,Phy.Balance,Phy.Jumping,Phy.LeftFoot,Phy.NaturalFitness,Phy.Pace,Phy.RightFoot,Phy.Stamina,Phy.Strength,Hidden.Consistency,Hidden.Dirtiness,Hidden.ImportantMatches,Hidden.InjuryProness,Hidden.Versatility,Personality.Adaptability,Personality.Ambition,Personality.Loyalty,Personality.Pressure,Personality.Professional,Personality.Sportsmanship,Personality.Temperament,Personality.Controversy,Positions.PositionsDesc,Positions.PositionsDescVal,Positions.Striker,Positions.AttackingMidfielder,Positions.Centre,Positions.Defender,Positions.DefensiveMidfielder,Positions.Goalkeeper,Positions.Left,Positions.Midfielder,Positions.Right,Positions.Sweeper,Positions.WingBack,Positions.AttackingMidCentral,Positions.AttackingMidLeft,Positions.AttackingMidRight,Positions.DefenderCentral,Positions.DefenderLeft,Positions.DefenderRight,Positions.MidfielderCentral,Positions.MidfielderLeft,Positions.MidfielderRight,Positions.WingBackLeft,Positions.WingBackRight,PPMVal,PPM0,PPM1,PPM2,PPM3,PPM4,PPM5,PPM6,PPM7,PPM8,PPM9,PPM10,PPM11,PPM12,PPM13,PPM14,PPM15,PPM16,PPM17,PPM18,PPM19,PPM20,PPM21,PPM22,PPM23,PPM24,PPM25,PPM26,PPM27,PPM28,PPM29,PPM30,PPM31,PPM32,PPM33,PPM34,PPM35,PPM36,PPM37,PPM38,PPM39,PPM40,PPM41,PPM42,PPM43,PPM44,PPM45,PPM46,PPM47
29/6/2010,Zoumana Camara,3801463,769,4/3/1979,31,1,0,20,0,4489,6000,6000,150,134,6590437,182,76,D C,1,1,3,2,1,3,1,2,2,3,1,5,8,7,5,10,7,14,9,7,14,9,8,14,10,12,15,17,13,11,8,13,14,7,15,6,14,14,15,12,13,15,11,8,12,14,20,16,15,12,12,14,9,8,11,14,11,10,14,14,14,5,D C,101,1,1,20,20,1,1,10,1,10,1,1,1,1,1,20,10,10,1,1,1,1,1,0,0,0,0,0,0,0,0,0,0,0,0,0,0,0,0,0,0,0,0,0,0,0,0,0,0,0,0,0,0,0,0,0,0,0,0,0,0,0,0,0,0,0,0,0,0,0,0,0
29/6/2010,Zé Castro,742153,788,1/13/1983,27,1,0,18,0,5041,7250,7500,150,142,11335258,183,77,D C,1,2,1,1,2,1,1,6,1,2,2,8,10,10,7,14,10,15,7,10,15,16,10,15,14,9,18,11,13,12,13,13,10,11,12,10,14,9,10,12,12,12,12,15,15,13,20,11,10,16,7,12,7,9,5,18,12,13,14,13,13,5,D C,101,1,1,20,20,5,1,1,1,5,10,1,1,1,1,20,1,5,1,1,1,1,1,8800387989504,0,0,0,0,0,0,0,0,0,0,0,0,0,0,0,0,0,0,0,0,0,0,0,0,0,0,0,0,0,0,0,0,1,0,0,0,0,0,0,0,0,0,0,1,0,0,0,0
29/6/2010,Zé Antonio,902120,788,3/14/1977,33,0,0,0,0,2970,5500,5500,111,109,253910,186,80,D C,1,3,1,2,2,2,3,1,1,1,2,4,4,4,5,5,4,16,4,12,14,5,5,13,4,16,10,17,6,12,4,7,16,3,11,4,10,9,13,11,12,15,14,20,12,10,8,13,15,9,16,14,12,6,7,15,12,14,11,8,8,15,D C,101,1,1,20,20,1,1,10,1,1,1,1,1,1,1,20,10,1,1,1,1,1,1,137438986240,0,0,0,0,0,0,0,0,0,0,0,0,0,0,0,1,0,0,0,0,0,0,0,0,0,0,0,0,0,0,0,0,0,0,0,0,0,1,0,0,0,0,0,0,0,0,0,0
29/6/2010,Zdenek Grygera,133001,763,5/14/1980,30,65,2,14,1,4761,7500,7250,155,138,12113230,185,78,D RC,3,3,2,1,1,3,1,1,3,2,1,8,11,10,8,13,6,14,13,16,15,13,13,14,10,14,14,14,14,16,10,14,15,10,9,12,15,15,15,12,13,15,11,5,14,13,20,14,14,16,10,13,12,13,13,11,15,13,15,12,14,12,D RC,103,1,1,18,20,1,1,12,1,20,14,10,1,1,1,18,12,20,1,1,1,1,10,6442483712,0,0,0,0,0,0,0,0,0,0,0,0,0,0,0,1,0,0,0,0,0,0,0,0,0,0,0,0,0,0,0,1,1,0,0,0,0,0,0,0,0,0,0,0,0,0,0,0
29/6/2010,Zat Knight,115850,765,5/2/1980,30,2,0,4,0,4692,6700,6700,148,137,9200000,198,87,D C,1,2,1,3,1,3,3,7,1,1,3,2,6,7,8,11,11,15,9,4,14,8,5,14,12,15,11,15,10,12,11,11,15,10,11,12,11,14,15,15,15,12,19,10,16,13,20,13,15,11,14,12,14,12,14,16,14,14,12,14,12,14,D C,101,1,1,20,20,1,1,1,1,1,1,1,1,1,1,20,1,1,1,1,1,1,1,17179869248,0,0,0,0,0,0,1,0,0,0,0,0,0,0,0,0,0,0,0,0,0,0,0,0,0,0,0,0,0,0,0,0,0,0,1,0,0,0,0,0,0,0,0,0,0,0,0,0
29/6/2010,Zarko Tomasevic,62055352,62002127,2/22/1990,20,1,0,3,0,1750,5650,5250,133,106,1099293,190,78,D C,3,1,3,1,1,3,2,2,2,1,3,8,9,7,8,9,8,13,7,10,13,8,10,12,9,13,12,10,13,12,7,9,13,6,12,9,12,11,11,11,9,8,15,20,14,11,10,11,14,11,9,10,8,12,13,12,14,14,14,14,14,5,D C,101,1,1,20,20,5,1,10,1,10,10,1,1,1,1,20,10,10,1,1,1,1,1,0,0,0,0,0,0,0,0,0,0,0,0,0,0,0,0,0,0,0,0,0,0,0,0,0,0,0,0,0,0,0,0,0,0,0,0,0,0,0,0,0,0,0,0,0,0,0,0,0
29/6/2010,Youssef Mohamad,128277,123,7/1/1980,29,33,0,0,0,3850,7100,7000,150,140,9959877,182,77,D C,3,1,1,3,2,3,2,1,1,1,2,8,7,7,9,9,11,16,11,13,14,9,14,18,9,18,13,20,13,11,9,9,14,6,16,9,13,13,16,16,14,12,13,9,17,14,20,13,16,13,12,11,8,16,13,17,12,13,14,14,7,16,D C,101,5,1,20,20,14,1,9,5,6,12,3,1,1,1,20,9,6,5,1,1,3,3,46179622584320,0,0,0,0,0,0,0,0,0,0,0,0,0,0,0,0,0,0,0,0,0,0,0,0,0,0,0,1,0,0,0,0,0,0,0,0,0,0,0,0,0,1,0,1,0,1,0,0
29/6/2010,Younes Kaboul,918434,769,1/4/1986,24,0,0,20,1,5041,6400,6900,160,142,13800000,191,85,D RC,1,3,3,3,3,3,2,1,2,1,3,7,13,8,10,14,10,15,14,8,13,11,8,14,12,11,11,14,13,12,13,12,14,6,12,9,13,12,12,14,9,16,17,12,11,15,20,14,19,12,10,12,12,8,13,16,15,12,15,14,13,8,D RC,103,1,1,20,20,14,1,1,10,19,1,1,1,1,1,20,1,19,10,1,1,1,1,43984760078338,0,1,0,0,0,0,0,0,0,0,0,0,0,0,0,0,0,0,0,0,0,0,0,0,0,0,0,0,0,0,0,0,1,0,0,0,0,0,0,0,0,0,0,1,0,1,0,0
29/6/2010,Yohan Tavarès,34012957,769,3/2/1988,22,0,0,0,0,500,2100,2100,125,93,95386,188,79,D C,3,2,2,1,1,3,3,5,2,2,2,6,6,6,6,8,6,14,8,10,12,7,11,8,8,9,11,12,12,12,6,12,13,5,10,8,10,14,11,11,7,16,15,10,13,11,20,6,15,13,10,9,8,10,14,13,14,12,13,13,13,6,D C,101,1,1,20,20,1,1,7,1,10,1,1,1,1,1,20,7,10,1,1,1,1,1,0,0,0,0,0,0,0,0,0,0,0,0,0,0,0,0,0,0,0,0,0,0,0,0,0,0,0,0,0,0,0,0,0,0,0,0,0,0,0,0,0,0,0,0,0,0,0,0,0
29/6/2010,Yohan Benalouane,8434244,51,3/28/1987,23,0,0,0,0,4032,6350,5700,148,127,2199998,185,79,D LC,1,1,2,3,1,1,2,6,3,1,2,5,8,9,6,12,6,14,8,6,12,8,8,12,12,13,15,13,11,13,8,13,14,9,12,7,14,13,13,14,11,15,13,8,15,13,20,15,15,14,13,14,7,8,17,16,13,13,16,14,13,9,D LC,104,1,1,20,20,12,1,15,1,1,1,1,1,1,1,20,15,1,1,1,1,1,1,8796093022240,0,0,0,0,0,1,0,0,0,0,0,0,0,0,0,0,0,0,0,0,0,0,0,0,0,0,0,0,0,0,0,0,0,0,0,0,0,0,0,0,0,0,0,1,0,0,0,0
29/6/2010,Xavi Torres,1508014,796,11/21/1986,23,0,0,0,0,3844,5750,5750,140,124,1720377,182,79,D/DM C,2,2,1,1,2,1,1,7,2,1,3,5,5,8,6,14,6,14,11,9,15,14,7,14,10,14,13,12,14,13,9,13,10,7,13,10,16,16,14,12,11,14,13,7,14,12,20,15,13,11,10,11,5,10,14,16,14,17,6,13,5,19,D/DM C,321,1,1,20,16,20,1,14,15,1,1,1,1,1,1,16,14,1,15,1,1,1,1,4294967296,0,0,0,0,0,0,0,0,0,0,0,0,0,0,0,0,0,0,0,0,0,0,0,0,0,0,0,0,0,0,0,0,1,0,0,0,0,0,0,0,0,0,0,0,0,0,0,0
29/6/2010,Winston Reid,947435,1438,7/3/1988,21,6,1,0,0,3782,6250,6200,143,123,8014380,189,84,D C,1,1,1,1,1,1,1,6,2,2,3,4,11,10,7,11,13,14,11,11,14,12,12,15,11,17,13,16,8,8,11,6,11,12,14,5,12,15,10,10,12,14,15,13,13,14,20,13,15,12,14,16,6,12,8,16,14,8,7,7,9,15,D C,101,7,1,20,20,10,1,1,10,1,1,1,1,1,1,20,1,1,10,1,1,1,1,131072,0,0,0,0,0,0,0,0,0,0,0,0,0,0,0,0,0,1,0,0,0,0,0,0,0,0,0,0,0,0,0,0,0,0,0,0,0,0,0,0,0,0,0,0,0,0,0,0
29/6/2010,Wilson Souprayen,8447295,769,2/24/1990,20,0,0,0,0,50,2400,2400,140,97,1798736,184,75,D C,3,3,3,3,3,2,1,1,2,2,3,5,6,7,5,12,7,14,8,6,12,8,7,9,12,14,12,13,11,11,7,12,10,6,9,7,12,13,15,12,9,14,12,20,12,10,5,15,13,14,14,10,12,11,11,17,4,8,6,11,9,11,D C,101,1,1,20,20,15,1,1,15,1,1,1,1,1,1,20,1,1,15,1,1,1,1,0,0,0,0,0,0,0,0,0,0,0,0,0,0,0,0,0,0,0,0,0,0,0,0,0,0,0,0,0,0,0,0,0,0,0,0,0,0,0,0,0,0,0,0,0,0,0,0,0
29/6/2010,William Gallas,2265,769,8/17/1977,32,84,5,11,0,6724,7379,7750,175,164,29536581,183,72,D C,1,1,2,3,1,2,3,4,1,3,3,5,5,10,10,14,2,16,10,5,16,12,7,17,13,15,16,15,15,14,9,15,16,10,12,12,14,15,16,15,13,16,13,12,15,14,20,16,15,15,10,15,14,15,11,19,13,10,10,10,8,14,D C,101,1,1,20,20,1,1,14,1,14,1,1,1,1,1,20,14,14,1,1,1,1,1,4,0,0,1,0,0,0,0,0,0,0,0,0,0,0,0,0,0,0,0,0,0,0,0,0,0,0,0,0,0,0,0,0,0,0,0,0,0,0,0,0,0,0,0,0,0,0,0,0
29/6/2010,Wes Brown,2003610,765,10/13/1979,30,23,1,8,0,6006,7750,7750,160,155,108162998,185,78,D RC,2,2,2,3,3,3,1,4,2,1,2,5,11,7,2,12,5,17,1,11,16,9,2,18,12,16,15,18,12,14,5,13,18,3,6,7,16,16,17,14,13,14,14,10,14,14,20,16,16,15,14,15,13,10,5,15,18,15,16,15,17,6,D RC,103,1,1,20,20,1,1,1,1,19,10,1,1,1,1,20,1,19,1,1,1,1,1,137438986240,0,0,0,0,0,0,0,0,0,0,0,0,0,0,0,1,0,0,0,0,0,0,0,0,0,0,0,0,0,0,0,0,0,0,0,0,0,1,0,0,0,0,0,0,0,0,0,0
29/6/2010,Weligton,316418,1651,8/26/1979,30,0,0,0,0,4970,6750,7250,143,141,9945342,185,72,D C,2,2,1,2,1,3,2,1,3,3,2,7,8,6,7,8,8,15,10,10,14,12,10,13,11,15,16,15,10,14,7,13,15,6,15,10,14,14,14,11,11,16,14,20,14,13,5,14,16,15,14,10,6,14,12,12,17,14,15,11,13,7,D C,101,1,1,20,20,10,1,10,1,1,1,1,1,1,1,20,10,1,1,1,1,1,1,32832,0,0,0,0,0,0,1,0,0,0,0,0,0,0,0,1,0,0,0,0,0,0,0,0,0,0,0,0,0,0,0,0,0,0,0,0,0,0,0,0,0,0,0,0,0,0,0,0
29/6/2010,Walter Samuel,108414,1649,3/22/1978,32,56,4,6,0,7396,8250,8600,179,172,154317397,183,83,D C,1,1,1,1,1,1,1,1,1,1,1,4,6,6,8,8,6,18,8,14,19,11,6,19,11,17,18,18,15,16,7,16,18,4,16,9,19,15,17,13,12,18,13,20,13,14,5,17,18,16,17,17,16,4,16,15,16,15,16,13,13,8,D C,101,1,1,20,20,1,1,4,1,1,15,1,1,1,1,20,4,1,1,1,1,1,1,274877939712,0,0,0,0,0,0,0,0,0,0,0,0,0,0,0,1,0,0,0,0,0,0,0,0,0,0,0,0,0,0,0,0,0,0,0,0,0,0,1,0,0,0,0,0,0,0,0,0
29/6/2010,Waldo Ponce,5250604,1652,12/4/1982,27,29,2,0,0,3200,6500,6500,150,130,2089197,182,78,D C,3,3,3,2,2,2,3,5,3,2,2,6,5,8,5,7,15,16,10,5,16,10,5,14,10,16,15,15,10,11,8,12,13,5,16,6,15,12,13,12,8,15,16,10,16,13,20,16,16,14,8,12,12,5,13,14,12,12,13,12,10,13,D C,101,1,1,20,20,10,1,1,1,14,20,1,1,1,1,20,1,14,1,1,1,1,1,35188667089408,0,0,0,0,0,0,0,0,0,1,0,0,0,0,0,1,0,0,0,0,0,0,0,0,0,0,0,0,0,0,0,0,1,0,0,0,0,0,0,0,0,0,0,0,0,1,0,0
29/6/2010,Vujadin Savic,62028022,802,7/1/1990,19,0,0,8,0,3364,5800,5400,150,116,10029464,194,82,D C,3,1,3,2,1,1,3,1,2,3,2,9,11,9,5,11,9,13,9,12,12,9,12,12,11,14,13,12,13,13,12,14,12,8,12,9,13,14,14,9,8,13,17,8,13,10,20,12,13,12,9,10,8,8,9,15,13,14,12,13,11,5,D C,101,1,1,20,20,1,1,1,1,14,1,10,1,1,1,20,1,14,1,1,1,1,10,0,0,0,0,0,0,0,0,0,0,0,0,0,0,0,0,0,0,0,0,0,0,0,0,0,0,0,0,0,0,0,0,0,0,0,0,0,0,0,0,0,0,0,0,0,0,0,0,0
29/6/2010,Vincenzo Camilleri,28021038,776,3/6/1992,18,0,0,0,0,1250,4500,4500,127,90,610093,186,85,D C,3,2,1,3,2,2,2,7,1,1,1,2,2,5,3,10,3,14,3,4,13,10,4,11,9,9,10,9,13,13,7,11,13,14,8,4,11,6,8,11,10,10,12,10,18,11,20,11,8,13,11,14,15,7,8,10,10,14,15,11,15,4,D C,101,1,1,20,20,1,1,1,1,1,1,1,1,1,1,20,1,1,1,1,1,1,1,0,0,0,0,0,0,0,0,0,0,0,0,0,0,0,0,0,0,0,0,0,0,0,0,0,0,0,0,0,0,0,0,0,0,0,0,0,0,0,0,0,0,0,0,0,0,0,0,0
29/6/2010,Vincent Kompany,8152558,757,4/10/1986,24,31,1,0,0,5476,7750,7400,156,148,14692290,191,91,D/DM C,3,2,1,2,2,1,3,1,2,1,2,5,5,9,7,14,12,15,10,12,14,12,10,16,12,14,15,14,14,12,12,12,15,11,14,9,15,14,14,15,15,16,16,10,6,13,20,15,16,11,8,15,17,14,14,13,11,18,8,17,14,12,D/DM C,111,1,1,20,20,17,1,1,15,12,1,1,1,1,1,20,1,12,15,1,1,1,1,4294967328,0,0,0,0,0,1,0,0,0,0,0,0,0,0,0,0,0,0,0,0,0,0,0,0,0,0,0,0,0,0,0,0,1,0,0,0,0,0,0,0,0,0,0,0,0,0,0,0
29/6/2010,Víctor Ruiz,67046591,796,1/25/1989,21,0,0,0,0,4500,6500,6500,155,138,9010175,184,73,D C,3,3,1,2,3,3,2,3,2,1,2,7,6,6,7,9,8,14,8,11,14,13,5,15,11,14,12,15,13,13,10,12,10,8,11,7,14,18,15,14,13,15,13,20,12,14,6,15,13,12,11,12,7,11,8,13,13,7,9,20,5,8,D C,101,1,1,20,20,1,1,10,1,1,1,1,1,1,1,20,10,1,1,1,1,1,1,0,0,0,0,0,0,0,0,0,0,0,0,0,0,0,0,0,0,0,0,0,0,0,0,0,0,0,0,0,0,0,0,0,0,0,0,0,0,0,0,0,0,0,0,0,0,0,0,0
29/6/2010,Vedran Corluka,126527,761,3/31/1986,24,36,1,0,0,5184,7920,7400,164,144,43486185,192,89,D RC,1,1,2,3,2,1,2,5,2,1,2,3,11,11,9,13,5,15,5,15,13,11,6,15,15,14,15,13,17,12,10,12,17,5,12,8,12,15,14,14,13,16,15,13,14,12,20,14,16,15,4,16,11,12,13,14,15,13,16,17,15,8,D RC,103,1,1,16,20,12,1,10,15,20,12,14,1,1,1,16,10,20,15,1,1,1,14,143881404456,0,0,0,1,0,1,0,0,0,0,0,0,0,0,0,0,0,0,0,0,0,0,0,0,0,0,0,0,0,0,0,1,1,0,0,0,0,1,0,0,0,0,0,0,0,0,0,0
29/6/2010,Vangelis Moras,678479,772,8/26/1981,28,12,0,11,0,2500,6500,6300,135,129,2900346,193,78,D RC,3,3,1,1,1,2,1,1,1,2,2,9,9,12,7,9,9,14,8,12,15,13,7,14,13,14,15,14,12,12,10,11,16,10,10,11,14,13,15,11,12,13,17,6,16,13,20,15,12,14,11,14,8,11,15,14,9,12,15,14,13,5,D RC,103,1,1,20,20,14,1,8,1,15,1,7,1,1,1,20,8,15,1,1,1,1,7,32,0,0,0,0,0,1,0,0,0,0,0,0,0,0,0,0,0,0,0,0,0,0,0,0,0,0,0,0,0,0,0,0,0,0,0,0,0,0,0,0,0,0,0,0,0,0,0,0
29/6/2010,Valdomiro,301522,1651,2/6/1979,31,0,0,0,0,2750,5500,5750,122,115,1214873,192,90,D C,2,3,2,1,2,2,2,10,2,3,1,8,9,10,8,9,5,14,11,12,13,11,6,12,10,17,10,12,8,12,12,12,14,3,6,6,12,14,13,10,10,14,15,20,14,8,10,14,16,14,16,15,9,13,9,14,13,10,7,8,5,13,D C,101,1,1,20,20,1,1,1,1,1,1,1,1,1,1,20,1,1,1,1,1,1,1,32768,0,0,0,0,0,0,0,0,0,0,0,0,0,0,0,1,0,0,0,0,0,0,0,0,0,0,0,0,0,0,0,0,0,0,0,0,0,0,0,0,0,0,0,0,0,0,0,0
29/6/2010,Ustaritz,7450345,796,2/16/1983,27,0,0,0,0,4096,6000,6000,142,128,3367150,183,75,D C,2,1,1,2,2,3,3,1,2,1,3,4,4,11,7,10,6,12,8,4,14,13,5,14,10,10,15,14,12,12,11,13,10,8,11,6,14,13,14,13,15,13,10,12,12,12,20,13,13,12,12,13,16,10,12,13,12,10,12,14,9,11,D C,101,1,1,20,20,9,1,8,1,10,1,1,1,1,1,20,8,10,1,1,1,1,1,0,0,0,0,0,0,0,0,0,0,0,0,0,0,0,0,0,0,0,0,0,0,0,0,0,0,0,0,0,0,0,0,0,0,0,0,0,0,0,0,0,0,0,0,0,0,0,0,0
29/6/2010,Ulick Lupède,8428752,769,6/1/1984,26,0,0,0,0,1500,4319,4500,115,96,90076,183,82,D C,2,2,2,3,1,1,1,2,2,3,2,5,7,5,5,7,5,13,8,7,12,8,6,10,9,11,10,13,12,12,5,10,14,5,9,6,12,12,12,13,10,13,12,8,13,13,20,13,14,13,11,10,7,10,18,12,12,9,14,14,14,7,D C,101,1,1,20,20,1,1,1,1,10,1,10,1,1,1,20,1,10,1,1,1,1,10,0,0,0,0,0,0,0,0,0,0,0,0,0,0,0,0,0,0,0,0,0,0,0,0,0,0,0,0,0,0,0,0,0,0,0,0,0,0,0,0,0,0,0,0,0,0,0,0,0
29/6/2010,Tore Reginiussen,762571,786,4/10/1986,24,8,1,15,0,4290,6800,6700,151,131,3497151,185,80,D C,2,3,3,2,3,3,1,6,1,2,2,4,5,8,5,11,4,14,6,12,13,12,9,15,9,14,14,14,11,11,10,12,16,5,10,7,14,15,7,15,12,13,13,10,12,14,20,12,14,10,5,11,10,6,10,15,17,15,17,17,17,1,D C,101,1,1,20,20,8,1,10,1,8,1,1,1,1,1,20,10,8,1,1,1,1,1,4294967296,0,0,0,0,0,0,0,0,0,0,0,0,0,0,0,0,0,0,0,0,0,0,0,0,0,0,0,0,0,0,0,0,1,0,0,0,0,0,0,0,0,0,0,0,0,0,0,0
29/6/2010,Tomas Ujfalusi,133081,763,3/24/1978,32,71,2,25,1,5256,7500,7500,153,145,91453172,185,76,D RC,3,1,3,3,2,3,1,6,2,2,1,8,12,12,6,12,7,14,9,10,15,13,11,15,11,14,15,15,14,12,10,14,17,8,12,8,14,14,13,13,12,16,14,14,16,12,20,16,16,14,13,14,7,15,18,16,15,15,18,15,11,4,D RC,103,1,1,20,20,8,1,5,1,19,8,1,1,1,1,20,5,19,1,1,1,1,1,2199023255552,0,0,0,0,0,0,0,0,0,0,0,0,0,0,0,0,0,0,0,0,0,0,0,0,0,0,0,0,0,0,0,0,0,0,0,0,0,0,0,0,0,1,0,0,0,0,0,0
29/6/2010,Titus Bramble,4000072,765,7/31/1981,28,0,0,10,1,4600,7000,7000,147,142,5540876,188,88,D C,3,1,2,1,1,2,1,4,2,1,3,3,9,7,7,13,3,18,4,2,15,14,4,17,13,14,15,16,13,9,12,9,16,10,13,8,13,14,15,14,9,13,16,10,14,14,20,15,16,11,10,10,7,9,14,14,17,9,11,14,9,15,D C,101,1,1,20,20,1,1,1,1,8,10,1,1,1,1,20,1,8,1,1,1,1,1,5368709120,0,0,0,0,0,0,0,0,0,0,0,0,0,0,0,0,0,0,0,0,0,0,0,0,0,0,0,0,0,0,1,0,1,0,0,0,0,0,0,0,0,0,0,0,0,0,0,0
29/6/2010,Timmy Simons,3339,757,12/11/1976,33,74,3,0,0,4160,7095,6400,150,129,2335015,186,78,D/DM C,2,2,1,1,3,3,1,4,1,3,3,9,9,8,7,12,10,15,10,12,15,11,18,15,11,12,13,12,14,13,12,13,18,10,18,10,15,15,14,11,11,14,14,10,15,11,20,12,12,16,6,17,2,17,16,12,15,16,18,16,15,1,D/DM C,321,1,1,20,18,20,1,1,15,14,14,7,1,1,1,18,1,14,15,1,1,1,7,0,0,0,0,0,0,0,0,0,0,0,0,0,0,0,0,0,0,0,0,0,0,0,0,0,0,0,0,0,0,0,0,0,0,0,0,0,0,0,0,0,0,0,0,0,0,0,0,0
29/6/2010,Tim Hoogland,8707937,771,6/11/1985,25,0,0,0,0,3400,6000,6000,138,131,2911143,183,78,D/M RC,1,2,3,2,2,1,3,4,1,3,3,8,10,7,14,9,8,17,13,16,15,9,8,15,8,16,12,16,10,15,7,10,11,4,13,14,14,16,17,14,10,12,14,6,13,14,20,17,12,12,10,12,13,17,12,14,8,8,10,13,6,13,D/M RC,113,1,12,15,20,10,1,1,16,20,1,14,1,1,12,15,1,20,1,1,16,1,14,0,0,0,0,0,0,0,0,0,0,0,0,0,0,0,0,0,0,0,0,0,0,0,0,0,0,0,0,0,0,0,0,0,0,0,0,0,0,0,0,0,0,0,0,0,0,0,0,0
29/6/2010,Thomas Vermaelen,8154103,757,11/14/1985,24,27,1,12,1,6162,8000,7850,164,157,-1,183,73,D LC,2,2,2,3,2,3,1,5,3,2,3,7,8,10,11,13,8,17,13,8,15,13,10,16,13,16,17,18,15,14,12,13,18,7,15,11,16,14,14,12,13,14,13,20,14,14,10,14,14,15,7,14,10,13,16,14,15,13,16,13,13,3,D LC,104,1,1,20,20,10,1,17,1,5,1,10,1,1,1,20,17,5,1,1,1,10,1,8796093022208,0,0,0,0,0,0,0,0,0,0,0,0,0,0,0,0,0,0,0,0,0,0,0,0,0,0,0,0,0,0,0,0,0,0,0,0,0,0,0,0,0,0,0,1,0,0,0,0
29/6/2010,Thomas Mangani,919962,769,4/29/1987,23,0,0,0,0,3906,5600,5600,140,125,1902707,183,78,D/DM C,1,3,2,2,1,1,2,3,1,1,2,6,8,9,6,12,6,13,10,12,11,12,8,13,12,12,15,13,13,13,11,13,15,6,12,7,13,16,18,12,11,14,12,20,14,11,8,16,14,14,12,14,6,12,10,12,14,11,15,15,15,5,D/DM C,321,1,5,20,17,20,1,14,15,1,1,14,5,1,1,17,14,1,15,12,1,14,1,137438953472,0,0,0,0,0,0,0,0,0,0,0,0,0,0,0,0,0,0,0,0,0,0,0,0,0,0,0,0,0,0,0,0,0,0,0,0,0,1,0,0,0,0,0,0,0,0,0,0
29/6/2010,Thomas Heurtaux,34003995,769,7/3/1988,21,0,0,4,0,150,4000,4000,140,120,1732810,183,75,D C,3,1,3,3,2,3,3,3,2,1,2,5,5,7,6,10,7,14,8,11,13,8,6,13,10,13,14,15,13,13,9,13,14,6,13,7,14,13,14,12,9,14,12,5,8,11,20,15,15,14,13,7,6,13,14,14,14,14,14,14,14,5,D C,101,1,8,20,20,10,1,10,10,13,1,1,8,1,1,20,10,13,10,1,1,1,1,0,0,0,0,0,0,0,0,0,0,0,0,0,0,0,0,0,0,0,0,0,0,0,0,0,0,0,0,0,0,0,0,0,0,0,0,0,0,0,0,0,0,0,0,0,0,0,0,0
29/6/2010,Thiago Silva,8833628,1651,9/22/1984,25,7,0,4,0,6250,8400,8200,174,165,155002075,183,79,D C,3,1,1,2,1,2,1,6,2,2,1,8,5,9,9,12,13,16,11,14,17,14,16,16,14,14,16,14,15,14,14,14,17,8,16,14,16,13,14,15,14,15,12,8,16,17,20,15,14,16,12,15,11,5,14,16,16,15,16,15,15,6,D C,101,1,1,20,20,13,1,1,9,1,10,1,1,1,1,20,1,1,9,1,1,1,1,2199023288324,0,0,1,0,0,0,0,0,0,0,0,0,0,0,0,1,0,0,0,0,0,0,0,0,0,0,0,0,0,0,0,0,0,0,0,0,0,0,0,0,0,1,0,0,0,0,0,0
29/6/2010,Thanos Petsos,91014707,772,6/5/1991,19,0,0,1,0,500,4000,4000,125,85,376639,184,80,D RLC,3,1,1,3,3,3,3,1,2,2,3,10,8,8,10,7,5,14,4,4,11,8,5,14,12,9,12,14,9,13,4,6,10,4,11,5,9,11,13,9,8,7,12,20,10,13,9,9,8,4,9,10,11,10,8,13,10,16,7,9,7,9,D RLC,106,1,1,20,20,1,1,20,1,16,1,7,1,1,1,20,20,16,1,1,1,7,1,0,0,0,0,0,0,0,0,0,0,0,0,0,0,0,0,0,0,0,0,0,0,0,0,0,0,0,0,0,0,0,0,0,0,0,0,0,0,0,0,0,0,0,0,0,0,0,0,0
29/6/2010,Teddy Mézague,34000012,769,5/27/1990,20,0,0,0,0,50,2450,2450,125,99,2532744,185,83,D C,3,3,1,2,1,2,3,1,3,3,3,5,5,5,5,7,2,14,3,6,13,6,2,10,7,8,11,14,12,12,6,11,11,5,8,6,12,16,16,11,7,15,12,5,15,10,20,13,15,14,6,10,5,10,11,20,20,14,15,12,13,10,D C,101,1,1,20,20,1,1,1,1,1,1,1,1,1,1,20,1,1,1,1,1,1,1,0,0,0,0,0,0,0,0,0,0,0,0,0,0,0,0,0,0,0,0,0,0,0,0,0,0,0,0,0,0,0,0,0,0,0,0,0,0,0,0,0,0,0,0,0,0,0,0,0
29/6/2010,Tamás Kádár,38001846,773,3/14/1990,20,0,0,1,0,3000,4949,5600,150,110,8221322,188,72,D LC,1,3,3,2,3,1,1,2,2,3,2,5,8,10,5,13,5,11,8,10,12,8,8,14,11,16,10,16,11,10,8,12,13,10,7,8,13,10,11,14,14,11,12,20,10,12,7,13,13,12,12,10,12,9,12,16,10,12,12,8,13,5,D LC,104,1,1,20,20,1,1,19,1,1,1,10,1,1,1,20,19,1,1,1,1,10,1,0,0,0,0,0,0,0,0,0,0,0,0,0,0,0,0,0,0,0,0,0,0,0,0,0,0,0,0,0,0,0,0,0,0,0,0,0,0,0,0,0,0,0,0,0,0,0,0,0
29/6/2010,Tal Ben-Haim,7860357,775,3/31/1982,28,54,0,6,0,4290,7205,6750,150,131,2966106,181,74,D C,1,3,1,3,3,2,3,4,2,2,3,8,9,5,8,9,4,16,10,11,14,10,10,15,9,12,14,10,9,15,8,13,18,9,11,9,15,18,14,10,11,13,12,11,11,13,20,14,14,12,13,15,3,10,15,10,20,13,18,16,15,12,D C,101,1,1,20,20,1,1,11,1,14,20,1,1,1,1,20,11,14,1,1,1,1,1,274877939776,0,0,0,0,0,0,1,0,0,0,0,0,0,0,0,1,0,0,0,0,0,0,0,0,0,0,0,0,0,0,0,0,0,0,0,0,0,0,1,0,0,0,0,0,0,0,0,0
29/6/2010,Sylvain Monsoreau,910802,769,1/23/1981,29,0,0,12,0,1450,6150,6150,140,125,3175475,186,80,D LC,3,1,1,1,1,2,3,5,3,3,3,8,11,8,6,10,7,14,8,9,14,12,11,12,11,10,14,14,15,14,9,14,16,6,13,7,13,14,13,12,11,15,13,20,15,11,5,15,15,15,7,15,14,10,13,14,14,13,15,15,15,6,D LC,104,1,5,20,20,10,1,17,1,1,12,10,5,1,1,20,17,1,1,1,1,10,1,562949953421312,0,0,0,0,0,0,0,0,0,0,0,0,0,0,0,0,0,0,0,0,0,0,0,0,0,0,0,0,0,0,0,0,0,0,0,0,0,0,0,0,0,0,0,0,0,0,0,0
29/6/2010,Sylvain Marchal,3503908,769,2/10/1980,30,0,0,0,0,1450,6250,6250,145,138,7954527,184,80,D C,1,2,1,2,1,2,3,5,2,1,2,5,7,6,6,10,7,14,8,10,14,9,7,12,7,13,16,14,14,14,7,13,15,5,15,6,15,14,14,13,9,16,12,16,13,11,20,15,16,15,10,15,11,10,13,12,15,14,14,14,14,6,D C,101,1,1,20,20,10,1,12,1,1,14,1,1,1,1,20,12,1,1,1,1,1,1,0,0,0,0,0,0,0,0,0,0,0,0,0,0,0,0,0,0,0,0,0,0,0,0,0,0,0,0,0,0,0,0,0,0,0,0,0,0,0,0,0,0,0,0,0,0,0,0,0
29/6/2010,Sylvain Distin,3506134,769,12/16/1977,32,0,0,0,0,5256,6524,7250,155,145,7344360,194,88,D C,1,1,3,1,3,1,1,10,1,1,1,5,8,8,4,13,4,15,6,15,14,11,5,14,12,12,13,14,14,12,8,14,17,9,11,10,15,14,14,16,11,16,16,20,15,16,6,15,16,15,2,11,7,14,15,17,12,14,17,14,15,11,D C,101,1,1,20,20,1,1,10,1,1,1,7,1,1,1,20,10,1,1,1,1,7,1,292057776128,0,0,0,0,0,0,0,0,0,0,0,0,0,0,0,0,0,0,0,0,0,0,0,0,0,0,0,0,0,0,0,0,0,0,1,0,0,0,1,0,0,0,0,0,0,0,0,0
29/6/2010,Sylvain Armand,6201353,769,8/1/1980,29,0,0,9,0,3906,5600,5600,145,125,2165887,182,82,D LC,2,1,1,1,3,3,2,1,3,3,1,10,11,9,6,11,13,15,13,12,13,12,12,15,11,14,14,16,13,11,9,12,14,6,14,7,13,16,13,11,11,15,12,20,14,11,8,15,15,12,14,13,6,12,13,14,13,9,16,14,12,7,D LC,104,1,1,20,20,14,1,18,12,1,1,14,1,1,1,20,18,1,10,12,1,14,1,35184372088832,0,0,0,0,0,0,0,0,0,0,0,0,0,0,0,0,0,0,0,0,0,0,0,0,0,0,0,0,0,0,0,0,0,0,0,0,0,0,0,0,0,0,0,0,0,1,0,0
29/6/2010,Steven Taylor,5114243,765,1/23/1986,24,0,0,29,4,4422,6500,6500,150,133,3950340,188,81,D RC,2,1,3,1,3,1,3,6,1,3,1,5,8,9,10,9,3,16,3,8,14,10,5,15,9,17,14,18,9,11,8,9,18,5,14,10,13,11,18,13,11,12,16,8,11,15,20,15,16,11,16,16,9,10,10,15,9,14,12,7,9,5,D RC,103,1,1,20,20,1,1,10,1,18,1,1,1,1,1,20,10,18,1,1,1,1,1,2199023353888,0,0,0,0,0,1,0,0,0,0,0,0,0,0,0,1,1,0,0,0,0,0,0,0,0,0,0,0,0,0,0,0,0,0,0,0,0,0,0,0,0,1,0,0,0,0,0,0
29/6/2010,Steven Mouyokolo,34000657,49,1/24/1987,23,0,0,0,0,4225,5849,6250,150,130,5750000,190,86,D C,1,1,2,2,1,3,1,1,3,3,2,5,5,5,6,12,5,16,9,8,14,7,5,14,12,13,14,16,15,15,7,12,15,6,13,6,11,15,15,12,8,17,15,6,14,13,20,14,14,16,13,14,11,8,11,13,11,14,12,14,14,7,D C,101,1,1,20,20,1,1,1,1,10,1,1,1,1,1,20,1,10,1,1,1,1,1,32768,0,0,0,0,0,0,0,0,0,0,0,0,0,0,0,1,0,0,0,0,0,0,0,0,0,0,0,0,0,0,0,0,0,0,0,0,0,0,0,0,0,0,0,0,0,0,0,0
29/6/2010,Steven Caldwell,103396,793,9/12/1980,29,10,0,8,0,3721,6250,5750,125,122,2588868,183,73,D C,1,3,1,1,3,3,1,2,3,2,1,3,3,5,7,8,6,16,6,3,14,12,8,15,13,17,13,15,11,12,13,13,17,6,17,9,13,14,15,7,9,9,15,8,14,7,20,16,16,11,14,12,10,6,15,17,10,15,15,16,17,5,D C,101,1,1,20,20,6,1,4,5,6,6,1,1,1,1,20,4,6,5,1,1,1,1,0,0,0,0,0,0,0,0,0,0,0,0,0,0,0,0,0,0,0,0,0,0,0,0,0,0,0,0,0,0,0,0,0,0,0,0,0,0,0,0,0,0,0,0,0,0,0,0,0
29/6/2010,Steve von Bergen,5720067,798,6/10/1983,27,14,0,11,0,4096,6700,6700,134,128,4855455,182,77,D C,3,1,3,2,3,1,1,7,1,3,3,5,8,7,5,12,6,10,6,10,14,12,6,15,12,15,9,12,9,12,10,14,16,5,12,6,11,18,16,16,13,12,11,14,14,16,20,14,12,14,3,11,8,10,15,14,13,15,16,17,12,2,D C,101,1,1,20,20,1,1,1,1,12,18,1,1,1,1,20,1,12,1,1,1,1,1,8796093022216,0,0,0,1,0,0,0,0,0,0,0,0,0,0,0,0,0,0,0,0,0,0,0,0,0,0,0,0,0,0,0,0,0,0,0,0,0,0,0,0,0,0,0,1,0,0,0,0
29/6/2010,Steve Gohouri,5720388,24,2/8/1981,29,11,3,0,0,3600,6500,6300,125,120,2942515,188,88,D C,3,2,1,1,2,3,1,3,1,2,1,5,5,7,10,8,6,18,6,15,17,8,8,13,7,18,13,19,7,5,9,7,18,5,12,9,7,14,18,14,10,17,16,20,16,15,6,16,17,10,16,13,11,10,12,17,11,12,6,10,7,14,D C,101,10,1,20,20,1,1,10,1,14,1,1,1,1,1,20,10,14,1,1,1,1,1,154619019272,0,0,0,1,0,0,0,0,0,0,0,0,0,0,0,0,1,1,0,0,0,0,0,0,0,0,0,0,0,0,0,0,0,0,1,0,0,1,0,0,0,0,0,0,0,0,0,0
29/6/2010,Stéphane Mbia,8440903,11,5/20/1986,24,34,3,4,1,5476,7400,6650,165,148,28514819,189,82,D/DM C,1,3,3,2,2,1,1,2,3,1,2,7,10,12,7,11,11,16,12,8,14,12,8,15,12,15,16,16,15,12,8,12,16,9,11,10,16,14,17,15,10,18,14,8,15,14,20,17,17,14,16,16,10,14,14,20,8,13,6,8,8,16,D/DM C,111,1,5,20,20,18,1,1,15,12,1,12,5,1,1,20,1,12,15,1,1,1,12,279172874496,0,0,0,0,0,0,0,0,1,0,0,0,0,0,0,0,0,0,0,0,0,0,0,0,0,0,0,0,0,0,0,0,1,0,0,0,0,0,1,0,0,0,0,0,0,0,0,0
29/6/2010,Stéphane Grichting,2018518,798,3/30/1979,31,38,1,25,0,4556,7000,5850,138,135,3153166,186,80,D LC,1,1,3,3,2,1,1,1,1,1,1,5,9,7,7,8,9,16,12,7,16,10,10,15,8,16,15,16,12,16,8,13,16,6,14,7,15,15,16,10,8,16,13,20,16,9,9,16,16,14,14,15,10,12,14,14,14,13,15,13,13,6,D LC,104,1,1,20,20,1,1,16,1,10,14,8,1,1,1,20,16,10,1,1,1,8,8,32768,0,0,0,0,0,0,0,0,0,0,0,0,0,0,0,1,0,0,0,0,0,0,0,0,0,0,0,0,0,0,0,0,0,0,0,0,0,0,0,0,0,0,0,0,0,0,0,0
29/6/2010,Stefano Lucchini,3804849,776,10/2/1980,29,0,0,12,0,4500,7150,7150,145,145,6179977,186,76,D RLC,3,3,1,1,1,1,1,1,2,2,3,5,8,8,7,7,5,15,6,10,14,10,6,16,7,15,16,12,13,13,18,15,12,8,12,18,14,10,10,11,12,11,14,10,14,14,20,16,14,11,12,15,8,15,10,12,10,13,12,11,10,10,D RLC,106,1,1,20,20,1,1,15,1,15,1,1,1,1,1,20,15,15,1,1,1,1,1,0,0,0,0,0,0,0,0,0,0,0,0,0,0,0,0,0,0,0,0,0,0,0,0,0,0,0,0,0,0,0,0,0,0,0,0,0,0,0,0,0,0,0,0,0,0,0,0,0
29/6/2010,Stefano Ferrario,7982770,776,3/28/1985,25,0,0,0,0,250,5450,5450,145,123,2389417,190,86,D C,1,3,3,2,1,3,3,1,3,1,1,5,6,5,6,8,4,17,6,11,15,8,10,15,7,15,13,14,10,14,5,12,13,4,8,5,12,11,11,10,7,13,17,5,13,11,20,14,16,15,13,12,11,6,11,14,12,15,13,15,14,4,D C,101,1,1,20,20,1,1,1,1,1,1,1,1,1,1,20,1,1,1,1,1,1,1,0,0,0,0,0,0,0,0,0,0,0,0,0,0,0,0,0,0,0,0,0,0,0,0,0,0,0,0,0,0,0,0,0,0,0,0,0,0,0,0,0,0,0,0,0,0,0,0,0
29/6/2010,Stefan Schwellenbach,8724327,771,3/17/1984,26,0,0,0,0,1500,4500,4500,115,95,717123,186,78,D C,1,1,2,3,1,3,1,2,3,1,1,6,6,5,6,10,2,13,9,6,12,8,7,9,7,11,8,12,12,12,5,9,10,6,11,10,12,14,15,8,8,9,13,15,15,9,20,12,15,14,10,10,12,10,8,9,7,6,14,7,7,12,D C,101,1,1,20,20,12,1,10,3,7,10,8,1,1,1,20,10,7,3,1,1,8,5,0,0,0,0,0,0,0,0,0,0,0,0,0,0,0,0,0,0,0,0,0,0,0,0,0,0,0,0,0,0,0,0,0,0,0,0,0,0,0,0,0,0,0,0,0,0,0,0,0
29/6/2010,Stefan Reinartz,35008899,771,1/1/1989,21,1,0,5,0,4000,6750,6750,158,135,8485056,189,84,D/DM C,3,3,1,1,2,3,3,2,1,1,2,4,8,10,8,11,6,15,6,10,14,13,8,14,11,11,14,13,13,13,12,12,13,5,9,8,14,16,12,13,12,16,16,10,15,14,20,14,15,13,3,11,9,10,6,14,13,13,14,15,18,5,D/DM C,111,1,1,20,20,18,1,1,15,1,1,1,1,1,1,20,1,1,15,1,1,1,1,0,0,0,0,0,0,0,0,0,0,0,0,0,0,0,0,0,0,0,0,0,0,0,0,0,0,0,0,0,0,0,0,0,0,0,0,0,0,0,0,0,0,0,0,0,0,0,0,0
29/6/2010,Stefan Radu,7545224,790,10/22/1986,23,8,0,0,0,5112,7000,6500,165,143,7991173,183,79,D LC,3,2,1,3,3,1,1,7,1,1,2,5,8,11,7,9,7,14,9,8,16,11,10,15,12,14,15,13,15,14,12,13,12,7,13,11,15,16,15,13,14,14,11,20,16,13,10,13,14,14,13,15,5,13,18,13,15,10,15,14,15,5,D LC,104,1,1,20,20,1,1,18,1,1,1,1,1,1,1,20,18,1,1,1,1,1,1,196672,0,0,0,0,0,0,1,0,0,0,0,0,0,0,0,0,1,1,0,0,0,0,0,0,0,0,0,0,0,0,0,0,0,0,0,0,0,0,0,0,0,0,0,0,0,0,0,0
29/6/2010,Soumahoro Johnson,85066974,24,2/27/1988,22,0,0,8,0,1300,5250,2600,135,105,2076390,186,80,D C,2,2,2,3,3,2,3,6,1,2,1,5,5,7,6,7,6,14,7,5,13,8,6,12,7,15,12,14,8,11,6,10,14,9,7,7,9,10,13,14,11,15,13,20,14,13,5,14,15,13,15,13,7,6,7,15,7,10,12,10,10,11,D C,101,1,1,20,20,1,1,10,1,1,1,1,1,1,1,20,10,1,1,1,1,1,1,32768,0,0,0,0,0,0,0,0,0,0,0,0,0,0,0,1,0,0,0,0,0,0,0,0,0,0,0,0,0,0,0,0,0,0,0,0,0,0,0,0,0,0,0,0,0,0,0,0
29/6/2010,Souleymane Diawara,6200433,41,12/24/1978,31,39,2,0,0,5852,7650,6900,155,153,25376041,187,88,D C,2,3,3,1,3,3,2,2,1,1,1,5,6,7,7,9,5,18,9,11,17,8,10,16,9,16,15,18,14,12,7,12,17,8,15,8,15,15,17,15,8,18,14,5,16,13,20,17,18,16,14,15,7,10,10,16,12,14,9,11,15,10,D C,101,1,1,20,20,1,1,8,1,8,1,1,1,1,1,20,8,8,1,1,1,1,1,563087392407584,0,0,0,0,0,1,0,0,0,0,0,0,0,0,0,1,0,0,0,0,0,0,0,0,0,0,0,0,0,0,0,0,0,0,0,0,0,1,0,0,0,0,0,0,0,0,0,0
29/6/2010,Souleymane Diamoutene,837067,31,1/30/1983,27,46,2,0,0,3192,6215,5850,127,113,1557384,184,80,D RC,1,1,1,1,1,1,1,1,1,1,1,8,4,7,10,8,9,18,6,4,14,10,5,14,7,17,13,12,11,8,8,10,16,8,8,7,9,14,12,15,14,11,12,5,8,14,20,15,15,13,8,12,3,10,15,10,15,7,12,14,9,7,D RC,103,1,1,20,20,1,1,10,2,16,1,8,1,1,1,20,10,16,2,2,2,5,8,32,0,0,0,0,0,1,0,0,0,0,0,0,0,0,0,0,0,0,0,0,0,0,0,0,0,0,0,0,0,0,0,0,0,0,0,0,0,0,0,0,0,0,0,0,0,0,0,0
29/6/2010,Sotiris Kyrgiakos,675787,772,7/23/1979,30,60,4,11,0,4624,7480,7000,150,136,4000000,193,88,D C,2,3,1,2,3,2,3,7,2,2,1,4,6,4,8,8,6,16,8,9,17,8,8,16,9,17,14,19,9,13,7,12,16,8,14,8,14,14,16,9,8,16,17,5,15,12,20,13,18,14,15,14,10,3,14,15,8,15,16,7,6,12,D C,101,1,1,20,20,1,1,1,1,1,5,1,1,1,1,20,1,1,1,1,1,1,1,2203318321152,0,0,0,0,0,0,0,0,0,0,0,0,0,0,0,1,1,0,0,0,0,0,0,0,0,0,0,0,0,0,0,0,1,0,0,0,0,0,0,0,0,1,0,0,0,0,0,0
29/6/2010,Sol Campbell,2003678,765,9/18/1974,35,73,1,11,2,4556,6250,6250,182,135,1559908,188,84,D C,3,2,2,1,2,3,3,4,3,1,2,1,4,7,7,10,7,17,4,6,13,9,6,16,12,13,13,17,13,13,8,17,17,5,19,7,15,13,11,9,6,10,16,8,6,11,20,9,17,11,12,14,14,10,12,19,8,13,14,15,14,14,D C,101,1,1,20,20,1,1,1,1,1,1,1,1,1,1,20,1,1,1,1,1,1,1,562949953421312,0,0,0,0,0,0,0,0,0,0,0,0,0,0,0,0,0,0,0,0,0,0,0,0,0,0,0,0,0,0,0,0,0,0,0,0,0,0,0,0,0,0,0,0,0,0,0,0
29/6/2010,Sokratis Papastathopoulos,1804808,772,6/9/1988,22,12,0,9,2,4970,7000,7000,165,141,24000000,183,80,D RC,2,1,3,2,3,2,3,7,3,3,2,3,4,9,8,7,4,15,6,12,16,10,4,15,12,16,15,15,10,12,8,14,16,7,13,11,14,13,15,13,12,16,13,8,14,13,20,15,16,14,16,13,5,8,14,15,12,14,13,12,13,5,D RC,103,1,1,19,20,5,1,3,9,20,12,14,1,1,1,19,3,20,1,1,9,1,14,32770,0,1,0,0,0,0,0,0,0,0,0,0,0,0,0,1,0,0,0,0,0,0,0,0,0,0,0,0,0,0,0,0,0,0,0,0,0,0,0,0,0,0,0,0,0,0,0,0
29/6/2010,Simon Kjær,947424,764,3/26/1989,21,11,0,2,0,5700,8300,8000,172,151,37960589,189,82,D C,1,3,3,2,2,1,1,7,2,3,3,3,2,5,3,14,13,15,9,13,17,15,3,16,13,5,15,16,16,14,9,14,15,9,14,13,14,10,13,10,13,12,15,14,14,13,20,12,14,18,6,15,5,12,14,12,12,16,16,16,14,3,D C,101,1,1,20,20,1,1,1,1,12,1,1,1,1,1,20,1,12,1,1,1,1,1,9070970929152,0,0,0,0,0,0,0,0,0,0,0,0,0,0,0,0,0,0,0,0,0,0,0,0,0,0,0,0,0,0,0,0,0,0,0,0,0,0,1,0,0,0,0,1,0,0,0,0
29/6/2010,Silva,317371,1651,8/6/1984,25,0,0,0,0,1750,4400,4400,117,98,2273632,178,75,D/DM C,3,2,3,2,3,1,3,1,3,3,3,9,8,9,7,12,14,12,10,6,11,11,10,14,7,10,14,11,8,6,10,13,9,11,14,4,11,13,8,11,10,15,11,11,8,11,20,11,15,9,8,10,5,10,12,9,13,13,14,4,11,11,D/DM C,321,1,1,20,18,20,1,1,15,1,1,1,1,1,1,18,1,1,15,1,1,1,1,35184372088832,0,0,0,0,0,0,0,0,0,0,0,0,0,0,0,0,0,0,0,0,0,0,0,0,0,0,0,0,0,0,0,0,0,0,0,0,0,0,0,0,0,0,0,0,0,1,0,0
29/6/2010,Sídnei,8832967,1651,8/23/1989,20,0,0,12,0,3500,6650,6650,149,136,10859232,185,80,D C,1,3,2,1,3,1,1,1,3,2,1,5,6,8,7,12,7,15,7,8,14,9,9,15,11,15,14,12,13,13,6,10,13,9,10,6,14,13,11,13,12,17,16,10,12,12,20,16,17,11,10,11,8,6,13,16,15,15,10,14,12,10,D C,101,1,1,20,20,8,1,5,1,5,10,1,1,1,1,20,5,5,1,1,1,1,1,0,0,0,0,0,0,0,0,0,0,0,0,0,0,0,0,0,0,0,0,0,0,0,0,0,0,0,0,0,0,0,0,0,0,0,0,0,0,0,0,0,0,0,0,0,0,0,0,0
29/6/2010,Sergio,4204249,796,5/23/1977,33,0,0,12,0,4096,6400,6400,139,128,1195484,191,81,D C,3,1,2,1,1,1,1,4,3,3,1,5,8,9,6,9,6,17,10,8,14,12,10,15,12,14,16,14,12,14,9,12,12,6,7,6,13,17,15,7,7,16,17,8,8,11,20,13,15,14,13,14,13,6,13,12,13,13,14,14,13,6,D C,101,1,1,20,20,4,1,1,1,6,12,1,1,1,1,20,1,6,1,1,1,1,1,137438953472,0,0,0,0,0,0,0,0,0,0,0,0,0,0,0,0,0,0,0,0,0,0,0,0,0,0,0,0,0,0,0,0,0,0,0,0,0,1,0,0,0,0,0,0,0,0,0,0
29/6/2010,Sergio Sánchez,1507596,796,4/3/1986,24,0,0,4,0,4500,6600,6600,156,138,5999998,185,78,D RC,3,1,1,2,1,1,1,4,3,2,3,5,6,6,8,12,6,14,7,9,15,12,8,14,11,15,14,14,13,12,8,12,13,7,12,12,15,14,16,14,12,15,13,10,14,13,20,16,14,13,12,10,8,14,13,13,14,11,14,13,12,10,D RC,103,1,1,18,20,10,1,8,1,20,1,10,1,1,1,18,8,20,1,1,1,1,10,0,0,0,0,0,0,0,0,0,0,0,0,0,0,0,0,0,0,0,0,0,0,0,0,0,0,0,0,0,0,0,0,0,0,0,0,0,0,0,0,0,0,0,0,0,0,0,0,0
29/6/2010,Sergio Ramos,7458272,796,3/30/1986,24,67,5,6,0,6642,8250,8250,173,163,165816446,183,81,D RC,1,1,2,1,3,2,1,5,1,1,3,10,15,13,11,15,13,17,13,16,15,13,10,17,15,16,15,17,10,13,12,10,16,13,12,13,15,15,16,13,15,14,13,13,16,15,20,17,12,14,15,13,3,15,15,18,12,13,12,11,13,11,D RC,103,1,2,16,20,11,1,10,9,20,8,15,2,1,2,16,10,20,9,1,9,5,15,35184372088864,0,0,0,0,0,1,0,0,0,0,0,0,0,0,0,0,0,0,0,0,0,0,0,0,0,0,0,0,0,0,0,0,0,0,0,0,0,0,0,0,0,0,0,0,0,1,0,0
29/6/2010,Sergio Ballesteros,14042,796,9/4/1975,34,0,0,0,0,4761,6500,6500,142,138,2777115,188,83,D C,3,1,2,2,3,2,3,7,3,2,2,3,12,7,6,11,12,17,12,11,15,11,6,15,11,17,14,16,12,12,7,11,17,6,16,12,16,12,15,9,8,14,15,10,17,11,20,15,17,14,18,11,5,11,13,15,15,12,10,13,9,10,D C,101,1,1,20,20,5,1,1,1,5,10,1,1,1,1,20,1,5,1,1,1,1,1,32768,0,0,0,0,0,0,0,0,0,0,0,0,0,0,0,1,0,0,0,0,0,0,0,0,0,0,0,0,0,0,0,0,0,0,0,0,0,0,0,0,0,0,0,0,0,0,0,0
29/6/2010,Serdar Tasçi,8729311,771,4/24/1987,23,7,0,1,0,3650,7350,7350,162,145,17681722,186,80,D C,1,2,3,1,2,3,3,4,2,1,1,6,10,9,5,12,5,14,5,10,14,13,7,16,13,10,12,13,17,9,11,17,16,6,12,8,10,17,15,12,14,15,15,14,10,16,20,16,12,13,9,11,13,10,8,13,13,12,15,14,15,4,D C,101,1,1,20,20,1,1,10,1,12,1,1,1,1,1,20,10,12,1,1,1,1,1,137438986252,0,0,1,1,0,0,0,0,0,0,0,0,0,0,0,1,0,0,0,0,0,0,0,0,0,0,0,0,0,0,0,0,0,0,0,0,0,1,0,0,0,0,0,0,0,0,0,0
29/6/2010,Sébastien Squillaci,3503999,769,8/11/1980,29,16,0,0,0,5700,6800,7350,162,151,-1,185,80,D C,2,3,3,3,3,2,2,5,3,3,3,5,10,7,10,11,5,15,9,9,16,11,12,15,10,16,16,16,16,15,8,14,15,7,14,8,15,14,14,12,10,15,13,9,14,13,20,15,16,13,11,15,14,7,12,14,10,17,12,13,14,13,D C,101,1,1,20,20,1,1,8,1,10,1,1,1,1,1,20,8,10,1,1,1,1,1,33587200,0,0,0,0,0,0,0,0,0,0,0,0,0,0,0,1,0,0,0,0,0,0,0,0,0,1,0,0,0,0,0,0,0,0,0,0,0,0,0,0,0,0,0,0,0,0,0,0
29/6/2010,Sébastien Puygrenier,144177,769,1/28/1982,28,0,0,0,0,4556,6050,6050,142,135,3080764,187,88,D C,2,3,2,1,3,2,3,1,2,2,2,5,6,6,9,8,7,18,11,7,14,7,13,13,8,15,16,17,11,15,6,12,16,7,15,11,15,14,16,12,8,17,15,5,13,11,20,15,17,13,15,15,9,6,8,14,14,14,15,13,13,6,D C,101,1,1,20,20,1,1,1,1,10,14,1,1,1,1,20,1,10,1,1,1,1,1,32800,0,0,0,0,0,1,0,0,0,0,0,0,0,0,0,1,0,0,0,0,0,0,0,0,0,0,0,0,0,0,0,0,0,0,0,0,0,0,0,0,0,0,0,0,0,0,0,0
29/6/2010,Sébastien De Maiò,8442734,769,3/5/1987,23,0,0,0,0,50,2800,4150,124,112,2191387,190,90,D C,2,3,3,2,1,2,2,1,3,3,3,6,5,11,7,10,1,16,6,3,15,11,8,14,8,14,12,17,9,11,9,9,12,10,9,4,9,12,14,10,9,9,15,5,14,12,20,13,18,12,8,5,4,8,10,12,13,12,6,6,7,13,D C,101,1,1,20,20,1,1,1,1,1,1,1,1,1,1,20,1,1,1,1,1,1,1,0,0,0,0,0,0,0,0,0,0,0,0,0,0,0,0,0,0,0,0,0,0,0,0,0,0,0,0,0,0,0,0,0,0,0,0,0,0,0,0,0,0,0,0,0,0,0,0,0
29/6/2010,Sébastien Bassong,8440183,11,7/9/1986,23,9,0,3,0,5184,6479,7250,165,144,16746908,188,73,D LC,1,3,3,3,2,3,3,3,3,3,1,8,9,8,5,9,5,16,7,11,14,11,7,15,9,15,14,15,14,13,9,12,15,6,12,8,15,14,15,14,12,16,16,20,16,15,5,16,15,14,14,13,7,12,14,17,10,13,14,14,12,7,D LC,104,1,1,20,20,1,1,15,1,10,1,10,1,1,1,20,15,10,1,1,1,10,1,274877906944,0,0,0,0,0,0,0,0,0,0,0,0,0,0,0,0,0,0,0,0,0,0,0,0,0,0,0,0,0,0,0,0,0,0,0,0,0,0,1,0,0,0,0,0,0,0,0,0
29/6/2010,Sebastian Prödl,5610074,755,6/21/1987,23,20,2,0,0,4000,6750,6750,135,127,5369551,194,90,D C,2,3,3,1,3,3,1,1,1,3,2,4,7,6,8,7,6,17,10,14,14,7,8,13,7,13,15,14,9,14,7,8,16,6,12,7,14,16,14,9,7,16,18,8,12,14,20,12,17,11,6,12,10,3,12,14,16,9,14,15,16,3,D C,101,1,1,20,20,1,1,1,1,12,1,1,1,1,1,20,1,12,1,1,1,1,1,8796093022216,0,0,0,1,0,0,0,0,0,0,0,0,0,0,0,0,0,0,0,0,0,0,0,0,0,0,0,0,0,0,0,0,0,0,0,0,0,0,0,0,0,0,0,1,0,0,0,0
29/6/2010,Sebastian Jung,35017378,771,6/22/1990,20,0,0,0,0,2000,6150,6150,134,123,2947123,178,68,D C,2,1,3,2,2,3,2,5,1,2,2,7,14,11,11,12,8,10,11,8,13,12,9,12,10,9,13,12,12,13,14,13,11,8,8,12,13,14,16,14,13,12,9,7,16,15,20,13,11,10,7,10,8,9,10,10,2,8,17,6,14,7,D C,101,1,1,20,20,14,1,1,1,13,1,1,1,1,1,20,1,13,1,1,1,1,1,0,0,0,0,0,0,0,0,0,0,0,0,0,0,0,0,0,0,0,0,0,0,0,0,0,0,0,0,0,0,0,0,0,0,0,0,0,0,0,0,0,0,0,0,0,0,0,0,0
29/6/2010,Scott Dann,5118396,765,2/14/1987,23,0,0,2,0,4400,6550,6550,158,140,8050000,188,77,D C,1,2,2,2,2,2,3,3,2,1,2,5,6,10,13,11,6,16,6,7,15,12,6,17,12,12,13,17,14,15,12,12,14,4,16,10,15,14,14,9,11,13,13,10,13,12,20,13,13,17,6,12,5,11,10,12,13,12,14,8,12,8,D C,101,10,1,20,20,5,1,1,1,10,1,1,1,1,1,20,1,10,1,1,1,1,1,0,0,0,0,0,0,0,0,0,0,0,0,0,0,0,0,0,0,0,0,0,0,0,0,0,0,0,0,0,0,0,0,0,0,0,0,0,0,0,0,0,0,0,0,0,0,0,0,0
29/6/2010,Santiago Morero,965358,1649,4/18/1982,28,0,0,0,0,1000,5000,6200,130,125,2605995,184,79,D RC,3,1,3,2,1,2,3,1,3,3,2,4,10,8,5,9,3,14,6,14,15,11,6,15,11,14,13,13,10,12,9,11,16,4,10,5,15,14,15,12,13,12,12,7,14,13,20,16,14,15,14,10,8,8,12,12,15,14,16,16,15,6,D RC,103,1,1,20,20,1,1,1,1,15,1,1,1,1,1,20,1,15,1,1,1,1,1,0,0,0,0,0,0,0,0,0,0,0,0,0,0,0,0,0,0,0,0,0,0,0,0,0,0,0,0,0,0,0,0,0,0,0,0,0,0,0,0,0,0,0,0,0,0,0,0,0
29/6/2010,Santiago Acasiete,5290404,1656,11/22/1977,32,27,2,0,0,3969,6930,6300,130,126,3411459,177,72,D C,2,3,3,1,3,1,2,2,3,2,2,9,11,11,9,11,6,14,9,7,13,10,15,13,10,16,13,14,13,14,10,11,13,5,11,10,14,13,13,14,13,12,10,9,11,12,20,14,12,9,15,14,12,9,15,15,14,15,18,12,7,5,D C,101,1,1,20,20,1,1,1,1,14,1,1,1,1,1,20,1,14,1,1,1,1,1,0,0,0,0,0,0,0,0,0,0,0,0,0,0,0,0,0,0,0,0,0,0,0,0,0,0,0,0,0,0,0,0,0,0,0,0,0,0,0,0,0,0,0,0,0,0,0,0,0
29/6/2010,Samuel,19001689,1651,3/7/1988,22,0,0,11,0,1500,5300,5300,132,106,105131,188,74,D C,2,3,2,2,1,3,1,5,2,2,2,6,6,10,8,10,9,13,7,3,11,11,8,11,10,8,11,12,10,11,8,11,12,9,10,9,11,12,13,12,12,13,15,10,11,12,20,13,13,10,12,11,7,12,11,11,16,12,14,9,10,8,D C,101,1,1,20,20,15,1,1,15,1,1,1,1,1,1,20,1,1,15,1,1,1,1,0,0,0,0,0,0,0,0,0,0,0,0,0,0,0,0,0,0,0,0,0,0,0,0,0,0,0,0,0,0,0,0,0,0,0,0,0,0,0,0,0,0,0,0,0,0,0,0,0
29/6/2010,Sammy Traoré,3501321,31,2/25/1976,34,22,0,0,0,3136,5600,5050,140,112,298428,192,82,D RC,1,1,1,3,1,3,2,1,1,3,2,5,6,8,7,8,10,16,12,6,13,7,13,14,8,14,15,15,11,10,7,12,11,8,13,8,12,16,15,7,7,16,16,8,12,8,20,13,17,10,14,12,8,10,11,13,15,8,11,13,13,12,D RC,103,1,1,20,20,10,1,1,10,15,1,1,1,1,1,20,1,15,10,1,1,1,1,274877906976,0,0,0,0,0,1,0,0,0,0,0,0,0,0,0,0,0,0,0,0,0,0,0,0,0,0,0,0,0,0,0,0,0,0,0,0,0,0,1,0,0,0,0,0,0,0,0,0
29/6/2010,Sami Hyypiä,600430,768,10/7/1973,36,103,5,27,0,6006,8000,8000,171,155,1588406,195,88,D C,3,1,2,3,2,3,2,3,1,2,1,6,8,6,8,14,3,18,3,5,15,14,5,15,12,12,18,16,19,18,10,16,18,6,18,3,18,18,7,6,7,17,19,15,16,6,20,12,14,19,10,18,3,8,18,12,20,19,17,16,17,5,D C,101,1,1,20,20,1,1,1,1,1,10,1,1,1,1,20,1,1,1,1,1,1,1,9070970961920,0,0,0,0,0,0,0,0,0,0,0,0,0,0,0,1,0,0,0,0,0,0,0,0,0,0,0,0,0,0,0,0,0,0,0,0,0,0,1,0,0,0,0,1,0,0,0,0
29/6/2010,Sam Ricketts,5101803,801,10/11/1981,28,38,0,0,0,3500,6150,6150,132,126,4600000,183,75,D/WB RLC,2,1,3,2,3,2,1,1,2,3,1,8,16,13,9,12,7,12,10,16,11,11,9,14,12,11,9,12,11,12,11,11,14,6,8,9,11,11,14,11,13,12,11,19,16,11,20,18,10,14,8,14,3,18,14,14,8,11,17,15,14,2,D/WB RLC,116,1,1,15,20,8,1,20,1,20,1,18,1,1,1,15,20,20,1,1,1,13,18,1099511627808,0,0,0,0,0,1,0,0,0,0,0,0,0,0,0,0,0,0,0,0,0,0,0,0,0,0,0,0,0,0,0,0,0,0,0,0,0,0,0,0,1,0,0,0,0,0,0,0
29/6/2010,Salvatore Aronica,703272,776,7/22/1978,31,0,0,0,0,1250,6400,6400,135,133,2500721,181,78,D LC,1,2,2,1,1,3,3,7,1,2,1,6,11,12,6,10,8,14,9,15,15,14,7,15,9,13,14,13,13,14,10,12,12,5,5,10,12,13,14,14,14,12,11,20,13,12,8,14,13,14,14,10,5,16,13,20,14,12,10,12,12,5,D LC,104,1,1,20,20,1,1,20,14,11,1,15,1,1,1,20,20,11,1,14,1,15,11,8589967360,0,0,0,0,0,0,0,0,0,0,0,0,0,0,0,1,0,0,0,0,0,0,0,0,0,0,0,0,0,0,0,0,0,1,0,0,0,0,0,0,0,0,0,0,0,0,0,0
29/6/2010,Salif Sané,85049933,769,8/25/1990,19,0,0,0,0,1200,2450,2450,132,99,3461302,194,84,D C,2,1,2,2,1,3,1,4,3,2,2,5,5,9,6,11,5,14,11,5,13,8,6,8,11,15,10,13,10,10,8,11,13,7,2,6,11,12,14,9,6,15,17,5,14,10,20,14,15,14,10,8,3,10,12,15,14,13,12,13,13,8,D C,101,1,5,20,20,10,1,1,10,1,1,1,5,1,1,20,1,1,10,1,1,1,1,32768,0,0,0,0,0,0,0,0,0,0,0,0,0,0,0,1,0,0,0,0,0,0,0,0,0,0,0,0,0,0,0,0,0,0,0,0,0,0,0,0,0,0,0,0,0,0,0,0
29/6/2010,Ryan Shotton,5129388,765,9/30/1988,21,0,0,0,0,2200,5100,5100,120,106,4371474,191,85,D RC,2,2,1,2,2,2,2,6,2,2,1,2,11,10,9,8,3,13,7,12,11,7,3,14,9,14,11,13,11,10,8,10,12,4,8,11,14,12,13,11,11,12,13,12,12,11,20,12,14,10,10,10,3,10,8,14,17,8,16,13,3,4,D RC,103,5,1,20,20,1,1,1,1,18,1,1,1,1,1,20,1,18,1,1,1,1,1,0,0,0,0,0,0,0,0,0,0,0,0,0,0,0,0,0,0,0,0,0,0,0,0,0,0,0,0,0,0,0,0,0,0,0,0,0,0,0,0,0,0,0,0,0,0,0,0,0
29/6/2010,Ryan Shawcross,5116920,765,10/4/1987,22,0,0,1,0,5000,7000,7000,165,148,14421208,196,77,D C,3,2,1,3,1,3,3,2,2,1,1,3,7,7,4,12,3,16,3,3,16,13,4,15,12,13,14,15,13,14,9,14,15,9,15,10,14,15,15,12,13,13,16,8,15,13,20,15,15,13,6,13,4,7,6,15,16,13,15,13,9,6,D C,101,1,1,20,20,1,1,1,1,10,1,1,1,1,1,20,1,10,1,1,1,1,1,137438986240,0,0,0,0,0,0,0,0,0,0,0,0,0,0,0,1,0,0,0,0,0,0,0,0,0,0,0,0,0,0,0,0,0,0,0,0,0,1,0,0,0,0,0,0,0,0,0,0
29/6/2010,Ryan Nelsen,976230,1438,10/18/1977,32,44,6,0,0,4830,7300,7050,153,139,3703605,183,90,D C,1,2,3,2,3,2,2,1,3,2,3,2,4,5,4,9,3,15,3,5,16,8,7,17,10,16,17,18,12,15,9,13,19,4,19,7,17,15,15,10,9,16,14,8,17,10,20,13,17,15,9,15,10,10,18,15,19,16,19,16,15,3,D C,101,1,1,20,20,1,1,1,1,10,14,1,1,1,1,20,1,10,1,1,1,1,1,8589967360,0,0,0,0,0,0,0,0,0,0,0,0,0,0,0,1,0,0,0,0,0,0,0,0,0,0,0,0,0,0,0,0,0,1,0,0,0,0,0,0,0,0,0,0,0,0,0,0
29/6/2010,Rubén,824435,796,1/29/1982,28,0,0,0,0,4692,6200,6200,140,137,3549222,187,75,D C,1,3,3,2,2,2,1,2,1,1,3,5,10,9,6,12,8,16,10,10,14,12,7,16,12,16,15,16,12,12,8,12,14,8,11,7,16,16,15,9,11,14,14,13,13,12,20,16,12,14,15,13,6,11,14,14,16,7,12,15,16,11,D C,101,1,1,20,20,6,1,1,1,7,15,1,1,1,1,20,1,7,1,1,1,1,1,163840,0,0,0,0,0,0,0,0,0,0,0,0,0,0,0,1,0,1,0,0,0,0,0,0,0,0,0,0,0,0,0,0,0,0,0,0,0,0,0,0,0,0,0,0,0,0,0,0
29/6/2010,Ruben,8871609,788,5/6/1986,24,0,0,0,0,1500,5000,5000,120,99,505131,184,76,D LC,3,2,3,2,2,1,1,3,1,1,3,11,12,10,8,10,10,11,11,11,12,10,10,12,11,10,12,10,14,10,8,9,13,8,9,11,12,12,11,12,12,12,12,20,13,12,5,11,11,10,7,10,7,11,9,15,15,11,15,15,15,5,D LC,104,1,1,20,20,5,1,17,1,1,1,10,1,1,1,20,17,1,1,1,1,10,1,2049,1,0,0,0,0,0,0,0,0,0,0,1,0,0,0,0,0,0,0,0,0,0,0,0,0,0,0,0,0,0,0,0,0,0,0,0,0,0,0,0,0,0,0,0,0,0,0,0
29/6/2010,Ronald Zubar,919995,769,9/20/1985,24,0,0,15,2,3750,5600,6100,145,130,5999998,186,80,D RC,3,3,3,3,1,3,2,1,2,3,1,6,10,8,7,11,7,15,12,9,14,10,8,15,11,12,14,16,7,9,8,12,17,9,13,9,12,14,14,11,9,16,13,10,13,14,20,16,16,13,12,14,10,14,14,14,13,9,16,14,14,5,D RC,103,5,8,20,20,12,1,10,8,18,1,14,1,1,8,20,10,18,1,1,8,10,14,0,0,0,0,0,0,0,0,0,0,0,0,0,0,0,0,0,0,0,0,0,0,0,0,0,0,0,0,0,0,0,0,0,0,0,0,0,0,0,0,0,0,0,0,0,0,0,0,0
29/6/2010,Roman Neustädter,91002404,771,2/18/1988,22,0,0,2,1,1650,5500,5500,135,107,2028538,190,83,D/DM C,3,1,3,3,2,2,3,3,1,2,3,5,4,6,11,6,4,15,7,12,13,11,5,13,12,8,11,12,10,12,5,13,10,4,14,5,13,10,9,12,12,14,17,5,11,11,20,13,14,11,5,11,5,7,9,17,18,6,12,17,13,8,D/DM C,111,1,1,20,20,17,1,1,15,1,1,1,1,1,1,20,1,1,15,1,1,1,1,0,0,0,0,0,0,0,0,0,0,0,0,0,0,0,0,0,0,0,0,0,0,0,0,0,0,0,0,0,0,0,0,0,0,0,0,0,0,0,0,0,0,0,0,0,0,0,0,0
29/6/2010,Romain Inez,29023778,769,4/30/1988,22,0,0,0,0,150,3350,3350,122,101,2625197,183,74,D RLC,1,2,3,2,2,3,3,3,3,2,3,6,8,7,6,11,5,13,8,8,12,9,6,12,11,10,12,13,13,12,10,12,14,5,12,7,13,12,12,7,9,13,11,9,14,11,20,15,13,13,10,10,6,10,12,12,17,14,15,15,15,5,D RLC,106,1,1,15,20,1,1,17,1,20,1,12,1,1,1,15,17,20,1,1,1,12,12,0,0,0,0,0,0,0,0,0,0,0,0,0,0,0,0,0,0,0,0,0,0,0,0,0,0,0,0,0,0,0,0,0,0,0,0,0,0,0,0,0,0,0,0,0,0,0,0,0
29/6/2010,Rolando,744475,788,8/31/1985,24,8,0,7,0,3500,6650,6650,143,133,37938740,189,77,D C,1,3,1,3,2,2,2,4,2,3,3,7,7,7,8,10,9,16,9,10,15,8,10,14,10,15,14,12,13,13,8,11,16,5,12,10,13,14,13,12,13,15,15,9,16,12,20,14,16,12,11,11,7,10,15,15,15,13,14,13,13,5,D C,101,1,1,20,20,5,1,1,1,5,5,1,1,1,1,20,1,5,1,1,1,1,1,32768,0,0,0,0,0,0,0,0,0,0,0,0,0,0,0,1,0,0,0,0,0,0,0,0,0,0,0,0,0,0,0,0,0,0,0,0,0,0,0,0,0,0,0,0,0,0,0,0
29/6/2010,Rogério Conceição,2111797,1651,9/20/1984,25,0,0,0,0,2250,5750,5250,120,110,549546,191,82,D C,2,2,1,1,1,3,1,4,2,1,3,7,10,11,6,9,3,15,9,4,11,12,8,11,11,12,10,13,10,11,9,12,15,5,14,8,11,13,14,10,11,16,15,20,16,9,7,14,16,12,6,12,6,10,5,12,7,12,14,10,1,6,D C,101,1,1,20,20,13,1,1,5,1,1,1,1,1,1,20,1,1,5,1,1,1,1,0,0,0,0,0,0,0,0,0,0,0,0,0,0,0,0,0,0,0,0,0,0,0,0,0,0,0,0,0,0,0,0,0,0,0,0,0,0,0,0,0,0,0,0,0,0,0,0,0
29/6/2010,Roger Johnson,5101233,765,4/28/1983,27,0,0,0,0,3700,6850,6850,150,145,11850525,191,70,D C,2,2,3,2,2,2,2,1,3,2,3,1,3,5,4,7,2,17,2,3,17,8,2,17,3,14,12,18,13,14,5,13,16,4,17,8,17,16,15,11,13,9,17,6,12,12,20,14,15,17,5,13,7,5,9,14,14,9,16,11,10,8,D C,101,1,1,20,20,1,1,1,1,1,1,1,1,1,1,20,1,1,1,1,1,1,1,2199023255552,0,0,0,0,0,0,0,0,0,0,0,0,0,0,0,0,0,0,0,0,0,0,0,0,0,0,0,0,0,0,0,0,0,0,0,0,0,0,0,0,0,1,0,0,0,0,0,0
29/6/2010,Roel Brouwers,851518,784,11/28/1981,28,0,0,0,0,1600,5000,6550,131,128,3078278,190,81,D C,3,2,3,3,2,3,1,4,2,3,3,3,5,4,14,6,10,18,9,8,14,7,8,14,6,14,10,12,13,17,5,9,13,3,10,16,14,17,14,8,8,12,17,10,15,12,20,15,14,16,10,13,13,10,12,12,12,12,15,13,7,11,D C,101,1,1,20,20,1,1,1,1,1,1,1,1,1,1,20,1,1,1,1,1,1,1,274877907552,0,0,0,0,0,1,1,0,0,1,0,0,0,0,0,0,0,0,0,0,0,0,0,0,0,0,0,0,0,0,0,0,0,0,0,0,0,0,1,0,0,0,0,0,0,0,0,0
29/6/2010,Rodríguez,7451907,796,8/17/1984,25,0,0,0,0,3906,5750,5750,145,125,2335965,185,78,D C,2,2,1,3,3,1,2,1,2,1,1,7,10,9,15,10,8,17,11,10,14,11,7,14,9,16,15,14,10,13,8,12,10,5,11,9,15,13,13,13,11,15,14,2,15,12,20,12,15,15,11,13,7,12,16,19,13,8,11,10,6,14,D C,101,1,1,20,20,6,1,13,1,14,10,1,1,1,1,20,13,14,1,1,1,1,1,32768,0,0,0,0,0,0,0,0,0,0,0,0,0,0,0,1,0,0,0,0,0,0,0,0,0,0,0,0,0,0,0,0,0,0,0,0,0,0,0,0,0,0,0,0,0,0,0,0
29/6/2010,Rodnei,19003707,1651,9/11/1985,24,0,0,0,0,2500,5750,6650,142,133,3085434,190,91,D LC,2,2,3,3,2,3,3,7,1,1,2,2,7,10,12,12,5,14,6,8,13,13,4,14,13,12,12,15,8,11,7,8,15,12,9,11,11,11,14,12,12,14,16,16,14,15,20,13,16,15,9,14,4,8,15,16,13,13,13,14,9,8,D LC,104,1,1,20,20,1,1,15,1,1,1,1,1,1,1,20,15,1,1,1,1,1,1,0,0,0,0,0,0,0,0,0,0,0,0,0,0,0,0,0,0,0,0,0,0,0,0,0,0,0,0,0,0,0,0,0,0,0,0,0,0,0,0,0,0,0,0,0,0,0,0,0
29/6/2010,Rod Fanni,6201566,769,12/6/1981,28,4,0,5,1,5000,6704,6700,155,149,10687572,186,78,D/WB RC,1,2,2,3,3,2,1,9,3,2,1,7,14,14,6,12,10,15,14,14,15,11,9,13,12,12,14,14,14,13,11,13,15,11,11,13,13,13,14,16,13,14,13,8,13,15,20,16,14,14,12,15,9,12,12,16,11,14,14,16,16,7,D/WB RC,113,1,1,17,20,13,1,1,10,20,1,18,1,1,1,17,8,20,1,1,10,1,18,2,0,1,0,0,0,0,0,0,0,0,0,0,0,0,0,0,0,0,0,0,0,0,0,0,0,0,0,0,0,0,0,0,0,0,0,0,0,0,0,0,0,0,0,0,0,0,0,0
29/6/2010,Robson,55002376,1651,7/10/1983,26,0,0,0,0,1500,1500,5500,113,108,481485,187,82,D C,1,2,1,1,3,2,1,1,3,3,1,6,7,7,7,7,7,14,6,11,13,6,9,12,8,11,10,12,15,14,6,8,14,6,12,9,13,12,13,10,9,13,13,7,13,9,20,13,13,14,9,10,7,10,15,13,10,14,14,14,14,6,D C,101,1,1,20,20,1,1,1,1,10,1,1,1,1,1,20,1,10,1,1,1,1,1,0,0,0,0,0,0,0,0,0,0,0,0,0,0,0,0,0,0,0,0,0,0,0,0,0,0,0,0,0,0,0,0,0,0,0,0,0,0,0,0,0,0,0,0,0,0,0,0,0
29/6/2010,Robin Schuster,92012107,771,4/24/1987,23,0,0,0,0,1250,3800,3800,110,86,341038,193,86,D C,1,3,1,1,2,3,1,1,3,1,3,6,4,7,3,7,4,12,6,3,10,13,5,13,4,10,11,4,8,8,3,13,7,3,7,5,13,16,11,13,10,13,14,20,15,13,10,10,7,10,8,10,11,10,14,14,8,13,9,10,6,5,D C,101,1,1,20,20,1,1,1,1,1,1,1,1,1,1,20,1,1,1,1,1,1,1,0,0,0,0,0,0,0,0,0,0,0,0,0,0,0,0,0,0,0,0,0,0,0,0,0,0,0,0,0,0,0,0,0,0,0,0,0,0,0,0,0,0,0,0,0,0,0,0,0
29/6/2010,Robert Huth,5112098,771,8/18/1984,25,19,2,2,0,4900,6500,6850,152,140,11500000,191,88,D C,1,2,2,2,1,2,3,7,2,3,2,3,6,6,7,10,12,16,12,11,15,9,10,16,11,14,10,18,10,15,6,12,18,4,12,5,13,15,12,10,6,18,17,14,15,13,20,14,19,15,14,11,10,14,17,16,15,13,15,15,9,1,D C,101,8,1,20,20,8,1,10,1,14,12,1,1,1,1,20,10,14,1,1,1,1,1,35184372122112,0,0,0,0,0,0,0,0,0,1,0,0,0,0,0,1,0,0,0,0,0,0,0,0,0,0,0,0,0,0,0,0,0,0,0,0,0,0,0,0,0,0,0,0,0,1,0,0
29/6/2010,Rio Ferdinand,2004089,765,11/7/1978,31,78,3,5,0,7656,8750,8750,180,175,108162998,189,83,D C,1,2,1,1,3,3,2,10,3,1,1,5,5,10,6,15,2,16,2,6,17,13,10,16,15,8,18,11,17,16,9,14,16,8,16,7,18,14,14,15,14,15,16,13,10,15,20,14,15,18,4,16,15,6,14,17,15,18,17,15,16,9,D C,101,1,1,20,20,5,1,1,5,1,12,1,1,1,1,20,1,1,5,1,1,1,1,279173005312,0,0,0,0,0,0,0,0,0,0,0,0,0,0,0,0,0,1,0,0,0,0,0,0,0,0,0,0,0,0,0,0,1,0,0,0,0,0,1,0,0,0,0,0,0,0,0,0
29/6/2010,Rincón,5116917,1651,5/31/1987,23,0,0,0,0,1000,4500,4950,140,109,338933,186,79,D RC,1,1,1,1,1,1,1,1,1,1,1,6,5,12,11,13,10,13,12,9,14,14,12,13,14,15,12,11,9,5,14,12,8,13,11,13,9,12,13,12,11,14,12,10,15,13,20,9,14,5,12,12,5,18,10,11,11,9,15,15,17,9,D RC,103,1,1,20,20,12,1,1,1,15,1,1,1,1,1,20,1,15,1,1,1,1,1,0,0,0,0,0,0,0,0,0,0,0,0,0,0,0,0,0,0,0,0,0,0,0,0,0,0,0,0,0,0,0,0,0,0,0,0,0,0,0,0,0,0,0,0,0,0,0,0,0
29/6/2010,Richard Dunne,2014389,789,9/21/1979,30,58,7,4,0,5400,7600,7600,158,154,39377088,188,96,D C,1,2,2,2,3,2,1,5,1,1,1,5,8,8,4,12,3,17,5,13,14,8,9,17,8,12,14,18,13,15,10,11,13,4,18,10,15,15,16,12,7,14,16,8,10,15,20,13,18,15,9,16,3,8,10,14,14,12,14,14,10,12,D C,101,1,1,20,20,1,1,1,1,10,1,1,1,1,1,20,1,10,1,1,1,1,1,32768,0,0,0,0,0,0,0,0,0,0,0,0,0,0,0,1,0,0,0,0,0,0,0,0,0,0,0,0,0,0,0,0,0,0,0,0,0,0,0,0,0,0,0,0,0,0,0,0
29/6/2010,Ricardo,735107,12,8/19/1980,29,4,0,0,0,2000,5750,5450,114,109,444805,185,77,D/DM RC,3,1,2,3,1,3,2,3,3,1,3,7,7,6,6,9,10,14,9,11,14,9,9,13,9,13,13,13,13,14,7,10,15,7,9,6,12,14,15,10,12,15,15,5,16,10,20,15,15,11,9,8,8,16,11,12,14,11,14,13,14,5,D/DM RC,113,1,1,20,20,17,1,1,15,15,5,7,1,1,1,20,1,15,15,1,1,1,7,66,0,1,0,0,0,0,1,0,0,0,0,0,0,0,0,0,0,0,0,0,0,0,0,0,0,0,0,0,0,0,0,0,0,0,0,0,0,0,0,0,0,0,0,0,0,0,0,0
29/6/2010,Ricardo Silva,901842,788,9/26/1975,34,0,0,4,1,2500,5350,5350,107,107,287500,188,80,D C,2,1,1,1,2,3,3,1,2,3,3,5,6,7,5,10,12,13,9,10,12,10,15,12,10,14,12,13,13,11,7,11,15,7,12,8,13,12,13,8,10,14,14,3,11,8,20,14,15,13,9,14,9,8,15,10,15,13,13,12,14,3,D C,101,1,1,20,20,5,1,1,1,5,5,1,1,1,1,20,1,5,1,1,1,1,1,0,0,0,0,0,0,0,0,0,0,0,0,0,0,0,0,0,0,0,0,0,0,0,0,0,0,0,0,0,0,0,0,0,0,0,0,0,0,0,0,0,0,0,0,0,0,0,0,0
29/6/2010,Ricardo Costa,728186,788,5/16/1981,29,10,0,23,0,4160,6450,6350,136,129,9548353,183,80,D C,3,2,2,1,2,1,1,3,3,1,1,5,7,7,8,8,10,16,10,11,15,8,12,14,8,17,12,18,9,12,7,10,15,5,15,8,14,17,16,13,11,15,11,8,12,12,20,16,15,13,17,14,8,10,11,16,13,13,18,9,9,4,D C,101,1,1,20,20,10,1,12,1,12,1,1,1,1,1,20,12,12,1,1,1,1,1,2336462307328,0,0,0,0,0,0,0,0,0,0,0,0,0,0,0,1,1,0,0,0,0,0,0,0,0,0,0,0,0,0,0,0,0,0,0,0,0,1,0,0,0,1,0,0,0,0,0,0
29/6/2010,Ricardo Carvalho,4100117,788,5/18/1978,32,67,4,0,0,7310,8750,8500,175,171,165331760,181,78,D C,2,1,2,3,2,2,3,3,1,1,3,6,6,11,13,13,4,15,7,12,17,12,12,17,11,16,16,17,17,16,8,16,18,6,13,10,17,16,16,14,14,15,12,12,15,12,20,15,14,16,10,16,13,7,15,15,16,15,16,16,17,3,D C,101,1,1,20,20,1,1,1,1,1,1,1,1,1,1,20,1,1,1,1,1,1,1,32800,0,0,0,0,0,1,0,0,0,0,0,0,0,0,0,1,0,0,0,0,0,0,0,0,0,0,0,0,0,0,0,0,0,0,0,0,0,0,0,0,0,0,0,0,0,0,0,0
29/6/2010,Renato Saldanha,320230,1651,1/21/1984,26,0,0,0,0,1000,4950,4950,116,105,671437,183,77,D C,3,2,3,3,1,2,2,6,3,2,2,4,5,1,7,13,3,13,8,4,10,12,9,11,8,3,10,11,9,10,1,12,11,8,11,8,9,16,14,13,13,13,13,8,11,13,20,11,14,10,7,10,6,10,12,14,12,5,9,2,7,10,D C,101,1,1,20,20,1,1,1,1,1,1,1,1,1,1,20,1,1,1,1,1,1,1,0,0,0,0,0,0,0,0,0,0,0,0,0,0,0,0,0,0,0,0,0,0,0,0,0,0,0,0,0,0,0,0,0,0,0,0,0,0,0,0,0,0,0,0,0,0,0,0,0
29/6/2010,Renato Civelli,958142,1649,10/14/1983,26,0,0,0,0,4422,5950,5950,135,133,3367868,193,89,D C,3,3,2,2,2,1,3,3,2,2,2,5,6,6,8,8,8,17,7,11,15,8,9,13,8,16,13,18,9,13,5,11,15,5,13,7,13,14,15,12,8,17,17,7,13,11,20,14,17,13,16,15,7,5,12,14,14,14,14,10,10,7,D C,101,1,1,20,20,1,1,1,1,10,1,1,1,1,1,20,1,10,1,1,1,1,1,32768,0,0,0,0,0,0,0,0,0,0,0,0,0,0,0,1,0,0,0,0,0,0,0,0,0,0,0,0,0,0,0,0,0,0,0,0,0,0,0,0,0,0,0,0,0,0,0,0
29/6/2010,Renan,315099,1651,2/12/1983,27,0,0,0,0,1500,4000,4000,115,90,322917,188,85,D C,3,3,2,3,3,1,2,1,3,1,3,9,10,9,9,10,4,11,10,4,9,9,7,10,5,11,9,9,7,8,9,9,11,9,5,9,10,10,9,9,9,14,16,10,5,9,20,14,14,10,9,9,6,10,11,10,12,9,13,8,9,4,D C,101,1,1,20,20,1,1,1,1,1,1,1,1,1,1,20,1,1,1,1,1,1,1,0,0,0,0,0,0,0,0,0,0,0,0,0,0,0,0,0,0,0,0,0,0,0,0,0,0,0,0,0,0,0,0,0,0,0,0,0,0,0,0,0,0,0,0,0,0,0,0,0
29/6/2010,Rémi Gomis,918889,41,2/14/1984,26,3,0,0,0,4290,6550,5850,138,131,3999999,180,72,D/DM C,1,2,3,3,3,3,3,6,1,3,1,6,9,8,7,12,8,13,10,10,10,14,9,13,12,13,14,16,14,14,13,13,15,8,12,8,13,14,16,14,11,15,11,8,15,14,20,16,13,14,13,15,6,10,12,14,13,11,15,15,15,6,D/DM C,321,1,10,20,16,20,1,1,15,10,1,1,10,1,1,16,1,1,15,1,10,1,1,64,0,0,0,0,0,0,1,0,0,0,0,0,0,0,0,0,0,0,0,0,0,0,0,0,0,0,0,0,0,0,0,0,0,0,0,0,0,0,0,0,0,0,0,0,0,0,0,0
29/6/2010,Rédah Atassi,85057616,769,3/16/1991,19,0,0,0,0,50,2250,2250,110,99,3092122,187,78,D LC,2,1,2,2,3,3,1,1,1,3,2,5,7,6,7,9,6,14,6,7,13,8,5,10,9,14,12,15,11,11,7,10,14,5,9,6,11,14,13,12,9,14,13,20,9,11,5,14,14,14,14,10,7,10,6,14,16,6,13,11,11,8,D LC,104,1,1,20,20,1,1,15,1,1,1,1,1,1,1,20,15,1,1,1,1,1,1,32800,0,0,0,0,0,1,0,0,0,0,0,0,0,0,0,1,0,0,0,0,0,0,0,0,0,0,0,0,0,0,0,0,0,0,0,0,0,0,0,0,0,0,0,0,0,0,0,0
29/6/2010,Raúl Albiol,7452450,796,9/4/1985,24,23,0,8,0,6162,7850,7850,164,157,21801492,190,82,D C,3,1,3,1,1,3,3,9,3,3,3,6,9,10,9,11,7,16,12,10,18,12,8,15,10,15,16,18,13,19,9,13,12,6,12,8,16,17,16,8,10,18,15,11,15,13,20,16,16,17,13,15,7,13,16,14,14,12,13,12,7,6,D C,101,1,1,20,20,13,1,3,5,10,11,1,1,1,1,20,3,10,5,1,1,1,1,32768,0,0,0,0,0,0,0,0,0,0,0,0,0,0,0,1,0,0,0,0,0,0,0,0,0,0,0,0,0,0,0,0,0,0,0,0,0,0,0,0,0,0,0,0,0,0,0,0
29/6/2010,Raphaël Varane,85075627,769,4/25/1993,17,0,0,0,0,1400,4589,2800,153,102,2056370,190,85,D C,1,2,1,1,3,1,2,2,3,2,3,5,5,7,6,12,6,14,7,7,12,11,6,9,12,10,13,13,14,11,10,12,14,5,6,6,11,13,13,10,8,15,15,5,14,9,20,14,15,16,10,10,6,10,12,13,14,13,15,17,17,5,D C,101,1,1,20,20,1,1,1,1,1,1,1,1,1,1,20,1,1,1,1,1,1,1,0,0,0,0,0,0,0,0,0,0,0,0,0,0,0,0,0,0,0,0,0,0,0,0,0,0,0,0,0,0,0,0,0,0,0,0,0,0,0,0,0,0,0,0,0,0,0,0,0
29/6/2010,Ralph Gunesch,885160,771,9/2/1983,26,0,0,0,0,2000,5650,5650,115,113,975278,190,83,D RC,3,2,1,1,2,2,1,1,2,3,3,5,8,6,4,8,5,10,6,9,12,8,7,14,9,12,10,11,8,11,6,11,12,4,12,3,12,14,12,11,9,12,15,14,12,12,20,15,14,12,15,10,9,11,6,12,9,12,13,11,9,8,D RC,103,1,1,20,20,1,1,10,1,16,1,1,1,1,1,20,10,16,1,1,1,1,1,0,0,0,0,0,0,0,0,0,0,0,0,0,0,0,0,0,0,0,0,0,0,0,0,0,0,0,0,0,0,0,0,0,0,0,0,0,0,0,0,0,0,0,0,0,0,0,0,0
29/6/2010,Rafik Halliche,12004449,5,9/2/1986,23,5,0,10,0,3000,6820,5750,140,124,7548654,187,77,D C,3,1,1,2,2,2,3,4,2,2,1,5,6,7,6,13,7,16,11,11,13,8,9,15,11,15,15,14,14,13,9,15,13,6,13,6,14,15,15,9,10,14,15,8,14,11,20,15,14,12,10,12,11,6,7,14,12,5,12,1,10,6,D C,101,1,1,20,20,1,1,1,1,1,17,1,1,1,1,20,1,1,1,1,1,1,1,0,0,0,0,0,0,0,0,0,0,0,0,0,0,0,0,0,0,0,0,0,0,0,0,0,0,0,0,0,0,0,0,0,0,0,0,0,0,0,0,0,0,0,0,0,0,0,0,0
29/6/2010,Rafael,912537,1651,12/17/1980,29,0,0,0,0,4290,5900,5900,142,131,2649143,182,74,D C,2,1,2,2,2,1,1,5,3,2,3,6,12,8,7,9,9,16,10,11,13,11,7,15,9,14,16,15,13,13,10,13,15,5,12,8,15,14,16,11,11,15,11,20,13,12,5,14,14,14,14,15,7,8,13,13,14,14,14,13,13,3,D C,101,1,1,20,20,1,1,10,1,1,1,10,1,1,1,20,10,1,1,1,1,10,1,8796093022208,0,0,0,0,0,0,0,0,0,0,0,0,0,0,0,0,0,0,0,0,0,0,0,0,0,0,0,0,0,0,0,0,0,0,0,0,0,0,0,0,0,0,0,1,0,0,0,0
29/6/2010,Rafa,7456623,796,4/19/1985,25,0,0,0,0,4100,6100,6100,141,129,3687905,179,69,D/DM C,3,2,2,3,2,3,1,5,3,1,1,8,9,7,5,14,9,15,10,5,12,14,9,14,14,13,15,16,13,16,9,14,13,14,13,8,15,13,13,10,12,15,11,7,10,12,20,13,15,15,8,13,5,15,8,13,14,12,16,16,15,5,D/DM C,321,1,1,20,17,20,1,1,15,1,1,1,1,1,1,17,1,1,15,1,1,1,1,8589967424,0,0,0,0,0,0,1,0,0,0,0,0,0,0,0,1,0,0,0,0,0,0,0,0,0,0,0,0,0,0,0,0,0,1,0,0,0,0,0,0,0,0,0,0,0,0,0,0
29/6/2010,Pietro Accardi,828431,776,9/12/1982,27,0,0,0,0,3000,6750,6750,144,135,11358849,182,71,D LC,3,2,2,3,3,3,1,3,2,1,3,5,8,8,6,4,12,12,6,14,16,12,8,16,12,18,15,16,8,10,16,8,10,5,15,14,16,10,10,15,15,10,13,20,19,15,9,14,15,18,7,16,15,12,14,15,15,10,15,11,13,3,D LC,104,1,1,20,20,1,1,20,1,1,1,11,1,1,1,20,20,11,1,1,1,11,1,142940806578176,0,0,0,0,0,0,0,0,0,0,0,0,0,0,0,0,0,0,0,0,0,0,0,0,0,0,0,0,0,0,0,0,1,0,0,0,0,0,0,0,0,1,0,0,0,0,0,1
29/6/2010,Phillipp Wollscheid,92021286,771,3/6/1989,21,0,0,0,0,150,3550,3550,123,100,1676601,181,81,D C,2,3,2,1,2,3,2,3,2,2,3,4,9,5,9,12,4,14,4,2,14,9,10,14,10,13,13,13,11,11,10,14,10,8,12,5,12,7,12,7,10,14,9,12,11,9,20,8,10,10,7,10,10,10,8,17,11,14,14,11,7,6,D C,101,1,1,20,20,1,1,1,1,1,1,1,1,1,1,20,1,1,1,1,1,1,1,0,0,0,0,0,0,0,0,0,0,0,0,0,0,0,0,0,0,0,0,0,0,0,0,0,0,0,0,0,0,0,0,0,0,0,0,0,0,0,0,0,0,0,0,0,0,0,0,0
29/6/2010,Philippe Senderos,5723454,798,2/14/1985,25,41,5,2,0,5112,7250,6850,160,143,6113002,190,87,D C,2,2,1,3,2,3,3,5,2,3,3,3,4,4,5,7,4,18,5,14,14,12,5,16,10,14,15,16,13,14,9,13,15,5,14,8,15,14,14,11,10,13,17,8,8,11,20,14,15,11,11,13,16,8,16,14,14,12,14,17,17,7,D C,101,1,1,20,20,1,1,1,1,1,10,1,1,1,1,20,1,1,1,1,1,1,1,32768,0,0,0,0,0,0,0,0,0,0,0,0,0,0,0,1,0,0,0,0,0,0,0,0,0,0,0,0,0,0,0,0,0,0,0,0,0,0,0,0,0,0,0,0,0,0,0,0
29/6/2010,Philippe Mexès,3506916,769,3/30/1982,28,13,0,7,0,5625,6750,8100,162,150,10285088,187,82,D C,1,1,1,1,1,1,1,1,1,1,1,5,9,12,10,10,7,18,8,7,16,14,12,17,12,18,15,17,14,11,12,15,18,9,16,13,16,14,15,11,12,16,16,6,13,13,20,17,15,13,16,12,4,5,14,18,17,10,14,14,9,11,D C,101,1,1,20,20,1,1,4,1,4,16,1,1,1,1,20,4,4,1,1,1,1,1,274878070824,0,0,0,1,0,1,0,0,0,0,0,0,0,0,0,1,0,1,0,0,0,0,0,0,0,0,0,0,0,0,0,0,0,0,0,0,0,0,1,0,0,0,0,0,0,0,0,0
29/6/2010,Phil Jones,28027433,765,2/21/1992,18,0,0,1,0,3100,6350,6350,168,116,11793468,186,71,D C,3,1,2,2,2,1,2,5,1,2,3,2,5,8,5,11,6,13,2,10,11,9,8,13,9,17,14,17,13,13,7,11,17,4,12,7,13,14,16,14,11,12,13,10,16,14,20,13,14,16,11,18,3,16,5,14,15,17,18,15,16,4,D C,101,1,1,20,20,15,1,1,15,14,1,1,1,1,1,20,1,14,15,1,1,1,1,2199023255552,0,0,0,0,0,0,0,0,0,0,0,0,0,0,0,0,0,0,0,0,0,0,0,0,0,0,0,0,0,0,0,0,0,0,0,0,0,0,0,0,0,1,0,0,0,0,0,0
29/6/2010,Phil Jagielka,5101381,765,8/17/1982,27,3,0,6,2,5500,7250,7250,165,149,11147759,180,87,D C,6,4,1,2,8,12,1,10,2,14,2,5,8,7,6,12,5,16,10,5,16,10,14,16,13,13,16,15,11,15,11,14,12,11,16,7,16,15,17,14,12,9,13,5,15,14,20,16,14,16,5,16,1,18,5,14,16,13,16,15,15,1,D C,101,10,1,20,20,12,10,1,10,12,1,1,1,1,1,20,1,12,10,1,1,1,1,8796093022720,0,0,0,0,0,0,0,0,0,1,0,0,0,0,0,0,0,0,0,0,0,0,0,0,0,0,0,0,0,0,0,0,0,0,0,0,0,0,0,0,0,0,0,1,0,0,0,0
29/6/2010,Petter Hansson,4300838,797,12/14/1976,33,43,2,0,0,3950,6299,6300,145,140,3295923,186,86,D C,1,3,2,3,3,2,2,7,2,1,1,5,7,7,10,9,8,17,12,6,15,8,8,16,9,13,16,18,12,15,9,13,15,5,18,7,14,17,15,10,9,17,13,8,14,7,20,15,17,17,13,15,9,6,12,14,15,14,18,14,14,6,D C,101,1,1,20,20,10,1,1,1,1,10,1,1,1,1,20,1,1,1,1,1,1,1,32,0,0,0,0,0,1,0,0,0,0,0,0,0,0,0,0,0,0,0,0,0,0,0,0,0,0,0,0,0,0,0,0,0,0,0,0,0,0,0,0,0,0,0,0,0,0,0,0
29/6/2010,Petri Pasanen,510588,768,9/24/1980,29,57,1,6,0,4489,7370,7000,138,134,3179554,187,86,D RLC,1,2,2,2,2,2,2,3,2,3,2,6,9,6,5,11,14,12,14,16,16,9,10,15,11,12,13,13,16,16,7,10,14,3,13,7,16,18,14,10,8,15,15,8,15,12,20,14,16,18,5,13,11,16,17,10,17,16,18,16,14,2,D RLC,106,1,1,20,20,1,1,18,1,19,1,1,1,1,1,20,18,19,1,1,1,1,1,35192962024256,0,0,0,0,0,0,1,0,1,1,0,0,0,0,0,0,0,0,0,0,0,0,0,0,0,0,0,0,0,0,0,0,0,1,0,0,0,0,0,0,0,0,0,0,0,1,0,0
29/6/2010,Per Nilsson,4300623,797,9/15/1982,27,5,0,22,1,3650,6000,6200,130,124,2128282,190,86,D C,1,3,2,2,2,3,3,6,2,3,2,6,8,5,7,8,7,16,11,9,14,7,14,15,8,14,13,18,13,12,5,12,12,5,15,7,15,15,14,8,7,15,16,8,15,10,20,15,16,15,11,14,5,12,13,14,12,13,13,15,14,5,D C,101,1,1,20,20,12,1,1,1,9,1,1,1,1,1,20,1,9,1,1,1,1,1,0,0,0,0,0,0,0,0,0,0,0,0,0,0,0,0,0,0,0,0,0,0,0,0,0,0,0,0,0,0,0,0,0,0,0,0,0,0,0,0,0,0,0,0,0,0,0,0,0
29/6/2010,Per Mertesacker,8707357,771,9/29/1984,25,55,1,3,0,6162,8350,8350,160,157,29595846,198,90,D C,2,3,3,1,1,1,1,1,1,3,2,3,4,3,8,9,4,16,4,13,17,7,6,18,7,7,19,8,20,18,9,12,9,2,14,5,19,20,7,7,6,14,20,11,15,14,20,12,16,15,1,12,8,5,13,6,18,17,15,19,20,1,D C,101,1,1,20,20,1,1,1,1,1,1,1,1,1,1,20,1,1,1,1,1,1,1,274877906944,0,0,0,0,0,0,0,0,0,0,0,0,0,0,0,0,0,0,0,0,0,0,0,0,0,0,0,0,0,0,0,0,0,0,0,0,0,0,1,0,0,0,0,0,0,0,0,0
29/6/2010,Per Krøldrup,3400909,764,7/31/1979,30,31,0,0,0,4356,6500,6400,142,132,3100041,194,91,D C,3,1,3,2,2,2,3,7,2,3,3,5,6,9,5,10,6,16,7,7,15,7,7,14,7,15,13,12,11,12,7,12,13,5,12,9,14,13,15,12,11,14,17,10,15,12,20,16,14,13,11,13,9,11,13,10,11,11,13,13,10,7,D C,101,1,1,20,20,1,1,1,1,1,1,1,1,1,1,20,1,1,1,1,1,1,1,0,0,0,0,0,0,0,0,0,0,0,0,0,0,0,0,0,0,0,0,0,0,0,0,0,0,0,0,0,0,0,0,0,0,0,0,0,0,0,0,0,0,0,0,0,0,0,0,0
29/6/2010,Pepe,309147,788,2/26/1983,27,27,2,0,0,6972,8250,8250,172,167,164727380,187,81,D C,2,3,1,1,2,1,3,2,2,2,2,7,7,12,10,11,10,16,12,10,17,12,8,17,13,18,16,17,12,17,10,13,15,11,9,11,15,15,17,15,12,17,14,11,18,17,20,16,13,17,13,14,9,12,13,16,11,17,12,8,10,15,D C,101,1,1,20,20,13,1,5,6,5,10,1,1,1,1,20,5,5,6,1,1,1,1,137438953472,0,0,0,0,0,0,0,0,0,0,0,0,0,0,0,0,0,0,0,0,0,0,0,0,0,0,0,0,0,0,0,0,0,0,0,0,0,1,0,0,0,0,0,0,0,0,0,0
29/6/2010,Pavel Krmas,5643787,763,3/3/1980,30,0,0,0,0,4000,6100,6350,133,129,3264675,193,86,D C,3,2,1,2,1,3,1,5,2,1,3,5,5,5,8,7,6,18,8,9,16,6,7,16,8,12,10,13,13,15,6,9,12,8,9,14,12,12,12,12,7,17,18,5,10,9,20,15,18,12,11,13,14,10,13,12,12,12,16,10,10,4,D C,101,1,1,20,20,5,1,9,1,9,1,1,1,1,1,20,9,9,1,1,1,1,1,32864,0,0,0,0,0,1,1,0,0,0,0,0,0,0,0,1,0,0,0,0,0,0,0,0,0,0,0,0,0,0,0,0,0,0,0,0,0,0,0,0,0,0,0,0,0,0,0,0
29/6/2010,Paulo Renato,744546,788,5/14/1987,23,0,0,1,0,1500,3500,3500,108,95,136779,183,74,D C,1,1,3,2,3,3,3,2,1,1,2,6,7,7,5,9,9,11,6,8,11,9,8,10,10,14,13,10,13,13,8,11,16,6,10,8,13,11,10,10,9,11,11,10,11,10,20,10,10,14,8,12,15,7,13,16,15,14,16,15,16,5,D C,101,1,1,20,20,5,1,1,1,1,5,1,1,1,1,20,1,1,1,1,1,1,1,8589934592,0,0,0,0,0,0,0,0,0,0,0,0,0,0,0,0,0,0,0,0,0,0,0,0,0,0,0,0,0,0,0,0,0,1,0,0,0,0,0,0,0,0,0,0,0,0,0,0
29/6/2010,Paulo da Silva,115460,1655,2/1/1980,30,76,2,0,0,4830,7645,6700,141,139,7642746,181,87,D C,2,2,1,3,2,2,2,4,3,1,3,9,10,4,10,10,11,15,10,10,15,13,9,17,12,9,17,13,13,14,12,14,10,8,8,5,15,13,13,11,11,16,10,10,15,10,20,14,15,13,8,12,8,10,8,10,8,10,10,12,12,8,D C,101,1,1,20,20,1,1,10,1,10,1,1,1,1,1,20,10,10,1,1,1,1,1,0,0,0,0,0,0,0,0,0,0,0,0,0,0,0,0,0,0,0,0,0,0,0,0,0,0,0,0,0,0,0,0,0,0,0,0,0,0,0,0,0,0,0,0,0,0,0,0,0
29/6/2010,Paulão,3300234,1651,5/6/1982,28,0,0,0,0,2000,5500,5500,119,113,533010,188,85,D C,1,2,2,2,2,1,1,6,1,2,1,6,6,7,7,8,12,14,12,11,12,7,9,13,10,12,10,11,11,12,8,9,15,7,12,8,11,13,13,11,12,14,15,8,16,11,20,14,13,12,12,10,12,9,14,12,14,12,13,14,14,5,D C,101,1,1,20,20,11,1,1,1,11,1,1,1,1,1,20,1,11,1,1,1,1,1,0,0,0,0,0,0,0,0,0,0,0,0,0,0,0,0,0,0,0,0,0,0,0,0,0,0,0,0,0,0,0,0,0,0,0,0,0,0,0,0,0,0,0,0,0,0,0,0,0
29/6/2010,Paul Scharner,134590,755,3/11/1980,30,30,0,12,0,3906,6875,7000,145,125,5755677,191,82,D/DM/M C,2,3,2,1,1,1,2,2,2,1,3,7,8,12,12,14,6,13,12,14,12,12,10,13,11,12,12,13,14,13,13,14,16,10,12,12,13,8,16,10,10,12,15,15,14,10,20,14,15,14,9,13,2,15,13,17,8,15,6,13,9,14,D/DM/M C,121,5,1,20,20,19,1,1,16,1,1,1,1,1,1,20,1,1,16,1,1,1,1,2147549216,0,0,0,0,0,1,0,0,0,0,0,0,0,0,0,0,1,0,0,0,0,0,0,0,0,0,0,0,0,0,0,1,0,0,0,0,0,0,0,0,0,0,0,0,0,0,0,0
29/6/2010,Paul Baysse,8448625,769,5/18/1988,22,0,0,7,0,2650,4050,4050,145,124,2832981,184,85,D C,3,2,2,2,2,2,1,7,2,3,2,5,7,7,7,11,6,14,13,11,13,9,7,11,11,14,13,16,12,15,10,13,14,6,12,7,15,12,13,12,8,15,12,6,13,11,20,15,15,15,14,14,8,6,16,15,12,14,14,14,14,5,D C,101,1,1,20,20,1,1,1,1,10,1,10,1,1,1,20,1,10,1,1,1,1,10,0,0,0,0,0,0,0,0,0,0,0,0,0,0,0,0,0,0,0,0,0,0,0,0,0,0,0,0,0,0,0,0,0,0,0,0,0,0,0,0,0,0,0,0,0,0,0,0,0
29/6/2010,Pape Sow,8429994,41,12/2/1985,24,0,0,0,0,750,4229,4200,120,94,1185410,180,76,D/DM C,3,1,2,2,2,3,2,1,2,2,1,5,8,6,6,8,11,13,13,6,13,9,7,10,8,16,13,15,10,10,6,9,12,7,12,7,11,12,14,12,9,15,10,5,12,9,20,15,15,12,16,13,13,10,11,12,10,9,13,13,13,7,D/DM C,111,1,1,20,20,17,1,1,15,1,10,1,1,1,1,20,1,1,15,1,1,1,1,35184372088832,0,0,0,0,0,0,0,0,0,0,0,0,0,0,0,0,0,0,0,0,0,0,0,0,0,0,0,0,0,0,0,0,0,0,0,0,0,0,0,0,0,0,0,0,0,1,0,0
29/6/2010,Pape Diakhate,917449,41,6/21/1984,26,30,1,0,0,4761,6900,6200,150,138,2983087,185,78,D C,1,2,1,3,3,2,2,8,1,3,2,7,12,8,8,9,8,15,11,7,15,11,12,14,9,14,15,16,13,14,11,13,17,6,15,8,16,14,15,14,12,16,12,5,14,11,20,15,16,15,14,15,11,10,13,16,14,15,13,13,13,7,D C,101,1,1,20,20,12,1,10,1,10,15,10,1,1,1,20,10,10,1,1,1,10,10,0,0,0,0,0,0,0,0,0,0,0,0,0,0,0,0,0,0,0,0,0,0,0,0,0,0,0,0,0,0,0,0,0,0,0,0,0,0,0,0,0,0,0,0,0,0,0,0,0
29/6/2010,Paolo Hernán Dellafiore,7988413,776,2/2/1985,25,0,0,6,0,3300,6150,6150,140,128,2056418,186,74,D RC,3,2,3,1,3,1,3,4,1,2,3,9,12,10,4,7,4,16,4,5,16,11,4,16,6,12,14,14,15,11,5,12,14,11,11,6,15,14,16,15,16,9,14,9,12,14,20,8,10,15,8,14,6,13,15,14,13,14,6,10,6,6,D RC,103,1,1,20,20,6,1,6,13,16,8,12,1,1,1,20,6,16,1,1,13,4,12,0,0,0,0,0,0,0,0,0,0,0,0,0,0,0,0,0,0,0,0,0,0,0,0,0,0,0,0,0,0,0,0,0,0,0,0,0,0,0,0,0,0,0,0,0,0,0,0,0
29/6/2010,Paolo Cannavaro,3801926,776,6/26/1981,29,0,0,18,0,4900,6800,6800,146,140,16437175,185,80,D C,1,1,2,2,2,2,1,6,1,1,3,3,8,9,10,8,3,16,3,4,15,12,5,16,12,16,14,16,9,13,12,13,13,9,17,12,15,16,16,12,11,14,14,10,14,12,20,16,17,14,15,14,10,12,14,15,16,15,14,16,13,3,D C,101,1,1,20,20,1,1,1,1,13,18,1,1,1,1,20,1,13,1,1,1,1,1,0,0,0,0,0,0,0,0,0,0,0,0,0,0,0,0,0,0,0,0,0,0,0,0,0,0,0,0,0,0,0,0,0,0,0,0,0,0,0,0,0,0,0,0,0,0,0,0,0
29/6/2010,Pablo,824599,796,8/3/1981,28,23,0,10,0,4624,6250,6250,153,136,4743731,192,86,D C,2,2,3,3,3,1,1,1,2,3,3,6,5,7,7,10,4,16,10,11,15,11,6,13,9,16,14,13,15,15,10,13,20,14,13,13,14,12,8,10,12,15,15,11,14,11,20,13,14,16,13,12,10,10,17,17,16,15,17,16,14,6,D C,101,1,1,20,20,1,1,1,1,1,10,1,1,1,1,20,1,1,1,1,1,1,1,4294967296,0,0,0,0,0,0,0,0,0,0,0,0,0,0,0,0,0,0,0,0,0,0,0,0,0,0,0,0,0,0,0,0,1,0,0,0,0,0,0,0,0,0,0,0,0,0,0,0
29/6/2010,Ósmar,67062727,796,6/8/1988,22,0,0,0,0,3080,5000,5000,139,111,1043646,192,84,D C,1,3,1,2,3,1,3,1,1,2,2,5,5,5,5,5,5,14,5,11,13,11,7,12,9,12,11,14,10,12,5,11,12,6,8,5,12,15,15,9,9,17,16,20,14,11,7,13,16,12,11,12,8,8,10,12,13,9,15,10,9,8,D C,101,1,1,20,20,1,1,7,1,1,1,1,1,1,1,20,7,1,1,1,1,1,1,0,0,0,0,0,0,0,0,0,0,0,0,0,0,0,0,0,0,0,0,0,0,0,0,0,0,0,0,0,0,0,0,0,0,0,0,0,0,0,0,0,0,0,0,0,0,0,0,0
29/6/2010,Orlando,7000766,788,10/24/1979,30,0,0,0,0,1250,5250,5250,112,108,175728,182,83,D C,3,3,2,1,2,3,2,2,3,3,1,8,8,7,9,10,9,12,8,10,14,9,10,12,10,12,11,14,15,15,8,12,13,6,11,9,13,15,14,11,12,14,11,8,11,11,20,12,12,13,10,11,10,11,9,10,14,12,15,14,14,5,D C,101,1,1,20,20,10,1,1,10,1,1,1,1,1,1,20,1,1,10,1,1,1,1,0,0,0,0,0,0,0,0,0,0,0,0,0,0,0,0,0,0,0,0,0,0,0,0,0,0,0,0,0,0,0,0,0,0,0,0,0,0,0,0,0,0,0,0,0,0,0,0,0
29/6/2010,Orestes,3301540,1651,3/24/1981,29,0,0,0,0,2916,4750,5500,112,108,688726,182,79,D C,2,2,2,1,2,3,2,1,1,1,3,8,9,9,8,9,8,12,9,11,14,12,9,13,12,14,13,12,11,14,11,10,11,9,12,10,15,12,12,12,12,15,14,6,15,12,20,13,15,12,12,10,6,12,12,13,9,13,11,10,11,8,D C,101,1,1,20,20,15,1,10,15,13,1,1,1,1,1,20,10,13,15,1,1,1,1,98304,0,0,0,0,0,0,0,0,0,0,0,0,0,0,0,1,1,0,0,0,0,0,0,0,0,0,0,0,0,0,0,0,0,0,0,0,0,0,0,0,0,0,0,0,0,0,0,0
29/6/2010,Onyekachi Apam,8632613,38,12/30/1986,23,12,0,10,1,4489,6700,6000,155,134,8999999,177,67,D RC,3,1,2,3,2,3,2,7,3,3,1,5,11,8,6,10,7,12,8,11,14,6,7,15,10,16,16,15,9,12,6,12,15,6,11,9,13,13,16,16,13,15,9,10,14,14,20,15,14,11,16,15,9,10,13,16,12,13,11,11,11,11,D RC,103,1,1,20,20,1,1,13,1,15,1,15,1,1,1,20,13,15,1,1,1,13,15,137438986240,0,0,0,0,0,0,0,0,0,0,0,0,0,0,0,1,0,0,0,0,0,0,0,0,0,0,0,0,0,0,0,0,0,0,0,0,0,1,0,0,0,0,0,0,0,0,0,0
29/6/2010,Ömer Toprak,91000354,771,7/21/1989,20,0,0,0,0,2750,6000,6000,166,130,8369107,186,81,D C,2,3,1,2,2,3,2,3,1,3,2,7,7,8,10,10,8,15,7,8,15,13,8,14,10,12,10,10,12,12,12,11,17,12,10,11,12,12,13,14,15,15,14,10,10,15,20,14,13,15,5,11,12,6,12,17,14,13,15,14,7,12,D C,101,1,1,20,20,8,1,12,1,14,1,1,1,1,1,20,12,14,1,1,1,1,1,8800387989504,0,0,0,0,0,0,0,0,0,0,0,0,0,0,0,0,0,0,0,0,0,0,0,0,0,0,0,0,0,0,0,0,1,0,0,0,0,0,0,0,0,0,0,1,0,0,0,0
29/6/2010,Oliver Barth,890717,771,10/6/1979,30,0,0,0,0,3906,5500,5500,125,125,2371834,188,81,D/DM C,2,2,2,2,3,3,1,2,1,2,3,7,9,12,11,10,9,17,11,15,15,11,9,16,9,8,13,9,12,17,11,9,11,6,10,11,11,16,16,10,11,12,16,20,15,9,6,15,14,10,5,12,4,15,7,6,16,8,15,15,11,4,D/DM C,111,1,1,20,20,16,1,10,15,1,1,1,1,1,1,20,10,1,15,1,1,1,1,8589934592,0,0,0,0,0,0,0,0,0,0,0,0,0,0,0,0,0,0,0,0,0,0,0,0,0,0,0,0,0,0,0,0,0,1,0,0,0,0,0,0,0,0,0,0,0,0,0,0
29/6/2010,Nuno André Coelho,8874548,788,1/7/1986,24,0,0,0,0,3750,6600,6600,150,132,42182124,190,78,D C,3,1,1,3,3,2,2,1,1,1,2,9,10,8,10,11,10,14,10,10,13,9,9,12,10,13,15,13,17,13,8,11,13,6,10,11,12,12,12,13,12,15,15,10,14,12,20,13,15,12,9,10,7,12,12,12,13,12,15,16,16,5,D C,101,1,1,20,20,13,1,7,1,10,5,1,1,1,1,20,7,10,1,1,1,1,1,0,0,0,0,0,0,0,0,0,0,0,0,0,0,0,0,0,0,0,0,0,0,0,0,0,0,0,0,0,0,0,0,0,0,0,0,0,0,0,0,0,0,0,0,0,0,0,0,0
29/6/2010,Noé Pamarot,3500933,769,4/14/1979,31,0,0,0,0,3906,5624,4750,139,125,1669540,180,87,D RC,1,2,1,1,3,2,2,7,1,1,2,5,9,6,7,9,10,16,9,5,14,10,6,14,9,14,12,16,11,11,8,10,17,6,8,8,12,14,14,14,7,16,12,9,10,13,20,15,17,11,14,10,5,7,12,13,16,14,13,10,14,7,D RC,103,1,1,20,20,1,1,13,1,16,1,1,1,1,1,20,13,16,1,1,1,1,1,137438986240,0,0,0,0,0,0,0,0,0,0,0,0,0,0,0,1,0,0,0,0,0,0,0,0,0,0,0,0,0,0,0,0,0,0,0,0,0,1,0,0,0,0,0,0,0,0,0,0
29/6/2010,Nikolce Noveski,884748,781,4/28/1979,31,25,3,0,0,4500,6750,7100,140,137,8017596,190,87,D C,1,3,3,3,2,2,2,3,2,1,2,6,8,7,7,9,7,17,10,17,17,11,7,13,10,16,14,17,12,11,13,10,13,7,12,12,13,15,17,11,9,15,16,20,12,11,15,13,12,15,11,13,12,9,14,17,17,15,14,17,18,10,D C,101,1,1,20,20,1,1,10,1,1,1,1,1,1,1,20,10,1,1,1,1,1,1,8589934592,0,0,0,0,0,0,0,0,0,0,0,0,0,0,0,0,0,0,0,0,0,0,0,0,0,0,0,0,0,0,0,0,0,1,0,0,0,0,0,0,0,0,0,0,0,0,0,0
29/6/2010,Niko Bungert,8728048,771,10/24/1986,23,0,0,3,0,3250,6250,6250,135,125,2755092,188,68,D RC,2,2,2,1,1,1,2,1,2,2,1,3,11,5,5,13,3,12,5,7,16,13,5,12,11,11,16,11,8,14,9,13,13,9,6,4,12,14,12,14,16,11,15,5,12,14,20,12,13,11,6,6,4,10,12,14,7,8,11,15,8,7,D RC,103,1,1,20,20,1,1,1,1,16,1,1,1,1,1,20,1,16,1,1,1,1,1,274877906944,0,0,0,0,0,0,0,0,0,0,0,0,0,0,0,0,0,0,0,0,0,0,0,0,0,0,0,0,0,0,0,0,0,0,0,0,0,0,1,0,0,0,0,0,0,0,0,0
29/6/2010,Nicolò Cherubin,1402118,776,12/2/1986,23,0,0,0,0,1750,5500,5500,135,111,1986151,188,83,D RC,1,1,1,1,1,1,1,1,1,1,1,2,4,4,4,8,4,15,5,8,13,7,5,14,8,12,14,11,8,11,8,11,14,6,14,5,13,14,14,12,11,14,16,6,14,12,20,12,15,15,12,13,4,14,5,12,18,10,14,12,8,4,D RC,103,1,1,20,20,1,1,14,1,15,10,1,1,1,1,20,14,15,1,1,1,1,1,0,0,0,0,0,0,0,0,0,0,0,0,0,0,0,0,0,0,0,0,0,0,0,0,0,0,0,0,0,0,0,0,0,0,0,0,0,0,0,0,0,0,0,0,0,0,0,0,0
29/6/2010,Nicolás Spolli,956682,1649,2/20/1983,27,0,0,0,0,3500,5750,6400,138,127,5582241,192,86,D C,1,2,3,3,1,2,2,7,2,2,3,4,4,7,7,8,4,16,5,13,14,10,11,14,10,16,12,14,11,10,10,10,16,4,11,6,14,12,15,12,14,16,18,5,12,12,20,14,15,12,14,13,13,5,14,15,15,13,12,14,10,9,D C,101,1,1,20,20,1,1,1,1,1,1,1,1,1,1,20,1,1,1,1,1,1,1,0,0,0,0,0,0,0,0,0,0,0,0,0,0,0,0,0,0,0,0,0,0,0,0,0,0,0,0,0,0,0,0,0,0,0,0,0,0,0,0,0,0,0,0,0,0,0,0,0
29/6/2010,Nicolas Seguin,34011691,769,3/6/1990,20,0,0,0,0,1400,2800,2800,140,113,6314493,181,76,D C,3,3,2,2,3,2,1,1,3,1,3,5,8,8,6,11,6,12,7,7,12,10,6,10,11,11,13,13,13,13,9,12,14,5,8,7,13,13,11,14,10,14,9,8,15,13,20,17,14,14,11,15,7,12,7,14,17,15,15,15,15,6,D C,101,1,1,20,20,1,1,10,1,14,1,14,1,1,1,20,10,14,1,1,1,10,14,0,0,0,0,0,0,0,0,0,0,0,0,0,0,0,0,0,0,0,0,0,0,0,0,0,0,0,0,0,0,0,0,0,0,0,0,0,0,0,0,0,0,0,0,0,0,0,0,0
29/6/2010,Nicolas Plestan,914473,769,6/2/1981,29,0,0,0,0,3969,5650,5650,140,126,5326752,184,76,D C,2,3,1,1,3,1,1,1,1,1,3,5,10,7,6,10,7,14,10,11,14,9,8,12,10,15,13,15,14,13,8,13,16,6,13,7,14,14,15,13,10,14,12,8,8,12,20,13,14,14,15,14,15,8,8,14,15,14,14,14,11,6,D C,101,1,1,20,20,1,1,1,1,1,1,1,1,1,1,20,1,1,1,1,1,1,1,0,0,0,0,0,0,0,0,0,0,0,0,0,0,0,0,0,0,0,0,0,0,0,0,0,0,0,0,0,0,0,0,0,0,0,0,0,0,0,0,0,0,0,0,0,0,0,0,0
29/6/2010,Nicolas Pallois,85074521,769,9/19/1987,22,0,0,0,0,1300,2600,2600,130,104,4214738,190,85,D LC,2,1,1,2,2,2,2,6,1,2,1,7,11,8,6,8,7,13,10,12,11,7,10,12,8,13,11,13,11,11,7,12,14,6,5,9,9,14,15,12,8,16,14,20,14,13,5,13,16,14,13,14,11,10,7,13,14,13,15,13,13,20,D LC,104,1,1,16,20,1,1,20,1,1,1,15,1,1,1,16,20,6,1,1,1,15,1,32,0,0,0,0,0,1,0,0,0,0,0,0,0,0,0,0,0,0,0,0,0,0,0,0,0,0,0,0,0,0,0,0,0,0,0,0,0,0,0,0,0,0,0,0,0,0,0,0
29/6/2010,Nicolás Otamendi,14004589,1649,2/12/1988,22,10,0,0,0,5256,7000,7000,177,145,48209291,178,75,D C,3,1,3,2,1,2,1,7,1,2,2,2,4,7,2,4,3,15,3,5,17,10,2,18,10,16,19,18,14,10,5,13,18,4,10,9,15,17,16,15,17,13,11,7,13,13,20,17,15,14,8,17,3,3,14,14,16,19,16,13,12,9,D C,101,1,1,20,20,7,1,1,1,13,1,1,1,1,1,20,1,13,1,1,1,1,1,137438986240,0,0,0,0,0,0,0,0,0,0,0,0,0,0,0,1,0,0,0,0,0,0,0,0,0,0,0,0,0,0,0,0,0,0,0,0,0,1,0,0,0,0,0,0,0,0,0,0
29/6/2010,Nicolas Nkoulou,12007662,11,3/27/1990,20,20,0,4,0,4225,6500,5850,170,130,9285899,180,77,D/DM C,2,3,2,3,2,3,1,1,3,3,3,5,7,11,6,13,6,11,9,6,16,12,7,13,13,12,15,15,12,12,13,12,16,9,10,7,14,15,13,15,13,15,10,5,15,14,20,14,15,13,12,16,7,12,9,15,14,13,15,14,14,7,D/DM C,321,7,1,20,18,20,5,1,15,12,1,12,1,1,1,18,1,12,15,1,1,1,12,0,0,0,0,0,0,0,0,0,0,0,0,0,0,0,0,0,0,0,0,0,0,0,0,0,0,0,0,0,0,0,0,0,0,0,0,0,0,0,0,0,0,0,0,0,0,0,0,0
29/6/2010,Nicolas Mélet,85045418,769,4/29/1990,20,0,0,0,0,50,2350,2350,130,95,3803602,193,90,D LC,1,1,1,3,1,2,2,7,2,1,3,9,11,8,3,11,7,12,4,7,12,14,8,12,12,15,15,14,12,13,11,12,9,5,8,7,10,17,14,14,9,10,16,20,14,11,5,11,6,10,5,5,13,10,15,11,8,12,7,8,13,5,D LC,104,1,1,20,20,1,1,18,1,1,1,15,1,1,1,20,18,1,1,1,1,15,1,0,0,0,0,0,0,0,0,0,0,0,0,0,0,0,0,0,0,0,0,0,0,0,0,0,0,0,0,0,0,0,0,0,0,0,0,0,0,0,0,0,0,0,0,0,0,0,0,0
29/6/2010,Nicolas Godemèche,916194,769,6/22/1984,26,0,0,0,0,2000,5000,5500,114,110,233473,185,78,DM/M C,1,2,1,3,2,1,2,1,3,1,1,7,9,9,6,11,7,14,11,5,10,13,11,12,11,10,14,13,14,14,14,11,13,7,11,8,12,12,14,12,10,15,13,7,12,10,20,17,15,14,10,14,14,15,16,12,16,12,16,15,14,6,DM/M C,311,1,1,20,15,20,1,1,17,10,1,1,1,1,1,15,1,10,17,1,1,1,1,0,0,0,0,0,0,0,0,0,0,0,0,0,0,0,0,0,0,0,0,0,0,0,0,0,0,0,0,0,0,0,0,0,0,0,0,0,0,0,0,0,0,0,0,0,0,0,0,0
29/6/2010,Nicolas Frey,8430961,769,3/6/1984,26,0,0,0,0,3844,5000,6100,129,124,2934190,184,78,D RC,1,3,1,3,2,1,3,1,2,2,1,8,12,9,6,11,7,12,7,13,14,12,5,13,11,13,11,13,12,15,10,10,10,8,9,12,13,12,13,13,13,14,12,8,15,14,20,14,15,15,12,13,10,13,15,10,14,10,14,13,10,5,D RC,103,1,1,18,20,1,1,1,1,20,1,14,1,1,1,18,6,20,1,1,1,1,14,0,0,0,0,0,0,0,0,0,0,0,0,0,0,0,0,0,0,0,0,0,0,0,0,0,0,0,0,0,0,0,0,0,0,0,0,0,0,0,0,0,0,0,0,0,0,0,0,0
29/6/2010,Nicolás Burdisso,6300458,1649,4/12/1981,29,25,2,0,0,5852,7250,7600,160,153,16683558,182,81,D C,1,1,1,1,1,1,1,1,1,1,1,3,10,8,11,11,3,19,7,10,17,12,8,16,10,17,16,16,12,14,9,14,15,5,13,10,15,16,18,12,14,15,13,8,15,12,20,15,16,15,16,10,10,18,16,13,16,10,16,15,7,8,D C,101,1,1,20,20,8,1,13,1,13,10,1,1,1,1,20,13,13,1,1,1,1,1,2473901195264,0,0,0,0,0,0,0,0,0,0,0,0,0,0,0,1,0,0,0,0,0,0,0,0,0,0,0,0,0,0,0,0,0,0,0,0,0,0,1,0,0,1,0,0,0,0,0,0
29/6/2010,Nicola Legrottaglie,1159,776,10/20/1976,33,16,1,0,0,5184,7450,7450,158,144,2310152,185,73,D C,2,2,3,2,2,2,1,1,2,3,3,4,5,8,12,13,5,16,6,14,16,14,7,16,8,14,14,15,14,14,12,13,16,8,14,13,17,17,17,12,12,13,12,7,17,14,20,14,14,13,13,11,4,9,8,10,16,10,16,20,20,3,D C,101,1,1,20,20,6,1,1,3,1,18,1,1,1,1,20,1,1,3,1,1,1,1,8796093038592,0,0,0,0,0,0,0,0,0,0,0,0,0,0,1,0,0,0,0,0,0,0,0,0,0,0,0,0,0,0,0,0,0,0,0,0,0,0,0,0,0,0,0,1,0,0,0,0
29/6/2010,Ney,2113304,1651,2/23/1981,29,0,0,0,0,2000,5800,5000,110,107,516265,181,81,D/DM RLC,2,2,1,1,3,1,3,3,1,2,1,9,9,9,7,9,7,9,9,13,12,10,5,10,11,16,11,15,9,10,8,8,14,8,10,9,10,12,11,12,13,10,12,10,13,12,20,14,13,11,14,13,7,19,9,12,9,12,12,10,10,10,D/DM RLC,116,1,1,18,20,18,1,15,15,20,1,13,1,1,1,15,15,20,15,1,1,10,13,34,0,1,0,0,0,1,0,0,0,0,0,0,0,0,0,0,0,0,0,0,0,0,0,0,0,0,0,0,0,0,0,0,0,0,0,0,0,0,0,0,0,0,0,0,0,0,0,0
29/6/2010,Neven Subotic,35013755,802,12/10/1988,21,15,1,0,0,5112,6900,7150,166,143,23703262,193,87,D C,1,3,2,3,3,1,1,6,1,1,1,3,7,6,13,12,11,18,12,9,15,13,5,16,13,12,14,13,12,9,12,13,15,8,8,7,13,15,11,8,13,14,17,14,12,14,20,12,16,14,8,9,5,4,18,13,10,14,17,16,15,3,D C,101,1,1,20,20,1,1,1,1,1,1,1,1,1,1,20,1,1,1,1,1,1,1,43980465111552,0,0,0,0,0,0,0,0,0,1,0,0,0,0,0,0,0,0,0,0,0,0,0,0,0,0,0,0,0,0,0,0,0,0,0,0,0,0,0,0,0,0,0,1,0,1,0,0
29/6/2010,Nenad Tomovic,5768029,802,8/30/1987,22,2,0,20,1,4250,6050,6150,158,133,6207536,184,74,D RC,2,3,3,2,3,1,2,2,3,3,3,8,12,10,8,15,11,10,9,10,14,14,13,14,14,16,10,12,16,11,11,13,13,13,11,14,13,14,16,14,13,13,12,5,15,14,20,13,14,11,9,13,7,15,12,15,13,14,11,11,13,6,D RC,103,1,1,18,20,1,1,1,15,20,1,15,1,1,1,18,1,20,1,1,15,1,15,8796093022240,0,0,0,0,0,1,0,0,0,0,0,0,0,0,0,0,0,0,0,0,0,0,0,0,0,0,0,0,0,0,0,0,0,0,0,0,0,0,0,0,0,0,0,1,0,0,0,0
29/6/2010,Nenad Dzodic,402511,802,1/4/1977,33,6,0,8,0,4356,5939,5900,142,132,1028315,188,75,D C,2,3,3,2,3,2,1,3,3,3,2,5,6,6,9,7,6,16,10,7,15,9,8,14,7,13,15,16,14,14,8,13,14,5,18,8,16,16,13,7,8,17,14,8,9,11,20,13,15,15,13,13,12,5,11,14,16,13,15,13,13,9,D C,101,1,1,20,20,1,1,1,1,10,1,1,1,1,1,20,1,10,1,1,1,1,1,32,0,0,0,0,0,1,0,0,0,0,0,0,0,0,0,0,0,0,0,0,0,0,0,0,0,0,0,0,0,0,0,0,0,0,0,0,0,0,0,0,0,0,0,0,0,0,0,0
29/6/2010,Nemanja Vidic,5743470,802,10/21/1981,28,48,2,2,1,7656,8200,8750,178,175,108162998,188,82,D C,3,3,3,1,2,1,3,9,3,2,2,3,3,4,7,13,3,19,4,7,17,11,10,17,13,18,18,19,13,16,7,15,18,4,12,6,17,16,15,12,12,13,17,12,16,12,20,16,18,16,16,15,8,4,17,17,14,14,16,12,16,5,D C,101,1,1,20,20,1,1,1,1,5,5,1,1,1,1,20,1,5,1,1,1,1,1,32768,0,0,0,0,0,0,0,0,0,0,0,0,0,0,0,1,0,0,0,0,0,0,0,0,0,0,0,0,0,0,0,0,0,0,0,0,0,0,0,0,0,0,0,0,0,0,0,0
29/6/2010,Nemanja Pejcinovic,5779333,802,11/4/1987,22,1,0,10,0,3481,5400,5400,148,118,525016,185,84,D LC,3,2,3,3,1,2,1,3,1,1,1,10,14,10,9,11,6,16,8,12,16,9,11,17,9,16,8,17,11,11,11,4,12,10,12,10,11,10,10,12,11,10,14,15,14,12,20,14,13,15,9,11,8,9,14,15,13,14,14,12,13,6,D LC,104,1,1,20,20,1,1,17,9,12,1,13,1,1,1,20,17,12,1,9,1,13,1,137438953472,0,0,0,0,0,0,0,0,0,0,0,0,0,0,0,0,0,0,0,0,0,0,0,0,0,0,0,0,0,0,0,0,0,0,0,0,0,1,0,0,0,0,0,0,0,0,0,0
29/6/2010,Nedum Onuoha,5114013,765,11/30/1986,23,0,0,21,2,4500,6750,6750,152,135,4173096,183,93,D RC,1,3,1,1,2,3,1,6,2,2,1,4,4,7,4,7,4,15,5,13,14,7,5,15,8,12,10,13,10,12,8,10,14,4,13,7,14,13,10,20,14,12,12,7,16,18,20,17,15,13,2,12,16,12,11,14,15,13,18,15,14,2,D RC,103,1,1,20,20,1,1,10,1,18,1,10,1,1,1,20,10,18,1,1,1,1,10,0,0,0,0,0,0,0,0,0,0,0,0,0,0,0,0,0,0,0,0,0,0,0,0,0,0,0,0,0,0,0,0,0,0,0,0,0,0,0,0,0,0,0,0,0,0,0,0,0
29/6/2010,Nano,813622,796,7/7/1980,29,0,0,0,0,3136,5600,5600,133,112,1692267,185,79,D LC,2,2,2,2,1,3,2,4,1,3,3,7,8,7,5,10,9,15,10,7,14,11,6,14,10,13,13,14,7,12,8,12,13,7,13,11,12,12,11,11,14,14,13,20,8,13,5,13,13,13,13,8,16,11,9,10,12,10,13,10,10,7,D LC,104,1,1,20,20,1,1,16,1,1,1,12,1,1,1,20,16,1,1,1,1,12,1,32768,0,0,0,0,0,0,0,0,0,0,0,0,0,0,0,1,0,0,0,0,0,0,0,0,0,0,0,0,0,0,0,0,0,0,0,0,0,0,0,0,0,0,0,0,0,0,0,0
29/6/2010,Naldo,8829862,1651,9/10/1982,27,4,0,0,0,6250,7250,8000,167,161,27797898,198,89,D C,3,1,1,3,1,2,1,4,3,1,2,7,8,12,8,12,14,17,14,15,14,13,12,17,14,9,17,9,12,10,12,16,15,14,11,13,10,14,16,15,10,14,20,10,19,17,20,15,14,15,11,15,7,10,12,9,17,16,13,14,12,8,D C,101,1,1,20,20,1,1,1,1,1,7,1,1,1,1,20,1,1,1,1,1,1,1,35463544963592,0,0,0,1,0,0,0,0,0,1,0,0,0,0,0,0,0,0,0,0,0,0,0,0,0,0,0,0,0,0,0,0,1,0,0,0,0,0,1,0,0,0,0,0,0,1,0,0
29/6/2010,Moustapha Bayal,34010587,41,11/30/1985,24,6,1,0,0,3600,6750,6050,158,135,4764847,191,90,D/DM C,3,1,2,2,1,1,1,1,2,2,2,6,8,8,6,10,12,17,16,7,14,11,7,13,10,15,15,16,13,12,11,12,15,6,13,7,13,16,16,13,10,18,17,8,15,9,20,15,18,13,12,14,13,10,14,14,13,13,13,13,13,9,D/DM C,111,1,1,20,20,18,1,1,15,1,1,1,1,1,1,20,1,1,15,1,1,1,1,35184372121600,0,0,0,0,0,0,0,0,0,0,0,0,0,0,0,1,0,0,0,0,0,0,0,0,0,0,0,0,0,0,0,0,0,0,0,0,0,0,0,0,0,0,0,0,0,1,0,0
29/6/2010,Mouhammadou N'Diaye,12029964,41,6/21/1990,20,0,0,0,0,1000,4049,4000,128,90,2107876,185,75,D C,1,1,1,3,2,2,3,2,3,3,1,7,5,2,5,12,8,13,5,6,12,7,9,11,7,15,13,15,10,10,1,10,10,3,12,6,8,7,10,10,10,13,13,9,14,10,20,10,12,8,6,10,9,10,8,15,11,12,16,8,12,5,D C,101,1,1,20,20,1,1,1,1,1,1,1,1,1,1,20,1,1,1,1,1,1,1,0,0,0,0,0,0,0,0,0,0,0,0,0,0,0,0,0,0,0,0,0,0,0,0,0,0,0,0,0,0,0,0,0,0,0,0,0,0,0,0,0,0,0,0,0,0,0,0,0
29/6/2010,Moriké Kallé,85042570,31,9/19/1990,19,1,0,4,0,2100,5500,2750,145,110,1892779,184,78,D C,1,3,3,2,2,2,1,3,2,3,1,5,5,6,7,8,6,13,7,8,14,7,6,12,8,13,13,17,11,13,8,12,14,6,10,6,11,15,13,13,9,14,12,5,13,11,20,14,14,13,13,5,7,8,11,14,12,12,14,14,16,5,D C,101,1,1,20,20,1,1,1,1,10,1,10,1,1,1,20,1,10,1,1,1,1,10,32768,0,0,0,0,0,0,0,0,0,0,0,0,0,0,0,1,0,0,0,0,0,0,0,0,0,0,0,0,0,0,0,0,0,0,0,0,0,0,0,0,0,0,0,0,0,0,0,0
29/6/2010,Moisés,6900168,1651,7/25/1979,30,0,0,0,0,2750,5700,6500,134,132,1106537,184,78,D C,2,1,2,2,2,2,3,3,2,1,1,7,7,11,11,12,10,16,8,9,15,11,11,14,12,17,12,16,15,11,11,14,16,11,17,13,16,15,15,10,12,13,14,5,15,10,20,16,12,16,12,14,6,11,14,14,16,14,17,13,13,5,D C,101,1,1,20,20,10,1,10,5,10,18,1,1,1,1,20,10,10,5,1,1,1,1,0,0,0,0,0,0,0,0,0,0,0,0,0,0,0,0,0,0,0,0,0,0,0,0,0,0,0,0,0,0,0,0,0,0,0,0,0,0,0,0,0,0,0,0,0,0,0,0,0
29/6/2010,Moïse Brou Apanga,838350,19,2/4/1982,28,20,1,0,0,3600,6100,4000,128,122,1100513,180,79,D C,2,3,3,2,2,3,3,8,1,2,2,5,7,7,8,9,6,15,6,6,14,7,8,14,9,11,15,14,12,13,6,12,14,5,12,8,14,14,13,12,11,15,12,5,15,11,20,14,14,14,11,15,7,8,12,12,15,15,15,15,15,5,D C,101,1,1,20,20,10,1,1,1,8,1,8,1,1,1,20,1,8,1,1,1,1,8,137438953504,0,0,0,0,0,1,0,0,0,0,0,0,0,0,0,0,0,0,0,0,0,0,0,0,0,0,0,0,0,0,0,0,0,0,0,0,0,1,0,0,0,0,0,0,0,0,0,0
29/6/2010,Mohamed Sarr,837276,41,12/23/1983,26,11,0,0,0,3969,6300,6250,135,126,2211291,185,84,D C,3,3,2,1,2,3,2,3,1,1,3,9,9,10,8,10,9,16,10,11,18,7,12,14,10,13,14,12,8,10,4,8,17,11,17,10,15,18,18,11,14,17,13,5,11,11,20,10,17,15,17,10,17,14,15,16,14,12,11,10,9,14,D C,101,1,1,20,20,1,1,10,1,14,1,1,1,1,1,20,10,14,1,1,1,1,1,0,0,0,0,0,0,0,0,0,0,0,0,0,0,0,0,0,0,0,0,0,0,0,0,0,0,0,0,0,0,0,0,0,0,0,0,0,0,0,0,0,0,0,0,0,0,0,0,0
29/6/2010,Mohamed Fofana,8443480,769,3/7/1985,25,0,0,0,0,1400,6029,6000,155,134,3870343,181,75,D C,1,2,2,2,2,1,1,3,3,1,1,5,9,8,6,9,7,17,11,9,16,7,6,13,9,13,15,14,13,14,7,12,13,6,11,7,13,15,16,13,11,14,10,12,13,12,20,17,14,14,11,11,9,8,6,13,15,14,16,16,16,6,D C,101,1,1,20,20,1,1,1,1,12,10,12,1,1,1,20,1,12,1,1,1,1,12,32768,0,0,0,0,0,0,0,0,0,0,0,0,0,0,0,1,0,0,0,0,0,0,0,0,0,0,0,0,0,0,0,0,0,0,0,0,0,0,0,0,0,0,0,0,0,0,0,0
29/6/2010,Modibo Diakité,1408579,769,3/2/1987,23,0,0,0,0,3000,5894,6500,153,131,4459425,192,84,D RC,1,1,2,3,1,3,2,1,1,3,1,2,2,6,6,4,2,17,4,15,14,8,6,15,6,15,13,14,10,12,4,10,12,3,6,8,14,11,14,15,11,17,18,7,7,13,20,15,18,12,15,12,10,11,10,12,11,12,11,12,14,8,D RC,103,1,1,20,20,1,1,1,1,15,10,1,1,1,1,20,1,15,1,1,1,1,1,292057808960,0,0,0,0,0,0,1,0,0,0,0,0,0,0,0,1,0,0,0,0,0,0,0,0,0,0,0,0,0,0,0,0,0,0,1,0,0,0,1,0,0,0,0,0,0,0,0,0
29/6/2010,Miquel Robusté,7451992,796,5/20/1985,25,0,0,0,0,3900,5500,5500,138,125,2555436,185,80,D C,3,2,2,1,3,2,1,6,2,3,3,5,3,2,8,6,3,14,4,13,15,9,7,13,7,15,15,15,10,14,10,12,12,10,14,6,14,13,13,11,13,14,14,5,14,9,20,15,16,15,13,11,4,7,11,14,12,10,13,14,14,5,D C,101,1,1,20,20,1,1,1,1,1,10,1,1,1,1,20,1,1,1,1,1,1,1,64,0,0,0,0,0,0,1,0,0,0,0,0,0,0,0,0,0,0,0,0,0,0,0,0,0,0,0,0,0,0,0,0,0,0,0,0,0,0,0,0,0,0,0,0,0,0,0,0
29/6/2010,Milan Bisevac,5763744,802,8/31/1983,26,3,0,20,1,4692,6164,6150,145,137,7361134,185,81,D RC,3,2,2,3,2,3,2,9,3,3,2,6,8,9,7,10,12,15,13,9,15,11,10,14,11,15,13,13,12,14,9,12,15,7,16,8,14,13,14,13,11,15,13,12,13,12,20,15,15,15,15,15,10,13,11,12,11,13,15,13,13,7,D RC,103,1,1,20,20,14,1,8,10,15,10,1,1,1,1,20,8,15,10,1,1,1,1,0,0,0,0,0,0,0,0,0,0,0,0,0,0,0,0,0,0,0,0,0,0,0,0,0,0,0,0,0,0,0,0,0,0,0,0,0,0,0,0,0,0,0,0,0,0,0,0,0
29/6/2010,Mikel San José,67037571,796,5/30/1989,21,0,0,3,0,4556,6250,6250,155,135,11881979,186,77,D C,1,2,2,1,2,3,1,4,2,2,2,3,8,8,8,12,5,16,5,8,14,12,13,15,12,9,11,14,13,13,12,12,12,7,12,7,14,14,12,9,13,14,14,12,12,12,20,14,14,13,5,12,7,5,14,14,7,14,17,10,10,5,D C,101,1,1,20,20,10,1,1,1,1,1,1,1,1,1,20,1,1,1,1,1,1,1,0,0,0,0,0,0,0,0,0,0,0,0,0,0,0,0,0,0,0,0,0,0,0,0,0,0,0,0,0,0,0,0,0,0,0,0,0,0,0,0,0,0,0,0,0,0,0,0,0
29/6/2010,Mikel Labaka,823567,796,4/8/1980,30,0,0,0,0,3844,5750,5750,132,124,1657059,184,77,D C,1,3,1,2,1,3,3,1,1,3,1,4,3,5,11,8,3,16,3,5,13,8,4,13,10,14,13,16,12,12,5,11,8,3,11,7,14,14,14,12,11,13,10,10,8,12,20,14,16,12,11,12,5,4,9,11,20,10,13,15,9,9,D C,101,1,1,20,20,1,1,1,1,1,15,1,1,1,1,20,1,1,1,1,1,1,1,8796093022208,0,0,0,0,0,0,0,0,0,0,0,0,0,0,0,0,0,0,0,0,0,0,0,0,0,0,0,0,0,0,0,0,0,0,0,0,0,0,0,0,0,0,0,1,0,0,0,0
29/6/2010,Mikel González,1507530,796,9/24/1985,24,0,0,0,0,4160,6000,6000,145,129,4134827,186,74,D C,3,14,3,1,3,2,2,1,2,3,1,2,7,9,5,10,5,13,4,3,14,12,6,16,13,13,14,12,12,12,12,13,13,10,13,9,14,13,12,12,13,11,13,20,11,14,11,13,13,13,8,14,4,13,14,14,14,14,14,14,13,6,D C,101,1,1,20,20,11,1,13,1,10,1,3,1,1,1,20,13,10,1,1,1,3,1,137438953472,0,0,0,0,0,0,0,0,0,0,0,0,0,0,0,0,0,0,0,0,0,0,0,0,0,0,0,0,0,0,0,0,0,0,0,0,0,1,0,0,0,0,0,0,0,0,0,0
29/6/2010,Mike Williamson,5102368,765,11/8/1983,26,0,0,0,0,3100,6400,6400,130,120,4140000,191,84,D C,1,3,1,1,1,1,2,5,1,2,3,4,7,6,4,12,5,15,5,5,14,9,5,14,9,12,15,14,12,14,8,13,12,4,12,9,12,13,11,8,12,14,16,5,14,11,20,12,15,18,10,8,11,5,13,14,10,13,13,11,12,4,D C,101,1,1,20,20,9,1,1,1,5,1,1,1,1,1,20,1,5,1,1,1,1,1,0,0,0,0,0,0,0,0,0,0,0,0,0,0,0,0,0,0,0,0,0,0,0,0,0,0,0,0,0,0,0,0,0,0,0,0,0,0,0,0,0,0,0,0,0,0,0,0,0
29/6/2010,Mikaël Silvestre,12114,769,8/9/1977,32,40,2,18,0,4225,5850,6800,165,130,5597268,183,84,D LC,1,1,1,1,1,1,1,1,1,1,1,4,13,8,5,14,2,16,6,9,14,12,6,16,13,11,13,13,10,10,11,13,16,8,8,10,13,13,14,12,13,14,13,20,15,13,10,15,14,12,12,13,15,11,17,15,16,12,16,12,13,8,D LC,104,1,1,20,20,1,1,17,1,1,14,14,1,1,1,20,17,1,1,1,1,14,1,149813827993600,0,0,0,0,0,0,0,0,0,0,0,0,0,0,0,0,0,0,0,0,0,0,0,0,0,0,0,0,0,0,1,0,1,0,0,0,0,0,1,0,0,0,0,1,0,0,0,1
29/6/2010,Miguel Flaño,7443557,796,8/19/1984,25,0,0,0,0,4356,6250,6250,142,132,4930823,177,72,D C,2,1,3,3,3,1,1,5,2,1,3,8,7,9,10,11,8,15,10,10,13,11,8,14,11,16,15,13,12,14,9,12,14,7,10,8,13,14,14,12,13,11,10,8,13,14,20,15,16,15,15,11,6,6,12,10,15,10,14,14,10,10,D C,101,1,1,20,20,1,1,1,1,1,1,1,1,1,1,20,1,1,1,1,1,1,1,0,0,0,0,0,0,0,0,0,0,0,0,0,0,0,0,0,0,0,0,0,0,0,0,0,0,0,0,0,0,0,0,0,0,0,0,0,0,0,0,0,0,0,0,0,0,0,0,0
29/6/2010,Miguel Britos,78007927,1657,7/17/1985,24,0,0,0,0,550,5984,5950,146,133,2420470,186,82,D C,3,1,3,2,1,3,2,6,3,3,1,14,11,12,8,13,12,14,10,13,13,11,8,12,13,15,11,13,12,12,8,12,12,9,6,13,13,13,13,15,11,14,14,20,14,14,9,14,14,12,14,12,7,9,11,9,13,14,13,14,11,5,D C,101,1,1,20,20,1,1,13,1,1,1,9,1,1,1,20,13,1,1,1,1,9,1,1099511627808,0,0,0,0,0,1,0,0,0,0,0,0,0,0,0,0,0,0,0,0,0,0,0,0,0,0,0,0,0,0,0,0,0,0,0,0,0,0,0,0,1,0,0,0,0,0,0,0
29/6/2010,Mickaël Nelson,34008681,769,2/2/1990,20,0,0,0,0,50,3500,3500,132,107,654536,184,76,D C,2,3,2,3,1,2,2,3,1,1,2,5,10,7,6,8,6,14,7,7,12,9,6,11,8,10,12,13,13,13,8,12,14,7,12,7,13,15,13,13,9,14,12,5,15,11,20,14,14,13,10,15,5,8,7,13,14,13,15,15,15,6,D C,101,1,1,20,20,1,1,1,1,14,1,14,1,1,1,20,1,14,1,1,1,1,14,0,0,0,0,0,0,0,0,0,0,0,0,0,0,0,0,0,0,0,0,0,0,0,0,0,0,0,0,0,0,0,0,0,0,0,0,0,0,0,0,0,0,0,0,0,0,0,0,0
29/6/2010,Michele Contini,43026372,776,3/27/1991,19,0,0,0,0,50,400,400,105,35,1552,192,88,D RLC,1,1,1,1,1,2,2,1,3,2,3,1,3,6,2,4,0,8,2,8,4,2,2,10,2,17,7,5,3,7,2,9,6,4,11,2,11,10,9,12,12,11,12,6,14,12,20,5,5,7,10,10,13,10,8,2,13,13,15,9,7,16,D RLC,106,1,1,20,20,1,1,20,1,20,1,9,1,1,1,20,20,20,1,1,1,6,9,0,0,0,0,0,0,0,0,0,0,0,0,0,0,0,0,0,0,0,0,0,0,0,0,0,0,0,0,0,0,0,0,0,0,0,0,0,0,0,0,0,0,0,0,0,0,0,0,0
29/6/2010,Michele Canini,7982713,776,6/5/1985,25,0,0,9,0,2500,6400,6400,144,129,2904281,187,78,D C,3,3,2,1,3,1,1,2,1,2,3,4,7,5,8,7,5,15,5,7,15,9,3,15,10,14,13,13,12,10,8,9,14,4,10,4,15,14,13,13,12,16,15,9,14,13,20,15,15,12,7,10,11,14,10,11,12,12,12,12,10,6,D C,101,1,1,20,20,1,1,5,1,12,1,10,1,1,1,20,5,12,1,1,1,1,10,4294967296,0,0,0,0,0,0,0,0,0,0,0,0,0,0,0,0,0,0,0,0,0,0,0,0,0,0,0,0,0,0,0,0,1,0,0,0,0,0,0,0,0,0,0,0,0,0,0,0
29/6/2010,Michael Turner,135160,765,11/9/1983,26,0,0,0,0,4850,7050,7050,145,144,21838158,193,79,D C,3,2,2,1,2,2,1,1,1,2,1,2,6,7,11,12,4,18,8,10,16,7,12,17,13,13,15,15,12,13,9,13,17,4,12,9,14,17,15,10,10,13,16,9,14,12,20,16,13,15,14,17,3,10,8,12,13,17,15,8,14,2,D C,101,4,1,20,20,1,1,1,1,1,1,1,1,1,1,20,1,1,1,1,1,1,1,4503599627370496,0,0,0,0,0,0,0,0,0,0,0,0,0,0,0,0,0,0,0,0,0,0,0,0,0,0,0,0,0,0,0,0,0,0,0,0,0,0,0,0,0,0,0,0,0,0,0,0
29/6/2010,Michael Mancienne,5006675,765,1/8/1988,22,0,0,21,1,3969,6000,6000,160,126,3027181,184,80,D RC,2,3,1,3,1,1,2,1,1,1,3,1,8,12,6,13,3,13,6,8,14,11,4,13,12,10,14,10,14,11,9,12,13,8,10,8,14,12,11,14,14,12,13,10,15,15,20,14,10,14,8,14,8,8,14,17,15,14,15,14,13,7,D RC,103,1,1,20,20,15,1,10,15,15,10,1,1,1,1,20,10,15,15,1,1,1,1,32832,0,0,0,0,0,0,1,0,0,0,0,0,0,0,0,1,0,0,0,0,0,0,0,0,0,0,0,0,0,0,0,0,0,0,0,0,0,0,0,0,0,0,0,0,0,0,0,0
29/6/2010,Michael Kammermeyer,35021010,771,1/14/1986,24,0,0,0,0,1000,4900,4900,120,103,151993,180,77,D C,2,2,1,3,3,1,3,6,2,1,1,3,3,2,3,8,2,9,7,5,13,9,5,13,9,8,11,14,10,13,6,13,10,7,13,3,13,10,13,13,11,10,11,6,14,13,20,13,9,10,13,10,6,10,13,20,6,9,8,16,13,6,D C,101,1,1,20,20,14,1,1,1,1,1,1,1,1,1,20,1,1,1,1,1,1,1,0,0,0,0,0,0,0,0,0,0,0,0,0,0,0,0,0,0,0,0,0,0,0,0,0,0,0,0,0,0,0,0,0,0,0,0,0,0,0,0,0,0,0,0,0,0,0,0,0
29/6/2010,Michael Jakobsen,929776,764,1/2/1986,24,5,0,31,4,3721,6250,6250,135,122,1766975,185,81,D LC,1,1,3,2,3,2,3,2,3,1,3,13,9,11,4,10,13,12,6,9,14,9,17,15,10,13,14,15,13,14,9,12,14,10,15,10,14,15,14,11,9,13,13,20,14,12,4,13,13,11,5,16,8,13,13,14,17,14,12,16,13,3,D LC,104,1,1,20,20,10,1,18,1,1,1,12,1,1,1,20,18,1,1,1,1,12,1,0,0,0,0,0,0,0,0,0,0,0,0,0,0,0,0,0,0,0,0,0,0,0,0,0,0,0,0,0,0,0,0,0,0,0,0,0,0,0,0,0,0,0,0,0,0,0,0,0
29/6/2010,Michael Dawson,142537,765,11/18/1983,26,0,0,13,0,5600,7100,7100,157,151,15110760,192,85,D C,1,2,2,1,1,1,1,8,2,1,1,2,4,4,4,9,4,17,4,7,14,11,5,15,9,14,15,18,12,14,10,14,17,4,14,6,15,17,18,11,12,15,17,12,14,12,20,16,15,16,6,14,8,7,12,15,16,12,14,14,14,5,D C,101,1,1,20,20,1,1,1,1,1,1,1,1,1,1,20,1,1,1,1,1,1,1,8933531975680,0,0,0,0,0,0,0,0,0,0,0,0,0,0,0,0,0,0,0,0,0,0,0,0,0,0,0,0,0,0,0,0,0,0,0,0,0,1,0,0,0,0,0,1,0,0,0,0
29/6/2010,Michaël Ciani,8156266,769,4/6/1984,26,1,0,5,0,5476,6659,6650,160,148,42223284,189,88,D C,2,3,2,3,1,1,2,3,1,2,1,5,11,8,7,10,8,17,7,7,16,8,8,14,10,14,15,16,12,12,7,14,15,6,11,7,14,14,15,15,10,18,14,5,16,13,20,17,18,14,10,13,6,6,8,15,13,10,15,13,12,7,D C,101,5,1,20,20,1,1,10,1,10,1,1,1,1,1,20,10,10,1,1,1,1,1,32800,0,0,0,0,0,1,0,0,0,0,0,0,0,0,0,1,0,0,0,0,0,0,0,0,0,0,0,0,0,0,0,0,0,0,0,0,0,0,0,0,0,0,0,0,0,0,0,0
29/6/2010,Michaël Chrétien,916312,34,7/10/1984,25,23,0,0,0,4830,6950,6250,150,139,4714799,179,69,D/WB RC,1,3,3,3,3,3,1,9,3,3,2,13,13,11,7,12,12,11,7,14,12,10,11,13,12,11,15,14,13,13,12,14,14,8,13,10,14,14,13,15,12,14,9,10,11,14,20,15,11,15,11,14,15,10,9,15,13,14,16,14,16,5,D/WB RC,113,1,1,16,20,12,1,10,12,20,1,18,1,1,1,16,10,20,10,8,12,10,18,274877906976,0,0,0,0,0,1,0,0,0,0,0,0,0,0,0,0,0,0,0,0,0,0,0,0,0,0,0,0,0,0,0,0,0,0,0,0,0,0,1,0,0,0,0,0,0,0,0,0
29/6/2010,Micah Richards,5005673,765,6/24/1988,22,11,1,14,3,4692,7150,7150,152,137,29235593,181,83,D RC,2,3,3,3,1,1,2,6,1,3,3,3,6,8,7,8,5,15,4,15,14,7,6,15,7,15,10,19,9,12,6,12,11,4,11,7,8,17,17,19,13,9,14,8,17,18,20,19,18,10,8,12,6,16,17,16,18,14,10,13,11,8,D RC,103,5,1,18,20,10,1,5,10,20,1,12,1,1,1,18,5,20,10,1,1,1,12,32808,0,0,0,1,0,1,0,0,0,0,0,0,0,0,0,1,0,0,0,0,0,0,0,0,0,0,0,0,0,0,0,0,0,0,0,0,0,0,0,0,0,0,0,0,0,0,0,0
29/6/2010,Mexer,12013851,35,9/8/1987,22,6,0,0,0,2500,5885,5250,130,107,599999,181,75,D C,2,3,1,3,3,2,3,1,3,3,3,5,8,5,4,14,3,14,10,4,14,12,4,14,10,7,14,8,9,11,4,12,13,7,8,9,12,6,10,14,14,14,9,8,14,14,20,6,6,9,15,9,8,10,10,13,14,13,14,13,13,4,D C,101,1,1,20,20,10,1,1,7,7,1,1,1,1,1,20,1,7,7,1,1,1,1,0,0,0,0,0,0,0,0,0,0,0,0,0,0,0,0,0,0,0,0,0,0,0,0,0,0,0,0,0,0,0,0,0,0,0,0,0,0,0,0,0,0,0,0,0,0,0,0,0
29/6/2010,Mehmet Topal,470897,799,3/3/1986,24,16,0,13,1,4900,6900,6900,155,140,20699998,187,76,DM C,3,3,3,2,1,1,3,2,2,3,2,3,10,10,5,12,7,10,13,6,12,14,10,16,12,13,13,12,10,13,7,11,12,9,7,6,14,17,14,11,13,15,15,18,13,15,20,17,13,14,9,17,15,12,9,16,15,10,14,14,15,4,DM C,301,1,1,20,15,20,1,1,15,10,1,1,1,1,1,15,1,1,15,1,10,1,1,140737488356096,0,0,0,0,0,0,0,0,1,1,0,0,0,0,0,0,0,0,0,0,0,0,0,0,0,0,0,0,0,0,0,0,0,0,0,0,0,0,0,0,0,0,0,0,0,0,0,1
29/6/2010,Medhi Benatia,8443128,34,4/17/1987,23,6,0,0,0,2600,6150,4050,150,123,30853893,190,80,D RC,1,3,3,3,2,2,2,1,2,1,3,5,8,8,6,11,7,14,9,7,16,10,7,12,11,12,14,15,13,12,10,12,14,8,12,7,13,13,14,13,8,16,15,8,13,10,20,15,16,14,12,16,11,8,14,17,8,13,14,14,11,12,D RC,103,1,1,20,20,15,1,1,15,16,14,12,1,1,1,20,1,16,15,1,1,1,12,0,0,0,0,0,0,0,0,0,0,0,0,0,0,0,0,0,0,0,0,0,0,0,0,0,0,0,0,0,0,0,0,0,0,0,0,0,0,0,0,0,0,0,0,0,0,0,0,0
29/6/2010,Maynor Figueroa,8827564,376,5/2/1983,27,72,2,0,0,4356,6850,6850,146,132,12065809,181,85,D LC,3,3,1,2,2,1,2,5,1,3,1,8,11,12,10,12,8,14,13,16,16,12,10,12,11,13,12,12,12,13,12,12,13,8,13,12,10,14,13,12,11,12,11,20,16,14,12,14,14,13,10,12,3,10,14,15,10,13,14,7,7,13,D LC,104,1,1,17,20,1,1,20,1,1,1,7,1,1,1,17,20,12,1,1,1,6,1,768,0,0,0,0,0,0,0,0,1,1,0,0,0,0,0,0,0,0,0,0,0,0,0,0,0,0,0,0,0,0,0,0,0,0,0,0,0,0,0,0,0,0,0,0,0,0,0,0
29/6/2010,Maximiliano Pellegrino,6300148,1649,1/26/1980,30,0,0,0,0,3481,5500,5850,124,118,186109,189,80,D C,2,1,1,2,3,1,2,1,2,3,3,9,6,8,7,8,7,16,7,13,16,11,9,13,10,16,11,10,5,13,8,11,16,6,11,7,13,13,15,9,11,13,16,7,12,10,20,10,14,13,5,12,12,5,14,12,16,11,17,17,18,1,D C,101,1,1,20,20,1,1,1,1,1,10,1,1,1,1,20,1,1,1,1,1,1,1,0,0,0,0,0,0,0,0,0,0,0,0,0,0,0,0,0,0,0,0,0,0,0,0,0,0,0,0,0,0,0,0,0,0,0,0,0,0,0,0,0,0,0,0,0,0,0,0,0
29/6/2010,Maxime Josse,8428698,769,3/21/1987,23,0,0,3,0,3249,5100,5100,130,114,2340719,184,82,D RC,1,1,2,1,1,1,3,7,2,1,1,5,9,8,5,9,11,15,8,10,13,7,7,14,9,12,13,14,11,11,6,10,14,5,11,7,11,12,15,14,9,15,12,8,12,13,20,15,15,14,12,12,8,8,9,13,14,10,16,15,15,6,D RC,103,1,1,20,20,1,1,1,8,16,1,14,1,1,1,20,1,16,1,1,8,1,14,0,0,0,0,0,0,0,0,0,0,0,0,0,0,0,0,0,0,0,0,0,0,0,0,0,0,0,0,0,0,0,0,0,0,0,0,0,0,0,0,0,0,0,0,0,0,0,0,0
29/6/2010,Mauro Cetto,950976,1649,4/14/1982,28,0,0,0,0,2850,6389,6350,145,142,6167465,182,78,D C,3,1,2,3,3,2,2,1,2,3,1,5,7,8,8,11,7,17,7,10,15,10,8,15,11,16,15,17,14,14,7,13,15,7,16,8,15,16,16,13,10,15,11,9,13,11,20,14,15,16,16,14,11,6,9,14,15,14,14,13,13,10,D C,101,1,1,20,20,1,1,1,1,13,1,1,1,1,1,20,1,13,1,1,1,1,1,131104,0,0,0,0,0,1,0,0,0,0,0,0,0,0,0,0,0,1,0,0,0,0,0,0,0,0,0,0,0,0,0,0,0,0,0,0,0,0,0,0,0,0,0,0,0,0,0,0
29/6/2010,Maurizio Lauro,3802302,776,3/12/1981,29,0,0,0,0,1250,5250,5250,111,110,826840,180,73,D/WB LC,1,1,2,1,3,1,1,4,3,3,1,7,10,8,6,6,6,13,6,7,15,10,6,14,8,17,16,16,14,13,6,12,13,6,11,8,12,12,10,13,10,12,10,20,14,9,8,13,11,16,14,16,3,8,11,16,16,13,14,14,14,3,D/WB LC,114,1,1,20,20,1,1,18,1,1,1,16,1,1,1,20,18,1,1,1,1,16,1,0,0,0,0,0,0,0,0,0,0,0,0,0,0,0,0,0,0,0,0,0,0,0,0,0,0,0,0,0,0,0,0,0,0,0,0,0,0,0,0,0,0,0,0,0,0,0,0,0
29/6/2010,Maurizio Lanzaro,3801610,776,3/14/1982,28,0,0,4,0,3000,5000,5550,118,115,1318683,183,80,D RC,1,1,1,1,1,1,1,1,1,1,1,4,9,4,5,8,4,16,6,12,13,10,6,14,10,13,12,11,11,10,5,13,18,11,7,11,13,10,12,11,12,14,13,8,11,12,20,13,15,9,18,13,11,13,3,16,17,12,18,15,15,1,D RC,103,1,1,20,20,1,1,1,1,18,5,1,1,1,1,20,1,18,1,1,1,1,1,1103806627840,0,0,0,0,0,0,0,0,0,0,0,0,0,0,0,1,0,0,0,0,0,0,0,0,0,0,0,0,0,0,0,0,1,0,0,0,0,0,0,0,1,0,0,0,0,0,0,0
29/6/2010,Maurizio Domizzi,830081,776,6/28/1980,30,0,0,1,0,3900,6600,6600,132,128,6185890,187,80,D LC,1,2,3,3,2,3,3,1,2,3,3,6,9,10,9,12,12,15,12,11,14,14,16,16,13,15,14,15,11,10,9,11,17,7,14,14,12,12,14,10,8,14,15,20,15,12,9,14,16,14,14,13,11,15,15,15,14,15,16,14,15,11,D LC,104,1,1,20,20,10,1,15,1,1,1,12,1,1,1,20,15,1,1,1,1,12,1,131072,0,0,0,0,0,0,0,0,0,0,0,0,0,0,0,0,0,1,0,0,0,0,0,0,0,0,0,0,0,0,0,0,0,0,0,0,0,0,0,0,0,0,0,0,0,0,0,0
29/6/2010,Maurício,304532,1651,7/5/1976,33,0,0,0,0,2750,5250,5300,107,106,213644,192,89,D C,1,1,1,3,1,1,2,1,3,2,3,5,7,7,10,8,15,14,11,9,12,9,11,10,9,16,12,16,10,12,9,10,12,6,14,8,11,13,12,8,7,15,13,8,15,8,20,13,16,13,13,12,11,8,10,11,13,12,12,13,12,2,D C,101,1,1,20,20,1,1,1,1,1,10,1,1,1,1,20,1,1,1,1,1,1,1,68719477504,0,0,0,0,0,0,0,0,1,1,0,0,0,0,0,0,0,0,0,0,0,0,0,0,0,0,0,0,0,0,0,0,0,0,0,0,1,0,0,0,0,0,0,0,0,0,0,0
29/6/2010,Matthias Jaissle,35015818,771,4/5/1988,22,0,0,1,0,3400,6800,6800,148,126,1920346,186,83,D LC,1,3,3,2,1,1,1,1,1,1,1,5,7,6,7,12,6,11,6,10,14,8,7,14,12,9,16,9,16,14,9,10,12,5,10,7,15,15,10,14,11,13,16,8,13,14,20,12,13,12,5,12,7,13,13,13,12,10,15,14,16,6,D LC,104,1,1,20,20,12,1,15,1,12,1,1,1,1,1,20,15,12,1,1,1,1,1,0,0,0,0,0,0,0,0,0,0,0,0,0,0,0,0,0,0,0,0,0,0,0,0,0,0,0,0,0,0,0,0,0,0,0,0,0,0,0,0,0,0,0,0,0,0,0,0,0
29/6/2010,Matthew Upson,2005781,765,4/18/1979,31,21,2,12,2,5112,7300,7300,150,143,5290993,185,72,D C,1,1,3,1,1,3,1,4,2,3,3,6,5,5,3,12,6,16,4,3,13,13,6,16,13,8,14,13,13,14,10,14,14,4,16,6,16,14,13,13,12,12,14,20,12,13,9,14,14,14,8,16,8,4,12,16,10,13,16,14,13,5,D C,101,1,1,20,20,1,1,14,1,1,1,1,1,1,1,20,14,1,1,1,1,1,1,274877906944,0,0,0,0,0,0,0,0,0,0,0,0,0,0,0,0,0,0,0,0,0,0,0,0,0,0,0,0,0,0,0,0,0,0,0,0,0,0,1,0,0,0,0,0,0,0,0,0
29/6/2010,Matteo Contini,3801540,776,4/16/1980,30,0,0,0,0,3750,6700,6700,140,139,7996955,184,76,D C,1,2,2,3,3,2,2,1,3,3,1,4,6,8,6,10,8,15,9,12,16,11,8,15,10,16,14,18,13,16,7,13,14,6,13,6,16,15,16,10,11,15,11,20,14,12,8,15,13,17,17,17,8,8,12,14,6,12,12,10,6,14,D C,101,1,1,20,20,5,1,11,1,1,10,3,1,1,1,20,11,1,1,1,1,3,1,32768,0,0,0,0,0,0,0,0,0,0,0,0,0,0,0,1,0,0,0,0,0,0,0,0,0,0,0,0,0,0,0,0,0,0,0,0,0,0,0,0,0,0,0,0,0,0,0,0
29/6/2010,Mats Hummels,35007944,771,12/16/1988,21,1,0,20,5,4500,7350,7350,172,147,24462238,192,88,D C,1,1,3,2,3,3,3,2,3,2,3,4,7,9,10,13,5,14,6,11,16,11,8,17,12,15,14,16,17,14,12,14,13,8,13,12,15,17,14,9,14,12,16,13,15,12,20,14,14,11,8,10,14,15,15,14,12,13,14,12,12,8,D C,101,1,1,20,20,15,1,1,15,12,1,1,1,1,1,20,1,12,15,1,1,1,1,137438953472,0,0,0,0,0,0,0,0,0,0,0,0,0,0,0,0,0,0,0,0,0,0,0,0,0,0,0,0,0,0,0,0,0,0,0,0,0,1,0,0,0,0,0,0,0,0,0,0
29/6/2010,Matías Silvestre,955977,1649,9/25/1984,25,0,0,0,0,4250,6250,6700,150,133,6954136,184,74,D C,1,1,1,1,1,1,1,1,1,1,1,5,8,7,8,9,5,17,7,12,16,12,9,15,10,13,14,13,12,12,10,12,16,5,14,7,15,13,13,13,14,14,12,5,16,14,20,14,13,14,10,15,4,12,15,14,15,16,16,14,14,7,D C,101,1,1,20,20,1,1,1,1,13,1,1,1,1,1,20,1,13,1,1,1,1,1,4295000064,0,0,0,0,0,0,0,0,0,0,0,0,0,0,0,1,0,0,0,0,0,0,0,0,0,0,0,0,0,0,0,0,1,0,0,0,0,0,0,0,0,0,0,0,0,0,0,0
29/6/2010,Mathieu Peybernes,34009939,769,10/21/1990,19,0,0,0,0,900,4500,4500,150,100,1314281,184,80,D C,1,1,2,1,3,3,1,3,1,3,1,5,6,9,4,8,4,14,10,5,11,7,2,10,8,10,14,12,12,12,7,11,11,5,9,5,13,14,16,9,9,14,12,8,10,11,20,14,14,14,10,10,6,10,13,6,11,14,9,5,8,8,D C,101,1,1,20,20,1,1,10,1,13,1,1,1,1,1,20,10,13,1,1,1,1,1,0,0,0,0,0,0,0,0,0,0,0,0,0,0,0,0,0,0,0,0,0,0,0,0,0,0,0,0,0,0,0,0,0,0,0,0,0,0,0,0,0,0,0,0,0,0,0,0,0
29/6/2010,Mathieu Delpierre,911593,769,4/26/1981,29,0,0,15,0,5000,6704,7500,152,149,22371232,193,86,D C,3,2,1,2,2,1,1,4,3,2,3,4,5,10,4,13,6,12,5,8,14,10,6,14,13,12,17,13,15,17,9,14,12,4,12,3,16,16,13,11,10,16,17,8,14,15,20,13,17,16,6,15,12,8,12,11,14,17,14,17,18,2,D C,101,1,1,20,20,1,1,1,1,10,1,1,1,1,1,20,1,10,1,1,1,1,1,0,0,0,0,0,0,0,0,0,0,0,0,0,0,0,0,0,0,0,0,0,0,0,0,0,0,0,0,0,0,0,0,0,0,0,0,0,0,0,0,0,0,0,0,0,0,0,0,0
29/6/2010,Mathias Abel,889227,771,6/22/1981,29,0,0,1,0,2750,5750,5750,133,115,1635323,188,82,D RC,3,3,3,2,3,3,3,3,3,1,2,7,8,9,10,11,8,13,10,15,13,11,8,15,10,13,12,13,12,12,9,11,13,12,14,9,14,14,14,14,11,12,16,6,15,12,20,11,12,12,9,12,18,15,14,15,14,13,16,18,8,13,D RC,103,1,1,17,20,10,1,1,1,20,1,14,1,1,1,17,9,20,1,1,1,1,14,2,0,1,0,0,0,0,0,0,0,0,0,0,0,0,0,0,0,0,0,0,0,0,0,0,0,0,0,0,0,0,0,0,0,0,0,0,0,0,0,0,0,0,0,0,0,0,0,0
29/6/2010,Mateo Musacchio,14000745,1649,8/26/1990,19,0,0,3,0,4489,6700,6700,154,134,24194402,180,73,D C,1,1,2,2,1,3,3,4,2,3,2,5,8,11,6,11,4,14,6,10,14,12,10,16,12,17,17,13,12,14,11,12,10,8,11,6,15,14,14,14,13,12,11,6,14,15,20,16,10,15,14,12,6,12,14,9,12,5,9,1,6,12,D C,101,1,1,20,20,10,1,1,1,12,15,1,1,1,1,20,1,12,1,1,1,1,1,0,0,0,0,0,0,0,0,0,0,0,0,0,0,0,0,0,0,0,0,0,0,0,0,0,0,0,0,0,0,0,0,0,0,0,0,0,0,0,0,0,0,0,0,0,0,0,0,0
29/6/2010,Massimo Volta,1410287,776,5/14/1987,23,0,0,0,0,2000,5300,5300,140,129,1092854,184,70,D C,2,3,2,1,1,2,1,3,3,2,1,5,6,5,3,8,4,17,5,5,16,14,5,15,9,13,15,16,17,15,7,12,19,9,11,8,13,10,5,13,12,10,12,20,13,12,5,14,14,15,7,13,4,7,13,14,9,14,12,16,18,6,D C,101,1,1,20,20,1,1,13,1,1,20,1,1,1,1,20,13,1,1,1,1,1,1,0,0,0,0,0,0,0,0,0,0,0,0,0,0,0,0,0,0,0,0,0,0,0,0,0,0,0,0,0,0,0,0,0,0,0,0,0,0,0,0,0,0,0,0,0,0,0,0,0
29/6/2010,Massimo Paci,3801507,776,5/9/1978,32,0,0,0,0,3250,6100,6100,127,126,1527252,190,88,D C,1,1,1,1,1,1,1,1,1,1,1,5,3,7,6,4,2,17,4,6,16,10,5,16,8,13,14,13,15,9,8,13,10,6,11,7,15,15,13,10,9,13,17,5,8,13,20,12,17,10,8,9,16,8,13,11,14,5,14,7,7,13,D C,101,1,1,20,20,1,1,1,1,14,1,1,1,1,1,20,1,14,1,1,1,1,1,8589934592,0,0,0,0,0,0,0,0,0,0,0,0,0,0,0,0,0,0,0,0,0,0,0,0,0,0,0,0,0,0,0,0,0,1,0,0,0,0,0,0,0,0,0,0,0,0,0,0
29/6/2010,Marvin Compper,893402,771,6/14/1985,25,1,0,0,0,3500,7100,7100,152,139,5751212,185,77,D LC,2,1,2,1,1,1,1,1,3,3,1,6,11,8,3,12,4,9,5,14,12,11,5,14,13,11,16,11,10,9,10,15,14,7,14,8,12,17,14,16,15,14,14,20,15,17,14,14,12,13,7,12,9,13,12,13,13,13,12,14,15,9,D LC,104,1,1,20,20,10,1,19,1,1,1,14,1,1,1,20,19,1,1,1,1,14,1,8800387989512,0,0,0,1,0,0,0,0,0,0,0,0,0,0,0,0,0,0,0,0,0,0,0,0,0,0,0,0,0,0,0,0,1,0,0,0,0,0,0,0,0,0,0,1,0,0,0,0
29/6/2010,Martin Skrtel,7561265,794,12/15/1984,25,43,5,13,0,5476,7750,7750,162,148,151878499,191,81,D C,3,1,2,3,2,1,1,2,3,1,1,7,9,7,4,12,1,16,7,5,14,12,2,18,12,16,14,12,13,14,10,12,16,7,6,11,14,14,13,12,14,14,15,10,15,14,20,16,16,9,12,13,15,11,16,15,15,14,14,16,12,10,D C,101,1,1,20,20,1,1,1,1,5,1,1,1,1,1,20,1,5,1,1,1,1,1,137438953472,0,0,0,0,0,0,0,0,0,0,0,0,0,0,0,0,0,0,0,0,0,0,0,0,0,0,0,0,0,0,0,0,0,0,0,0,0,1,0,0,0,0,0,0,0,0,0,0
29/6/2010,Martin Petras,5640419,794,11/2/1979,30,39,1,0,0,2756,5750,5200,114,105,995624,186,82,D RC,3,3,1,1,2,1,1,1,1,2,3,8,11,8,12,9,8,16,6,9,14,13,10,13,8,13,13,13,13,9,9,13,15,6,9,11,10,15,11,10,9,12,13,9,11,9,20,13,13,13,14,10,10,10,14,15,13,14,13,11,8,9,D RC,103,1,1,20,20,1,1,13,1,17,1,1,1,1,1,20,13,17,1,1,1,1,1,33024,0,0,0,0,0,0,0,0,1,0,0,0,0,0,0,1,0,0,0,0,0,0,0,0,0,0,0,0,0,0,0,0,0,0,0,0,0,0,0,0,0,0,0,0,0,0,0,0
29/6/2010,Martin Jiranek,132959,763,5/25/1979,31,31,0,20,4,4096,6750,5500,150,128,2699066,190,91,D RC,2,3,1,3,2,3,3,3,3,1,3,5,9,10,7,13,5,16,9,15,12,11,10,15,11,15,10,14,14,13,10,11,12,9,14,8,12,14,12,12,13,15,15,5,12,13,20,15,16,12,9,14,4,11,17,14,15,14,12,14,15,10,D RC,103,1,1,20,20,1,1,6,1,15,1,12,1,1,1,20,6,15,1,1,1,1,12,1099511627840,0,0,0,0,0,0,1,0,0,0,0,0,0,0,0,0,0,0,0,0,0,0,0,0,0,0,0,0,0,0,0,0,0,0,0,0,0,0,0,0,1,0,0,0,0,0,0,0
29/6/2010,Martín Demichelis,952826,1649,12/20/1980,29,30,2,0,0,5625,8150,7500,170,150,99699478,184,78,D C,3,1,1,3,3,1,2,2,2,2,2,6,6,10,9,11,4,17,5,6,19,12,11,17,13,18,16,18,16,7,11,12,14,7,13,9,15,15,15,12,12,15,15,12,15,13,20,16,12,9,16,12,9,17,14,16,15,9,16,15,11,17,D C,101,1,1,20,20,11,1,1,2,1,6,1,1,1,1,20,1,1,2,1,1,1,1,98304,0,0,0,0,0,0,0,0,0,0,0,0,0,0,0,1,1,0,0,0,0,0,0,0,0,0,0,0,0,0,0,0,0,0,0,0,0,0,0,0,0,0,0,0,0,0,0,0
29/6/2010,Martín Cáceres,78010878,1657,4/7/1987,23,20,0,11,0,5000,7550,7100,160,145,4986821,182,77,D C,2,1,3,1,1,3,1,1,3,1,1,6,9,8,8,11,5,14,9,14,14,11,7,15,12,16,13,14,11,14,8,12,12,7,13,9,12,14,15,15,14,15,12,12,13,15,20,15,14,13,9,14,16,16,16,12,12,10,14,13,12,5,D C,101,1,1,20,20,1,1,13,6,13,16,13,1,1,1,20,13,10,1,1,6,1,13,137438953472,0,0,0,0,0,0,0,0,0,0,0,0,0,0,0,0,0,0,0,0,0,0,0,0,0,0,0,0,0,0,0,0,0,0,0,0,0,1,0,0,0,0,0,0,0,0,0,0
29/6/2010,Martin Amedick,884718,771,9/6/1982,27,0,0,0,0,1500,6900,6900,143,138,5748731,194,85,D C,1,1,2,1,3,1,3,7,3,1,1,4,6,7,12,12,5,17,6,11,16,11,8,17,9,8,12,13,9,14,5,13,15,5,15,11,16,13,12,8,9,12,16,6,14,10,20,13,15,14,6,13,5,1,12,16,13,15,16,16,13,9,D C,101,1,1,20,20,1,1,1,1,10,1,1,1,1,1,20,1,10,1,1,1,1,1,0,0,0,0,0,0,0,0,0,0,0,0,0,0,0,0,0,0,0,0,0,0,0,0,0,0,0,0,0,0,0,0,0,0,0,0,0,0,0,0,0,0,0,0,0,0,0,0,0
29/6/2010,Martí Crespí,67006016,796,6/15/1987,23,0,0,0,0,3250,5050,5050,139,117,623387,180,71,D C,3,1,3,1,1,2,1,5,2,3,1,5,4,6,7,7,14,13,14,9,14,11,7,14,9,14,14,13,13,13,6,14,8,5,11,7,13,12,11,12,7,13,11,7,11,14,20,16,13,14,14,12,8,15,13,14,12,6,10,16,10,1,D C,101,1,1,20,20,10,1,2,1,7,8,1,1,1,1,20,2,7,1,1,1,1,1,8796093022720,0,0,0,0,0,0,0,0,0,1,0,0,0,0,0,0,0,0,0,0,0,0,0,0,0,0,0,0,0,0,0,0,0,0,0,0,0,0,0,0,0,0,0,1,0,0,0,0
29/6/2010,Markus Thorandt,890557,771,4/1/1981,29,0,0,0,0,2750,5900,5900,118,118,2330136,186,82,D RC,3,1,1,3,2,3,3,1,2,1,1,8,12,8,7,11,6,14,9,12,12,10,8,13,11,12,12,14,9,10,8,13,12,6,12,9,13,14,13,12,10,14,14,8,15,13,20,14,15,14,5,10,5,13,8,11,12,11,13,14,8,5,D RC,103,1,1,20,20,10,1,8,12,18,1,14,1,1,1,20,8,18,5,1,12,6,14,2,0,1,0,0,0,0,0,0,0,0,0,0,0,0,0,0,0,0,0,0,0,0,0,0,0,0,0,0,0,0,0,0,0,0,0,0,0,0,0,0,0,0,0,0,0,0,0,0
29/6/2010,Markus Berger,8708085,755,1/21/1985,25,0,0,33,0,2000,5000,5000,112,106,162037,183,75,D RC,2,3,2,3,1,2,1,1,3,3,1,7,7,8,8,9,7,14,9,10,12,9,10,12,10,13,11,11,15,15,8,11,12,6,9,8,12,13,11,11,10,13,14,4,13,10,20,12,13,11,8,10,7,13,9,12,9,10,13,13,12,10,D RC,103,1,1,20,20,12,1,8,1,15,1,5,1,1,1,20,8,15,1,1,1,1,5,0,0,0,0,0,0,0,0,0,0,0,0,0,0,0,0,0,0,0,0,0,0,0,0,0,0,0,0,0,0,0,0,0,0,0,0,0,0,0,0,0,0,0,0,0,0,0,0,0
29/6/2010,Marius Stankevicius,139029,779,7/15/1981,28,49,4,0,0,4556,6750,6750,144,135,2145466,190,83,D/WB RC,2,3,2,3,3,2,2,3,2,2,3,7,7,5,5,10,15,13,9,20,14,11,8,14,8,12,11,13,13,12,12,12,10,5,11,12,14,13,14,14,12,15,14,13,12,13,20,19,11,12,9,10,10,15,12,17,5,5,9,2,5,2,D/WB RC,113,1,1,15,20,1,1,1,15,20,1,20,1,1,1,15,13,20,1,1,15,1,20,0,0,0,0,0,0,0,0,0,0,0,0,0,0,0,0,0,0,0,0,0,0,0,0,0,0,0,0,0,0,0,0,0,0,0,0,0,0,0,0,0,0,0,0,0,0,0,0,0
29/6/2010,Mario,813641,796,2/2/1982,28,0,0,3,0,4489,6250,6250,145,134,2454399,178,75,D C,2,3,2,2,2,3,1,2,3,1,1,4,9,7,5,11,3,15,4,12,13,10,7,14,7,15,15,16,12,12,5,14,15,6,12,8,14,15,13,12,15,15,11,8,12,12,20,17,15,14,13,13,16,13,8,13,12,12,10,15,14,9,D C,101,1,1,20,20,10,1,10,1,5,10,1,1,1,1,20,10,5,1,1,1,1,1,4295000064,0,0,0,0,0,0,0,0,0,0,0,0,0,0,0,1,0,0,0,0,0,0,0,0,0,0,0,0,0,0,0,0,1,0,0,0,0,0,0,0,0,0,0,0,0,0,0,0
29/6/2010,Mario Yepes,120931,1653,1/13/1976,34,56,4,0,0,4761,6900,6900,155,138,2565094,186,83,D C,2,1,2,2,2,3,1,5,2,2,1,6,9,8,10,9,6,17,7,10,17,13,10,16,9,17,15,17,14,14,7,13,17,6,15,8,14,15,16,10,11,17,12,20,14,8,7,14,16,14,15,15,9,9,12,14,15,14,15,10,12,8,D C,101,1,1,20,20,1,1,1,1,1,12,1,1,1,1,20,1,1,1,1,1,1,1,137439084576,0,0,0,0,0,1,0,0,0,0,0,0,0,0,0,0,0,1,0,0,0,0,0,0,0,0,0,0,0,0,0,0,0,0,0,0,0,1,0,0,0,0,0,0,0,0,0,0
29/6/2010,Mario Eggimann,7283,798,1/24/1981,29,9,0,0,0,3750,6500,6350,128,127,3190708,190,84,D LC,3,2,2,1,3,3,1,7,3,3,2,6,7,7,10,10,6,15,11,11,14,9,8,15,11,12,14,12,14,9,6,12,14,3,16,7,13,14,14,9,12,15,16,20,13,10,12,14,16,9,7,13,3,8,13,16,12,16,8,11,16,7,D LC,104,1,1,20,20,1,1,15,1,1,1,1,1,1,1,20,15,1,1,1,1,1,1,562949953421312,0,0,0,0,0,0,0,0,0,0,0,0,0,0,0,0,0,0,0,0,0,0,0,0,0,0,0,0,0,0,0,0,0,0,0,0,0,0,0,0,0,0,0,0,0,0,0,0
29/6/2010,Marcos Angeleri,955253,1649,8/30/1982,27,3,0,0,0,4761,7000,6400,139,138,19280853,182,68,D/WB RC,3,2,2,3,1,2,2,6,3,1,3,9,13,11,4,8,4,11,9,15,15,12,9,14,11,13,14,14,12,14,10,14,15,8,10,4,16,14,15,14,14,13,12,5,12,17,20,13,13,13,13,16,6,15,6,16,16,16,14,14,13,8,D/WB RC,113,1,1,15,20,1,1,1,1,20,16,17,1,1,1,15,11,20,1,1,1,1,17,34,0,1,0,0,0,1,0,0,0,0,0,0,0,0,0,0,0,0,0,0,0,0,0,0,0,0,0,0,0,0,0,0,0,0,0,0,0,0,0,0,0,0,0,0,0,0,0,0
29/6/2010,Marco Torsiglieri,14003065,1649,1/12/1988,22,0,0,1,0,1750,5000,5500,140,122,8400000,190,77,D C,1,1,3,1,1,3,2,3,3,2,2,5,10,10,6,10,5,14,9,9,14,12,7,16,11,13,12,16,12,12,8,12,15,8,11,10,13,13,13,11,8,14,13,20,10,10,5,13,16,12,8,9,5,10,8,14,13,15,12,10,8,12,D C,101,1,1,20,20,1,1,12,1,1,1,5,1,1,1,20,12,1,1,1,1,5,1,32768,0,0,0,0,0,0,0,0,0,0,0,0,0,0,0,1,0,0,0,0,0,0,0,0,0,0,0,0,0,0,0,0,0,0,0,0,0,0,0,0,0,0,0,0,0,0,0,0
29/6/2010,Marco Tautenhahn,35006957,771,6/19/1985,25,0,0,0,0,1156,2250,2250,117,68,28705,187,81,D/DM C,1,3,1,1,3,1,3,7,1,2,2,11,12,13,8,12,11,10,11,4,6,7,11,7,13,11,6,8,9,11,11,9,7,11,13,7,8,9,3,12,14,7,14,15,12,11,20,5,6,12,2,10,12,12,9,18,10,1,14,11,11,20,D/DM C,111,1,1,20,20,20,1,10,15,10,1,10,1,1,1,20,1,1,15,1,1,10,10,0,0,0,0,0,0,0,0,0,0,0,0,0,0,0,0,0,0,0,0,0,0,0,0,0,0,0,0,0,0,0,0,0,0,0,0,0,0,0,0,0,0,0,0,0,0,0,0,0
29/6/2010,Marco Russ,8718185,771,8/4/1985,24,0,0,0,0,3250,6500,6500,142,130,5820498,190,75,D C,2,3,1,2,1,1,2,6,2,3,3,6,6,7,10,10,8,15,12,11,14,9,7,15,9,8,12,14,8,12,8,11,9,3,10,9,13,12,14,15,13,10,16,8,10,14,20,16,15,12,5,7,7,8,6,13,13,6,8,11,14,11,D C,101,1,1,20,20,15,1,1,15,1,1,1,1,1,1,20,1,1,15,1,1,1,1,512,0,0,0,0,0,0,0,0,0,1,0,0,0,0,0,0,0,0,0,0,0,0,0,0,0,0,0,0,0,0,0,0,0,0,0,0,0,0,0,0,0,0,0,0,0,0,0,0
29/6/2010,Marco Rossi,1400704,776,9/30/1987,22,0,0,3,0,4032,6000,6000,156,127,770238,188,78,D C,1,2,2,3,2,1,1,6,2,3,2,5,6,7,4,9,6,15,7,10,14,10,7,13,8,13,12,12,12,15,7,11,12,7,10,9,16,14,14,12,12,16,15,20,15,12,5,16,15,14,10,12,12,10,14,11,16,11,13,12,14,9,D C,101,1,1,20,20,1,1,12,1,1,1,1,1,1,1,20,12,1,1,1,1,1,1,137438953472,0,0,0,0,0,0,0,0,0,0,0,0,0,0,0,0,0,0,0,0,0,0,0,0,0,0,0,0,0,0,0,0,0,0,0,0,0,1,0,0,0,0,0,0,0,0,0,0
29/6/2010,Marco Materazzi,6073,776,8/19/1973,36,41,2,0,0,5112,7150,7150,170,143,995800,193,92,D C,1,1,1,1,1,1,1,1,1,1,1,9,8,7,12,12,14,19,13,6,15,13,18,15,9,19,15,18,15,12,13,12,19,5,19,11,16,13,17,9,8,19,17,20,12,9,5,14,18,14,19,16,6,10,15,14,17,15,18,4,5,14,D C,101,5,1,20,20,1,1,5,1,1,19,1,1,1,1,20,5,1,1,1,1,1,1,8864879804416,0,0,0,0,0,0,0,0,0,0,0,0,0,0,0,0,1,1,0,0,0,0,0,0,0,0,1,0,0,0,0,0,0,0,0,0,1,0,0,0,0,0,0,1,0,0,0,0
29/6/2010,Marco Cassetti,3802204,776,5/29/1977,33,5,0,0,0,4500,7100,7100,150,146,6685309,187,80,D/WB/AM RC,1,1,1,1,1,1,1,1,1,1,1,10,15,14,11,11,10,14,13,10,13,16,6,13,13,12,13,14,13,13,14,14,12,11,8,14,15,16,16,13,13,14,14,5,16,14,20,14,14,12,13,12,10,16,5,10,16,10,18,18,16,3,D/WB/AM RC,233,1,17,17,19,10,1,12,15,20,1,20,1,1,17,17,12,19,10,1,15,10,20,1103806595840,0,0,0,0,0,0,0,0,1,1,0,0,0,0,0,0,0,0,0,0,0,0,0,0,0,0,0,0,0,0,0,0,1,0,0,0,0,0,0,0,1,0,0,0,0,0,0,0
29/6/2010,Marco Caligiuri,8707875,771,4/14/1984,26,0,0,0,0,3000,6100,6100,125,124,2836804,180,75,D/WB/DM/M RC,1,1,2,1,1,1,2,2,2,1,1,5,9,11,9,13,6,10,9,7,13,11,8,16,13,7,15,11,15,11,10,12,13,14,10,10,14,11,14,12,13,12,12,10,14,12,20,12,11,14,11,11,13,10,12,13,8,8,13,13,11,8,D/WB/DM/M RC,343,1,10,20,16,20,1,14,17,16,1,16,10,10,10,16,10,14,17,14,16,12,16,4503603922337856,0,0,0,0,0,0,1,0,0,0,0,0,0,0,0,0,0,0,0,0,0,0,0,0,0,0,0,0,0,0,0,0,1,0,0,0,0,0,0,0,0,0,0,0,0,0,0,0
29/6/2010,Marco Andreolli,7984570,776,6/10/1986,24,0,0,24,0,3500,6100,6100,148,125,3001521,187,81,D RC,3,1,1,2,1,2,1,1,3,3,2,4,13,8,8,10,8,15,9,11,15,11,6,15,8,9,14,13,12,13,10,17,15,5,8,10,13,14,14,13,13,13,14,5,15,13,20,12,12,13,13,10,15,14,19,15,13,8,7,11,12,11,D RC,103,1,1,20,20,10,1,10,1,16,1,1,1,1,1,20,10,16,1,1,1,1,1,0,0,0,0,0,0,0,0,0,0,0,0,0,0,0,0,0,0,0,0,0,0,0,0,0,0,0,0,0,0,0,0,0,0,0,0,0,0,0,0,0,0,0,0,0,0,0,0,0
29/6/2010,Marcelo Silva,78017624,1657,3/21/1989,21,0,0,15,1,1500,4904,3600,128,109,2599998,185,89,D C,1,1,3,1,3,2,3,2,2,2,3,6,6,8,9,8,2,13,5,10,12,9,10,12,11,13,10,14,10,11,8,9,13,7,12,8,11,13,14,10,10,13,14,10,12,13,20,14,14,10,14,9,3,10,10,3,6,11,12,11,10,6,D C,101,1,1,20,20,1,1,1,1,1,1,1,1,1,1,20,1,1,1,1,1,1,1,0,0,0,0,0,0,0,0,0,0,0,0,0,0,0,0,0,0,0,0,0,0,0,0,0,0,0,0,0,0,0,0,0,0,0,0,0,0,0,0,0,0,0,0,0,0,0,0,0
29/6/2010,Marcel Eger,896755,771,3/23/1983,27,0,0,0,0,2000,5250,5250,110,105,1566628,190,86,D C,3,2,3,3,2,1,2,6,2,2,3,6,8,5,5,9,5,12,5,12,14,8,8,14,9,13,13,14,10,9,6,9,10,5,12,8,13,12,11,10,9,13,14,20,12,12,10,14,12,14,9,10,7,5,10,5,14,10,8,5,12,15,D C,101,1,1,20,20,1,1,14,1,10,1,1,1,1,1,20,14,10,1,1,1,1,1,0,0,0,0,0,0,0,0,0,0,0,0,0,0,0,0,0,0,0,0,0,0,0,0,0,0,0,0,0,0,0,0,0,0,0,0,0,0,0,0,0,0,0,0,0,0,0,0,0
29/6/2010,Marc Wilson,5114764,789,8/17/1987,22,0,0,0,0,3844,6000,6350,146,124,10350000,188,80,DM/M C,2,3,3,2,1,3,1,1,2,2,3,12,15,11,8,13,14,12,8,6,8,15,16,10,11,14,12,12,15,12,13,13,16,10,13,10,12,9,14,11,10,14,14,17,14,12,20,14,13,12,8,11,7,12,14,12,15,10,12,9,9,14,DM/M C,421,1,1,20,15,18,1,10,20,14,1,10,1,1,1,15,10,14,20,10,14,10,10,149537880539136,0,0,0,0,0,0,0,0,0,0,0,0,0,0,0,0,0,0,0,0,0,0,1,0,0,0,0,0,0,0,0,0,1,0,0,0,0,0,0,0,0,0,0,1,0,0,0,1
29/6/2010,Marc Torrejón,1509743,796,2/18/1986,24,0,0,8,0,4225,6500,6500,142,130,3654194,186,85,D C,1,1,2,1,3,2,1,4,3,3,1,6,9,7,8,10,7,16,8,15,15,11,12,14,11,14,12,17,11,14,7,12,15,7,12,7,14,12,15,10,10,18,13,5,15,10,20,15,18,14,14,13,11,10,13,16,11,14,15,7,7,7,D C,101,1,1,20,20,8,1,1,1,14,1,1,1,1,1,20,1,14,1,1,1,1,1,8796093022208,0,0,0,0,0,0,0,0,0,0,0,0,0,0,0,0,0,0,0,0,0,0,0,0,0,0,0,0,0,0,0,0,0,0,0,0,0,0,0,0,0,0,0,1,0,0,0,0
29/6/2010,Marc Planus,916449,769,3/7/1982,28,1,0,4,0,5256,6524,6500,150,145,42266672,183,76,D C,2,1,1,1,1,3,2,1,2,3,1,5,8,8,5,11,9,14,8,7,14,12,6,16,11,12,18,15,16,16,11,15,15,5,15,6,17,14,15,12,11,14,11,8,13,11,20,15,14,16,12,15,10,6,14,12,18,14,16,16,16,6,D C,101,1,1,20,20,1,1,1,1,1,17,1,1,1,1,20,1,1,1,1,1,1,1,146028888064,0,0,0,0,0,0,0,0,0,0,0,0,0,0,0,0,0,0,0,0,0,0,0,0,0,0,0,0,0,0,0,0,0,1,0,0,0,1,0,0,0,0,0,0,0,0,0,0
29/6/2010,Marc Bartra,67063004,796,1/15/1991,19,0,0,0,0,2500,5250,5250,132,105,1978902,184,82,D RC,2,3,3,3,1,2,3,4,3,3,1,5,8,8,5,10,5,11,4,9,13,12,9,12,10,8,11,13,8,12,8,10,8,7,11,8,14,14,13,13,10,12,11,7,11,13,20,14,10,12,10,10,7,12,11,12,11,13,15,13,7,13,D RC,103,1,1,20,20,1,1,10,1,16,1,1,1,1,1,20,10,16,1,1,1,1,1,0,0,0,0,0,0,0,0,0,0,0,0,0,0,0,0,0,0,0,0,0,0,0,0,0,0,0,0,0,0,0,0,0,0,0,0,0,0,0,0,0,0,0,0,0,0,0,0,0
29/6/2010,Mapou Yanga Mbiwa,34000001,769,5/15/1989,21,0,0,4,0,4761,6209,6200,165,138,12611678,184,77,D/WB RLC,2,2,1,3,2,1,1,6,3,1,2,5,11,9,5,9,6,15,8,12,15,8,7,14,9,13,15,15,12,12,6,12,17,9,9,7,14,14,16,14,11,15,13,10,14,13,20,16,15,14,13,15,7,12,12,14,14,14,16,14,14,6,D/WB RLC,116,1,1,20,20,1,1,17,1,17,1,17,1,1,1,20,17,17,1,1,1,17,17,0,0,0,0,0,0,0,0,0,0,0,0,0,0,0,0,0,0,0,0,0,0,0,0,0,0,0,0,0,0,0,0,0,0,0,0,0,0,0,0,0,0,0,0,0,0,0,0,0
29/6/2010,Manuel Hornig,8720668,771,12/18/1982,27,0,0,0,0,1500,5550,5550,118,111,1464911,189,83,D RC,3,3,3,2,3,1,1,6,1,1,3,3,10,7,13,10,3,15,6,10,14,12,2,15,10,10,8,7,8,13,8,7,12,4,7,11,13,13,16,9,9,16,15,18,11,9,20,11,11,11,10,10,12,4,10,12,13,10,11,14,10,11,D RC,103,10,1,20,20,1,1,1,1,18,1,1,1,1,1,20,1,18,1,1,1,1,1,0,0,0,0,0,0,0,0,0,0,0,0,0,0,0,0,0,0,0,0,0,0,0,0,0,0,0,0,0,0,0,0,0,0,0,0,0,0,0,0,0,0,0,0,0,0,0,0,0
29/6/2010,Manuel Friedrich,876739,771,9/13/1979,30,9,1,0,0,4556,6750,6750,145,135,3597528,189,83,D C,2,3,1,3,3,2,3,5,3,2,3,4,7,7,12,11,4,18,6,6,14,8,8,13,11,11,14,12,12,11,8,11,14,6,14,13,14,14,12,11,11,14,16,12,14,13,20,15,14,13,6,13,3,6,10,13,16,14,14,14,14,6,D C,101,1,1,20,20,1,1,1,1,1,1,1,1,1,1,20,1,1,1,1,1,1,1,32768,0,0,0,0,0,0,0,0,0,0,0,0,0,0,0,1,0,0,0,0,0,0,0,0,0,0,0,0,0,0,0,0,0,0,0,0,0,0,0,0,0,0,0,0,0,0,0,0
29/6/2010,Manuel da Costa,8444513,788,5/6/1986,24,0,0,22,0,3969,6250,6600,138,126,5200339,191,82,D LC,2,1,3,3,1,1,1,2,1,1,1,6,4,9,4,12,8,16,11,11,14,10,3,15,12,12,8,15,13,4,15,14,10,4,12,14,15,13,14,11,13,16,16,20,13,11,5,16,17,14,15,12,12,10,6,15,9,7,9,8,9,16,D LC,104,1,1,20,20,1,1,16,1,1,1,1,1,1,1,20,16,1,1,1,1,1,1,0,0,0,0,0,0,0,0,0,0,0,0,0,0,0,0,0,0,0,0,0,0,0,0,0,0,0,0,0,0,0,0,0,0,0,0,0,0,0,0,0,0,0,0,0,0,0,0,0
29/6/2010,Mamadou Sakho,34000070,769,2/13/1990,20,0,0,17,1,4556,6074,6050,168,135,25472539,187,83,D LC,2,3,3,3,2,1,1,1,3,3,1,5,7,9,6,11,6,16,8,10,15,8,7,14,11,13,14,16,15,11,9,12,16,11,16,8,14,14,15,12,11,17,14,20,15,11,8,15,17,13,13,14,8,7,12,17,14,17,15,13,13,7,D LC,104,1,1,20,20,1,1,15,1,1,1,1,1,1,1,20,15,1,1,1,1,1,1,4295000064,0,0,0,0,0,0,0,0,0,0,0,0,0,0,0,1,0,0,0,0,0,0,0,0,0,0,0,0,0,0,0,0,1,0,0,0,0,0,0,0,0,0,0,0,0,0,0,0
29/6/2010,Malik Fathi,892146,771,10/29/1983,26,2,0,18,2,3500,6000,6500,136,127,4447253,186,86,D/WB LC,1,3,1,3,1,2,2,1,2,1,3,10,12,11,10,13,8,14,9,12,12,13,7,13,12,12,10,10,14,13,11,12,10,7,10,11,13,12,13,12,13,13,13,20,15,13,10,13,12,13,10,14,4,11,10,15,15,10,12,12,15,10,D/WB LC,114,1,1,15,20,1,1,20,1,1,1,18,1,1,1,15,20,10,1,1,1,18,1,9663676416,0,0,0,0,0,0,0,0,0,0,0,0,0,0,0,0,0,0,0,0,0,0,0,0,0,0,0,0,0,0,1,0,0,1,0,0,0,0,0,0,0,0,0,0,0,0,0,0
29/6/2010,Maik Franz,876931,771,8/5/1981,28,0,0,19,1,3500,6900,6900,144,138,6638337,190,85,D C,2,3,2,3,2,1,3,3,1,3,2,2,6,6,10,11,7,13,8,12,17,9,6,16,8,18,13,19,11,13,5,14,18,7,16,5,13,15,16,11,10,14,16,6,16,14,20,13,17,12,19,10,10,6,5,15,11,13,10,4,6,16,D C,101,1,1,20,20,1,1,5,1,14,1,1,1,1,1,20,5,14,1,1,1,1,1,137439182848,0,0,0,0,0,0,0,0,0,0,0,0,0,0,0,1,1,1,0,0,0,0,0,0,0,0,0,0,0,0,0,0,0,0,0,0,0,1,0,0,0,0,0,0,0,0,0,0
29/6/2010,Maicon,19017908,1651,9/14/1988,21,0,0,0,0,2250,5714,6500,155,127,9211332,190,74,D C,3,3,1,1,2,2,2,1,2,2,2,7,7,7,10,11,7,15,8,8,14,11,10,13,11,12,13,13,13,13,8,11,12,7,10,8,14,13,11,13,12,15,16,8,14,12,20,12,15,12,10,12,8,8,14,13,13,13,14,14,14,5,D C,101,1,1,20,20,4,1,1,1,1,7,1,1,1,1,20,1,1,1,1,1,1,1,0,0,0,0,0,0,0,0,0,0,0,0,0,0,0,0,0,0,0,0,0,0,0,0,0,0,0,0,0,0,0,0,0,0,0,0,0,0,0,0,0,0,0,0,0,0,0,0,0
29/6/2010,Luiz Nunes,5512962,1651,12/4/1980,29,0,0,0,0,2250,6050,5000,105,100,147726,181,83,D C,3,1,3,2,2,3,2,1,1,1,1,6,5,6,9,10,11,14,7,12,12,10,14,11,8,14,11,12,10,11,4,8,12,2,13,8,10,13,11,7,10,17,13,10,7,7,20,13,16,10,14,10,10,10,11,10,13,7,14,12,7,6,D C,101,1,1,20,20,5,1,1,1,1,10,1,1,1,1,20,1,1,1,1,1,1,1,137438953472,0,0,0,0,0,0,0,0,0,0,0,0,0,0,0,0,0,0,0,0,0,0,0,0,0,0,0,0,0,0,0,0,0,0,0,0,0,1,0,0,0,0,0,0,0,0,0,0
29/6/2010,Luisão,304150,1651,2/13/1981,29,42,3,10,0,5500,7750,7650,160,153,29075395,192,81,D C,3,1,1,1,3,3,2,4,3,1,3,6,7,9,10,11,9,15,9,9,15,9,11,13,9,16,14,15,10,16,9,14,18,8,17,11,15,14,15,10,11,17,17,10,17,10,20,15,17,16,12,15,8,8,16,15,17,15,16,13,13,10,D C,101,1,1,20,20,1,1,1,1,1,5,1,1,1,1,20,1,1,1,1,1,1,1,2199023288320,0,0,0,0,0,0,0,0,0,0,0,0,0,0,0,1,0,0,0,0,0,0,0,0,0,0,0,0,0,0,0,0,0,0,0,0,0,0,0,0,0,1,0,0,0,0,0,0
29/6/2010,Luís Tinoco,8878050,788,10/17/1986,23,0,0,0,0,500,3500,3500,100,90,484502,185,75,D C,3,3,3,1,2,1,3,1,3,3,3,9,5,6,12,11,5,13,9,11,12,10,6,12,6,10,11,15,15,12,6,10,10,3,2,9,16,11,16,11,12,9,13,1,8,11,20,14,10,10,15,7,8,10,11,16,13,10,14,10,6,13,D C,101,1,1,20,20,1,1,1,1,1,1,1,1,1,1,20,1,1,1,1,1,1,1,0,0,0,0,0,0,0,0,0,0,0,0,0,0,0,0,0,0,0,0,0,0,0,0,0,0,0,0,0,0,0,0,0,0,0,0,0,0,0,0,0,0,0,0,0,0,0,0,0
29/6/2010,Luis Perea,5260012,1653,1/30/1979,31,37,0,0,0,4830,7000,6500,160,139,3137953,181,73,D RC,2,2,2,1,3,3,1,2,3,3,2,4,7,9,5,7,5,13,9,11,13,10,10,15,11,14,17,17,11,12,11,8,17,5,10,10,9,15,16,19,15,15,11,7,16,18,20,17,15,9,13,11,8,14,17,16,15,14,15,14,13,10,D RC,103,1,1,20,20,1,1,5,1,19,10,10,1,1,1,20,5,19,1,1,1,1,10,12884901888,0,0,0,0,0,0,0,0,0,0,0,0,0,0,0,0,0,0,0,0,0,0,0,0,0,0,0,0,0,0,0,0,1,1,0,0,0,0,0,0,0,0,0,0,0,0,0,0
29/6/2010,Ludovic Sané,85032367,769,3/22/1987,23,0,0,0,0,4096,5759,5750,150,128,4353438,192,77,D RC,1,3,1,2,1,2,3,6,1,1,3,6,8,8,7,9,5,15,10,5,14,8,7,14,9,14,14,15,13,14,7,11,15,5,9,8,14,12,15,15,10,16,16,5,14,13,20,15,15,14,13,14,7,6,6,14,11,14,13,14,14,7,D RC,103,1,1,20,20,14,1,1,10,16,1,10,1,1,1,20,1,16,10,1,1,1,10,4503874505277440,0,0,0,0,0,0,0,0,0,0,0,0,0,0,0,0,0,0,0,0,0,0,0,0,0,0,0,0,0,0,0,0,0,0,0,0,0,0,1,0,0,0,0,0,0,0,0,0
29/6/2010,Lúcio,303441,1651,5/8/1978,32,96,4,4,0,7396,8500,8550,173,172,154317397,188,84,D C,3,1,1,2,2,1,1,10,2,2,2,4,7,14,7,9,12,16,13,12,14,8,10,18,9,17,13,18,15,13,8,13,20,14,18,10,12,14,19,17,8,20,16,9,19,19,20,19,18,14,13,19,11,12,16,18,16,18,19,13,10,13,D C,101,1,1,20,20,1,1,1,1,1,1,1,1,1,1,20,1,1,1,1,1,1,1,70506317348900,0,0,1,0,0,1,0,0,0,0,0,0,0,0,0,0,0,0,0,0,0,0,0,0,0,0,0,1,0,0,0,0,0,0,0,0,0,1,0,0,0,0,0,0,0,0,1,0
29/6/2010,Lorenzo Ariaudo,43006766,776,6/11/1989,21,0,0,6,1,1450,6000,6000,143,119,1847450,186,71,D LC,2,1,3,3,3,1,1,2,1,2,1,2,3,5,5,9,3,13,5,7,12,10,2,12,10,16,14,13,12,11,11,13,16,7,7,7,14,11,14,12,13,14,12,20,14,11,6,15,14,13,7,11,8,8,5,15,15,11,15,13,11,4,D LC,104,1,1,20,20,1,1,15,1,10,10,1,1,1,1,20,15,10,1,1,1,1,1,0,0,0,0,0,0,0,0,0,0,0,0,0,0,0,0,0,0,0,0,0,0,0,0,0,0,0,0,0,0,0,0,0,0,0,0,0,0,0,0,0,0,0,0,0,0,0,0,0
29/6/2010,Lolo,7453005,796,8/22/1984,25,0,0,0,0,4250,6250,6250,140,131,5374312,182,80,D/DM C,2,2,2,2,1,1,2,4,1,3,3,8,9,11,12,15,15,10,16,8,13,13,13,13,13,14,13,14,15,14,13,14,15,9,16,13,15,13,14,11,11,15,11,8,13,8,20,15,15,14,11,11,7,13,10,13,14,11,13,12,12,7,D/DM C,111,1,1,20,20,19,1,1,15,1,1,1,1,1,1,20,1,1,15,1,1,1,1,256,0,0,0,0,0,0,0,0,1,0,0,0,0,0,0,0,0,0,0,0,0,0,0,0,0,0,0,0,0,0,0,0,0,0,0,0,0,0,0,0,0,0,0,0,0,0,0,0
29/6/2010,Loïc Poujol,8442422,769,2/27/1989,21,0,0,4,0,1000,5129,5100,150,114,1529424,188,86,D/DM C,3,1,3,1,1,2,2,1,1,3,1,5,6,8,5,11,7,14,13,6,12,9,10,11,12,13,12,13,13,13,9,11,13,8,11,7,12,12,16,14,9,16,14,8,14,10,20,14,17,14,13,5,8,11,8,12,14,5,15,15,15,6,D/DM C,321,1,1,20,16,20,1,1,15,1,1,1,1,1,1,16,1,1,15,1,1,1,1,512,0,0,0,0,0,0,0,0,0,1,0,0,0,0,0,0,0,0,0,0,0,0,0,0,0,0,0,0,0,0,0,0,0,0,0,0,0,0,0,0,0,0,0,0,0,0,0,0
29/6/2010,Loïc Abenzoar,8442417,769,2/14/1989,21,0,0,0,0,50,2600,2600,145,104,846062,182,74,D RC,2,2,1,2,1,1,1,1,1,1,2,5,7,7,5,10,6,14,7,6,12,7,6,9,10,11,12,14,12,12,7,11,10,6,10,7,11,11,14,16,9,13,11,5,13,13,20,14,13,14,11,10,11,10,11,11,14,12,9,9,10,20,D RC,103,1,1,20,20,1,1,1,1,15,1,15,1,1,1,20,1,15,1,1,1,1,15,0,0,0,0,0,0,0,0,0,0,0,0,0,0,0,0,0,0,0,0,0,0,0,0,0,0,0,0,0,0,0,0,0,0,0,0,0,0,0,0,0,0,0,0,0,0,0,0,0
29/6/2010,Liassine Cadamuro,67065936,769,3/5/1988,22,0,0,0,0,2256,4300,4300,123,95,494990,186,76,D C,1,1,3,3,1,2,1,1,3,2,2,2,6,8,3,4,2,12,11,6,13,8,2,11,9,10,12,15,13,9,10,10,10,6,12,3,10,8,13,12,10,10,13,20,11,11,14,14,13,11,5,10,12,5,15,11,6,5,14,13,6,8,D C,101,1,1,20,20,13,1,13,1,8,1,1,1,1,1,20,13,8,1,1,1,1,1,0,0,0,0,0,0,0,0,0,0,0,0,0,0,0,0,0,0,0,0,0,0,0,0,0,0,0,0,0,0,0,0,0,0,0,0,0,0,0,0,0,0,0,0,0,0,0,0,0
29/6/2010,Liam Ridgewell,5104215,765,7/21/1984,25,0,0,8,0,4550,6550,6550,142,139,5184998,188,80,D LC,2,1,1,1,2,1,3,3,3,2,2,1,12,10,12,12,5,18,5,9,17,13,5,16,13,17,11,16,12,12,12,13,14,4,16,7,12,15,14,12,11,11,15,20,14,12,9,14,12,16,11,10,9,12,7,12,15,15,16,8,12,2,D LC,104,1,1,18,20,1,1,20,1,1,1,6,1,1,1,18,20,5,1,1,1,6,1,0,0,0,0,0,0,0,0,0,0,0,0,0,0,0,0,0,0,0,0,0,0,0,0,0,0,0,0,0,0,0,0,0,0,0,0,0,0,0,0,0,0,0,0,0,0,0,0,0
29/6/2010,Leyti N'Diaye,8434552,41,8/19/1985,24,0,0,0,0,3364,5219,5200,132,116,5546543,188,84,D C,2,2,3,2,2,2,2,6,3,1,2,5,6,7,7,9,7,16,12,6,13,9,6,11,9,14,15,15,13,12,8,12,15,5,11,7,13,13,14,13,7,17,14,5,12,11,20,14,16,14,14,14,11,6,7,13,13,12,14,13,13,6,D C,101,1,1,20,20,14,1,1,10,1,1,1,1,1,1,20,1,1,10,1,1,1,1,32768,0,0,0,0,0,0,0,0,0,0,0,0,0,0,0,1,0,0,0,0,0,0,0,0,0,0,0,0,0,0,0,0,0,0,0,0,0,0,0,0,0,0,0,0,0,0,0,0
29/6/2010,Leonardo Bonucci,1410956,776,5/1/1987,23,2,1,0,0,5000,7000,7000,163,148,64012671,190,81,D C,1,2,1,3,1,3,3,1,3,3,1,4,7,9,9,10,4,15,4,7,16,10,4,16,12,11,13,15,13,14,11,13,17,4,10,7,15,14,14,12,11,15,16,10,11,13,20,15,14,14,9,15,11,11,14,19,16,17,18,15,12,3,D C,101,1,1,20,20,1,1,6,1,13,10,1,1,1,1,20,6,13,1,1,1,1,1,8796093022208,0,0,0,0,0,0,0,0,0,0,0,0,0,0,0,0,0,0,0,0,0,0,0,0,0,0,0,0,0,0,0,0,0,0,0,0,0,0,0,0,0,0,0,1,0,0,0,0
29/6/2010,Leon Andreasen,927544,764,4/23/1983,27,15,2,23,6,4000,6750,7000,140,136,10840910,188,81,D/DM/M C,1,1,3,3,1,2,2,8,2,2,3,8,11,9,9,13,13,14,13,12,14,12,13,15,12,17,13,17,14,13,11,13,15,9,14,6,13,15,13,12,13,12,15,11,16,12,20,15,14,13,14,16,10,15,5,16,14,14,9,6,5,16,D/DM/M C,331,1,5,20,18,20,1,11,16,13,5,8,5,1,1,18,11,13,16,1,1,8,8,35253091730176,0,0,0,0,0,0,0,0,1,1,0,0,0,0,0,1,0,1,0,0,0,0,0,0,0,0,0,0,0,0,0,0,0,0,0,0,1,0,0,0,0,0,0,0,0,1,0,0
29/6/2010,Léo Schwechlen,8442420,769,6/5/1989,21,0,0,0,0,50,2650,2650,140,106,1381563,182,75,D LC,1,1,1,1,1,3,2,3,1,3,2,7,7,7,5,9,6,13,7,6,11,10,6,11,9,11,12,12,14,14,10,13,10,6,13,7,12,12,13,12,9,13,11,20,14,11,5,14,13,14,11,7,6,8,13,16,10,13,6,12,10,12,D LC,104,1,1,20,20,1,1,15,1,1,10,1,1,1,1,20,15,1,1,1,1,1,1,0,0,0,0,0,0,0,0,0,0,0,0,0,0,0,0,0,0,0,0,0,0,0,0,0,0,0,0,0,0,0,0,0,0,0,0,0,0,0,0,0,0,0,0,0,0,0,0,0
29/6/2010,Léo Fortunato,8825082,1651,3/14/1983,27,0,0,0,0,3000,6250,6250,131,125,658622,184,80,D C,2,1,2,1,3,3,3,2,2,3,2,1,5,4,6,5,1,13,4,5,13,12,10,13,6,16,14,16,10,13,5,15,14,8,12,6,14,16,17,14,12,15,12,6,15,14,20,15,16,13,14,12,17,4,14,13,14,12,12,13,18,12,D C,101,1,1,20,20,14,1,1,1,1,1,1,1,1,1,20,1,1,1,1,1,1,1,0,0,0,0,0,0,0,0,0,0,0,0,0,0,0,0,0,0,0,0,0,0,0,0,0,0,0,0,0,0,0,0,0,0,0,0,0,0,0,0,0,0,0,0,0,0,0,0,0
29/6/2010,Ledley King,4000326,765,10/12/1980,29,21,2,14,1,6480,7650,7650,161,161,37454015,189,89,D C,3,2,3,1,1,3,3,9,3,1,3,1,6,8,3,12,3,15,3,2,15,11,5,16,13,14,15,17,15,16,9,17,16,11,17,7,17,15,16,13,12,14,16,14,6,14,20,9,17,15,10,15,20,14,6,14,15,13,13,10,14,13,D C,101,1,1,20,20,14,1,5,1,5,1,1,1,1,1,20,5,5,1,1,1,1,1,0,0,0,0,0,0,0,0,0,0,0,0,0,0,0,0,0,0,0,0,0,0,0,0,0,0,0,0,0,0,0,0,0,0,0,0,0,0,0,0,0,0,0,0,0,0,0,0,0
29/6/2010,Leandro Rinaudo,829305,776,5/9/1983,27,0,0,0,0,2500,6400,6400,140,131,2345676,191,78,D C,3,3,2,1,2,2,1,4,2,2,1,5,4,5,8,5,8,18,7,4,15,9,5,15,8,13,14,15,14,13,5,12,13,6,14,5,14,11,12,10,8,15,17,5,10,10,20,13,18,13,13,14,5,4,13,14,14,15,15,15,16,2,D C,101,1,1,20,20,1,1,1,1,1,1,1,1,1,1,20,1,1,1,1,1,1,1,0,0,0,0,0,0,0,0,0,0,0,0,0,0,0,0,0,0,0,0,0,0,0,0,0,0,0,0,0,0,0,0,0,0,0,0,0,0,0,0,0,0,0,0,0,0,0,0,0
29/6/2010,Laurent Koscielny,8442484,769,9/10/1985,24,0,0,0,0,5200,6569,7300,165,146,-1,186,75,D C,1,1,2,3,1,3,3,3,3,3,3,5,7,9,10,11,5,15,7,6,15,9,7,13,11,12,17,15,15,15,11,14,16,5,11,11,16,14,16,14,12,16,14,8,15,13,20,15,14,17,12,14,6,8,10,15,13,14,15,15,15,6,D C,101,1,1,20,20,1,1,12,1,10,1,12,1,1,1,20,12,10,1,1,1,12,10,274877906976,0,0,0,0,0,1,0,0,0,0,0,0,0,0,0,0,0,0,0,0,0,0,0,0,0,0,0,0,0,0,0,0,0,0,0,0,0,0,1,0,0,0,0,0,0,0,0,0
29/6/2010,Larrys Mabiala,8444104,53,10/8/1987,22,8,0,0,0,3306,6000,5150,140,115,1563462,189,84,D RC,3,2,3,1,1,2,1,5,1,1,3,6,10,7,6,9,8,15,11,8,13,8,6,14,9,10,13,14,11,11,7,11,14,7,7,7,12,13,14,8,11,16,14,10,10,11,20,14,16,12,10,13,14,8,11,13,14,9,12,15,15,7,D RC,103,5,1,20,20,1,1,1,1,15,1,1,1,1,1,20,1,15,1,1,1,1,1,0,0,0,0,0,0,0,0,0,0,0,0,0,0,0,0,0,0,0,0,0,0,0,0,0,0,0,0,0,0,0,0,0,0,0,0,0,0,0,0,0,0,0,0,0,0,0,0,0
29/6/2010,Lamine Koné,34000665,769,2/1/1989,21,0,0,3,0,2500,3800,3800,150,116,2932393,186,83,D RC,2,2,1,1,2,2,2,3,1,1,2,5,7,8,6,9,6,14,8,6,14,8,6,11,9,14,14,15,13,13,6,12,14,8,9,9,13,13,14,11,9,16,14,20,13,13,8,16,16,14,14,14,10,8,5,13,14,13,15,15,15,6,D RC,103,1,1,18,20,1,1,14,1,20,1,14,1,1,1,18,14,20,1,1,1,14,14,32,0,0,0,0,0,1,0,0,0,0,0,0,0,0,0,0,0,0,0,0,0,0,0,0,0,0,0,0,0,0,0,0,0,0,0,0,0,0,0,0,0,0,0,0,0,0,0,0
29/6/2010,Kris Stadsgaard,931999,764,8/1/1985,24,1,0,0,0,4225,5849,6750,135,130,3847359,185,78,D C,3,3,1,2,3,1,2,7,2,1,2,2,7,11,4,11,4,13,10,1,14,12,7,13,12,7,15,9,16,16,12,14,14,4,4,9,14,11,11,16,12,13,13,7,11,16,20,13,13,16,2,15,15,8,10,15,12,14,15,15,10,5,D C,101,1,1,20,20,1,1,1,1,12,1,1,1,1,1,20,1,12,1,1,1,1,1,279172874240,0,0,0,0,0,0,0,0,0,0,0,0,0,0,0,0,0,0,0,0,0,0,0,0,0,0,0,0,0,0,0,0,1,0,0,0,0,0,1,0,0,0,0,0,0,0,0,0
29/6/2010,Kolo Touré,5370564,24,3/19/1981,29,84,3,0,0,5550,8195,7450,165,149,59845046,183,77,D RC,1,1,2,1,1,2,2,9,2,3,2,4,11,11,8,10,12,15,12,6,15,12,9,15,13,14,13,18,13,13,12,13,18,10,14,8,14,16,16,16,12,12,12,10,13,15,20,15,15,13,7,15,6,15,18,15,15,16,17,17,16,9,D RC,103,1,1,20,20,12,1,1,10,15,1,12,1,1,1,20,1,15,10,1,10,1,12,35184372089124,0,0,1,0,0,1,0,0,1,0,0,0,0,0,0,0,0,0,0,0,0,0,0,0,0,0,0,0,0,0,0,0,0,0,0,0,0,0,0,0,0,0,0,0,0,1,0,0
29/6/2010,Kiko,67006138,796,8/21/1988,21,0,0,0,0,3136,5600,5600,132,112,1698816,189,83,D C,2,2,3,1,2,3,2,5,1,3,1,4,6,6,4,8,7,16,9,8,16,9,6,12,6,13,12,16,8,13,6,10,11,4,10,6,12,15,13,8,9,13,14,9,14,11,20,13,14,16,14,10,8,3,14,7,10,9,6,18,10,14,D C,101,1,1,20,20,1,1,1,1,9,5,1,1,1,1,20,1,9,1,1,1,1,1,32768,0,0,0,0,0,0,0,0,0,0,0,0,0,0,0,1,0,0,0,0,0,0,0,0,0,0,0,0,0,0,0,0,0,0,0,0,0,0,0,0,0,0,0,0,0,0,0,0
29/6/2010,Kheireddine Zarabi,8625861,5,7/8/1984,25,0,0,1,0,1000,4500,4500,106,100,328626,187,80,D C,3,2,1,2,1,2,2,1,3,3,2,7,9,8,5,9,4,13,10,13,12,8,8,12,8,16,8,12,9,8,7,7,12,4,12,6,11,15,16,13,11,14,14,5,14,12,20,12,15,13,13,12,8,12,12,12,12,11,12,13,12,7,D C,101,1,1,20,20,10,1,3,1,7,1,3,1,1,1,20,1,7,1,1,1,3,1,0,0,0,0,0,0,0,0,0,0,0,0,0,0,0,0,0,0,0,0,0,0,0,0,0,0,0,0,0,0,0,0,0,0,0,0,0,0,0,0,0,0,0,0,0,0,0,0,0
29/6/2010,Khalid Boulahrouz,854399,784,12/28/1981,28,31,0,0,0,4830,7645,6900,162,139,8652118,183,74,D RC,3,2,2,1,1,3,3,1,2,1,2,5,8,5,4,10,6,14,6,15,18,8,10,18,9,19,14,19,8,10,7,9,17,12,14,5,16,17,17,15,10,16,13,8,17,13,20,15,15,15,18,17,11,11,14,19,7,16,10,5,8,15,D RC,103,1,1,20,20,10,1,1,1,16,1,1,1,1,1,20,1,16,1,1,1,1,1,137438986240,0,0,0,0,0,0,0,0,0,0,0,0,0,0,0,1,0,0,0,0,0,0,0,0,0,0,0,0,0,0,0,0,0,0,0,0,0,1,0,0,0,0,0,0,0,0,0,0
29/6/2010,Kevin Pezzoni,28000488,771,3/22/1989,21,0,0,2,0,3250,6050,6050,135,121,944273,193,91,D/DM C,1,3,1,2,2,2,1,2,2,2,3,5,6,8,7,10,6,15,11,13,13,11,7,13,9,12,12,14,14,11,8,12,8,8,8,8,13,15,16,10,9,9,16,20,15,11,17,14,15,12,12,10,6,12,10,4,5,14,7,5,13,11,D/DM C,321,1,1,20,18,20,1,12,15,5,8,6,1,1,1,18,12,5,15,1,1,6,3,0,0,0,0,0,0,0,0,0,0,0,0,0,0,0,0,0,0,0,0,0,0,0,0,0,0,0,0,0,0,0,0,0,0,0,0,0,0,0,0,0,0,0,0,0,0,0,0,0
29/6/2010,Kevin McKenna,6000664,364,1/21/1980,30,46,9,7,0,3500,6000,6300,132,126,2806513,190,85,D C,2,1,2,2,3,1,3,1,3,1,1,3,8,6,10,10,6,17,9,6,14,7,15,14,8,12,13,15,14,14,7,13,18,8,15,10,14,15,15,8,9,10,16,9,14,7,20,14,14,14,5,12,1,17,17,10,17,14,14,15,13,4,D C,101,15,1,20,20,8,1,5,4,7,15,3,1,1,1,20,5,7,4,1,1,1,3,0,0,0,0,0,0,0,0,0,0,0,0,0,0,0,0,0,0,0,0,0,0,0,0,0,0,0,0,0,0,0,0,0,0,0,0,0,0,0,0,0,0,0,0,0,0,0,0,0
29/6/2010,Kévin Gomis,34005112,769,1/20/1989,21,0,0,0,0,1000,2300,5000,118,100,49959,182,81,D C,1,3,2,3,1,1,1,3,3,3,2,8,9,7,7,9,7,13,7,8,12,7,6,8,9,13,12,13,11,11,7,11,15,7,7,9,10,12,13,15,8,14,11,8,14,14,20,14,13,13,13,10,6,10,13,12,14,14,15,14,14,6,D C,101,1,1,20,20,10,1,1,1,7,7,1,1,1,1,20,1,7,1,1,1,1,1,0,0,0,0,0,0,0,0,0,0,0,0,0,0,0,0,0,0,0,0,0,0,0,0,0,0,0,0,0,0,0,0,0,0,0,0,0,0,0,0,0,0,0,0,0,0,0,0,0
29/6/2010,Karim Haggui,8627401,51,1/20/1984,26,56,5,0,0,4692,7535,6850,148,137,6325330,187,88,D C,1,2,3,1,2,2,3,2,3,2,3,7,9,8,8,12,9,15,11,10,13,10,10,14,12,16,13,15,10,8,8,10,14,8,11,8,13,13,11,13,14,15,16,14,15,14,20,15,16,8,11,14,8,9,13,14,10,14,13,13,13,12,D C,101,1,1,20,20,1,1,1,1,10,10,1,1,1,1,20,1,10,1,1,1,1,1,0,0,0,0,0,0,0,0,0,0,0,0,0,0,0,0,0,0,0,0,0,0,0,0,0,0,0,0,0,0,0,0,0,0,0,0,0,0,0,0,0,0,0,0,0,0,0,0,0
29/6/2010,Kanu,19014435,1651,5/3/1984,26,0,0,0,0,2500,5300,4850,122,109,442510,188,77,D C,1,1,2,2,3,2,3,2,2,2,2,6,5,6,7,9,10,13,9,8,13,7,9,11,9,15,12,13,12,12,8,11,15,6,11,11,12,10,12,11,11,16,14,8,17,10,20,14,16,13,12,12,6,7,13,13,13,14,14,13,13,8,D C,101,1,1,20,20,1,1,1,1,1,1,1,1,1,1,20,1,1,1,1,1,1,1,0,0,0,0,0,0,0,0,0,0,0,0,0,0,0,0,0,0,0,0,0,0,0,0,0,0,0,0,0,0,0,0,0,0,0,0,0,0,0,0,0,0,0,0,0,0,0,0,0
29/6/2010,Kamil Glik,67030699,787,2/3/1988,22,0,0,0,0,3306,5174,4500,130,115,1699631,190,80,D C,2,2,3,1,3,1,3,1,3,1,2,9,3,7,10,12,8,13,12,7,13,11,5,13,11,12,14,15,12,15,12,14,15,6,8,12,12,14,12,11,12,13,13,5,12,13,20,14,14,12,7,15,3,10,12,12,12,15,15,11,10,5,D C,101,1,1,20,20,14,1,1,1,1,10,1,1,1,1,20,1,1,1,1,1,1,1,0,0,0,0,0,0,0,0,0,0,0,0,0,0,0,0,0,0,0,0,0,0,0,0,0,0,0,0,0,0,0,0,0,0,0,0,0,0,0,0,0,0,0,0,0,0,0,0,0
29/6/2010,Kakha Kaladze,115765,770,2/27/1978,32,69,1,0,0,4422,7315,6700,163,133,3333734,186,76,D C,1,2,1,3,1,3,3,9,2,3,1,4,9,8,8,9,2,14,6,14,15,10,5,16,13,16,13,14,12,12,10,12,10,4,14,8,17,14,13,12,13,16,12,20,11,13,10,14,15,11,15,8,17,10,18,8,14,14,15,14,13,16,D C,101,1,1,20,20,8,1,14,6,1,1,11,1,1,1,20,14,1,6,5,1,11,1,4294967296,0,0,0,0,0,0,0,0,0,0,0,0,0,0,0,0,0,0,0,0,0,0,0,0,0,0,0,0,0,0,0,0,1,0,0,0,0,0,0,0,0,0,0,0,0,0,0,0
29/6/2010,Kader Mangane,2018587,41,3/23/1983,27,2,0,3,0,4400,6659,6650,156,148,11005424,190,80,D/DM C,2,3,3,1,2,1,1,4,3,2,3,6,8,9,9,11,8,14,10,2,18,12,5,16,13,16,14,16,13,13,10,12,11,7,12,7,14,14,16,16,10,18,15,8,13,12,20,15,18,15,16,7,8,10,9,12,13,10,7,12,13,8,D/DM C,111,1,1,20,20,18,1,1,15,12,1,1,1,1,1,20,1,1,15,1,12,1,1,0,0,0,0,0,0,0,0,0,0,0,0,0,0,0,0,0,0,0,0,0,0,0,0,0,0,0,0,0,0,0,0,0,0,0,0,0,0,0,0,0,0,0,0,0,0,0,0,0
29/6/2010,Junior NTamé,18020837,11,5/17/1985,25,0,0,0,0,3000,5500,5500,122,112,1023888,188,83,D C,3,1,1,1,3,3,3,5,2,1,2,5,6,7,8,9,6,14,8,5,13,8,14,12,9,15,13,12,12,12,9,12,15,13,10,7,11,11,15,12,9,15,14,5,12,11,20,13,15,17,6,13,7,11,14,14,6,14,16,15,15,7,D C,101,8,1,20,20,1,1,1,1,1,1,1,1,1,1,20,1,1,1,1,1,1,1,0,0,0,0,0,0,0,0,0,0,0,0,0,0,0,0,0,0,0,0,0,0,0,0,0,0,0,0,0,0,0,0,0,0,0,0,0,0,0,0,0,0,0,0,0,0,0,0,0
29/6/2010,Júlio César,4201735,1651,11/18/1978,31,0,0,0,0,3906,5624,5800,155,125,1972655,186,78,D C,1,1,3,1,1,1,3,1,3,2,1,4,11,12,11,13,12,14,6,8,10,14,6,12,12,10,16,12,14,9,11,15,8,12,11,13,13,12,13,11,13,10,13,12,10,11,20,13,14,11,8,12,13,8,15,14,7,16,6,14,15,11,D C,101,1,1,20,20,8,1,1,1,5,18,1,1,1,1,20,1,5,1,1,1,1,1,4294967328,0,0,0,0,0,1,0,0,0,0,0,0,0,0,0,0,0,0,0,0,0,0,0,0,0,0,0,0,0,0,0,0,1,0,0,0,0,0,0,0,0,0,0,0,0,0,0,0
29/6/2010,Julien Rodriguez,3503962,769,6/11/1978,32,0,0,0,0,2916,4850,4850,140,108,3832626,182,80,D C,3,2,3,1,3,3,1,5,2,3,3,5,6,7,7,8,9,14,10,6,13,8,8,14,9,15,13,17,12,13,7,14,16,5,15,6,12,15,16,8,9,15,11,5,6,7,20,11,15,13,16,14,20,6,12,12,16,14,17,8,8,3,D C,101,1,1,20,20,1,1,1,1,1,1,1,1,1,1,20,1,1,1,1,1,1,1,137438953472,0,0,0,0,0,0,0,0,0,0,0,0,0,0,0,0,0,0,0,0,0,0,0,0,0,0,0,0,0,0,0,0,0,0,0,0,0,1,0,0,0,0,0,0,0,0,0,0
29/6/2010,Julien Escudé,400514,769,8/17/1979,30,9,0,21,1,5625,6749,7100,158,150,144492258,184,76,D LC,1,3,1,1,1,3,14,1,3,1,1,5,12,9,6,11,11,14,11,11,16,11,12,16,10,11,16,11,16,16,8,15,15,6,12,8,17,13,13,11,12,12,13,20,13,12,15,14,14,16,10,13,10,10,13,15,15,16,16,9,14,9,D LC,104,1,1,20,20,14,1,15,1,12,1,5,1,1,1,20,15,12,1,1,1,5,5,137472507904,0,0,0,0,0,0,0,0,0,0,0,0,0,0,0,0,0,0,0,0,0,0,0,0,0,1,0,0,0,0,0,0,0,0,0,0,0,1,0,0,0,0,0,0,0,0,0,0
29/6/2010,Juanito,6701738,796,7/23/1976,33,26,3,0,0,4225,6500,6500,154,130,1550294,183,76,D C,1,2,3,2,3,1,3,3,1,2,3,7,8,7,8,11,12,16,9,14,14,12,9,14,8,17,13,15,13,12,8,13,16,7,17,8,10,14,15,10,10,15,13,5,14,12,20,15,15,14,15,13,13,8,14,16,15,14,16,14,13,8,D C,101,1,1,20,20,1,1,1,1,1,12,1,1,1,1,20,1,1,1,1,1,1,1,274878005248,0,0,0,0,0,0,0,0,0,0,0,0,0,0,0,1,1,0,0,0,0,0,0,0,0,0,0,0,0,0,0,0,0,0,0,0,0,0,1,0,0,0,0,0,0,0,0,0
29/6/2010,Juan,3301249,1651,2/1/1979,31,80,8,0,0,6724,8000,8050,168,164,22239510,182,74,D C,3,2,1,1,1,3,1,3,1,3,1,6,7,9,7,13,6,17,7,6,18,14,10,18,15,12,17,14,13,15,10,16,15,10,12,6,17,15,14,13,12,14,13,8,11,15,20,14,15,17,7,16,15,10,15,14,14,14,15,14,16,2,D C,101,1,1,20,20,1,1,1,1,1,10,1,1,1,1,20,1,1,1,1,1,1,1,32768,0,0,0,0,0,0,0,0,0,0,0,0,0,0,0,1,0,0,0,0,0,0,0,0,0,0,0,0,0,0,0,0,0,0,0,0,0,0,0,0,0,0,0,0,0,0,0,0
29/6/2010,Juan Forlín,962963,1649,1/10/1988,22,0,0,11,0,4500,6250,6750,160,136,8000000,180,72,D/DM C,3,3,2,1,3,2,1,6,3,3,2,4,9,8,8,12,8,14,9,10,14,13,12,15,14,14,12,15,14,13,12,11,17,8,12,8,15,14,14,15,14,13,12,6,12,14,20,16,13,13,10,13,12,11,14,15,14,16,14,14,13,11,D/DM C,111,1,1,20,20,20,1,1,15,1,14,1,1,1,1,20,1,1,15,1,1,1,1,0,0,0,0,0,0,0,0,0,0,0,0,0,0,0,0,0,0,0,0,0,0,0,0,0,0,0,0,0,0,0,0,0,0,0,0,0,0,0,0,0,0,0,0,0,0,0,0,0
29/6/2010,Josip Simunic,3601919,761,2/18/1978,32,72,3,0,0,5256,7850,7350,147,145,6473274,195,91,D C,1,3,1,3,2,1,3,7,3,3,3,5,8,12,3,15,5,17,5,12,18,10,5,18,17,17,15,17,19,7,7,8,10,10,15,4,16,12,4,7,9,16,18,18,7,13,20,12,17,10,18,16,9,12,18,14,12,7,5,6,4,18,D C,101,1,1,20,20,10,1,12,1,10,8,1,1,1,1,20,12,10,1,1,1,1,1,12885098496,0,0,0,0,0,0,0,0,0,0,0,0,0,0,0,0,1,1,0,0,0,0,0,0,0,0,0,0,0,0,0,0,1,1,0,0,0,0,0,0,0,0,0,0,0,0,0,0
29/6/2010,Josetxo,4203315,796,2/25/1977,33,0,0,0,0,3422,5750,5750,129,117,783064,185,79,D C,1,2,1,2,2,1,2,1,1,1,3,3,5,7,5,8,11,16,13,7,15,10,5,12,7,18,15,13,7,14,4,12,15,6,16,9,13,12,15,7,9,16,14,12,11,9,20,12,13,12,16,12,10,5,10,13,12,9,13,9,7,11,D C,101,1,1,20,20,10,1,1,1,12,10,1,1,1,1,20,1,12,1,1,1,1,1,137438986240,0,0,0,0,0,0,0,0,0,0,0,0,0,0,0,1,0,0,0,0,0,0,0,0,0,0,0,0,0,0,0,0,0,0,0,0,0,1,0,0,0,0,0,0,0,0,0,0
29/6/2010,José Nunes,4102055,788,3/7/1977,33,0,0,0,0,5329,6750,6500,149,146,5108812,185,82,D C,3,1,2,1,3,1,1,3,3,3,3,6,7,8,11,8,9,18,9,13,15,13,11,14,10,14,15,16,14,17,8,12,13,6,11,7,16,15,16,11,10,16,14,11,14,11,20,13,15,18,13,15,6,8,10,12,11,12,13,10,9,5,D C,101,1,1,20,20,12,1,1,5,2,10,1,1,1,1,20,1,2,5,1,1,1,1,32768,0,0,0,0,0,0,0,0,0,0,0,0,0,0,0,1,0,0,0,0,0,0,0,0,0,0,0,0,0,0,0,0,0,0,0,0,0,0,0,0,0,0,0,0,0,0,0,0
29/6/2010,José Manuel Velázquez,86005919,1658,9/8/1990,19,7,1,17,1,1500,4724,4250,133,105,1853230,184,78,D C,1,1,2,2,3,1,1,1,1,2,1,9,6,1,6,9,7,13,5,0,12,11,9,13,5,8,11,14,10,11,0,11,10,3,13,8,12,16,14,12,12,8,14,11,12,13,20,10,9,10,11,10,10,10,8,14,9,7,8,5,11,16,D C,101,1,1,20,20,1,1,1,1,1,1,1,1,1,1,20,1,1,1,1,1,1,1,0,0,0,0,0,0,0,0,0,0,0,0,0,0,0,0,0,0,0,0,0,0,0,0,0,0,0,0,0,0,0,0,0,0,0,0,0,0,0,0,0,0,0,0,0,0,0,0,0
29/6/2010,José Manuel Català,67013281,796,1/1/1985,25,0,0,0,0,3364,5800,5800,126,116,2819117,175,72,D LC,3,2,3,2,3,3,3,5,2,3,2,7,10,9,8,10,12,12,13,16,13,11,9,13,10,16,14,13,11,12,8,11,10,4,9,8,12,16,15,14,12,11,10,20,15,12,6,16,11,17,15,13,10,16,10,2,12,16,10,12,10,13,D LC,104,1,1,16,20,1,1,20,10,1,9,12,1,1,1,16,20,11,1,10,1,12,1,35184372089088,0,0,0,0,0,0,0,0,1,0,0,0,0,0,0,0,0,0,0,0,0,0,0,0,0,0,0,0,0,0,0,0,0,0,0,0,0,0,0,0,0,0,0,0,0,1,0,0
29/6/2010,Jörn Neumeister,8724476,771,5/7/1987,23,0,0,0,0,100,4000,4000,95,80,413246,193,87,D C,2,1,3,3,2,3,2,2,1,3,3,7,3,4,5,6,3,9,7,4,13,9,6,13,9,9,12,11,9,11,4,13,7,4,10,6,13,16,10,8,11,10,15,20,5,11,5,8,5,10,3,10,18,10,10,16,10,18,10,11,10,6,D C,101,1,1,20,20,1,1,14,1,1,1,1,1,1,1,20,14,1,1,1,1,1,1,0,0,0,0,0,0,0,0,0,0,0,0,0,0,0,0,0,0,0,0,0,0,0,0,0,0,0,0,0,0,0,0,0,0,0,0,0,0,0,0,0,0,0,0,0,0,0,0,0
29/6/2010,Joris Mathijsen,850104,784,4/5/1980,30,62,3,0,0,5041,7810,7600,148,142,10229091,183,82,D C,2,3,2,2,1,3,3,2,3,3,3,5,6,4,8,8,5,14,5,10,17,7,10,17,7,16,17,16,15,17,10,14,15,5,16,6,18,18,14,7,7,14,12,20,15,14,8,16,15,17,5,15,8,13,14,12,16,13,17,17,16,3,D C,101,1,1,20,20,8,1,12,1,1,1,12,1,1,1,20,12,1,1,1,1,12,1,146028888064,0,0,0,0,0,0,0,0,0,0,0,0,0,0,0,0,0,0,0,0,0,0,0,0,0,0,0,0,0,0,0,0,0,1,0,0,0,1,0,0,0,0,0,0,0,0,0,0
29/6/2010,Jorginho,743131,788,5/29/1978,32,0,0,0,0,2000,5250,5250,110,108,80003,188,76,D LC,3,3,2,2,3,1,2,4,3,1,3,9,10,9,6,7,15,15,14,11,13,10,17,11,10,10,13,11,11,12,10,9,12,8,16,6,13,13,13,13,11,10,13,20,10,12,5,13,10,14,5,15,5,14,5,14,16,13,8,9,8,8,D LC,104,1,1,18,20,10,1,20,1,1,1,10,1,1,1,18,20,1,1,1,1,10,1,0,0,0,0,0,0,0,0,0,0,0,0,0,0,0,0,0,0,0,0,0,0,0,0,0,0,0,0,0,0,0,0,0,0,0,0,0,0,0,0,0,0,0,0,0,0,0,0,0
29/6/2010,Jorge García,1507828,796,1/13/1984,26,0,0,0,0,3250,5500,5500,130,117,1364684,185,79,D C,3,3,2,2,3,1,1,2,3,3,2,7,8,7,8,12,5,16,8,10,14,12,8,15,8,12,12,13,11,11,11,10,10,7,12,7,15,13,17,10,10,13,14,20,13,10,5,13,12,13,11,10,7,9,13,10,9,5,10,10,7,5,D C,101,1,1,20,20,1,1,5,1,1,1,1,1,1,1,20,5,1,1,1,1,1,1,0,0,0,0,0,0,0,0,0,0,0,0,0,0,0,0,0,0,0,0,0,0,0,0,0,0,0,0,0,0,0,0,0,0,0,0,0,0,0,0,0,0,0,0,0,0,0,0,0
29/6/2010,Jordan Lotiès,8427417,769,8/5/1984,25,0,0,0,0,3844,5550,5550,138,124,3166983,190,82,D/DM RC,2,1,2,2,3,1,2,5,1,3,2,5,8,8,6,9,10,14,13,8,13,11,7,12,9,14,15,14,13,11,9,12,13,7,9,9,14,13,14,15,9,15,15,5,17,13,20,15,15,13,14,14,5,11,11,13,14,14,14,13,13,10,D/DM RC,113,1,1,20,20,17,1,1,15,15,1,15,1,1,1,20,1,15,15,1,1,1,15,33024,0,0,0,0,0,0,0,0,1,0,0,0,0,0,0,1,0,0,0,0,0,0,0,0,0,0,0,0,0,0,0,0,0,0,0,0,0,0,0,0,0,0,0,0,0,0,0,0
29/6/2010,Jonny Evans,5005078,785,1/3/1988,22,20,1,3,0,5700,7500,7500,174,151,20739481,188,78,D C,1,1,2,3,3,1,1,2,1,1,2,4,5,7,4,14,4,16,3,9,14,13,5,15,13,12,16,13,13,15,8,14,15,3,12,6,15,15,14,14,14,14,15,14,15,12,20,14,14,16,3,14,3,10,13,14,16,15,17,16,18,6,D C,101,1,1,20,20,1,1,14,1,11,1,1,1,1,1,20,14,11,1,1,1,1,1,274877906944,0,0,0,0,0,0,0,0,0,0,0,0,0,0,0,0,0,0,0,0,0,0,0,0,0,0,0,0,0,0,0,0,0,0,0,0,0,0,1,0,0,0,0,0,0,0,0,0
29/6/2010,Jonathas,19001302,1651,4/10/1985,25,0,0,0,0,500,4550,4550,107,91,258481,188,80,D LC,3,1,2,1,2,3,3,1,1,1,2,9,9,9,7,11,9,13,9,9,11,10,9,10,11,10,10,10,9,8,7,8,10,8,10,9,11,10,9,13,12,14,15,20,15,13,5,13,15,10,9,10,8,11,8,9,5,11,13,11,12,3,D LC,104,1,1,20,20,1,1,17,1,1,10,7,1,1,1,20,17,1,1,1,1,7,1,0,0,0,0,0,0,0,0,0,0,0,0,0,0,0,0,0,0,0,0,0,0,0,0,0,0,0,0,0,0,0,0,0,0,0,0,0,0,0,0,0,0,0,0,0,0,0,0,0
29/6/2010,Jonathan Spector,979165,390,3/1/1986,24,26,0,0,0,3906,6150,6050,136,125,2360231,186,80,D RLC,1,1,1,1,1,1,1,1,1,1,1,3,8,7,10,12,4,12,9,8,14,11,6,14,13,15,12,15,10,12,8,12,15,12,11,11,12,13,12,15,12,14,12,8,13,14,20,13,12,13,12,13,5,15,15,18,14,14,15,12,13,8,D RLC,106,6,6,15,20,12,1,15,10,20,1,12,6,1,1,15,15,20,10,1,1,8,12,4294967300,0,0,1,0,0,0,0,0,0,0,0,0,0,0,0,0,0,0,0,0,0,0,0,0,0,0,0,0,0,0,0,0,1,0,0,0,0,0,0,0,0,0,0,0,0,0,0,0
29/6/2010,Jonathan Rossini,43002969,798,4/5/1989,21,1,0,12,1,1250,5039,5100,149,112,1134719,185,69,D LC,2,2,2,2,2,2,2,2,2,2,2,5,12,4,8,10,4,18,5,12,12,12,8,14,12,12,14,9,10,8,8,10,7,6,13,11,10,12,10,14,14,10,12,20,13,11,7,10,10,12,15,9,7,9,9,10,14,14,13,9,6,9,D LC,104,1,1,20,20,1,1,18,1,1,1,1,1,1,1,20,18,1,1,1,1,1,1,0,0,0,0,0,0,0,0,0,0,0,0,0,0,0,0,0,0,0,0,0,0,0,0,0,0,0,0,0,0,0,0,0,0,0,0,0,0,0,0,0,0,0,0,0,0,0,0,0
29/6/2010,Jonas Olsson,617578,797,3/10/1983,27,1,0,20,1,4422,6500,6650,148,133,5804859,196,86,D C,3,3,3,1,2,1,1,6,1,1,2,2,4,8,7,13,4,14,3,5,13,14,2,14,13,15,13,15,14,14,14,13,17,8,17,11,15,12,14,8,12,12,17,20,15,10,10,15,15,17,14,15,5,10,18,16,16,11,12,7,7,8,D C,101,3,1,20,20,10,1,13,6,2,12,5,1,1,1,20,13,2,6,4,1,5,2,141734019072,0,0,0,0,0,0,0,0,0,0,0,0,0,0,0,1,1,0,0,0,0,0,0,0,0,0,0,0,0,0,0,0,1,0,0,0,0,1,0,0,0,0,0,0,0,0,0,0
29/6/2010,Joleon Lescott,5101074,765,8/16/1982,27,9,0,2,0,5550,7200,7200,158,149,68006999,188,89,D LC,3,1,1,2,2,2,2,1,3,1,2,5,9,9,6,12,5,17,2,10,14,9,2,15,10,13,14,16,14,13,6,13,17,5,11,8,14,16,15,14,12,14,16,20,14,14,12,15,17,15,10,14,11,14,9,17,12,17,14,14,15,10,D LC,104,1,1,20,20,1,1,17,1,1,1,1,1,1,1,20,17,1,1,1,1,1,1,274877906945,1,0,0,0,0,0,0,0,0,0,0,0,0,0,0,0,0,0,0,0,0,0,0,0,0,0,0,0,0,0,0,0,0,0,0,0,0,0,1,0,0,0,0,0,0,0,0,0
29/6/2010,John Terry,108625,765,12/7/1980,29,64,6,9,1,7310,8750,8750,180,171,105617647,187,91,D C,2,2,3,3,2,3,2,7,3,3,2,1,6,9,10,14,4,18,3,4,16,11,11,16,11,16,17,20,15,16,10,16,20,6,20,10,16,20,17,11,11,14,14,16,16,10,20,15,16,16,12,16,14,7,8,18,20,12,19,10,13,13,D C,101,1,1,20,20,1,1,1,1,1,1,1,1,1,1,20,1,1,1,1,1,1,1,131072,0,0,0,0,0,0,0,0,0,0,0,0,0,0,0,0,0,1,0,0,0,0,0,0,0,0,0,0,0,0,0,0,0,0,0,0,0,0,0,0,0,0,0,0,0,0,0,0
29/6/2010,John O'Shea,125120,789,4/30/1981,29,62,1,6,0,5184,7500,7500,145,144,25770181,191,75,D RLC,3,2,2,1,3,1,1,8,1,3,1,5,11,7,10,12,4,16,4,13,16,10,10,14,12,9,13,9,12,15,7,14,13,9,10,12,15,16,14,11,11,15,16,14,13,12,20,15,16,18,3,11,4,19,7,12,18,14,17,17,19,2,D RLC,106,5,1,17,20,10,5,17,8,20,1,10,1,1,1,17,17,20,8,1,1,9,10,274877907008,0,0,0,0,0,0,1,0,0,0,0,0,0,0,0,0,0,0,0,0,0,0,0,0,0,0,0,0,0,0,0,0,0,0,0,0,0,0,1,0,0,0,0,0,0,0,0,0
29/6/2010,John Mensah,121096,21,11/29/1982,27,67,0,0,0,5112,7150,6400,150,143,3758406,180,81,D C,1,1,1,3,3,3,1,4,2,1,3,5,9,7,7,10,7,16,6,13,17,9,8,13,10,14,15,16,14,14,8,13,17,7,13,7,15,14,15,15,11,17,11,8,6,14,20,12,17,14,14,14,18,8,15,15,13,10,13,15,15,10,D C,101,1,1,20,20,1,1,10,1,12,1,12,1,1,1,20,10,12,1,1,1,10,12,32768,0,0,0,0,0,0,0,0,0,0,0,0,0,0,0,1,0,0,0,0,0,0,0,0,0,0,0,0,0,0,0,0,0,0,0,0,0,0,0,0,0,0,0,0,0,0,0,0
29/6/2010,John Heitinga,850009,784,11/15/1983,26,61,6,0,0,5550,7750,7250,160,149,13800000,183,75,D/DM RC,1,3,3,3,3,1,1,5,1,2,1,8,13,11,7,12,7,16,12,10,14,14,13,16,12,17,15,15,12,12,12,12,16,11,16,12,14,14,16,13,15,15,11,15,14,12,20,14,14,14,17,12,13,15,8,15,17,13,16,14,12,4,D/DM RC,113,1,1,20,20,16,1,6,15,19,17,14,1,1,1,20,6,19,15,1,7,6,14,8933531975680,0,0,0,0,0,0,0,0,0,0,0,0,0,0,0,0,0,0,0,0,0,0,0,0,0,0,0,0,0,0,0,0,0,0,0,0,0,1,0,0,0,0,0,1,0,0,0,0
29/6/2010,John Boye,28031632,21,4/23/1987,23,3,0,17,0,2450,5150,2550,140,103,115124,184,69,D C,1,1,1,1,2,1,3,2,1,2,2,5,6,6,8,8,5,16,7,8,13,7,6,11,8,13,14,12,11,11,7,11,10,6,11,7,10,12,14,11,9,14,12,5,14,13,20,15,11,13,13,15,6,10,10,17,10,7,14,13,14,7,D C,101,1,1,20,20,1,1,1,1,1,1,1,1,1,1,20,1,1,1,1,1,1,1,0,0,0,0,0,0,0,0,0,0,0,0,0,0,0,0,0,0,0,0,0,0,0,0,0,0,0,0,0,0,0,0,0,0,0,0,0,0,0,0,0,0,0,0,0,0,0,0,0
29/6/2010,Johan Martial,85038920,769,5/30/1991,19,0,0,0,0,2300,3550,3550,150,108,934787,184,82,D C,3,2,2,2,1,3,3,1,3,2,2,5,7,7,6,9,5,14,7,6,13,7,6,12,9,10,14,14,12,12,6,11,9,6,10,7,12,12,13,12,10,14,13,20,14,10,5,14,14,13,10,14,8,6,14,14,10,11,14,14,14,8,D C,101,1,1,20,20,1,1,10,1,1,1,10,1,1,1,20,10,1,1,1,1,10,1,0,0,0,0,0,0,0,0,0,0,0,0,0,0,0,0,0,0,0,0,0,0,0,0,0,0,0,0,0,0,0,0,0,0,0,0,0,0,0,0,0,0,0,0,0,0,0,0,0
29/6/2010,Johan Djourou,5724377,798,1/18/1987,23,24,1,2,0,4830,7100,6550,166,139,-1,191,89,D C,3,3,3,2,3,1,1,4,3,2,1,2,4,8,3,12,3,16,4,7,14,12,3,15,14,14,14,14,11,13,10,13,11,6,10,8,13,12,14,15,12,13,16,12,14,14,20,15,14,14,6,13,9,10,12,13,15,13,12,15,19,3,D C,101,1,1,20,20,13,1,1,9,11,1,1,1,1,1,20,1,11,9,1,1,1,1,0,0,0,0,0,0,0,0,0,0,0,0,0,0,0,0,0,0,0,0,0,0,0,0,0,0,0,0,0,0,0,0,0,0,0,0,0,0,0,0,0,0,0,0,0,0,0,0,0
29/6/2010,Joël Sami,8426202,53,11/13/1984,25,3,0,0,0,4032,5750,5750,145,127,2600496,190,90,D C,1,2,2,1,2,2,1,3,1,2,1,5,7,7,8,11,6,16,9,6,14,7,7,13,11,12,15,14,11,12,7,13,14,7,13,8,14,14,14,12,6,18,15,5,15,9,20,14,18,13,11,12,9,7,10,16,11,13,13,13,13,7,D C,101,1,1,20,20,1,1,5,1,10,1,1,1,1,1,20,5,10,1,1,1,1,1,32800,0,0,0,0,0,1,0,0,0,0,0,0,0,0,0,1,0,0,0,0,0,0,0,0,0,0,0,0,0,0,0,0,0,0,0,0,0,0,0,0,0,0,0,0,0,0,0,0
29/6/2010,Joël Matip,91018389,11,8/8/1991,18,5,0,0,0,3250,6750,6750,153,125,18995757,193,88,D/DM C,2,3,2,1,1,1,3,4,3,1,3,4,9,9,6,12,5,15,6,13,15,9,7,16,13,10,14,15,9,11,12,8,10,7,6,7,16,17,13,12,8,12,18,12,14,15,20,14,13,13,6,11,5,16,6,7,6,13,14,11,9,14,D/DM C,321,1,1,20,18,20,1,10,15,8,1,1,1,1,1,18,8,8,15,10,1,1,1,1048576,0,0,0,0,0,0,0,0,0,0,0,0,0,0,0,0,0,0,0,0,1,0,0,0,0,0,0,0,0,0,0,0,0,0,0,0,0,0,0,0,0,0,0,0,0,0,0,0
29/6/2010,Jody Craddock,2003835,765,7/25/1975,34,0,0,0,0,3400,6400,6400,125,123,827418,183,77,D C,3,1,1,3,3,2,1,4,1,3,1,3,3,4,7,6,8,15,1,3,13,9,2,15,10,12,14,16,10,11,5,12,14,1,16,10,14,13,12,11,9,13,14,10,14,11,20,14,14,14,5,11,13,4,12,7,17,12,19,17,17,2,D C,101,1,1,20,20,1,1,5,1,1,1,1,1,1,1,20,5,1,1,1,1,1,1,32768,0,0,0,0,0,0,0,0,0,0,0,0,0,0,0,1,0,0,0,0,0,0,0,0,0,0,0,0,0,0,0,0,0,0,0,0,0,0,0,0,0,0,0,0,0,0,0,0
29/6/2010,João Real,742978,788,5/13/1983,27,0,0,0,0,1000,5000,5000,110,102,91689,187,84,D C,3,3,3,3,2,3,3,3,3,1,3,8,8,8,10,11,9,12,10,10,13,9,10,12,11,13,11,12,12,11,9,10,13,7,9,11,12,12,12,12,12,12,13,6,12,11,20,11,12,11,9,10,11,10,8,12,13,11,13,13,13,6,D C,101,1,1,20,20,10,1,1,1,7,7,1,1,1,1,20,1,7,1,1,1,1,1,0,0,0,0,0,0,0,0,0,0,0,0,0,0,0,0,0,0,0,0,0,0,0,0,0,0,0,0,0,0,0,0,0,0,0,0,0,0,0,0,0,0,0,0,0,0,0,0,0
29/6/2010,João Paulo,735574,788,6/6/1981,29,0,0,12,1,4032,5700,5700,135,127,1586517,180,81,D C,3,2,3,3,3,3,2,4,3,3,1,6,8,9,7,10,9,16,11,10,15,11,9,14,10,12,14,14,13,13,8,12,15,7,14,8,14,16,13,12,10,16,12,5,13,11,20,14,16,14,12,12,11,12,12,14,14,12,14,16,16,3,D C,101,1,1,20,20,14,1,1,1,10,1,10,1,1,1,20,1,10,1,1,1,1,10,32768,0,0,0,0,0,0,0,0,0,0,0,0,0,0,0,1,0,0,0,0,0,0,0,0,0,0,0,0,0,0,0,0,0,0,0,0,0,0,0,0,0,0,0,0,0,0,0,0
29/6/2010,João Guilherme,317299,1651,4/21/1986,24,0,0,0,0,3250,5150,5950,139,119,1030690,185,77,D C,2,2,3,2,3,2,2,2,3,1,3,9,9,11,11,11,15,15,15,11,13,11,11,13,13,7,12,9,12,9,10,11,14,12,10,11,13,11,10,14,13,15,16,6,17,13,20,16,15,11,9,11,7,7,13,18,12,10,9,13,15,12,D C,101,1,1,20,20,15,1,3,15,4,7,1,1,1,1,20,3,4,15,1,1,1,1,35184372088832,0,0,0,0,0,0,0,0,0,0,0,0,0,0,0,0,0,0,0,0,0,0,0,0,0,0,0,0,0,0,0,0,0,0,0,0,0,0,0,0,0,0,0,0,0,1,0,0
29/6/2010,Jiri Jarosik,132887,763,10/27/1977,32,23,0,24,4,4556,6500,6250,155,135,3704167,193,87,D/DM C,1,2,1,1,3,2,1,8,1,1,3,5,8,10,12,10,12,15,16,8,13,13,11,15,12,10,17,12,15,16,12,14,11,9,12,11,13,16,13,6,8,18,16,15,12,9,20,13,17,19,13,15,7,13,18,13,17,15,15,12,11,4,D/DM C,321,6,11,20,17,20,1,5,15,5,12,1,11,1,1,17,3,3,15,5,5,1,1,137438953984,0,0,0,0,0,0,0,0,0,1,0,0,0,0,0,0,0,0,0,0,0,0,0,0,0,0,0,0,0,0,0,0,0,0,0,0,0,1,0,0,0,0,0,0,0,0,0,0
29/6/2010,Jesús Gámez,1501035,796,4/10/1985,25,0,0,4,2,5256,7250,7250,157,145,12969412,182,70,D/WB RC,3,2,2,1,3,3,2,2,1,1,1,3,13,9,5,13,4,13,6,14,13,13,7,14,14,14,13,15,14,13,11,12,12,6,18,15,13,14,14,14,14,14,12,11,15,13,20,14,14,17,8,14,8,8,8,16,15,11,12,12,8,5,D/WB RC,113,1,1,18,20,1,1,1,12,20,1,17,1,1,1,18,1,20,1,1,12,1,17,8933531975712,0,0,0,0,0,1,0,0,0,0,0,0,0,0,0,0,0,0,0,0,0,0,0,0,0,0,0,0,0,0,0,0,0,0,0,0,0,1,0,0,0,0,0,1,0,0,0,0
29/6/2010,Jérôme Boateng,35002579,771,9/3/1988,21,10,0,15,1,4750,7200,7200,174,144,34339299,192,90,D/WB RLC,3,2,1,1,1,3,2,3,3,3,2,9,15,11,4,15,6,8,9,18,12,13,8,12,14,6,14,10,17,6,15,13,9,11,10,4,12,13,4,12,11,15,17,18,10,18,20,12,17,8,6,14,7,20,12,13,5,14,10,12,8,11,D/WB RLC,116,3,10,20,20,12,1,17,13,19,1,17,1,10,10,20,17,19,12,13,13,15,17,149812754251904,0,0,0,0,0,0,0,1,0,0,0,0,0,0,0,0,0,0,0,0,0,0,0,0,0,0,0,0,0,0,0,0,1,0,0,0,0,0,1,0,0,0,0,1,0,0,0,1
29/6/2010,Jérémy Toulalan,916258,769,9/10/1983,26,36,0,20,3,6400,7200,7200,167,160,37612993,183,77,D/DM C,3,2,3,3,3,3,1,4,3,2,3,7,11,11,5,13,9,12,11,6,13,14,12,17,13,13,17,18,16,16,13,14,17,6,13,8,14,20,19,14,14,15,11,11,16,11,20,20,15,16,13,15,8,12,7,15,15,15,17,14,14,6,D/DM C,321,1,10,20,18,20,1,1,15,7,1,5,10,1,7,18,1,5,15,1,7,1,5,8933531975936,0,0,0,0,0,0,0,0,1,0,0,0,0,0,0,0,0,0,0,0,0,0,0,0,0,0,0,0,0,0,0,0,0,0,0,0,0,1,0,0,0,0,0,1,0,0,0,0
29/6/2010,Jérémy Sorbon,8440046,769,8/5/1983,26,0,0,0,0,4160,5800,5800,140,129,2534904,183,79,D RC,2,3,3,2,2,3,1,1,1,3,2,5,8,6,8,9,7,15,7,11,16,10,7,14,9,11,15,14,15,14,9,13,16,6,12,8,15,13,15,11,11,16,11,5,16,10,20,16,16,13,11,12,5,10,19,15,14,13,17,14,14,5,D RC,103,1,1,20,20,10,1,1,1,18,1,12,1,1,1,20,1,18,1,1,1,1,12,0,0,0,0,0,0,0,0,0,0,0,0,0,0,0,0,0,0,0,0,0,0,0,0,0,0,0,0,0,0,0,0,0,0,0,0,0,0,0,0,0,0,0,0,0,0,0,0,0
29/6/2010,Jérémy Sapina,8434322,769,2/1/1985,25,0,0,0,0,2916,5450,5000,120,108,299477,187,83,D C,2,1,2,3,3,1,1,2,3,1,2,4,5,8,6,11,2,14,2,9,14,8,10,13,9,13,13,12,13,11,6,12,10,5,15,6,11,15,15,11,7,14,13,8,13,11,20,14,14,14,14,10,7,10,8,3,20,7,7,7,5,13,D C,101,1,1,20,20,1,1,1,1,1,1,1,1,1,1,20,1,1,1,1,1,1,1,0,0,0,0,0,0,0,0,0,0,0,0,0,0,0,0,0,0,0,0,0,0,0,0,0,0,0,0,0,0,0,0,0,0,0,0,0,0,0,0,0,0,0,0,0,0,0,0,0
29/6/2010,Jérémie Bréchet,3502070,769,8/14/1979,30,3,0,0,0,3400,5850,5850,140,131,2674045,186,77,D C,3,2,3,1,3,1,2,3,3,3,1,6,12,8,6,11,6,14,7,10,14,11,7,14,11,10,13,14,14,13,9,13,14,5,16,8,16,14,14,12,11,15,13,20,9,11,8,14,15,16,10,16,12,10,13,14,16,14,17,15,15,6,D C,101,1,1,20,20,10,1,12,10,1,14,12,1,1,1,20,12,1,10,10,1,12,1,0,0,0,0,0,0,0,0,0,0,0,0,0,0,0,0,0,0,0,0,0,0,0,0,0,0,0,0,0,0,0,0,0,0,0,0,0,0,0,0,0,0,0,0,0,0,0,0,0
29/6/2010,Jens Hegeler,92001113,771,1/21/1988,22,0,0,0,0,2100,5900,5900,150,118,1231891,193,85,D/DM/M C,1,2,1,3,3,1,3,1,2,1,3,4,6,10,8,10,7,13,11,6,12,12,8,14,11,12,13,12,9,14,11,13,12,8,9,10,14,14,13,12,10,14,15,9,13,13,20,14,13,12,4,10,4,14,8,10,13,10,12,15,18,2,D/DM/M C,121,1,1,20,20,20,1,1,17,12,1,1,1,1,1,20,1,12,17,1,1,1,1,0,0,0,0,0,0,0,0,0,0,0,0,0,0,0,0,0,0,0,0,0,0,0,0,0,0,0,0,0,0,0,0,0,0,0,0,0,0,0,0,0,0,0,0,0,0,0,0,0
29/6/2010,Jelle Van Damme,533273,757,10/10/1983,26,25,0,4,0,4160,6750,6400,132,129,6500000,194,87,D/WB LC,3,1,2,3,1,2,2,3,1,2,1,10,14,11,14,11,11,17,11,18,14,9,9,16,10,15,11,17,8,15,5,7,16,10,14,15,14,16,17,10,8,16,17,20,13,13,7,14,18,16,14,12,14,14,11,11,7,15,16,10,13,12,D/WB LC,114,8,10,18,20,14,1,20,15,1,1,17,1,10,1,18,20,8,12,15,1,17,1,0,0,0,0,0,0,0,0,0,0,0,0,0,0,0,0,0,0,0,0,0,0,0,0,0,0,0,0,0,0,0,0,0,0,0,0,0,0,0,0,0,0,0,0,0,0,0,0,0
29/6/2010,Jéferson,19108563,1651,1/15/1986,24,0,0,0,0,50,3700,3700,100,83,477330,188,74,D C,1,1,2,2,1,2,1,1,1,1,1,8,4,4,6,8,6,12,4,7,12,6,4,12,6,15,8,9,10,11,4,11,10,4,12,1,7,15,12,12,12,12,10,20,14,12,9,8,8,10,5,10,6,10,13,12,5,10,7,7,3,10,D C,101,1,1,20,20,1,1,1,1,1,1,1,1,1,1,20,1,1,1,1,1,1,1,0,0,0,0,0,0,0,0,0,0,0,0,0,0,0,0,0,0,0,0,0,0,0,0,0,0,0,0,0,0,0,0,0,0,0,0,0,0,0,0,0,0,0,0,0,0,0,0,0
29/6/2010,Jean-Pascal Mignot,916278,769,2/26/1981,29,0,0,0,0,4422,5950,5950,135,133,3207123,183,75,D LC,2,2,2,3,2,1,1,5,1,1,3,5,9,7,7,11,12,16,15,10,15,14,13,14,11,15,13,16,13,13,11,13,14,7,14,7,14,14,16,11,12,14,12,20,13,12,5,14,14,13,11,14,8,8,11,12,16,12,14,14,14,6,D LC,104,1,1,20,20,1,1,17,1,5,1,1,1,1,1,20,17,5,1,1,1,1,1,128,0,0,0,0,0,0,0,1,0,0,0,0,0,0,0,0,0,0,0,0,0,0,0,0,0,0,0,0,0,0,0,0,0,0,0,0,0,0,0,0,0,0,0,0,0,0,0,0
29/6/2010,Jean-Armel Kana-Biyik,34011545,769,7/3/1989,20,0,0,5,1,3450,5309,5300,160,118,3999999,183,86,D LC,3,2,2,1,2,2,3,6,1,2,2,5,10,9,6,11,7,13,8,8,13,7,6,15,11,11,12,13,12,12,6,11,15,8,8,7,12,13,13,15,9,15,11,5,15,14,20,14,15,14,11,16,5,10,9,16,13,15,13,14,14,7,D LC,104,1,1,20,20,1,1,15,1,10,1,15,1,1,1,20,15,10,1,1,1,15,10,0,0,0,0,0,0,0,0,0,0,0,0,0,0,0,0,0,0,0,0,0,0,0,0,0,0,0,0,0,0,0,0,0,0,0,0,0,0,0,0,0,0,0,0,0,0,0,0,0
29/6/2010,Javier Pinola,951247,1649,2/24/1983,27,1,0,0,0,4250,6850,6700,140,134,7463354,178,79,D/WB LC,1,3,1,3,1,3,2,4,3,2,1,11,12,13,7,13,13,11,9,11,11,13,11,16,13,18,12,13,11,12,12,11,14,10,8,5,13,13,16,14,13,13,11,20,14,14,5,17,15,16,16,13,10,1,13,12,8,11,13,10,7,7,D/WB LC,114,1,1,15,20,1,1,20,8,1,1,18,1,1,1,15,20,9,1,8,1,18,1,33,1,0,0,0,0,1,0,0,0,0,0,0,0,0,0,0,0,0,0,0,0,0,0,0,0,0,0,0,0,0,0,0,0,0,0,0,0,0,0,0,0,0,0,0,0,0,0,0
29/6/2010,Javier Malagueño,955665,1649,10/27/1982,27,0,0,0,0,2250,5750,6000,130,121,679642,185,81,D C,1,1,2,3,3,2,2,3,2,3,1,5,7,8,8,11,3,16,5,8,15,13,8,15,10,11,10,14,9,10,9,13,9,7,8,11,14,14,14,8,9,11,13,20,11,8,12,11,14,14,10,11,13,7,11,11,13,13,12,13,3,10,D C,101,1,1,20,20,1,1,1,1,5,1,1,1,1,1,20,1,5,1,1,1,1,1,0,0,0,0,0,0,0,0,0,0,0,0,0,0,0,0,0,0,0,0,0,0,0,0,0,0,0,0,0,0,0,0,0,0,0,0,0,0,0,0,0,0,0,0,0,0,0,0,0
29/6/2010,Javier Cohene,79003177,1655,5/3/1987,23,0,0,0,0,1650,3500,5200,124,104,346879,187,84,D C,2,2,2,2,1,3,2,1,3,3,2,9,6,8,9,11,6,13,9,2,13,8,10,14,8,12,12,14,11,12,8,12,10,6,12,7,11,12,12,11,9,15,14,20,14,11,7,12,14,12,10,10,7,5,10,10,6,11,9,1,3,7,D C,101,1,1,20,20,1,1,1,1,1,10,1,1,1,1,20,1,1,1,1,1,1,1,0,0,0,0,0,0,0,0,0,0,0,0,0,0,0,0,0,0,0,0,0,0,0,0,0,0,0,0,0,0,0,0,0,0,0,0,0,0,0,0,0,0,0,0,0,0,0,0,0
29/6/2010,Jardel,2114077,1651,3/29/1986,24,0,0,0,0,2000,5250,5250,122,107,69842,191,84,D C,3,2,1,3,2,3,2,4,3,2,2,4,6,5,7,11,3,15,6,9,13,12,7,11,7,15,11,13,10,8,5,12,14,10,13,9,14,12,12,6,7,5,16,10,15,9,20,14,14,14,13,12,6,8,13,12,7,11,17,1,2,7,D C,101,1,1,20,20,8,1,1,1,1,5,1,1,1,1,20,1,1,1,1,1,1,1,8589934592,0,0,0,0,0,0,0,0,0,0,0,0,0,0,0,0,0,0,0,0,0,0,0,0,0,0,0,0,0,0,0,0,0,1,0,0,0,0,0,0,0,0,0,0,0,0,0,0
29/6/2010,Jan-Ingwer Callsen-Bracker,8701229,771,9/23/1984,25,0,0,5,0,2150,4500,4500,123,110,718925,189,80,D C,3,3,2,2,1,1,1,1,2,1,3,7,6,5,6,7,6,15,9,6,14,8,8,15,7,9,10,12,9,13,6,11,10,6,6,6,13,14,12,12,8,15,16,5,12,12,20,13,14,12,8,10,5,8,11,12,16,9,11,14,18,3,D C,101,1,1,20,20,12,1,1,1,1,1,1,1,1,1,20,1,1,1,1,1,1,1,0,0,0,0,0,0,0,0,0,0,0,0,0,0,0,0,0,0,0,0,0,0,0,0,0,0,0,0,0,0,0,0,0,0,0,0,0,0,0,0,0,0,0,0,0,0,0,0,0
29/6/2010,Jan Simunek,5654057,763,2/20/1987,23,4,0,5,0,2750,6400,6350,142,126,1699999,187,75,D C,2,2,1,2,3,1,3,2,2,3,3,4,8,5,5,12,4,14,5,7,13,10,5,15,12,8,15,9,14,13,8,13,13,6,12,6,12,16,12,14,13,8,16,6,12,14,20,15,10,13,3,11,5,6,15,10,12,10,16,15,15,4,D C,101,1,1,20,20,1,1,1,1,1,1,1,1,1,1,20,1,1,1,1,1,1,1,0,0,0,0,0,0,0,0,0,0,0,0,0,0,0,0,0,0,0,0,0,0,0,0,0,0,0,0,0,0,0,0,0,0,0,0,0,0,0,0,0,0,0,0,0,0,0,0,0
29/6/2010,Jamie Carragher,2003693,765,1/28/1978,32,38,0,27,1,5476,7800,7800,168,148,3076456,186,78,D RC,2,1,2,1,2,1,2,6,3,2,2,3,7,5,2,11,5,16,3,12,15,11,13,16,12,15,16,20,15,16,7,14,19,2,17,6,14,16,18,10,9,14,13,12,19,10,20,15,18,17,8,17,2,17,5,15,19,15,20,10,14,5,D RC,103,1,1,20,20,10,1,14,1,16,1,1,1,1,1,20,14,16,1,1,1,1,1,281475312386048,0,0,0,0,0,0,0,0,0,0,0,0,0,0,0,0,0,1,0,0,0,0,0,0,0,0,1,0,1,0,0,0,0,0,0,0,0,0,0,0,0,0,0,0,0,0,0,0
29/6/2010,James Collins,5100376,801,8/23/1983,26,34,2,8,0,4500,7000,7000,145,141,14712895,193,90,D C,1,2,2,3,3,2,3,7,2,1,3,5,7,10,9,12,4,17,7,5,13,11,14,16,11,16,11,19,10,13,8,14,14,4,13,8,12,13,13,13,11,13,16,10,11,11,20,14,17,14,7,14,12,10,14,15,14,13,15,18,19,5,D C,101,9,1,20,20,1,1,1,1,1,1,1,1,1,1,20,1,1,1,1,1,1,1,140874927308800,0,0,0,0,0,0,0,0,0,0,0,0,0,0,0,0,0,0,0,0,0,0,0,0,0,0,0,0,0,0,0,0,0,0,0,0,0,1,0,0,0,0,0,0,0,0,0,1
29/6/2010,Jacques Faty,144182,41,2/25/1984,26,3,0,0,0,3969,6300,5650,135,126,3093794,183,75,D RC,2,2,3,2,2,3,3,5,1,2,2,5,9,7,7,11,6,15,8,11,14,9,10,14,11,13,14,14,11,11,7,12,13,8,13,7,13,14,13,13,12,15,12,8,13,12,20,16,14,13,13,14,9,8,12,16,12,9,14,14,15,10,D RC,103,1,1,20,20,12,1,1,1,15,1,15,1,1,1,20,1,15,1,1,1,1,15,32768,0,0,0,0,0,0,0,0,0,0,0,0,0,0,0,1,0,0,0,0,0,0,0,0,0,0,0,0,0,0,0,0,0,0,0,0,0,0,0,0,0,0,0,0,0,0,0,0
29/6/2010,Jack Rodwell,28010312,765,3/11/1991,19,0,0,11,2,4556,7100,7100,172,135,15908261,188,80,D/DM/M C,3,1,2,2,3,2,1,1,1,2,1,4,9,10,9,14,4,14,11,3,13,14,10,14,14,13,12,13,14,11,12,13,12,5,14,8,14,14,14,14,12,14,14,10,15,14,20,16,13,9,7,12,5,10,7,15,13,14,13,11,15,5,D/DM/M C,431,1,1,20,18,18,1,1,20,1,1,1,1,1,1,18,1,1,20,1,1,1,1,32832,0,0,0,0,0,0,1,0,0,0,0,0,0,0,0,1,0,0,0,0,0,0,0,0,0,0,0,0,0,0,0,0,0,0,0,0,0,0,0,0,0,0,0,0,0,0,0,0
29/6/2010,Ivica Dragutinovic,20,802,11/13/1975,34,49,0,0,0,5112,7200,6650,151,143,1166437,186,84,D LC,1,3,1,3,2,1,1,6,3,3,2,11,16,8,7,8,15,16,11,13,14,11,11,14,10,17,16,16,12,15,7,15,16,6,16,12,15,14,15,12,11,15,14,20,14,11,5,15,15,16,12,16,15,13,12,15,9,15,17,12,6,17,D LC,104,1,1,20,20,6,1,19,1,1,1,10,1,1,1,20,19,1,1,1,1,10,1,2203318386688,0,0,0,0,0,0,0,0,0,0,0,0,0,0,0,1,0,1,0,0,0,0,0,0,0,0,0,0,0,0,0,0,1,0,0,0,0,0,0,0,0,1,0,0,0,0,0,0
29/6/2010,Iván Ramis,7444112,796,10/25/1984,25,0,0,0,0,4556,6650,6650,144,135,2742491,188,82,D C,3,2,3,1,1,2,3,3,3,3,1,6,5,6,7,7,12,16,9,9,16,10,7,13,8,15,13,16,12,16,7,8,11,4,9,6,14,16,15,8,10,17,15,13,13,11,20,14,16,16,13,12,6,10,1,20,2,8,15,12,10,4,D C,101,1,1,20,20,6,1,2,1,7,8,1,1,1,1,20,2,7,1,1,1,1,1,35184372121600,0,0,0,0,0,0,0,0,0,0,0,0,0,0,0,1,0,0,0,0,0,0,0,0,0,0,0,0,0,0,0,0,0,0,0,0,0,0,0,0,0,0,0,0,0,1,0,0
29/6/2010,Iván Marcano,67009719,796,6/23/1987,23,0,0,1,0,4830,6850,6850,155,139,7814134,189,78,D LC,1,1,2,1,3,3,2,1,2,2,3,9,12,6,9,7,5,16,7,13,15,12,6,15,10,13,13,17,10,16,7,13,15,6,11,8,13,16,16,11,10,16,15,20,13,13,9,16,15,15,15,13,7,13,16,13,15,14,18,13,13,5,D LC,104,1,1,20,20,5,1,16,4,1,13,8,1,1,1,20,16,1,1,4,1,8,1,0,0,0,0,0,0,0,0,0,0,0,0,0,0,0,0,0,0,0,0,0,0,0,0,0,0,0,0,0,0,0,0,0,0,0,0,0,0,0,0,0,0,0,0,0,0,0,0,0
29/6/2010,Iván Hernández,824380,796,2/27/1980,30,0,0,0,0,3600,5000,5000,127,120,1282896,188,80,D/DM C,3,1,2,2,3,1,1,7,3,1,2,8,8,10,10,13,8,15,10,8,15,14,9,14,11,11,14,10,14,14,14,12,10,12,11,10,13,14,14,11,10,13,14,1,14,11,20,14,15,13,6,10,4,10,7,10,8,14,14,10,17,12,D/DM C,111,1,1,20,20,20,1,1,15,1,1,1,1,1,1,20,1,1,15,1,1,1,1,64,0,0,0,0,0,0,1,0,0,0,0,0,0,0,0,0,0,0,0,0,0,0,0,0,0,0,0,0,0,0,0,0,0,0,0,0,0,0,0,0,0,0,0,0,0,0,0,0
29/6/2010,Iván González,67031046,796,2/15/1988,22,0,0,0,0,3422,5750,5750,145,117,369041,180,72,D C,1,3,3,2,1,1,3,3,3,1,2,3,5,7,5,8,4,14,8,2,11,9,8,12,9,13,12,15,11,11,8,12,12,6,11,8,13,10,12,12,12,14,14,11,10,9,20,13,14,13,11,10,8,7,6,12,15,13,12,12,10,8,D C,101,1,1,20,20,1,1,1,1,1,1,1,1,1,1,20,1,1,1,1,1,1,1,32,0,0,0,0,0,1,0,0,0,0,0,0,0,0,0,0,0,0,0,0,0,0,0,0,0,0,0,0,0,0,0,0,0,0,0,0,0,0,0,0,0,0,0,0,0,0,0,0
29/6/2010,Ivan Fatic,5781384,62002127,8/21/1988,21,4,0,6,0,3306,6000,5500,148,115,767682,188,83,D/WB LC,1,1,1,1,1,1,1,1,1,1,1,15,13,11,7,11,14,11,16,7,14,14,15,13,14,11,10,7,11,11,12,11,13,8,10,13,13,12,12,11,15,10,12,20,7,12,5,11,12,10,8,13,7,15,15,12,7,8,13,19,7,7,D/WB LC,114,1,1,15,20,1,1,20,10,1,1,20,1,1,1,15,20,9,1,10,1,20,1,35253091566080,0,0,0,0,0,0,0,0,0,1,0,0,0,0,0,0,0,0,0,0,0,0,0,0,0,0,0,0,0,0,0,0,0,0,0,0,1,0,0,0,0,0,0,0,0,1,0,0
29/6/2010,Iván Córdoba,3100676,1653,8/11/1976,33,71,5,11,1,5625,7400,7450,167,150,3920683,173,70,D C,1,1,1,1,1,1,1,1,1,1,1,3,5,6,9,4,3,17,5,15,16,7,9,16,5,17,16,16,12,13,6,11,18,3,18,8,14,17,17,17,15,15,9,9,15,17,20,15,14,15,16,15,12,13,18,15,18,14,18,13,11,5,D C,101,1,1,20,20,1,1,12,1,13,5,1,1,1,1,20,12,13,1,1,1,1,1,12884934656,0,0,0,0,0,0,0,0,0,0,0,0,0,0,0,1,0,0,0,0,0,0,0,0,0,0,0,0,0,0,0,0,1,1,0,0,0,0,0,0,0,0,0,0,0,0,0,0
29/6/2010,Ismaël Gacé,8431694,769,9/19/1986,23,0,0,0,0,1000,5000,5000,135,111,3956188,180,77,D LC,1,1,1,2,1,1,2,6,1,1,1,5,7,6,6,8,7,14,9,10,14,7,6,11,8,13,14,14,12,12,8,11,14,6,9,7,12,12,14,11,9,14,10,20,9,13,8,14,14,14,13,10,10,10,13,11,13,6,10,13,7,5,D LC,104,1,1,18,20,1,1,20,1,1,1,15,1,1,1,18,20,5,1,1,1,15,1,32832,0,0,0,0,0,0,1,0,0,0,0,0,0,0,0,1,0,0,0,0,0,0,0,0,0,0,0,0,0,0,0,0,0,0,0,0,0,0,0,0,0,0,0,0,0,0,0,0
29/6/2010,Isaac Vorsah,12010808,21,6/21/1988,22,4,0,0,0,4000,7000,6700,152,134,3916459,192,85,D C,3,2,2,3,3,1,1,7,3,2,3,4,6,5,5,8,5,11,6,14,16,7,5,15,7,15,13,18,8,12,7,9,13,4,10,6,14,16,17,14,8,16,18,9,11,18,20,15,18,10,14,10,12,12,13,14,12,12,8,15,16,6,D C,101,1,1,20,20,14,1,1,10,1,1,1,1,1,1,20,1,1,10,1,1,1,1,0,0,0,0,0,0,0,0,0,0,0,0,0,0,0,0,0,0,0,0,0,0,0,0,0,0,0,0,0,0,0,0,0,0,0,0,0,0,0,0,0,0,0,0,0,0,0,0,0
29/6/2010,Ion Ansotegi,823758,796,7/13/1982,27,0,0,0,0,4032,6000,6000,137,127,4306506,192,80,D C,3,3,1,3,2,3,3,3,3,2,2,3,4,7,10,9,2,16,5,6,14,9,5,15,9,12,14,14,13,13,8,12,12,3,14,5,16,12,11,10,8,11,17,6,14,14,20,12,13,13,6,12,5,4,17,13,15,14,15,14,10,5,D C,101,1,1,20,20,1,1,1,1,1,1,1,1,1,1,20,1,1,1,1,1,1,1,0,0,0,0,0,0,0,0,0,0,0,0,0,0,0,0,0,0,0,0,0,0,0,0,0,0,0,0,0,0,0,0,0,0,0,0,0,0,0,0,0,0,0,0,0,0,0,0,0
29/6/2010,Iñigo Martínez,67104772,796,5/17/1991,19,0,0,0,0,1482,3550,3550,143,77,1308726,186,83,D/DM C,1,3,2,2,1,3,2,1,3,1,1,2,2,3,5,4,4,8,9,7,10,8,3,12,9,12,13,11,12,12,9,11,7,11,13,5,11,12,11,11,13,12,10,20,17,10,9,11,12,10,12,11,8,10,7,11,9,10,13,7,8,8,D/DM C,111,1,1,20,20,16,1,8,15,1,1,1,1,1,1,20,8,1,15,1,1,1,1,0,0,0,0,0,0,0,0,0,0,0,0,0,0,0,0,0,0,0,0,0,0,0,0,0,0,0,0,0,0,0,0,0,0,0,0,0,0,0,0,0,0,0,0,0,0,0,0,0
29/6/2010,Igor,19089312,1651,3/10/1989,21,0,0,0,0,750,4850,4850,125,97,43993,189,77,D LC,3,1,1,3,3,3,2,6,2,3,2,7,9,10,4,11,3,14,5,10,13,12,10,12,14,14,9,10,13,14,9,10,10,13,15,10,8,15,15,14,14,14,10,20,17,14,10,11,5,10,5,10,6,10,9,5,5,7,9,4,4,5,D LC,104,1,1,20,20,1,1,15,1,1,1,14,1,1,1,20,15,1,1,1,1,14,1,4194304,0,0,0,0,0,0,0,0,0,0,0,0,0,0,0,0,0,0,0,0,0,0,1,0,0,0,0,0,0,0,0,0,0,0,0,0,0,0,0,0,0,0,0,0,0,0,0,0
29/6/2010,Igor Lolo,8626845,24,7/22/1982,27,9,0,1,0,3600,6029,6000,140,134,3759444,180,77,D/WB RC,2,3,3,2,3,1,3,1,2,3,3,10,15,12,7,12,10,14,11,11,12,12,7,14,14,18,14,13,11,11,12,11,14,12,10,12,11,14,15,14,13,14,10,12,15,13,20,13,14,14,18,8,8,10,11,13,14,14,11,13,15,7,D/WB RC,113,1,1,16,20,12,1,1,1,20,1,18,1,1,1,16,11,20,1,1,1,1,18,65696,0,0,0,0,0,1,0,1,0,0,0,0,0,0,0,0,1,0,0,0,0,0,0,0,0,0,0,0,0,0,0,0,0,0,0,0,0,0,0,0,0,0,0,0,0,0,0,0
29/6/2010,Ibrahim Kas,8491444,799,9/20/1986,23,7,0,7,0,3600,6000,5650,135,120,1516368,185,79,D RC,1,1,2,3,3,3,1,3,3,3,1,7,9,8,7,11,8,14,8,6,13,8,5,14,11,16,11,17,11,10,6,9,14,5,11,11,11,14,17,14,13,12,12,10,12,14,20,14,14,11,17,6,8,10,8,5,5,13,13,4,3,15,D RC,103,1,1,20,20,1,1,1,1,15,10,1,1,1,1,20,1,15,1,1,1,1,1,65536,0,0,0,0,0,0,0,0,0,0,0,0,0,0,0,0,1,0,0,0,0,0,0,0,0,0,0,0,0,0,0,0,0,0,0,0,0,0,0,0,0,0,0,0,0,0,0,0
29/6/2010,Ian Evatt,122718,765,11/19/1981,28,0,0,0,0,3100,5850,5850,124,119,2737598,190,89,D C,6,3,2,4,2,8,1,3,3,2,2,3,6,7,6,12,4,16,4,6,14,10,5,14,12,14,13,15,12,12,8,13,12,5,14,5,12,15,13,9,5,11,16,5,13,9,20,15,16,14,7,14,4,11,8,10,19,17,15,16,9,11,D C,101,1,1,20,20,1,1,1,1,1,10,1,1,1,1,20,1,1,1,1,1,1,1,32768,0,0,0,0,0,0,0,0,0,0,0,0,0,0,0,1,0,0,0,0,0,0,0,0,0,0,0,0,0,0,0,0,0,0,0,0,0,0,0,0,0,0,0,0,0,0,0,0
29/6/2010,Hugo,707881,788,8/11/1976,33,0,0,0,0,2000,5300,5300,106,105,54037,182,78,D C,2,3,3,3,1,2,2,1,1,2,3,4,5,6,5,6,8,13,9,10,13,7,9,12,5,16,11,14,12,16,5,10,15,4,11,7,13,15,14,8,8,14,13,8,15,9,20,14,15,12,13,10,7,14,8,15,14,9,13,14,11,8,D C,101,1,1,20,20,10,1,1,5,5,1,1,1,1,1,20,1,5,5,1,1,1,1,98304,0,0,0,0,0,0,0,0,0,0,0,0,0,0,0,1,1,0,0,0,0,0,0,0,0,0,0,0,0,0,0,0,0,0,0,0,0,0,0,0,0,0,0,0,0,0,0,0
29/6/2010,Hugo Campagnaro,6300344,1649,6/27/1980,30,0,0,0,0,2750,6479,7250,154,144,20108977,180,85,D RC,2,1,1,1,3,1,3,3,1,3,2,7,6,15,10,10,8,12,7,12,11,10,10,17,14,17,16,20,12,13,12,14,15,8,14,14,13,16,15,15,15,11,12,5,13,13,20,11,16,14,12,13,18,16,10,10,16,8,12,5,6,6,D RC,103,1,1,20,20,12,1,1,1,20,1,15,1,1,1,20,5,20,1,1,1,1,15,8,0,0,0,1,0,0,0,0,0,0,0,0,0,0,0,0,0,0,0,0,0,0,0,0,0,0,0,0,0,0,0,0,0,0,0,0,0,0,0,0,0,0,0,0,0,0,0,0
29/6/2010,Holger Badstuber,35016427,771,3/13/1989,21,4,0,8,2,4500,7750,7750,163,143,22251810,189,78,D C,3,2,1,2,1,1,2,4,2,3,3,14,13,5,6,11,14,10,7,12,16,13,12,16,9,17,14,16,15,17,8,14,14,4,8,6,17,18,10,9,7,14,16,20,17,17,8,15,12,16,14,9,6,15,7,5,15,13,16,16,16,5,D C,101,1,1,20,20,12,1,14,2,6,3,10,1,1,1,20,14,6,1,2,1,10,3,25769836608,0,0,0,0,0,0,1,0,0,0,0,0,0,0,0,1,0,0,0,0,0,0,0,0,0,0,0,0,0,0,0,0,0,1,1,0,0,0,0,0,0,0,0,0,0,0,0,0
29/6/2010,Hilton,3301316,1651,9/13/1977,32,0,0,0,0,4761,6200,6200,150,138,1641333,182,73,D C,2,2,2,1,1,3,3,10,3,2,3,5,9,11,7,12,7,15,9,11,14,11,10,16,13,12,17,15,16,13,11,14,16,6,15,9,15,14,15,12,11,15,11,8,14,10,20,14,15,15,12,13,8,10,15,15,14,14,18,13,13,8,D C,101,1,1,20,20,12,1,1,10,1,16,1,1,1,1,20,1,1,10,1,1,1,1,137438953472,0,0,0,0,0,0,0,0,0,0,0,0,0,0,0,0,0,0,0,0,0,0,0,0,0,0,0,0,0,0,0,0,0,0,0,0,0,1,0,0,0,0,0,0,0,0,0,0
29/6/2010,Hernán Pellerano,956747,1649,6/4/1984,26,0,0,0,0,3500,6250,6250,148,137,2742351,183,72,D RC,3,3,1,1,1,3,1,3,2,1,3,4,6,7,2,10,3,17,6,8,15,9,5,16,8,16,12,15,13,15,6,12,16,5,13,8,11,14,13,15,13,15,12,8,15,15,20,14,15,13,9,15,6,11,14,13,15,16,15,15,11,12,D RC,103,1,1,20,20,1,1,1,1,15,10,1,1,1,1,20,1,15,1,1,1,1,1,137438953472,0,0,0,0,0,0,0,0,0,0,0,0,0,0,0,0,0,0,0,0,0,0,0,0,0,0,0,0,0,0,0,0,0,0,0,0,0,1,0,0,0,0,0,0,0,0,0,0
29/6/2010,Hérita Ilunga,144178,53,2/25/1982,28,18,1,1,0,3750,6650,6700,142,134,8557013,180,74,D LC,1,3,3,3,2,3,2,1,1,1,3,11,11,11,5,13,8,12,9,12,14,9,7,14,11,14,12,15,13,14,8,13,14,8,11,9,13,13,13,14,12,12,12,20,14,14,11,16,14,14,17,6,6,8,10,13,13,13,13,13,15,7,D LC,104,1,1,16,20,1,1,20,1,10,1,15,1,1,1,16,20,10,1,1,1,15,10,0,0,0,0,0,0,0,0,0,0,0,0,0,0,0,0,0,0,0,0,0,0,0,0,0,0,0,0,0,0,0,0,0,0,0,0,0,0,0,0,0,0,0,0,0,0,0,0,0
29/6/2010,Henrique,2116459,1651,10/14/1986,23,3,0,0,0,4422,6750,6750,155,133,1844412,185,78,D C,1,3,2,2,1,2,1,7,3,2,1,3,6,7,6,12,13,15,12,5,15,12,11,14,11,11,12,14,13,11,9,13,14,12,13,7,14,13,13,13,14,14,13,9,14,14,20,12,13,11,6,14,7,10,12,11,12,14,14,13,11,5,D C,101,1,1,20,20,1,1,1,1,12,1,1,1,1,1,20,1,12,1,1,1,1,1,35184372121600,0,0,0,0,0,0,0,0,0,0,0,0,0,0,0,1,0,0,0,0,0,0,0,0,0,0,0,0,0,0,0,0,0,0,0,0,0,0,0,0,0,0,0,0,0,1,0,0
29/6/2010,Henrique Sereno,8876190,788,5/18/1985,25,0,0,1,0,350,6250,6250,140,122,5184337,187,78,D C,1,2,1,3,1,2,3,5,3,3,2,8,8,9,8,12,8,14,9,9,14,9,10,12,10,13,14,14,12,14,8,8,13,6,12,9,13,14,15,16,14,14,15,5,14,16,20,12,11,15,11,10,13,14,11,11,11,10,15,16,16,5,D C,101,1,1,20,20,1,1,13,1,10,10,1,1,1,1,20,13,10,1,1,1,1,1,274877906944,0,0,0,0,0,0,0,0,0,0,0,0,0,0,0,0,0,0,0,0,0,0,0,0,0,0,0,0,0,0,0,0,0,0,0,0,0,0,1,0,0,0,0,0,0,0,0,0
29/6/2010,Hélder Rosário,734300,788,3/9/1980,30,0,0,0,0,4032,5750,5750,142,127,3449957,180,81,D C,2,3,3,2,1,3,2,5,1,3,1,6,7,6,8,9,10,16,7,12,18,12,8,17,9,16,16,16,10,16,7,10,15,6,10,10,15,15,15,8,10,13,12,6,4,13,20,14,16,15,14,10,14,12,14,14,11,11,13,12,6,13,D C,101,1,1,20,20,14,1,8,10,14,1,1,1,1,1,20,8,14,10,1,1,1,1,32776,0,0,0,1,0,0,0,0,0,0,0,0,0,0,0,1,0,0,0,0,0,0,0,0,0,0,0,0,0,0,0,0,0,0,0,0,0,0,0,0,0,0,0,0,0,0,0,0
29/6/2010,Heiko Westermann,885406,771,8/14/1983,26,18,2,2,0,5700,7400,7400,154,151,16932498,190,80,D/M RLC,1,3,2,1,3,3,2,5,2,2,1,6,9,8,15,7,10,17,11,14,12,8,6,13,7,15,9,17,13,16,9,12,18,5,15,15,10,18,17,14,9,15,17,17,18,16,20,18,17,16,3,17,6,18,5,14,18,13,20,18,13,3,D/M RLC,116,5,1,20,20,14,1,16,16,18,1,14,1,1,1,20,16,18,16,1,1,12,14,274877907490,0,1,0,0,0,1,0,0,0,1,0,0,0,0,0,0,0,0,0,0,0,0,0,0,0,0,0,0,0,0,0,0,0,0,0,0,0,0,1,0,0,0,0,0,0,0,0,0
29/6/2010,Heiko Butscher,877015,771,7/28/1980,29,0,0,0,0,4000,6400,6400,140,135,2560052,189,86,D LC,2,3,3,1,2,2,1,2,2,3,2,8,9,8,11,9,6,17,12,9,16,8,12,16,11,13,12,12,12,12,6,12,14,7,17,12,12,15,14,12,12,13,17,20,15,11,10,13,15,14,8,15,3,14,15,12,16,13,13,14,10,5,D LC,104,1,1,20,20,1,1,18,1,1,1,9,1,1,1,20,18,1,1,1,1,9,1,32768,0,0,0,0,0,0,0,0,0,0,0,0,0,0,0,1,0,0,0,0,0,0,0,0,0,0,0,0,0,0,0,0,0,0,0,0,0,0,0,0,0,0,0,0,0,0,0,0
29/6/2010,Hedwiges Maduro,856953,784,2/13/1985,25,12,0,0,0,4422,6750,6500,143,133,2889198,185,79,D/DM C,1,3,3,2,1,3,3,4,1,2,2,5,12,11,10,15,13,15,11,10,15,13,16,12,11,13,15,16,15,12,12,13,13,10,14,9,14,16,13,10,11,16,13,11,13,11,20,15,13,14,12,12,11,13,10,14,15,14,12,13,7,12,D/DM C,321,1,1,20,16,20,1,5,15,10,7,3,1,1,1,16,5,10,15,1,1,1,3,0,0,0,0,0,0,0,0,0,0,0,0,0,0,0,0,0,0,0,0,0,0,0,0,0,0,0,0,0,0,0,0,0,0,0,0,0,0,0,0,0,0,0,0,0,0,0,0,0
29/6/2010,Héctor Rodas,67010170,796,3/7/1988,22,0,0,0,0,3721,5600,5600,142,122,1440191,190,80,D C,2,2,1,1,1,1,3,1,3,1,3,5,6,7,6,8,7,14,8,7,13,9,8,14,8,14,15,16,13,13,8,11,13,9,12,8,13,14,13,11,10,13,15,4,14,12,20,14,13,15,12,14,6,8,14,15,16,12,15,13,12,12,D C,101,1,1,20,20,1,1,1,1,5,8,1,1,1,1,20,1,5,1,1,1,1,1,0,0,0,0,0,0,0,0,0,0,0,0,0,0,0,0,0,0,0,0,0,0,0,0,0,0,0,0,0,0,0,0,0,0,0,0,0,0,0,0,0,0,0,0,0,0,0,0,0
29/6/2010,Hauke Brückner,880684,771,2/29/1980,30,0,0,0,0,250,3750,3750,100,75,227948,182,76,D/DM/M C,3,3,1,3,1,2,2,3,2,3,2,5,3,8,7,7,8,11,8,0,9,11,3,10,7,5,10,9,6,7,6,8,10,4,7,5,12,12,13,11,11,11,9,12,13,12,20,11,11,10,13,10,12,10,5,13,18,7,10,13,11,13,D/DM/M C,331,1,1,20,17,20,1,10,18,11,1,11,1,1,1,17,10,11,18,1,1,10,11,0,0,0,0,0,0,0,0,0,0,0,0,0,0,0,0,0,0,0,0,0,0,0,0,0,0,0,0,0,0,0,0,0,0,0,0,0,0,0,0,0,0,0,0,0,0,0,0,0
29/6/2010,Guy Demel,910017,24,6/13/1981,29,18,0,0,0,4761,6209,6900,142,138,31636329,189,85,D RLC,3,2,2,3,2,3,2,2,1,1,1,6,9,12,5,12,5,10,8,15,14,10,7,15,13,12,15,16,8,14,8,9,15,8,12,9,14,16,15,12,11,17,15,8,10,15,20,13,18,10,16,13,16,17,13,10,14,7,10,9,8,8,D RLC,106,1,1,17,20,15,1,15,15,20,1,14,1,1,1,17,15,20,15,1,12,14,14,1116826763272,0,0,0,1,0,0,0,0,0,0,0,0,0,0,0,0,0,0,0,0,1,0,0,0,0,0,0,1,0,0,0,0,0,0,1,0,0,0,0,0,1,0,0,0,0,0,0,0
29/6/2010,Gustavo,3301003,1651,2/19/1982,28,0,0,0,0,2750,6050,6050,132,121,1592683,187,81,D C,2,1,2,2,2,3,3,2,3,3,1,1,7,6,8,9,3,14,3,4,14,10,9,13,10,15,13,15,13,12,10,12,15,7,15,8,12,15,14,12,12,15,14,5,15,12,20,14,15,16,13,15,6,13,6,13,10,14,13,11,11,16,D C,101,1,1,20,20,1,1,1,1,12,11,1,1,1,1,20,1,12,1,1,1,1,1,0,0,0,0,0,0,0,0,0,0,0,0,0,0,0,0,0,0,0,0,0,0,0,0,0,0,0,0,0,0,0,0,0,0,0,0,0,0,0,0,0,0,0,0,0,0,0,0,0
29/6/2010,Guirane N'Daw,8425476,41,4/24/1984,26,31,2,0,0,3782,6150,5500,135,123,6399220,190,78,D/DM C,3,2,2,1,3,1,2,5,2,1,1,5,11,8,8,10,13,14,15,12,14,10,8,14,10,13,13,16,9,12,8,10,15,12,12,9,13,15,15,13,8,17,15,20,14,10,8,16,17,11,13,14,7,12,14,15,12,9,13,13,11,12,D/DM C,321,1,1,20,18,20,1,14,15,1,1,14,1,1,1,18,14,1,15,1,1,14,1,35184372089600,0,0,0,0,0,0,0,0,1,1,0,0,0,0,0,0,0,0,0,0,0,0,0,0,0,0,0,0,0,0,0,0,0,0,0,0,0,0,0,0,0,0,0,0,0,1,0,0
29/6/2010,Guillermo Burdisso,965278,1649,9/26/1988,21,1,1,0,0,4000,6500,6500,163,136,3657845,187,86,D C,2,3,1,3,1,1,1,7,1,1,1,4,7,9,8,11,5,15,7,11,16,11,5,14,10,13,18,14,13,12,9,12,16,6,11,12,14,12,14,13,12,12,15,6,14,13,20,14,13,13,8,14,7,2,8,15,12,14,15,15,10,8,D C,101,1,1,20,20,1,1,1,1,1,5,1,1,1,1,20,1,1,1,1,1,1,1,0,0,0,0,0,0,0,0,0,0,0,0,0,0,0,0,0,0,0,0,0,0,0,0,0,0,0,0,0,0,0,0,0,0,0,0,0,0,0,0,0,0,0,0,0,0,0,0,0
29/6/2010,Guglielmo Stendardo,3804725,776,5/6/1981,29,0,0,0,0,4500,6500,6500,140,136,7118887,190,89,D C,2,3,3,2,3,2,2,5,3,3,1,4,4,5,9,7,2,18,5,14,16,9,6,15,5,15,12,16,12,12,7,12,14,4,14,14,15,13,14,10,10,17,15,5,12,10,20,15,18,11,14,12,8,7,14,15,10,10,12,10,16,16,D C,101,1,1,20,20,1,1,1,1,1,1,1,1,1,1,20,1,1,1,1,1,1,1,8796093022208,0,0,0,0,0,0,0,0,0,0,0,0,0,0,0,0,0,0,0,0,0,0,0,0,0,0,0,0,0,0,0,0,0,0,0,0,0,0,0,0,0,0,0,1,0,0,0,0
29/6/2010,Gregory,8873727,769,11/10/1980,29,0,0,0,0,1750,3000,5000,139,138,2059238,187,89,D C,1,3,2,2,2,2,1,1,3,1,1,6,7,6,6,7,8,17,8,12,15,9,7,15,7,16,15,17,11,14,9,13,15,5,10,14,15,15,16,10,10,16,16,3,16,10,20,16,17,13,10,12,7,12,12,15,14,13,14,15,13,7,D C,101,1,1,20,20,10,1,1,5,5,5,1,1,1,1,20,1,5,5,1,1,1,1,98368,0,0,0,0,0,0,1,0,0,0,0,0,0,0,0,1,1,0,0,0,0,0,0,0,0,0,0,0,0,0,0,0,0,0,0,0,0,0,0,0,0,0,0,0,0,0,0,0
29/6/2010,Grégory Paisley,3500639,769,5/7/1977,33,0,0,0,0,1350,5650,5650,135,127,1947788,185,85,D LC,2,1,1,3,2,1,1,4,2,3,1,8,11,8,6,9,6,14,14,8,14,9,7,13,9,11,14,15,13,13,7,11,14,6,13,7,13,13,15,14,11,15,12,20,13,13,7,14,15,14,11,13,10,7,8,14,12,12,14,14,14,12,D LC,104,1,1,20,20,1,1,16,1,1,1,12,1,1,1,20,16,1,1,1,1,12,1,0,0,0,0,0,0,0,0,0,0,0,0,0,0,0,0,0,0,0,0,0,0,0,0,0,0,0,0,0,0,0,0,0,0,0,0,0,0,0,0,0,0,0,0,0,0,0,0,0
29/6/2010,Grégory Lorenzi,916230,769,12/17/1983,26,0,0,0,0,1000,5200,5200,125,116,1032030,186,86,D C,1,1,1,1,3,2,2,3,3,1,3,5,6,7,8,10,11,16,11,7,14,8,12,13,10,14,13,14,13,13,7,12,15,5,12,7,12,14,15,11,7,15,13,20,15,8,5,14,15,14,14,16,6,8,15,12,14,13,15,15,15,7,D C,101,1,1,20,20,1,1,10,1,1,1,1,1,1,1,20,10,1,1,1,1,1,1,8388640,0,0,0,0,0,1,0,0,0,0,0,0,0,0,0,0,0,0,0,0,0,0,0,1,0,0,0,0,0,0,0,0,0,0,0,0,0,0,0,0,0,0,0,0,0,0,0,0
29/6/2010,Grégory Leca,3503905,769,8/22/1980,29,0,0,0,0,1350,5700,5700,135,127,2522435,183,84,D C,2,3,3,1,2,1,3,1,3,1,2,8,8,8,6,12,12,15,12,7,13,13,7,14,12,14,15,14,15,13,11,12,14,7,14,7,15,15,15,10,9,15,11,10,13,8,20,14,15,13,7,14,8,8,13,12,14,13,14,14,13,7,D C,101,1,1,20,20,13,1,1,10,1,1,1,1,1,1,20,1,1,10,1,1,1,1,0,0,0,0,0,0,0,0,0,0,0,0,0,0,0,0,0,0,0,0,0,0,0,0,0,0,0,0,0,0,0,0,0,0,0,0,0,0,0,0,0,0,0,0,0,0,0,0,0
29/6/2010,Grégory Bourillon,919543,769,7/1/1984,25,0,0,16,0,1050,5500,5500,136,123,3399998,187,74,D C,3,3,3,3,1,3,3,6,2,1,3,5,8,8,5,11,12,15,10,7,13,11,7,13,11,10,15,14,9,12,10,12,14,5,9,6,14,17,15,13,11,15,13,8,13,11,20,15,13,12,10,14,8,8,5,14,14,7,15,15,15,5,D C,101,1,1,20,20,15,1,1,15,8,1,5,1,1,1,20,1,5,15,1,8,1,5,0,0,0,0,0,0,0,0,0,0,0,0,0,0,0,0,0,0,0,0,0,0,0,0,0,0,0,0,0,0,0,0,0,0,0,0,0,0,0,0,0,0,0,0,0,0,0,0,0
29/6/2010,Granddi Ngoyi,152601,769,5/17/1988,22,0,0,5,0,3540,5350,5350,140,119,767033,186,77,D/DM C,2,3,1,2,2,1,2,1,3,1,1,6,8,10,6,12,5,15,10,7,13,12,8,12,12,12,14,14,12,12,11,11,13,7,9,7,12,16,15,12,11,15,14,8,15,10,20,16,15,12,12,12,5,8,18,13,16,11,14,14,15,6,D/DM C,321,1,1,20,16,20,1,1,15,1,1,1,1,1,1,16,1,1,15,1,1,1,1,0,0,0,0,0,0,0,0,0,0,0,0,0,0,0,0,0,0,0,0,0,0,0,0,0,0,0,0,0,0,0,0,0,0,0,0,0,0,0,0,0,0,0,0,0,0,0,0,0
29/6/2010,Gonzalo Rodríguez,951032,1649,4/10/1984,26,6,1,0,0,5041,7810,7800,152,142,17578340,182,76,D C,3,2,3,1,3,2,3,7,2,1,3,9,8,12,9,13,8,16,10,11,17,13,7,16,12,17,16,18,14,15,11,13,18,7,16,7,18,14,16,12,11,17,11,5,9,13,20,14,10,16,14,15,17,11,17,17,15,16,15,13,8,10,D C,101,1,1,20,20,3,1,2,1,7,15,1,1,1,1,20,2,7,1,1,1,1,1,32768,0,0,0,0,0,0,0,0,0,0,0,0,0,0,0,1,0,0,0,0,0,0,0,0,0,0,0,0,0,0,0,0,0,0,0,0,0,0,0,0,0,0,0,0,0,0,0,0
29/6/2010,Gonzalo Jara,5250132,1652,8/23/1985,24,38,3,0,0,4624,7000,6750,145,136,6550116,178,76,D/DM/M RLC,3,1,1,1,2,2,1,4,3,2,2,5,8,10,8,12,8,14,10,10,14,13,5,15,11,15,13,14,11,12,12,12,15,10,13,10,16,15,15,10,13,13,11,14,14,11,20,14,13,14,15,13,8,17,11,14,13,12,13,12,7,6,D/DM/M RLC,126,1,1,20,20,19,1,17,16,20,18,15,1,1,1,20,17,20,16,1,15,12,15,16810048,0,0,0,0,0,0,1,0,0,0,0,0,0,0,0,1,0,0,0,0,0,0,0,0,1,0,0,0,0,0,0,0,0,0,0,0,0,0,0,0,0,0,0,0,0,0,0,0
29/6/2010,Gojko Kacar,5779401,802,1/26/1987,23,18,0,15,8,5041,6900,6750,163,142,12432500,183,77,DM/M C,1,2,3,1,2,2,2,4,3,2,1,7,10,14,16,9,9,17,13,12,17,10,9,17,14,18,14,18,12,8,15,16,18,10,13,17,9,12,19,10,13,17,16,11,6,15,20,10,13,11,9,15,12,20,16,17,8,12,9,10,7,6,DM/M C,311,12,10,20,15,20,1,1,19,14,1,11,10,1,1,15,1,10,19,1,14,1,11,8933531976228,0,0,1,0,0,1,0,0,0,1,0,0,0,0,0,0,0,0,0,0,0,0,0,0,0,0,0,0,0,0,0,0,0,0,0,0,0,1,0,0,0,0,0,1,0,0,0,0
29/6/2010,Giuseppe Biava,3802481,776,5/8/1977,33,0,0,0,0,4500,6950,6950,148,137,2931372,180,73,D C,1,1,1,2,2,1,1,10,3,3,2,2,4,4,6,8,2,15,2,5,15,12,3,17,12,14,17,16,12,15,9,12,17,10,14,9,16,13,16,12,13,14,12,8,13,13,20,14,13,15,15,11,7,8,9,8,18,12,17,17,14,5,D C,101,1,1,20,20,1,1,9,1,12,15,7,1,1,1,20,9,12,1,1,1,3,7,32840,0,0,0,1,0,0,1,0,0,0,0,0,0,0,0,1,0,0,0,0,0,0,0,0,0,0,0,0,0,0,0,0,0,0,0,0,0,0,0,0,0,0,0,0,0,0,0,0
29/6/2010,Giuseppe Bellusci,43000005,776,8/21/1989,20,0,0,5,0,3422,5750,5750,148,117,4267935,185,81,D RC,1,2,3,1,3,2,3,2,2,3,3,5,10,8,5,5,5,15,5,11,15,10,5,15,10,16,13,12,10,14,10,14,16,5,8,9,15,11,11,13,10,11,13,5,18,10,20,10,15,10,16,10,2,12,9,15,13,10,16,11,9,7,D RC,103,1,1,20,20,1,1,1,1,15,1,1,1,1,1,20,1,15,1,1,1,1,1,32768,0,0,0,0,0,0,0,0,0,0,0,0,0,0,0,1,0,0,0,0,0,0,0,0,0,0,0,0,0,0,0,0,0,0,0,0,0,0,0,0,0,0,0,0,0,0,0,0
29/6/2010,Giorgio Chiellini,831079,776,8/14/1984,25,32,1,26,6,7140,8400,8400,182,169,71708188,186,76,D LC,1,3,2,1,2,2,1,8,3,2,3,5,13,10,8,10,9,17,13,20,17,14,5,17,11,17,17,17,15,16,11,15,18,8,15,13,16,15,15,13,11,15,13,20,19,15,6,16,17,16,12,16,5,13,12,17,16,14,13,16,14,11,D LC,104,1,1,20,20,1,1,16,1,1,1,13,1,1,1,20,16,1,1,1,1,13,1,137975824420,0,0,1,0,0,1,0,0,0,0,0,0,0,0,0,0,0,0,0,0,0,0,0,0,0,0,0,0,0,1,0,0,0,0,0,0,0,1,0,0,0,0,0,0,0,0,0,0
29/6/2010,Gilberto Martínez,5385001,366,10/1/1979,30,58,0,0,0,3481,6490,5750,148,118,2294667,174,72,D RC,1,2,1,2,1,1,3,1,3,1,2,3,12,11,3,12,2,8,9,11,14,13,2,14,11,12,12,14,10,10,9,13,19,7,6,10,12,12,12,13,13,14,6,12,4,12,20,15,13,12,7,1,18,12,15,18,12,14,12,2,8,16,D RC,103,1,1,18,20,1,1,1,1,20,1,15,1,1,1,18,13,20,1,1,1,1,15,0,0,0,0,0,0,0,0,0,0,0,0,0,0,0,0,0,0,0,0,0,0,0,0,0,0,0,0,0,0,0,0,0,0,0,0,0,0,0,0,0,0,0,0,0,0,0,0,0
29/6/2010,Gianluca Grava,705845,776,3/7/1977,33,0,0,0,0,2250,6350,6350,134,134,787063,172,68,D/WB RC,1,3,2,2,3,2,1,4,2,2,2,4,12,11,5,13,5,8,4,11,16,10,7,14,8,16,14,15,11,14,10,12,13,3,15,12,14,14,13,13,14,11,7,9,14,15,20,15,10,15,14,11,5,15,11,15,12,15,17,14,9,7,D/WB RC,113,1,1,20,20,1,1,12,1,20,1,18,1,1,1,20,1,20,1,1,1,12,18,0,0,0,0,0,0,0,0,0,0,0,0,0,0,0,0,0,0,0,0,0,0,0,0,0,0,0,0,0,0,0,0,0,0,0,0,0,0,0,0,0,0,0,0,0,0,0,0,0
29/6/2010,Geromel,8878850,1651,9/21/1985,24,0,0,0,0,4200,6524,7250,162,145,10447835,190,84,D C,3,2,1,1,1,2,3,8,3,3,2,6,10,9,6,13,5,10,6,10,17,12,6,12,14,7,18,9,17,14,8,12,13,6,9,6,18,17,7,15,14,12,16,10,11,16,20,14,10,16,3,12,7,12,16,12,14,15,16,18,17,2,D C,101,1,1,20,20,10,1,5,5,8,14,3,1,1,1,20,5,8,5,1,1,3,3,279172874304,0,0,0,0,0,0,1,0,0,0,0,0,0,0,0,0,0,0,0,0,0,0,0,0,0,0,0,0,0,0,0,0,1,0,0,0,0,0,1,0,0,0,0,0,0,0,0,0
29/6/2010,Gerard Piqué,5124470,796,2/2/1987,23,23,4,12,1,7310,8250,8250,179,171,125499005,192,85,D C,1,2,2,1,1,2,3,1,3,2,2,8,6,9,8,15,7,16,7,8,18,15,11,16,14,12,16,13,15,17,13,15,16,9,16,9,18,15,16,11,11,18,16,9,15,15,20,17,16,15,9,15,6,9,16,18,8,15,14,17,12,11,D C,101,1,1,20,20,14,1,1,1,8,12,1,1,1,1,20,1,8,1,1,1,1,1,9075265929248,0,0,0,0,0,1,0,0,0,0,0,0,0,0,0,1,0,0,0,0,0,0,0,0,0,0,0,0,0,0,0,0,1,0,0,0,0,0,1,0,0,0,0,1,0,0,0,0
29/6/2010,Georg Niedermeier,8728397,771,2/26/1986,24,0,0,0,0,1250,4000,4000,120,110,3231858,189,75,D C,3,2,3,1,2,1,3,1,3,3,2,8,7,8,1,9,5,13,3,3,13,13,4,13,7,14,13,14,8,13,4,13,11,3,8,5,13,15,15,13,12,13,15,5,8,13,20,13,13,10,7,10,8,10,10,8,11,7,9,9,12,12,D C,101,1,1,20,20,1,1,1,1,14,1,10,1,1,1,20,1,14,1,1,1,1,10,0,0,0,0,0,0,0,0,0,0,0,0,0,0,0,0,0,0,0,0,0,0,0,0,0,0,0,0,0,0,0,0,0,0,0,0,0,0,0,0,0,0,0,0,0,0,0,0,0
29/6/2010,Gaspar,15228,788,6/1/1975,35,0,0,2,0,2000,5200,5200,108,106,29834,190,78,D C,1,1,3,3,3,1,1,1,3,3,2,5,7,4,7,5,5,14,3,10,13,5,2,11,5,15,13,14,13,13,3,11,12,3,11,6,13,14,16,10,8,14,15,5,15,9,20,14,13,14,11,12,7,9,9,15,13,14,14,13,12,4,D C,101,1,1,20,20,1,1,1,1,1,1,1,1,1,1,20,1,1,1,1,1,1,1,32768,0,0,0,0,0,0,0,0,0,0,0,0,0,0,0,1,0,0,0,0,0,0,0,0,0,0,0,0,0,0,0,0,0,0,0,0,0,0,0,0,0,0,0,0,0,0,0,0
29/6/2010,Gary Caldwell,121982,793,4/12/1982,28,37,2,21,2,4356,7000,7000,141,132,1328790,181,75,D C,1,1,3,2,2,3,1,6,3,3,2,5,11,9,6,11,14,18,10,6,17,13,13,16,10,14,11,18,14,13,11,12,15,11,15,8,14,16,16,9,8,12,12,10,14,12,20,14,14,11,13,13,7,14,10,16,13,15,16,16,16,3,D C,101,1,1,20,20,14,1,5,1,13,1,1,1,1,1,20,5,13,1,1,1,1,1,128,0,0,0,0,0,0,0,1,0,0,0,0,0,0,0,0,0,0,0,0,0,0,0,0,0,0,0,0,0,0,0,0,0,0,0,0,0,0,0,0,0,0,0,0,0,0,0,0
29/6/2010,Gary Cahill,5112583,765,12/19/1985,24,0,0,4,0,5000,7000,7000,155,145,6787709,188,79,D C,2,1,3,2,3,3,3,4,1,3,2,3,5,11,10,14,4,16,10,8,14,15,8,15,16,12,15,15,15,14,12,14,15,13,15,12,13,12,13,13,13,12,14,8,13,14,20,14,14,13,9,12,7,8,7,16,12,16,14,12,13,5,D C,101,1,1,20,20,1,1,1,1,1,1,1,1,1,1,20,1,1,1,1,1,1,1,2252078986592256,0,0,0,0,0,0,0,0,0,0,0,0,0,0,0,1,0,0,0,0,0,0,0,0,0,0,0,0,0,0,0,0,1,0,0,0,0,0,1,0,0,0,0,0,0,0,0,0
29/6/2010,Garry Bocaly,8439529,769,4/19/1988,22,0,0,14,0,4356,5900,5900,155,132,1840000,180,74,D/WB RC,2,2,1,3,1,1,2,2,2,3,1,12,11,11,7,11,7,13,10,10,12,9,7,15,12,14,13,14,12,13,10,13,16,8,10,12,12,12,15,15,13,14,10,5,15,14,20,15,14,15,12,14,6,10,9,16,14,14,14,14,14,6,D/WB RC,113,1,1,16,20,12,1,8,10,20,1,18,1,1,1,16,8,20,8,1,10,8,18,32,0,0,0,0,0,1,0,0,0,0,0,0,0,0,0,0,0,0,0,0,0,0,0,0,0,0,0,0,0,0,0,0,0,0,0,0,0,0,0,0,0,0,0,0,0,0,0,0
29/6/2010,Gaël Givet,3504004,769,10/9/1981,28,13,0,15,1,5476,6700,7350,155,148,14937361,181,75,D LC,3,1,3,3,3,3,2,4,2,1,3,4,5,5,6,9,6,15,6,10,15,8,8,18,9,16,18,19,13,14,9,15,18,5,17,8,16,16,16,11,12,14,12,20,15,12,10,13,16,16,12,15,6,12,18,13,15,13,18,15,16,7,D LC,104,1,1,20,20,1,1,18,1,10,1,1,1,1,1,20,18,10,1,1,1,1,1,563087392374784,0,0,0,0,0,0,0,0,0,0,0,0,0,0,0,0,0,0,0,0,0,0,0,0,0,0,0,0,0,0,0,0,0,0,0,0,0,1,0,0,0,0,0,0,0,0,0,0
29/6/2010,Gabriele Perico,836917,776,3/11/1984,26,0,0,0,0,2400,5900,5900,125,120,372387,183,75,D/WB/M RC,2,1,3,1,1,1,3,3,3,3,2,7,14,9,10,9,6,15,10,14,15,10,6,14,12,12,11,11,9,13,6,11,14,7,13,9,13,12,14,14,12,10,13,7,12,14,20,12,12,13,14,14,9,12,5,13,15,13,12,8,10,6,D/WB/M RC,123,1,1,15,20,1,1,1,17,20,1,20,1,1,1,15,12,20,1,1,17,1,20,8796093022208,0,0,0,0,0,0,0,0,0,0,0,0,0,0,0,0,0,0,0,0,0,0,0,0,0,0,0,0,0,0,0,0,0,0,0,0,0,0,0,0,0,0,0,1,0,0,0,0
29/6/2010,Gabriel Paletta,8441078,1649,2/15/1986,24,0,0,8,0,3000,6000,6000,133,123,2782053,190,80,D C,2,2,1,2,2,1,1,4,2,1,3,4,6,8,4,9,4,14,6,7,15,11,6,14,10,18,14,14,12,10,7,11,16,7,8,11,13,14,12,12,12,14,15,9,14,11,20,13,15,8,14,12,7,9,14,14,15,15,13,14,11,8,D C,101,1,1,20,20,1,1,1,1,1,1,1,1,1,1,20,1,1,1,1,1,1,1,0,0,0,0,0,0,0,0,0,0,0,0,0,0,0,0,0,0,0,0,0,0,0,0,0,0,0,0,0,0,0,0,0,0,0,0,0,0,0,0,0,0,0,0,0,0,0,0,0
29/6/2010,Gabriel Milito,3100476,1649,9/7/1980,29,32,1,0,0,6006,7500,8000,168,155,12520891,179,78,D C,1,3,1,2,1,2,2,4,1,3,3,8,8,9,8,12,10,15,11,8,17,12,11,16,13,17,15,17,13,15,10,15,19,9,18,8,17,16,16,13,10,16,11,20,9,15,7,14,15,17,13,17,14,10,15,19,18,14,18,17,14,10,D C,101,1,1,20,20,5,1,8,1,1,19,1,1,1,1,20,8,1,1,1,1,1,1,8800388022784,0,0,0,0,0,0,0,0,0,1,0,0,0,0,0,1,0,0,0,0,0,0,0,0,0,0,0,0,0,0,0,0,1,0,0,0,0,0,0,0,0,0,0,1,0,0,0,0
29/6/2010,Gabriel Heinze,4201729,1649,4/19/1978,32,64,2,0,0,5041,7100,6400,160,142,21871324,178,72,D LC,2,2,3,3,2,2,2,1,1,1,2,5,11,8,8,9,12,16,10,13,15,10,7,17,9,18,16,20,14,15,6,14,20,7,16,7,15,18,17,12,13,15,10,20,12,9,5,14,15,14,14,16,12,14,17,16,12,18,17,9,9,5,D LC,104,1,1,18,20,1,1,20,1,1,1,10,1,1,1,18,20,9,1,1,1,10,1,137439150080,0,0,0,0,0,0,0,0,0,0,0,0,0,0,0,0,1,1,0,0,0,0,0,0,0,0,0,0,0,0,0,0,0,0,0,0,0,1,0,0,0,0,0,0,0,0,0,0
29/6/2010,Freire,19081578,1651,8/21/1989,20,0,0,0,0,1250,5650,5650,132,113,1957186,186,73,D C,3,3,2,3,3,2,2,1,3,2,3,6,7,7,8,8,7,13,9,6,12,9,9,12,9,16,13,14,10,12,8,10,14,8,10,9,11,13,13,13,13,13,14,8,14,13,20,14,13,11,14,10,7,8,13,14,5,11,11,9,10,14,D C,101,1,1,20,20,1,1,1,1,1,11,1,1,1,1,20,1,1,1,1,1,1,1,0,0,0,0,0,0,0,0,0,0,0,0,0,0,0,0,0,0,0,0,0,0,0,0,0,0,0,0,0,0,0,0,0,0,0,0,0,0,0,0,0,0,0,0,0,0,0,0,0
29/6/2010,Fredrik Stoor,615742,797,2/28/1984,26,11,0,13,0,3540,6250,6100,124,119,5701730,184,80,D RLC,3,3,2,2,3,1,2,4,2,1,2,8,12,8,7,11,12,11,11,10,12,12,8,12,12,10,12,11,12,12,12,14,14,8,11,13,13,14,13,12,11,12,8,3,13,17,20,15,13,12,5,14,4,11,15,11,16,15,14,14,10,4,D RLC,106,1,1,18,20,1,1,16,11,20,1,14,1,1,1,18,16,20,1,1,11,1,14,0,0,0,0,0,0,0,0,0,0,0,0,0,0,0,0,0,0,0,0,0,0,0,0,0,0,0,0,0,0,0,0,0,0,0,0,0,0,0,0,0,0,0,0,0,0,0,0,0
29/6/2010,Frederik Sørensen,27020708,764,4/14/1992,18,0,0,0,0,1482,3750,3750,123,77,425984,192,71,D C,1,3,3,2,3,1,3,3,3,2,2,5,5,4,4,6,5,10,5,7,7,8,5,10,6,13,6,11,10,9,6,9,8,5,9,6,11,13,13,11,5,11,15,10,13,14,20,13,11,5,17,7,8,9,8,5,12,8,10,15,6,19,D C,101,1,1,20,20,1,1,1,1,1,1,1,1,1,1,20,1,1,1,1,1,1,1,4294967296,0,0,0,0,0,0,0,0,0,0,0,0,0,0,0,0,0,0,0,0,0,0,0,0,0,0,0,0,0,0,0,0,1,0,0,0,0,0,0,0,0,0,0,0,0,0,0,0
29/6/2010,Frank Fahrenhorst,1635,771,9/24/1977,32,2,0,2,0,2250,4500,4500,133,112,1554354,190,77,D C,2,2,3,3,2,1,1,1,2,1,1,3,4,4,10,7,7,16,9,12,14,8,7,14,7,13,12,13,11,11,5,8,13,8,12,7,14,14,13,8,7,14,17,10,13,8,20,14,15,11,12,13,6,5,8,11,13,8,13,13,11,4,D C,101,1,1,20,20,8,1,5,1,5,1,1,1,1,1,20,5,5,1,1,1,1,1,0,0,0,0,0,0,0,0,0,0,0,0,0,0,0,0,0,0,0,0,0,0,0,0,0,0,0,0,0,0,0,0,0,0,0,0,0,0,0,0,0,0,0,0,0,0,0,0,0
29/6/2010,Franck Queudrue,3503746,769,8/27/1978,31,0,0,0,0,3600,5400,5400,140,120,2288630,183,77,D/WB LC,2,1,3,3,1,3,1,5,1,1,3,12,13,10,7,10,12,13,12,11,13,12,11,15,12,16,11,14,12,10,11,12,14,11,10,10,14,11,14,13,12,14,12,20,10,12,5,10,12,13,16,12,9,10,12,13,14,10,11,8,8,14,D/WB LC,114,1,1,20,20,12,1,18,12,1,1,18,1,1,1,20,18,1,10,12,1,18,1,565286416678913,1,0,0,0,0,0,0,0,0,0,0,0,0,0,0,0,0,0,0,0,1,0,0,0,0,0,0,0,0,0,0,0,0,0,0,0,0,1,0,0,0,1,0,0,0,0,0,0
29/6/2010,Franck Béria,143897,769,5/23/1983,27,0,0,3,0,5150,6479,6450,150,144,4555621,177,75,D/WB RLC,3,2,1,3,1,2,1,1,1,1,3,7,13,9,5,12,8,12,10,12,14,11,7,14,12,13,15,14,13,14,8,13,15,8,9,8,14,16,14,13,12,13,8,12,15,15,20,15,13,16,13,15,7,16,13,14,15,14,17,15,15,6,D/WB RLC,116,1,10,17,20,10,1,18,10,20,1,18,1,5,10,17,18,20,1,5,10,16,18,32,0,0,0,0,0,1,0,0,0,0,0,0,0,0,0,0,0,0,0,0,0,0,0,0,0,0,0,0,0,0,0,0,0,0,0,0,0,0,0,0,0,0,0,0,0,0,0,0
29/6/2010,Francisco Pavón,812817,796,1/9/1980,30,0,0,0,0,3660,6100,5650,146,121,864311,188,78,D C,3,2,2,3,2,3,2,2,3,2,1,5,6,6,7,8,5,17,9,8,15,12,6,13,8,12,14,13,10,14,8,13,9,4,7,6,16,16,13,8,10,16,15,9,10,10,20,12,13,12,12,13,14,4,12,11,18,14,15,15,17,5,D C,101,1,1,20,20,5,1,2,2,7,10,1,1,1,1,20,2,7,2,1,1,1,1,274877906944,0,0,0,0,0,0,0,0,0,0,0,0,0,0,0,0,0,0,0,0,0,0,0,0,0,0,0,0,0,0,0,0,0,0,0,0,0,0,1,0,0,0,0,0,0,0,0,0
29/6/2010,Francesco Bega,705282,776,10/26/1974,35,0,0,0,0,3364,5550,5550,130,116,223421,180,78,D C,1,3,2,3,2,3,3,8,2,3,2,2,9,9,3,4,4,15,12,5,14,10,1,13,12,13,12,13,12,11,13,13,13,2,15,13,13,14,15,12,13,12,11,5,14,14,20,15,13,12,14,15,7,10,12,10,12,11,13,12,12,5,D C,101,1,1,20,20,1,1,10,1,13,15,1,1,1,1,20,10,13,1,1,1,1,1,1073774592,0,0,0,0,0,0,0,0,0,0,0,0,0,0,0,1,0,0,0,0,0,0,0,0,0,0,0,0,0,0,1,0,0,0,0,0,0,0,0,0,0,0,0,0,0,0,0,0
29/6/2010,Filip Daems,200448,757,10/31/1978,31,7,0,9,0,3700,6600,6500,132,131,2880477,181,79,D/WB LC,2,1,1,3,1,3,1,2,1,3,2,8,13,7,8,10,12,9,11,14,12,11,13,14,10,15,16,12,15,15,8,11,15,8,14,7,15,16,12,16,13,10,10,20,14,14,8,12,9,16,12,12,15,15,14,12,17,14,18,16,13,3,D/WB LC,114,1,10,16,20,1,1,20,13,1,1,18,1,10,1,16,20,13,1,13,1,18,1,73014444552,0,0,0,1,0,0,0,0,0,1,0,0,0,0,0,0,0,0,0,0,0,0,0,0,0,0,0,0,0,0,0,0,1,0,0,0,1,0,0,0,0,0,0,0,0,0,0,0
29/6/2010,Fernando,7002210,788,10/3/1980,29,0,0,0,0,1000,5000,5000,110,104,107229,175,70,D/DM C,3,3,2,1,2,1,3,5,3,1,1,8,8,7,7,9,9,11,10,11,14,9,9,13,8,17,14,14,10,10,7,9,14,9,13,10,12,13,14,11,11,10,10,8,12,11,20,12,13,12,14,12,7,12,7,19,14,18,11,9,11,5,D/DM C,111,1,1,20,20,20,1,1,15,1,1,1,1,1,1,20,1,1,15,1,1,1,1,0,0,0,0,0,0,0,0,0,0,0,0,0,0,0,0,0,0,0,0,0,0,0,0,0,0,0,0,0,0,0,0,0,0,0,0,0,0,0,0,0,0,0,0,0,0,0,0,0
29/6/2010,Fernando Amorebieta,7458268,796,3/21/1985,25,0,0,0,0,4970,6600,6600,152,141,7018690,192,86,D C,3,2,2,2,3,2,2,6,2,3,3,6,8,10,6,11,11,16,15,7,15,10,6,14,10,17,13,16,11,11,10,13,12,10,11,6,15,10,15,13,13,15,17,20,14,13,6,15,16,11,17,12,8,9,12,15,13,12,14,14,2,17,D C,101,1,1,20,20,1,1,14,1,1,1,1,1,1,1,20,14,1,1,1,1,1,1,8813273022464,0,0,0,0,0,0,0,0,0,0,0,0,0,0,0,0,0,1,0,0,0,0,0,0,0,0,0,0,0,0,0,0,0,0,1,0,0,0,0,0,0,0,0,1,0,0,0,0
29/6/2010,Felix Bastians,5006686,771,5/9/1988,22,0,0,0,0,4250,6250,6250,137,132,3801102,188,84,D LC,2,1,1,1,2,1,3,6,2,2,3,8,12,10,10,12,7,12,8,6,13,12,9,14,12,13,10,12,15,12,11,8,14,12,8,10,12,14,15,14,13,13,12,20,14,14,16,13,12,12,8,10,7,13,12,13,11,10,14,13,8,8,D LC,104,1,15,16,20,1,1,20,15,1,1,15,1,15,1,16,20,16,1,15,1,15,1,536870912,0,0,0,0,0,0,0,0,0,0,0,0,0,0,0,0,0,0,0,0,0,0,0,0,0,0,0,0,0,1,0,0,0,0,0,0,0,0,0,0,0,0,0,0,0,0,0,0
29/6/2010,Felipe,837211,1651,7/31/1984,25,0,0,0,0,4556,5300,7250,154,135,48826345,188,78,D LC,2,1,2,1,3,3,3,4,3,1,2,4,6,10,9,15,5,18,6,12,14,15,6,15,14,14,15,12,12,12,11,15,14,6,14,11,14,16,15,12,12,13,15,20,9,12,7,13,14,12,13,12,14,13,16,15,13,10,15,13,13,10,D LC,104,1,1,20,20,1,1,15,1,1,15,1,1,1,1,20,15,1,1,1,1,1,1,140737488355328,0,0,0,0,0,0,0,0,0,0,0,0,0,0,0,0,0,0,0,0,0,0,0,0,0,0,0,0,0,0,0,0,0,0,0,0,0,0,0,0,0,0,0,0,0,0,0,1
29/6/2010,Felipe Santana,2107819,1651,3/17/1986,24,0,0,0,0,3500,6600,6750,149,135,4478475,194,82,D C,3,2,1,3,2,2,3,4,3,2,1,4,6,9,10,10,7,17,7,11,14,6,4,15,7,14,15,13,14,10,6,10,16,5,15,12,13,15,13,12,10,12,18,8,13,15,20,12,16,13,13,12,7,9,10,12,14,15,17,16,11,8,D C,101,1,1,20,20,1,1,1,1,10,10,1,1,1,1,20,1,10,1,1,1,1,1,8,0,0,0,1,0,0,0,0,0,0,0,0,0,0,0,0,0,0,0,0,0,0,0,0,0,0,0,0,0,0,0,0,0,0,0,0,0,0,0,0,0,0,0,0,0,0,0,0
29/6/2010,Felipe Lopes,316709,1651,8/7/1987,22,0,0,0,0,2500,4700,6000,144,122,2895047,184,76,D C,1,3,3,1,3,2,3,4,3,1,2,8,8,8,7,11,10,13,10,11,13,12,11,12,13,13,13,12,13,13,11,12,16,7,10,8,13,12,13,14,14,12,13,10,6,15,20,13,10,12,8,13,4,9,11,15,11,13,13,12,13,11,D C,101,1,1,20,20,1,1,1,1,1,1,1,1,1,1,20,1,1,1,1,1,1,1,0,0,0,0,0,0,0,0,0,0,0,0,0,0,0,0,0,0,0,0,0,0,0,0,0,0,0,0,0,0,0,0,0,0,0,0,0,0,0,0,0,0,0,0,0,0,0,0,0
29/6/2010,Federico Fazio,964847,1649,3/17/1987,23,0,0,16,1,4422,6500,6650,157,133,636645,195,85,D/DM C,2,2,2,2,1,1,1,1,2,3,3,4,6,7,6,10,8,16,8,13,13,12,10,15,11,14,13,13,10,11,8,12,13,4,9,8,13,13,15,12,10,18,17,12,16,12,20,16,19,12,14,9,7,13,13,12,12,12,14,14,11,11,D/DM C,111,1,1,20,20,20,1,1,15,1,12,1,1,1,1,20,1,1,15,1,1,1,1,64,0,0,0,0,0,0,1,0,0,0,0,0,0,0,0,0,0,0,0,0,0,0,0,0,0,0,0,0,0,0,0,0,0,0,0,0,0,0,0,0,0,0,0,0,0,0,0,0
29/6/2010,Fabricio Coloccini,3100188,1649,1/22/1982,28,33,1,0,0,4556,7425,6500,140,135,10380529,183,78,D C,1,1,1,1,2,3,7,6,2,1,2,6,8,9,5,11,6,15,8,11,13,12,11,16,14,13,14,13,16,11,10,8,11,7,14,8,13,14,15,13,18,14,10,10,14,12,20,18,15,13,15,13,7,12,7,18,10,9,11,9,9,9,D C,101,1,1,20,20,10,1,5,8,12,4,10,1,1,1,20,5,12,8,1,1,5,10,4295000064,0,0,0,0,0,0,0,0,0,0,0,0,0,0,0,1,0,0,0,0,0,0,0,0,0,0,0,0,0,0,0,0,1,0,0,0,0,0,0,0,0,0,0,0,0,0,0,0
29/6/2010,Fabio Morena,6001728,771,3/19/1980,30,0,0,0,0,3250,6150,6150,125,123,1278325,180,75,D C,1,2,3,2,1,3,3,4,2,2,1,3,6,8,4,12,8,9,5,7,13,12,12,13,12,7,18,13,14,14,11,16,12,7,16,6,15,14,9,9,13,11,12,10,7,11,20,12,12,15,10,15,12,5,11,10,14,11,13,14,5,11,D C,101,1,1,20,20,14,1,1,1,1,14,1,1,1,1,20,1,1,1,1,1,1,1,0,0,0,0,0,0,0,0,0,0,0,0,0,0,0,0,0,0,0,0,0,0,0,0,0,0,0,0,0,0,0,0,0,0,0,0,0,0,0,0,0,0,0,0,0,0,0,0,0
29/6/2010,Fábio Faria,55003770,788,4/24/1989,21,0,0,8,0,2500,5500,5500,159,109,5807748,186,75,D LC,3,3,2,1,2,3,1,6,3,3,2,8,7,8,8,11,11,13,10,9,14,8,9,13,10,14,14,13,13,15,10,10,16,7,13,11,13,13,13,11,11,13,13,20,15,10,6,11,12,14,9,10,8,10,12,15,16,12,15,14,14,6,D LC,104,1,1,20,20,5,1,15,1,1,1,5,1,1,1,20,15,1,1,1,1,5,1,32768,0,0,0,0,0,0,0,0,0,0,0,0,0,0,0,1,0,0,0,0,0,0,0,0,0,0,0,0,0,0,0,0,0,0,0,0,0,0,0,0,0,0,0,0,0,0,0,0
29/6/2010,Fabien Laurenti,914452,769,1/6/1983,27,0,0,3,0,3481,5300,5300,130,118,3550644,181,75,D RC,2,1,2,2,2,1,2,6,3,1,1,5,9,8,4,10,7,13,7,8,13,10,6,12,10,12,14,14,11,13,7,13,14,5,12,6,13,16,13,13,11,13,11,8,14,12,20,15,13,14,12,14,8,12,8,13,15,12,16,14,14,6,D RC,103,1,1,18,20,10,1,10,1,20,12,10,1,1,1,18,10,20,1,1,1,10,10,0,0,0,0,0,0,0,0,0,0,0,0,0,0,0,0,0,0,0,0,0,0,0,0,0,0,0,0,0,0,0,0,0,0,0,0,0,0,0,0,0,0,0,0,0,0,0,0,0
29/6/2010,Fabiano,832590,1651,1/18/1982,28,0,0,0,0,1000,5400,5800,124,114,397847,192,79,D C,1,1,1,1,1,1,1,1,1,1,1,12,10,3,12,11,14,14,14,12,14,14,5,14,11,11,13,14,12,12,10,7,11,4,11,11,12,13,13,7,8,14,16,15,12,9,20,14,15,12,14,9,5,9,14,10,14,13,15,15,12,9,D C,101,1,1,20,20,15,1,10,15,1,1,1,1,1,1,20,10,1,15,1,1,1,1,8796093022208,0,0,0,0,0,0,0,0,0,0,0,0,0,0,0,0,0,0,0,0,0,0,0,0,0,0,0,0,0,0,0,0,0,0,0,0,0,0,0,0,0,0,0,1,0,0,0,0
29/6/2010,Fabiano Santacroce,1400569,776,8/24/1986,23,0,0,6,0,3250,6700,6700,160,135,20621488,181,72,D RC,2,2,2,1,1,3,2,4,2,1,2,4,11,11,4,11,4,14,4,14,16,8,6,16,13,14,16,15,12,13,8,14,15,9,6,9,12,12,11,15,16,12,12,7,8,15,20,14,12,13,15,16,18,10,14,14,15,16,14,12,5,3,D RC,103,1,1,20,20,1,1,1,1,15,1,1,1,1,1,20,1,15,1,1,1,1,1,140737488355328,0,0,0,0,0,0,0,0,0,0,0,0,0,0,0,0,0,0,0,0,0,0,0,0,0,0,0,0,0,0,0,0,0,0,0,0,0,0,0,0,0,0,0,0,0,0,0,1
29/6/2010,Ezequiel Muñoz,14000741,1649,10/8/1990,19,0,0,1,0,4160,5804,5500,165,129,8471140,185,82,D C,3,3,2,2,1,3,3,2,1,2,2,5,7,8,9,10,5,15,7,9,16,11,10,15,11,15,12,15,11,11,6,10,15,7,9,6,14,13,14,12,14,16,14,6,17,13,20,14,15,13,14,12,15,10,11,15,14,15,15,16,10,11,D C,101,1,1,20,20,1,1,1,1,11,1,1,1,1,1,20,1,11,1,1,1,1,1,32768,0,0,0,0,0,0,0,0,0,0,0,0,0,0,0,1,0,0,0,0,0,0,0,0,0,0,0,0,0,0,0,0,0,0,0,0,0,0,0,0,0,0,0,0,0,0,0,0
29/6/2010,Ezequiel Garay,956658,1649,10/10/1986,23,1,0,0,0,5550,7200,7450,162,149,13920758,188,84,D C,2,1,2,1,2,2,3,5,2,1,3,9,12,8,11,10,15,15,14,9,16,15,16,15,15,10,17,12,16,16,11,14,8,8,10,6,16,13,12,7,10,16,15,11,14,11,20,16,15,16,9,12,12,5,11,15,8,10,12,16,18,9,D C,101,1,1,20,20,6,1,3,1,3,15,1,1,1,1,20,3,3,1,1,1,1,1,279172874240,0,0,0,0,0,0,0,0,0,0,0,0,0,0,0,0,0,0,0,0,0,0,0,0,0,0,0,0,0,0,0,0,1,0,0,0,0,0,1,0,0,0,0,0,0,0,0,0
29/6/2010,Ernesto Galán,1512134,796,6/17/1986,24,0,0,0,0,2000,5000,5000,125,110,1604909,181,79,D RC,3,3,2,1,3,1,2,1,2,3,3,9,14,12,11,10,8,11,10,11,13,11,10,11,11,12,12,11,10,7,13,9,10,11,8,14,14,15,14,15,15,13,11,7,13,11,20,14,12,11,8,13,15,11,12,13,9,10,10,14,10,9,D RC,103,1,1,20,20,1,1,1,1,20,1,15,1,1,1,20,1,20,1,1,1,1,15,0,0,0,0,0,0,0,0,0,0,0,0,0,0,0,0,0,0,0,0,0,0,0,0,0,0,0,0,0,0,0,0,0,0,0,0,0,0,0,0,0,0,0,0,0,0,0,0,0
29/6/2010,Eric Chelle,910736,31,11/11/1977,32,7,0,0,0,3550,6450,5800,134,129,3585537,175,75,D RC,3,2,2,2,2,2,3,10,1,1,2,6,10,6,8,8,7,15,13,7,16,8,8,12,8,12,16,16,13,14,8,13,15,5,15,7,13,14,16,13,10,16,7,8,15,14,20,14,16,16,10,14,7,12,15,14,15,12,12,12,12,7,D RC,103,5,1,20,20,14,1,1,1,17,1,12,1,1,1,20,1,17,1,1,1,1,12,0,0,0,0,0,0,0,0,0,0,0,0,0,0,0,0,0,0,0,0,0,0,0,0,0,0,0,0,0,0,0,0,0,0,0,0,0,0,0,0,0,0,0,0,0,0,0,0,0
29/6/2010,Eric Abidal,910295,769,7/11/1979,30,50,0,0,0,6561,8000,8000,165,162,124405403,186,75,D/WB LC,1,3,2,1,3,1,2,6,3,3,3,12,12,9,7,12,9,14,8,14,16,12,8,15,12,14,11,16,13,13,12,12,13,9,12,12,16,15,16,16,16,15,11,20,17,17,7,18,16,15,11,11,10,12,12,14,13,11,15,15,15,10,D/WB LC,114,1,1,18,20,1,1,20,10,1,10,17,1,1,1,18,20,2,1,10,1,17,1,8813273939969,1,0,0,0,0,0,0,0,0,0,0,0,0,0,0,0,0,0,0,0,1,0,0,0,0,0,0,0,0,0,0,0,0,0,1,0,0,0,0,0,0,0,0,1,0,0,0,0
29/6/2010,Erdal Çelik,91014702,799,1/1/1988,22,0,0,0,0,700,3400,3400,90,78,413468,185,79,D/DM C,1,1,3,3,1,1,3,1,3,3,1,4,3,9,5,10,8,11,7,1,13,13,7,11,9,6,5,14,9,13,8,7,10,7,9,5,8,10,14,13,11,13,15,9,12,12,20,11,6,10,14,10,11,10,14,1,7,7,12,9,3,9,D/DM C,111,1,1,20,20,16,1,1,15,12,1,1,1,1,1,20,1,12,15,1,1,1,1,0,0,0,0,0,0,0,0,0,0,0,0,0,0,0,0,0,0,0,0,0,0,0,0,0,0,0,0,0,0,0,0,0,0,0,0,0,0,0,0,0,0,0,0,0,0,0,0,0
29/6/2010,Emmerson Boyce,108265,361,9/24/1979,30,2,0,0,0,3600,6500,6400,140,130,3798726,181,73,D RC,3,2,3,3,3,3,3,1,1,3,2,3,8,6,6,12,3,16,3,11,14,11,3,14,11,8,12,13,12,15,10,13,13,5,13,11,14,13,14,13,14,16,11,8,16,12,20,15,14,15,6,12,9,13,14,14,15,14,20,18,16,2,D RC,103,1,1,20,20,1,1,10,1,17,1,1,1,1,1,20,10,17,1,1,1,1,1,1081360,0,0,0,0,1,0,0,0,0,0,0,0,0,0,0,1,0,0,0,0,1,0,0,0,0,0,0,0,0,0,0,0,0,0,0,0,0,0,0,0,0,0,0,0,0,0,0,0
29/6/2010,Emir Spahic,656972,759,8/18/1980,29,40,2,3,0,5550,7650,6700,150,149,9778328,183,77,D C,1,3,2,1,2,3,1,3,1,1,2,5,8,11,7,12,11,15,12,11,16,13,7,15,12,17,16,16,14,14,12,13,15,9,16,9,17,15,18,10,13,15,12,10,15,12,20,15,15,15,17,15,9,10,13,15,13,14,11,10,7,12,D C,101,1,1,20,20,5,1,10,1,12,15,1,1,1,1,20,10,12,1,1,1,1,1,4295032864,0,0,0,0,0,1,0,0,0,0,0,0,0,0,0,0,1,0,0,0,0,0,0,0,0,0,0,0,0,0,0,0,1,0,0,0,0,0,0,0,0,0,0,0,0,0,0,0
29/6/2010,Emílson Cribari,3804588,1651,3/6/1980,30,0,0,0,0,3721,5400,6450,130,122,1652727,187,79,D C,1,1,1,1,1,1,1,1,1,1,1,1,2,7,5,7,3,17,3,3,13,10,2,16,10,14,14,19,13,7,9,11,17,6,13,10,13,12,14,9,12,15,16,20,15,10,10,14,17,13,13,13,11,4,14,17,14,12,16,14,15,7,D C,101,1,1,20,20,1,1,5,1,1,12,1,1,1,1,20,5,1,1,1,1,1,1,0,0,0,0,0,0,0,0,0,0,0,0,0,0,0,0,0,0,0,0,0,0,0,0,0,0,0,0,0,0,0,0,0,0,0,0,0,0,0,0,0,0,0,0,0,0,0,0,0
29/6/2010,Emiliano Moretti,3802413,776,6/11/1981,29,0,0,24,0,4900,7100,7100,148,140,12652332,185,80,D LC,3,3,3,1,3,3,3,1,3,1,1,10,11,10,6,12,8,15,8,13,16,13,9,14,10,13,13,16,12,15,9,12,13,6,12,13,15,15,16,12,12,15,12,20,14,13,5,15,16,15,15,11,5,12,14,14,8,10,13,10,12,10,D LC,104,1,1,17,20,3,1,20,9,1,5,14,1,1,1,17,20,10,1,9,1,14,1,0,0,0,0,0,0,0,0,0,0,0,0,0,0,0,0,0,0,0,0,0,0,0,0,0,0,0,0,0,0,0,0,0,0,0,0,0,0,0,0,0,0,0,0,0,0,0,0,0
29/6/2010,Emanuel Pogatetz,885005,755,1/16/1983,27,37,2,0,0,4160,7095,6650,142,129,5987115,188,77,D LC,2,3,1,2,3,3,1,1,2,2,2,5,7,4,6,8,4,14,7,12,16,9,7,16,7,19,11,20,8,12,3,9,16,3,14,6,15,15,16,8,6,18,16,20,14,13,12,19,18,15,18,16,10,12,15,9,7,12,13,6,5,10,D LC,104,1,1,20,20,1,1,18,1,1,1,11,1,1,1,20,18,1,1,1,1,11,1,137439182848,0,0,0,0,0,0,0,0,0,0,0,0,0,0,0,1,1,1,0,0,0,0,0,0,0,0,0,0,0,0,0,0,0,0,0,0,0,1,0,0,0,0,0,0,0,0,0,0
29/6/2010,Elamin Erbate,7601052,34,7/1/1981,28,23,0,0,0,3750,6000,5500,130,123,1003454,186,72,D LC,2,1,1,1,1,1,3,7,1,1,1,6,9,9,6,12,6,15,7,8,13,12,7,13,12,10,15,13,13,12,11,11,14,8,10,6,12,13,14,11,12,14,13,20,13,12,8,15,13,14,10,9,9,8,9,14,6,9,14,14,14,7,D LC,104,1,1,20,20,10,1,15,1,1,10,10,1,1,1,20,15,1,1,1,1,10,1,0,0,0,0,0,0,0,0,0,0,0,0,0,0,0,0,0,0,0,0,0,0,0,0,0,0,0,0,0,0,0,0,0,0,0,0,0,0,0,0,0,0,0,0,0,0,0,0,0
29/6/2010,Edson Braafheid,857193,784,4/8/1983,27,8,0,16,0,4422,7250,6500,138,133,9027971,178,70,D/WB LC,3,2,3,1,1,1,3,1,2,2,1,14,12,13,3,12,15,12,5,11,13,12,10,13,14,13,13,14,14,12,14,12,11,11,12,14,13,13,15,8,12,13,12,20,15,14,12,15,13,12,8,10,9,7,14,16,15,12,14,15,13,8,D/WB LC,114,1,1,19,20,14,1,20,13,8,1,18,1,1,1,19,20,8,1,13,1,18,8,0,0,0,0,0,0,0,0,0,0,0,0,0,0,0,0,0,0,0,0,0,0,0,0,0,0,0,0,0,0,0,0,0,0,0,0,0,0,0,0,0,0,0,0,0,0,0,0,0
29/6/2010,Éder Monteiro,321044,1651,9/21/1983,26,0,0,0,0,1000,4500,4500,119,90,47880,183,77,D C,1,1,2,2,1,1,2,5,1,2,1,6,8,6,4,7,6,15,7,5,14,9,4,14,11,15,11,16,9,3,3,12,12,6,4,9,14,16,14,11,11,9,13,8,15,11,20,15,14,12,17,13,5,10,11,12,11,4,11,10,5,6,D C,101,1,1,20,20,12,1,1,12,1,1,1,1,1,1,20,1,1,12,1,1,1,1,0,0,0,0,0,0,0,0,0,0,0,0,0,0,0,0,0,0,0,0,0,0,0,0,0,0,0,0,0,0,0,0,0,0,0,0,0,0,0,0,0,0,0,0,0,0,0,0,0
29/6/2010,Dorin Goian,7542014,790,12/12/1980,29,27,5,0,0,4489,7370,6800,143,134,8852704,194,83,D C,3,2,2,1,1,3,2,4,3,1,2,8,8,5,11,8,7,16,4,7,13,12,6,14,6,14,12,14,18,12,8,16,15,8,7,12,15,15,14,8,8,19,18,8,17,10,20,15,19,16,10,13,5,6,10,14,11,14,13,13,14,3,D C,101,1,1,20,20,1,1,1,1,1,12,1,1,1,1,20,1,1,1,1,1,1,1,274877939720,0,0,0,1,0,0,0,0,0,0,0,0,0,0,0,1,0,0,0,0,0,0,0,0,0,0,0,0,0,0,0,0,0,0,0,0,0,0,1,0,0,0,0,0,0,0,0,0
29/6/2010,Dominik Schmidt,35007315,771,7/1/1987,22,0,0,0,0,250,4350,4350,105,87,898013,187,78,D/DM RC,3,3,1,1,1,3,2,1,2,1,2,6,9,8,3,10,6,11,8,4,9,7,4,13,11,8,11,8,10,12,8,8,10,11,1,9,13,10,11,13,11,13,15,7,16,12,20,7,8,10,4,10,9,10,11,6,9,10,10,9,3,13,D/DM RC,113,1,1,20,20,20,1,7,15,16,1,15,1,1,1,20,7,16,15,1,10,5,15,0,0,0,0,0,0,0,0,0,0,0,0,0,0,0,0,0,0,0,0,0,0,0,0,0,0,0,0,0,0,0,0,0,0,0,0,0,0,0,0,0,0,0,0,0,0,0,0,0
29/6/2010,Dominic Maroh,35007305,771,3/4/1987,23,0,0,0,0,2750,6350,6350,149,127,5204891,186,75,D C,1,3,1,1,3,3,1,4,2,2,1,7,8,7,6,10,6,14,6,10,15,11,7,17,10,10,13,12,12,14,8,13,10,7,10,9,13,11,11,11,12,13,14,5,14,11,20,13,15,17,8,10,10,5,19,13,14,13,17,17,10,7,D C,101,1,1,20,20,1,1,1,1,1,1,1,1,1,1,20,1,1,1,1,1,1,1,0,0,0,0,0,0,0,0,0,0,0,0,0,0,0,0,0,0,0,0,0,0,0,0,0,0,0,0,0,0,0,0,0,0,0,0,0,0,0,0,0,0,0,0,0,0,0,0,0
29/6/2010,Domenico Criscito,7987827,776,12/30/1986,23,10,0,30,1,5776,7500,7500,172,152,19937180,181,73,D/WB/M LC,1,1,1,1,1,1,1,1,1,1,1,6,10,10,9,13,8,11,7,2,16,16,14,15,17,9,18,11,13,13,13,13,18,8,9,15,16,14,12,13,15,12,11,20,17,14,14,15,11,13,7,13,5,16,8,14,17,15,17,15,12,6,D/WB/M LC,234,1,1,16,19,5,1,20,19,14,15,20,1,1,1,16,19,14,5,19,1,20,5,1,1,0,0,0,0,0,0,0,0,0,0,0,0,0,0,0,0,0,0,0,0,0,0,0,0,0,0,0,0,0,0,0,0,0,0,0,0,0,0,0,0,0,0,0,0,0,0,0
29/6/2010,Domagoj Vida,24003525,761,4/29/1989,21,2,0,14,0,3000,5900,6200,150,124,4799999,184,73,D/DM RC,2,3,1,1,3,2,2,4,3,1,3,7,11,10,9,10,6,13,10,12,12,10,8,16,11,16,10,16,10,10,8,10,17,5,17,12,13,13,17,13,10,13,12,6,15,14,20,16,14,13,13,10,6,16,5,18,15,8,15,12,8,2,D/DM RC,113,1,1,20,20,19,1,13,15,17,1,13,1,1,1,20,13,17,15,1,8,10,13,2203318222912,0,0,0,0,0,0,1,0,0,0,0,0,0,0,0,0,0,0,0,0,0,0,0,0,0,0,0,0,0,0,0,0,1,0,0,0,0,0,0,0,0,1,0,0,0,0,0,0
29/6/2010,Djimi Traoré,3502324,31,3/1/1980,30,10,1,0,0,3350,5714,5700,135,127,4701414,187,78,D LC,1,2,1,3,1,2,2,2,2,2,3,5,8,8,5,10,5,13,7,12,14,7,7,16,10,13,13,14,12,12,7,11,12,6,11,6,13,15,14,14,10,16,13,20,14,13,10,14,16,13,13,14,10,8,14,14,12,13,16,12,12,4,D LC,104,1,1,17,20,1,1,20,8,1,1,12,1,1,1,17,20,8,1,8,1,12,1,0,0,0,0,0,0,0,0,0,0,0,0,0,0,0,0,0,0,0,0,0,0,0,0,0,0,0,0,0,0,0,0,0,0,0,0,0,0,0,0,0,0,0,0,0,0,0,0,0
29/6/2010,Djikiné,55012455,31,5/16/1987,23,0,0,0,0,2000,4049,4000,116,90,226015,188,82,DM C,2,2,3,1,1,1,1,1,1,2,1,7,7,8,8,10,10,13,9,10,11,10,10,12,10,12,10,13,11,10,10,8,13,7,11,11,11,14,12,12,12,15,14,20,15,12,5,13,15,10,10,10,7,12,14,14,13,13,14,14,14,5,DM C,301,1,1,20,15,20,1,1,15,1,1,1,1,1,1,15,1,1,15,1,1,1,1,0,0,0,0,0,0,0,0,0,0,0,0,0,0,0,0,0,0,0,0,0,0,0,0,0,0,0,0,0,0,0,0,0,0,0,0,0,0,0,0,0,0,0,0,0,0,0,0,0
29/6/2010,Diego Godín,8826848,1657,2/16/1986,24,43,3,9,0,5329,7950,7000,156,146,91453172,185,73,D C,2,2,3,1,2,1,1,2,3,1,3,4,5,8,10,11,5,14,7,9,15,11,12,15,12,16,14,16,13,14,8,14,14,7,15,7,15,15,16,14,11,17,13,9,14,13,20,16,15,14,10,15,6,5,16,13,12,13,14,11,10,6,D C,101,1,1,20,20,5,1,2,1,7,13,1,1,1,1,20,2,7,1,1,1,1,1,0,0,0,0,0,0,0,0,0,0,0,0,0,0,0,0,0,0,0,0,0,0,0,0,0,0,0,0,0,0,0,0,0,0,0,0,0,0,0,0,0,0,0,0,0,0,0,0,0
29/6/2010,Diego Gaúcho,317255,1651,11/15/1981,28,0,0,0,0,3000,4100,5500,122,110,438322,186,81,D C,1,2,2,2,1,1,1,1,3,3,2,9,9,5,9,10,13,14,12,10,13,10,9,9,10,16,12,13,11,11,9,11,13,5,13,8,12,11,12,8,10,15,12,8,13,8,20,13,15,13,11,12,6,5,12,13,13,12,12,13,12,6,D C,101,1,1,20,20,1,1,1,1,1,1,1,1,1,1,20,1,1,1,1,1,1,1,0,0,0,0,0,0,0,0,0,0,0,0,0,0,0,0,0,0,0,0,0,0,0,0,0,0,0,0,0,0,0,0,0,0,0,0,0,0,0,0,0,0,0,0,0,0,0,0,0
29/6/2010,Diego Colotto,951083,1649,3/10/1981,29,0,0,7,1,4000,5250,6500,140,140,4429712,184,81,D C,3,3,3,2,3,2,3,6,2,2,1,11,11,12,7,13,11,17,11,5,14,15,11,14,15,8,15,12,15,15,9,13,13,8,14,9,16,11,11,11,13,14,14,20,5,9,13,15,13,12,5,10,6,3,3,7,5,5,7,8,12,12,D C,101,1,1,20,20,1,1,1,1,1,20,1,1,1,1,20,1,1,1,1,1,1,1,4294967296,0,0,0,0,0,0,0,0,0,0,0,0,0,0,0,0,0,0,0,0,0,0,0,0,0,0,0,0,0,0,0,0,1,0,0,0,0,0,0,0,0,0,0,0,0,0,0,0
29/6/2010,di Fábio,302073,1651,2/10/1979,31,0,0,0,0,1500,3650,3650,104,90,120301,186,75,D C,2,3,3,3,3,1,1,1,2,1,3,8,3,2,5,8,4,12,6,0,12,11,3,12,4,9,10,7,12,12,3,12,6,3,7,2,10,7,7,12,10,9,14,9,12,12,20,5,12,10,12,10,8,10,20,1,11,12,7,8,7,17,D C,101,1,1,20,20,1,1,1,1,1,1,1,1,1,1,20,1,1,1,1,1,1,1,0,0,0,0,0,0,0,0,0,0,0,0,0,0,0,0,0,0,0,0,0,0,0,0,0,0,0,0,0,0,0,0,0,0,0,0,0,0,0,0,0,0,0,0,0,0,0,0,0
29/6/2010,Dennis Appiah,85010865,769,6/9/1992,18,0,0,0,0,1300,4814,2650,179,107,2025411,179,68,D/WB RC,3,3,1,2,3,2,3,1,1,1,2,5,8,8,6,11,6,12,6,7,11,10,6,11,11,9,13,13,13,13,9,11,14,6,8,8,12,14,12,14,13,12,9,5,15,13,20,15,8,14,9,14,7,12,10,14,14,14,12,15,15,6,D/WB RC,113,1,1,18,20,14,1,1,1,20,1,16,1,1,1,18,13,20,1,1,1,1,16,64,0,0,0,0,0,0,1,0,0,0,0,0,0,0,0,0,0,0,0,0,0,0,0,0,0,0,0,0,0,0,0,0,0,0,0,0,0,0,0,0,0,0,0,0,0,0,0,0
29/6/2010,Dekel Keinan,7861672,775,9/15/1984,25,15,0,30,0,3250,6325,5500,131,115,2297997,184,74,D C,3,3,1,2,2,2,3,2,2,1,3,6,9,9,7,6,8,15,4,10,14,10,7,14,10,13,12,14,12,11,10,11,11,9,13,12,13,13,16,12,11,11,14,11,9,11,20,13,14,12,6,12,4,9,10,14,16,14,13,13,13,7,D C,101,1,1,20,20,1,1,9,1,1,15,1,1,1,1,20,9,1,1,1,1,1,1,0,0,0,0,0,0,0,0,0,0,0,0,0,0,0,0,0,0,0,0,0,0,0,0,0,0,0,0,0,0,0,0,0,0,0,0,0,0,0,0,0,0,0,0,0,0,0,0,0
29/6/2010,Dejan Lovren,24000971,761,7/5/1989,20,0,0,21,1,4489,6029,6000,165,134,32887462,188,84,D RC,1,1,1,1,3,3,3,1,2,2,1,5,8,11,7,13,9,14,10,14,13,12,10,15,13,14,14,16,11,9,10,10,17,9,13,8,12,15,15,12,13,14,15,16,15,14,20,15,14,13,14,13,7,14,12,18,15,15,14,11,12,8,D RC,103,1,1,20,20,1,1,13,1,18,14,13,1,1,1,20,13,18,1,1,1,10,13,35184372219904,0,0,0,0,0,0,0,0,0,0,0,0,0,0,0,0,0,1,0,0,0,0,0,0,0,0,0,0,0,0,0,0,0,0,0,0,0,0,0,0,0,0,0,0,0,1,0,0
29/6/2010,Davidson Drobo-Ampem,35021177,21,3/26/1988,22,0,0,0,0,1750,5450,5450,122,109,1609511,189,89,D LC,2,1,1,1,3,1,2,5,2,1,1,6,8,7,4,9,6,9,7,12,14,8,5,13,8,13,12,13,10,10,7,8,10,7,6,7,13,14,12,12,9,13,14,15,14,13,20,14,15,14,10,10,5,13,14,2,6,7,8,6,6,7,D LC,104,1,1,18,20,1,1,20,1,10,1,14,1,1,1,18,20,10,1,1,1,14,8,32768,0,0,0,0,0,0,0,0,0,0,0,0,0,0,0,1,0,0,0,0,0,0,0,0,0,0,0,0,0,0,0,0,0,0,0,0,0,0,0,0,0,0,0,0,0,0,0,0
29/6/2010,Davide Zoboli,3804649,776,10/8/1981,28,0,0,0,0,1400,6100,6100,124,115,2484552,190,78,D C,1,3,2,2,2,2,2,5,2,3,1,4,3,6,10,7,5,17,3,7,14,6,4,15,10,12,14,15,7,12,9,10,10,12,10,12,8,12,14,8,7,5,17,10,16,12,20,14,17,14,9,2,3,7,14,9,12,13,11,6,4,11,D C,101,1,1,20,20,1,1,1,1,10,1,1,1,1,1,20,1,10,1,1,1,1,1,8589934592,0,0,0,0,0,0,0,0,0,0,0,0,0,0,0,0,0,0,0,0,0,0,0,0,0,0,0,0,0,0,0,0,0,1,0,0,0,0,0,0,0,0,0,0,0,0,0,0
29/6/2010,Davide Mandelli,3802512,776,6/28/1977,33,0,0,0,0,1750,6050,6050,130,125,927324,190,84,D RC,1,2,3,2,3,1,1,5,1,3,1,6,6,3,6,7,7,15,6,11,16,10,8,14,9,8,14,14,13,14,10,14,14,5,12,8,15,14,15,12,13,13,14,5,14,7,20,13,14,16,7,14,7,6,13,13,13,12,14,12,11,8,D RC,103,1,1,20,20,1,1,1,1,18,1,1,1,1,1,20,1,18,1,1,1,1,1,0,0,0,0,0,0,0,0,0,0,0,0,0,0,0,0,0,0,0,0,0,0,0,0,0,0,0,0,0,0,0,0,0,0,0,0,0,0,0,0,0,0,0,0,0,0,0,0,0
29/6/2010,Davide Astori,7983992,776,1/7/1987,23,0,0,0,0,500,6200,6200,160,137,2493884,188,80,D C,2,3,3,1,3,3,3,8,3,2,2,9,8,10,9,10,6,16,5,12,14,12,5,17,14,18,16,10,10,10,12,11,14,8,9,9,13,13,14,13,12,14,15,20,16,13,7,15,14,10,8,12,6,13,16,15,9,11,12,8,18,14,D C,101,1,1,20,20,1,1,10,1,5,1,1,1,1,1,20,10,5,1,1,1,1,1,8813272924160,0,0,0,0,0,0,0,0,0,0,0,0,0,0,0,1,0,0,0,0,0,0,0,0,0,0,0,0,0,0,0,0,0,0,1,0,0,0,0,0,0,0,0,1,0,0,0,0
29/6/2010,David Rozehnal,5640673,763,7/5/1980,29,60,1,8,1,4225,7150,6550,140,130,5539544,193,77,D C,3,1,3,1,1,2,1,3,1,1,1,4,6,6,3,11,4,8,5,13,14,9,12,14,10,6,15,7,16,14,9,10,14,4,13,5,16,14,8,15,14,10,17,20,14,15,16,13,11,13,3,14,7,10,17,12,10,12,16,19,18,5,D C,101,1,1,20,20,15,1,1,15,4,10,1,1,1,1,20,1,4,15,1,1,1,1,283467841536,0,0,0,0,0,0,0,0,0,0,0,0,0,0,0,0,0,0,0,0,0,0,0,0,0,0,0,0,0,0,0,0,0,1,0,0,0,0,1,0,0,0,0,0,0,0,0,0
29/6/2010,David Navarro,4210604,796,5/25/1980,30,0,0,0,0,4556,6500,6500,137,135,86992260,183,76,D C,2,3,2,2,1,1,3,4,1,1,3,5,5,7,9,11,6,17,5,8,17,11,6,13,9,18,13,18,9,14,6,11,15,4,9,6,14,15,15,11,11,17,13,11,14,13,20,15,12,13,16,13,11,10,6,15,15,7,8,9,5,11,D C,101,1,1,20,20,6,1,2,1,5,8,1,1,1,1,20,2,5,1,1,1,1,1,137438986240,0,0,0,0,0,0,0,0,0,0,0,0,0,0,0,1,0,0,0,0,0,0,0,0,0,0,0,0,0,0,0,0,0,0,0,0,0,1,0,0,0,0,0,0,0,0,0,0
29/6/2010,David Luiz,2114068,1651,4/22/1987,23,0,0,0,0,4500,7750,7350,167,147,26938113,188,78,D C,2,2,1,3,3,1,3,5,2,2,3,7,8,10,9,12,8,13,11,17,16,11,9,15,12,17,15,16,10,11,7,11,17,10,12,11,12,12,15,15,14,15,15,13,16,14,20,12,13,14,12,13,10,13,16,16,18,16,16,11,10,7,D C,101,1,1,20,20,10,1,12,1,12,1,1,1,1,1,20,12,12,1,1,1,1,1,1125899906875424,0,0,0,0,0,1,0,0,0,0,0,0,0,0,0,1,0,0,0,0,0,0,0,0,0,0,0,0,0,0,0,0,0,0,0,0,0,0,0,0,0,0,0,0,0,0,0,0
29/6/2010,Dariusz Dudka,712275,787,12/9/1983,26,43,2,0,0,3844,6750,5550,135,124,1863833,182,71,D/DM LC,1,3,3,1,3,3,2,1,3,3,2,8,14,6,6,11,13,12,14,7,12,14,8,13,11,12,14,13,10,11,10,9,14,10,11,7,13,15,13,11,10,14,11,18,14,10,20,15,13,13,12,11,7,15,11,10,15,9,9,12,15,7,D/DM LC,324,1,1,20,18,20,1,15,15,10,1,15,1,1,1,18,15,10,15,1,1,15,10,17179869440,0,0,0,0,0,0,0,0,1,0,0,0,0,0,0,0,0,0,0,0,0,0,0,0,0,0,0,0,0,0,0,0,0,0,1,0,0,0,0,0,0,0,0,0,0,0,0,0
29/6/2010,Dario Dainelli,704180,776,6/9/1979,31,1,0,1,0,5000,7200,7200,153,143,22736279,191,83,D C,3,1,1,3,1,3,1,1,1,3,1,4,5,7,9,9,6,15,8,13,16,10,9,17,11,15,14,16,11,11,10,14,16,7,17,10,17,11,12,11,10,14,16,5,12,11,20,15,16,14,12,15,12,7,11,13,15,10,14,13,12,2,D C,101,1,1,20,20,1,1,3,1,1,10,1,1,1,1,20,3,1,1,1,1,1,1,8796093022208,0,0,0,0,0,0,0,0,0,0,0,0,0,0,0,0,0,0,0,0,0,0,0,0,0,0,0,0,0,0,0,0,0,0,0,0,0,0,0,0,0,0,0,1,0,0,0,0
29/6/2010,Dario Biasi,703809,776,8/24/1979,30,0,0,0,0,1000,5000,5000,106,106,1331847,180,73,D C,3,3,3,3,1,2,3,1,2,2,1,6,6,6,5,10,8,15,5,10,15,13,8,14,6,15,15,13,13,8,8,11,15,9,11,5,16,13,13,10,11,12,11,20,11,10,5,9,10,11,14,14,8,13,9,13,15,9,15,12,16,3,D C,101,1,1,20,20,1,1,10,1,10,1,1,1,1,1,20,10,10,1,1,1,1,1,0,0,0,0,0,0,0,0,0,0,0,0,0,0,0,0,0,0,0,0,0,0,0,0,0,0,0,0,0,0,0,0,0,0,0,0,0,0,0,0,0,0,0,0,0,0,0,0,0
29/6/2010,Dante,316742,1651,10/18/1983,26,0,0,0,0,2600,6659,7400,157,148,11680161,187,82,D LC,2,1,2,3,3,2,3,1,3,2,2,7,11,13,8,13,10,15,9,15,18,11,12,18,14,18,16,19,18,7,14,7,14,16,15,8,17,10,19,9,12,18,16,20,11,14,8,17,15,12,13,10,12,14,8,8,13,12,13,7,11,5,D LC,104,1,1,20,20,10,1,15,6,1,1,13,1,1,1,20,15,1,1,6,1,13,1,8955006844928,0,0,0,0,0,0,0,0,0,0,0,0,0,0,0,1,0,0,0,0,0,0,0,0,0,0,0,0,0,0,0,0,1,0,1,0,0,1,0,0,0,0,0,1,0,0,0,0
29/6/2010,Danny Higginbotham,108664,765,12/29/1978,31,0,0,0,0,4225,6350,6350,135,130,3476543,186,78,D LC,2,3,2,1,1,2,3,1,2,1,1,4,10,9,6,9,13,14,7,12,14,9,17,15,12,14,13,17,13,13,8,13,17,6,17,9,14,17,15,12,12,13,14,20,15,12,5,14,12,16,8,15,8,9,11,12,13,14,16,11,14,5,D LC,104,1,1,20,20,1,1,18,1,1,10,10,1,1,1,20,18,1,1,1,1,10,1,8796093022208,0,0,0,0,0,0,0,0,0,0,0,0,0,0,0,0,0,0,0,0,0,0,0,0,0,0,0,0,0,0,0,0,0,0,0,0,0,0,0,0,0,0,0,1,0,0,0,0
29/6/2010,Danny Collins,5109654,801,8/6/1980,29,7,0,0,0,3650,5624,6450,127,125,12650000,183,77,D LC,2,1,2,1,2,2,1,2,3,2,3,5,13,11,7,11,8,17,6,8,12,13,5,16,10,12,13,18,14,11,11,12,15,7,11,10,13,14,16,9,11,14,13,20,14,8,12,15,13,19,5,9,5,8,15,11,17,4,13,15,10,14,D LC,104,4,1,20,20,1,1,19,1,1,1,10,1,1,1,20,19,1,1,1,1,10,1,0,0,0,0,0,0,0,0,0,0,0,0,0,0,0,0,0,0,0,0,0,0,0,0,0,0,0,0,0,0,0,0,0,0,0,0,0,0,0,0,0,0,0,0,0,0,0,0,0
29/6/2010,Danielson,316521,1651,1/9/1981,29,0,0,0,0,1000,2000,5250,112,108,273040,186,75,D C,3,2,2,3,2,3,3,3,3,2,3,8,8,8,8,10,11,13,11,10,13,9,10,10,10,11,12,11,11,11,10,10,13,7,13,10,13,13,11,11,9,13,13,20,13,10,5,12,14,12,10,12,12,9,11,15,14,11,14,15,13,6,D C,101,1,1,20,20,5,1,5,1,1,5,1,1,1,1,20,5,1,1,1,1,1,1,17179901952,0,0,0,0,0,0,0,0,0,0,0,0,0,0,0,1,0,0,0,0,0,0,0,0,0,0,0,0,0,0,0,0,0,0,1,0,0,0,0,0,0,0,0,0,0,0,0,0
29/6/2010,Daniele Portanova,3801856,776,12/17/1978,31,0,0,0,0,2500,6300,6300,135,132,2303127,185,78,D RC,3,3,3,3,3,2,1,9,1,1,1,7,7,6,9,9,6,16,6,10,16,9,5,14,11,14,13,17,8,14,9,9,20,5,10,11,13,11,14,12,11,18,13,10,15,13,20,14,16,15,8,10,11,10,12,10,18,5,19,11,11,10,D RC,103,1,1,20,20,1,1,1,1,15,1,1,1,1,1,20,1,15,1,1,1,1,1,8796093022208,0,0,0,0,0,0,0,0,0,0,0,0,0,0,0,0,0,0,0,0,0,0,0,0,0,0,0,0,0,0,0,0,0,0,0,0,0,0,0,0,0,0,0,1,0,0,0,0
29/6/2010,Daniele Gastaldello,829775,776,6/16/1983,27,0,0,0,0,5256,7250,7250,155,145,8698433,185,77,D C,3,1,3,3,2,2,3,5,3,2,2,7,11,8,10,8,5,16,5,10,12,10,7,16,12,16,14,11,13,15,8,18,16,7,14,11,15,10,12,13,12,10,14,10,12,11,20,15,14,10,10,15,5,11,14,15,12,14,12,12,10,2,D C,101,1,1,20,20,1,1,1,1,1,1,1,1,1,1,20,1,1,1,1,1,1,1,32768,0,0,0,0,0,0,0,0,0,0,0,0,0,0,0,1,0,0,0,0,0,0,0,0,0,0,0,0,0,0,0,0,0,0,0,0,0,0,0,0,0,0,0,0,0,0,0,0
29/6/2010,Daniele Bonera,3801706,776,5/31/1981,29,16,0,34,0,5250,7350,7350,154,145,14620918,183,74,D RC,2,3,2,3,3,2,3,9,1,1,3,2,13,10,6,12,2,15,8,12,16,13,5,14,12,14,15,13,15,15,10,15,16,5,14,12,16,15,14,14,12,14,11,9,11,14,20,13,14,14,14,10,18,17,13,15,15,15,16,14,15,8,D RC,103,1,1,20,20,1,1,10,1,18,1,14,1,1,1,20,10,18,1,1,1,8,14,0,0,0,0,0,0,0,0,0,0,0,0,0,0,0,0,0,0,0,0,0,0,0,0,0,0,0,0,0,0,0,0,0,0,0,0,0,0,0,0,0,0,0,0,0,0,0,0,0
29/6/2010,Daniel Vier,35005273,771,5/16/1982,28,0,0,0,0,1500,4300,4300,99,96,458289,188,80,D C,2,3,1,2,2,3,1,3,2,1,3,6,7,6,9,9,6,15,7,7,11,9,7,12,5,15,10,17,10,9,8,10,12,2,12,15,10,12,11,10,9,9,15,6,16,9,20,18,18,8,8,8,5,12,13,19,7,4,6,7,6,12,D C,101,1,1,20,20,15,1,1,15,1,1,1,1,1,1,20,1,1,15,1,1,1,1,0,0,0,0,0,0,0,0,0,0,0,0,0,0,0,0,0,0,0,0,0,0,0,0,0,0,0,0,0,0,0,0,0,0,0,0,0,0,0,0,0,0,0,0,0,0,0,0,0
29/6/2010,Daniel Van Buyten,3201152,757,2/7/1978,32,55,7,6,1,5476,7800,7500,155,148,99699478,196,96,D C,3,2,3,2,3,1,1,3,3,1,3,4,6,8,13,9,12,19,12,15,16,11,11,16,9,17,12,18,14,11,10,13,17,7,17,14,13,18,14,8,8,16,19,10,19,13,20,16,19,12,15,12,4,16,16,19,12,18,19,16,15,14,D C,101,12,1,20,20,9,1,1,1,1,14,1,1,1,1,20,1,1,1,1,1,1,1,37452114821120,0,0,0,0,0,0,0,0,0,0,0,0,0,0,0,0,0,0,0,0,0,0,0,0,0,0,0,0,0,0,0,0,0,0,0,0,1,0,0,0,0,1,0,0,0,1,0,0
29/6/2010,Daniel Sereinig,5720088,798,5/10/1982,28,0,0,0,0,500,4000,4000,105,95,161000,186,87,D C,1,3,2,1,1,2,3,1,1,1,3,2,1,5,3,7,1,9,5,2,12,10,4,11,2,12,12,7,12,11,1,12,10,3,13,3,12,9,10,12,12,11,11,20,12,12,20,6,4,10,9,10,12,10,7,7,17,9,18,7,12,7,D C,101,1,1,20,20,1,1,1,1,1,1,1,1,1,1,20,1,1,1,1,1,1,1,0,0,0,0,0,0,0,0,0,0,0,0,0,0,0,0,0,0,0,0,0,0,0,0,0,0,0,0,0,0,0,0,0,0,0,0,0,0,0,0,0,0,0,0,0,0,0,0,0
29/6/2010,Daniel Gabbidon,4001390,801,8/8/1979,30,43,0,17,0,4225,7000,6500,142,130,2965392,178,71,D C,2,2,2,3,3,1,1,4,1,3,3,8,4,9,4,11,11,13,5,2,13,11,4,13,13,7,15,11,14,13,12,14,11,8,14,10,14,14,12,12,12,14,11,13,13,13,20,12,11,13,13,14,16,12,14,16,14,16,16,13,16,8,D C,101,1,1,20,20,1,1,1,1,12,1,1,1,1,1,20,1,12,1,1,1,1,1,0,0,0,0,0,0,0,0,0,0,0,0,0,0,0,0,0,0,0,0,0,0,0,0,0,0,0,0,0,0,0,0,0,0,0,0,0,0,0,0,0,0,0,0,0,0,0,0,0
29/6/2010,Daniel Congré,8431097,769,4/5/1985,25,0,0,5,2,1450,6150,6150,155,137,4011853,184,78,D RC,1,1,1,1,1,3,3,1,2,3,2,5,10,9,6,11,7,16,8,8,16,9,6,13,11,12,14,16,13,13,8,12,17,5,13,6,14,14,14,13,11,15,12,15,13,11,20,14,15,15,12,15,11,12,13,15,17,14,16,15,15,7,D RC,103,1,1,20,20,10,1,12,1,18,1,1,1,1,1,20,12,18,1,1,1,1,1,0,0,0,0,0,0,0,0,0,0,0,0,0,0,0,0,0,0,0,0,0,0,0,0,0,0,0,0,0,0,0,0,0,0,0,0,0,0,0,0,0,0,0,0,0,0,0,0,0
29/6/2010,Daniel Carriço,55000931,788,8/4/1988,21,0,0,15,0,4970,7050,7050,151,141,42802261,181,74,D C,2,1,3,3,2,3,2,3,3,1,2,8,9,9,9,12,11,14,10,10,15,10,12,15,13,17,16,15,10,15,10,14,14,7,15,11,15,14,17,15,15,12,13,10,14,14,20,12,11,14,14,12,9,12,12,14,15,14,17,16,17,8,D C,101,1,1,20,20,13,1,1,7,1,10,1,1,1,1,20,1,1,7,1,1,1,1,0,0,0,0,0,0,0,0,0,0,0,0,0,0,0,0,0,0,0,0,0,0,0,0,0,0,0,0,0,0,0,0,0,0,0,0,0,0,0,0,0,0,0,0,0,0,0,0,0
29/6/2010,Daniel Agger,933352,764,12/12/1984,25,38,3,10,3,6320,8500,7850,170,159,151878499,187,75,D C,2,2,2,1,1,3,1,1,1,3,1,8,9,10,10,15,12,15,14,14,14,15,14,15,13,13,15,15,15,16,12,16,15,11,15,8,17,14,12,12,11,16,15,20,10,14,14,15,13,14,7,14,18,10,17,15,12,16,15,11,8,6,D C,101,5,1,20,20,9,1,12,1,2,6,5,1,1,1,20,12,2,1,1,1,5,1,8800388022304,0,0,0,0,0,1,0,0,0,0,0,0,0,0,0,1,0,0,0,0,0,0,0,0,0,0,0,0,0,0,0,0,1,0,0,0,0,0,0,0,0,0,0,1,0,0,0,0
29/6/2010,Damien Perquis,915252,769,4/10/1984,26,0,0,3,0,1350,5804,5800,140,129,2640492,184,80,D C,1,1,1,3,1,3,2,1,2,3,3,5,8,7,8,10,7,15,12,10,13,10,7,14,10,14,14,16,13,13,8,12,14,7,13,8,15,15,15,13,12,15,12,7,14,11,20,15,15,14,14,14,8,10,13,14,14,13,15,14,14,5,D C,101,1,1,20,20,14,1,1,1,1,10,1,1,1,1,20,1,1,1,1,1,1,1,32,0,0,0,0,0,1,0,0,0,0,0,0,0,0,0,0,0,0,0,0,0,0,0,0,0,0,0,0,0,0,0,0,0,0,0,0,0,0,0,0,0,0,0,0,0,0,0,0
29/6/2010,Damien Marcq,34005947,769,12/8/1988,21,0,0,3,0,4160,5804,5800,150,129,5999998,183,72,D/DM C,3,1,2,2,3,2,2,5,2,1,3,5,8,9,6,11,7,13,12,6,12,12,7,15,11,13,15,16,14,15,11,14,16,6,14,7,13,18,17,13,12,13,11,5,15,11,20,17,13,16,13,14,6,10,8,14,18,15,16,13,13,6,D/DM C,321,1,1,20,16,20,1,8,15,12,1,8,1,1,1,16,8,8,15,1,12,8,8,137438953472,0,0,0,0,0,0,0,0,0,0,0,0,0,0,0,0,0,0,0,0,0,0,0,0,0,0,0,0,0,0,0,0,0,0,0,0,0,1,0,0,0,0,0,0,0,0,0,0
29/6/2010,Damiano Ferronetti,829414,776,11/1/1984,25,0,0,5,0,3650,6350,6350,143,132,4781193,185,74,D RC,2,1,1,2,1,1,2,7,2,2,2,3,11,8,8,9,2,16,4,12,15,10,4,15,10,16,15,15,13,13,8,12,15,4,12,8,13,16,15,12,14,14,13,6,13,14,20,14,14,15,13,15,8,15,11,15,18,15,19,14,8,5,D RC,103,1,1,17,20,1,1,1,1,20,1,10,1,1,1,17,9,20,1,1,1,1,10,0,0,0,0,0,0,0,0,0,0,0,0,0,0,0,0,0,0,0,0,0,0,0,0,0,0,0,0,0,0,0,0,0,0,0,0,0,0,0,0,0,0,0,0,0,0,0,0,0
29/6/2010,Curtis Davies,5112976,765,3/15/1985,25,0,0,3,0,5000,6479,6400,154,144,6696262,188,76,D C,2,1,1,1,2,2,1,5,1,3,1,3,5,9,5,12,2,16,2,6,14,9,1,15,11,12,15,12,13,13,6,12,17,3,14,8,14,13,14,14,14,14,15,10,12,16,20,15,14,13,5,14,9,6,13,16,16,14,16,17,14,3,D C,101,1,1,20,20,1,1,1,1,1,13,1,1,1,1,20,1,1,1,1,1,1,1,274877939712,0,0,0,0,0,0,0,0,0,0,0,0,0,0,0,1,0,0,0,0,0,0,0,0,0,0,0,0,0,0,0,0,0,0,0,0,0,0,1,0,0,0,0,0,0,0,0,0
29/6/2010,Cristián Zapata,8825553,1653,9/30/1986,23,18,0,0,0,4900,7000,7200,167,143,40741318,187,79,D C,2,2,2,2,2,2,3,1,1,1,3,3,9,8,7,10,3,14,6,6,17,10,4,17,11,12,15,16,14,11,5,10,12,7,5,12,16,10,11,16,14,15,16,12,14,15,20,12,15,14,6,16,7,13,18,9,16,10,16,15,17,4,D C,101,1,1,20,20,1,1,1,1,14,1,1,1,1,1,20,1,14,1,1,1,1,1,137438953472,0,0,0,0,0,0,0,0,0,0,0,0,0,0,0,0,0,0,0,0,0,0,0,0,0,0,0,0,0,0,0,0,0,0,0,0,0,1,0,0,0,0,0,0,0,0,0,0
29/6/2010,Cristian Zaccardo,3801411,776,12/21/1981,28,17,1,21,2,5112,7000,7000,152,143,14606785,183,77,D RC,3,1,1,2,3,2,1,3,2,2,3,9,10,6,9,12,6,16,13,10,16,10,6,16,12,14,16,14,15,15,10,12,15,5,10,12,17,15,15,11,8,10,13,14,12,12,20,15,14,17,10,16,5,12,4,20,18,20,17,17,17,5,D RC,103,1,1,16,20,12,1,13,9,20,3,14,1,1,1,16,13,20,7,4,9,2,14,140758963191808,0,0,0,0,0,0,0,0,0,0,0,0,0,0,0,0,0,0,0,0,0,0,0,0,0,0,0,0,0,0,0,0,1,0,1,0,0,0,0,0,0,0,0,0,0,0,0,1
29/6/2010,Cristian Chivu,7200103,790,10/26/1980,29,71,3,5,0,5852,8000,7750,165,153,154317397,184,81,D LC,1,1,1,1,1,1,1,1,1,1,1,12,13,10,8,14,14,15,14,10,15,16,15,15,15,14,13,15,14,13,15,14,15,10,15,12,16,14,14,13,13,14,12,20,5,13,5,14,14,13,12,13,16,16,17,15,14,14,18,16,17,13,D LC,104,1,1,18,20,14,1,20,5,1,1,15,1,1,1,18,20,10,1,5,1,15,1,8813272926240,0,0,0,0,0,1,0,0,0,0,0,1,0,0,0,1,0,0,0,0,0,0,0,0,0,0,0,0,0,0,0,0,0,0,1,0,0,0,0,0,0,0,0,1,0,0,0,0
29/6/2010,Cris,3301196,1651,6/3/1977,33,17,2,0,0,5476,7150,6650,167,148,19522610,183,77,D C,3,1,1,2,2,1,3,1,1,2,3,5,7,8,8,12,10,17,12,11,16,12,13,15,12,14,17,16,13,13,9,14,16,6,16,9,17,16,17,8,9,17,11,8,16,12,20,15,17,15,14,14,8,6,13,16,16,14,18,13,13,8,D C,101,1,1,20,20,1,1,8,1,12,1,1,1,1,1,20,8,12,1,1,1,1,1,32800,0,0,0,0,0,1,0,0,0,0,0,0,0,0,0,1,0,0,0,0,0,0,0,0,0,0,0,0,0,0,0,0,0,0,0,0,0,0,0,0,0,0,0,0,0,0,0,0
29/6/2010,Craig Cathcart,28000905,785,2/6/1989,21,0,0,15,0,3192,5650,5650,140,113,1173231,188,73,D C,1,1,2,3,3,1,1,1,2,1,3,3,3,6,4,11,3,15,1,5,14,10,2,15,11,12,15,13,14,10,5,10,16,3,14,8,15,13,14,11,8,10,15,12,13,11,20,10,13,16,6,9,6,5,7,12,14,14,16,15,16,3,D C,101,1,1,20,20,8,1,9,1,12,1,1,1,1,1,20,9,12,1,1,1,1,1,274877906944,0,0,0,0,0,0,0,0,0,0,0,0,0,0,0,0,0,0,0,0,0,0,0,0,0,0,0,0,0,0,0,0,0,0,0,0,0,0,1,0,0,0,0,0,0,0,0,0
29/6/2010,Claudio Morel Rodríguez,3100688,1655,2/2/1978,32,25,0,0,0,4356,7260,6250,147,132,4723280,175,74,D LC,3,1,3,3,3,3,2,5,3,3,2,13,14,9,9,13,16,12,12,10,15,13,15,14,15,16,13,17,13,12,9,15,16,9,12,7,15,14,14,12,12,13,12,20,13,11,6,14,12,13,16,14,7,11,18,14,11,17,13,15,8,17,D LC,104,1,1,15,20,5,1,20,1,1,1,10,1,1,1,15,20,9,1,1,1,10,1,98304,0,0,0,0,0,0,0,0,0,0,0,0,0,0,0,1,1,0,0,0,0,0,0,0,0,0,0,0,0,0,0,0,0,0,0,0,0,0,0,0,0,0,0,0,0,0,0,0
29/6/2010,Christos Melissis,682476,772,12/1/1982,27,2,0,0,0,2500,5750,5750,125,115,298035,184,72,D RC,2,2,2,2,3,2,3,1,3,3,2,5,8,8,7,9,4,13,6,10,14,9,5,14,9,12,13,13,12,12,8,12,16,10,9,10,12,13,14,13,12,12,14,7,16,14,20,14,14,12,8,13,5,16,5,13,15,16,18,15,14,6,D RC,103,1,1,20,20,12,1,7,1,15,10,5,1,1,1,20,7,15,1,1,1,1,5,2251799813685248,0,0,0,0,0,0,0,0,0,0,0,0,0,0,0,0,0,0,0,0,0,0,0,0,0,0,0,0,0,0,0,0,0,0,0,0,0,0,0,0,0,0,0,0,0,0,0,0
29/6/2010,Christopher Schorch,35012895,771,1/30/1989,21,0,0,0,0,3250,5750,5750,138,115,2971443,189,83,D RC,3,3,1,3,1,2,3,4,3,1,1,5,9,7,4,11,4,16,5,16,12,9,5,13,11,12,9,13,5,9,5,10,10,5,8,6,10,13,14,13,9,12,15,16,12,15,20,11,17,10,6,9,11,9,14,6,12,11,10,6,5,1,D RC,103,1,1,20,20,5,1,10,1,16,1,7,1,1,1,20,10,16,1,1,1,1,7,0,0,0,0,0,0,0,0,0,0,0,0,0,0,0,0,0,0,0,0,0,0,0,0,0,0,0,0,0,0,0,0,0,0,0,0,0,0,0,0,0,0,0,0,0,0,0,0,0
29/6/2010,Christopher Samba,8428691,49,3/28/1984,26,20,1,0,0,5500,7400,7400,160,150,16489923,193,91,D C,1,2,2,1,1,3,2,1,3,3,3,2,4,9,9,11,4,16,8,5,13,9,6,15,12,17,16,18,11,14,9,12,18,8,13,11,14,15,13,15,10,13,18,7,15,15,20,13,19,15,12,15,5,12,20,12,18,13,17,13,11,7,D C,101,11,1,20,20,5,1,1,1,5,1,1,1,1,1,20,1,5,1,1,1,1,1,4,0,0,1,0,0,0,0,0,0,0,0,0,0,0,0,0,0,0,0,0,0,0,0,0,0,0,0,0,0,0,0,0,0,0,0,0,0,0,0,0,0,0,0,0,0,0,0,0
29/6/2010,Christopher Mfuiy,69003012,53,7/3/1989,20,0,0,0,0,2500,5000,4500,134,100,2174491,185,75,D C,1,3,1,3,3,3,1,1,1,1,1,8,6,5,5,7,4,13,6,4,11,7,10,12,7,13,12,14,10,12,5,11,9,6,7,6,9,11,13,14,11,14,12,5,15,13,20,12,14,13,7,10,6,10,16,19,13,10,15,14,11,16,D C,101,1,1,20,20,1,1,1,1,12,1,12,1,1,1,20,1,12,1,1,1,1,12,0,0,0,0,0,0,0,0,0,0,0,0,0,0,0,0,0,0,0,0,0,0,0,0,0,0,0,0,0,0,0,0,0,0,0,0,0,0,0,0,0,0,0,0,0,0,0,0,0
29/6/2010,Christophe Berra,5204034,793,1/31/1985,25,7,0,6,0,4000,6300,6350,146,130,5750000,191,81,D C,1,10,12,1,1,8,1,5,1,1,1,4,6,5,6,8,5,14,6,4,14,10,7,16,10,10,12,14,10,15,12,10,20,4,13,7,14,14,15,14,10,13,14,20,17,13,9,15,15,17,6,14,1,5,15,17,16,15,17,15,8,1,D C,101,1,1,20,20,1,1,10,1,1,9,1,1,1,1,20,10,1,1,1,1,1,1,274877906944,0,0,0,0,0,0,0,0,0,0,0,0,0,0,0,0,0,0,0,0,0,0,0,0,0,0,0,0,0,0,0,0,0,0,0,0,0,0,1,0,0,0,0,0,0,0,0,0
29/6/2010,Christoph Metzelder,6001957,771,11/5/1980,29,47,0,9,1,5041,7000,7000,161,142,23399030,194,84,D C,3,3,2,1,2,3,3,5,1,2,3,5,9,8,5,12,7,14,6,13,17,10,6,17,11,12,18,14,17,14,7,11,18,4,16,6,15,17,9,7,7,16,18,14,4,10,20,12,17,18,9,19,19,9,16,8,15,12,19,18,17,7,D C,101,1,1,20,20,3,1,10,1,12,12,10,1,1,1,20,10,12,1,1,1,8,10,0,0,0,0,0,0,0,0,0,0,0,0,0,0,0,0,0,0,0,0,0,0,0,0,0,0,0,0,0,0,0,0,0,0,0,0,0,0,0,0,0,0,0,0,0,0,0,0,0
29/6/2010,Christian Terlizzi,3802418,776,11/22/1979,30,1,0,0,0,3000,6000,6000,130,121,1789561,190,78,D C,1,1,1,1,1,1,1,1,1,1,1,5,5,5,13,10,7,19,8,10,14,11,5,11,10,15,14,13,16,8,13,11,15,5,11,10,13,12,10,11,8,16,17,5,13,11,20,15,16,14,16,10,13,8,5,12,12,5,12,12,10,14,D C,101,7,1,20,20,1,1,1,1,1,1,1,1,1,1,20,1,1,1,1,1,1,1,8796093022240,0,0,0,0,0,1,0,0,0,0,0,0,0,0,0,0,0,0,0,0,0,0,0,0,0,0,0,0,0,0,0,0,0,0,0,0,0,0,0,0,0,0,0,1,0,0,0,0
29/6/2010,Christian Schulz,885274,771,4/1/1983,27,3,0,16,5,3900,6800,6800,143,136,6331064,185,81,D/WB/DM LC,1,1,2,2,3,2,2,3,3,1,2,10,11,11,8,11,11,12,13,17,14,12,12,14,12,15,14,13,12,11,11,13,16,8,11,10,14,15,12,13,12,13,14,20,15,13,9,15,14,11,14,13,8,17,8,15,18,9,16,14,6,11,D/WB/DM LC,334,1,4,20,19,20,1,18,15,1,1,18,1,4,1,19,17,1,15,14,1,18,1,0,0,0,0,0,0,0,0,0,0,0,0,0,0,0,0,0,0,0,0,0,0,0,0,0,0,0,0,0,0,0,0,0,0,0,0,0,0,0,0,0,0,0,0,0,0,0,0,0
29/6/2010,Chris Basham,28016310,765,7/20/1988,21,0,0,0,0,2750,5250,5250,140,115,1725000,181,80,D/DM C,1,1,1,2,2,2,1,4,1,2,1,6,10,11,9,12,15,13,10,9,11,12,5,14,12,12,12,12,12,12,10,10,17,9,11,13,12,11,12,12,11,11,10,12,14,13,20,14,11,10,6,8,5,16,14,12,12,12,14,13,11,9,D/DM C,321,1,1,20,16,20,1,1,15,1,1,1,1,1,1,16,1,1,15,1,1,1,1,8796097773572,0,0,1,0,0,0,0,0,0,0,0,0,0,0,0,1,0,0,0,1,0,0,1,0,0,0,0,0,0,0,0,0,0,0,0,0,0,0,0,0,0,0,0,1,0,0,0,0
29/6/2010,Chris Baird,5102412,785,2/25/1982,28,44,0,6,1,4290,6500,6200,135,131,10210585,181,75,D RC,2,1,3,1,3,3,3,4,1,3,3,5,11,8,5,13,6,14,8,11,16,13,7,15,12,11,14,15,14,13,10,14,14,9,13,13,16,15,15,12,10,12,12,5,14,12,20,15,14,15,8,14,6,16,10,9,17,15,15,13,16,1,D RC,103,1,1,20,20,15,1,1,15,20,1,8,1,1,1,20,13,20,15,1,1,1,5,283467841536,0,0,0,0,0,0,0,0,0,0,0,0,0,0,0,0,0,0,0,0,0,0,0,0,0,0,0,0,0,0,0,0,0,1,0,0,0,0,1,0,0,0,0,0,0,0,0,0
29/6/2010,Chico,1507717,796,3/6/1987,23,0,0,3,0,4450,6100,6100,148,135,28814831,186,77,D C,1,3,1,1,1,3,1,5,1,2,1,7,7,6,8,10,8,15,9,9,15,11,7,13,11,14,14,15,13,13,9,12,14,6,12,7,13,15,17,12,11,13,13,9,12,13,20,16,15,14,10,11,8,10,12,16,17,12,9,11,10,10,D C,101,1,1,20,20,15,1,1,15,1,1,1,1,1,1,20,1,1,15,1,1,1,1,8800387989504,0,0,0,0,0,0,0,0,0,0,0,0,0,0,0,0,0,0,0,0,0,0,0,0,0,0,0,0,0,0,0,0,1,0,0,0,0,0,0,0,0,0,0,1,0,0,0,0
29/6/2010,Chérif Faty,85057012,41,5/19/1990,20,0,0,0,0,1200,2450,2450,125,98,2485707,190,85,D C,3,1,1,1,2,1,3,1,2,2,2,5,5,7,7,7,6,16,6,6,13,7,6,10,7,12,13,14,10,12,6,9,10,6,8,7,11,13,13,11,9,16,15,5,14,9,20,13,16,13,12,6,7,10,8,5,11,13,15,14,4,12,D C,101,1,1,20,20,12,1,1,1,1,1,1,1,1,1,20,1,1,1,1,1,1,1,0,0,0,0,0,0,0,0,0,0,0,0,0,0,0,0,0,0,0,0,0,0,0,0,0,0,0,0,0,0,0,0,0,0,0,0,0,0,0,0,0,0,0,0,0,0,0,0,0
29/6/2010,Cesare Natali,703059,776,4/5/1979,31,0,0,3,0,4290,6500,6500,142,131,5000000,191,87,D C,1,1,1,1,1,1,1,1,1,1,1,4,7,6,8,8,6,17,7,11,15,9,2,17,9,12,12,16,14,15,4,12,16,7,9,10,16,14,13,8,9,14,17,7,12,10,20,13,16,14,9,14,7,4,14,12,11,10,18,15,16,5,D C,101,1,1,20,20,1,1,1,1,1,1,1,1,1,1,20,1,1,1,1,1,1,1,64,0,0,0,0,0,0,1,0,0,0,0,0,0,0,0,0,0,0,0,0,0,0,0,0,0,0,0,0,0,0,0,0,0,0,0,0,0,0,0,0,0,0,0,0,0,0,0,0
29/6/2010,Cesare Bovo,829401,776,1/14/1983,27,0,0,27,2,4500,7100,7100,160,146,9402910,181,75,D C,3,3,3,3,2,3,2,5,3,1,3,3,5,5,8,8,15,15,13,3,16,13,15,17,13,12,12,16,16,9,14,12,17,8,9,10,15,15,15,11,12,17,12,11,15,13,20,16,17,13,17,13,15,16,13,12,15,12,16,14,14,3,D C,101,1,1,20,20,1,1,13,1,7,1,1,1,1,1,20,13,7,1,1,1,1,1,8796093022208,0,0,0,0,0,0,0,0,0,0,0,0,0,0,0,0,0,0,0,0,0,0,0,0,0,0,0,0,0,0,0,0,0,0,0,0,0,0,0,0,0,0,0,1,0,0,0,0
29/6/2010,Cédric Mongongu,8432567,53,6/22/1989,21,4,0,0,0,3350,6500,5850,165,130,5608290,189,78,D RC,3,1,3,2,3,3,2,5,3,2,3,5,9,9,6,12,6,17,8,5,16,13,8,13,11,13,15,14,13,8,9,13,10,6,11,7,15,15,14,15,10,17,14,7,16,12,20,14,17,14,13,10,7,10,3,15,11,12,7,12,10,8,D RC,103,1,1,20,20,14,1,1,1,15,1,15,1,1,1,20,1,15,1,1,1,1,15,0,0,0,0,0,0,0,0,0,0,0,0,0,0,0,0,0,0,0,0,0,0,0,0,0,0,0,0,0,0,0,0,0,0,0,0,0,0,0,0,0,0,0,0,0,0,0,0,0
29/6/2010,Cata Díaz,950054,1649,7/13/1979,30,5,0,0,0,5256,7000,7000,155,145,6695841,181,80,D C,1,2,3,2,1,2,2,4,1,2,2,6,7,10,5,10,15,16,15,7,16,12,14,15,10,17,12,17,14,15,6,11,18,6,14,5,15,14,16,13,15,16,12,5,18,13,20,15,16,15,14,16,8,9,14,12,15,13,15,14,10,9,D C,101,1,1,20,20,1,1,1,1,13,10,1,1,1,1,20,1,13,1,1,1,1,1,35184372122112,0,0,0,0,0,0,0,0,0,1,0,0,0,0,0,1,0,0,0,0,0,0,0,0,0,0,0,0,0,0,0,0,0,0,0,0,0,0,0,0,0,0,0,0,0,1,0,0
29/6/2010,Carsten Rothenbach,877016,771,9/3/1980,29,0,0,0,0,3000,6350,6350,127,127,1886120,185,82,D/WB RC,1,3,1,2,2,2,2,1,3,3,2,5,12,8,6,11,8,13,9,13,13,10,3,14,8,12,14,14,13,14,7,13,12,7,12,9,13,15,11,10,9,12,13,15,13,12,20,14,15,11,14,13,9,15,9,6,12,14,13,11,6,19,D/WB RC,113,1,5,15,20,14,1,14,10,20,1,19,1,1,5,15,14,20,1,1,10,13,19,0,0,0,0,0,0,0,0,0,0,0,0,0,0,0,0,0,0,0,0,0,0,0,0,0,0,0,0,0,0,0,0,0,0,0,0,0,0,0,0,0,0,0,0,0,0,0,0,0
29/6/2010,Carsten Cullmann,3600836,771,3/5/1976,34,0,0,0,0,2250,4550,4550,130,96,183114,187,82,D RC,2,1,1,1,2,2,3,2,3,3,2,9,9,7,8,7,7,16,8,16,12,8,6,13,8,12,10,16,11,9,7,10,13,8,14,8,12,15,15,11,9,9,15,5,11,10,20,14,14,8,8,10,13,15,3,12,20,9,8,15,14,2,D RC,103,1,1,15,20,5,1,5,5,20,12,14,1,1,1,15,5,20,1,1,5,1,14,0,0,0,0,0,0,0,0,0,0,0,0,0,0,0,0,0,0,0,0,0,0,0,0,0,0,0,0,0,0,0,0,0,0,0,0,0,0,0,0,0,0,0,0,0,0,0,0,0
29/6/2010,Carlos Zambrano,77000913,1656,7/10/1989,20,11,1,0,0,3000,5900,5900,135,118,2559029,185,77,D C,1,3,2,3,1,3,1,1,3,2,3,4,4,10,8,14,5,13,14,9,12,11,9,12,14,16,14,6,13,14,9,12,10,4,9,8,12,13,13,15,12,12,14,12,13,14,20,9,9,10,7,10,7,17,7,10,15,13,9,10,12,13,D C,101,1,1,20,20,14,1,14,1,14,1,13,1,1,1,20,14,14,1,1,1,13,11,0,0,0,0,0,0,0,0,0,0,0,0,0,0,0,0,0,0,0,0,0,0,0,0,0,0,0,0,0,0,0,0,0,0,0,0,0,0,0,0,0,0,0,0,0,0,0,0,0
29/6/2010,Carlos Salcido,5662979,379,4/2/1980,30,77,6,0,0,4761,7000,6850,148,138,13199999,176,75,D LC,1,2,1,1,1,3,2,3,1,1,2,7,8,11,6,14,6,15,11,10,13,12,12,15,13,18,12,17,14,13,12,13,13,9,11,13,15,15,16,12,13,16,8,12,17,12,20,14,13,17,11,16,4,13,14,14,12,7,12,11,12,5,D LC,104,1,1,20,20,10,1,18,8,1,1,14,1,1,1,20,18,1,8,8,1,14,1,0,0,0,0,0,0,0,0,0,0,0,0,0,0,0,0,0,0,0,0,0,0,0,0,0,0,0,0,0,0,0,0,0,0,0,0,0,0,0,0,0,0,0,0,0,0,0,0,0
29/6/2010,Carlos Marchena,4204105,796,7/31/1979,30,62,2,17,0,5700,7750,7750,159,151,19237740,183,78,D/DM C,1,3,1,2,3,1,2,6,1,1,3,8,10,10,7,11,10,16,12,9,17,13,12,16,12,17,17,17,13,18,12,13,17,7,16,9,17,16,15,12,12,16,12,9,13,12,20,16,13,13,19,13,13,12,9,16,12,7,15,5,7,8,D/DM C,111,1,1,20,20,16,1,2,15,2,13,1,1,1,1,20,2,2,15,1,1,1,1,137439150080,0,0,0,0,0,0,0,0,0,0,0,0,0,0,0,0,1,1,0,0,0,0,0,0,0,0,0,0,0,0,0,0,0,0,0,0,0,1,0,0,0,0,0,0,0,0,0,0
29/6/2010,Carlos García,7440264,796,4/29/1984,26,0,0,5,0,4225,6250,6250,142,130,5016914,185,80,D C,2,2,2,3,2,2,3,5,2,2,3,5,5,5,7,8,5,16,7,12,15,13,10,14,8,17,15,13,14,11,7,13,8,2,15,8,15,14,13,12,9,13,14,20,14,10,7,14,15,15,14,7,10,12,6,10,11,10,7,10,1,9,D C,101,1,1,20,20,1,1,1,1,1,10,1,1,1,1,20,1,1,1,1,1,1,1,0,0,0,0,0,0,0,0,0,0,0,0,0,0,0,0,0,0,0,0,0,0,0,0,0,0,0,0,0,0,0,0,0,0,0,0,0,0,0,0,0,0,0,0,0,0,0,0,0
29/6/2010,Carlos Cuéllar,815160,796,8/23/1981,28,0,0,0,0,5184,6750,7200,155,144,39895331,190,84,D RC,2,1,1,3,2,3,3,3,3,2,3,7,3,5,7,12,7,15,5,13,16,4,7,15,12,13,15,14,13,16,7,11,14,2,14,9,17,15,15,13,12,15,15,8,16,12,20,16,15,14,14,12,4,10,15,18,4,12,14,10,12,5,D RC,103,1,1,20,20,1,1,1,1,17,10,1,1,1,1,20,1,17,1,1,1,1,1,137438953536,0,0,0,0,0,0,1,0,0,0,0,0,0,0,0,0,0,0,0,0,0,0,0,0,0,0,0,0,0,0,0,0,0,0,0,0,0,1,0,0,0,0,0,0,0,0,0,0
29/6/2010,Carlos Bocanegra,975000,390,5/25/1979,31,84,12,0,0,4422,7000,5950,140,133,2429434,183,78,D LC,1,1,3,1,2,1,2,4,3,3,1,7,13,7,7,10,9,16,10,13,14,10,8,13,10,12,13,17,13,13,8,12,16,8,15,6,13,16,15,12,11,14,11,20,15,11,14,15,14,16,12,12,9,15,12,14,15,14,17,15,12,10,D LC,104,1,1,17,20,10,1,20,1,1,1,15,1,1,1,17,20,11,1,1,1,15,1,0,0,0,0,0,0,0,0,0,0,0,0,0,0,0,0,0,0,0,0,0,0,0,0,0,0,0,0,0,0,0,0,0,0,0,0,0,0,0,0,0,0,0,0,0,0,0,0,0
29/6/2010,Carles Puyol,4206586,796,4/13/1978,32,90,3,9,0,7140,8600,8600,177,169,125362916,178,80,D RC,2,2,2,3,2,2,1,9,1,3,3,6,9,8,7,12,6,13,8,12,17,11,8,18,10,18,17,20,16,18,10,13,19,7,18,8,18,20,19,15,14,17,11,8,14,12,20,18,16,18,14,16,13,14,12,16,18,18,18,14,11,6,D RC,103,1,1,20,20,1,1,8,1,15,14,12,1,1,1,20,8,15,1,1,1,1,12,281758444584960,0,0,0,0,0,0,0,0,0,0,0,0,0,0,0,1,0,0,0,0,0,0,0,0,0,0,0,0,0,0,0,0,0,1,0,0,0,0,1,0,0,0,0,0,0,0,0,0
29/6/2010,Cachito Wanduka,85068980,769,2/21/1992,18,0,0,0,0,1150,4274,2350,146,95,2871008,187,76,D C,2,1,3,1,2,2,3,5,2,1,1,6,8,6,5,11,3,12,8,10,9,9,7,10,11,10,12,14,10,9,9,10,14,9,14,6,12,11,8,12,9,14,13,8,15,12,20,13,14,14,15,10,8,10,10,12,15,11,12,9,11,8,D C,101,1,1,20,20,14,1,1,10,1,1,1,1,1,1,20,1,1,10,1,1,1,1,0,0,0,0,0,0,0,0,0,0,0,0,0,0,0,0,0,0,0,0,0,0,0,0,0,0,0,0,0,0,0,0,0,0,0,0,0,0,0,0,0,0,0,0,0,0,0,0,0
29/6/2010,Bura,55003092,788,12/17/1988,21,0,0,13,2,1000,2000,2000,135,100,43107,190,82,D C,1,2,3,1,1,1,1,7,2,2,2,3,5,5,8,7,4,13,3,1,13,12,7,13,4,9,12,12,10,10,3,12,14,3,14,7,11,10,11,13,13,15,12,7,15,13,20,7,8,10,7,3,15,10,5,14,14,13,14,13,13,7,D C,101,1,1,20,20,1,1,1,1,10,1,1,1,1,1,20,1,10,1,1,1,1,1,0,0,0,0,0,0,0,0,0,0,0,0,0,0,0,0,0,0,0,0,0,0,0,0,0,0,0,0,0,0,0,0,0,0,0,0,0,0,0,0,0,0,0,0,0,0,0,0,0
29/6/2010,Bruno Miguel,8871355,788,9/24/1982,27,0,0,0,0,1000,5350,5350,110,107,177833,188,85,D C,2,1,1,3,1,2,1,5,1,1,1,7,7,7,7,9,8,14,10,10,13,7,10,11,9,14,12,12,13,13,7,11,13,6,10,9,12,12,12,10,11,14,13,5,14,10,20,13,14,14,9,12,12,9,7,12,13,10,15,14,13,5,D C,101,1,1,20,20,10,1,1,1,1,1,1,1,1,1,20,1,1,1,1,1,1,1,0,0,0,0,0,0,0,0,0,0,0,0,0,0,0,0,0,0,0,0,0,0,0,0,0,0,0,0,0,0,0,0,0,0,0,0,0,0,0,0,0,0,0,0,0,0,0,0,0
29/6/2010,Bruno Martignoni,98005663,798,12/13/1992,17,0,0,0,0,992,3250,3250,111,63,230269,178,73,D C,2,2,1,3,1,1,3,3,1,1,1,3,3,3,0,9,3,8,2,0,8,7,3,8,9,8,6,13,7,10,5,10,9,4,11,4,9,16,11,13,13,13,13,8,16,13,20,8,5,10,17,10,13,10,5,18,11,1,9,18,10,6,D C,101,1,1,20,20,1,1,1,1,1,1,1,1,1,1,20,1,1,1,1,1,1,1,0,0,0,0,0,0,0,0,0,0,0,0,0,0,0,0,0,0,0,0,0,0,0,0,0,0,0,0,0,0,0,0,0,0,0,0,0,0,0,0,0,0,0,0,0,0,0,0,0
29/6/2010,Bruno Ecuélé Manga,34010356,19,7/16/1988,21,15,2,0,0,3800,6450,4250,165,129,5000000,186,76,D C,1,2,3,3,3,2,2,4,3,3,2,5,5,5,7,8,6,13,8,7,15,7,10,12,8,10,14,14,13,13,9,14,14,5,12,6,14,13,13,15,8,15,13,5,15,14,20,16,15,15,10,15,5,10,12,15,13,14,14,16,16,5,D C,101,1,1,20,20,1,1,1,1,1,1,1,1,1,1,20,1,1,1,1,1,1,1,32768,0,0,0,0,0,0,0,0,0,0,0,0,0,0,0,1,0,0,0,0,0,0,0,0,0,0,0,0,0,0,0,0,0,0,0,0,0,0,0,0,0,0,0,0,0,0,0,0
29/6/2010,Breno,2115209,1651,10/13/1989,20,0,0,0,0,4000,7250,6650,164,136,24822305,187,83,D C,1,1,2,1,1,1,1,7,3,1,3,4,7,11,6,11,6,15,7,9,14,12,8,15,13,10,12,10,13,15,8,12,16,9,7,10,14,13,14,11,7,14,16,13,15,14,20,15,15,16,6,15,3,4,3,16,15,15,15,13,9,6,D C,101,1,1,20,20,12,1,1,1,11,10,6,1,1,1,20,1,11,1,1,1,1,6,274877906976,0,0,0,0,0,1,0,0,0,0,0,0,0,0,0,0,0,0,0,0,0,0,0,0,0,0,0,0,0,0,0,0,0,0,0,0,0,0,1,0,0,0,0,0,0,0,0,0
29/6/2010,Brede Hangeland,753920,786,6/20/1981,29,61,0,12,0,6006,7100,7500,160,155,15735594,195,92,D C,3,3,2,3,2,2,1,2,1,2,3,4,4,6,6,11,4,17,4,8,16,13,4,15,10,14,16,16,14,14,9,14,15,8,16,8,15,15,14,10,10,15,18,12,14,13,20,14,16,15,4,17,8,14,14,14,15,11,16,17,14,3,D C,101,1,1,20,20,10,1,1,1,1,10,1,1,1,1,20,1,1,1,1,1,1,1,1073741952,0,0,0,0,0,0,0,1,0,0,0,0,0,0,0,0,0,0,0,0,0,0,0,0,0,0,0,0,0,0,1,0,0,0,0,0,0,0,0,0,0,0,0,0,0,0,0,0
29/6/2010,Branko Lazarevic,5758778,802,5/14/1984,26,0,0,3,0,1750,5600,5600,132,124,2361631,185,81,D C,3,1,2,1,1,1,2,6,1,2,2,8,13,11,8,11,5,12,8,11,14,8,11,14,14,12,12,12,12,11,14,11,13,13,13,11,12,12,12,13,13,15,12,20,12,14,5,16,12,13,9,12,7,10,10,14,12,13,13,11,13,4,D C,101,1,1,20,20,8,1,12,1,5,10,12,1,1,1,20,12,5,1,1,1,12,5,0,0,0,0,0,0,0,0,0,0,0,0,0,0,0,0,0,0,0,0,0,0,0,0,0,0,0,0,0,0,0,0,0,0,0,0,0,0,0,0,0,0,0,0,0,0,0,0,0
29/6/2010,Branislav Ivanovic,5743241,802,4/22/1984,26,34,4,37,5,6480,7650,7750,163,161,105617647,185,89,D RC,3,3,3,3,2,2,1,3,3,3,1,7,12,10,10,14,10,16,7,15,15,12,10,17,11,12,15,16,12,14,13,14,15,6,11,14,16,14,15,15,11,14,12,10,10,13,20,16,16,16,10,13,10,14,12,16,11,14,13,15,12,10,D RC,103,1,1,18,20,1,1,12,1,20,1,14,1,1,1,18,12,20,1,1,1,12,14,0,0,0,0,0,0,0,0,0,0,0,0,0,0,0,0,0,0,0,0,0,0,0,0,0,0,0,0,0,0,0,0,0,0,0,0,0,0,0,0,0,0,0,0,0,0,0,0,0
29/6/2010,Bostjan Cesar,652520,795,7/9/1982,27,46,3,15,1,4032,6985,6450,139,127,1614715,191,89,D C,1,1,2,2,3,1,2,2,3,1,2,5,5,8,6,9,5,15,9,7,15,9,7,14,11,15,13,15,13,13,7,12,16,6,14,7,13,14,14,12,8,17,15,20,13,10,9,15,17,14,15,13,11,6,14,12,13,13,12,9,9,10,D C,101,1,1,20,20,1,1,10,1,1,12,1,1,1,1,20,10,1,1,1,1,1,1,137439117312,0,0,0,0,0,0,0,0,0,0,0,0,0,0,0,1,0,1,0,0,0,0,0,0,0,0,0,0,0,0,0,0,0,0,0,0,0,1,0,0,0,0,0,0,0,0,0,0
29/6/2010,Boris Leschinski,890457,771,11/7/1983,26,0,0,0,0,400,4450,4450,102,89,997463,182,74,D/DM C,3,1,1,2,3,3,1,3,2,1,3,4,3,6,6,8,7,13,9,7,8,7,6,11,9,11,8,6,10,11,7,9,10,8,8,9,13,13,11,13,12,12,12,16,11,11,20,10,11,8,4,8,8,12,6,1,11,14,15,11,8,12,D/DM C,111,1,1,20,20,20,1,10,15,10,1,1,1,1,1,20,10,10,15,1,1,1,1,0,0,0,0,0,0,0,0,0,0,0,0,0,0,0,0,0,0,0,0,0,0,0,0,0,0,0,0,0,0,0,0,0,0,0,0,0,0,0,0,0,0,0,0,0,0,0,0,0
29/6/2010,Bobo Baldé,402970,22,10/5/1975,34,31,4,0,0,3481,5900,5300,146,118,430575,192,95,D C,1,3,2,2,2,3,1,2,2,2,1,2,5,5,8,6,7,16,7,11,14,7,5,15,6,15,14,18,9,12,7,11,16,5,13,8,13,13,13,10,6,18,16,5,10,8,20,12,18,12,15,15,14,7,14,12,13,15,12,12,15,9,D C,101,1,1,20,20,1,1,1,1,1,10,1,1,1,1,20,1,1,1,1,1,1,1,137438954016,0,0,0,0,0,1,0,0,0,1,0,0,0,0,0,0,0,0,0,0,0,0,0,0,0,0,0,0,0,0,0,0,0,0,0,0,0,1,0,0,0,0,0,0,0,0,0,0
29/6/2010,Bo Svensson,7300032,764,8/4/1979,30,1,0,2,0,3650,6000,6300,128,126,2610835,190,85,D C,3,1,3,2,2,1,2,5,3,1,2,4,8,5,6,13,4,14,8,16,15,13,7,13,11,13,13,13,13,16,12,14,11,4,9,9,14,9,12,12,7,14,15,3,13,11,20,14,14,14,10,6,6,13,12,11,10,11,11,6,7,12,D C,101,1,1,20,20,7,1,4,5,12,8,5,1,1,1,20,4,12,5,1,5,1,5,4294967296,0,0,0,0,0,0,0,0,0,0,0,0,0,0,0,0,0,0,0,0,0,0,0,0,0,0,0,0,0,0,0,0,1,0,0,0,0,0,0,0,0,0,0,0,0,0,0,0
29/6/2010,Blazej Augustyn,29003178,787,1/26/1988,22,0,0,0,0,3192,5084,5500,142,113,1833399,191,89,D/WB RLC,2,2,2,3,3,2,1,1,3,2,2,4,12,7,6,10,9,12,15,10,12,12,9,13,10,13,12,13,10,11,11,12,14,7,8,12,12,11,13,12,12,13,13,6,8,11,20,13,13,12,13,10,8,12,15,12,11,12,15,12,12,14,D/WB RLC,116,1,1,19,20,15,1,20,15,15,1,18,1,1,1,19,20,15,15,1,1,18,14,512,0,0,0,0,0,0,0,0,0,1,0,0,0,0,0,0,0,0,0,0,0,0,0,0,0,0,0,0,0,0,0,0,0,0,0,0,0,0,0,0,0,0,0,0,0,0,0,0
29/6/2010,Bira Dembelé,8449424,769,3/22/1988,22,0,0,0,0,3422,5300,5300,145,117,908053,189,75,D LC,3,1,2,1,1,1,1,7,1,2,1,5,7,7,7,7,7,15,9,8,13,8,6,11,8,12,14,13,15,13,6,11,14,6,11,7,13,12,14,13,8,16,14,20,11,11,10,14,14,14,12,7,17,10,6,16,14,14,14,4,13,6,D LC,104,1,1,20,20,1,1,15,1,1,1,1,1,1,1,20,15,1,1,1,1,1,1,0,0,0,0,0,0,0,0,0,0,0,0,0,0,0,0,0,0,0,0,0,0,0,0,0,0,0,0,0,0,0,0,0,0,0,0,0,0,0,0,0,0,0,0,0,0,0,0,0
29/6/2010,Benjamin Stambouli,34008684,769,8/13/1990,19,0,0,0,0,1350,2700,2700,140,108,1885380,180,75,D/DM C,2,2,3,2,2,3,2,1,1,2,2,6,8,8,5,11,6,12,8,6,12,12,6,11,11,11,13,13,14,14,12,11,14,5,13,7,13,16,14,11,12,14,10,5,15,10,20,16,14,14,11,14,5,10,7,13,14,15,15,15,15,5,D/DM C,111,1,1,20,20,16,1,1,15,1,1,1,1,1,1,20,1,1,15,1,1,1,1,0,0,0,0,0,0,0,0,0,0,0,0,0,0,0,0,0,0,0,0,0,0,0,0,0,0,0,0,0,0,0,0,0,0,0,0,0,0,0,0,0,0,0,0,0,0,0,0,0
29/6/2010,Benjamin Oliveras,915957,769,2/7/1982,28,0,0,0,0,800,4350,4350,115,97,1918044,181,72,D LC,3,1,1,3,3,1,2,3,1,1,2,5,7,7,6,7,6,12,9,8,10,8,6,10,9,13,12,15,12,13,6,12,16,6,11,7,12,12,14,12,9,13,10,20,15,11,10,14,11,16,13,14,10,10,6,12,12,12,13,13,13,7,D LC,104,1,1,20,20,13,1,15,1,10,1,10,1,1,1,20,15,10,1,1,1,10,10,0,0,0,0,0,0,0,0,0,0,0,0,0,0,0,0,0,0,0,0,0,0,0,0,0,0,0,0,0,0,0,0,0,0,0,0,0,0,0,0,0,0,0,0,0,0,0,0,0
29/6/2010,Benjamin Angoua,38001740,24,11/28/1986,23,7,1,4,1,3481,5900,5300,140,118,2686252,183,72,D/DM RC,2,2,3,2,2,1,3,8,2,1,1,5,9,6,6,7,5,14,7,10,13,8,6,13,7,13,15,14,15,13,10,12,13,9,6,8,13,15,13,10,12,14,12,10,13,14,20,15,13,15,13,13,8,10,14,12,13,13,14,11,11,7,D/DM RC,113,1,1,20,20,18,1,1,15,15,1,15,1,1,1,20,1,15,15,1,1,1,15,0,0,0,0,0,0,0,0,0,0,0,0,0,0,0,0,0,0,0,0,0,0,0,0,0,0,0,0,0,0,0,0,0,0,0,0,0,0,0,0,0,0,0,0,0,0,0,0,0
29/6/2010,Benedikt Höwedes,35015879,771,2/29/1988,22,0,0,21,3,4500,7000,7000,164,149,26511837,187,78,D C,1,1,2,3,2,3,1,2,1,1,2,3,8,4,6,10,3,17,4,12,15,8,8,17,9,17,12,18,11,18,7,10,17,3,14,6,14,18,17,12,10,13,16,12,13,15,20,16,15,16,9,16,3,14,9,14,19,14,17,16,14,3,D C,101,1,1,20,20,10,1,14,1,12,1,1,1,1,1,20,14,12,1,1,1,1,1,137438986240,0,0,0,0,0,0,0,0,0,0,0,0,0,0,0,1,0,0,0,0,0,0,0,0,0,0,0,0,0,0,0,0,0,0,0,0,0,1,0,0,0,0,0,0,0,0,0,0
29/6/2010,Baltasar Rigo,1501608,796,6/26/1985,25,0,0,0,0,1750,4250,4250,102,91,1636191,185,81,D C,3,3,2,2,3,3,3,3,3,1,2,6,8,5,8,9,12,15,13,7,13,9,10,11,9,16,11,13,8,12,6,10,10,4,8,6,12,12,12,6,7,16,13,20,8,8,5,12,13,17,13,12,19,3,12,19,14,14,13,14,13,20,D C,101,1,1,20,20,5,1,7,1,1,9,2,1,1,1,20,7,1,1,1,1,2,1,35184372089344,0,0,0,0,0,0,0,0,0,1,0,0,0,0,0,0,0,0,0,0,0,0,0,0,0,0,0,0,0,0,0,0,0,0,0,0,0,0,0,0,0,0,0,0,0,1,0,0
29/6/2010,Bakary Soro,8631066,24,12/5/1985,24,0,0,5,0,3300,5750,5150,140,115,2149819,184,74,D/WB RC,3,1,1,2,1,1,2,1,1,2,1,5,11,8,5,8,6,14,6,10,12,9,7,13,9,14,12,13,13,13,8,12,17,7,13,8,13,13,13,13,10,14,12,8,14,11,20,16,14,14,13,11,9,12,8,13,13,12,15,15,15,6,D/WB RC,113,1,1,20,20,12,1,10,8,17,1,17,1,1,1,20,10,17,8,1,1,10,17,0,0,0,0,0,0,0,0,0,0,0,0,0,0,0,0,0,0,0,0,0,0,0,0,0,0,0,0,0,0,0,0,0,0,0,0,0,0,0,0,0,0,0,0,0,0,0,0,0
29/6/2010,Bakar,55024935,770,5/24/1992,18,0,0,0,0,500,3374,3000,124,75,280088,184,75,D C,1,1,1,2,1,2,1,5,1,3,2,5,6,6,7,9,3,11,6,7,11,7,9,10,10,13,10,11,12,11,7,9,10,6,11,7,11,10,10,10,11,12,11,8,12,10,20,10,11,12,11,11,7,8,14,9,7,15,7,8,8,2,D C,101,1,1,20,20,1,1,1,1,1,1,1,1,1,1,20,1,1,1,1,1,1,1,0,0,0,0,0,0,0,0,0,0,0,0,0,0,0,0,0,0,0,0,0,0,0,0,0,0,0,0,0,0,0,0,0,0,0,0,0,0,0,0,0,0,0,0,0,0,0,0,0
29/6/2010,Aythami,7458270,796,4/2/1986,24,0,0,0,0,4000,5800,5800,151,128,1845074,185,79,D C,1,2,1,1,3,3,3,3,2,2,2,7,8,10,4,9,6,16,10,14,14,11,9,14,13,13,14,12,14,10,12,12,12,13,13,11,13,14,14,10,11,13,14,10,14,12,20,13,12,14,10,15,4,12,13,16,12,8,14,12,12,7,D C,101,1,1,20,20,1,1,1,1,1,10,1,1,1,1,20,1,1,1,1,1,1,1,8800387989504,0,0,0,0,0,0,0,0,0,0,0,0,0,0,0,0,0,0,0,0,0,0,0,0,0,0,0,0,0,0,0,0,1,0,0,0,0,0,0,0,0,0,0,1,0,0,0,0
29/6/2010,Aurélien Collin,8447129,769,3/8/1986,24,0,0,0,0,1600,5450,5550,123,112,267845,185,77,D C,3,2,1,1,3,2,3,3,1,2,3,7,7,6,6,10,8,16,9,8,13,8,10,12,9,14,8,15,11,10,7,7,12,6,12,9,12,13,13,12,10,14,14,10,15,11,20,14,15,9,12,10,8,12,10,12,10,11,12,10,12,9,D C,101,1,1,20,20,7,1,1,1,10,1,7,1,1,1,20,1,10,1,1,1,1,7,137438953472,0,0,0,0,0,0,0,0,0,0,0,0,0,0,0,0,0,0,0,0,0,0,0,0,0,0,0,0,0,0,0,0,0,0,0,0,0,1,0,0,0,0,0,0,0,0,0,0
29/6/2010,Aurélien Chedjou,8439083,11,6/20/1985,25,10,0,4,0,4970,7050,6350,150,141,5142818,184,84,D/DM C,2,3,1,3,2,3,3,4,2,1,3,10,9,11,7,13,10,15,13,6,15,13,10,13,13,14,16,14,13,13,12,12,15,8,12,8,15,13,15,15,12,16,12,8,14,13,20,14,16,15,14,14,7,14,11,14,13,14,15,14,14,5,D/DM C,111,1,12,20,20,16,1,10,15,1,1,1,12,10,1,20,1,1,15,10,1,1,1,512,0,0,0,0,0,0,0,0,0,1,0,0,0,0,0,0,0,0,0,0,0,0,0,0,0,0,0,0,0,0,0,0,0,0,0,0,0,0,0,0,0,0,0,0,0,0,0,0
29/6/2010,Arne Friedrich,6002074,771,5/29/1979,31,79,1,5,0,5852,8150,8150,153,153,12553294,185,80,D RC,2,2,2,3,1,3,2,6,3,3,1,4,8,7,3,10,5,12,4,13,17,8,7,16,9,12,16,13,15,18,7,10,11,3,12,6,17,19,14,15,9,14,16,9,17,17,20,15,16,11,6,19,11,10,2,4,18,13,20,17,19,6,D RC,103,1,1,20,20,1,1,1,1,17,1,12,1,1,1,20,1,17,1,1,1,1,12,8589967424,0,0,0,0,0,0,1,0,0,0,0,0,0,0,0,1,0,0,0,0,0,0,0,0,0,0,0,0,0,0,0,0,0,1,0,0,0,0,0,0,0,0,0,0,0,0,0,0
29/6/2010,Armin Bacinovic,64001279,795,10/24/1989,20,1,0,11,4,3250,6000,5500,148,117,5135258,183,75,DM/M C,3,2,3,3,1,1,2,1,1,3,1,10,11,12,11,11,8,15,13,8,14,13,9,12,13,10,14,12,15,13,11,11,15,12,9,14,10,13,13,13,12,13,12,20,13,12,7,13,12,12,13,13,11,12,14,12,12,15,10,10,11,13,DM/M C,311,1,1,20,15,20,1,1,17,14,13,1,1,1,1,15,1,14,17,1,1,1,1,512,0,0,0,0,0,0,0,0,0,1,0,0,0,0,0,0,0,0,0,0,0,0,0,0,0,0,0,0,0,0,0,0,0,0,0,0,0,0,0,0,0,0,0,0,0,0,0,0
29/6/2010,Anton Ferdinand,5112089,765,2/18/1985,25,0,0,17,0,4225,6700,6700,143,130,5534444,183,72,D C,2,1,1,3,2,3,2,4,2,1,1,5,7,11,5,14,4,14,8,12,14,13,7,14,12,12,12,12,13,8,8,14,14,8,13,10,13,13,14,15,13,14,12,12,14,14,20,11,13,10,4,12,14,14,7,9,16,8,10,14,10,3,D C,101,1,1,20,20,5,1,14,1,12,1,1,1,1,1,20,14,12,1,1,1,1,1,0,0,0,0,0,0,0,0,0,0,0,0,0,0,0,0,0,0,0,0,0,0,0,0,0,0,0,0,0,0,0,0,0,0,0,0,0,0,0,0,0,0,0,0,0,0,0,0,0
29/6/2010,Antolín Alcaraz,745751,1655,7/30/1982,27,10,1,0,0,3906,6875,6400,131,125,4980167,184,80,D C,1,1,2,1,3,1,1,5,3,1,3,9,8,11,7,12,9,16,10,10,17,11,10,15,10,13,17,14,12,8,5,8,13,6,11,10,12,15,15,13,8,15,14,5,14,12,20,8,16,13,11,10,5,7,12,15,12,13,14,11,10,5,D C,101,1,1,20,20,1,1,1,1,5,5,1,1,1,1,20,1,5,1,1,1,1,1,98304,0,0,0,0,0,0,0,0,0,0,0,0,0,0,0,1,1,0,0,0,0,0,0,0,0,0,0,0,0,0,0,0,0,0,0,0,0,0,0,0,0,0,0,0,0,0,0,0
29/6/2010,Anthony Vanden Borre,8152564,757,10/24/1987,22,22,1,6,2,4096,5759,5750,152,128,880576,185,80,WB/DM/M RC,1,2,1,1,1,2,2,4,1,1,2,14,14,14,10,16,13,10,9,13,12,13,14,15,16,12,16,14,16,7,10,10,16,15,6,16,11,10,11,12,12,15,11,5,17,14,20,16,13,9,12,7,7,19,8,14,7,12,7,11,10,13,WB/DM/M RC,433,1,1,20,15,16,1,10,20,18,7,18,1,1,1,15,5,15,20,10,15,5,18,0,0,0,0,0,0,0,0,0,0,0,0,0,0,0,0,0,0,0,0,0,0,0,0,0,0,0,0,0,0,0,0,0,0,0,0,0,0,0,0,0,0,0,0,0,0,0,0,0
29/6/2010,Anselmo,316326,1651,6/10/1981,29,0,0,0,0,1000,2200,5000,103,100,127080,184,77,D C,3,3,3,2,1,3,2,3,1,1,1,7,7,7,6,11,10,13,9,10,13,9,9,11,11,12,11,11,11,11,7,10,14,7,10,8,12,10,12,9,10,12,12,20,10,9,5,14,13,13,10,11,11,11,7,11,13,12,11,14,14,5,D C,101,1,1,20,20,10,1,10,5,1,5,10,1,1,1,20,10,1,5,1,1,10,1,0,0,0,0,0,0,0,0,0,0,0,0,0,0,0,0,0,0,0,0,0,0,0,0,0,0,0,0,0,0,0,0,0,0,0,0,0,0,0,0,0,0,0,0,0,0,0,0,0
29/6/2010,Anis Bouziane,91003262,5,10/13/1985,24,0,0,0,0,1225,1100,3000,75,70,181157,185,83,D C,1,2,3,1,2,3,3,2,2,3,3,1,1,6,6,7,1,9,3,6,12,9,6,12,4,6,8,13,8,7,0,12,10,4,3,8,8,6,10,12,10,9,9,20,13,12,8,7,7,10,5,7,13,10,9,11,13,7,10,8,5,13,D C,101,1,1,20,20,1,1,1,1,1,1,1,1,1,1,20,1,1,1,1,1,1,1,0,0,0,0,0,0,0,0,0,0,0,0,0,0,0,0,0,0,0,0,0,0,0,0,0,0,0,0,0,0,0,0,0,0,0,0,0,0,0,0,0,0,0,0,0,0,0,0,0
29/6/2010,Ángel Dealbert,7443877,796,7/1/1983,26,0,0,0,0,4900,6750,6750,145,140,86992260,185,75,D C,1,3,3,1,1,2,3,7,3,2,2,4,6,8,3,9,6,16,8,8,16,12,6,13,11,12,16,15,13,16,10,12,17,6,15,6,17,16,15,12,11,16,13,9,14,12,20,15,12,17,7,12,5,8,12,16,14,13,18,14,12,8,D C,101,1,1,20,20,12,1,1,4,5,7,1,1,1,1,20,1,5,4,1,1,1,1,274877939712,0,0,0,0,0,0,0,0,0,0,0,0,0,0,0,1,0,0,0,0,0,0,0,0,0,0,0,0,0,0,0,0,0,0,0,0,0,0,1,0,0,0,0,0,0,0,0,0
29/6/2010,Andy Wilkinson,5107983,765,8/6/1984,25,0,0,0,0,3550,6150,6150,137,128,14972557,181,70,D RC,2,2,3,3,3,3,2,4,3,3,2,7,9,8,7,11,5,14,8,11,13,11,5,14,13,17,12,18,10,13,8,13,15,9,15,9,14,15,16,12,11,12,11,5,14,13,20,15,16,15,17,12,15,16,5,7,15,12,15,10,15,8,D RC,103,1,1,20,20,5,1,14,1,18,1,10,1,1,1,20,14,18,1,1,1,1,10,137438953472,0,0,0,0,0,0,0,0,0,0,0,0,0,0,0,0,0,0,0,0,0,0,0,0,0,0,0,0,0,0,0,0,0,0,0,0,0,1,0,0,0,0,0,0,0,0,0,0
29/6/2010,Andy O'Brien,2005063,789,6/29/1979,31,26,1,8,1,4096,6400,6400,135,128,1941937,191,78,D C,2,1,3,1,3,3,2,1,2,2,2,1,6,3,6,11,6,15,6,1,13,13,4,15,11,12,13,15,12,11,11,13,15,4,13,12,14,14,14,12,12,13,14,4,13,13,20,16,14,11,12,10,7,9,13,13,18,12,16,15,16,1,D C,101,1,1,20,20,1,1,1,1,10,1,1,1,1,1,20,1,10,1,1,1,1,1,296352743424,0,0,0,0,0,0,0,0,0,0,0,0,0,0,0,0,0,0,0,0,0,0,0,0,0,0,0,0,0,0,0,0,1,0,1,0,0,0,1,0,0,0,0,0,0,0,0,0
29/6/2010,Andreu Fontàs,67038644,796,11/14/1989,20,0,0,0,0,3906,6250,6250,160,125,5637399,186,84,D/DM C,3,3,1,3,3,3,2,1,1,1,1,5,6,7,5,13,7,13,7,7,13,13,10,12,11,8,13,11,12,14,12,13,10,8,12,7,15,15,14,12,9,15,13,20,11,13,7,14,14,15,9,10,6,9,14,11,8,14,13,8,10,9,D/DM C,111,1,1,20,20,17,1,13,15,1,1,1,1,1,1,20,13,1,15,1,1,1,1,0,0,0,0,0,0,0,0,0,0,0,0,0,0,0,0,0,0,0,0,0,0,0,0,0,0,0,0,0,0,0,0,0,0,0,0,0,0,0,0,0,0,0,0,0,0,0,0,0
29/6/2010,Andreas Wolf,890347,771,6/12/1982,28,0,0,0,0,2750,6550,6550,144,130,4219206,182,77,D C,3,3,1,3,2,3,2,5,2,2,1,5,5,10,4,9,6,16,5,9,12,10,8,16,10,17,12,16,12,13,8,13,11,7,15,8,10,13,16,11,12,12,15,10,15,11,20,15,16,8,10,14,5,7,14,5,1,9,13,11,5,13,D C,101,1,1,20,20,6,1,8,1,12,1,6,1,1,1,20,8,12,1,1,1,6,6,137438986240,0,0,0,0,0,0,0,0,0,0,0,0,0,0,0,1,0,0,0,0,0,0,0,0,0,0,0,0,0,0,0,0,0,0,0,0,0,1,0,0,0,0,0,0,0,0,0,0
29/6/2010,Andrea Ranocchia,7988517,776,2/16/1988,22,0,0,9,1,3100,7000,7000,165,145,6467680,195,82,D C,2,1,3,1,2,1,2,9,1,2,2,1,3,4,6,9,2,16,2,3,16,8,4,16,8,13,15,16,12,15,8,11,17,6,10,5,16,14,15,12,13,16,18,7,11,11,20,15,17,14,9,15,3,10,16,20,17,11,15,17,10,1,D C,101,1,1,20,20,1,1,1,1,1,1,1,1,1,1,20,1,1,1,1,1,1,1,0,0,0,0,0,0,0,0,0,0,0,0,0,0,0,0,0,0,0,0,0,0,0,0,0,0,0,0,0,0,0,0,0,0,0,0,0,0,0,0,0,0,0,0,0,0,0,0,0
29/6/2010,Andrea Raggi,837002,776,6/24/1984,26,0,0,3,0,3906,6300,6300,138,125,6042783,184,80,D RLC,2,2,2,2,3,1,2,2,3,3,3,5,13,5,4,10,6,13,5,10,13,8,4,13,10,14,13,14,7,10,5,12,12,8,10,10,13,17,13,14,13,11,13,12,9,16,20,15,13,10,14,13,13,13,8,12,6,4,14,12,11,5,D RLC,106,1,1,20,20,1,1,15,1,20,1,10,1,1,1,20,15,20,1,1,1,1,10,0,0,0,0,0,0,0,0,0,0,0,0,0,0,0,0,0,0,0,0,0,0,0,0,0,0,0,0,0,0,0,0,0,0,0,0,0,0,0,0,0,0,0,0,0,0,0,0,0
29/6/2010,Andrea Masiello,7984549,776,2/5/1986,24,0,0,0,0,3500,6650,6650,156,141,4286859,185,75,D RC,1,2,2,1,1,1,2,5,3,2,2,3,8,7,5,10,5,15,5,3,16,10,4,16,10,13,16,15,14,13,8,14,14,12,16,8,16,14,13,13,13,14,13,6,14,13,20,16,15,14,8,14,7,10,14,16,16,3,16,14,11,3,D RC,103,1,1,20,20,1,1,9,1,18,13,1,1,1,1,20,9,18,1,1,1,1,1,0,0,0,0,0,0,0,0,0,0,0,0,0,0,0,0,0,0,0,0,0,0,0,0,0,0,0,0,0,0,0,0,0,0,0,0,0,0,0,0,0,0,0,0,0,0,0,0,0
29/6/2010,Andrea Mantovani,837215,776,6/22/1984,26,0,0,17,0,3500,6400,6400,142,130,6177646,185,79,D/WB LC,3,1,1,2,2,3,3,4,1,2,3,8,12,7,9,12,10,11,8,11,13,10,7,13,10,12,15,13,10,14,11,12,14,5,10,12,11,12,13,14,13,11,12,20,12,16,8,16,13,15,8,12,8,15,11,9,10,10,12,10,7,1,D/WB LC,114,1,1,18,20,1,1,20,1,10,1,20,1,1,1,18,20,10,1,1,1,20,10,0,0,0,0,0,0,0,0,0,0,0,0,0,0,0,0,0,0,0,0,0,0,0,0,0,0,0,0,0,0,0,0,0,0,0,0,0,0,0,0,0,0,0,0,0,0,0,0,0
29/6/2010,Andrea Esposito,837132,776,5/17/1986,24,0,0,0,0,2500,6000,6000,151,130,1943793,187,78,D C,1,1,1,1,1,1,1,1,1,1,1,8,8,8,8,10,3,16,8,2,15,10,8,14,10,13,13,15,13,14,6,14,13,6,6,10,13,15,16,13,12,10,16,20,17,13,5,16,11,11,10,9,5,8,14,19,16,10,9,12,17,1,D C,101,1,1,20,20,1,1,1,1,12,1,1,1,1,1,20,1,12,1,1,1,1,1,0,0,0,0,0,0,0,0,0,0,0,0,0,0,0,0,0,0,0,0,0,0,0,0,0,0,0,0,0,0,0,0,0,0,0,0,0,0,0,0,0,0,0,0,0,0,0,0,0
29/6/2010,Andrea Coda,7982658,776,4/25/1985,25,0,0,16,0,3400,6600,6600,148,132,10974696,188,81,D C,3,1,3,2,2,3,1,5,3,2,1,3,4,5,7,8,3,14,10,3,14,12,6,16,8,11,17,20,10,12,9,12,15,3,10,5,14,15,16,11,11,16,15,7,12,12,20,12,16,13,12,14,8,6,9,11,16,14,17,16,19,4,D C,101,1,1,20,20,1,1,1,1,1,1,1,1,1,1,20,1,1,1,1,1,1,1,0,0,0,0,0,0,0,0,0,0,0,0,0,0,0,0,0,0,0,0,0,0,0,0,0,0,0,0,0,0,0,0,0,0,0,0,0,0,0,0,0,0,0,0,0,0,0,0,0
29/6/2010,Andrea Barzagli,6100324,776,5/8/1981,29,25,0,15,0,5041,7000,7100,153,142,3601344,186,79,D C,2,2,1,2,2,3,3,5,3,3,3,4,4,6,5,12,3,9,4,8,14,11,6,15,12,8,18,10,16,18,10,16,10,3,13,5,18,17,8,8,7,14,15,10,15,16,20,13,15,17,3,12,5,5,9,10,13,15,17,18,20,7,D C,101,1,1,20,20,1,1,1,1,1,10,1,1,1,1,20,1,1,1,1,1,1,1,283467841536,0,0,0,0,0,0,0,0,0,0,0,0,0,0,0,0,0,0,0,0,0,0,0,0,0,0,0,0,0,0,0,0,0,1,0,0,0,0,1,0,0,0,0,0,0,0,0,0
29/6/2010,André Pinto,55009586,788,10/5/1989,20,0,0,0,0,1250,4500,4500,113,94,21585,192,86,D C,1,2,1,3,3,2,2,1,1,3,2,6,6,6,9,9,14,12,15,12,11,9,11,10,9,14,11,13,9,9,7,9,16,6,10,10,11,11,11,11,11,15,13,8,14,10,20,12,13,12,10,10,10,8,12,12,15,13,14,13,13,7,D C,101,1,1,20,20,1,1,1,1,1,1,1,1,1,1,20,1,1,1,1,1,1,1,0,0,0,0,0,0,0,0,0,0,0,0,0,0,0,0,0,0,0,0,0,0,0,0,0,0,0,0,0,0,0,0,0,0,0,0,0,0,0,0,0,0,0,0,0,0,0,0,0
29/6/2010,André Luiz,317148,1651,1/27/1980,30,0,0,0,0,4556,6050,6050,142,135,2767566,185,88,D/DM C,1,1,2,1,2,1,1,6,1,3,3,5,9,9,8,12,9,16,12,7,15,11,8,14,12,16,16,15,14,14,9,13,16,5,14,8,13,14,14,13,9,17,12,8,16,11,20,16,17,16,16,14,5,8,12,14,13,14,14,12,12,9,D/DM C,321,1,7,20,18,20,1,1,15,1,10,1,7,1,1,18,1,1,15,1,1,1,1,8813273088000,0,0,0,0,0,0,0,0,0,0,0,0,0,0,0,0,1,1,0,0,0,0,0,0,0,0,0,0,0,0,0,0,0,0,1,0,0,0,0,0,0,0,0,1,0,0,0,0
29/6/2010,André Dias,3301312,1651,5/15/1979,31,0,0,0,0,4750,7400,7100,150,143,5682499,184,80,D C,2,1,3,3,2,2,3,1,1,2,1,3,5,8,7,6,3,15,3,3,16,8,10,18,13,17,16,11,16,14,5,13,14,3,16,5,15,14,14,13,12,14,13,9,16,13,20,16,14,15,10,16,4,5,12,16,13,15,15,14,12,10,D C,101,1,1,20,20,8,1,1,1,10,12,1,1,1,1,20,1,10,1,1,1,1,1,0,0,0,0,0,0,0,0,0,0,0,0,0,0,0,0,0,0,0,0,0,0,0,0,0,0,0,0,0,0,0,0,0,0,0,0,0,0,0,0,0,0,0,0,0,0,0,0,0
29/6/2010,Anderson Polga,303486,1651,2/9/1979,31,12,3,0,0,4225,6500,6500,136,130,2585782,182,79,D C,3,3,2,3,3,2,3,1,3,3,1,8,8,8,10,12,11,14,10,10,14,10,13,14,12,13,15,11,17,14,10,13,13,6,16,8,14,14,12,11,13,14,14,7,14,11,20,13,13,14,9,12,10,10,15,13,16,14,16,13,16,7,D C,101,1,1,20,20,10,1,1,5,5,8,1,1,1,1,20,1,5,5,1,1,1,1,8589934592,0,0,0,0,0,0,0,0,0,0,0,0,0,0,0,0,0,0,0,0,0,0,0,0,0,0,0,0,0,0,0,0,0,1,0,0,0,0,0,0,0,0,0,0,0,0,0,0
29/6/2010,Ânderson do Ó,3300677,1651,12/14/1980,29,0,0,0,0,1750,4500,4500,103,100,849130,190,85,D LC,2,3,1,3,2,2,3,1,1,1,1,6,8,9,6,8,12,13,8,10,11,12,12,11,11,12,10,11,9,10,10,8,12,8,12,6,14,12,12,10,8,14,14,20,12,11,10,12,14,12,7,13,7,5,12,14,5,11,13,12,12,6,D LC,104,1,1,20,20,5,1,17,1,10,10,5,1,1,1,20,17,10,1,1,1,5,3,43980465111040,0,0,0,0,0,0,0,0,0,0,0,0,0,0,0,0,0,0,0,0,0,0,0,0,0,0,0,0,0,0,0,0,0,0,0,0,0,0,0,0,0,0,0,1,0,1,0,0
29/6/2010,Anderson Bamba,19000542,1651,1/10/1988,22,0,0,0,0,1750,4900,6000,145,123,3888480,188,88,D C,2,3,3,3,2,2,1,4,3,1,2,3,9,10,7,12,6,14,4,3,11,12,6,14,13,9,14,10,9,10,10,13,12,10,8,7,13,14,12,15,13,12,16,6,13,17,20,14,12,14,7,10,11,10,14,15,7,12,14,1,13,5,D C,101,1,1,20,20,14,1,1,1,12,1,1,1,1,1,20,1,12,1,1,1,1,1,32,0,0,0,0,0,1,0,0,0,0,0,0,0,0,0,0,0,0,0,0,0,0,0,0,0,0,0,0,0,0,0,0,0,0,0,0,0,0,0,0,0,0,0,0,0,0,0,0
29/6/2010,Amoreirinha,741693,788,8/5/1984,25,0,0,12,0,2162,4500,4500,105,93,110643,180,75,D C,2,1,3,3,2,3,1,2,2,1,1,7,9,7,9,9,7,11,9,11,11,10,9,11,9,12,11,10,14,15,10,10,15,6,9,10,10,12,11,11,11,11,14,7,13,11,20,12,12,9,8,8,7,14,1,13,10,13,14,13,13,5,D C,101,1,1,20,20,10,1,5,3,13,1,10,1,1,1,20,5,13,1,1,3,5,10,32768,0,0,0,0,0,0,0,0,0,0,0,0,0,0,0,1,0,0,0,0,0,0,0,0,0,0,0,0,0,0,0,0,0,0,0,0,0,0,0,0,0,0,0,0,0,0,0,0
29/6/2010,Amine Linganzi,34009734,49,11/16/1989,20,0,0,0,0,3100,5039,5750,152,112,4345158,186,81,D/DM C,1,1,3,2,2,2,2,2,3,3,1,5,6,8,6,12,8,14,11,10,13,11,10,12,11,12,13,14,12,10,9,11,14,8,10,7,12,13,16,12,9,16,12,8,11,10,20,15,15,14,12,10,1,10,12,15,13,12,10,12,12,8,D/DM C,321,1,1,20,18,20,1,1,15,1,1,1,1,1,1,18,1,1,15,1,1,1,1,256,0,0,0,0,0,0,0,0,1,0,0,0,0,0,0,0,0,0,0,0,0,0,0,0,0,0,0,0,0,0,0,0,0,0,0,0,0,0,0,0,0,0,0,0,0,0,0,0
29/6/2010,Álvaro Mejía,7451695,796,1/18/1982,28,0,0,0,0,3540,6150,5350,139,119,1208780,181,76,D C,1,1,1,3,2,1,3,1,3,2,2,7,8,6,5,10,5,15,6,8,14,9,7,15,9,12,13,15,10,12,10,11,16,7,13,7,14,14,13,12,13,13,11,9,12,10,20,13,12,13,12,10,10,8,10,16,19,15,16,17,14,10,D C,101,1,1,20,20,5,1,8,1,10,10,1,1,1,1,20,8,10,1,1,1,1,1,4294967296,0,0,0,0,0,0,0,0,0,0,0,0,0,0,0,0,0,0,0,0,0,0,0,0,0,0,0,0,0,0,0,0,1,0,0,0,0,0,0,0,0,0,0,0,0,0,0,0
29/6/2010,Álvaro Domínguez,67037294,796,5/15/1989,21,0,0,1,0,4750,6299,5500,160,140,91453172,189,83,D LC,3,2,2,3,2,1,3,9,3,3,3,2,10,8,5,10,3,15,2,10,17,11,3,15,10,13,13,12,12,12,4,15,17,7,8,6,16,13,13,14,16,12,15,20,12,12,8,10,16,14,10,15,7,9,11,12,15,12,16,14,10,7,D LC,104,1,1,20,20,5,1,15,1,1,10,1,1,1,1,20,15,1,1,1,1,1,1,32768,0,0,0,0,0,0,0,0,0,0,0,0,0,0,0,1,0,0,0,0,0,0,0,0,0,0,0,0,0,0,0,0,0,0,0,0,0,0,0,0,0,0,0,0,0,0,0,0
29/6/2010,Alfred N'Diaye,34009062,769,3/6/1990,20,0,0,2,0,3600,5400,5400,160,120,4143768,188,94,D/DM C,3,2,3,3,2,1,1,4,1,3,3,5,7,8,6,10,11,12,15,7,14,11,14,12,10,15,13,15,12,12,9,11,18,6,12,7,13,14,16,11,9,18,14,5,15,13,20,15,18,13,13,14,5,12,6,15,13,14,11,11,13,6,D/DM C,321,1,1,20,18,20,1,1,15,12,1,12,1,1,1,18,1,12,15,1,1,1,12,32,0,0,0,0,0,1,0,0,0,0,0,0,0,0,0,0,0,0,0,0,0,0,0,0,0,0,0,0,0,0,0,0,0,0,0,0,0,0,0,0,0,0,0,0,0,0,0,0
29/6/2010,Alexis,7444671,796,8/4/1985,24,0,0,3,0,5184,7150,7150,154,144,144492258,183,75,D C,2,3,3,1,1,2,2,2,3,3,1,7,8,8,6,13,6,16,8,9,14,13,9,16,13,13,17,15,14,13,12,15,14,7,10,9,16,15,16,11,12,15,13,9,11,12,20,15,12,14,13,14,14,12,8,14,14,12,12,15,10,6,D C,101,1,1,20,20,10,1,13,5,12,20,3,1,1,1,20,13,12,5,1,1,3,2,137438953472,0,0,0,0,0,0,0,0,0,0,0,0,0,0,0,0,0,0,0,0,0,0,0,0,0,0,0,0,0,0,0,0,0,0,0,0,0,1,0,0,0,0,0,0,0,0,0,0
29/6/2010,Alexander Madlung,892149,771,7/11/1982,27,2,0,13,1,4000,6850,6850,130,127,3302633,193,93,D C,3,3,1,1,2,1,3,2,3,2,1,5,5,5,12,7,6,18,10,13,15,7,7,14,6,16,8,16,7,14,6,7,16,4,11,9,10,16,15,9,7,17,19,8,16,14,20,15,18,11,12,12,5,10,14,14,14,12,12,14,10,5,D C,101,1,1,20,20,10,1,1,1,10,1,1,1,1,1,20,1,10,1,1,1,1,1,512,0,0,0,0,0,0,0,0,0,1,0,0,0,0,0,0,0,0,0,0,0,0,0,0,0,0,0,0,0,0,0,0,0,0,0,0,0,0,0,0,0,0,0,0,0,0,0,0
29/6/2010,Alexander Klitzpera,3611081,771,10/19/1977,32,0,0,19,0,2300,5300,5300,125,107,1148012,184,82,D C,2,1,3,1,3,3,1,4,3,3,2,7,5,6,4,8,7,13,7,10,12,11,11,13,10,17,12,11,14,11,8,14,13,5,15,3,13,14,14,10,9,13,13,6,14,12,20,12,13,12,8,12,4,10,5,11,12,13,15,14,11,6,D C,101,1,1,20,20,1,1,1,1,1,15,1,1,1,1,20,1,1,1,1,1,1,1,0,0,0,0,0,0,0,0,0,0,0,0,0,0,0,0,0,0,0,0,0,0,0,0,0,0,0,0,0,0,0,0,0,0,0,0,0,0,0,0,0,0,0,0,0,0,0,0,0
29/6/2010,Alex,317273,1651,6/17/1982,28,12,0,15,2,6162,7600,8000,160,157,105617647,189,92,D C,2,3,1,1,2,1,3,4,3,2,1,5,6,9,9,11,10,17,11,11,15,11,15,14,12,12,15,16,14,14,13,14,14,8,12,12,14,12,14,13,12,14,16,10,15,12,20,15,17,14,11,16,12,14,15,15,16,16,14,18,13,4,D C,101,1,1,20,20,1,1,1,1,1,1,1,1,1,1,20,1,1,1,1,1,1,1,35253091598336,0,0,0,0,0,0,0,0,0,0,0,0,0,0,0,1,0,0,0,0,0,0,0,0,0,0,0,0,0,0,0,0,0,0,0,0,1,0,0,0,0,0,0,0,0,1,0,0
29/6/2010,Alex Song,8428095,11,9/9/1987,22,24,0,0,0,6162,7850,7750,167,157,-1,185,74,D/DM/M C,1,3,2,3,1,3,1,6,2,3,3,5,9,12,6,13,5,14,8,10,14,13,10,16,13,12,16,15,17,16,12,14,17,9,9,13,15,16,17,12,14,16,13,13,16,11,20,18,17,16,11,13,7,15,14,14,15,12,15,13,16,8,D/DM/M C,331,1,1,20,17,20,1,1,18,1,1,1,1,1,1,17,1,1,18,1,1,1,1,16777220,0,0,1,0,0,0,0,0,0,0,0,0,0,0,0,0,0,0,0,0,0,0,0,0,1,0,0,0,0,0,0,0,0,0,0,0,0,0,0,0,0,0,0,0,0,0,0,0
29/6/2010,Alex John-Baptiste,5112061,765,1/31/1986,24,0,0,0,0,2000,5750,5750,141,121,3355131,181,74,D RC,2,2,1,3,1,2,2,4,1,2,3,8,10,5,2,11,9,14,7,8,15,10,2,15,10,11,13,13,14,14,7,14,11,5,8,9,13,9,12,12,8,13,12,10,14,14,20,9,13,16,6,10,9,9,12,12,9,12,12,12,15,4,D RC,103,1,1,20,20,1,1,12,1,20,1,9,1,1,1,20,12,20,1,1,1,1,9,140737488355328,0,0,0,0,0,0,0,0,0,0,0,0,0,0,0,0,0,0,0,0,0,0,0,0,0,0,0,0,0,0,0,0,0,0,0,0,0,0,0,0,0,0,0,0,0,0,0,1
29/6/2010,Alex Bruno,317737,1651,5/9/1982,28,0,0,0,0,2500,6000,5250,113,110,797476,189,83,D C,1,1,1,2,3,3,1,1,2,1,2,3,5,12,5,8,10,13,12,9,10,11,9,13,13,14,11,14,11,12,9,11,13,10,12,7,12,10,12,9,12,15,13,10,11,11,20,13,11,10,8,13,9,8,11,10,14,15,13,13,12,11,D C,101,1,1,20,20,1,1,1,1,1,10,1,1,1,1,20,1,1,1,1,1,1,1,4294967296,0,0,0,0,0,0,0,0,0,0,0,0,0,0,0,0,0,0,0,0,0,0,0,0,0,0,0,0,0,0,0,0,1,0,0,0,0,0,0,0,0,0,0,0,0,0,0,0
29/6/2010,Alessandro Potenza,837116,776,3/8/1984,26,0,0,27,1,3500,6000,6000,128,120,1999999,185,78,D/WB RC,1,1,1,1,1,1,1,1,1,1,1,8,14,9,10,13,6,16,9,16,14,12,8,14,10,14,12,13,10,10,10,10,13,6,10,7,14,13,13,12,12,16,12,7,11,12,20,13,13,11,13,10,12,13,12,13,12,13,14,12,13,11,D/WB RC,113,1,1,18,20,1,1,12,1,20,1,18,1,1,1,18,12,20,1,1,1,12,18,64,0,0,0,0,0,0,1,0,0,0,0,0,0,0,0,0,0,0,0,0,0,0,0,0,0,0,0,0,0,0,0,0,0,0,0,0,0,0,0,0,0,0,0,0,0,0,0,0
29/6/2010,Alessandro Nesta,8432,776,3/19/1976,34,78,0,9,1,6724,8250,8250,182,164,155002075,187,79,D C,1,1,2,3,2,2,2,7,2,2,2,2,5,7,8,11,2,15,4,14,17,13,14,17,14,15,16,16,17,15,12,17,18,5,18,5,18,14,15,12,13,15,14,12,8,13,20,13,14,16,13,17,19,5,15,14,15,18,18,14,15,12,D C,101,1,1,20,20,1,1,1,1,1,14,1,1,1,1,20,1,1,1,1,1,1,1,137438986240,0,0,0,0,0,0,0,0,0,0,0,0,0,0,0,1,0,0,0,0,0,0,0,0,0,0,0,0,0,0,0,0,0,0,0,0,0,1,0,0,0,0,0,0,0,0,0,0
29/6/2010,Alessandro Lucarelli,700011,776,7/22/1977,32,0,0,0,0,4000,6450,6450,135,128,1332551,183,77,D LC,3,1,1,2,1,2,3,1,3,3,2,2,8,4,4,6,6,16,9,12,15,9,6,14,10,14,14,13,14,12,11,16,12,7,15,10,14,10,11,9,13,13,13,20,12,11,9,13,16,15,13,12,7,14,6,14,20,10,9,14,15,8,D LC,104,1,1,20,20,1,1,15,1,8,12,1,1,1,1,20,15,8,1,1,1,1,1,32768,0,0,0,0,0,0,0,0,0,0,0,0,0,0,0,1,0,0,0,0,0,0,0,0,0,0,0,0,0,0,0,0,0,0,0,0,0,0,0,0,0,0,0,0,0,0,0,0
29/6/2010,Alessandro Gamberini,3804551,776,8/27/1981,28,7,0,4,0,2500,7500,7500,156,145,53793908,185,80,D C,2,1,3,1,1,2,2,6,3,2,1,3,5,6,5,9,6,16,6,11,16,10,6,16,8,15,14,15,16,15,8,13,16,3,9,7,17,16,16,15,13,14,14,8,14,13,20,15,14,13,10,14,13,11,13,15,16,13,16,12,14,2,D C,101,1,1,20,20,1,1,3,1,1,3,1,1,1,1,20,3,1,1,1,1,1,1,4294967360,0,0,0,0,0,0,1,0,0,0,0,0,0,0,0,0,0,0,0,0,0,0,0,0,0,0,0,0,0,0,0,0,1,0,0,0,0,0,0,0,0,0,0,0,0,0,0,0
29/6/2010,Aleksandar Vasoski,7960570,781,11/21/1979,30,33,2,0,0,4000,6600,6500,135,130,2400966,182,77,D C,3,1,2,2,3,3,1,5,3,1,3,7,12,5,4,11,7,14,8,11,13,10,11,14,11,13,13,11,12,14,12,12,13,4,13,13,13,17,15,13,12,12,13,10,14,15,20,12,11,14,10,14,16,10,16,13,11,13,15,11,7,8,D C,101,1,1,20,20,1,1,1,1,1,1,1,1,1,1,20,1,1,1,1,1,1,1,0,0,0,0,0,0,0,0,0,0,0,0,0,0,0,0,0,0,0,0,0,0,0,0,0,0,0,0,0,0,0,0,0,0,0,0,0,0,0,0,0,0,0,0,0,0,0,0,0
29/6/2010,Alberto Rodríguez,5290498,1656,3/31/1984,26,31,3,0,0,4624,7000,6800,146,136,2598016,182,73,D C,1,1,1,2,3,2,2,2,1,2,1,7,7,8,10,11,10,14,10,10,16,10,10,13,11,16,15,14,10,16,10,14,13,7,14,10,16,12,13,12,11,14,13,8,12,12,20,14,14,17,10,14,7,10,15,16,15,14,16,16,12,4,D C,101,1,1,20,20,1,1,1,1,1,15,1,1,1,1,20,1,1,1,1,1,1,1,0,0,0,0,0,0,0,0,0,0,0,0,0,0,0,0,0,0,0,0,0,0,0,0,0,0,0,0,0,0,0,0,0,0,0,0,0,0,0,0,0,0,0,0,0,0,0,0,0
29/6/2010,Alberto Lopo,4210204,796,5/5/1980,30,0,0,0,0,5184,6750,6750,151,144,7189017,186,81,D C,1,1,2,2,2,2,1,4,3,1,2,9,10,7,9,12,9,14,6,12,15,11,9,15,12,17,14,14,15,13,11,13,15,4,13,11,14,9,15,14,14,14,14,12,13,9,20,13,13,8,16,14,10,10,14,17,9,17,16,17,9,3,D C,101,1,1,20,20,1,1,1,1,10,10,1,1,1,1,20,1,10,1,1,1,1,1,281612415696896,0,0,0,0,0,0,0,0,0,0,0,0,0,0,0,1,0,0,0,0,0,0,0,0,0,0,0,0,0,0,0,0,0,0,0,0,0,1,0,0,0,0,0,0,0,0,0,0
29/6/2010,Alberto Botía,67024158,796,1/27/1989,21,0,0,1,0,3750,6209,5750,162,138,4475459,187,80,D RC,3,1,2,1,3,3,2,1,3,1,1,4,9,7,8,11,5,15,9,10,14,12,5,15,10,12,15,14,13,15,9,14,12,5,7,5,15,15,14,14,13,15,15,2,13,14,20,15,12,13,9,11,14,10,14,12,15,10,15,12,10,4,D RC,103,1,1,20,20,10,1,1,1,15,1,1,1,1,1,20,1,15,1,1,1,1,1,0,0,0,0,0,0,0,0,0,0,0,0,0,0,0,0,0,0,0,0,0,0,0,0,0,0,0,0,0,0,0,0,0,0,0,0,0,0,0,0,0,0,0,0,0,0,0,0,0
29/6/2010,Alassane Touré,34009553,769,2/9/1989,21,0,0,0,0,50,2250,2250,125,90,228511,183,71,D RC,2,2,2,3,1,3,3,1,1,1,3,4,7,7,4,10,3,12,5,8,9,12,4,14,6,4,12,10,8,12,7,10,11,9,3,10,9,12,15,14,14,14,11,5,13,14,20,11,11,10,7,10,10,10,8,6,17,11,12,9,14,12,D RC,103,1,1,20,20,1,1,1,1,15,1,1,1,1,1,20,1,15,1,1,1,1,1,0,0,0,0,0,0,0,0,0,0,0,0,0,0,0,0,0,0,0,0,0,0,0,0,0,0,0,0,0,0,0,0,0,0,0,0,0,0,0,0,0,0,0,0,0,0,0,0,0
29/6/2010,Ala-Eddine Yahia,916024,51,9/26/1981,28,15,0,0,0,3900,6400,5750,136,128,2577973,186,81,D/WB RC,3,2,3,2,2,3,2,8,2,1,2,5,9,7,8,7,8,16,12,9,15,11,8,14,7,15,15,16,12,12,7,12,15,7,13,7,12,12,14,13,9,16,13,12,13,11,20,14,16,13,15,14,10,7,10,12,13,13,15,14,14,7,D/WB RC,113,1,1,20,20,8,1,10,1,16,1,16,1,1,1,20,10,16,1,1,1,10,16,32800,0,0,0,0,0,1,0,0,0,0,0,0,0,0,0,1,0,0,0,0,0,0,0,0,0,0,0,0,0,0,0,0,0,0,0,0,0,0,0,0,0,0,0,0,0,0,0,0
29/6/2010,Aitor Ocio,4206685,796,11/28/1976,33,0,0,0,0,3844,5900,5900,145,124,1165237,187,81,D C,1,2,2,1,3,2,2,7,2,2,1,3,6,8,9,9,3,15,13,11,14,11,5,14,6,17,15,16,12,13,9,13,13,6,15,8,15,12,14,10,10,9,15,6,10,12,20,13,17,12,15,11,9,12,14,13,14,10,11,10,4,15,D C,101,1,1,20,20,1,1,1,1,1,20,1,1,1,1,20,1,1,1,1,1,1,1,25769803776,0,0,0,0,0,0,0,0,0,0,0,0,0,0,0,0,0,0,0,0,0,0,0,0,0,0,0,0,0,0,0,0,0,1,1,0,0,0,0,0,0,0,0,0,0,0,0,0
29/6/2010,Ahmed Kantari,8430573,34,6/28/1985,25,1,0,0,0,2700,5714,4150,138,127,2305797,185,80,D C,1,3,1,3,2,1,1,7,3,2,3,5,7,7,6,9,6,14,10,5,14,9,7,14,9,14,15,16,14,14,8,13,16,6,11,6,14,14,14,12,9,15,13,20,14,11,5,16,15,14,14,15,7,8,7,13,15,14,15,13,13,6,D C,101,5,1,20,20,8,1,14,1,1,1,1,1,1,1,20,14,1,1,1,1,1,1,137438986240,0,0,0,0,0,0,0,0,0,0,0,0,0,0,0,1,0,0,0,0,0,0,0,0,0,0,0,0,0,0,0,0,0,0,0,0,0,1,0,0,0,0,0,0,0,0,0,0
29/6/2010,Adriano,312341,1651,4/3/1982,28,0,0,3,0,1300,5550,5550,135,123,1177150,180,74,D/WB RC,2,1,1,1,3,3,2,6,2,2,1,6,9,8,7,10,8,14,11,15,15,10,7,13,12,14,13,15,14,11,10,12,15,6,13,8,11,12,15,14,11,13,10,8,15,13,20,14,13,15,12,14,10,8,12,15,16,13,12,12,14,9,D/WB RC,113,1,1,20,20,10,1,1,1,16,1,16,1,1,1,20,1,16,1,1,1,1,16,0,0,0,0,0,0,0,0,0,0,0,0,0,0,0,0,0,0,0,0,0,0,0,0,0,0,0,0,0,0,0,0,0,0,0,0,0,0,0,0,0,0,0,0,0,0,0,0,0
29/6/2010,Adlène Guédioura,34001314,5,11/12/1985,24,5,0,0,0,3600,5600,5850,130,120,4600000,185,80,D/DM C,1,2,1,2,2,1,1,5,2,2,1,5,7,11,9,11,15,13,15,7,10,10,4,10,11,19,12,15,14,14,8,10,13,6,16,9,13,16,17,11,11,13,12,9,12,11,20,16,12,18,17,9,8,10,10,11,10,12,10,10,12,16,D/DM C,321,1,1,20,18,20,1,1,15,1,12,1,1,1,1,18,1,1,15,1,1,1,1,256,0,0,0,0,0,0,0,0,1,0,0,0,0,0,0,0,0,0,0,0,0,0,0,0,0,0,0,0,0,0,0,0,0,0,0,0,0,0,0,0,0,0,0,0,0,0,0,0
29/6/2010,Adil Rami,34004844,769,12/27/1985,24,0,0,0,0,5450,6850,6850,165,152,5944989,190,90,D C,3,2,3,3,3,3,2,5,3,1,1,5,7,7,9,9,11,17,12,8,16,10,6,14,9,15,16,17,12,13,7,13,18,6,12,8,15,15,16,14,12,18,15,8,16,13,20,16,18,15,15,15,8,12,6,15,11,15,14,12,12,7,D C,101,1,1,20,20,12,8,1,10,10,1,10,1,1,1,20,1,10,10,1,1,1,10,68719476768,0,0,0,0,0,1,0,0,0,0,0,0,0,0,0,0,0,0,0,0,0,0,0,0,0,0,0,0,0,0,0,0,0,0,0,0,1,0,0,0,0,0,0,0,0,0,0,0
29/6/2010,Adama Coulibaly,6200462,31,10/9/1980,29,30,1,0,0,4350,7050,6300,150,141,7128172,186,83,D C,2,3,3,3,2,1,1,3,2,3,3,5,9,6,8,8,9,17,14,10,16,11,8,14,8,12,14,16,13,13,7,12,15,6,15,7,15,14,16,13,9,17,13,11,14,10,20,14,17,15,8,14,8,10,14,13,14,14,16,14,14,6,D C,101,1,1,20,20,1,1,8,1,10,12,10,1,1,1,20,8,10,1,1,1,8,10,32768,0,0,0,0,0,0,0,0,0,0,0,0,0,0,0,1,0,0,0,0,0,0,0,0,0,0,0,0,0,0,0,0,0,0,0,0,0,0,0,0,0,0,0,0,0,0,0,0
29/6/2010,Ádám Pintér,38001863,773,6/12/1988,22,0,0,6,0,1000,5000,5000,133,110,933155,190,76,D/DM C,3,1,1,2,3,2,2,1,2,2,2,6,7,7,8,12,11,16,7,9,13,9,9,14,8,12,11,14,11,11,8,9,10,9,10,8,10,13,14,9,14,9,13,11,12,8,20,13,15,14,10,11,10,11,15,5,16,8,15,9,10,19,D/DM C,111,1,1,20,20,20,1,14,15,1,1,1,1,1,1,20,14,1,15,1,1,1,1,0,0,0,0,0,0,0,0,0,0,0,0,0,0,0,0,0,0,0,0,0,0,0,0,0,0,0,0,0,0,0,0,0,0,0,0,0,0,0,0,0,0,0,0,0,0,0,0,0
29/6/2010,Abraham Paz,813506,796,6/29/1979,31,0,0,0,0,4160,5400,5400,130,129,1719090,180,75,D C,1,2,2,2,2,3,2,1,3,3,2,9,10,9,13,10,13,17,11,8,13,13,16,14,10,12,14,12,12,12,12,12,15,6,18,8,16,14,13,11,11,13,12,7,13,12,20,13,14,15,8,16,7,12,12,16,15,15,14,11,11,12,D C,101,1,1,20,20,12,1,1,5,9,18,1,1,1,1,20,1,9,5,1,1,1,1,8796093022208,0,0,0,0,0,0,0,0,0,0,0,0,0,0,0,0,0,0,0,0,0,0,0,0,0,0,0,0,0,0,0,0,0,0,0,0,0,0,0,0,0,0,0,1,0,0,0,0
29/6/2010,Abdoulaye Faye,919576,41,2/26/1978,32,34,3,0,0,4830,7000,6850,146,139,3046299,187,87,D/DM C,2,1,2,2,2,3,1,1,3,3,3,1,8,8,5,14,5,15,13,9,15,13,7,15,14,14,14,16,13,13,11,12,16,4,14,13,14,12,14,12,12,14,15,12,13,12,20,14,15,14,12,14,15,15,16,12,16,15,17,13,16,3,D/DM C,111,1,1,20,20,17,1,1,15,14,1,10,1,1,1,20,1,14,15,1,1,1,10,2340757209344,0,0,0,0,0,0,0,0,1,0,0,0,0,0,0,1,0,0,0,0,0,0,0,0,0,0,0,0,0,0,0,0,1,0,0,0,0,1,0,0,0,1,0,0,0,0,0,0
29/6/2010,Abdoulay Konko,7987468,769,3/9/1984,26,0,0,0,0,4830,6500,6000,148,139,144492258,183,75,D/WB/M RC,2,1,2,3,3,2,3,5,3,1,1,9,13,11,8,10,7,13,8,8,15,12,5,14,11,15,12,15,13,11,9,13,13,8,6,14,13,14,14,14,16,10,10,11,9,15,20,16,16,13,12,11,17,18,6,11,8,9,14,14,12,4,D/WB/M RC,123,1,1,15,20,14,1,9,17,20,1,18,1,1,1,15,7,20,10,9,17,9,18,2,0,1,0,0,0,0,0,0,0,0,0,0,0,0,0,0,0,0,0,0,0,0,0,0,0,0,0,0,0,0,0,0,0,0,0,0,0,0,0,0,0,0,0,0,0,0,0,0
29/6/2010,Abdel El Kaoutari,34008676,769,3/17/1990,20,0,0,0,0,1300,5579,5550,160,124,8396710,180,73,D/WB LC,3,3,3,1,3,1,2,3,2,3,1,7,12,8,6,11,11,13,11,10,14,9,7,13,11,12,13,14,10,13,9,11,16,8,11,7,14,13,14,14,12,13,10,20,15,13,5,15,13,13,12,16,6,8,7,14,15,15,13,13,13,6,D/WB LC,114,1,1,20,20,1,5,17,1,1,1,17,1,1,1,20,17,1,1,1,1,17,1,0,0,0,0,0,0,0,0,0,0,0,0,0,0,0,0,0,0,0,0,0,0,0,0,0,0,0,0,0,0,0,0,0,0,0,0,0,0,0,0,0,0,0,0,0,0,0,0,0
29/6/2010,Aaron Hughes,2011560,785,11/8/1979,30,71,0,0,0,4350,6750,6900,144,144,7850827,183,71,D C,1,2,1,1,1,3,1,6,2,1,3,8,12,11,6,11,8,12,6,10,13,13,1,14,12,12,15,14,14,14,11,15,14,2,11,14,15,15,14,15,11,12,12,13,14,14,20,14,13,15,6,10,5,14,12,15,17,11,16,15,14,1,D C,101,1,1,20,20,10,1,10,1,10,1,1,1,1,1,20,10,10,1,1,1,1,1,274877906944,0,0,0,0,0,0,0,0,0,0,0,0,0,0,0,0,0,0,0,0,0,0,0,0,0,0,0,0,0,0,0,0,0,0,0,0,0,0,1,0,0,0,0,0,0,0,0,0
