GameDate,Name,UID,NationID,Born,Age,IntCaps,IntGoals,U21Caps,U21Goals,WorldReputation,HomeReputation,CurrentReputation,PA,CA,Price,Height,Weight,PositionsString,GK.AerialAbility,GK.CommandOfArea,GK.Communication,GK.Eccentricity,GK.Handling,GK.Kicking,GK.OneOnOnes,GK.Reflexes,GK.RushingOut,GK.TendencyToPunch,GK.Throwing,Tech.Corners,Tech.Crossing,Tech.Dribbling,Tech.Finishing,Tech.FirstTouch,Tech.Freekicks,Tech.Heading,Tech.LongShots,Tech.Longthrows,Tech.Marking,Tech.Passing,Tech.PenaltyTaking,Tech.Tackling,Tech.Technique,Mental.Aggression,Mental.Anticipation,Mental.Bravery,Mental.Composure,Mental.Concentration,Mental.Vision,Mental.Decisions,Mental.Determination,Mental.Flair,Mental.Leadership,Mental.OffTheBall,Mental.Positioning,Mental.Teamwork,Mental.Workrate,Phy.Acceleration,Phy.Agility,Phy.Balance,Phy.Jumping,Phy.LeftFoot,Phy.NaturalFitness,Phy.Pace,Phy.RightFoot,Phy.Stamina,Phy.Strength,Hidden.Consistency,Hidden.Dirtiness,Hidden.ImportantMatches,Hidden.InjuryProness,Hidden.Versatility,Personality.Adaptability,Personality.Ambition,Personality.Loyalty,Personality.Pressure,Personality.Professional,Personality.Sportsmanship,Personality.Temperament,Personality.Controversy,Positions.PositionsDesc,Positions.PositionsDescVal,Positions.Striker,Positions.AttackingMidfielder,Positions.Centre,Positions.Defender,Positions.DefensiveMidfielder,Positions.Goalkeeper,Positions.Left,Positions.Midfielder,Positions.Right,Positions.Sweeper,Positions.WingBack,Positions.AttackingMidCentral,Positions.AttackingMidLeft,Positions.AttackingMidRight,Positions.DefenderCentral,Positions.DefenderLeft,Positions.DefenderRight,Positions.MidfielderCentral,Positions.MidfielderLeft,Positions.MidfielderRight,Positions.WingBackLeft,Positions.WingBackRight,PPMVal,PPM0,PPM1,PPM2,PPM3,PPM4,PPM5,PPM6,PPM7,PPM8,PPM9,PPM10,PPM11,PPM12,PPM13,PPM14,PPM15,PPM16,PPM17,PPM18,PPM19,PPM20,PPM21,PPM22,PPM23,PPM24,PPM25,PPM26,PPM27,PPM28,PPM29,PPM30,PPM31,PPM32,PPM33,PPM34,PPM35,PPM36,PPM37,PPM38,PPM39,PPM40,PPM41,PPM42,PPM43,PPM44,PPM45,PPM46,PPM47
29/6/2010,Zé Gomes,728617,788,9/24/1976,33,0,0,0,0,2000,5250,5250,108,105,57965,178,76,D R,1,1,2,1,2,2,2,6,2,3,3,11,12,12,8,10,7,10,10,10,10,10,11,10,13,12,11,12,11,11,10,10,13,11,8,9,10,12,10,14,11,11,8,11,12,11,20,11,11,13,13,11,8,12,13,13,13,14,14,13,12,13,D R,102,1,5,1,20,1,1,1,6,20,1,10,1,1,5,1,1,20,1,1,6,1,10,1116692547588,0,0,1,0,0,0,0,0,0,0,0,1,0,0,0,0,0,0,0,0,1,0,0,0,0,0,0,0,0,0,0,0,0,0,1,0,0,0,0,0,1,0,0,0,0,0,0,0
29/6/2010,Zdenek Grygera,133001,763,5/14/1980,30,65,2,14,1,4761,7500,7250,155,138,12113230,185,78,D RC,3,3,2,1,1,3,1,1,3,2,1,8,11,10,8,13,6,14,13,16,15,13,13,14,10,14,14,14,14,16,10,14,15,10,9,12,15,15,15,12,13,15,11,5,14,13,20,14,14,16,10,13,12,13,13,11,15,13,15,12,14,12,D RC,103,1,1,18,20,1,1,12,1,20,14,10,1,1,1,18,12,20,1,1,1,1,10,6442483712,0,0,0,0,0,0,0,0,0,0,0,0,0,0,0,1,0,0,0,0,0,0,0,0,0,0,0,0,0,0,0,1,1,0,0,0,0,0,0,0,0,0,0,0,0,0,0,0
29/6/2010,Yvan Bourgis,913093,769,9/24/1979,30,0,0,0,0,2400,3650,3650,114,112,1256899,169,69,D R,3,2,3,3,2,3,2,1,2,3,3,7,12,8,5,9,6,9,11,14,11,9,7,13,9,11,14,15,14,14,8,13,15,6,11,8,12,15,13,14,12,11,5,5,15,12,20,16,8,15,11,14,6,6,19,12,16,14,17,17,17,4,D R,102,1,1,10,20,1,1,1,1,20,1,15,1,1,1,10,1,20,1,1,1,1,15,32,0,0,0,0,0,1,0,0,0,0,0,0,0,0,0,0,0,0,0,0,0,0,0,0,0,0,0,0,0,0,0,0,0,0,0,0,0,0,0,0,0,0,0,0,0,0,0,0
29/6/2010,Yuto Nagatomo,45005331,116,9/12/1986,23,26,3,0,0,2750,6300,6150,145,125,4101916,170,65,D/WB RL,1,3,1,1,1,2,2,7,2,3,2,5,10,10,4,13,4,14,7,10,14,13,4,14,13,10,14,14,12,14,12,14,10,11,5,15,14,10,15,14,14,11,7,8,8,14,20,10,6,10,6,10,9,10,11,10,6,11,11,11,6,6,D/WB RL,115,1,1,1,20,1,1,20,1,19,1,18,1,1,1,1,20,19,1,1,1,17,18,0,0,0,0,0,0,0,0,0,0,0,0,0,0,0,0,0,0,0,0,0,0,0,0,0,0,0,0,0,0,0,0,0,0,0,0,0,0,0,0,0,0,0,0,0,0,0,0,0
29/6/2010,Younes Kaboul,918434,769,1/4/1986,24,0,0,20,1,5041,6400,6900,160,142,13800000,191,85,D RC,1,3,3,3,3,3,2,1,2,1,3,7,13,8,10,14,10,15,14,8,13,11,8,14,12,11,11,14,13,12,13,12,14,6,12,9,13,12,12,14,9,16,17,12,11,15,20,14,19,12,10,12,12,8,13,16,15,12,15,14,13,8,D RC,103,1,1,20,20,14,1,1,10,19,1,1,1,1,1,20,1,19,10,1,1,1,1,43984760078338,0,1,0,0,0,0,0,0,0,0,0,0,0,0,0,0,0,0,0,0,0,0,0,0,0,0,0,0,0,0,0,0,1,0,0,0,0,0,0,0,0,0,0,1,0,1,0,0
29/6/2010,Yohan Demont,3501868,769,5/15/1978,32,0,0,0,0,1450,6209,6200,145,138,3817142,181,73,D/WB/M/AM R,3,1,2,3,1,2,2,5,1,3,1,11,13,11,6,11,12,11,14,11,11,13,9,12,13,15,13,13,13,13,12,12,14,8,14,12,13,15,16,16,12,14,10,8,14,14,20,16,12,15,12,13,6,15,13,13,14,13,15,13,13,7,D/WB/M/AM R,442,1,16,12,18,1,1,1,20,20,1,18,10,1,16,1,1,18,12,1,20,1,18,2,0,1,0,0,0,0,0,0,0,0,0,0,0,0,0,0,0,0,0,0,0,0,0,0,0,0,0,0,0,0,0,0,0,0,0,0,0,0,0,0,0,0,0,0,0,0,0,0
29/6/2010,Yoann Andreu,85016145,769,5/3/1989,21,0,0,0,0,1000,5174,5150,137,115,1487012,175,64,D RL,1,1,3,1,3,3,3,1,1,2,1,8,12,9,6,12,6,13,11,10,10,9,9,11,12,10,13,11,12,12,11,11,14,8,8,9,13,13,13,14,13,12,7,10,12,13,20,16,7,14,10,10,8,10,14,17,15,1,13,10,15,8,D RL,105,1,1,10,20,10,1,15,9,20,1,15,1,1,1,1,15,20,1,7,9,15,15,0,0,0,0,0,0,0,0,0,0,0,0,0,0,0,0,0,0,0,0,0,0,0,0,0,0,0,0,0,0,0,0,0,0,0,0,0,0,0,0,0,0,0,0,0,0,0,0,0
29/6/2010,Xavier Collin,15922,769,8/17/1974,35,0,0,0,0,1050,5500,5500,140,123,296035,174,68,D RL,2,3,3,2,1,1,2,7,2,1,2,8,12,7,5,9,7,14,10,11,13,10,6,14,11,10,13,15,13,13,11,12,12,6,15,8,14,14,13,13,11,13,7,10,14,11,20,14,13,15,10,11,6,10,14,12,14,13,16,14,14,6,D RL,105,1,1,12,20,1,1,20,1,15,1,15,1,1,1,12,20,15,1,1,1,15,15,0,0,0,0,0,0,0,0,0,0,0,0,0,0,0,0,0,0,0,0,0,0,0,0,0,0,0,0,0,0,0,0,0,0,0,0,0,0,0,0,0,0,0,0,0,0,0,0,0
29/6/2010,Wires,19026407,1651,12/30/1982,27,0,0,0,0,250,3550,3550,107,96,337987,178,74,D/WB/M RC,2,3,1,2,3,2,2,3,3,3,1,8,8,8,8,10,10,11,9,10,11,8,10,12,10,11,11,10,12,10,8,10,7,8,10,10,11,12,11,10,11,12,11,7,12,11,20,12,12,10,11,10,9,12,15,12,18,9,2,1,3,13,D/WB/M RC,123,1,1,20,20,15,1,1,20,20,1,17,1,1,1,1,1,20,20,1,10,1,17,0,0,0,0,0,0,0,0,0,0,0,0,0,0,0,0,0,0,0,0,0,0,0,0,0,0,0,0,0,0,0,0,0,0,0,0,0,0,0,0,0,0,0,0,0,0,0,0,0
29/6/2010,Wes Brown,2003610,765,10/13/1979,30,23,1,8,0,6006,7750,7750,160,155,108162998,185,78,D RC,2,2,2,3,3,3,1,4,2,1,2,5,11,7,2,12,5,17,1,11,16,9,2,18,12,16,15,18,12,14,5,13,18,3,6,7,16,16,17,14,13,14,14,10,14,14,20,16,16,15,14,15,13,10,5,15,18,15,16,15,17,6,D RC,103,1,1,20,20,1,1,1,1,19,10,1,1,1,1,20,1,19,1,1,1,1,1,137438986240,0,0,0,0,0,0,0,0,0,0,0,0,0,0,0,1,0,0,0,0,0,0,0,0,0,0,0,0,0,0,0,0,0,0,0,0,0,1,0,0,0,0,0,0,0,0,0,0
29/6/2010,Vincent Acapandié,8438696,769,2/9/1990,20,0,0,0,0,1300,2650,2650,140,106,5320401,180,79,D/WB R,2,2,3,1,3,3,2,1,1,3,1,6,9,10,9,11,7,7,12,7,11,8,10,10,11,12,14,13,10,10,9,8,14,12,6,12,9,12,13,16,11,14,10,10,14,14,20,14,14,12,12,15,10,16,6,13,15,11,14,14,14,6,D/WB R,112,14,10,14,20,1,1,1,10,20,1,17,1,1,10,10,13,20,1,1,10,1,17,514,0,1,0,0,0,0,0,0,0,1,0,0,0,0,0,0,0,0,0,0,0,0,0,0,0,0,0,0,0,0,0,0,0,0,0,0,0,0,0,0,0,0,0,0,0,0,0,0
29/6/2010,Víctor Sánchez,67046419,796,8/8/1987,22,0,0,0,0,3969,6000,6000,140,126,451211,174,73,WB/DM/M RC,3,2,2,1,3,3,1,4,1,1,3,7,9,10,8,13,6,10,8,11,12,13,8,12,11,14,12,14,11,12,12,12,18,8,6,12,13,18,18,14,12,10,10,10,14,12,20,15,10,12,7,10,5,18,14,10,15,10,17,13,12,3,WB/DM/M RC,433,7,11,20,15,16,1,9,20,18,1,18,10,7,11,12,9,15,20,7,17,7,18,0,0,0,0,0,0,0,0,0,0,0,0,0,0,0,0,0,0,0,0,0,0,0,0,0,0,0,0,0,0,0,0,0,0,0,0,0,0,0,0,0,0,0,0,0,0,0,0,0
29/6/2010,Vedran Corluka,126527,761,3/31/1986,24,36,1,0,0,5184,7920,7400,164,144,43486185,192,89,D RC,1,1,2,3,2,1,2,5,2,1,2,3,11,11,9,13,5,15,5,15,13,11,6,15,15,14,15,13,17,12,10,12,17,5,12,8,12,15,14,14,13,16,15,13,14,12,20,14,16,15,4,16,11,12,13,14,15,13,16,17,15,8,D RC,103,1,1,16,20,12,1,10,15,20,12,14,1,1,1,16,10,20,15,1,1,1,14,143881404456,0,0,0,1,0,1,0,0,0,0,0,0,0,0,0,0,0,0,0,0,0,0,0,0,0,0,0,0,0,0,0,1,1,0,0,0,0,1,0,0,0,0,0,0,0,0,0,0
29/6/2010,Vangelis Moras,678479,772,8/26/1981,28,12,0,11,0,2500,6500,6300,135,129,2900346,193,78,D RC,3,3,1,1,1,2,1,1,1,2,2,9,9,12,7,9,9,14,8,12,15,13,7,14,13,14,15,14,12,12,10,11,16,10,10,11,14,13,15,11,12,13,17,6,16,13,20,15,12,14,11,14,8,11,15,14,9,12,15,14,13,5,D RC,103,1,1,20,20,14,1,8,1,15,1,7,1,1,1,20,8,15,1,1,1,1,7,32,0,0,0,0,0,1,0,0,0,0,0,0,0,0,0,0,0,0,0,0,0,0,0,0,0,0,0,0,0,0,0,0,0,0,0,0,0,0,0,0,0,0,0,0,0,0,0,0
29/6/2010,Valon Behrami,5724445,798,4/19/1985,25,28,2,4,0,5476,7500,7000,155,148,13491018,186,78,D/WB/M RLC,1,1,1,1,1,1,1,1,1,1,1,4,10,12,9,13,3,8,10,8,11,14,5,16,14,16,14,18,11,12,10,8,18,10,8,14,13,18,19,15,14,14,11,10,15,14,20,19,15,14,16,15,14,14,15,15,10,10,16,8,15,4,D/WB/M RLC,436,1,12,18,18,10,1,15,20,20,1,18,1,9,12,1,7,18,18,15,20,12,18,1374527946760,0,0,0,1,0,0,0,0,0,0,0,0,0,0,0,0,0,0,0,0,0,0,1,0,0,0,0,1,0,0,0,0,0,0,0,0,0,0,1,0,1,0,0,0,0,0,0,0
29/6/2010,Tony Hibbert,115448,765,2/20/1981,29,0,0,0,0,4250,6500,6500,140,135,6029351,173,71,D R,1,2,1,1,1,3,1,1,1,1,1,4,7,5,7,7,5,14,7,10,17,10,5,18,8,17,14,18,11,17,6,11,18,3,8,10,15,15,16,13,13,14,8,4,14,13,20,16,14,17,12,15,14,6,6,8,14,16,15,11,15,2,D R,102,1,1,1,20,1,1,1,1,20,1,10,1,1,1,1,12,20,1,1,1,1,10,154618822720,0,0,0,0,0,0,1,0,0,0,0,0,0,0,0,0,0,0,0,0,0,0,0,0,0,0,0,0,0,0,0,0,0,0,1,0,0,1,0,0,0,0,0,0,0,0,0,0
29/6/2010,Tomas Ujfalusi,133081,763,3/24/1978,32,71,2,25,1,5256,7500,7500,153,145,91453172,185,76,D RC,3,1,3,3,2,3,1,6,2,2,1,8,12,12,6,12,7,14,9,10,15,13,11,15,11,14,15,15,14,12,10,14,17,8,12,8,14,14,13,13,12,16,14,14,16,12,20,16,16,14,13,14,7,15,18,16,15,15,18,15,11,4,D RC,103,1,1,20,20,8,1,5,1,19,8,1,1,1,1,20,5,19,1,1,1,1,1,2199023255552,0,0,0,0,0,0,0,0,0,0,0,0,0,0,0,0,0,0,0,0,0,0,0,0,0,0,0,0,0,0,0,0,0,0,0,0,0,0,0,0,0,1,0,0,0,0,0,0
29/6/2010,Tobias Levels,35006409,771,11/22/1986,23,0,0,0,0,1000,5900,5900,128,126,4636361,186,81,D R,2,2,3,3,1,2,3,3,1,2,1,8,11,5,5,7,6,12,6,15,14,8,9,16,7,15,12,18,9,15,9,10,17,3,15,12,14,17,18,12,7,14,14,7,15,14,20,17,15,17,8,10,7,10,7,14,18,10,16,15,17,8,D R,102,1,1,14,20,5,1,5,1,20,5,14,1,1,1,14,5,20,1,1,1,5,14,0,0,0,0,0,0,0,0,0,0,0,0,0,0,0,0,0,0,0,0,0,0,0,0,0,0,0,0,0,0,0,0,0,0,0,0,0,0,0,0,0,0,0,0,0,0,0,0,0
29/6/2010,Tim Hoogland,8707937,771,6/11/1985,25,0,0,0,0,3400,6000,6000,138,131,2911143,183,78,D/M RC,1,2,3,2,2,1,3,4,1,3,3,8,10,7,14,9,8,17,13,16,15,9,8,15,8,16,12,16,10,15,7,10,11,4,13,14,14,16,17,14,10,12,14,6,13,14,20,17,12,12,10,12,13,17,12,14,8,8,10,13,6,13,D/M RC,113,1,12,15,20,10,1,1,16,20,1,14,1,1,12,15,1,20,1,1,16,1,14,0,0,0,0,0,0,0,0,0,0,0,0,0,0,0,0,0,0,0,0,0,0,0,0,0,0,0,0,0,0,0,0,0,0,0,0,0,0,0,0,0,0,0,0,0,0,0,0,0
29/6/2010,Thanos Petsos,91014707,772,6/5/1991,19,0,0,1,0,500,4000,4000,125,85,376639,184,80,D RLC,3,1,1,3,3,3,3,1,2,2,3,10,8,8,10,7,5,14,4,4,11,8,5,14,12,9,12,14,9,13,4,6,10,4,11,5,9,11,13,9,8,7,12,20,10,13,9,9,8,4,9,10,11,10,8,13,10,16,7,9,7,9,D RLC,106,1,1,20,20,1,1,20,1,16,1,7,1,1,1,20,20,16,1,1,1,7,1,0,0,0,0,0,0,0,0,0,0,0,0,0,0,0,0,0,0,0,0,0,0,0,0,0,0,0,0,0,0,0,0,0,0,0,0,0,0,0,0,0,0,0,0,0,0,0,0,0
29/6/2010,Stuart Parnaby,5100707,765,7/19/1982,27,0,0,4,0,3600,5500,5500,125,120,1731091,178,70,D/WB R,1,1,1,2,2,1,1,1,1,1,3,10,14,11,8,11,7,12,11,13,12,11,7,13,11,12,13,14,12,10,9,10,12,11,11,11,13,11,14,12,12,12,11,10,11,14,20,13,14,9,11,11,14,12,12,12,14,12,14,14,14,2,D/WB R,112,1,1,14,20,10,1,12,10,20,1,20,1,1,1,14,12,20,1,1,10,12,20,137438953474,0,1,0,0,0,0,0,0,0,0,0,0,0,0,0,0,0,0,0,0,0,0,0,0,0,0,0,0,0,0,0,0,0,0,0,0,0,1,0,0,0,0,0,0,0,0,0,0
29/6/2010,Steven Taylor,5114243,765,1/23/1986,24,0,0,29,4,4422,6500,6500,150,133,3950340,188,81,D RC,2,1,3,1,3,1,3,6,1,3,1,5,8,9,10,9,3,16,3,8,14,10,5,15,9,17,14,18,9,11,8,9,18,5,14,10,13,11,18,13,11,12,16,8,11,15,20,15,16,11,16,16,9,10,10,15,9,14,12,7,9,5,D RC,103,1,1,20,20,1,1,10,1,18,1,1,1,1,1,20,10,18,1,1,1,1,1,2199023353888,0,0,0,0,0,1,0,0,0,0,0,0,0,0,0,1,1,0,0,0,0,0,0,0,0,0,0,0,0,0,0,0,0,0,0,0,0,0,0,0,0,1,0,0,0,0,0,0
29/6/2010,Steven Reid,107553,789,3/10/1981,29,23,2,0,0,4160,6400,6250,145,129,4457682,186,88,DM/M RC,3,2,3,2,3,1,3,2,1,1,2,10,11,12,8,12,9,14,9,14,13,10,8,14,12,15,13,15,12,12,10,13,20,10,13,13,14,15,17,13,11,12,13,11,14,13,20,16,17,12,11,13,17,17,14,14,15,15,19,13,15,1,DM/M RC,423,1,10,20,15,17,1,10,20,15,1,10,5,1,10,1,1,15,20,10,14,1,10,288,0,0,0,0,0,1,0,0,1,0,0,0,0,0,0,0,0,0,0,0,0,0,0,0,0,0,0,0,0,0,0,0,0,0,0,0,0,0,0,0,0,0,0,0,0,0,0,0
29/6/2010,Steven Cherundolo,120636,390,2/19/1979,31,64,2,0,0,3750,6985,6750,135,127,4697428,172,69,D/WB R,1,1,2,2,1,1,3,3,1,3,2,10,11,10,6,11,10,9,9,11,14,12,12,14,10,13,12,14,13,12,11,12,13,8,13,8,12,16,12,14,13,15,8,10,13,13,20,15,14,13,12,14,11,8,16,14,12,12,15,18,17,3,D/WB R,112,1,1,1,20,1,1,1,1,20,1,20,1,1,1,1,9,20,1,1,1,1,20,0,0,0,0,0,0,0,0,0,0,0,0,0,0,0,0,0,0,0,0,0,0,0,0,0,0,0,0,0,0,0,0,0,0,0,0,0,0,0,0,0,0,0,0,0,0,0,0,0
29/6/2010,Stephen Kelly,5112417,789,9/6/1983,26,18,0,17,0,3906,6350,6500,138,125,9265712,183,78,D R,2,3,3,2,3,3,1,7,3,1,3,5,12,11,8,12,3,14,10,13,13,12,7,15,11,9,12,14,11,10,11,11,17,10,11,13,14,13,15,14,14,13,11,5,17,14,20,14,11,15,10,11,3,10,7,13,13,12,14,13,13,7,D R,102,1,1,7,20,1,1,12,10,20,1,15,1,1,1,7,12,20,1,1,10,12,15,32,0,0,0,0,0,1,0,0,0,0,0,0,0,0,0,0,0,0,0,0,0,0,0,0,0,0,0,0,0,0,0,0,0,0,0,0,0,0,0,0,0,0,0,0,0,0,0,0
29/6/2010,Stephen Carr,2014367,789,8/29/1976,33,44,0,0,0,4650,6850,6850,145,141,2234127,175,78,D R,3,2,2,3,1,3,2,4,1,2,1,12,15,13,8,12,8,15,10,11,15,14,8,16,13,16,12,16,14,12,10,14,16,11,13,13,16,17,16,12,10,12,10,5,13,12,20,14,16,17,9,14,10,12,10,14,12,13,11,10,10,8,D R,102,1,1,10,20,8,1,10,8,20,1,10,1,1,1,10,10,20,1,1,8,1,10,131074,0,1,0,0,0,0,0,0,0,0,0,0,0,0,0,0,0,1,0,0,0,0,0,0,0,0,0,0,0,0,0,0,0,0,0,0,0,0,0,0,0,0,0,0,0,0,0,0
29/6/2010,Stephan Lichtsteiner,5723486,798,1/16/1984,26,31,0,28,1,5256,7500,7300,150,145,6725735,181,75,D/WB/M R,2,2,3,2,2,3,1,7,1,3,3,9,14,11,7,11,7,13,13,10,13,13,11,13,11,16,13,14,13,13,12,13,15,9,14,14,14,14,15,14,13,14,12,8,13,16,20,17,14,15,16,14,7,14,15,16,12,13,14,13,14,12,D/WB/M R,122,1,10,1,20,1,1,3,17,20,1,20,1,3,10,1,3,20,1,3,17,3,20,163842,0,1,0,0,0,0,0,0,0,0,0,0,0,0,0,1,0,1,0,0,0,0,0,0,0,0,0,0,0,0,0,0,0,0,0,0,0,0,0,0,0,0,0,0,0,0,0,0
29/6/2010,Stefano Lucchini,3804849,776,10/2/1980,29,0,0,12,0,4500,7150,7150,145,145,6179977,186,76,D RLC,3,3,1,1,1,1,1,1,2,2,3,5,8,8,7,7,5,15,6,10,14,10,6,16,7,15,16,12,13,13,18,15,12,8,12,18,14,10,10,11,12,11,14,10,14,14,20,16,14,11,12,15,8,15,10,12,10,13,12,11,10,10,D RLC,106,1,1,20,20,1,1,15,1,15,1,1,1,1,1,20,15,15,1,1,1,1,1,0,0,0,0,0,0,0,0,0,0,0,0,0,0,0,0,0,0,0,0,0,0,0,0,0,0,0,0,0,0,0,0,0,0,0,0,0,0,0,0,0,0,0,0,0,0,0,0,0
29/6/2010,Stefano Celozzi,35000513,771,11/2/1988,21,0,0,0,0,3750,6450,6450,155,129,32282524,171,65,D/WB R,2,1,1,2,1,2,3,4,2,3,1,11,12,14,4,12,6,7,10,12,13,12,7,14,15,14,14,12,14,13,11,10,15,13,8,11,10,14,13,15,14,12,9,6,14,16,20,15,10,12,6,14,12,12,12,16,12,12,16,12,13,6,D/WB R,112,1,8,10,20,10,1,1,10,20,1,18,1,1,8,1,7,20,1,1,10,1,18,40,0,0,0,1,0,1,0,0,0,0,0,0,0,0,0,0,0,0,0,0,0,0,0,0,0,0,0,0,0,0,0,0,0,0,0,0,0,0,0,0,0,0,0,0,0,0,0,0
29/6/2010,Souleymane Diamoutene,837067,31,1/30/1983,27,46,2,0,0,3192,6215,5850,127,113,1557384,184,80,D RC,1,1,1,1,1,1,1,1,1,1,1,8,4,7,10,8,9,18,6,4,14,10,5,14,7,17,13,12,11,8,8,10,16,8,8,7,9,14,12,15,14,11,12,5,8,14,20,15,15,13,8,12,3,10,15,10,15,7,12,14,9,7,D RC,103,1,1,20,20,1,1,10,2,16,1,8,1,1,1,20,10,16,2,2,2,5,8,32,0,0,0,0,0,1,0,0,0,0,0,0,0,0,0,0,0,0,0,0,0,0,0,0,0,0,0,0,0,0,0,0,0,0,0,0,0,0,0,0,0,0,0,0,0,0,0,0
29/6/2010,Sokratis Papastathopoulos,1804808,772,6/9/1988,22,12,0,9,2,4970,7000,7000,165,141,24000000,183,80,D RC,2,1,3,2,3,2,3,7,3,3,2,3,4,9,8,7,4,15,6,12,16,10,4,15,12,16,15,15,10,12,8,14,16,7,13,11,14,13,15,13,12,16,13,8,14,13,20,15,16,14,16,13,5,8,14,15,12,14,13,12,13,5,D RC,103,1,1,19,20,5,1,3,9,20,12,14,1,1,1,19,3,20,1,1,9,1,14,32770,0,1,0,0,0,0,0,0,0,0,0,0,0,0,0,1,0,0,0,0,0,0,0,0,0,0,0,0,0,0,0,0,0,0,0,0,0,0,0,0,0,0,0,0,0,0,0,0
29/6/2010,Sofian Chahed,892144,51,4/18/1983,27,0,0,0,0,3100,6150,6150,129,123,2278151,178,74,D/DM RC,1,1,3,2,1,3,2,8,3,2,3,6,10,8,9,12,8,10,8,10,12,10,16,14,11,12,9,11,14,12,8,8,12,5,10,14,10,16,16,12,13,10,12,16,13,14,20,16,12,13,10,11,7,14,12,12,15,10,15,10,15,5,D/DM RC,113,1,1,20,20,20,1,1,15,20,1,14,1,1,1,1,19,20,15,1,14,1,14,1073741824,0,0,0,0,0,0,0,0,0,0,0,0,0,0,0,0,0,0,0,0,0,0,0,0,0,0,0,0,0,0,1,0,0,0,0,0,0,0,0,0,0,0,0,0,0,0,0,0
29/6/2010,Sílvio,55011718,788,9/28/1987,22,0,0,0,0,2750,6250,6250,145,127,2433974,178,72,D RL,3,1,3,2,1,1,1,4,1,3,2,10,11,10,8,12,9,9,11,11,11,11,11,14,13,13,13,12,13,13,10,11,14,11,10,14,12,13,14,16,14,11,9,14,13,15,20,13,11,13,8,12,7,15,5,12,13,14,14,14,15,6,D RL,105,1,1,1,20,1,1,17,1,20,1,10,1,1,1,1,17,20,1,1,1,1,10,0,0,0,0,0,0,0,0,0,0,0,0,0,0,0,0,0,0,0,0,0,0,0,0,0,0,0,0,0,0,0,0,0,0,0,0,0,0,0,0,0,0,0,0,0,0,0,0,0
29/6/2010,Sergio Sánchez,1507596,796,4/3/1986,24,0,0,4,0,4500,6600,6600,156,138,5999998,185,78,D RC,3,1,1,2,1,1,1,4,3,2,3,5,6,6,8,12,6,14,7,9,15,12,8,14,11,15,14,14,13,12,8,12,13,7,12,12,15,14,16,14,12,15,13,10,14,13,20,16,14,13,12,10,8,14,13,13,14,11,14,13,12,10,D RC,103,1,1,18,20,10,1,8,1,20,1,10,1,1,1,18,8,20,1,1,1,1,10,0,0,0,0,0,0,0,0,0,0,0,0,0,0,0,0,0,0,0,0,0,0,0,0,0,0,0,0,0,0,0,0,0,0,0,0,0,0,0,0,0,0,0,0,0,0,0,0,0
29/6/2010,Sergio Ramos,7458272,796,3/30/1986,24,67,5,6,0,6642,8250,8250,173,163,165816446,183,81,D RC,1,1,2,1,3,2,1,5,1,1,3,10,15,13,11,15,13,17,13,16,15,13,10,17,15,16,15,17,10,13,12,10,16,13,12,13,15,15,16,13,15,14,13,13,16,15,20,17,12,14,15,13,3,15,15,18,12,13,12,11,13,11,D RC,103,1,2,16,20,11,1,10,9,20,8,15,2,1,2,16,10,20,9,1,9,5,15,35184372088864,0,0,0,0,0,1,0,0,0,0,0,0,0,0,0,0,0,0,0,0,0,0,0,0,0,0,0,0,0,0,0,0,0,0,0,0,0,0,0,0,0,0,0,0,0,1,0,0
29/6/2010,Sérgio Pinto,6000562,771,10/16/1980,29,0,0,0,0,3500,6400,6400,132,128,3649933,176,74,WB/M/AM R,2,1,1,3,2,2,2,3,3,3,2,13,15,14,8,13,12,4,16,6,5,13,16,10,13,9,10,9,11,8,13,9,10,13,9,13,11,12,13,14,15,12,11,9,14,15,20,13,11,12,8,12,6,14,13,11,13,8,10,11,5,13,WB/M/AM R,432,5,20,14,14,7,1,1,20,20,1,16,14,1,20,1,1,14,13,1,19,1,16,0,0,0,0,0,0,0,0,0,0,0,0,0,0,0,0,0,0,0,0,0,0,0,0,0,0,0,0,0,0,0,0,0,0,0,0,0,0,0,0,0,0,0,0,0,0,0,0,0
29/6/2010,Serge Aurier,85057643,24,12/24/1992,17,0,0,0,0,3422,5264,5250,161,117,14403016,182,70,D/WB R,2,3,3,1,2,1,2,6,3,3,1,8,12,9,6,11,5,10,7,9,11,10,6,12,11,12,14,13,9,13,10,11,15,9,12,9,12,15,14,15,13,13,11,5,14,14,20,15,13,14,12,10,8,10,13,14,14,16,13,15,15,8,D/WB R,112,1,1,14,20,14,1,1,10,20,1,16,1,1,1,1,6,20,10,1,1,1,16,0,0,0,0,0,0,0,0,0,0,0,0,0,0,0,0,0,0,0,0,0,0,0,0,0,0,0,0,0,0,0,0,0,0,0,0,0,0,0,0,0,0,0,0,0,0,0,0,0
29/6/2010,Sebastian Schachten,8718065,771,11/6/1984,25,0,0,0,0,1900,5900,5900,128,118,737981,190,82,D/WB RL,3,2,1,2,2,3,2,4,1,3,3,10,11,11,7,10,7,8,8,6,11,10,11,12,11,10,10,10,10,11,11,11,12,9,5,10,11,13,13,13,12,10,14,14,12,13,20,12,11,12,8,10,16,18,8,12,12,10,12,11,7,5,D/WB RL,115,1,1,10,20,1,1,15,15,20,1,18,1,1,1,10,4,20,1,1,15,15,18,0,0,0,0,0,0,0,0,0,0,0,0,0,0,0,0,0,0,0,0,0,0,0,0,0,0,0,0,0,0,0,0,0,0,0,0,0,0,0,0,0,0,0,0,0,0,0,0,0
29/6/2010,Sebastian Larsson,615722,797,6/6/1985,25,22,0,12,0,4489,7000,6500,142,134,4472863,178,70,M/AM RC,3,1,1,2,1,3,3,6,2,3,1,12,15,13,11,12,17,12,15,8,10,13,8,12,13,9,12,12,13,12,10,12,14,12,11,11,9,12,14,13,12,9,8,12,15,14,20,14,11,12,2,12,5,10,13,14,17,12,13,15,15,5,M/AM RC,413,1,19,19,15,10,1,14,20,20,1,15,1,1,19,1,1,15,19,14,20,14,15,68719476992,0,0,0,0,0,0,0,0,1,0,0,0,0,0,0,0,0,0,0,0,0,0,0,0,0,0,0,0,0,0,0,0,0,0,0,0,1,0,0,0,0,0,0,0,0,0,0,0
29/6/2010,Sebastian Boenisch,35001645,787,2/1/1987,23,0,0,13,0,3750,6750,6750,137,127,11012827,191,86,D/WB RL,2,1,1,1,1,2,1,2,2,2,3,7,9,10,6,8,9,12,9,16,13,8,10,13,7,16,9,16,9,10,7,8,18,7,11,15,10,15,18,13,8,15,16,20,14,18,19,17,16,12,12,10,11,16,12,13,14,13,15,11,8,5,D/WB RL,115,1,1,12,20,1,1,20,12,15,1,20,1,1,1,12,20,15,1,12,1,20,15,131593,1,0,0,1,0,0,0,0,0,1,0,0,0,0,0,0,0,1,0,0,0,0,0,0,0,0,0,0,0,0,0,0,0,0,0,0,0,0,0,0,0,0,0,0,0,0,0,0
29/6/2010,Sascha Riether,890204,771,3/23/1983,27,0,0,20,0,3200,7050,7050,142,141,16654801,174,70,D/DM/M RC,1,3,2,2,1,1,2,1,2,1,3,6,8,8,6,11,7,10,5,14,14,11,12,15,10,13,16,14,9,16,8,10,18,3,14,12,14,19,18,18,15,13,8,8,17,15,20,18,9,17,10,14,11,16,6,13,17,11,16,12,11,7,D/DM/M RC,123,1,1,19,20,19,1,5,16,20,1,14,1,1,1,10,5,20,16,1,12,5,14,0,0,0,0,0,0,0,0,0,0,0,0,0,0,0,0,0,0,0,0,0,0,0,0,0,0,0,0,0,0,0,0,0,0,0,0,0,0,0,0,0,0,0,0,0,0,0,0,0
29/6/2010,Santiago Morero,965358,1649,4/18/1982,28,0,0,0,0,1000,5000,6200,130,125,2605995,184,79,D RC,3,1,3,2,1,2,3,1,3,3,2,4,10,8,5,9,3,14,6,14,15,11,6,15,11,14,13,13,10,12,9,11,16,4,10,5,15,14,15,12,13,12,12,7,14,13,20,16,14,15,14,10,8,8,12,12,15,14,16,16,15,6,D RC,103,1,1,20,20,1,1,1,1,15,1,1,1,1,1,20,1,15,1,1,1,1,1,0,0,0,0,0,0,0,0,0,0,0,0,0,0,0,0,0,0,0,0,0,0,0,0,0,0,0,0,0,0,0,0,0,0,0,0,0,0,0,0,0,0,0,0,0,0,0,0,0
29/6/2010,Sandro Stallbaum,891544,771,9/14/1981,28,0,0,0,0,250,5000,5000,110,100,979598,183,79,D/WB/DM RLC,3,1,3,2,3,2,3,2,2,1,2,6,8,11,5,11,8,5,4,2,12,11,6,12,7,14,12,5,10,9,9,11,7,13,11,6,12,7,10,12,12,11,7,15,6,12,20,11,3,10,9,10,5,10,20,20,5,13,14,5,4,5,D/WB/DM RLC,126,1,1,16,20,16,1,18,15,20,1,19,1,1,1,14,18,20,15,10,10,17,19,0,0,0,0,0,0,0,0,0,0,0,0,0,0,0,0,0,0,0,0,0,0,0,0,0,0,0,0,0,0,0,0,0,0,0,0,0,0,0,0,0,0,0,0,0,0,0,0,0
29/6/2010,Sammy Traoré,3501321,31,2/25/1976,34,22,0,0,0,3136,5600,5050,140,112,298428,192,82,D RC,1,1,1,3,1,3,2,1,1,3,2,5,6,8,7,8,10,16,12,6,13,7,13,14,8,14,15,15,11,10,7,12,11,8,13,8,12,16,15,7,7,16,16,8,12,8,20,13,17,10,14,12,8,10,11,13,15,8,11,13,13,12,D RC,103,1,1,20,20,10,1,1,10,15,1,1,1,1,1,20,1,15,10,1,1,1,1,274877906976,0,0,0,0,0,1,0,0,0,0,0,0,0,0,0,0,0,0,0,0,0,0,0,0,0,0,0,0,0,0,0,0,0,0,0,0,0,0,1,0,0,0,0,0,0,0,0,0
29/6/2010,Samba Diakité,85010614,769,1/24/1989,21,0,0,0,0,3306,5174,5150,135,115,1124463,186,76,D/WB/DM RC,2,3,3,2,1,1,2,7,2,3,2,5,7,8,6,11,6,11,7,9,13,9,6,12,11,15,14,14,12,12,8,10,16,7,8,7,10,15,17,16,12,14,13,5,15,12,20,17,14,14,15,14,5,10,8,12,10,14,13,12,12,7,D/WB/DM RC,333,1,1,20,16,20,1,1,15,16,1,16,1,1,1,12,1,16,15,1,1,1,16,1073741824,0,0,0,0,0,0,0,0,0,0,0,0,0,0,0,0,0,0,0,0,0,0,0,0,0,0,0,0,0,0,1,0,0,0,0,0,0,0,0,0,0,0,0,0,0,0,0,0
29/6/2010,Sam Ricketts,5101803,801,10/11/1981,28,38,0,0,0,3500,6150,6150,132,126,4600000,183,75,D/WB RLC,2,1,3,2,3,2,1,1,2,3,1,8,16,13,9,12,7,12,10,16,11,11,9,14,12,11,9,12,11,12,11,11,14,6,8,9,11,11,14,11,13,12,11,19,16,11,20,18,10,14,8,14,3,18,14,14,8,11,17,15,14,2,D/WB RLC,116,1,1,15,20,8,1,20,1,20,1,18,1,1,1,15,20,20,1,1,1,13,18,1099511627808,0,0,0,0,0,1,0,0,0,0,0,0,0,0,0,0,0,0,0,0,0,0,0,0,0,0,0,0,0,0,0,0,0,0,0,0,0,0,0,0,1,0,0,0,0,0,0,0
29/6/2010,Ryan Taylor,5111053,765,8/19/1984,25,0,0,4,0,3540,6000,6000,138,119,15092204,173,69,D/WB/M R,3,1,2,3,3,1,1,2,2,3,2,14,14,10,9,12,14,6,15,16,9,12,13,12,12,10,13,10,10,12,10,10,13,10,8,13,12,12,13,12,13,11,8,12,13,13,20,15,10,12,7,12,9,18,12,13,14,12,11,11,8,8,D/WB/M R,122,5,14,5,20,1,1,12,19,20,1,18,1,8,14,1,9,20,5,12,19,10,18,68719477024,0,0,0,0,0,1,0,0,1,0,0,0,0,0,0,0,0,0,0,0,0,0,0,0,0,0,0,0,0,0,0,0,0,0,0,0,1,0,0,0,0,0,0,0,0,0,0,0
29/6/2010,Ryan Shotton,5129388,765,9/30/1988,21,0,0,0,0,2200,5100,5100,120,106,4371474,191,85,D RC,2,2,1,2,2,2,2,6,2,2,1,2,11,10,9,8,3,13,7,12,11,7,3,14,9,14,11,13,11,10,8,10,12,4,8,11,14,12,13,11,11,12,13,12,12,11,20,12,14,10,10,10,3,10,8,14,17,8,16,13,3,4,D RC,103,5,1,20,20,1,1,1,1,18,1,1,1,1,1,20,1,18,1,1,1,1,1,0,0,0,0,0,0,0,0,0,0,0,0,0,0,0,0,0,0,0,0,0,0,0,0,0,0,0,0,0,0,0,0,0,0,0,0,0,0,0,0,0,0,0,0,0,0,0,0,0
29/6/2010,Rudy Mater,914150,769,1/13/1980,30,0,0,0,0,4761,6200,6200,140,138,7209258,180,70,D/WB/M R,3,2,1,2,3,1,2,9,1,3,2,10,15,12,6,13,7,11,12,11,9,13,9,14,13,15,13,15,12,13,11,14,16,8,15,11,13,16,17,15,12,14,10,8,15,14,20,15,11,15,14,14,7,15,12,15,13,14,14,10,10,10,D/WB/M R,122,1,12,1,20,1,1,12,17,20,1,18,1,10,12,1,12,20,1,10,17,12,18,2251799813816320,0,0,0,0,0,0,0,0,0,0,0,0,0,0,0,0,0,1,0,0,0,0,0,0,0,0,0,0,0,0,0,0,0,0,0,0,0,0,0,0,0,0,0,0,0,0,0,0
29/6/2010,Ronnie Stam,857224,784,6/18/1984,26,0,0,0,0,4830,6750,6650,142,139,6900000,175,70,D/WB/DM RLC,3,1,2,3,3,3,2,3,3,3,3,8,7,13,7,13,12,8,9,8,13,15,7,12,15,18,14,15,14,13,16,13,10,12,12,17,13,15,15,10,14,13,11,10,14,11,20,14,13,14,14,10,13,14,13,9,14,10,14,14,5,9,D/WB/DM RLC,126,1,1,18,20,18,1,15,15,20,1,16,1,1,1,10,15,20,15,13,13,14,16,0,0,0,0,0,0,0,0,0,0,0,0,0,0,0,0,0,0,0,0,0,0,0,0,0,0,0,0,0,0,0,0,0,0,0,0,0,0,0,0,0,0,0,0,0,0,0,0,0
29/6/2010,Ronald Zubar,919995,769,9/20/1985,24,0,0,15,2,3750,5600,6100,145,130,5999998,186,80,D RC,3,3,3,3,1,3,2,1,2,3,1,6,10,8,7,11,7,15,12,9,14,10,8,15,11,12,14,16,7,9,8,12,17,9,13,9,12,14,14,11,9,16,13,10,13,14,20,16,16,13,12,14,10,14,14,14,13,9,16,14,14,5,D RC,103,5,8,20,20,12,1,10,8,18,1,14,1,1,8,20,10,18,1,1,8,10,14,0,0,0,0,0,0,0,0,0,0,0,0,0,0,0,0,0,0,0,0,0,0,0,0,0,0,0,0,0,0,0,0,0,0,0,0,0,0,0,0,0,0,0,0,0,0,0,0,0
29/6/2010,Romain Inez,29023778,769,4/30/1988,22,0,0,0,0,150,3350,3350,122,101,2625197,183,74,D RLC,1,2,3,2,2,3,3,3,3,2,3,6,8,7,6,11,5,13,8,8,12,9,6,12,11,10,12,13,13,12,10,12,14,5,12,7,13,12,12,7,9,13,11,9,14,11,20,15,13,13,10,10,6,10,12,12,17,14,15,15,15,5,D RLC,106,1,1,15,20,1,1,17,1,20,1,12,1,1,1,15,17,20,1,1,1,12,12,0,0,0,0,0,0,0,0,0,0,0,0,0,0,0,0,0,0,0,0,0,0,0,0,0,0,0,0,0,0,0,0,0,0,0,0,0,0,0,0,0,0,0,0,0,0,0,0,0
29/6/2010,Romain Danzé,8428673,769,7/3/1986,23,0,0,3,0,4356,5900,5900,140,132,2059650,184,72,D/WB RL,2,3,2,1,2,1,1,7,3,2,1,8,13,11,7,11,7,12,8,10,12,10,9,10,12,7,14,13,11,13,10,12,16,9,7,11,13,14,16,15,13,14,12,8,13,14,20,17,12,13,7,14,8,15,15,13,16,14,16,16,16,5,D/WB RL,115,1,14,1,20,1,1,15,14,20,1,17,1,10,14,1,15,20,1,10,14,15,17,32,0,0,0,0,0,1,0,0,0,0,0,0,0,0,0,0,0,0,0,0,0,0,0,0,0,0,0,0,0,0,0,0,0,0,0,0,0,0,0,0,0,0,0,0,0,0,0,0
29/6/2010,Rolf Feltscher,69003383,798,10/6/1990,19,0,0,10,0,3000,5750,5750,129,114,7673430,183,78,D/WB R,2,2,1,3,3,2,2,3,3,3,2,9,11,10,7,14,5,10,8,10,14,11,5,14,13,6,12,10,12,14,12,11,9,4,10,10,12,17,14,11,10,13,16,11,15,13,20,9,9,10,6,6,9,10,14,17,11,9,9,7,5,13,D/WB R,112,1,1,1,20,1,1,1,1,20,1,20,1,1,1,1,6,20,1,1,1,1,20,0,0,0,0,0,0,0,0,0,0,0,0,0,0,0,0,0,0,0,0,0,0,0,0,0,0,0,0,0,0,0,0,0,0,0,0,0,0,0,0,0,0,0,0,0,0,0,0,0
29/6/2010,Rod Fanni,6201566,769,12/6/1981,28,4,0,5,1,5000,6704,6700,155,149,10687572,186,78,D/WB RC,1,2,2,3,3,2,1,9,3,2,1,7,14,14,6,12,10,15,14,14,15,11,9,13,12,12,14,14,14,13,11,13,15,11,11,13,13,13,14,16,13,14,13,8,13,15,20,16,14,14,12,15,9,12,12,16,11,14,14,16,16,7,D/WB RC,113,1,1,17,20,13,1,1,10,20,1,18,1,1,1,17,8,20,1,1,10,1,18,2,0,1,0,0,0,0,0,0,0,0,0,0,0,0,0,0,0,0,0,0,0,0,0,0,0,0,0,0,0,0,0,0,0,0,0,0,0,0,0,0,0,0,0,0,0,0,0,0
29/6/2010,Rincón,5116917,1651,5/31/1987,23,0,0,0,0,1000,4500,4950,140,109,338933,186,79,D RC,1,1,1,1,1,1,1,1,1,1,1,6,5,12,11,13,10,13,12,9,14,14,12,13,14,15,12,11,9,5,14,12,8,13,11,13,9,12,13,12,11,14,12,10,15,13,20,9,14,5,12,12,5,18,10,11,11,9,15,15,17,9,D RC,103,1,1,20,20,12,1,1,1,15,1,1,1,1,1,20,1,15,1,1,1,1,1,0,0,0,0,0,0,0,0,0,0,0,0,0,0,0,0,0,0,0,0,0,0,0,0,0,0,0,0,0,0,0,0,0,0,0,0,0,0,0,0,0,0,0,0,0,0,0,0,0
29/6/2010,Ricardo,735107,12,8/19/1980,29,4,0,0,0,2000,5750,5450,114,109,444805,185,77,D/DM RC,3,1,2,3,1,3,2,3,3,1,3,7,7,6,6,9,10,14,9,11,14,9,9,13,9,13,13,13,13,14,7,10,15,7,9,6,12,14,15,10,12,15,15,5,16,10,20,15,15,11,9,8,8,16,11,12,14,11,14,13,14,5,D/DM RC,113,1,1,20,20,17,1,1,15,15,5,7,1,1,1,20,1,15,15,1,1,1,7,66,0,1,0,0,0,0,1,0,0,0,0,0,0,0,0,0,0,0,0,0,0,0,0,0,0,0,0,0,0,0,0,0,0,0,0,0,0,0,0,0,0,0,0,0,0,0,0,0
29/6/2010,Ricardo Esteves,7004820,788,9/16/1979,30,0,0,8,0,3080,5500,5500,116,111,923935,175,68,D/WB R,1,1,1,1,2,1,2,1,1,3,1,14,15,11,7,9,12,10,13,12,11,13,12,12,12,11,12,13,12,12,10,12,14,9,12,11,12,12,14,12,11,10,10,8,11,12,20,11,10,13,6,10,7,12,8,9,13,12,14,14,13,6,D/WB R,112,1,12,14,20,7,1,1,15,20,1,17,12,1,10,1,12,20,14,1,15,1,17,2050,0,1,0,0,0,0,0,0,0,0,0,1,0,0,0,0,0,0,0,0,0,0,0,0,0,0,0,0,0,0,0,0,0,0,0,0,0,0,0,0,0,0,0,0,0,0,0,0
29/6/2010,Ricardo Clark,978701,390,2/10/1983,27,31,2,0,0,3782,6100,6150,134,123,916394,178,73,D/WB/DM RC,3,1,2,3,3,3,3,5,3,1,3,12,11,10,8,12,11,13,11,7,13,10,10,13,13,14,11,13,11,11,13,10,16,9,10,10,12,16,17,11,12,13,13,14,14,11,20,13,12,14,7,13,4,12,13,16,14,16,19,18,16,5,D/WB/DM RC,333,1,7,20,18,20,1,9,15,18,4,17,7,1,5,8,9,18,15,7,12,9,17,2147614720,0,0,0,0,0,0,0,0,0,0,0,0,0,0,0,0,0,1,0,0,0,0,0,0,0,0,0,0,0,0,0,1,0,0,0,0,0,0,0,0,0,0,0,0,0,0,0,0
29/6/2010,Ralph Gunesch,885160,771,9/2/1983,26,0,0,0,0,2000,5650,5650,115,113,975278,190,83,D RC,3,2,1,1,2,2,1,1,2,3,3,5,8,6,4,8,5,10,6,9,12,8,7,14,9,12,10,11,8,11,6,11,12,4,12,3,12,14,12,11,9,12,15,14,12,12,20,15,14,12,15,10,9,11,6,12,9,12,13,11,9,8,D RC,103,1,1,20,20,1,1,10,1,16,1,1,1,1,1,20,10,16,1,1,1,1,1,0,0,0,0,0,0,0,0,0,0,0,0,0,0,0,0,0,0,0,0,0,0,0,0,0,0,0,0,0,0,0,0,0,0,0,0,0,0,0,0,0,0,0,0,0,0,0,0,0
29/6/2010,Rafinha,8833533,1651,9/7/1985,24,1,0,15,3,5929,7750,7700,166,154,17999999,172,68,D/WB R,2,3,2,1,2,2,2,1,2,3,1,10,14,15,7,14,10,9,9,10,12,14,17,13,16,17,14,16,14,10,15,17,18,13,6,15,12,14,17,16,17,7,6,14,15,15,20,17,6,11,19,12,4,7,10,7,8,16,6,2,8,17,D/WB R,112,1,1,12,20,9,1,8,14,20,1,19,1,1,1,1,8,20,12,1,14,8,19,1245194,0,1,0,1,0,0,0,0,0,0,0,0,0,0,0,0,1,1,0,0,1,0,0,0,0,0,0,0,0,0,0,0,0,0,0,0,0,0,0,0,0,0,0,0,0,0,0,0
29/6/2010,Rafel Sastre,4206711,796,10/22/1975,34,0,0,0,0,3782,5750,5750,125,123,470090,175,74,D R,1,1,2,3,3,3,1,5,3,1,3,11,12,10,6,11,6,9,13,13,13,10,9,13,10,16,11,18,10,10,12,14,6,5,13,15,11,16,18,14,12,11,10,2,16,14,20,17,15,12,14,10,1,8,10,11,17,9,6,12,15,6,D R,102,1,1,1,20,1,1,1,10,20,1,15,1,1,1,1,9,20,1,1,10,1,15,32,0,0,0,0,0,1,0,0,0,0,0,0,0,0,0,0,0,0,0,0,0,0,0,0,0,0,0,0,0,0,0,0,0,0,0,0,0,0,0,0,0,0,0,0,0,0,0,0
29/6/2010,Radoslav Zabavnik,7560200,794,9/16/1980,29,46,1,0,0,3906,6750,6750,140,125,9325329,181,77,D RL,3,1,1,2,3,2,1,1,1,1,3,7,9,10,8,12,10,12,12,17,13,12,12,13,11,12,11,14,15,15,11,12,14,8,15,8,12,14,15,12,10,12,12,10,13,11,20,12,16,13,8,15,10,14,18,11,8,16,16,18,16,4,D RL,105,1,1,10,20,1,1,18,1,20,1,10,1,1,1,10,18,20,1,1,1,10,10,0,0,0,0,0,0,0,0,0,0,0,0,0,0,0,0,0,0,0,0,0,0,0,0,0,0,0,0,0,0,0,0,0,0,0,0,0,0,0,0,0,0,0,0,0,0,0,0,0
29/6/2010,Philipp Lahm,890613,771,11/11/1983,26,71,4,3,0,7396,8750,8750,175,172,99699478,170,62,D/WB RL,2,3,2,2,2,3,2,6,3,1,2,9,14,15,9,14,4,14,11,8,11,13,13,20,17,15,18,15,19,11,13,18,18,14,15,15,10,15,16,16,17,10,8,12,14,15,20,17,8,13,7,19,12,15,8,17,18,17,19,14,17,5,D/WB RL,115,1,1,12,20,12,1,20,9,20,1,20,1,1,1,1,20,20,4,9,9,20,20,691759218720,0,0,0,0,0,1,0,0,0,0,0,0,0,0,0,0,0,0,0,0,1,0,0,0,0,0,0,0,1,0,0,0,1,0,0,0,0,1,0,1,0,0,0,0,0,0,0,0
29/6/2010,Philipp Degen,5723167,798,2/15/1983,27,32,0,14,0,3721,6500,6250,132,122,3241499,185,81,D/WB R,2,3,3,2,3,1,2,1,3,2,3,10,12,14,7,11,8,10,12,12,9,14,11,13,15,13,11,8,10,9,13,10,10,11,8,14,8,8,16,15,13,12,12,10,6,16,20,15,9,8,8,13,20,12,12,14,10,13,12,11,9,11,D/WB R,112,1,11,1,20,1,1,8,14,20,1,20,1,1,11,1,8,20,1,1,14,8,20,4294967330,0,1,0,0,0,1,0,0,0,0,0,0,0,0,0,0,0,0,0,0,0,0,0,0,0,0,0,0,0,0,0,0,1,0,0,0,0,0,0,0,0,0,0,0,0,0,0,0
29/6/2010,Phil Neville,2005034,765,1/21/1977,33,59,0,7,0,5402,7100,7100,155,147,4777190,181,77,D/DM RLC,1,1,1,1,1,1,1,1,1,1,1,8,14,9,4,14,5,13,7,15,16,14,10,16,12,15,14,16,14,17,8,12,16,4,19,9,16,18,17,10,13,15,10,12,16,13,20,16,12,14,12,15,2,18,2,13,17,15,19,16,15,3,D/DM RLC,116,1,1,18,20,18,1,16,15,20,1,12,1,1,1,10,16,20,15,8,12,12,12,1236950581312,0,0,0,0,0,0,1,0,0,0,0,0,0,0,0,0,0,0,0,0,0,0,0,0,0,0,0,0,0,0,0,0,0,0,0,0,0,1,0,0,1,0,0,0,0,0,0,0
29/6/2010,Phil Bardsley,5107572,793,6/28/1985,25,0,0,0,0,3000,6500,6500,130,129,4369188,180,74,D R,3,2,3,3,2,1,2,3,1,3,2,5,11,9,8,10,11,10,9,10,14,11,6,14,11,17,14,17,11,14,7,14,18,5,12,9,12,15,15,14,12,12,9,7,16,13,20,16,11,6,14,11,4,8,7,16,15,12,13,6,9,10,D R,102,1,1,1,20,1,1,7,4,20,1,7,1,1,1,1,7,20,1,1,4,1,7,154618822658,0,1,0,0,0,0,0,0,0,0,0,0,0,0,0,0,0,0,0,0,0,0,0,0,0,0,0,0,0,0,0,0,0,0,1,0,0,1,0,0,0,0,0,0,0,0,0,0
29/6/2010,Petri Pasanen,510588,768,9/24/1980,29,57,1,6,0,4489,7370,7000,138,134,3179554,187,86,D RLC,1,2,2,2,2,2,2,3,2,3,2,6,9,6,5,11,14,12,14,16,16,9,10,15,11,12,13,13,16,16,7,10,14,3,13,7,16,18,14,10,8,15,15,8,15,12,20,14,16,18,5,13,11,16,17,10,17,16,18,16,14,2,D RLC,106,1,1,20,20,1,1,18,1,19,1,1,1,1,1,20,18,19,1,1,1,1,1,35192962024256,0,0,0,0,0,0,1,0,1,1,0,0,0,0,0,0,0,0,0,0,0,0,0,0,0,0,0,0,0,0,0,0,0,1,0,0,0,0,0,0,0,0,0,0,0,1,0,0
29/6/2010,Peter Pekarik,7563749,794,10/30/1986,23,24,1,5,0,3000,6500,6500,150,125,3480153,176,72,D R,2,1,1,2,1,2,1,4,1,3,3,12,16,12,8,14,9,10,6,10,14,13,8,13,12,9,13,11,10,10,15,13,15,7,1,13,16,17,12,12,12,9,8,10,15,13,20,14,6,17,16,10,12,10,5,12,13,14,14,17,9,7,D R,102,1,1,8,20,1,1,1,8,20,1,14,1,1,1,8,1,20,1,1,8,1,14,0,0,0,0,0,0,0,0,0,0,0,0,0,0,0,0,0,0,0,0,0,0,0,0,0,0,0,0,0,0,0,0,0,0,0,0,0,0,0,0,0,0,0,0,0,0,0,0,0
29/6/2010,Pereirinha,55001512,788,3/2/1988,22,0,0,11,0,2250,5800,5800,131,116,412122,173,68,D/M/AM R,2,2,3,2,2,3,3,3,3,2,3,12,12,12,8,10,7,6,9,9,9,9,9,12,11,11,9,13,13,10,11,8,11,13,9,13,8,9,10,16,13,6,7,8,13,15,20,10,7,10,8,11,7,16,11,11,15,12,16,16,16,3,D/M/AM R,432,1,20,12,17,1,1,10,20,20,1,14,12,10,20,1,1,17,10,8,15,1,14,19,1,1,0,0,1,0,0,0,0,0,0,0,0,0,0,0,0,0,0,0,0,0,0,0,0,0,0,0,0,0,0,0,0,0,0,0,0,0,0,0,0,0,0,0,0,0,0,0
29/6/2010,Pedro Silva,316622,1651,4/25/1981,29,0,0,0,0,3250,6350,6000,128,120,408733,179,77,D/WB R,3,3,3,2,2,3,1,1,3,1,3,13,14,13,12,14,13,11,13,11,12,15,14,12,14,12,12,10,11,11,12,11,10,11,10,15,9,11,13,12,12,15,12,10,10,13,20,14,17,12,12,11,10,12,11,10,7,9,6,12,6,13,D/WB R,112,1,1,1,20,1,1,10,10,20,1,18,1,1,1,1,10,20,1,1,10,10,18,288,0,0,0,0,0,1,0,0,1,0,0,0,0,0,0,0,0,0,0,0,0,0,0,0,0,0,0,0,0,0,0,0,0,0,0,0,0,0,0,0,0,0,0,0,0,0,0,0
29/6/2010,Pedro Queirós,55011074,788,8/8/1984,25,0,0,0,0,1980,4500,4500,105,89,453068,180,72,D R,3,3,2,3,2,3,1,4,3,3,1,10,10,9,7,10,9,9,10,10,10,9,10,12,10,11,10,11,11,11,7,10,13,8,10,11,11,12,12,12,11,11,10,7,13,12,20,12,12,11,10,10,8,10,10,10,13,11,12,13,13,6,D R,102,1,1,1,20,1,1,10,1,20,1,10,1,1,1,1,10,20,1,1,1,1,10,0,0,0,0,0,0,0,0,0,0,0,0,0,0,0,0,0,0,0,0,0,0,0,0,0,0,0,0,0,0,0,0,0,0,0,0,0,0,0,0,0,0,0,0,0,0,0,0,0
29/6/2010,Pedro Moreira,741746,788,10/23/1983,26,0,0,0,0,1500,5250,5250,105,93,209537,177,72,D R,1,1,3,3,1,1,2,5,2,2,3,10,11,9,7,11,7,10,9,11,10,10,6,12,11,9,11,11,14,10,9,9,12,7,7,14,12,13,13,12,13,11,11,7,13,12,20,12,12,13,7,10,6,7,5,14,14,11,13,14,15,4,D R,102,1,1,1,20,1,1,5,10,20,1,10,1,1,1,1,5,20,1,1,10,1,10,1050626,0,1,0,0,0,0,0,0,0,0,0,1,0,0,0,0,0,0,0,0,1,0,0,0,0,0,0,0,0,0,0,0,0,0,0,0,0,0,0,0,0,0,0,0,0,0,0,0
29/6/2010,Pedro Costa,726086,788,11/21/1981,28,0,0,0,0,1000,5000,5000,104,102,196563,167,68,D RL,2,3,3,2,1,3,3,1,1,2,2,8,10,9,6,10,9,9,8,11,10,9,8,13,10,10,10,12,14,13,7,9,13,7,8,13,12,13,14,12,12,9,6,14,12,12,20,11,9,11,6,10,8,9,9,11,13,10,14,15,15,3,D RL,105,1,1,1,20,1,1,17,5,20,1,6,1,1,1,1,17,20,1,1,5,1,5,2,0,1,0,0,0,0,0,0,0,0,0,0,0,0,0,0,0,0,0,0,0,0,0,0,0,0,0,0,0,0,0,0,0,0,0,0,0,0,0,0,0,0,0,0,0,0,0,0
29/6/2010,Pedrinho,743337,788,3/6/1985,25,0,0,0,0,2250,5500,5500,115,109,238676,175,72,D R,3,1,2,1,2,1,1,1,3,1,2,12,12,14,12,12,11,9,10,9,9,10,10,9,15,11,13,12,12,11,10,11,14,12,16,12,11,11,11,13,12,10,9,5,12,13,20,12,10,15,9,13,8,11,10,13,13,11,14,14,15,5,D R,102,1,13,5,20,1,1,1,12,20,1,10,5,1,13,1,1,20,1,1,12,1,10,19,1,1,0,0,1,0,0,0,0,0,0,0,0,0,0,0,0,0,0,0,0,0,0,0,0,0,0,0,0,0,0,0,0,0,0,0,0,0,0,0,0,0,0,0,0,0,0,0
29/6/2010,Paulo Ferreira,4102044,788,1/18/1979,31,62,0,27,0,4900,7250,6900,160,140,4797358,183,76,D RL,2,2,3,1,2,1,2,1,2,2,2,10,14,10,5,9,12,10,9,11,14,10,12,14,13,14,14,13,11,17,13,14,18,5,10,12,14,16,16,10,15,15,10,15,15,11,20,16,9,13,5,17,4,16,10,18,16,14,18,18,18,3,D RL,105,1,1,10,20,1,1,16,8,20,1,10,1,1,1,10,16,20,1,1,8,1,10,0,0,0,0,0,0,0,0,0,0,0,0,0,0,0,0,0,0,0,0,0,0,0,0,0,0,0,0,0,0,0,0,0,0,0,0,0,0,0,0,0,0,0,0,0,0,0,0,0
29/6/2010,Paul Stalteri,3601906,364,10/18/1977,32,81,7,7,2,3660,6655,5050,135,121,2720002,181,77,D R,1,2,3,1,3,3,2,2,2,3,1,8,10,7,6,12,8,12,11,12,13,8,7,14,10,15,14,9,11,14,7,11,15,8,12,9,13,18,16,12,10,10,13,13,17,12,20,15,13,13,15,12,3,14,18,14,12,14,15,15,12,8,D R,102,5,1,13,20,13,1,9,5,20,1,11,1,1,1,1,9,20,1,1,5,6,11,0,0,0,0,0,0,0,0,0,0,0,0,0,0,0,0,0,0,0,0,0,0,0,0,0,0,0,0,0,0,0,0,0,0,0,0,0,0,0,0,0,0,0,0,0,0,0,0,0
29/6/2010,Pau Cendrós,67006021,796,4/1/1987,23,0,0,0,0,3700,5100,5100,138,123,5354131,176,72,D/WB R,2,2,3,3,3,3,3,1,1,3,3,9,12,11,5,11,7,9,8,13,13,11,6,13,10,14,14,13,10,11,9,12,14,7,9,12,13,14,14,13,12,12,8,11,10,15,20,16,10,13,15,11,6,13,12,15,11,12,13,14,14,5,D/WB R,112,1,1,1,20,1,1,10,1,20,1,16,1,1,1,1,10,20,1,1,1,6,16,141733920768,0,0,0,0,0,0,0,0,0,0,0,0,0,0,0,0,0,0,0,0,0,0,0,0,0,0,0,0,0,0,0,0,1,0,0,0,0,1,0,0,0,0,0,0,0,0,0,0
29/6/2010,Patrick Owomoyela,6000923,771,11/5/1979,30,11,0,0,0,3750,6850,6850,141,134,8542538,187,84,D/WB R,1,2,3,2,1,3,1,4,2,1,1,8,13,14,8,13,9,15,9,16,11,12,8,12,13,10,11,12,14,10,11,12,13,14,11,13,11,15,16,13,14,15,16,10,12,14,20,15,15,13,6,13,12,16,12,13,11,13,16,15,10,8,D/WB R,112,1,11,1,20,1,1,14,14,20,1,19,1,8,11,1,14,20,1,11,14,13,19,8,0,0,0,1,0,0,0,0,0,0,0,0,0,0,0,0,0,0,0,0,0,0,0,0,0,0,0,0,0,0,0,0,0,0,0,0,0,0,0,0,0,0,0,0,0,0,0,0
29/6/2010,Patrick Ochs,890615,771,5/14/1984,26,0,0,9,0,3500,7050,7050,146,141,10633866,179,71,D R,1,3,3,3,2,1,3,4,3,2,3,8,12,11,8,11,6,9,8,7,12,14,8,15,10,16,12,14,12,12,12,13,11,5,15,11,14,15,16,15,15,13,9,10,14,16,20,16,14,14,13,13,3,12,10,2,7,6,20,14,7,10,D R,102,1,1,10,20,10,1,1,14,20,1,14,1,1,1,10,6,20,1,1,14,1,14,0,0,0,0,0,0,0,0,0,0,0,0,0,0,0,0,0,0,0,0,0,0,0,0,0,0,0,0,0,0,0,0,0,0,0,0,0,0,0,0,0,0,0,0,0,0,0,0,0
29/6/2010,Patrick Funk,29022521,771,2/11/1990,20,0,0,0,0,3000,5750,5750,140,115,8835806,177,73,D/DM/M RC,3,2,1,2,2,3,1,1,1,2,2,14,6,9,5,12,10,10,7,6,12,13,17,13,12,15,12,17,12,12,11,13,14,5,16,8,12,16,18,11,10,12,9,6,15,11,20,14,15,12,6,14,4,16,12,14,16,16,13,12,10,11,D/DM/M RC,433,1,1,20,17,17,1,10,20,17,1,1,1,1,1,1,10,17,20,1,1,1,1,0,0,0,0,0,0,0,0,0,0,0,0,0,0,0,0,0,0,0,0,0,0,0,0,0,0,0,0,0,0,0,0,0,0,0,0,0,0,0,0,0,0,0,0,0,0,0,0,0
29/6/2010,Pascal Chimbonda,911945,769,2/21/1979,31,1,0,0,0,4160,5850,6250,145,129,3450000,181,70,D RL,3,2,3,2,3,2,2,7,3,1,2,7,12,12,8,14,6,14,8,10,13,12,10,15,13,15,14,9,14,11,10,11,10,14,7,14,12,14,12,14,14,13,11,5,16,14,20,17,14,11,10,12,5,9,14,20,3,13,6,8,8,16,D RL,105,1,1,12,20,1,1,18,1,20,1,10,1,1,1,12,18,20,1,1,1,1,10,17314086944,0,0,0,0,0,1,0,0,0,0,0,0,0,0,0,0,0,0,0,0,0,0,0,0,0,0,0,1,0,0,0,0,0,0,1,0,0,0,0,0,0,0,0,0,0,0,0,0
29/6/2010,Paolo Hernán Dellafiore,7988413,776,2/2/1985,25,0,0,6,0,3300,6150,6150,140,128,2056418,186,74,D RC,3,2,3,1,3,1,3,4,1,2,3,9,12,10,4,7,4,16,4,5,16,11,4,16,6,12,14,14,15,11,5,12,14,11,11,6,15,14,16,15,16,9,14,9,12,14,20,8,10,15,8,14,6,13,15,14,13,14,6,10,6,6,D RC,103,1,1,20,20,6,1,6,13,16,8,12,1,1,1,20,6,16,1,1,13,4,12,0,0,0,0,0,0,0,0,0,0,0,0,0,0,0,0,0,0,0,0,0,0,0,0,0,0,0,0,0,0,0,0,0,0,0,0,0,0,0,0,0,0,0,0,0,0,0,0,0
29/6/2010,Pablo Zabaleta,951034,1649,1/16/1985,25,7,0,43,5,5476,6750,7250,155,148,67459202,177,76,D/WB/M RC,2,3,1,1,3,1,2,3,3,1,3,8,13,11,10,12,7,10,12,14,13,12,11,13,13,17,14,14,15,14,12,12,17,4,10,11,13,18,18,15,14,13,9,10,15,14,20,16,12,13,8,14,13,19,18,16,15,18,17,15,14,11,D/WB/M RC,123,1,14,18,20,14,1,1,18,20,1,18,1,1,14,1,13,20,18,1,18,1,18,0,0,0,0,0,0,0,0,0,0,0,0,0,0,0,0,0,0,0,0,0,0,0,0,0,0,0,0,0,0,0,0,0,0,0,0,0,0,0,0,0,0,0,0,0,0,0,0,0
29/6/2010,Pablo Pintos,78015289,1657,7/1/1987,22,0,0,0,0,4356,6500,6050,150,132,2999998,182,78,D/WB/M R,2,1,3,3,1,3,2,8,1,2,1,4,13,12,6,12,4,10,8,10,12,12,5,11,14,14,13,13,12,8,12,7,13,15,7,13,11,15,15,17,13,14,13,10,17,18,20,15,14,11,14,12,4,18,10,10,10,12,14,7,8,6,D/WB/M R,122,1,1,1,20,1,1,1,17,20,1,19,1,1,1,1,10,20,1,1,17,1,19,32,0,0,0,0,0,1,0,0,0,0,0,0,0,0,0,0,0,0,0,0,0,0,0,0,0,0,0,0,0,0,0,0,0,0,0,0,0,0,0,0,0,0,0,0,0,0,0,0
29/6/2010,Pablo Pinillos,4209187,796,7/9/1974,35,0,0,0,0,4160,6500,6500,135,129,466945,174,71,D RL,2,3,3,1,3,2,1,1,2,1,3,8,8,8,6,11,3,13,4,15,14,8,14,14,5,18,13,20,9,20,6,13,18,3,17,10,15,20,20,11,13,13,8,4,14,11,20,15,14,16,15,14,6,15,19,11,18,16,20,13,7,4,D RL,105,1,1,12,20,1,1,15,1,20,1,15,1,1,1,12,15,20,1,1,1,13,15,2199023288320,0,0,0,0,0,0,0,0,0,0,0,0,0,0,0,1,0,0,0,0,0,0,0,0,0,0,0,0,0,0,0,0,0,0,0,0,0,0,0,0,0,1,0,0,0,0,0,0
29/6/2010,Pablo Barzola,954179,1649,11/17/1983,26,0,0,3,0,1350,5600,5600,144,125,5220354,178,79,D/WB R,3,2,1,3,1,2,3,5,3,3,2,14,14,10,6,12,15,9,11,14,13,9,14,12,12,13,12,14,12,12,12,12,12,11,9,9,11,12,14,13,10,14,9,12,12,14,20,15,14,14,9,13,12,10,13,11,14,13,14,13,16,9,D/WB R,222,1,1,1,19,1,1,12,12,20,1,20,1,1,1,1,12,19,1,10,12,12,20,68719477248,0,0,0,0,0,0,0,0,0,1,0,0,0,0,0,0,0,0,0,0,0,0,0,0,0,0,0,0,0,0,0,0,0,0,0,0,1,0,0,0,0,0,0,0,0,0,0,0
29/6/2010,Pablo Álvarez,957025,1649,4/17/1984,26,0,0,0,0,4000,6000,6500,140,129,7451736,177,78,D/WB RL,1,1,1,1,1,1,1,1,1,1,1,11,14,11,6,9,9,8,14,14,12,13,5,15,11,16,12,15,10,10,10,11,17,10,9,10,13,12,13,15,14,12,9,12,14,15,20,14,12,13,13,13,7,17,14,15,12,15,13,12,8,10,D/WB RL,115,1,1,1,20,1,1,18,14,20,1,19,1,1,1,1,18,20,1,1,14,18,19,1099511627776,0,0,0,0,0,0,0,0,0,0,0,0,0,0,0,0,0,0,0,0,0,0,0,0,0,0,0,0,0,0,0,0,0,0,0,0,0,0,0,0,1,0,0,0,0,0,0,0
29/6/2010,Onyekachi Apam,8632613,38,12/30/1986,23,12,0,10,1,4489,6700,6000,155,134,8999999,177,67,D RC,3,1,2,3,2,3,2,7,3,3,1,5,11,8,6,10,7,12,8,11,14,6,7,15,10,16,16,15,9,12,6,12,15,6,11,9,13,13,16,16,13,15,9,10,14,14,20,15,14,11,16,15,9,10,13,16,12,13,11,11,11,11,D RC,103,1,1,20,20,1,1,13,1,15,1,15,1,1,1,20,13,15,1,1,1,13,15,137438986240,0,0,0,0,0,0,0,0,0,0,0,0,0,0,0,1,0,0,0,0,0,0,0,0,0,0,0,0,0,0,0,0,0,0,0,0,0,1,0,0,0,0,0,0,0,0,0,0
29/6/2010,Omar Daf,3501767,41,2/12/1977,33,46,0,0,0,3844,6200,5550,138,124,1121767,177,71,D RL,2,1,2,2,3,2,3,1,1,1,2,7,11,8,6,11,7,11,10,13,12,8,6,14,11,13,14,15,10,13,9,12,14,6,15,7,13,16,14,13,12,13,8,12,10,12,20,14,13,14,13,15,12,7,8,12,18,14,17,15,15,5,D RL,105,1,1,12,20,1,1,15,1,20,1,15,1,1,1,12,15,20,1,1,1,15,15,0,0,0,0,0,0,0,0,0,0,0,0,0,0,0,0,0,0,0,0,0,0,0,0,0,0,0,0,0,0,0,0,0,0,0,0,0,0,0,0,0,0,0,0,0,0,0,0,0
29/6/2010,Oliver Kirch,890518,771,8/21/1982,27,0,0,0,0,3422,5850,5850,125,117,2292260,182,73,WB/M R,3,1,3,2,3,3,1,4,1,2,3,8,10,11,5,12,6,13,9,9,14,10,7,13,13,13,13,13,12,12,9,10,12,10,6,7,12,14,15,15,15,9,13,5,12,15,20,12,10,12,7,11,15,14,12,13,12,10,13,13,11,6,WB/M R,422,1,13,14,14,14,1,5,20,20,5,18,1,1,13,10,5,14,8,1,20,5,18,0,0,0,0,0,0,0,0,0,0,0,0,0,0,0,0,0,0,0,0,0,0,0,0,0,0,0,0,0,0,0,0,0,0,0,0,0,0,0,0,0,0,0,0,0,0,0,0,0
29/6/2010,Noé Pamarot,3500933,769,4/14/1979,31,0,0,0,0,3906,5624,4750,139,125,1669540,180,87,D RC,1,2,1,1,3,2,2,7,1,1,2,5,9,6,7,9,10,16,9,5,14,10,6,14,9,14,12,16,11,11,8,10,17,6,8,8,12,14,14,14,7,16,12,9,10,13,20,15,17,11,14,10,5,7,12,13,16,14,13,10,14,7,D RC,103,1,1,20,20,1,1,13,1,16,1,1,1,1,1,20,13,16,1,1,1,1,1,137438986240,0,0,0,0,0,0,0,0,0,0,0,0,0,0,0,1,0,0,0,0,0,0,0,0,0,0,0,0,0,0,0,0,0,0,0,0,0,1,0,0,0,0,0,0,0,0,0,0
29/6/2010,Niko Bungert,8728048,771,10/24/1986,23,0,0,3,0,3250,6250,6250,135,125,2755092,188,68,D RC,2,2,2,1,1,1,2,1,2,2,1,3,11,5,5,13,3,12,5,7,16,13,5,12,11,11,16,11,8,14,9,13,13,9,6,4,12,14,12,14,16,11,15,5,12,14,20,12,13,11,6,6,4,10,12,14,7,8,11,15,8,7,D RC,103,1,1,20,20,1,1,1,1,16,1,1,1,1,1,20,1,16,1,1,1,1,1,274877906944,0,0,0,0,0,0,0,0,0,0,0,0,0,0,0,0,0,0,0,0,0,0,0,0,0,0,0,0,0,0,0,0,0,0,0,0,0,0,1,0,0,0,0,0,0,0,0,0
29/6/2010,Nicolò Cherubin,1402118,776,12/2/1986,23,0,0,0,0,1750,5500,5500,135,111,1986151,188,83,D RC,1,1,1,1,1,1,1,1,1,1,1,2,4,4,4,8,4,15,5,8,13,7,5,14,8,12,14,11,8,11,8,11,14,6,14,5,13,14,14,12,11,14,16,6,14,12,20,12,15,15,12,13,4,14,5,12,18,10,14,12,8,4,D RC,103,1,1,20,20,1,1,14,1,15,10,1,1,1,1,20,14,15,1,1,1,1,1,0,0,0,0,0,0,0,0,0,0,0,0,0,0,0,0,0,0,0,0,0,0,0,0,0,0,0,0,0,0,0,0,0,0,0,0,0,0,0,0,0,0,0,0,0,0,0,0,0
29/6/2010,Nicolas Frey,8430961,769,3/6/1984,26,0,0,0,0,3844,5000,6100,129,124,2934190,184,78,D RC,1,3,1,3,2,1,3,1,2,2,1,8,12,9,6,11,7,12,7,13,14,12,5,13,11,13,11,13,12,15,10,10,10,8,9,12,13,12,13,13,13,14,12,8,15,14,20,14,15,15,12,13,10,13,15,10,14,10,14,13,10,5,D RC,103,1,1,18,20,1,1,1,1,20,1,14,1,1,1,18,6,20,1,1,1,1,14,0,0,0,0,0,0,0,0,0,0,0,0,0,0,0,0,0,0,0,0,0,0,0,0,0,0,0,0,0,0,0,0,0,0,0,0,0,0,0,0,0,0,0,0,0,0,0,0,0
29/6/2010,Nicola Belmonte,7990575,776,4/15/1987,23,0,0,0,0,1000,5300,5300,130,121,2624222,183,77,D R,3,2,2,1,2,2,2,1,2,3,1,5,9,8,5,9,5,13,7,12,14,10,7,14,7,13,14,11,8,13,6,12,14,5,8,13,14,11,12,13,12,12,13,10,12,13,20,12,15,13,7,10,12,15,12,15,12,10,15,9,10,2,D R,102,1,1,14,20,1,1,14,1,20,1,8,1,1,1,14,14,20,1,1,1,1,8,64,0,0,0,0,0,0,1,0,0,0,0,0,0,0,0,0,0,0,0,0,0,0,0,0,0,0,0,0,0,0,0,0,0,0,0,0,0,0,0,0,0,0,0,0,0,0,0,0
29/6/2010,Ney,2113304,1651,2/23/1981,29,0,0,0,0,2000,5800,5000,110,107,516265,181,81,D/DM RLC,2,2,1,1,3,1,3,3,1,2,1,9,9,9,7,9,7,9,9,13,12,10,5,10,11,16,11,15,9,10,8,8,14,8,10,9,10,12,11,12,13,10,12,10,13,12,20,14,13,11,14,13,7,19,9,12,9,12,12,10,10,10,D/DM RLC,116,1,1,18,20,18,1,15,15,20,1,13,1,1,1,15,15,20,15,1,1,10,13,34,0,1,0,0,0,1,0,0,0,0,0,0,0,0,0,0,0,0,0,0,0,0,0,0,0,0,0,0,0,0,0,0,0,0,0,0,0,0,0,0,0,0,0,0,0,0,0,0
29/6/2010,Nenad Tomovic,5768029,802,8/30/1987,22,2,0,20,1,4250,6050,6150,158,133,6207536,184,74,D RC,2,3,3,2,3,1,2,2,3,3,3,8,12,10,8,15,11,10,9,10,14,14,13,14,14,16,10,12,16,11,11,13,13,13,11,14,13,14,16,14,13,13,12,5,15,14,20,13,14,11,9,13,7,15,12,15,13,14,11,11,13,6,D RC,103,1,1,18,20,1,1,1,15,20,1,15,1,1,1,18,1,20,1,1,15,1,15,8796093022240,0,0,0,0,0,1,0,0,0,0,0,0,0,0,0,0,0,0,0,0,0,0,0,0,0,0,0,0,0,0,0,0,0,0,0,0,0,0,0,0,0,0,0,1,0,0,0,0
29/6/2010,Nélson,735185,788,6/10/1983,27,0,0,3,0,4032,6985,6000,146,127,1671678,175,71,D/WB R,2,1,1,1,3,1,3,4,1,3,3,12,13,13,11,10,9,7,10,10,11,12,10,12,13,11,13,11,12,10,8,9,11,11,7,15,12,12,14,16,15,10,7,10,12,17,20,15,11,11,7,12,15,13,10,12,7,14,7,15,15,7,D/WB R,112,1,13,1,20,1,1,10,10,20,1,20,1,10,13,1,10,20,1,1,10,10,20,1374389534754,0,1,0,0,0,1,0,0,0,0,0,0,0,0,0,0,0,0,0,0,0,0,0,0,0,0,0,0,0,0,0,0,0,0,0,0,0,0,1,0,1,0,0,0,0,0,0,0
29/6/2010,Nedum Onuoha,5114013,765,11/30/1986,23,0,0,21,2,4500,6750,6750,152,135,4173096,183,93,D RC,1,3,1,1,2,3,1,6,2,2,1,4,4,7,4,7,4,15,5,13,14,7,5,15,8,12,10,13,10,12,8,10,14,4,13,7,14,13,10,20,14,12,12,7,16,18,20,17,15,13,2,12,16,12,11,14,15,13,18,15,14,2,D RC,103,1,1,20,20,1,1,10,1,18,1,10,1,1,1,20,10,18,1,1,1,1,10,0,0,0,0,0,0,0,0,0,0,0,0,0,0,0,0,0,0,0,0,0,0,0,0,0,0,0,0,0,0,0,0,0,0,0,0,0,0,0,0,0,0,0,0,0,0,0,0,0
29/6/2010,Neal Eardley,28003784,801,11/6/1988,21,13,0,10,1,3000,6000,5700,138,110,5033672,181,74,D R,2,1,3,2,1,2,1,2,3,1,1,9,13,13,13,9,13,13,12,8,13,13,15,14,10,11,11,12,10,10,10,12,11,5,14,9,13,8,15,10,9,9,10,11,16,14,20,10,13,13,6,8,3,10,11,14,14,12,10,10,14,11,D R,102,1,1,1,20,1,1,12,5,20,1,14,1,1,1,1,12,20,1,1,5,1,14,39582687036192,0,0,0,0,0,1,0,0,1,1,0,0,0,0,0,0,0,0,0,0,0,0,0,0,0,0,0,0,1,0,0,0,0,0,0,0,0,0,0,0,0,0,1,0,0,1,0,0
29/6/2010,Mourad Benhamida,915741,769,1/18/1986,24,0,0,0,0,100,3550,3550,130,108,3390149,176,67,D RL,1,3,1,3,2,3,3,2,1,2,1,6,9,8,6,11,6,11,7,10,11,9,6,12,11,8,11,13,11,11,7,13,10,6,13,6,13,13,15,14,12,12,8,10,14,11,20,14,9,13,11,6,7,8,8,18,15,14,6,5,7,10,D RL,105,1,1,12,20,1,1,15,10,20,1,15,1,1,1,12,15,20,1,1,10,15,15,0,0,0,0,0,0,0,0,0,0,0,0,0,0,0,0,0,0,0,0,0,0,0,0,0,0,0,0,0,0,0,0,0,0,0,0,0,0,0,0,0,0,0,0,0,0,0,0,0
29/6/2010,Mouhamadou Dabo,919771,769,11/28/1986,23,0,0,17,0,4830,6200,6200,152,139,13768721,176,67,D/WB/M RL,2,3,3,3,3,2,3,7,1,3,1,10,12,12,6,12,9,11,11,13,10,12,8,14,13,11,12,13,13,13,11,12,16,11,9,11,13,12,14,16,13,13,8,14,12,14,20,15,8,14,11,15,8,17,9,16,11,14,17,14,14,9,D/WB/M RL,125,5,14,10,20,10,1,20,16,18,1,18,1,14,13,1,20,18,1,16,13,18,18,2251799813685280,0,0,0,0,0,1,0,0,0,0,0,0,0,0,0,0,0,0,0,0,0,0,0,0,0,0,0,0,0,0,0,0,0,0,0,0,0,0,0,0,0,0,0,0,0,0,0,0
29/6/2010,Moritz Volz,5101690,771,1/21/1983,27,0,0,20,0,3192,5650,5650,121,113,2747001,178,78,D R,3,1,2,1,1,3,2,1,2,2,1,5,10,10,7,9,9,8,7,5,11,10,5,13,12,10,13,14,12,10,14,11,16,11,11,12,11,14,17,13,14,13,10,8,14,13,20,12,16,13,4,13,14,11,15,15,17,16,17,18,20,4,D R,102,1,1,1,20,1,1,1,1,20,1,15,1,1,1,1,13,20,1,1,1,1,15,549755813888,0,0,0,0,0,0,0,0,0,0,0,0,0,0,0,0,0,0,0,0,0,0,0,0,0,0,0,0,0,0,0,0,0,0,0,0,0,0,0,1,0,0,0,0,0,0,0,0
29/6/2010,Modibo Diakité,1408579,769,3/2/1987,23,0,0,0,0,3000,5894,6500,153,131,4459425,192,84,D RC,1,1,2,3,1,3,2,1,1,3,1,2,2,6,6,4,2,17,4,15,14,8,6,15,6,15,13,14,10,12,4,10,12,3,6,8,14,11,14,15,11,17,18,7,7,13,20,15,18,12,15,12,10,11,10,12,11,12,11,12,14,8,D RC,103,1,1,20,20,1,1,1,1,15,10,1,1,1,1,20,1,15,1,1,1,1,1,292057808960,0,0,0,0,0,0,1,0,0,0,0,0,0,0,0,1,0,0,0,0,0,0,0,0,0,0,0,0,0,0,0,0,0,0,1,0,0,0,1,0,0,0,0,0,0,0,0,0
29/6/2010,Miso Brecko,7582393,795,5/1/1984,26,34,0,0,0,3850,6875,6250,133,125,2893639,178,68,D RL,2,3,3,1,1,1,1,6,2,2,2,11,8,10,7,11,10,11,11,10,13,11,8,14,11,12,13,14,11,11,9,11,9,7,7,8,13,15,14,14,13,12,9,12,14,14,20,14,14,12,12,11,5,8,14,16,5,5,6,1,5,18,D RL,105,1,5,5,20,1,1,15,8,20,1,12,1,2,5,5,15,20,1,5,8,8,12,0,0,0,0,0,0,0,0,0,0,0,0,0,0,0,0,0,0,0,0,0,0,0,0,0,0,0,0,0,0,0,0,0,0,0,0,0,0,0,0,0,0,0,0,0,0,0,0,0
29/6/2010,Milan Bisevac,5763744,802,8/31/1983,26,3,0,20,1,4692,6164,6150,145,137,7361134,185,81,D RC,3,2,2,3,2,3,2,9,3,3,2,6,8,9,7,10,12,15,13,9,15,11,10,14,11,15,13,13,12,14,9,12,15,7,16,8,14,13,14,13,11,15,13,12,13,12,20,15,15,15,15,15,10,13,11,12,11,13,15,13,13,7,D RC,103,1,1,20,20,14,1,8,10,15,10,1,1,1,1,20,8,15,10,1,1,1,1,0,0,0,0,0,0,0,0,0,0,0,0,0,0,0,0,0,0,0,0,0,0,0,0,0,0,0,0,0,0,0,0,0,0,0,0,0,0,0,0,0,0,0,0,0,0,0,0,0
29/6/2010,Miguel,7003451,788,1/4/1980,30,58,1,23,4,5041,7500,7000,152,142,86992260,179,78,D/WB R,1,3,2,3,2,1,2,6,3,2,2,7,12,12,7,12,7,8,12,13,11,13,10,15,12,11,12,16,9,10,11,10,12,11,9,13,11,16,15,15,16,17,9,12,17,17,20,18,12,13,12,12,11,12,13,13,11,10,7,12,11,5,D/WB R,112,1,8,6,20,6,1,5,10,20,1,20,1,1,8,1,5,20,4,1,10,5,20,32,0,0,0,0,0,1,0,0,0,0,0,0,0,0,0,0,0,0,0,0,0,0,0,0,0,0,0,0,0,0,0,0,0,0,0,0,0,0,0,0,0,0,0,0,0,0,0,0
29/6/2010,Miguel Torres,67011252,796,1/28/1986,24,0,0,12,0,4624,6550,6550,151,136,5690856,184,74,D RL,2,2,1,2,1,2,1,4,3,2,2,7,11,8,5,10,6,13,10,16,16,11,6,14,10,14,14,16,13,17,8,11,13,4,11,8,15,17,16,13,11,14,12,8,15,14,20,15,12,17,13,14,8,19,13,9,18,14,15,13,17,4,D RL,105,1,1,10,20,8,1,19,8,20,5,13,1,1,1,10,19,20,3,8,8,13,13,0,0,0,0,0,0,0,0,0,0,0,0,0,0,0,0,0,0,0,0,0,0,0,0,0,0,0,0,0,0,0,0,0,0,0,0,0,0,0,0,0,0,0,0,0,0,0,0,0
29/6/2010,Michele Contini,43026372,776,3/27/1991,19,0,0,0,0,50,400,400,105,35,1552,192,88,D RLC,1,1,1,1,1,2,2,1,3,2,3,1,3,6,2,4,0,8,2,8,4,2,2,10,2,17,7,5,3,7,2,9,6,4,11,2,11,10,9,12,12,11,12,6,14,12,20,5,5,7,10,10,13,10,8,2,13,13,15,9,7,16,D RLC,106,1,1,20,20,1,1,20,1,20,1,9,1,1,1,20,20,20,1,1,1,6,9,0,0,0,0,0,0,0,0,0,0,0,0,0,0,0,0,0,0,0,0,0,0,0,0,0,0,0,0,0,0,0,0,0,0,0,0,0,0,0,0,0,0,0,0,0,0,0,0,0
29/6/2010,Michel,19019226,1651,2/15/1990,20,0,0,3,0,3906,5624,5250,131,125,10515418,174,67,D/WB R,3,2,3,1,3,3,3,4,3,1,2,12,14,13,12,11,10,7,10,11,12,12,11,12,12,11,12,12,12,9,11,12,14,12,7,13,10,11,12,15,14,11,7,14,13,15,20,15,12,13,8,12,9,13,9,16,12,11,13,12,14,9,D/WB R,112,1,1,1,20,1,1,1,11,20,1,16,1,1,1,1,5,20,1,1,11,1,16,0,0,0,0,0,0,0,0,0,0,0,0,0,0,0,0,0,0,0,0,0,0,0,0,0,0,0,0,0,0,0,0,0,0,0,0,0,0,0,0,0,0,0,0,0,0,0,0,0
29/6/2010,Míchel Salgado,4200618,796,10/22/1975,34,53,0,10,0,4356,6750,6750,162,132,1030510,174,75,D R,1,2,1,1,1,3,1,4,2,2,1,11,14,11,9,13,9,5,10,12,14,15,4,16,13,18,14,18,14,14,10,14,18,10,13,15,14,17,17,11,10,14,8,6,16,11,20,13,12,14,16,17,13,10,13,17,9,13,17,12,10,11,D R,102,1,1,5,20,5,1,7,10,20,5,15,1,1,1,2,7,20,5,1,10,2,15,32,0,0,0,0,0,1,0,0,0,0,0,0,0,0,0,0,0,0,0,0,0,0,0,0,0,0,0,0,0,0,0,0,0,0,0,0,0,0,0,0,0,0,0,0,0,0,0,0
29/6/2010,Michel Bertasso,55012134,1651,3/6/1985,25,0,0,0,0,500,4500,4500,110,100,443024,183,77,D R,1,3,2,3,2,3,3,3,1,3,2,11,14,9,9,13,9,12,9,10,11,8,10,14,13,17,10,10,11,11,10,10,12,6,13,5,12,9,13,14,10,12,10,5,17,14,20,9,8,10,8,10,8,10,12,11,12,12,13,13,13,5,D R,102,1,1,10,20,1,1,10,1,20,1,10,1,1,1,10,10,20,1,1,1,1,10,0,0,0,0,0,0,0,0,0,0,0,0,0,0,0,0,0,0,0,0,0,0,0,0,0,0,0,0,0,0,0,0,0,0,0,0,0,0,0,0,0,0,0,0,0,0,0,0,0
29/6/2010,Michel Bastos,856161,1651,8/2/1983,26,10,1,0,0,6162,7500,7050,160,157,33925325,178,74,D/WB/M/AM RL,2,2,2,2,1,1,1,8,1,3,1,14,16,14,13,14,17,8,16,11,8,14,16,11,14,11,12,12,14,14,15,13,15,13,11,13,12,13,14,14,14,13,9,20,14,16,8,15,13,16,11,14,8,15,12,15,13,13,15,13,13,10,D/WB/M/AM RL,445,1,20,10,16,10,1,20,20,15,1,16,1,20,15,1,16,1,10,18,15,16,15,2286984185774112,0,0,0,0,0,1,0,0,0,0,0,0,0,0,0,0,0,0,0,0,0,0,0,0,0,0,0,0,0,0,0,0,0,0,0,0,0,0,0,0,0,0,0,0,0,1,0,0
29/6/2010,Michael Mancienne,5006675,765,1/8/1988,22,0,0,21,1,3969,6000,6000,160,126,3027181,184,80,D RC,2,3,1,3,1,1,2,1,1,1,3,1,8,12,6,13,3,13,6,8,14,11,4,13,12,10,14,10,14,11,9,12,13,8,10,8,14,12,11,14,14,12,13,10,15,15,20,14,10,14,8,14,8,8,14,17,15,14,15,14,13,7,D RC,103,1,1,20,20,15,1,10,15,15,10,1,1,1,1,20,10,15,15,1,1,1,1,32832,0,0,0,0,0,0,1,0,0,0,0,0,0,0,0,1,0,0,0,0,0,0,0,0,0,0,0,0,0,0,0,0,0,0,0,0,0,0,0,0,0,0,0,0,0,0,0,0
29/6/2010,Michaël Chrétien,916312,34,7/10/1984,25,23,0,0,0,4830,6950,6250,150,139,4714799,179,69,D/WB RC,1,3,3,3,3,3,1,9,3,3,2,13,13,11,7,12,12,11,7,14,12,10,11,13,12,11,15,14,13,13,12,14,14,8,13,10,14,14,13,15,12,14,9,10,11,14,20,15,11,15,11,14,15,10,9,15,13,14,16,14,16,5,D/WB RC,113,1,1,16,20,12,1,10,12,20,1,18,1,1,1,16,10,20,10,8,12,10,18,274877906976,0,0,0,0,0,1,0,0,0,0,0,0,0,0,0,0,0,0,0,0,0,0,0,0,0,0,0,0,0,0,0,0,0,0,0,0,0,0,1,0,0,0,0,0,0,0,0,0
29/6/2010,Micah Richards,5005673,765,6/24/1988,22,11,1,14,3,4692,7150,7150,152,137,29235593,181,83,D RC,2,3,3,3,1,1,2,6,1,3,3,3,6,8,7,8,5,15,4,15,14,7,6,15,7,15,10,19,9,12,6,12,11,4,11,7,8,17,17,19,13,9,14,8,17,18,20,19,18,10,8,12,6,16,17,16,18,14,10,13,11,8,D RC,103,5,1,18,20,10,1,5,10,20,1,12,1,1,1,18,5,20,10,1,1,1,12,32808,0,0,0,1,0,1,0,0,0,0,0,0,0,0,0,1,0,0,0,0,0,0,0,0,0,0,0,0,0,0,0,0,0,0,0,0,0,0,0,0,0,0,0,0,0,0,0,0
29/6/2010,Mensur Mujdza,658188,759,8/10/1984,25,0,0,4,0,3906,5624,6000,134,125,2728900,185,84,D/WB/M R,3,3,1,3,2,2,2,1,1,1,3,7,15,13,6,12,6,14,9,14,14,13,7,10,14,9,11,12,13,13,13,8,12,8,7,12,13,12,14,15,10,13,14,10,12,13,20,14,11,15,7,9,10,12,16,15,11,9,13,11,8,4,D/WB/M R,122,1,14,7,20,7,1,1,16,20,1,20,1,1,14,1,8,20,7,1,16,1,20,0,0,0,0,0,0,0,0,0,0,0,0,0,0,0,0,0,0,0,0,0,0,0,0,0,0,0,0,0,0,0,0,0,0,0,0,0,0,0,0,0,0,0,0,0,0,0,0,0
29/6/2010,Medhi Benatia,8443128,34,4/17/1987,23,6,0,0,0,2600,6150,4050,150,123,30853893,190,80,D RC,1,3,3,3,2,2,2,1,2,1,3,5,8,8,6,11,7,14,9,7,16,10,7,12,11,12,14,15,13,12,10,12,14,8,12,7,13,13,14,13,8,16,15,8,13,10,20,15,16,14,12,16,11,8,14,17,8,13,14,14,11,12,D RC,103,1,1,20,20,15,1,1,15,16,14,12,1,1,1,20,1,16,15,1,1,1,12,0,0,0,0,0,0,0,0,0,0,0,0,0,0,0,0,0,0,0,0,0,0,0,0,0,0,0,0,0,0,0,0,0,0,0,0,0,0,0,0,0,0,0,0,0,0,0,0,0
29/6/2010,Maxime Josse,8428698,769,3/21/1987,23,0,0,3,0,3249,5100,5100,130,114,2340719,184,82,D RC,1,1,2,1,1,1,3,7,2,1,1,5,9,8,5,9,11,15,8,10,13,7,7,14,9,12,13,14,11,11,6,10,14,5,11,7,11,12,15,14,9,15,12,8,12,13,20,15,15,14,12,12,8,8,9,13,14,10,16,15,15,6,D RC,103,1,1,20,20,1,1,1,8,16,1,14,1,1,1,20,1,16,1,1,8,1,14,0,0,0,0,0,0,0,0,0,0,0,0,0,0,0,0,0,0,0,0,0,0,0,0,0,0,0,0,0,0,0,0,0,0,0,0,0,0,0,0,0,0,0,0,0,0,0,0,0
29/6/2010,Maxime Baca,918411,769,6/2/1983,27,0,0,0,0,1000,5300,5300,130,118,1180875,171,68,D/WB R,1,3,1,2,2,1,3,5,1,2,3,10,12,9,6,11,6,7,8,10,9,10,5,14,11,11,13,13,13,13,8,11,13,8,9,12,12,12,14,14,13,12,5,12,14,13,20,14,8,14,7,13,6,8,12,13,13,11,15,15,15,8,D/WB R,112,1,1,1,20,1,1,13,1,20,1,18,1,1,1,1,13,20,1,1,1,13,18,0,0,0,0,0,0,0,0,0,0,0,0,0,0,0,0,0,0,0,0,0,0,0,0,0,0,0,0,0,0,0,0,0,0,0,0,0,0,0,0,0,0,0,0,0,0,0,0,0
29/6/2010,Maxi Pereira,5512991,1657,6/8/1984,26,44,1,3,0,4900,7700,7000,153,140,27844206,173,70,D/WB/M R,2,1,2,2,1,3,2,6,2,3,2,12,12,12,11,11,13,11,13,13,11,13,12,15,12,13,12,14,14,13,11,13,13,9,15,15,12,15,15,15,14,12,6,10,15,14,20,17,14,15,12,13,10,16,14,14,14,14,14,12,10,6,D/WB/M R,232,1,12,13,19,13,1,11,17,20,1,20,10,9,12,1,1,19,10,11,17,7,20,2147483680,0,0,0,0,0,1,0,0,0,0,0,0,0,0,0,0,0,0,0,0,0,0,0,0,0,0,0,0,0,0,0,1,0,0,0,0,0,0,0,0,0,0,0,0,0,0,0,0
29/6/2010,Maurizio Lanzaro,3801610,776,3/14/1982,28,0,0,4,0,3000,5000,5550,118,115,1318683,183,80,D RC,1,1,1,1,1,1,1,1,1,1,1,4,9,4,5,8,4,16,6,12,13,10,6,14,10,13,12,11,11,10,5,13,18,11,7,11,13,10,12,11,12,14,13,8,11,12,20,13,15,9,18,13,11,13,3,16,17,12,18,15,15,1,D RC,103,1,1,20,20,1,1,1,1,18,5,1,1,1,1,20,1,18,1,1,1,1,1,1103806627840,0,0,0,0,0,0,0,0,0,0,0,0,0,0,0,1,0,0,0,0,0,0,0,0,0,0,0,0,0,0,0,0,1,0,0,0,0,0,0,0,1,0,0,0,0,0,0,0
29/6/2010,Mauricio Isla,75000523,1652,6/12/1988,22,16,0,1,0,4500,6950,6950,167,139,36277081,175,72,D/WB/DM/M RC,3,2,3,1,3,3,3,8,2,3,3,7,8,14,8,12,6,6,7,7,10,11,10,14,13,18,16,15,9,14,13,12,15,10,14,15,11,16,18,15,14,14,6,9,15,15,20,18,9,14,12,13,3,20,17,15,11,12,12,12,9,6,D/WB/DM/M RC,243,1,8,20,16,18,1,10,20,20,1,20,1,8,8,1,1,16,20,8,14,10,20,32,0,0,0,0,0,1,0,0,0,0,0,0,0,0,0,0,0,0,0,0,0,0,0,0,0,0,0,0,0,0,0,0,0,0,0,0,0,0,0,0,0,0,0,0,0,0,0,0
29/6/2010,Mattia Cassani,837158,776,8/26/1983,26,0,0,0,0,5500,7450,7450,162,153,19728148,182,71,D/WB RL,3,1,1,2,1,3,2,6,1,2,2,12,16,15,13,14,10,10,15,18,16,16,4,16,14,10,15,13,14,13,6,13,18,10,8,13,13,15,14,13,13,15,9,13,13,15,20,13,14,16,8,18,7,20,13,15,16,14,16,16,15,3,D/WB RL,115,1,1,10,20,10,1,16,13,20,1,20,1,1,1,4,16,20,1,1,13,15,20,1099511627808,0,0,0,0,0,1,0,0,0,0,0,0,0,0,0,0,0,0,0,0,0,0,0,0,0,0,0,0,0,0,0,0,0,0,0,0,0,0,0,0,1,0,0,0,0,0,0,0
29/6/2010,Matias Ezequiel Schelotto,43048983,776,5/23/1989,21,0,0,3,0,4422,6250,6250,166,133,1171844,187,76,WB/M/AM R,1,2,2,1,3,3,3,3,1,3,1,10,13,13,14,8,12,8,10,14,10,14,10,8,11,9,13,14,14,10,8,9,19,11,6,15,9,13,9,15,9,10,13,13,17,14,20,16,15,13,8,12,4,14,18,19,18,6,17,13,8,6,WB/M/AM R,432,1,18,1,14,1,1,1,20,20,1,16,1,1,18,1,1,14,1,1,20,1,16,1099511627778,0,1,0,0,0,0,0,0,0,0,0,0,0,0,0,0,0,0,0,0,0,0,0,0,0,0,0,0,0,0,0,0,0,0,0,0,0,0,0,0,1,0,0,0,0,0,0,0
29/6/2010,Mathieu Debuchy,915351,769,7/28/1985,24,0,0,3,0,4761,6200,6200,150,138,4002245,177,74,D/WB/M R,3,1,3,1,3,3,3,6,3,1,1,10,12,11,7,12,13,12,14,10,11,13,9,15,12,12,13,17,13,15,12,12,17,11,13,8,13,16,17,14,12,14,8,12,12,11,20,17,13,15,12,15,12,18,7,12,17,13,16,14,14,6,D/WB/M R,122,1,12,14,20,14,5,10,18,20,1,16,8,10,12,1,4,20,14,10,18,10,16,2,0,1,0,0,0,0,0,0,0,0,0,0,0,0,0,0,0,0,0,0,0,0,0,0,0,0,0,0,0,0,0,0,0,0,0,0,0,0,0,0,0,0,0,0,0,0,0,0
29/6/2010,Mathieu Chalmé,919901,769,10/7/1980,29,0,0,0,0,4624,6100,6100,145,136,53292101,175,72,D/WB R,1,2,1,3,2,1,3,8,1,3,1,13,15,11,5,11,13,10,12,12,11,12,14,15,11,14,14,15,8,12,12,13,14,7,13,9,14,15,17,15,13,13,7,10,15,12,20,16,12,14,17,13,6,16,14,14,15,12,14,7,7,6,D/WB R,112,1,10,12,20,12,1,12,12,20,1,17,1,1,10,1,12,20,10,5,12,12,17,2,0,1,0,0,0,0,0,0,0,0,0,0,0,0,0,0,0,0,0,0,0,0,0,0,0,0,0,0,0,0,0,0,0,0,0,0,0,0,0,0,0,0,0,0,0,0,0,0
29/6/2010,Mathias Hinzmann,8707391,771,1/2/1984,26,0,0,0,0,250,4250,4250,90,85,520184,180,74,D/WB R,3,3,3,2,3,1,1,1,1,1,3,4,8,9,3,11,3,9,7,1,10,9,5,13,7,15,11,13,13,9,10,11,11,4,14,8,9,14,9,13,12,12,6,12,13,12,20,13,8,10,11,8,12,10,8,10,17,12,15,12,6,8,D/WB R,112,1,1,11,20,10,1,13,5,20,5,18,1,1,1,11,13,20,5,1,1,12,18,0,0,0,0,0,0,0,0,0,0,0,0,0,0,0,0,0,0,0,0,0,0,0,0,0,0,0,0,0,0,0,0,0,0,0,0,0,0,0,0,0,0,0,0,0,0,0,0,0
29/6/2010,Mathias Abel,889227,771,6/22/1981,29,0,0,1,0,2750,5750,5750,133,115,1635323,188,82,D RC,3,3,3,2,3,3,3,3,3,1,2,7,8,9,10,11,8,13,10,15,13,11,8,15,10,13,12,13,12,12,9,11,13,12,14,9,14,14,14,14,11,12,16,6,15,12,20,11,12,12,9,12,18,15,14,15,14,13,16,18,8,13,D RC,103,1,1,17,20,10,1,1,1,20,1,14,1,1,1,17,9,20,1,1,1,1,14,2,0,1,0,0,0,0,0,0,0,0,0,0,0,0,0,0,0,0,0,0,0,0,0,0,0,0,0,0,0,0,0,0,0,0,0,0,0,0,0,0,0,0,0,0,0,0,0,0
29/6/2010,Massimo Oddo,705380,776,6/14/1976,34,34,1,0,0,4556,6750,6750,152,135,1943606,182,76,D/WB R,3,1,1,3,3,3,3,2,3,1,3,12,13,12,6,12,13,11,13,13,13,14,16,14,12,12,13,12,11,10,12,11,12,8,13,14,15,13,14,13,13,14,11,14,15,14,20,14,13,8,10,10,12,8,15,10,14,13,15,16,15,12,D/WB R,112,1,1,8,20,1,1,1,11,20,1,18,1,1,1,8,9,20,1,1,11,1,18,9895604649986,0,1,0,0,0,0,0,0,0,0,0,0,0,0,0,0,0,0,0,0,0,0,0,0,0,0,0,0,0,0,0,0,0,0,0,0,0,0,0,0,1,0,0,1,0,0,0,0
29/6/2010,Martin Petras,5640419,794,11/2/1979,30,39,1,0,0,2756,5750,5200,114,105,995624,186,82,D RC,3,3,1,1,2,1,1,1,1,2,3,8,11,8,12,9,8,16,6,9,14,13,10,13,8,13,13,13,13,9,9,13,15,6,9,11,10,15,11,10,9,12,13,9,11,9,20,13,13,13,14,10,10,10,14,15,13,14,13,11,8,9,D RC,103,1,1,20,20,1,1,13,1,17,1,1,1,1,1,20,13,17,1,1,1,1,1,33024,0,0,0,0,0,0,0,0,1,0,0,0,0,0,0,1,0,0,0,0,0,0,0,0,0,0,0,0,0,0,0,0,0,0,0,0,0,0,0,0,0,0,0,0,0,0,0,0
29/6/2010,Martin Jiranek,132959,763,5/25/1979,31,31,0,20,4,4096,6750,5500,150,128,2699066,190,91,D RC,2,3,1,3,2,3,3,3,3,1,3,5,9,10,7,13,5,16,9,15,12,11,10,15,11,15,10,14,14,13,10,11,12,9,14,8,12,14,12,12,13,15,15,5,12,13,20,15,16,12,9,14,4,11,17,14,15,14,12,14,15,10,D RC,103,1,1,20,20,1,1,6,1,15,1,12,1,1,1,20,6,15,1,1,1,1,12,1099511627840,0,0,0,0,0,0,1,0,0,0,0,0,0,0,0,0,0,0,0,0,0,0,0,0,0,0,0,0,0,0,0,0,0,0,0,0,0,0,0,0,1,0,0,0,0,0,0,0
29/6/2010,Markus Thorandt,890557,771,4/1/1981,29,0,0,0,0,2750,5900,5900,118,118,2330136,186,82,D RC,3,1,1,3,2,3,3,1,2,1,1,8,12,8,7,11,6,14,9,12,12,10,8,13,11,12,12,14,9,10,8,13,12,6,12,9,13,14,13,12,10,14,14,8,15,13,20,14,15,14,5,10,5,13,8,11,12,11,13,14,8,5,D RC,103,1,1,20,20,10,1,8,12,18,1,14,1,1,1,20,8,18,5,1,12,6,14,2,0,1,0,0,0,0,0,0,0,0,0,0,0,0,0,0,0,0,0,0,0,0,0,0,0,0,0,0,0,0,0,0,0,0,0,0,0,0,0,0,0,0,0,0,0,0,0,0
29/6/2010,Markus Berger,8708085,755,1/21/1985,25,0,0,33,0,2000,5000,5000,112,106,162037,183,75,D RC,2,3,2,3,1,2,1,1,3,3,1,7,7,8,8,9,7,14,9,10,12,9,10,12,10,13,11,11,15,15,8,11,12,6,9,8,12,13,11,11,10,13,14,4,13,10,20,12,13,11,8,10,7,13,9,12,9,10,13,13,12,10,D RC,103,1,1,20,20,12,1,8,1,15,1,5,1,1,1,20,8,15,1,1,1,1,5,0,0,0,0,0,0,0,0,0,0,0,0,0,0,0,0,0,0,0,0,0,0,0,0,0,0,0,0,0,0,0,0,0,0,0,0,0,0,0,0,0,0,0,0,0,0,0,0,0
29/6/2010,Marius Stankevicius,139029,779,7/15/1981,28,49,4,0,0,4556,6750,6750,144,135,2145466,190,83,D/WB RC,2,3,2,3,3,2,2,3,2,2,3,7,7,5,5,10,15,13,9,20,14,11,8,14,8,12,11,13,13,12,12,12,10,5,11,12,14,13,14,14,12,15,14,13,12,13,20,19,11,12,9,10,10,15,12,17,5,5,9,2,5,2,D/WB RC,113,1,1,15,20,1,1,1,15,20,1,20,1,1,1,15,13,20,1,1,15,1,20,0,0,0,0,0,0,0,0,0,0,0,0,0,0,0,0,0,0,0,0,0,0,0,0,0,0,0,0,0,0,0,0,0,0,0,0,0,0,0,0,0,0,0,0,0,0,0,0,0
29/6/2010,Mario,67066949,796,11/24/1990,19,0,0,0,0,3721,6100,6100,154,122,36629265,178,71,D/WB R,2,2,3,1,2,1,3,7,1,2,3,8,12,10,5,12,6,7,8,12,11,12,8,13,12,13,12,11,13,15,10,11,10,9,10,12,11,15,13,16,12,11,9,6,13,15,20,15,10,17,11,13,6,10,15,16,6,13,8,13,12,17,D/WB R,112,1,1,1,20,1,1,1,8,20,1,16,1,1,1,1,9,20,1,1,8,1,16,32,0,0,0,0,0,1,0,0,0,0,0,0,0,0,0,0,0,0,0,0,0,0,0,0,0,0,0,0,0,0,0,0,0,0,0,0,0,0,0,0,0,0,0,0,0,0,0,0
29/6/2010,Marcos Angeleri,955253,1649,8/30/1982,27,3,0,0,0,4761,7000,6400,139,138,19280853,182,68,D/WB RC,3,2,2,3,1,2,2,6,3,1,3,9,13,11,4,8,4,11,9,15,15,12,9,14,11,13,14,14,12,14,10,14,15,8,10,4,16,14,15,14,14,13,12,5,12,17,20,13,13,13,13,16,6,15,6,16,16,16,14,14,13,8,D/WB RC,113,1,1,15,20,1,1,1,1,20,16,17,1,1,1,15,11,20,1,1,1,1,17,34,0,1,0,0,0,1,0,0,0,0,0,0,0,0,0,0,0,0,0,0,0,0,0,0,0,0,0,0,0,0,0,0,0,0,0,0,0,0,0,0,0,0,0,0,0,0,0,0
29/6/2010,Marco Zambelli,7982685,776,8/22/1985,24,0,0,1,0,1400,5900,5900,151,132,4546917,178,75,D/WB/DM/M RC,1,1,1,1,1,1,1,1,1,1,1,10,16,9,7,12,2,9,14,4,15,14,1,16,12,12,14,10,12,7,12,9,9,12,15,4,15,12,14,16,14,12,6,5,12,17,20,14,9,10,5,11,12,14,8,2,19,7,11,12,5,14,D/WB/DM/M RC,133,1,12,20,20,18,1,1,20,20,1,20,1,1,12,1,12,20,20,1,20,1,20,0,0,0,0,0,0,0,0,0,0,0,0,0,0,0,0,0,0,0,0,0,0,0,0,0,0,0,0,0,0,0,0,0,0,0,0,0,0,0,0,0,0,0,0,0,0,0,0,0
29/6/2010,Marco Rossi,704332,776,4/1/1978,32,0,0,7,0,5329,7050,7050,150,146,22864330,179,71,M R,1,1,1,1,1,1,1,1,1,1,1,9,13,12,10,11,5,10,8,3,10,14,10,13,13,14,16,18,16,16,12,13,17,10,18,16,15,17,18,13,14,14,9,8,15,14,20,18,14,16,10,16,6,18,5,7,20,15,18,15,14,2,M R,402,1,5,14,14,10,1,10,20,20,1,15,2,5,5,5,3,14,14,10,20,10,15,549755813890,0,1,0,0,0,0,0,0,0,0,0,0,0,0,0,0,0,0,0,0,0,0,0,0,0,0,0,0,0,0,0,0,0,0,0,0,0,0,0,1,0,0,0,0,0,0,0,0
29/6/2010,Marco Padalino,1402112,798,12/8/1983,26,8,1,0,0,4250,6750,6750,139,135,2123722,177,73,M/AM R,1,1,1,1,3,1,1,3,1,1,1,9,12,14,6,10,7,8,9,8,5,12,8,12,9,16,10,15,8,10,11,10,19,14,11,16,11,16,18,18,18,10,8,5,12,18,20,15,12,12,10,10,5,13,16,16,16,12,12,14,12,10,M/AM R,412,1,20,1,1,1,1,1,20,20,1,15,1,1,20,1,1,1,1,1,20,1,15,554320265248,0,0,0,0,0,1,0,0,0,0,0,0,0,0,0,0,0,0,0,0,1,0,0,0,0,0,0,0,1,0,0,0,1,0,0,0,0,0,0,1,0,0,0,0,0,0,0,0
29/6/2010,Marco Motta,7990132,776,5/14/1986,24,0,0,38,1,4750,7100,7100,154,141,7440348,183,76,D/WB RL,1,1,1,1,1,1,1,1,1,1,1,8,11,13,8,11,5,11,11,11,16,14,5,14,14,15,14,15,8,10,11,10,16,11,13,15,12,16,16,15,12,13,12,15,13,15,20,15,12,13,8,15,7,18,6,15,17,14,18,19,13,13,D/WB RL,115,1,8,5,20,1,1,15,15,20,1,20,1,1,8,5,15,20,1,15,15,15,20,0,0,0,0,0,0,0,0,0,0,0,0,0,0,0,0,0,0,0,0,0,0,0,0,0,0,0,0,0,0,0,0,0,0,0,0,0,0,0,0,0,0,0,0,0,0,0,0,0
29/6/2010,Marco Cassetti,3802204,776,5/29/1977,33,5,0,0,0,4500,7100,7100,150,146,6685309,187,80,D/WB/AM RC,1,1,1,1,1,1,1,1,1,1,1,10,15,14,11,11,10,14,13,10,13,16,6,13,13,12,13,14,13,13,14,14,12,11,8,14,15,16,16,13,13,14,14,5,16,14,20,14,14,12,13,12,10,16,5,10,16,10,18,18,16,3,D/WB/AM RC,233,1,17,17,19,10,1,12,15,20,1,20,1,1,17,17,12,19,10,1,15,10,20,1103806595840,0,0,0,0,0,0,0,0,1,1,0,0,0,0,0,0,0,0,0,0,0,0,0,0,0,0,0,0,0,0,0,0,1,0,0,0,0,0,0,0,1,0,0,0,0,0,0,0
29/6/2010,Marco Caligiuri,8707875,771,4/14/1984,26,0,0,0,0,3000,6100,6100,125,124,2836804,180,75,D/WB/DM/M RC,1,1,2,1,1,1,2,2,2,1,1,5,9,11,9,13,6,10,9,7,13,11,8,16,13,7,15,11,15,11,10,12,13,14,10,10,14,11,14,12,13,12,12,10,14,12,20,12,11,14,11,11,13,10,12,13,8,8,13,13,11,8,D/WB/DM/M RC,343,1,10,20,16,20,1,14,17,16,1,16,10,10,10,16,10,14,17,14,16,12,16,4503603922337856,0,0,0,0,0,0,1,0,0,0,0,0,0,0,0,0,0,0,0,0,0,0,0,0,0,0,0,0,0,0,0,0,1,0,0,0,0,0,0,0,0,0,0,0,0,0,0,0
29/6/2010,Marco Andreolli,7984570,776,6/10/1986,24,0,0,24,0,3500,6100,6100,148,125,3001521,187,81,D RC,3,1,1,2,1,2,1,1,3,3,2,4,13,8,8,10,8,15,9,11,15,11,6,15,8,9,14,13,12,13,10,17,15,5,8,10,13,14,14,13,13,13,14,5,15,13,20,12,12,13,13,10,15,14,19,15,13,8,7,11,12,11,D RC,103,1,1,20,20,10,1,10,1,16,1,1,1,1,1,20,10,16,1,1,1,1,1,0,0,0,0,0,0,0,0,0,0,0,0,0,0,0,0,0,0,0,0,0,0,0,0,0,0,0,0,0,0,0,0,0,0,0,0,0,0,0,0,0,0,0,0,0,0,0,0,0
29/6/2010,Marc Bartra,67063004,796,1/15/1991,19,0,0,0,0,2500,5250,5250,132,105,1978902,184,82,D RC,2,3,3,3,1,2,3,4,3,3,1,5,8,8,5,10,5,11,4,9,13,12,9,12,10,8,11,13,8,12,8,10,8,7,11,8,14,14,13,13,10,12,11,7,11,13,20,14,10,12,10,10,7,12,11,12,11,13,15,13,7,13,D RC,103,1,1,20,20,1,1,10,1,16,1,1,1,1,1,20,10,16,1,1,1,1,1,0,0,0,0,0,0,0,0,0,0,0,0,0,0,0,0,0,0,0,0,0,0,0,0,0,0,0,0,0,0,0,0,0,0,0,0,0,0,0,0,0,0,0,0,0,0,0,0,0
29/6/2010,Mapou Yanga Mbiwa,34000001,769,5/15/1989,21,0,0,4,0,4761,6209,6200,165,138,12611678,184,77,D/WB RLC,2,2,1,3,2,1,1,6,3,1,2,5,11,9,5,9,6,15,8,12,15,8,7,14,9,13,15,15,12,12,6,12,17,9,9,7,14,14,16,14,11,15,13,10,14,13,20,16,15,14,13,15,7,12,12,14,14,14,16,14,14,6,D/WB RLC,116,1,1,20,20,1,1,17,1,17,1,17,1,1,1,20,17,17,1,1,1,17,17,0,0,0,0,0,0,0,0,0,0,0,0,0,0,0,0,0,0,0,0,0,0,0,0,0,0,0,0,0,0,0,0,0,0,0,0,0,0,0,0,0,0,0,0,0,0,0,0,0
29/6/2010,Manuel Schmiedebach,35008171,771,12/5/1988,21,0,0,0,0,1000,5250,5250,122,105,5750333,174,68,D R,1,1,1,2,1,2,2,4,2,2,2,6,8,8,10,8,4,11,4,7,11,14,8,14,13,11,13,13,14,13,8,7,9,5,9,7,8,17,12,14,12,10,8,8,16,14,20,10,4,9,3,8,8,10,8,5,14,8,12,5,11,12,D R,102,1,1,10,20,10,1,1,5,20,1,15,1,1,1,1,6,20,1,1,5,1,15,0,0,0,0,0,0,0,0,0,0,0,0,0,0,0,0,0,0,0,0,0,0,0,0,0,0,0,0,0,0,0,0,0,0,0,0,0,0,0,0,0,0,0,0,0,0,0,0,0
29/6/2010,Manuel Pablo,4200628,796,1/25/1976,34,13,0,1,0,4624,6750,6750,157,136,2086344,172,70,D R,1,2,3,1,2,3,2,6,2,1,1,12,11,12,7,11,5,6,14,14,14,13,4,13,10,14,10,14,14,13,12,12,13,2,13,12,15,14,14,15,13,12,7,12,15,14,20,16,12,13,4,14,10,11,15,16,10,14,13,14,16,8,D R,102,1,1,1,20,1,1,12,1,20,1,15,1,1,1,1,12,20,1,1,1,7,15,8796094070784,0,0,0,0,0,0,0,0,0,0,0,0,0,0,0,0,0,0,0,0,1,0,0,0,0,0,0,0,0,0,0,0,0,0,0,0,0,0,0,0,0,0,0,1,0,0,0,0
29/6/2010,Manuel Hornig,8720668,771,12/18/1982,27,0,0,0,0,1500,5550,5550,118,111,1464911,189,83,D RC,3,3,3,2,3,1,1,6,1,1,3,3,10,7,13,10,3,15,6,10,14,12,2,15,10,10,8,7,8,13,8,7,12,4,7,11,13,13,16,9,9,16,15,18,11,9,20,11,11,11,10,10,12,4,10,12,13,10,11,14,10,11,D RC,103,10,1,20,20,1,1,1,1,18,1,1,1,1,1,20,1,18,1,1,1,1,1,0,0,0,0,0,0,0,0,0,0,0,0,0,0,0,0,0,0,0,0,0,0,0,0,0,0,0,0,0,0,0,0,0,0,0,0,0,0,0,0,0,0,0,0,0,0,0,0,0
29/6/2010,Manolo Gaspar,7444663,796,2/3/1981,29,0,0,0,0,3969,5750,5750,134,126,1843120,176,75,D R,2,3,2,1,1,2,3,3,1,1,2,10,14,11,8,7,11,8,11,16,10,14,10,14,10,16,10,11,11,14,13,13,12,10,17,13,15,15,18,11,15,14,9,7,13,11,20,15,16,16,14,13,7,8,7,12,18,13,14,6,6,6,D R,102,1,1,1,20,1,1,1,1,20,1,15,1,1,1,1,1,20,1,1,1,1,15,32,0,0,0,0,0,1,0,0,0,0,0,0,0,0,0,0,0,0,0,0,0,0,0,0,0,0,0,0,0,0,0,0,0,0,0,0,0,0,0,0,0,0,0,0,0,0,0,0
29/6/2010,Maicon,308421,1651,7/26/1981,28,58,5,19,2,7832,8500,8950,178,177,154317397,184,77,D/WB R,1,1,1,1,1,1,1,1,1,1,1,10,17,15,11,15,8,14,15,18,13,14,8,14,14,17,15,16,12,14,13,14,17,14,14,18,14,14,18,17,14,16,12,10,14,18,20,18,19,15,11,15,8,7,15,16,12,15,13,13,14,16,D/WB R,112,1,5,1,20,1,1,1,7,20,1,19,1,1,5,1,9,20,1,1,7,1,19,135282706,0,1,0,0,1,0,0,0,0,0,0,0,0,0,1,0,0,0,0,0,1,0,0,0,0,0,0,1,0,0,0,0,0,0,0,0,0,0,0,0,0,0,0,0,0,0,0,0
29/6/2010,Madi Panandetiguiri,5370416,9,3/22/1984,26,26,1,0,0,2450,5995,5450,120,109,377141,175,75,D/WB/DM RLC,1,1,2,1,2,2,1,2,2,1,3,12,10,14,3,14,11,5,8,3,11,12,7,12,13,12,10,13,8,8,9,9,14,10,6,12,11,9,14,14,13,9,10,10,14,13,20,12,9,12,7,10,3,18,15,14,11,8,10,11,12,7,D/WB/DM RLC,336,1,1,20,18,20,1,18,15,18,1,16,1,1,1,1,18,18,15,7,14,7,16,1,1,0,0,0,0,0,0,0,0,0,0,0,0,0,0,0,0,0,0,0,0,0,0,0,0,0,0,0,0,0,0,0,0,0,0,0,0,0,0,0,0,0,0,0,0,0,0,0
29/6/2010,Luke Young,108689,765,7/19/1979,30,7,0,17,1,5112,6750,6750,145,143,33745390,183,78,D/WB RL,1,2,1,2,3,1,3,1,1,1,2,6,12,9,8,13,6,10,7,14,14,12,5,14,12,15,14,15,14,15,10,15,10,7,16,12,15,15,16,12,10,13,12,11,16,13,20,16,13,17,10,13,7,13,14,16,10,14,12,15,13,6,D/WB RL,115,1,1,12,20,1,1,17,1,20,1,19,1,1,1,12,17,20,1,1,1,11,19,274877906944,0,0,0,0,0,0,0,0,0,0,0,0,0,0,0,0,0,0,0,0,0,0,0,0,0,0,0,0,0,0,0,0,0,0,0,0,0,0,1,0,0,0,0,0,0,0,0,0
29/6/2010,Lukasz Piszczek,719130,787,6/3/1985,25,8,0,0,0,3500,6400,6400,135,127,3448725,184,78,D/WB/M/AM R,2,1,1,2,2,2,1,5,1,3,2,6,11,12,7,11,7,10,8,9,7,10,10,8,13,6,13,10,9,12,12,13,12,15,6,14,8,17,15,16,15,10,12,10,14,14,20,14,11,11,6,12,8,18,12,9,8,12,15,12,11,5,D/WB/M/AM R,442,14,20,14,16,1,1,14,20,20,1,17,10,14,20,1,1,16,1,1,18,1,17,0,0,0,0,0,0,0,0,0,0,0,0,0,0,0,0,0,0,0,0,0,0,0,0,0,0,0,0,0,0,0,0,0,0,0,0,0,0,0,0,0,0,0,0,0,0,0,0,0
29/6/2010,Luis Perea,5260012,1653,1/30/1979,31,37,0,0,0,4830,7000,6500,160,139,3137953,181,73,D RC,2,2,2,1,3,3,1,2,3,3,2,4,7,9,5,7,5,13,9,11,13,10,10,15,11,14,17,17,11,12,11,8,17,5,10,10,9,15,16,19,15,15,11,7,16,18,20,17,15,9,13,11,8,14,17,16,15,14,15,14,13,10,D RC,103,1,1,20,20,1,1,5,1,19,10,10,1,1,1,20,5,19,1,1,1,1,10,12884901888,0,0,0,0,0,0,0,0,0,0,0,0,0,0,0,0,0,0,0,0,0,0,0,0,0,0,0,0,0,0,0,0,1,1,0,0,0,0,0,0,0,0,0,0,0,0,0,0
29/6/2010,Luis Olim,7002225,788,8/27/1981,28,0,0,0,0,500,5000,5000,107,100,74536,178,74,D/WB/M R,2,3,1,1,2,2,2,1,3,3,2,11,12,10,6,10,9,7,11,10,9,9,9,8,11,13,9,14,10,11,8,8,14,13,8,14,10,13,13,13,13,9,9,6,14,13,20,12,10,12,8,10,7,13,11,11,14,12,14,14,11,4,D/WB/M R,122,1,5,5,20,1,1,10,20,20,1,20,1,1,5,1,10,20,5,10,20,10,20,0,0,0,0,0,0,0,0,0,0,0,0,0,0,0,0,0,0,0,0,0,0,0,0,0,0,0,0,0,0,0,0,0,0,0,0,0,0,0,0,0,0,0,0,0,0,0,0,0
29/6/2010,Luís Filipe,902538,788,6/14/1979,31,0,0,10,0,3000,5800,5800,125,116,2661953,180,75,D R,2,2,3,2,1,2,3,1,3,2,3,12,13,13,9,12,9,10,12,11,11,12,12,13,13,13,13,11,11,14,11,11,14,9,8,12,12,14,14,13,13,13,12,8,13,13,20,14,13,12,10,10,11,12,10,7,14,12,14,15,11,3,D R,102,1,14,1,20,1,1,5,12,20,1,10,1,5,14,1,1,20,1,1,12,1,10,274894684194,0,1,0,0,0,1,0,0,0,0,0,0,0,0,0,0,0,0,0,0,0,0,0,0,1,0,0,0,0,0,0,0,0,0,0,0,0,0,1,0,0,0,0,0,0,0,0,0
29/6/2010,Ludovic Sané,85032367,769,3/22/1987,23,0,0,0,0,4096,5759,5750,150,128,4353438,192,77,D RC,1,3,1,2,1,2,3,6,1,1,3,6,8,8,7,9,5,15,10,5,14,8,7,14,9,14,14,15,13,14,7,11,15,5,9,8,14,12,15,15,10,16,16,5,14,13,20,15,15,14,13,14,7,6,6,14,11,14,13,14,14,7,D RC,103,1,1,20,20,14,1,1,10,16,1,10,1,1,1,20,1,16,10,1,1,1,10,4503874505277440,0,0,0,0,0,0,0,0,0,0,0,0,0,0,0,0,0,0,0,0,0,0,0,0,0,0,0,0,0,0,0,0,0,0,0,0,0,0,1,0,0,0,0,0,0,0,0,0
29/6/2010,Luciano Zauri,703064,776,1/20/1978,32,5,0,1,0,4500,6900,6900,152,138,4015940,178,75,D/WB RL,1,1,1,1,1,1,1,1,1,1,1,8,11,11,5,10,8,11,11,9,14,12,7,14,11,11,14,15,11,13,9,13,17,9,17,12,13,14,16,14,13,11,8,13,16,15,20,15,11,19,10,13,11,20,14,16,15,14,17,16,14,3,D/WB RL,115,1,3,14,20,12,1,18,10,20,5,20,1,3,3,14,18,20,10,10,10,15,20,96,0,0,0,0,0,1,1,0,0,0,0,0,0,0,0,0,0,0,0,0,0,0,0,0,0,0,0,0,0,0,0,0,0,0,0,0,0,0,0,0,0,0,0,0,0,0,0,0
29/6/2010,Luca Ceccarelli,837453,776,3/24/1983,27,0,0,0,0,2000,5850,5850,122,122,4425216,183,70,D/WB R,3,3,2,2,2,1,2,9,1,1,3,10,15,14,8,10,6,11,11,8,11,14,10,11,13,12,10,11,13,11,12,10,17,11,17,16,10,14,13,14,13,11,11,12,14,13,20,12,10,11,10,14,6,20,9,17,18,11,14,9,14,5,D/WB R,112,1,10,14,20,1,1,14,14,20,1,18,1,1,10,14,14,20,1,1,14,14,18,131074,0,1,0,0,0,0,0,0,0,0,0,0,0,0,0,0,0,1,0,0,0,0,0,0,0,0,0,0,0,0,0,0,0,0,0,0,0,0,0,0,0,0,0,0,0,0,0,0
29/6/2010,Luca Antonini,829394,776,8/4/1982,27,0,0,0,0,4500,7200,7200,148,143,200046902,182,70,D/WB RL,3,2,3,2,1,3,3,5,1,1,3,7,13,12,6,12,7,12,11,13,14,13,8,14,13,14,13,12,12,13,12,11,16,7,9,16,15,14,15,15,14,8,10,12,14,16,20,15,12,14,12,11,11,17,10,13,16,13,17,15,15,5,D/WB RL,115,1,8,1,20,1,1,20,11,17,1,18,1,8,5,1,20,17,1,11,9,18,15,1099511627840,0,0,0,0,0,0,1,0,0,0,0,0,0,0,0,0,0,0,0,0,0,0,0,0,0,0,0,0,0,0,0,0,0,0,0,0,0,0,0,0,1,0,0,0,0,0,0,0
29/6/2010,Lorenzo De Silvestri,1401054,776,5/23/1988,22,0,0,17,0,4000,7250,7250,170,143,49280148,185,78,D R,1,1,1,1,1,1,1,1,1,1,1,5,13,10,4,7,3,14,7,9,12,11,5,15,10,15,14,17,10,14,7,12,13,4,10,16,13,16,16,17,15,15,14,7,16,17,20,18,18,15,12,14,11,11,15,12,14,12,15,16,13,10,D R,102,1,1,1,20,1,1,1,1,20,1,15,1,1,1,1,10,20,1,1,1,1,15,1374390583296,0,0,0,0,0,0,0,0,0,0,0,0,0,0,0,0,0,0,0,0,1,0,0,0,0,0,0,0,0,0,0,0,0,0,0,0,0,0,1,0,1,0,0,0,0,0,0,0
29/6/2010,Loïc Perrin,8433507,769,8/7/1985,24,0,0,4,0,1400,5900,5900,150,132,2605077,180,76,D/WB/DM RC,3,3,2,1,2,3,3,4,3,3,2,6,12,10,6,12,7,14,13,9,11,13,7,13,12,11,14,15,14,14,11,14,14,7,14,8,14,14,17,13,11,13,10,8,9,12,20,13,13,15,11,14,16,15,5,13,17,13,16,15,15,5,D/WB/DM RC,123,1,10,16,20,16,1,1,15,20,1,18,1,1,10,12,1,20,15,1,14,1,18,256,0,0,0,0,0,0,0,0,1,0,0,0,0,0,0,0,0,0,0,0,0,0,0,0,0,0,0,0,0,0,0,0,0,0,0,0,0,0,0,0,0,0,0,0,0,0,0,0
29/6/2010,Loïc Abenzoar,8442417,769,2/14/1989,21,0,0,0,0,50,2600,2600,145,104,846062,182,74,D RC,2,2,1,2,1,1,1,1,1,1,2,5,7,7,5,10,6,14,7,6,12,7,6,9,10,11,12,14,12,12,7,11,10,6,10,7,11,11,14,16,9,13,11,5,13,13,20,14,13,14,11,10,11,10,11,11,14,12,9,9,10,20,D RC,103,1,1,20,20,1,1,1,1,15,1,15,1,1,1,20,1,15,1,1,1,1,15,0,0,0,0,0,0,0,0,0,0,0,0,0,0,0,0,0,0,0,0,0,0,0,0,0,0,0,0,0,0,0,0,0,0,0,0,0,0,0,0,0,0,0,0,0,0,0,0,0
29/6/2010,Lionn,2108018,1651,1/29/1989,21,0,0,0,0,1000,3400,4500,125,92,490742,183,72,D R,1,2,2,1,1,2,3,1,1,3,2,12,14,9,10,12,10,9,7,10,13,11,8,14,14,11,6,13,9,8,8,10,8,9,9,5,13,17,12,12,14,14,11,7,12,14,20,9,7,10,8,10,12,10,14,14,10,9,11,4,3,7,D R,102,1,1,1,20,1,1,1,1,20,1,12,1,1,1,1,4,20,1,1,1,1,12,0,0,0,0,0,0,0,0,0,0,0,0,0,0,0,0,0,0,0,0,0,0,0,0,0,0,0,0,0,0,0,0,0,0,0,0,0,0,0,0,0,0,0,0,0,0,0,0,0
29/6/2010,Lionel Scaloni,2000219,1649,5/16/1978,32,7,0,0,0,4096,6500,6250,153,128,688150,182,80,D R,2,3,2,3,1,3,3,9,1,1,3,11,12,10,6,13,10,11,12,15,10,13,8,15,13,15,11,15,11,11,13,12,15,12,6,14,14,17,17,14,13,7,10,10,13,12,20,14,13,10,13,10,12,14,11,18,10,8,14,10,6,10,D R,102,1,1,8,20,8,1,8,10,20,1,15,1,1,1,7,8,20,8,8,10,5,15,6597069897730,0,1,0,0,0,0,0,0,0,0,0,0,0,0,0,0,0,1,0,0,0,0,0,0,0,0,0,0,0,0,0,0,0,0,0,0,0,0,0,0,0,1,1,0,0,0,0,0
29/6/2010,Lillo,67065634,796,3/27/1989,21,0,0,0,0,2401,5390,5500,124,98,2047147,176,74,D R,2,3,2,1,3,1,1,1,3,3,2,7,7,5,4,7,4,7,6,10,13,9,7,12,7,17,12,15,10,13,6,12,10,7,10,6,11,12,13,11,12,9,8,9,12,10,20,13,10,10,11,10,12,10,14,9,17,7,10,8,12,5,D R,102,1,1,12,20,5,1,1,7,20,1,10,1,1,1,12,4,20,1,1,7,1,10,0,0,0,0,0,0,0,0,0,0,0,0,0,0,0,0,0,0,0,0,0,0,0,0,0,0,0,0,0,0,0,0,0,0,0,0,0,0,0,0,0,0,0,0,0,0,0,0,0
29/6/2010,Leonardo Ponzio,950349,1649,1/29/1982,28,7,0,0,0,4489,7000,6750,142,134,7999998,178,75,D/DM/M RC,1,1,1,2,2,3,3,3,3,1,3,10,11,9,7,11,12,6,17,12,12,12,12,15,12,16,15,17,10,13,9,11,16,9,13,11,12,17,19,14,12,13,8,9,15,12,20,17,12,16,13,13,6,17,13,14,14,14,17,17,15,8,D/DM/M RC,333,1,4,20,17,20,1,12,16,17,13,11,4,1,4,10,12,17,16,10,15,6,11,44117904065024,0,0,0,0,0,0,0,0,0,1,0,0,0,0,0,0,0,0,0,0,0,0,0,0,0,0,0,0,0,0,0,0,0,0,0,0,0,1,0,0,0,0,0,1,0,1,0,0
29/6/2010,Laurent Bonnart,3502431,769,12/25/1979,30,0,0,0,0,5150,6479,6450,146,144,9427873,171,62,D/WB RL,3,1,2,1,3,3,3,1,2,1,2,10,12,9,5,11,6,8,7,14,13,11,10,14,11,12,14,15,14,15,8,14,16,6,15,10,15,16,17,13,12,12,5,16,16,14,20,18,8,17,7,14,5,14,16,14,15,16,18,17,17,6,D/WB RL,115,1,1,1,20,1,1,16,1,20,1,18,1,1,1,1,16,20,1,1,1,16,18,536870944,0,0,0,0,0,1,0,0,0,0,0,0,0,0,0,0,0,0,0,0,0,0,0,0,0,0,0,0,0,1,0,0,0,0,0,0,0,0,0,0,0,0,0,0,0,0,0,0
29/6/2010,Laure,67013448,796,3/22/1985,25,0,0,0,0,4225,6500,6500,142,130,3719407,171,66,D R,1,1,3,2,2,2,2,8,3,1,3,10,13,9,4,10,7,8,8,9,13,12,7,13,9,16,12,16,9,15,7,11,16,7,8,10,11,14,16,14,13,14,7,12,13,15,20,17,12,10,15,14,7,10,8,15,18,1,12,11,6,8,D R,102,1,1,6,20,1,1,9,9,20,1,15,1,1,1,6,9,20,1,2,9,9,15,32802,0,1,0,0,0,1,0,0,0,0,0,0,0,0,0,1,0,0,0,0,0,0,0,0,0,0,0,0,0,0,0,0,0,0,0,0,0,0,0,0,0,0,0,0,0,0,0,0
29/6/2010,Lassana Diarra,8434283,769,3/10/1985,25,27,0,18,0,6084,7750,7500,166,156,166098613,172,73,DM/M RC,1,1,2,3,1,3,3,2,3,3,3,11,10,12,6,13,9,8,10,12,12,15,6,16,13,16,14,16,12,17,11,13,19,8,8,12,14,19,17,15,15,16,7,12,18,13,20,19,13,19,13,16,4,16,17,15,9,17,14,14,18,14,DM/M RC,313,1,8,20,15,20,1,1,19,15,1,12,8,1,6,1,1,15,19,1,13,1,12,137438953536,0,0,0,0,0,0,1,0,0,0,0,0,0,0,0,0,0,0,0,0,0,0,0,0,0,0,0,0,0,0,0,0,0,0,0,0,0,1,0,0,0,0,0,0,0,0,0,0
29/6/2010,Lars Jacobsen,3400857,764,9/20/1979,30,36,0,26,0,4032,6750,6400,142,127,8440859,181,78,D R,2,1,2,1,2,1,1,1,2,1,3,13,14,8,4,13,6,9,4,16,14,13,15,13,11,9,12,10,13,14,9,12,13,6,14,11,14,16,14,12,10,14,10,10,16,12,20,15,14,14,11,15,15,15,14,13,14,13,17,13,13,10,D R,102,1,1,7,20,4,1,13,1,20,5,15,1,1,1,7,13,20,1,1,1,9,15,32,0,0,0,0,0,1,0,0,0,0,0,0,0,0,0,0,0,0,0,0,0,0,0,0,0,0,0,0,0,0,0,0,0,0,0,0,0,0,0,0,0,0,0,0,0,0,0,0
29/6/2010,Larrys Mabiala,8444104,53,10/8/1987,22,8,0,0,0,3306,6000,5150,140,115,1563462,189,84,D RC,3,2,3,1,1,2,1,5,1,1,3,6,10,7,6,9,8,15,11,8,13,8,6,14,9,10,13,14,11,11,7,11,14,7,7,7,12,13,14,8,11,16,14,10,10,11,20,14,16,12,10,13,14,8,11,13,14,9,12,15,15,7,D RC,103,5,1,20,20,1,1,1,1,15,1,1,1,1,1,20,1,15,1,1,1,1,1,0,0,0,0,0,0,0,0,0,0,0,0,0,0,0,0,0,0,0,0,0,0,0,0,0,0,0,0,0,0,0,0,0,0,0,0,0,0,0,0,0,0,0,0,0,0,0,0,0
29/6/2010,Lamine Koné,34000665,769,2/1/1989,21,0,0,3,0,2500,3800,3800,150,116,2932393,186,83,D RC,2,2,1,1,2,2,2,3,1,1,2,5,7,8,6,9,6,14,8,6,14,8,6,11,9,14,14,15,13,13,6,12,14,8,9,9,13,13,14,11,9,16,14,20,13,13,8,16,16,14,14,14,10,8,5,13,14,13,15,15,15,6,D RC,103,1,1,18,20,1,1,14,1,20,1,14,1,1,1,18,14,20,1,1,1,14,14,32,0,0,0,0,0,1,0,0,0,0,0,0,0,0,0,0,0,0,0,0,0,0,0,0,0,0,0,0,0,0,0,0,0,0,0,0,0,0,0,0,0,0,0,0,0,0,0,0
29/6/2010,Lamine Gassama,34011685,769,10/20/1989,20,0,0,3,0,1300,5309,5250,160,118,8038438,181,74,D/WB R,3,2,1,2,2,3,3,4,2,1,1,8,12,8,6,10,7,10,9,12,12,8,7,13,10,12,13,13,12,12,8,12,14,8,8,11,9,12,14,17,12,13,10,7,14,15,20,15,13,13,12,14,6,10,11,16,12,13,16,15,15,6,D/WB R,112,1,1,10,20,1,1,12,1,20,1,18,1,1,1,10,12,20,1,1,1,12,18,0,0,0,0,0,0,0,0,0,0,0,0,0,0,0,0,0,0,0,0,0,0,0,0,0,0,0,0,0,0,0,0,0,0,0,0,0,0,0,0,0,0,0,0,0,0,0,0,0
29/6/2010,Kyle Naughton,152937,765,11/11/1988,21,0,0,6,0,3250,6150,6150,142,126,27520005,180,73,D RL,1,2,2,3,3,3,1,1,3,1,3,7,12,9,5,10,3,12,5,14,14,11,8,13,13,10,12,13,13,8,8,11,9,8,12,14,12,15,14,14,14,13,11,12,18,16,20,12,10,12,4,13,6,15,9,16,12,6,15,16,11,4,D RL,105,7,1,10,20,1,1,15,13,20,1,15,1,1,1,1,15,20,10,10,13,12,15,0,0,0,0,0,0,0,0,0,0,0,0,0,0,0,0,0,0,0,0,0,0,0,0,0,0,0,0,0,0,0,0,0,0,0,0,0,0,0,0,0,0,0,0,0,0,0,0,0
29/6/2010,Kolo Touré,5370564,24,3/19/1981,29,84,3,0,0,5550,8195,7450,165,149,59845046,183,77,D RC,1,1,2,1,1,2,2,9,2,3,2,4,11,11,8,10,12,15,12,6,15,12,9,15,13,14,13,18,13,13,12,13,18,10,14,8,14,16,16,16,12,12,12,10,13,15,20,15,15,13,7,15,6,15,18,15,15,16,17,17,16,9,D RC,103,1,1,20,20,12,1,1,10,15,1,12,1,1,1,20,1,15,10,1,10,1,12,35184372089124,0,0,1,0,0,1,0,0,1,0,0,0,0,0,0,0,0,0,0,0,0,0,0,0,0,0,0,0,0,0,0,0,0,0,0,0,0,0,0,0,0,0,0,0,0,1,0,0
29/6/2010,Khalid Boulahrouz,854399,784,12/28/1981,28,31,0,0,0,4830,7645,6900,162,139,8652118,183,74,D RC,3,2,2,1,1,3,3,1,2,1,2,5,8,5,4,10,6,14,6,15,18,8,10,18,9,19,14,19,8,10,7,9,17,12,14,5,16,17,17,15,10,16,13,8,17,13,20,15,15,15,18,17,11,11,14,19,7,16,10,5,8,15,D RC,103,1,1,20,20,10,1,1,1,16,1,1,1,1,1,20,1,16,1,1,1,1,1,137438986240,0,0,0,0,0,0,0,0,0,0,0,0,0,0,0,1,0,0,0,0,0,0,0,0,0,0,0,0,0,0,0,0,0,0,0,0,0,1,0,0,0,0,0,0,0,0,0,0
29/6/2010,Kevin Foley,5107874,789,11/1/1984,25,2,0,9,1,4000,6250,6400,136,127,5069382,176,70,D/WB R,3,1,1,1,3,2,2,3,1,3,3,8,13,12,8,14,10,13,4,12,14,13,10,14,13,6,12,10,15,14,11,12,14,6,9,12,14,11,12,13,10,12,10,9,14,12,20,14,11,18,3,12,5,14,16,14,17,12,12,13,17,7,D/WB R,112,1,1,14,20,10,1,1,15,20,1,18,1,1,1,1,12,20,14,1,15,1,18,32,0,0,0,0,0,1,0,0,0,0,0,0,0,0,0,0,0,0,0,0,0,0,0,0,0,0,0,0,0,0,0,0,0,0,0,0,0,0,0,0,0,0,0,0,0,0,0,0
29/6/2010,Kelvin Maynard,37002597,784,5/29/1987,23,0,0,0,0,2600,4750,4750,121,104,907453,180,83,D/WB R,3,3,2,1,1,1,3,2,1,2,2,7,10,6,4,12,4,3,2,6,11,11,5,11,14,13,11,14,11,9,12,11,10,4,7,8,12,13,13,12,13,13,11,15,11,12,20,12,12,10,5,10,12,10,9,3,20,5,6,12,12,14,D/WB R,112,1,1,10,20,10,1,1,10,20,1,17,1,1,1,10,13,20,10,1,9,1,17,0,0,0,0,0,0,0,0,0,0,0,0,0,0,0,0,0,0,0,0,0,0,0,0,0,0,0,0,0,0,0,0,0,0,0,0,0,0,0,0,0,0,0,0,0,0,0,0,0
29/6/2010,Jurij Krause,8708266,771,5/28/1984,26,0,0,0,0,750,3250,3250,100,78,81146,183,73,D R,1,1,2,3,1,1,3,3,3,3,3,12,6,14,14,5,4,11,11,8,6,15,14,11,13,8,7,9,5,6,15,11,10,14,14,12,7,12,14,12,13,7,12,4,12,14,20,11,9,7,1,1,11,10,9,5,13,13,12,8,12,7,D R,102,1,1,14,20,1,1,1,1,20,14,14,1,1,1,14,11,20,1,1,1,1,14,0,0,0,0,0,0,0,0,0,0,0,0,0,0,0,0,0,0,0,0,0,0,0,0,0,0,0,0,0,0,0,0,0,0,0,0,0,0,0,0,0,0,0,0,0,0,0,0,0
29/6/2010,Juri Judt,8718376,771,7/24/1986,23,0,0,4,0,2500,5900,5900,129,117,4563354,173,67,D/DM/M RC,2,3,2,3,1,1,3,8,2,3,2,10,12,10,6,11,8,12,9,9,13,11,8,14,10,14,11,16,12,14,8,13,14,10,9,9,11,14,16,12,12,15,9,7,15,12,20,15,13,14,13,13,13,15,13,14,11,14,16,15,14,6,D/DM/M RC,333,1,4,20,17,20,1,1,17,17,1,14,4,1,1,1,1,17,17,1,11,1,14,140883550797824,0,0,0,0,0,0,0,0,0,0,0,0,0,0,0,0,0,0,0,0,0,0,0,0,0,1,0,0,0,0,0,0,0,1,0,0,0,1,0,0,0,0,0,0,0,0,0,1
29/6/2010,Jurado,67044755,796,3/14/1990,20,0,0,0,0,1806,4000,4000,125,85,1375851,173,61,D/WB/M R,3,3,3,1,1,3,3,1,1,3,1,9,13,11,9,13,8,7,9,6,9,8,3,9,13,17,10,8,9,7,10,7,7,15,6,7,11,13,10,11,13,13,4,10,16,13,20,8,6,10,8,10,10,8,10,14,14,7,15,11,10,10,D/WB/M R,122,1,14,14,20,1,1,1,17,20,1,18,12,1,14,1,1,20,14,1,17,1,18,0,0,0,0,0,0,0,0,0,0,0,0,0,0,0,0,0,0,0,0,0,0,0,0,0,0,0,0,0,0,0,0,0,0,0,0,0,0,0,0,0,0,0,0,0,0,0,0,0
29/6/2010,Juanra,823367,796,4/24/1980,30,0,0,0,0,3844,5350,5350,134,124,5396228,183,78,D/WB R,1,3,3,2,2,2,2,3,3,3,3,8,15,10,6,12,4,14,7,14,12,13,4,14,11,12,15,9,10,11,10,9,16,4,10,14,13,15,18,15,12,9,12,4,14,15,20,18,13,16,14,14,10,17,9,15,15,10,14,13,16,5,D/WB R,112,1,1,8,20,1,1,12,12,20,1,18,1,1,1,8,12,20,1,1,12,12,18,0,0,0,0,0,0,0,0,0,0,0,0,0,0,0,0,0,0,0,0,0,0,0,0,0,0,0,0,0,0,0,0,0,0,0,0,0,0,0,0,0,0,0,0,0,0,0,0,0
29/6/2010,Juanma Ortiz,824372,796,3/1/1982,28,0,0,0,0,4556,6250,6250,141,135,4574857,179,72,D/WB/M/AM R,1,3,2,3,1,2,1,1,3,3,3,12,12,11,13,11,12,12,12,5,9,14,11,8,12,14,12,14,9,13,12,13,12,13,10,15,12,17,17,14,13,11,10,10,13,15,20,14,11,13,14,9,10,15,12,9,6,7,13,8,8,4,D/WB/M/AM R,442,1,20,14,17,1,1,1,20,20,1,17,14,1,20,1,1,17,5,1,20,1,17,0,0,0,0,0,0,0,0,0,0,0,0,0,0,0,0,0,0,0,0,0,0,0,0,0,0,0,0,0,0,0,0,0,0,0,0,0,0,0,0,0,0,0,0,0,0,0,0,0
29/6/2010,Juan Valera,7456608,796,12/21/1984,25,0,0,1,0,4422,6500,6500,141,133,4999732,184,70,D/WB/M R,3,1,1,3,3,2,1,6,2,1,3,12,12,11,11,11,10,15,11,14,12,11,11,13,11,12,13,14,12,13,11,12,12,11,12,12,12,14,14,15,13,14,12,5,13,15,20,15,14,11,8,13,11,14,15,14,12,12,13,13,12,7,D/WB/M R,232,1,8,1,18,1,1,1,16,20,1,20,1,1,8,1,1,18,1,1,16,1,20,141837134200834,0,1,0,0,0,0,0,0,0,0,0,0,0,0,0,0,0,0,0,0,0,0,0,0,0,0,0,1,0,0,0,0,0,0,0,0,0,0,0,0,1,0,0,0,0,0,0,1
29/6/2010,Juan Guillermo Cuadrado,76010707,1653,5/26/1988,22,0,0,0,0,2750,6200,6150,145,124,4762371,176,66,WB/M R,1,1,1,2,2,3,3,3,3,1,1,9,12,14,7,12,14,10,15,12,9,12,8,10,14,10,12,13,11,10,13,10,13,14,8,13,8,13,14,15,14,9,9,11,15,14,20,14,8,11,9,15,8,13,12,12,15,13,13,14,14,7,WB/M R,212,1,15,5,15,1,1,1,19,20,1,20,1,1,15,1,1,15,5,1,19,1,20,35184372089344,0,0,0,0,0,0,0,0,0,1,0,0,0,0,0,0,0,0,0,0,0,0,0,0,0,0,0,0,0,0,0,0,0,0,0,0,0,0,0,0,0,0,0,0,0,1,0,0
29/6/2010,José Bosingwa,741143,788,8/24/1982,27,23,0,18,0,6006,7750,7500,162,155,8658774,183,72,D R,2,3,1,2,3,2,3,3,2,2,3,9,14,14,7,14,9,11,11,13,12,12,11,13,16,14,11,13,14,12,13,12,13,12,10,17,13,12,17,18,16,13,12,12,17,18,20,13,12,12,8,11,8,15,13,12,15,11,14,16,16,6,D R,102,1,10,12,20,12,1,12,12,20,1,14,1,1,10,1,12,20,10,1,12,1,14,70368879444002,0,1,0,0,0,1,0,0,0,0,0,0,0,0,0,0,0,0,0,0,1,0,0,0,0,0,0,1,0,0,0,0,0,0,0,0,0,0,0,0,0,0,0,0,0,0,1,0
29/6/2010,Jorge Fucile,8829824,1657,11/19/1984,25,28,0,0,0,3500,7850,7150,158,143,44667850,177,73,D RL,3,3,1,2,3,2,3,6,2,3,3,11,12,11,8,14,11,9,12,15,13,11,11,15,13,16,12,14,13,12,11,13,15,11,11,14,12,13,15,15,14,12,10,13,14,14,20,14,12,15,11,14,12,13,14,13,15,17,14,12,12,5,D RL,105,1,1,1,20,1,1,15,8,20,1,13,1,1,1,1,15,20,1,1,8,5,13,549755813923,1,1,0,0,0,1,0,0,0,0,0,0,0,0,0,0,0,0,0,0,0,0,0,0,0,0,0,0,0,0,0,0,0,0,0,0,0,0,0,1,0,0,0,0,0,0,0,0
29/6/2010,Jordan Lotiès,8427417,769,8/5/1984,25,0,0,0,0,3844,5550,5550,138,124,3166983,190,82,D/DM RC,2,1,2,2,3,1,2,5,1,3,2,5,8,8,6,9,10,14,13,8,13,11,7,12,9,14,15,14,13,11,9,12,13,7,9,9,14,13,14,15,9,15,15,5,17,13,20,15,15,13,14,14,5,11,11,13,14,14,14,13,13,10,D/DM RC,113,1,1,20,20,17,1,1,15,15,1,15,1,1,1,20,1,15,15,1,1,1,15,33024,0,0,0,0,0,0,0,0,1,0,0,0,0,0,0,1,0,0,0,0,0,0,0,0,0,0,0,0,0,0,0,0,0,0,0,0,0,0,0,0,0,0,0,0,0,0,0,0
29/6/2010,Jonathan Zebina,400507,769,7/19/1978,31,1,0,0,0,4692,6500,7300,163,137,9828801,189,86,D/WB R,1,1,1,1,1,1,1,1,1,1,1,6,13,14,7,13,9,14,12,16,14,13,8,14,15,16,16,15,11,11,11,11,15,6,9,14,14,14,14,14,13,18,14,8,2,13,20,14,14,11,15,13,20,13,14,14,10,9,9,14,5,15,D/WB R,112,1,1,14,20,1,1,8,6,20,7,17,1,1,1,14,8,20,1,1,6,8,17,34,0,1,0,0,0,1,0,0,0,0,0,0,0,0,0,0,0,0,0,0,0,0,0,0,0,0,0,0,0,0,0,0,0,0,0,0,0,0,0,0,0,0,0,0,0,0,0,0
29/6/2010,Jonathan Spector,979165,390,3/1/1986,24,26,0,0,0,3906,6150,6050,136,125,2360231,186,80,D RLC,1,1,1,1,1,1,1,1,1,1,1,3,8,7,10,12,4,12,9,8,14,11,6,14,13,15,12,15,10,12,8,12,15,12,11,11,12,13,12,15,12,14,12,8,13,14,20,13,12,13,12,13,5,15,15,18,14,14,15,12,13,8,D RLC,106,6,6,15,20,12,1,15,10,20,1,12,6,1,1,15,15,20,10,1,1,8,12,4294967300,0,0,1,0,0,0,0,0,0,0,0,0,0,0,0,0,0,0,0,0,0,0,0,0,0,0,0,0,0,0,0,0,1,0,0,0,0,0,0,0,0,0,0,0,0,0,0,0
29/6/2010,John Pantsil,7861479,21,6/15/1981,29,61,0,0,0,4556,6500,6650,135,135,9144321,178,69,D R,1,3,3,3,3,3,3,6,3,1,2,8,13,13,8,13,8,13,7,15,14,13,8,13,14,11,10,15,15,11,12,14,18,11,11,14,11,14,15,14,10,11,11,12,16,14,20,14,13,12,13,13,5,14,14,14,10,15,12,14,13,10,D R,102,1,1,1,20,1,1,1,10,20,1,10,1,1,1,1,4,20,1,1,10,1,10,2336462209024,0,0,0,0,0,0,0,0,0,0,0,0,0,0,0,0,0,0,0,0,0,0,0,0,0,0,0,0,0,0,0,0,0,0,0,0,0,1,0,0,0,1,0,0,0,0,0,0
29/6/2010,John O'Shea,125120,789,4/30/1981,29,62,1,6,0,5184,7500,7500,145,144,25770181,191,75,D RLC,3,2,2,1,3,1,1,8,1,3,1,5,11,7,10,12,4,16,4,13,16,10,10,14,12,9,13,9,12,15,7,14,13,9,10,12,15,16,14,11,11,15,16,14,13,12,20,15,16,18,3,11,4,19,7,12,18,14,17,17,19,2,D RLC,106,5,1,17,20,10,5,17,8,20,1,10,1,1,1,17,17,20,8,1,1,9,10,274877907008,0,0,0,0,0,0,1,0,0,0,0,0,0,0,0,0,0,0,0,0,0,0,0,0,0,0,0,0,0,0,0,0,0,0,0,0,0,0,1,0,0,0,0,0,0,0,0,0
29/6/2010,John Heitinga,850009,784,11/15/1983,26,61,6,0,0,5550,7750,7250,160,149,13800000,183,75,D/DM RC,1,3,3,3,3,1,1,5,1,2,1,8,13,11,7,12,7,16,12,10,14,14,13,16,12,17,15,15,12,12,12,12,16,11,16,12,14,14,16,13,15,15,11,15,14,12,20,14,14,14,17,12,13,15,8,15,17,13,16,14,12,4,D/DM RC,113,1,1,20,20,16,1,6,15,19,17,14,1,1,1,20,6,19,15,1,7,6,14,8933531975680,0,0,0,0,0,0,0,0,0,0,0,0,0,0,0,0,0,0,0,0,0,0,0,0,0,0,0,0,0,0,0,0,0,0,0,0,0,1,0,0,0,0,0,1,0,0,0,0
29/6/2010,João Pereira,742580,788,2/25/1984,26,0,0,23,1,4000,6750,6750,145,135,38007584,172,64,D R,1,1,3,1,1,1,3,6,1,1,3,12,13,12,10,13,8,8,11,17,11,11,11,14,13,17,14,16,9,13,11,12,17,12,12,17,12,14,17,17,16,9,8,7,12,15,20,11,9,12,13,10,6,12,12,14,15,15,13,11,11,9,D R,102,1,13,1,20,1,1,1,10,20,1,10,1,1,13,1,1,20,1,1,10,1,10,137707585538,0,1,0,0,0,0,0,0,0,0,0,0,0,0,0,0,1,1,0,0,0,0,0,0,0,0,0,0,1,0,0,0,0,0,0,0,0,1,0,0,0,0,0,0,0,0,0,0
29/6/2010,João Gonçalves,55003168,788,1/18/1988,22,0,0,8,0,2000,5500,5500,145,110,179710,180,73,D R,1,3,1,2,1,3,3,1,1,3,2,11,12,10,8,12,10,10,10,12,11,10,12,13,12,12,12,12,12,12,11,11,12,9,10,14,12,12,12,12,12,12,11,8,12,12,20,12,12,13,8,10,11,10,6,11,15,13,14,15,15,5,D R,102,1,1,10,20,10,1,5,10,20,1,10,1,1,1,1,5,20,10,1,10,1,10,0,0,0,0,0,0,0,0,0,0,0,0,0,0,0,0,0,0,0,0,0,0,0,0,0,0,0,0,0,0,0,0,0,0,0,0,0,0,0,0,0,0,0,0,0,0,0,0,0
29/6/2010,Jesús Gámez,1501035,796,4/10/1985,25,0,0,4,2,5256,7250,7250,157,145,12969412,182,70,D/WB RC,3,2,2,1,3,3,2,2,1,1,1,3,13,9,5,13,4,13,6,14,13,13,7,14,14,14,13,15,14,13,11,12,12,6,18,15,13,14,14,14,14,14,12,11,15,13,20,14,14,17,8,14,8,8,8,16,15,11,12,12,8,5,D/WB RC,113,1,1,18,20,1,1,1,12,20,1,17,1,1,1,18,1,20,1,1,12,1,17,8933531975712,0,0,0,0,0,1,0,0,0,0,0,0,0,0,0,0,0,0,0,0,0,0,0,0,0,0,0,0,0,0,0,0,0,0,0,0,0,1,0,0,0,0,0,1,0,0,0,0
29/6/2010,Jerry Vandam,8440118,769,12/8/1988,21,0,0,0,0,3600,5400,5400,145,120,5167000,186,77,D R,3,2,1,2,3,2,3,1,1,3,2,6,13,9,5,9,7,13,8,10,13,10,7,12,11,8,14,14,12,12,11,11,12,7,9,9,12,13,16,15,10,14,13,5,15,14,20,16,14,14,8,13,5,10,9,12,16,13,11,15,15,6,D R,102,1,1,13,20,13,1,1,10,20,1,15,1,1,1,1,1,20,10,1,1,1,15,0,0,0,0,0,0,0,0,0,0,0,0,0,0,0,0,0,0,0,0,0,0,0,0,0,0,0,0,0,0,0,0,0,0,0,0,0,0,0,0,0,0,0,0,0,0,0,0,0
29/6/2010,Jérôme Boateng,35002579,771,9/3/1988,21,10,0,15,1,4750,7200,7200,174,144,34339299,192,90,D/WB RLC,3,2,1,1,1,3,2,3,3,3,2,9,15,11,4,15,6,8,9,18,12,13,8,12,14,6,14,10,17,6,15,13,9,11,10,4,12,13,4,12,11,15,17,18,10,18,20,12,17,8,6,14,7,20,12,13,5,14,10,12,8,11,D/WB RLC,116,3,10,20,20,12,1,17,13,19,1,17,1,10,10,20,17,19,12,13,13,15,17,149812754251904,0,0,0,0,0,0,0,1,0,0,0,0,0,0,0,0,0,0,0,0,0,0,0,0,0,0,0,0,0,0,0,0,1,0,0,0,0,0,1,0,0,0,0,1,0,0,0,1
29/6/2010,Jérémy Sorbon,8440046,769,8/5/1983,26,0,0,0,0,4160,5800,5800,140,129,2534904,183,79,D RC,2,3,3,2,2,3,1,1,1,3,2,5,8,6,8,9,7,15,7,11,16,10,7,14,9,11,15,14,15,14,9,13,16,6,12,8,15,13,15,11,11,16,11,5,16,10,20,16,16,13,11,12,5,10,19,15,14,13,17,14,14,5,D RC,103,1,1,20,20,10,1,1,1,18,1,12,1,1,1,20,1,18,1,1,1,1,12,0,0,0,0,0,0,0,0,0,0,0,0,0,0,0,0,0,0,0,0,0,0,0,0,0,0,0,0,0,0,0,0,0,0,0,0,0,0,0,0,0,0,0,0,0,0,0,0,0
29/6/2010,Jean-Joël Perrier-Doumbé,3503491,11,9/27/1978,31,20,0,0,0,3050,5400,5400,134,120,9067800,180,74,D/WB R,2,2,2,1,1,3,1,1,3,2,3,6,12,9,6,8,8,13,11,11,13,13,6,13,9,14,14,14,12,12,7,11,16,7,11,8,13,15,15,14,11,14,10,10,12,13,20,13,14,13,14,13,9,12,12,12,14,16,14,14,14,5,D/WB R,112,1,1,10,20,1,1,14,1,20,1,16,1,1,1,10,14,20,1,1,1,14,16,0,0,0,0,0,0,0,0,0,0,0,0,0,0,0,0,0,0,0,0,0,0,0,0,0,0,0,0,0,0,0,0,0,0,0,0,0,0,0,0,0,0,0,0,0,0,0,0,0
29/6/2010,Javier Zanetti,7931,1649,8/10/1973,36,136,5,6,0,6972,7750,8200,179,167,2384121,178,75,D/WB/M RLC,1,1,1,1,1,1,1,1,1,1,1,7,11,15,5,10,4,7,9,10,14,12,7,15,13,14,15,16,14,16,10,16,18,10,19,11,15,18,19,15,15,19,7,10,19,14,20,19,17,20,8,17,2,19,19,14,20,15,20,19,18,5,D/WB/M RLC,126,1,1,18,20,14,1,17,18,20,1,18,1,1,1,1,17,20,18,11,14,15,18,88240371531776,0,0,0,0,0,0,0,0,0,0,0,0,0,0,0,0,0,0,0,0,0,0,0,0,0,0,0,0,1,0,0,0,1,0,0,0,0,0,1,0,0,0,0,0,1,0,1,0
29/6/2010,Javi Venta,4211496,796,12/13/1975,34,0,0,0,0,4356,6600,6600,142,132,714413,181,74,D/WB R,1,1,2,3,2,2,3,1,2,1,2,15,15,13,4,13,8,10,6,15,12,13,7,14,11,13,13,17,14,15,12,14,13,12,12,15,12,15,16,10,11,12,10,12,16,13,20,14,9,16,7,15,8,13,12,14,17,13,15,12,9,8,D/WB R,112,1,1,7,20,3,1,4,11,20,9,19,1,1,1,7,4,20,1,1,11,3,19,32,0,0,0,0,0,1,0,0,0,0,0,0,0,0,0,0,0,0,0,0,0,0,0,0,0,0,0,0,0,0,0,0,0,0,0,0,0,0,0,0,0,0,0,0,0,0,0,0
29/6/2010,Jamie Carragher,2003693,765,1/28/1978,32,38,0,27,1,5476,7800,7800,168,148,3076456,186,78,D RC,2,1,2,1,2,1,2,6,3,2,2,3,7,5,2,11,5,16,3,12,15,11,13,16,12,15,16,20,15,16,7,14,19,2,17,6,14,16,18,10,9,14,13,12,19,10,20,15,18,17,8,17,2,17,5,15,19,15,20,10,14,5,D RC,103,1,1,20,20,10,1,14,1,16,1,1,1,1,1,20,14,16,1,1,1,1,1,281475312386048,0,0,0,0,0,0,0,0,0,0,0,0,0,0,0,0,0,1,0,0,0,0,0,0,0,0,1,0,1,0,0,0,0,0,0,0,0,0,0,0,0,0,0,0,0,0,0,0
29/6/2010,Jacques Faty,144182,41,2/25/1984,26,3,0,0,0,3969,6300,5650,135,126,3093794,183,75,D RC,2,2,3,2,2,3,3,5,1,2,2,5,9,7,7,11,6,15,8,11,14,9,10,14,11,13,14,14,11,11,7,12,13,8,13,7,13,14,13,13,12,15,12,8,13,12,20,16,14,13,13,14,9,8,12,16,12,9,14,14,15,10,D RC,103,1,1,20,20,12,1,1,1,15,1,15,1,1,1,20,1,15,1,1,1,1,15,32768,0,0,0,0,0,0,0,0,0,0,0,0,0,0,0,1,0,0,0,0,0,0,0,0,0,0,0,0,0,0,0,0,0,0,0,0,0,0,0,0,0,0,0,0,0,0,0,0
29/6/2010,Igor Lolo,8626845,24,7/22/1982,27,9,0,1,0,3600,6029,6000,140,134,3759444,180,77,D/WB RC,2,3,3,2,3,1,3,1,2,3,3,10,15,12,7,12,10,14,11,11,12,12,7,14,14,18,14,13,11,11,12,11,14,12,10,12,11,14,15,14,13,14,10,12,15,13,20,13,14,14,18,8,8,10,11,13,14,14,11,13,15,7,D/WB RC,113,1,1,16,20,12,1,1,1,20,1,18,1,1,1,16,11,20,1,1,1,1,18,65696,0,0,0,0,0,1,0,1,0,0,0,0,0,0,0,0,1,0,0,0,0,0,0,0,0,0,0,0,0,0,0,0,0,0,0,0,0,0,0,0,0,0,0,0,0,0,0,0
29/6/2010,Ignazio Abate,7983987,776,11/12/1986,23,0,0,19,2,4000,6850,6850,154,138,155002075,180,73,WB/M/AM R,3,2,1,3,3,2,1,8,3,3,1,9,13,14,7,13,8,11,9,12,13,13,8,11,12,15,14,13,11,11,9,11,14,12,7,18,13,14,15,17,17,13,9,8,12,16,20,14,12,12,10,9,11,15,10,15,16,12,17,15,14,7,WB/M/AM R,432,1,18,7,14,1,1,1,20,20,1,16,1,1,18,1,1,14,7,1,20,1,16,1099511627810,0,1,0,0,0,1,0,0,0,0,0,0,0,0,0,0,0,0,0,0,0,0,0,0,0,0,0,0,0,0,0,0,0,0,0,0,0,0,0,0,1,0,0,0,0,0,0,0
29/6/2010,Ibrahim Kas,8491444,799,9/20/1986,23,7,0,7,0,3600,6000,5650,135,120,1516368,185,79,D RC,1,1,2,3,3,3,1,3,3,3,1,7,9,8,7,11,8,14,8,6,13,8,5,14,11,16,11,17,11,10,6,9,14,5,11,11,11,14,17,14,13,12,12,10,12,14,20,14,14,11,17,6,8,10,8,5,5,13,13,4,3,15,D RC,103,1,1,20,20,1,1,1,1,15,10,1,1,1,1,20,1,15,1,1,1,1,1,65536,0,0,0,0,0,0,0,0,0,0,0,0,0,0,0,0,1,0,0,0,0,0,0,0,0,0,0,0,0,0,0,0,0,0,0,0,0,0,0,0,0,0,0,0,0,0,0,0
29/6/2010,Hugo Gomes,7005117,788,10/11/1979,30,0,0,0,0,750,4900,4900,105,98,329337,174,73,D R,2,3,1,1,1,1,2,1,1,3,2,10,11,10,7,11,10,10,10,10,11,10,10,12,11,11,10,10,12,12,9,11,12,6,8,11,11,12,11,11,12,11,11,5,12,11,20,11,11,11,10,2,9,12,11,10,13,12,13,13,13,5,D R,102,1,1,1,20,1,1,10,10,20,1,12,1,1,1,1,10,20,1,10,10,10,12,0,0,0,0,0,0,0,0,0,0,0,0,0,0,0,0,0,0,0,0,0,0,0,0,0,0,0,0,0,0,0,0,0,0,0,0,0,0,0,0,0,0,0,0,0,0,0,0,0
29/6/2010,Hugo Campagnaro,6300344,1649,6/27/1980,30,0,0,0,0,2750,6479,7250,154,144,20108977,180,85,D RC,2,1,1,1,3,1,3,3,1,3,2,7,6,15,10,10,8,12,7,12,11,10,10,17,14,17,16,20,12,13,12,14,15,8,14,14,13,16,15,15,15,11,12,5,13,13,20,11,16,14,12,13,18,16,10,10,16,8,12,5,6,6,D RC,103,1,1,20,20,12,1,1,1,20,1,15,1,1,1,20,5,20,1,1,1,1,15,8,0,0,0,1,0,0,0,0,0,0,0,0,0,0,0,0,0,0,0,0,0,0,0,0,0,0,0,0,0,0,0,0,0,0,0,0,0,0,0,0,0,0,0,0,0,0,0,0
29/6/2010,Hernán Pellerano,956747,1649,6/4/1984,26,0,0,0,0,3500,6250,6250,148,137,2742351,183,72,D RC,3,3,1,1,1,3,1,3,2,1,3,4,6,7,2,10,3,17,6,8,15,9,5,16,8,16,12,15,13,15,6,12,16,5,13,8,11,14,13,15,13,15,12,8,15,15,20,14,15,13,9,15,6,11,14,13,15,16,15,15,11,12,D RC,103,1,1,20,20,1,1,1,1,15,10,1,1,1,1,20,1,15,1,1,1,1,1,137438953472,0,0,0,0,0,0,0,0,0,0,0,0,0,0,0,0,0,0,0,0,0,0,0,0,0,0,0,0,0,0,0,0,0,0,0,0,0,1,0,0,0,0,0,0,0,0,0,0
29/6/2010,Heiko Westermann,885406,771,8/14/1983,26,18,2,2,0,5700,7400,7400,154,151,16932498,190,80,D/M RLC,1,3,2,1,3,3,2,5,2,2,1,6,9,8,15,7,10,17,11,14,12,8,6,13,7,15,9,17,13,16,9,12,18,5,15,15,10,18,17,14,9,15,17,17,18,16,20,18,17,16,3,17,6,18,5,14,18,13,20,18,13,3,D/M RLC,116,5,1,20,20,14,1,16,16,18,1,14,1,1,1,20,16,18,16,1,1,12,14,274877907490,0,1,0,0,0,1,0,0,0,1,0,0,0,0,0,0,0,0,0,0,0,0,0,0,0,0,0,0,0,0,0,0,0,0,0,0,0,0,1,0,0,0,0,0,0,0,0,0
29/6/2010,Hasan Salihamidzic,7178,759,1/1/1977,33,42,6,1,1,4761,6250,7150,159,138,1712534,180,77,D/WB/M RL,1,2,3,1,3,1,1,3,2,2,3,12,12,12,12,12,8,10,8,17,12,13,17,12,11,16,15,16,13,12,11,13,16,12,14,11,15,16,15,13,13,12,8,14,13,12,20,14,10,14,10,16,14,20,18,18,15,13,16,10,9,15,D/WB/M RL,435,1,11,9,16,1,1,16,20,20,1,19,1,10,11,1,13,16,9,15,20,16,19,137439019010,0,1,0,0,0,0,0,0,0,0,0,0,0,0,0,0,1,0,0,0,0,0,0,0,0,0,0,0,0,0,0,0,0,0,0,0,0,1,0,0,0,0,0,0,0,0,0,0
29/6/2010,Hans Sarpei,6000687,21,6/28/1976,34,34,0,0,0,4096,6250,6400,132,128,1100947,178,73,D/WB/DM RLC,3,1,1,3,1,1,1,4,1,3,3,4,8,6,4,13,4,11,5,12,14,12,8,15,10,9,11,10,12,13,10,12,12,4,10,6,15,16,15,12,13,12,10,10,16,13,20,14,13,15,3,12,3,14,15,13,18,14,14,15,18,3,D/WB/DM RLC,336,1,1,20,19,20,1,17,15,19,1,16,1,1,1,10,17,19,15,1,1,14,16,0,0,0,0,0,0,0,0,0,0,0,0,0,0,0,0,0,0,0,0,0,0,0,0,0,0,0,0,0,0,0,0,0,0,0,0,0,0,0,0,0,0,0,0,0,0,0,0,0
29/6/2010,Hamit Altintop,884384,799,12/8/1982,27,56,4,9,2,5776,8000,7750,153,152,99699478,183,82,WB/DM/M/AM RC,1,2,2,2,3,3,1,6,2,3,1,13,12,11,9,12,14,8,16,14,12,12,13,13,14,16,11,16,11,15,10,12,17,8,10,12,9,15,18,14,13,14,12,12,15,16,20,17,13,18,6,17,13,18,16,16,15,19,17,15,16,5,WB/DM/M/AM RC,443,1,18,20,14,18,1,14,20,20,1,17,18,14,17,1,1,14,20,14,20,8,17,69793219330,0,1,0,0,0,0,0,0,1,1,0,0,0,0,0,0,0,0,0,0,0,0,0,0,0,0,0,0,0,0,1,0,0,0,0,0,1,0,0,0,0,0,0,0,0,0,0,0
29/6/2010,Habib Beye,3504204,41,10/19/1977,32,41,1,0,0,4489,7350,6500,150,134,5750000,182,79,D R,3,2,2,1,1,1,1,10,3,1,2,7,12,9,6,11,7,14,9,13,14,12,5,14,11,11,13,16,10,10,8,12,16,7,15,9,14,15,16,15,11,14,13,5,16,15,20,14,14,15,10,14,9,9,15,15,15,15,15,15,12,6,D R,102,1,1,14,20,8,1,1,1,20,1,14,1,1,1,14,10,20,1,1,1,1,14,2199023288352,0,0,0,0,0,1,0,0,0,0,0,0,0,0,0,1,0,0,0,0,0,0,0,0,0,0,0,0,0,0,0,0,0,0,0,0,0,0,0,0,0,1,0,0,0,0,0,0
29/6/2010,György Garics,5602750,755,3/8/1984,26,23,1,21,2,3906,6875,6250,133,125,6298513,183,75,D/WB/M R,1,1,2,2,1,3,3,4,1,2,1,9,11,12,7,10,3,15,5,13,15,12,7,13,10,14,15,14,6,12,11,14,16,5,12,14,14,15,14,13,12,15,11,8,13,13,20,15,14,13,12,10,10,10,16,15,14,15,16,14,14,10,D/WB/M R,122,1,1,1,20,1,1,1,17,20,1,20,1,1,1,1,5,20,1,1,17,1,20,4294967296,0,0,0,0,0,0,0,0,0,0,0,0,0,0,0,0,0,0,0,0,0,0,0,0,0,0,0,0,0,0,0,0,1,0,0,0,0,0,0,0,0,0,0,0,0,0,0,0
29/6/2010,Guy Demel,910017,24,6/13/1981,29,18,0,0,0,4761,6209,6900,142,138,31636329,189,85,D RLC,3,2,2,3,2,3,2,2,1,1,1,6,9,12,5,12,5,10,8,15,14,10,7,15,13,12,15,16,8,14,8,9,15,8,12,9,14,16,15,12,11,17,15,8,10,15,20,13,18,10,16,13,16,17,13,10,14,7,10,9,8,8,D RLC,106,1,1,17,20,15,1,15,15,20,1,14,1,1,1,17,15,20,15,1,12,14,14,1116826763272,0,0,0,1,0,0,0,0,0,0,0,0,0,0,0,0,0,0,0,0,1,0,0,0,0,0,0,1,0,0,0,0,0,0,1,0,0,0,0,0,1,0,0,0,0,0,0,0
29/6/2010,Grétar Steinsson,7840247,774,1/9/1982,28,38,4,0,0,4225,5850,6550,138,130,7386788,189,78,D/WB R,1,1,2,3,3,3,1,6,1,1,2,4,14,10,5,12,9,13,12,14,14,14,9,14,11,19,12,18,13,14,13,11,18,11,11,14,10,13,17,12,12,15,13,7,18,12,20,15,17,15,8,16,7,14,17,18,14,15,18,17,5,12,D/WB R,112,1,1,1,20,1,1,1,8,20,1,20,1,1,1,1,6,20,1,1,8,1,20,3435973837600,0,0,0,0,0,1,0,0,1,1,0,0,0,0,0,0,0,0,0,0,0,0,0,0,0,0,0,0,0,0,0,0,0,0,0,0,0,1,0,0,1,1,0,0,0,0,0,0
29/6/2010,Greg Halford,5110801,765,12/8/1984,25,0,0,0,0,2900,5750,5750,125,115,3624518,194,81,D/M R,1,1,2,3,2,2,1,1,2,1,2,11,12,11,12,12,14,16,13,19,10,13,10,11,13,10,12,9,12,12,12,9,11,12,10,13,10,12,13,11,11,10,16,10,15,12,20,12,15,10,8,10,5,16,8,15,15,8,10,15,14,8,D/M R,112,10,12,12,20,12,1,8,20,20,1,12,1,8,12,10,13,20,10,8,20,1,10,44530220925448,0,0,0,1,0,0,0,0,0,1,0,0,0,0,0,0,0,0,0,0,0,0,0,0,0,0,0,0,0,0,0,0,0,0,0,0,0,0,0,1,0,0,0,1,0,1,0,0
29/6/2010,Gonzalo Jara,5250132,1652,8/23/1985,24,38,3,0,0,4624,7000,6750,145,136,6550116,178,76,D/DM/M RLC,3,1,1,1,2,2,1,4,3,2,2,5,8,10,8,12,8,14,10,10,14,13,5,15,11,15,13,14,11,12,12,12,15,10,13,10,16,15,15,10,13,13,11,14,14,11,20,14,13,14,15,13,8,17,11,14,13,12,13,12,7,6,D/DM/M RLC,126,1,1,20,20,19,1,17,16,20,18,15,1,1,1,20,17,20,16,1,15,12,15,16810048,0,0,0,0,0,0,1,0,0,0,0,0,0,0,0,1,0,0,0,0,0,0,0,0,1,0,0,0,0,0,0,0,0,0,0,0,0,0,0,0,0,0,0,0,0,0,0,0
29/6/2010,Gonzalo Castro,8723487,771,6/11/1987,23,5,0,21,3,4500,6900,6900,168,138,13523993,171,72,D/WB/DM/M RC,1,3,1,2,2,2,2,1,2,2,3,13,13,14,8,13,13,8,11,11,12,15,12,11,14,12,13,11,11,11,13,11,12,12,7,12,10,13,13,16,16,13,6,15,12,13,20,12,10,12,8,12,4,16,10,11,17,11,12,12,14,4,D/WB/DM/M RC,133,1,12,18,20,18,1,14,16,20,1,20,12,1,11,1,14,20,16,1,12,14,20,1048584,0,0,0,1,0,0,0,0,0,0,0,0,0,0,0,0,0,0,0,0,1,0,0,0,0,0,0,0,0,0,0,0,0,0,0,0,0,0,0,0,0,0,0,0,0,0,0,0
29/6/2010,Glen Johnson,5112082,765,8/23/1984,25,26,1,14,0,5700,8000,8000,167,151,151878499,178,73,D R,1,2,2,3,1,1,1,7,2,2,2,3,15,13,10,13,8,12,10,6,12,13,12,14,13,11,13,12,13,11,12,16,13,9,7,14,11,13,16,15,14,16,13,14,17,15,20,17,15,16,7,13,14,14,18,16,15,14,15,16,17,5,D R,102,10,13,12,20,1,1,10,14,20,1,14,1,1,13,12,10,20,1,1,14,1,14,549755813890,0,1,0,0,0,0,0,0,0,0,0,0,0,0,0,0,0,0,0,0,0,0,0,0,0,0,0,0,0,0,0,0,0,0,0,0,0,0,0,1,0,0,0,0,0,0,0,0
29/6/2010,Giuseppe Bellusci,43000005,776,8/21/1989,20,0,0,5,0,3422,5750,5750,148,117,4267935,185,81,D RC,1,2,3,1,3,2,3,2,2,3,3,5,10,8,5,5,5,15,5,11,15,10,5,15,10,16,13,12,10,14,10,14,16,5,8,9,15,11,11,13,10,11,13,5,18,10,20,10,15,10,16,10,2,12,9,15,13,10,16,11,9,7,D RC,103,1,1,20,20,1,1,1,1,15,1,1,1,1,1,20,1,15,1,1,1,1,1,32768,0,0,0,0,0,0,0,0,0,0,0,0,0,0,0,1,0,0,0,0,0,0,0,0,0,0,0,0,0,0,0,0,0,0,0,0,0,0,0,0,0,0,0,0,0,0,0,0
29/6/2010,Giulio Donati,43036529,776,2/5/1990,20,0,0,0,0,1250,5000,5000,114,105,236401,175,70,D R,1,1,1,1,1,1,1,1,1,1,1,3,10,7,4,9,6,10,10,11,13,9,6,14,7,16,12,13,12,13,4,10,18,5,13,8,15,16,16,13,12,14,10,5,14,12,20,16,14,17,10,13,8,11,12,14,14,14,17,14,14,5,D R,102,1,1,12,20,1,1,10,1,20,1,14,1,1,1,12,10,20,1,1,1,1,14,274877907008,0,0,0,0,0,0,1,0,0,0,0,0,0,0,0,0,0,0,0,0,0,0,0,0,0,0,0,0,0,0,0,0,0,0,0,0,0,0,1,0,0,0,0,0,0,0,0,0
29/6/2010,Gilberto Martínez,5385001,366,10/1/1979,30,58,0,0,0,3481,6490,5750,148,118,2294667,174,72,D RC,1,2,1,2,1,1,3,1,3,1,2,3,12,11,3,12,2,8,9,11,14,13,2,14,11,12,12,14,10,10,9,13,19,7,6,10,12,12,12,13,13,14,6,12,4,12,20,15,13,12,7,1,18,12,15,18,12,14,12,2,8,16,D RC,103,1,1,18,20,1,1,1,1,20,1,15,1,1,1,18,13,20,1,1,1,1,15,0,0,0,0,0,0,0,0,0,0,0,0,0,0,0,0,0,0,0,0,0,0,0,0,0,0,0,0,0,0,0,0,0,0,0,0,0,0,0,0,0,0,0,0,0,0,0,0,0
29/6/2010,Gianni Zuiverloon,859941,784,12/30/1986,23,0,0,18,0,3906,6500,6000,145,125,11730078,178,70,D R,2,1,2,1,1,3,1,1,3,2,1,5,13,14,6,13,8,14,5,13,11,12,5,14,14,12,13,14,13,7,12,9,13,11,10,14,11,13,14,16,13,13,10,11,15,15,20,14,14,10,8,12,8,13,14,14,13,15,15,17,14,6,D R,102,1,1,12,20,5,1,4,10,20,8,15,1,1,1,12,4,20,3,1,10,4,15,17592186044418,0,1,0,0,0,0,0,0,0,0,0,0,0,0,0,0,0,0,0,0,0,0,0,0,0,0,0,0,0,0,0,0,0,0,0,0,0,0,0,0,0,0,0,0,1,0,0,0
29/6/2010,Gianluca Zambrotta,704897,776,2/19/1977,33,97,2,13,1,5402,7550,7550,171,147,155002075,181,76,D/WB RL,2,2,3,2,1,3,1,4,3,2,2,8,14,13,8,13,5,8,13,14,15,13,8,14,14,15,12,15,14,13,13,14,14,8,14,14,16,15,14,12,14,13,10,16,13,14,20,13,13,15,12,13,12,15,13,11,15,16,16,15,17,8,D/WB RL,115,1,6,1,20,1,1,18,12,20,1,18,1,4,6,1,18,20,1,10,12,16,18,1099511627776,0,0,0,0,0,0,0,0,0,0,0,0,0,0,0,0,0,0,0,0,0,0,0,0,0,0,0,0,0,0,0,0,0,0,0,0,0,0,0,0,1,0,0,0,0,0,0,0
29/6/2010,Gianluca Grava,705845,776,3/7/1977,33,0,0,0,0,2250,6350,6350,134,134,787063,172,68,D/WB RC,1,3,2,2,3,2,1,4,2,2,2,4,12,11,5,13,5,8,4,11,16,10,7,14,8,16,14,15,11,14,10,12,13,3,15,12,14,14,13,13,14,11,7,9,14,15,20,15,10,15,14,11,5,15,11,15,12,15,17,14,9,7,D/WB RC,113,1,1,20,20,1,1,12,1,20,1,18,1,1,1,20,1,20,1,1,1,12,18,0,0,0,0,0,0,0,0,0,0,0,0,0,0,0,0,0,0,0,0,0,0,0,0,0,0,0,0,0,0,0,0,0,0,0,0,0,0,0,0,0,0,0,0,0,0,0,0,0
29/6/2010,Gianluca Comotto,704642,776,10/16/1978,31,0,0,0,0,2250,6950,6950,138,132,3678470,182,78,D R,3,3,1,2,4,1,1,1,2,3,2,9,11,10,7,8,3,14,9,8,15,12,5,14,9,13,13,15,12,12,10,12,17,5,16,15,16,14,14,14,12,13,12,7,15,13,20,17,14,13,12,12,6,14,16,11,14,15,15,10,13,6,D R,102,1,1,13,20,1,1,1,1,20,1,10,1,1,1,13,11,20,1,1,1,1,10,0,0,0,0,0,0,0,0,0,0,0,0,0,0,0,0,0,0,0,0,0,0,0,0,0,0,0,0,0,0,0,0,0,0,0,0,0,0,0,0,0,0,0,0,0,0,0,0,0
29/6/2010,Giandomenico Mesto,3802004,776,5/25/1982,28,3,0,9,0,4900,7150,7150,149,140,3144794,180,73,WB/M R,1,1,1,1,1,1,8,1,1,1,1,6,15,14,8,10,5,10,11,6,11,14,5,12,12,13,12,12,13,8,12,14,14,13,8,18,14,13,16,13,14,10,11,13,15,14,20,17,16,10,16,10,7,16,15,15,15,13,20,15,15,6,WB/M R,212,1,12,6,12,6,1,10,20,20,1,20,1,1,12,1,1,12,6,8,20,10,20,2,0,1,0,0,0,0,0,0,0,0,0,0,0,0,0,0,0,0,0,0,0,0,0,0,0,0,0,0,0,0,0,0,0,0,0,0,0,0,0,0,0,0,0,0,0,0,0,0
29/6/2010,George Lucas,319186,1651,2/20/1984,26,0,0,0,0,3306,6550,5750,130,115,1561861,172,72,D/WB R,1,1,1,3,2,1,3,4,1,3,3,12,14,11,10,11,15,9,11,9,8,13,13,11,13,8,13,13,13,15,13,13,15,12,12,13,7,14,15,15,13,11,6,7,14,13,20,15,11,13,13,15,7,10,6,16,15,14,16,13,14,12,D/WB R,222,1,1,1,19,1,1,1,12,20,1,20,1,1,1,1,1,19,1,1,12,1,20,134219778,0,1,0,0,0,0,0,0,0,0,0,1,0,0,0,0,0,0,0,0,0,0,0,0,0,0,0,1,0,0,0,0,0,0,0,0,0,0,0,0,0,0,0,0,0,0,0,0
29/6/2010,Gennaro Sardo,6100462,776,5/8/1979,31,0,0,0,0,2500,5750,5750,120,118,1663246,190,87,D/WB R,1,1,1,1,1,1,1,1,1,1,1,12,14,9,6,11,9,14,8,17,10,12,6,14,8,12,10,13,8,12,9,12,18,8,10,14,10,14,14,13,11,16,15,8,13,13,20,15,15,12,14,12,7,12,12,11,15,4,15,14,4,5,D/WB R,112,1,1,1,20,1,1,1,9,20,1,20,1,1,1,1,4,20,1,1,9,1,20,1099511627776,0,0,0,0,0,0,0,0,0,0,0,0,0,0,0,0,0,0,0,0,0,0,0,0,0,0,0,0,0,0,0,0,0,0,0,0,0,0,0,0,1,0,0,0,0,0,0,0
29/6/2010,Garry Bocaly,8439529,769,4/19/1988,22,0,0,14,0,4356,5900,5900,155,132,1840000,180,74,D/WB RC,2,2,1,3,1,1,2,2,2,3,1,12,11,11,7,11,7,13,10,10,12,9,7,15,12,14,13,14,12,13,10,13,16,8,10,12,12,12,15,15,13,14,10,5,15,14,20,15,14,15,12,14,6,10,9,16,14,14,14,14,14,6,D/WB RC,113,1,1,16,20,12,1,8,10,20,1,18,1,1,1,16,8,20,8,1,10,8,18,32,0,0,0,0,0,1,0,0,0,0,0,0,0,0,0,0,0,0,0,0,0,0,0,0,0,0,0,0,0,0,0,0,0,0,0,0,0,0,0,0,0,0,0,0,0,0,0,0
29/6/2010,Gaetano Berardi,1408506,798,8/21/1988,21,0,0,11,0,1350,5650,5400,118,117,1320000,182,80,D RL,1,3,1,1,2,1,2,3,3,3,1,1,12,11,4,6,7,13,13,4,16,12,1,12,12,6,12,8,9,10,11,10,9,4,4,11,13,8,14,15,13,12,14,15,11,13,20,11,11,9,3,10,4,15,13,18,17,6,14,13,13,5,D RL,105,1,1,13,20,1,1,20,10,15,1,13,1,1,1,13,20,15,1,10,1,13,1,0,0,0,0,0,0,0,0,0,0,0,0,0,0,0,0,0,0,0,0,0,0,0,0,0,0,0,0,0,0,0,0,0,0,0,0,0,0,0,0,0,0,0,0,0,0,0,0,0
29/6/2010,Gabriele Perico,836917,776,3/11/1984,26,0,0,0,0,2400,5900,5900,125,120,372387,183,75,D/WB/M RC,2,1,3,1,1,1,3,3,3,3,2,7,14,9,10,9,6,15,10,14,15,10,6,14,12,12,11,11,9,13,6,11,14,7,13,9,13,12,14,14,12,10,13,7,12,14,20,12,12,13,14,14,9,12,5,13,15,13,12,8,10,6,D/WB/M RC,123,1,1,15,20,1,1,1,17,20,1,20,1,1,1,15,12,20,1,1,17,1,20,8796093022208,0,0,0,0,0,0,0,0,0,0,0,0,0,0,0,0,0,0,0,0,0,0,0,0,0,0,0,0,0,0,0,0,0,0,0,0,0,0,0,0,0,0,0,1,0,0,0,0
29/6/2010,Fredrik Stoor,615742,797,2/28/1984,26,11,0,13,0,3540,6250,6100,124,119,5701730,184,80,D RLC,3,3,2,2,3,1,2,4,2,1,2,8,12,8,7,11,12,11,11,10,12,12,8,12,12,10,12,11,12,12,12,14,14,8,11,13,13,14,13,12,11,12,8,3,13,17,20,15,13,12,5,14,4,11,15,11,16,15,14,14,10,4,D RLC,106,1,1,18,20,1,1,16,11,20,1,14,1,1,1,18,16,20,1,1,11,1,14,0,0,0,0,0,0,0,0,0,0,0,0,0,0,0,0,0,0,0,0,0,0,0,0,0,0,0,0,0,0,0,0,0,0,0,0,0,0,0,0,0,0,0,0,0,0,0,0,0
29/6/2010,Frédéric Duplus,34000468,769,4/7/1990,20,0,0,0,0,950,4724,4600,150,105,2807426,175,66,D R,2,1,3,3,2,1,2,3,1,2,1,8,12,7,5,8,6,7,7,7,8,9,7,10,10,5,11,12,13,13,11,14,14,6,11,9,13,12,14,12,11,12,7,10,13,14,20,15,6,15,9,10,9,12,13,16,6,14,8,10,6,5,D R,102,1,1,12,20,1,1,13,1,20,1,15,1,1,1,12,13,20,1,1,1,13,15,0,0,0,0,0,0,0,0,0,0,0,0,0,0,0,0,0,0,0,0,0,0,0,0,0,0,0,0,0,0,0,0,0,0,0,0,0,0,0,0,0,0,0,0,0,0,0,0,0
29/6/2010,François Clerc,915732,769,4/18/1983,27,13,0,4,0,4422,6000,6000,140,133,4398115,186,77,D/WB R,2,3,2,1,1,3,2,1,1,3,3,8,14,12,6,12,8,14,13,13,13,12,10,13,13,7,15,13,9,12,12,12,15,12,8,11,13,12,14,15,12,15,13,8,11,14,20,14,13,13,7,14,11,10,10,14,13,14,15,14,14,8,D/WB R,112,1,15,1,20,1,1,1,15,20,1,17,1,1,15,1,8,20,1,1,15,1,17,2,0,1,0,0,0,0,0,0,0,0,0,0,0,0,0,0,0,0,0,0,0,0,0,0,0,0,0,0,0,0,0,0,0,0,0,0,0,0,0,0,0,0,0,0,0,0,0,0
29/6/2010,Franco Sosa,955420,1649,4/4/1981,29,0,0,0,0,1400,6050,6050,148,135,6394475,179,73,D/WB R,1,1,2,3,3,3,2,4,3,1,1,12,12,11,8,11,13,14,9,11,14,11,12,14,13,14,13,16,13,14,11,12,16,10,13,11,12,13,15,14,13,12,9,10,16,12,20,16,12,14,14,15,5,18,15,13,14,15,14,14,11,9,D/WB R,112,1,1,14,20,10,1,13,1,20,1,17,1,1,1,14,13,20,1,1,1,13,17,2199023255584,0,0,0,0,0,1,0,0,0,0,0,0,0,0,0,0,0,0,0,0,0,0,0,0,0,0,0,0,0,0,0,0,0,0,0,0,0,0,0,0,0,1,0,0,0,0,0,0
29/6/2010,Franck Béria,143897,769,5/23/1983,27,0,0,3,0,5150,6479,6450,150,144,4555621,177,75,D/WB RLC,3,2,1,3,1,2,1,1,1,1,3,7,13,9,5,12,8,12,10,12,14,11,7,14,12,13,15,14,13,14,8,13,15,8,9,8,14,16,14,13,12,13,8,12,15,15,20,15,13,16,13,15,7,16,13,14,15,14,17,15,15,6,D/WB RLC,116,1,10,17,20,10,1,18,10,20,1,18,1,5,10,17,18,20,1,5,10,16,18,32,0,0,0,0,0,1,0,0,0,0,0,0,0,0,0,0,0,0,0,0,0,0,0,0,0,0,0,0,0,0,0,0,0,0,0,0,0,0,0,0,0,0,0,0,0,0,0,0
29/6/2010,Francisco Javier Chica,7451987,796,5/17/1985,25,0,0,0,0,4225,6250,6250,143,130,2454216,179,76,D/WB RL,3,3,2,1,3,1,3,2,2,2,2,6,10,9,5,9,6,9,6,12,13,10,9,14,9,15,14,15,11,12,9,11,14,7,12,9,14,16,17,14,11,14,11,13,14,14,20,16,13,14,10,11,7,15,10,16,13,12,12,15,10,9,D/WB RL,115,1,1,1,20,1,1,18,1,20,1,20,1,1,1,1,18,20,1,1,1,17,20,4295000064,0,0,0,0,0,0,0,0,0,0,0,0,0,0,0,1,0,0,0,0,0,0,0,0,0,0,0,0,0,0,0,0,1,0,0,0,0,0,0,0,0,0,0,0,0,0,0,0
29/6/2010,Francis,6704030,796,12/17/1981,28,0,0,0,0,4000,6250,6250,137,133,4365777,178,70,D/WB R,3,2,2,3,2,3,2,4,3,3,2,4,12,10,6,9,7,6,8,6,13,12,8,14,11,13,14,14,13,14,12,14,12,9,14,10,10,15,15,16,14,9,10,10,13,15,20,15,13,14,9,13,7,15,15,15,15,8,15,14,14,8,D/WB R,112,1,1,1,20,1,1,1,1,20,1,20,1,1,1,1,2,20,1,1,1,1,20,1048736,0,0,0,0,0,1,0,1,0,0,0,0,0,0,0,0,0,0,0,0,1,0,0,0,0,0,0,0,0,0,0,0,0,0,0,0,0,0,0,0,0,0,0,0,0,0,0,0
29/6/2010,Francis Coquelin,34012022,769,5/13/1991,19,0,0,0,0,2025,3150,4250,149,90,-1,178,73,D/DM/M RC,1,2,2,2,2,1,3,1,1,2,1,5,5,8,5,10,4,9,5,5,10,11,3,13,12,12,11,15,9,10,8,9,16,8,13,10,10,14,15,12,10,12,8,12,14,10,20,15,12,14,5,10,10,15,13,16,14,10,13,15,14,5,D/DM/M RC,333,1,1,20,17,20,1,1,16,17,1,1,1,1,1,1,1,17,16,1,1,1,1,0,0,0,0,0,0,0,0,0,0,0,0,0,0,0,0,0,0,0,0,0,0,0,0,0,0,0,0,0,0,0,0,0,0,0,0,0,0,0,0,0,0,0,0,0,0,0,0,0
29/6/2010,Francesco Pisano,7988382,776,4/29/1986,24,0,0,12,0,2000,6400,6400,140,126,6594728,170,65,D/WB RL,2,3,1,3,3,3,1,4,1,2,2,8,12,12,9,10,5,8,8,14,12,10,6,13,11,17,16,15,7,12,9,12,11,5,11,13,12,12,11,15,15,12,5,7,15,14,20,17,13,10,11,10,6,10,10,10,10,10,9,10,11,6,D/WB RL,115,1,1,1,20,1,1,16,1,20,1,18,1,1,1,1,16,20,1,1,1,13,18,274877939776,0,0,0,0,0,0,1,0,0,0,0,0,0,0,0,1,0,0,0,0,0,0,0,0,0,0,0,0,0,0,0,0,0,0,0,0,0,0,1,0,0,0,0,0,0,0,0,0
29/6/2010,Florian Lechner,876507,771,3/3/1981,29,0,0,0,0,1750,5300,5300,108,106,1546030,179,75,D/WB R,2,2,3,2,1,2,1,4,1,2,3,10,12,8,5,9,9,7,11,12,12,8,2,13,9,14,13,14,11,9,6,12,10,7,11,9,12,14,12,12,12,12,9,8,7,13,20,15,12,9,7,11,16,5,10,11,14,10,12,12,14,1,D/WB R,112,1,1,1,20,1,1,1,10,20,1,18,1,1,1,1,7,20,1,1,10,1,18,0,0,0,0,0,0,0,0,0,0,0,0,0,0,0,0,0,0,0,0,0,0,0,0,0,0,0,0,0,0,0,0,0,0,0,0,0,0,0,0,0,0,0,0,0,0,0,0,0
29/6/2010,Florian Heller,883741,771,3/10/1982,28,0,0,0,0,3250,5750,5750,125,115,2823479,179,75,WB/M R,1,3,2,3,3,2,3,1,3,2,3,12,13,12,12,12,12,10,12,8,8,14,12,11,13,13,12,11,14,10,12,12,13,11,12,11,9,11,12,14,13,11,8,4,10,13,20,13,10,4,10,9,9,11,9,13,14,10,11,12,9,9,WB/M R,212,1,10,1,9,1,1,1,20,20,1,20,1,1,10,1,1,9,1,1,20,1,20,0,0,0,0,0,0,0,0,0,0,0,0,0,0,0,0,0,0,0,0,0,0,0,0,0,0,0,0,0,0,0,0,0,0,0,0,0,0,0,0,0,0,0,0,0,0,0,0,0
29/6/2010,Florian Dick,8708170,771,11/9/1984,25,0,0,0,0,3200,6300,6300,132,126,1544080,184,83,D/WB/M R,3,1,2,1,1,1,1,2,1,3,3,9,14,13,12,12,12,11,15,17,14,14,10,14,13,12,11,12,9,14,8,11,11,11,12,8,13,12,14,11,11,13,14,10,12,13,20,13,13,13,5,12,4,11,8,12,20,13,13,13,9,6,D/WB/M R,232,1,1,1,16,1,1,10,18,20,1,20,1,1,1,1,10,16,1,1,18,10,20,1099511627784,0,0,0,1,0,0,0,0,0,0,0,0,0,0,0,0,0,0,0,0,0,0,0,0,0,0,0,0,0,0,0,0,0,0,0,0,0,0,0,0,1,0,0,0,0,0,0,0
29/6/2010,Felix Bastians,5006686,771,5/9/1988,22,0,0,0,0,4250,6250,6250,137,132,3801102,188,84,D LC,2,1,1,1,2,1,3,6,2,2,3,8,12,10,10,12,7,12,8,6,13,12,9,14,12,13,10,12,15,12,11,8,14,12,8,10,12,14,15,14,13,13,12,20,14,14,16,13,12,12,8,10,7,13,12,13,11,10,14,13,8,8,D LC,104,1,15,16,20,1,1,20,15,1,1,15,1,15,1,16,20,16,1,15,1,15,1,536870912,0,0,0,0,0,0,0,0,0,0,0,0,0,0,0,0,0,0,0,0,0,0,0,0,0,0,0,0,0,1,0,0,0,0,0,0,0,0,0,0,0,0,0,0,0,0,0,0
29/6/2010,Felipe Mattioni,8833559,1651,10/15/1988,21,0,0,0,0,4750,6254,6500,164,139,19119659,177,72,D/WB R,1,2,2,1,2,3,1,6,3,1,2,12,13,15,7,12,11,8,10,12,11,13,5,11,16,12,13,12,11,12,13,11,13,14,6,13,11,10,13,17,15,8,10,7,12,16,20,13,9,12,11,10,10,14,12,15,8,12,14,15,11,17,D/WB R,222,1,9,1,18,1,1,1,15,20,1,20,1,1,9,1,1,18,1,1,15,1,20,32,0,0,0,0,0,1,0,0,0,0,0,0,0,0,0,0,0,0,0,0,0,0,0,0,0,0,0,0,0,0,0,0,0,0,0,0,0,0,0,0,0,0,0,0,0,0,0,0
29/6/2010,Fabrizio Cacciatore,7988563,776,10/8/1986,23,0,0,0,0,3600,5500,5500,135,120,2991663,182,75,D RL,3,3,3,1,2,1,1,2,1,1,2,10,12,9,8,9,9,12,8,14,13,10,9,14,8,15,12,12,7,13,9,12,12,10,9,13,14,14,16,12,11,10,12,10,15,12,20,15,13,14,8,14,7,14,15,14,10,5,12,12,7,11,D RL,105,1,1,12,20,1,1,15,1,20,1,9,1,1,1,12,15,20,1,1,1,1,9,2,0,1,0,0,0,0,0,0,0,0,0,0,0,0,0,0,0,0,0,0,0,0,0,0,0,0,0,0,0,0,0,0,0,0,0,0,0,0,0,0,0,0,0,0,0,0,0,0
29/6/2010,Fábio,2107501,1651,7/9/1990,19,0,0,0,0,3782,6750,6500,160,123,52274055,172,69,D/WB RL,1,1,2,1,3,2,3,4,3,2,1,6,13,13,12,14,5,10,10,9,10,11,13,11,13,13,11,12,11,10,8,10,14,15,10,14,8,10,14,17,15,13,9,13,14,17,20,10,9,12,11,14,13,13,14,16,10,16,15,14,16,6,D/WB RL,115,1,12,8,20,1,1,20,12,17,1,18,6,12,6,1,20,17,8,12,8,18,15,2251799814733864,0,0,0,1,0,1,0,0,0,0,0,0,0,0,0,0,0,0,0,0,1,0,0,0,0,0,0,0,0,0,0,0,0,0,0,0,0,0,0,0,0,0,0,0,0,0,0,0
29/6/2010,Fabien Laurenti,914452,769,1/6/1983,27,0,0,3,0,3481,5300,5300,130,118,3550644,181,75,D RC,2,1,2,2,2,1,2,6,3,1,1,5,9,8,4,10,7,13,7,8,13,10,6,12,10,12,14,14,11,13,7,13,14,5,12,6,13,16,13,13,11,13,11,8,14,12,20,15,13,14,12,14,8,12,8,13,15,12,16,14,14,6,D RC,103,1,1,18,20,10,1,10,1,20,12,10,1,1,1,18,10,20,1,1,1,10,10,0,0,0,0,0,0,0,0,0,0,0,0,0,0,0,0,0,0,0,0,0,0,0,0,0,0,0,0,0,0,0,0,0,0,0,0,0,0,0,0,0,0,0,0,0,0,0,0,0
29/6/2010,Fabiano Santacroce,1400569,776,8/24/1986,23,0,0,6,0,3250,6700,6700,160,135,20621488,181,72,D RC,2,2,2,1,1,3,2,4,2,1,2,4,11,11,4,11,4,14,4,14,16,8,6,16,13,14,16,15,12,13,8,14,15,9,6,9,12,12,11,15,16,12,12,7,8,15,20,14,12,13,15,16,18,10,14,14,15,16,14,12,5,3,D RC,103,1,1,20,20,1,1,1,1,15,1,1,1,1,1,20,1,15,1,1,1,1,1,140737488355328,0,0,0,0,0,0,0,0,0,0,0,0,0,0,0,0,0,0,0,0,0,0,0,0,0,0,0,0,0,0,0,0,0,0,0,0,0,0,0,0,0,0,0,0,0,0,0,1
29/6/2010,Fabian Johnson,8726381,771,12/11/1987,22,0,0,6,0,2800,5600,5600,140,121,5637396,183,70,D/M RL,1,2,1,2,2,1,3,1,3,3,2,9,10,12,7,11,10,8,10,12,11,9,8,10,12,9,9,10,10,10,8,8,9,10,7,14,10,13,15,17,16,11,10,20,13,15,15,14,10,10,7,10,10,18,10,11,17,10,9,12,8,8,D/M RL,115,1,10,1,20,1,1,20,17,18,1,14,1,1,10,1,20,18,1,15,17,14,10,3,1,1,0,0,0,0,0,0,0,0,0,0,0,0,0,0,0,0,0,0,0,0,0,0,0,0,0,0,0,0,0,0,0,0,0,0,0,0,0,0,0,0,0,0,0,0,0,0
29/6/2010,Ernesto Galán,1512134,796,6/17/1986,24,0,0,0,0,2000,5000,5000,125,110,1604909,181,79,D RC,3,3,2,1,3,1,2,1,2,3,3,9,14,12,11,10,8,11,10,11,13,11,10,11,11,12,12,11,10,7,13,9,10,11,8,14,14,15,14,15,15,13,11,7,13,11,20,14,12,11,8,13,15,11,12,13,9,10,10,14,10,9,D RC,103,1,1,20,20,1,1,1,1,20,1,15,1,1,1,20,1,20,1,1,1,1,15,0,0,0,0,0,0,0,0,0,0,0,0,0,0,0,0,0,0,0,0,0,0,0,0,0,0,0,0,0,0,0,0,0,0,0,0,0,0,0,0,0,0,0,0,0,0,0,0,0
29/6/2010,Eric Chelle,910736,31,11/11/1977,32,7,0,0,0,3550,6450,5800,134,129,3585537,175,75,D RC,3,2,2,2,2,2,3,10,1,1,2,6,10,6,8,8,7,15,13,7,16,8,8,12,8,12,16,16,13,14,8,13,15,5,15,7,13,14,16,13,10,16,7,8,15,14,20,14,16,16,10,14,7,12,15,14,15,12,12,12,12,7,D RC,103,5,1,20,20,14,1,1,1,17,1,12,1,1,1,20,1,17,1,1,1,1,12,0,0,0,0,0,0,0,0,0,0,0,0,0,0,0,0,0,0,0,0,0,0,0,0,0,0,0,0,0,0,0,0,0,0,0,0,0,0,0,0,0,0,0,0,0,0,0,0,0
29/6/2010,Eneko Bóveda,67018261,796,12/14/1988,21,0,0,0,0,2256,4400,4400,121,95,4583649,180,77,D RL,1,3,3,1,2,3,2,2,3,3,2,4,9,10,3,12,6,11,8,12,10,11,4,12,11,10,9,14,11,11,8,11,10,9,10,8,11,12,13,10,11,10,10,20,8,11,10,13,12,13,13,10,13,14,11,10,7,10,15,8,13,14,D RL,105,1,1,14,20,1,1,15,14,20,1,15,1,1,1,14,15,20,1,1,14,15,15,0,0,0,0,0,0,0,0,0,0,0,0,0,0,0,0,0,0,0,0,0,0,0,0,0,0,0,0,0,0,0,0,0,0,0,0,0,0,0,0,0,0,0,0,0,0,0,0,0
29/6/2010,Emmerson Boyce,108265,361,9/24/1979,30,2,0,0,0,3600,6500,6400,140,130,3798726,181,73,D RC,3,2,3,3,3,3,3,1,1,3,2,3,8,6,6,12,3,16,3,11,14,11,3,14,11,8,12,13,12,15,10,13,13,5,13,11,14,13,14,13,14,16,11,8,16,12,20,15,14,15,6,12,9,13,14,14,15,14,20,18,16,2,D RC,103,1,1,20,20,1,1,10,1,17,1,1,1,1,1,20,10,17,1,1,1,1,1,1081360,0,0,0,0,1,0,0,0,0,0,0,0,0,0,0,1,0,0,0,0,1,0,0,0,0,0,0,0,0,0,0,0,0,0,0,0,0,0,0,0,0,0,0,0,0,0,0,0
29/6/2010,Emmanuel Eboué,8153988,24,6/4/1983,27,45,1,0,0,5476,7500,7500,156,148,-1,178,72,D/WB R,3,3,1,1,2,1,1,6,2,1,1,6,15,13,7,13,8,14,5,10,12,13,10,16,13,17,12,13,10,9,12,10,14,14,10,13,12,14,16,17,16,15,10,10,17,15,20,17,15,11,16,14,12,15,14,14,14,7,12,8,8,14,D/WB R,112,1,15,10,20,10,1,12,15,20,1,16,1,12,15,1,1,20,9,12,15,12,16,134414370,0,1,0,0,0,1,0,0,0,0,0,0,0,0,0,0,1,1,0,0,0,0,0,0,0,0,0,1,0,0,0,0,0,0,0,0,0,0,0,0,0,0,0,0,0,0,0,0
29/6/2010,Édson,316806,1651,6/17/1983,27,0,0,0,0,2250,5800,5500,124,112,735034,170,65,M RC,3,3,2,2,3,2,2,1,3,3,3,11,13,12,11,11,11,11,14,12,12,11,11,12,12,13,13,12,12,11,10,13,11,12,7,13,12,13,14,11,14,11,6,8,13,11,20,13,9,15,10,12,10,15,11,13,7,12,13,12,12,11,M RC,403,1,8,20,14,15,1,10,20,15,1,15,5,1,8,1,10,14,20,7,15,5,15,290,0,1,0,0,0,1,0,0,1,0,0,0,0,0,0,0,0,0,0,0,0,0,0,0,0,0,0,0,0,0,0,0,0,0,0,0,0,0,0,0,0,0,0,0,0,0,0,0
29/6/2010,Edson,19008137,1651,5/31/1986,24,0,0,0,0,2250,5750,5750,140,115,4600577,170,64,D/WB/M R,2,1,1,1,3,2,3,2,2,1,1,6,11,14,6,13,6,7,6,10,9,10,6,10,14,12,9,11,8,9,11,9,10,13,5,14,9,12,14,17,16,10,8,10,12,17,20,15,8,14,10,12,5,10,8,10,9,12,7,12,12,12,D/WB/M R,122,1,10,1,20,1,1,1,17,20,1,18,1,1,10,1,6,20,1,1,17,1,18,34,0,1,0,0,0,1,0,0,0,0,0,0,0,0,0,0,0,0,0,0,0,0,0,0,0,0,0,0,0,0,0,0,0,0,0,0,0,0,0,0,0,0,0,0,0,0,0,0
29/6/2010,Dusan Basta,5754424,802,8/18/1984,25,2,0,18,1,4096,6100,6100,140,128,715831,184,74,D/WB R,2,3,3,2,3,2,2,6,2,2,1,10,14,14,8,9,6,12,15,15,8,13,8,9,12,16,12,15,12,8,16,8,12,14,9,19,8,15,17,15,17,11,12,13,8,15,20,17,9,17,9,11,14,16,12,9,12,14,13,15,16,4,D/WB R,222,1,10,10,18,10,1,1,13,20,1,20,1,1,10,1,1,18,10,1,13,1,20,140737639350274,0,1,0,0,0,0,0,0,0,0,0,0,0,0,0,0,0,0,0,0,0,0,0,0,1,0,0,1,0,0,0,0,0,0,0,0,0,0,0,0,0,0,0,0,0,0,0,1
29/6/2010,Drissa Diakité,8750151,31,2/18/1985,25,14,0,10,0,4096,6400,5750,145,128,3174424,175,69,D/DM RC,3,3,3,2,1,3,1,3,1,1,1,9,13,11,7,11,6,12,11,8,11,12,10,14,11,15,14,14,13,12,10,12,14,9,8,9,13,14,16,14,12,13,7,8,17,13,20,16,12,14,10,14,5,10,14,15,12,14,14,13,13,6,D/DM RC,113,1,1,18,20,18,1,1,15,20,8,15,1,1,1,12,1,20,15,1,8,1,15,32,0,0,0,0,0,1,0,0,0,0,0,0,0,0,0,0,0,0,0,0,0,0,0,0,0,0,0,0,0,0,0,0,0,0,0,0,0,0,0,0,0,0,0,0,0,0,0,0
29/6/2010,Dominik Schmidt,35007315,771,7/1/1987,22,0,0,0,0,250,4350,4350,105,87,898013,187,78,D/DM RC,3,3,1,1,1,3,2,1,2,1,2,6,9,8,3,10,6,11,8,4,9,7,4,13,11,8,11,8,10,12,8,8,10,11,1,9,13,10,11,13,11,13,15,7,16,12,20,7,8,10,4,10,9,10,11,6,9,10,10,9,3,13,D/DM RC,113,1,1,20,20,20,1,7,15,16,1,15,1,1,1,20,7,16,15,1,10,5,15,0,0,0,0,0,0,0,0,0,0,0,0,0,0,0,0,0,0,0,0,0,0,0,0,0,0,0,0,0,0,0,0,0,0,0,0,0,0,0,0,0,0,0,0,0,0,0,0,0
29/6/2010,Domagoj Vida,24003525,761,4/29/1989,21,2,0,14,0,3000,5900,6200,150,124,4799999,184,73,D/DM RC,2,3,1,1,3,2,2,4,3,1,3,7,11,10,9,10,6,13,10,12,12,10,8,16,11,16,10,16,10,10,8,10,17,5,17,12,13,13,17,13,10,13,12,6,15,14,20,16,14,13,13,10,6,16,5,18,15,8,15,12,8,2,D/DM RC,113,1,1,20,20,19,1,13,15,17,1,13,1,1,1,20,13,17,15,1,8,10,13,2203318222912,0,0,0,0,0,0,1,0,0,0,0,0,0,0,0,0,0,0,0,0,0,0,0,0,0,0,0,0,0,0,0,0,1,0,0,0,0,0,0,0,0,1,0,0,0,0,0,0
29/6/2010,Didier Zokora,527746,24,12/14/1980,29,72,1,0,0,5929,7750,7500,160,154,144492258,179,70,DM/M RC,3,3,3,3,3,1,1,1,1,1,1,11,12,14,3,12,9,11,3,11,12,14,6,14,13,16,15,16,11,12,11,13,16,8,13,11,16,14,17,16,15,15,10,13,17,16,20,18,15,15,14,15,8,12,12,17,14,12,14,8,10,8,DM/M RC,313,1,12,20,15,20,1,1,19,15,1,12,12,1,11,14,1,15,19,1,12,1,12,4429185028,0,0,1,0,0,0,0,0,0,0,0,0,0,0,0,0,0,0,0,0,0,0,0,0,0,0,0,1,0,0,0,0,1,0,0,0,0,0,0,0,0,0,0,0,0,0,0,0
29/6/2010,Dennis Diekmeier,35016422,771,10/20/1989,20,0,0,0,0,2250,6750,6750,158,127,4399999,188,80,D/WB R,3,3,1,3,1,2,3,5,1,1,1,11,14,13,8,10,9,7,9,15,9,12,6,12,11,13,8,15,9,9,10,11,8,12,7,16,8,14,18,16,11,16,14,7,10,18,20,17,14,10,6,10,5,10,3,18,6,9,6,8,3,15,D/WB R,112,1,12,1,20,1,1,1,15,20,1,20,1,1,12,1,13,20,1,1,15,1,20,1099511627786,0,1,0,1,0,0,0,0,0,0,0,0,0,0,0,0,0,0,0,0,0,0,0,0,0,0,0,0,0,0,0,0,0,0,0,0,0,0,0,0,1,0,0,0,0,0,0,0
29/6/2010,Dennis Appiah,85010865,769,6/9/1992,18,0,0,0,0,1300,4814,2650,179,107,2025411,179,68,D/WB RC,3,3,1,2,3,2,3,1,1,1,2,5,8,8,6,11,6,12,6,7,11,10,6,11,11,9,13,13,13,13,9,11,14,6,8,8,12,14,12,14,13,12,9,5,15,13,20,15,8,14,9,14,7,12,10,14,14,14,12,15,15,6,D/WB RC,113,1,1,18,20,14,1,1,1,20,1,16,1,1,1,18,13,20,1,1,1,1,16,64,0,0,0,0,0,0,1,0,0,0,0,0,0,0,0,0,0,0,0,0,0,0,0,0,0,0,0,0,0,0,0,0,0,0,0,0,0,0,0,0,0,0,0,0,0,0,0,0
29/6/2010,Dejan Lovren,24000971,761,7/5/1989,20,0,0,21,1,4489,6029,6000,165,134,32887462,188,84,D RC,1,1,1,1,3,3,3,1,2,2,1,5,8,11,7,13,9,14,10,14,13,12,10,15,13,14,14,16,11,9,10,10,17,9,13,8,12,15,15,12,13,14,15,16,15,14,20,15,14,13,14,13,7,14,12,18,15,15,14,11,12,8,D RC,103,1,1,20,20,1,1,13,1,18,14,13,1,1,1,20,13,18,1,1,1,10,13,35184372219904,0,0,0,0,0,0,0,0,0,0,0,0,0,0,0,0,0,1,0,0,0,0,0,0,0,0,0,0,0,0,0,0,0,0,0,0,0,0,0,0,0,0,0,0,0,1,0,0
29/6/2010,Davide Santon,43016424,776,1/2/1991,19,5,0,3,0,4970,7350,7350,163,141,99123370,187,77,D/WB RL,1,1,1,1,1,1,1,1,1,1,1,10,14,14,8,13,10,11,11,13,12,13,10,12,14,11,13,12,13,12,13,13,13,10,12,13,12,14,12,15,14,12,12,8,14,15,20,15,13,13,10,15,13,15,13,15,17,15,13,14,17,7,D/WB RL,115,1,12,1,20,1,1,19,14,20,1,19,1,12,12,1,19,20,1,12,14,18,19,268435458,0,1,0,0,0,0,0,0,0,0,0,0,0,0,0,0,0,0,0,0,0,0,0,0,0,0,0,0,1,0,0,0,0,0,0,0,0,0,0,0,0,0,0,0,0,0,0,0
29/6/2010,Davide Mandelli,3802512,776,6/28/1977,33,0,0,0,0,1750,6050,6050,130,125,927324,190,84,D RC,1,2,3,2,3,1,1,5,1,3,1,6,6,3,6,7,7,15,6,11,16,10,8,14,9,8,14,14,13,14,10,14,14,5,12,8,15,14,15,12,13,13,14,5,14,7,20,13,14,16,7,14,7,6,13,13,13,12,14,12,11,8,D RC,103,1,1,20,20,1,1,1,1,18,1,1,1,1,1,20,1,18,1,1,1,1,1,0,0,0,0,0,0,0,0,0,0,0,0,0,0,0,0,0,0,0,0,0,0,0,0,0,0,0,0,0,0,0,0,0,0,0,0,0,0,0,0,0,0,0,0,0,0,0,0,0
29/6/2010,David Sauget,911778,769,11/23/1979,30,0,0,0,0,4225,5850,5850,135,130,1658271,175,69,D/WB RL,1,2,1,3,3,1,3,1,2,1,3,8,13,10,7,12,7,8,15,12,13,13,14,12,12,12,13,14,11,11,11,11,13,11,9,13,10,14,14,15,13,13,8,13,12,14,20,14,9,11,12,13,9,15,14,16,12,10,12,9,9,14,D/WB RL,115,1,12,1,20,1,1,17,10,20,1,18,1,12,12,1,17,20,1,10,10,17,18,288,0,0,0,0,0,1,0,0,1,0,0,0,0,0,0,0,0,0,0,0,0,0,0,0,0,0,0,0,0,0,0,0,0,0,0,0,0,0,0,0,0,0,0,0,0,0,0,0
29/6/2010,David Murphy,142385,765,3/1/1984,26,0,0,0,0,3600,6350,6350,130,120,2724383,183,85,D L,1,1,2,2,1,2,2,2,2,1,2,11,12,12,11,12,12,11,12,7,13,12,1,13,12,10,11,11,12,12,10,10,18,11,12,12,12,15,13,12,11,12,11,20,12,13,15,15,14,11,9,13,10,6,13,16,11,12,16,13,16,4,D L,103,1,1,10,20,1,1,20,15,1,1,15,1,1,1,10,20,16,1,15,1,15,1,0,0,0,0,0,0,0,0,0,0,0,0,0,0,0,0,0,0,0,0,0,0,0,0,0,0,0,0,0,0,0,0,0,0,0,0,0,0,0,0,0,0,0,0,0,0,0,0,0
29/6/2010,David Ducourtioux,3503562,769,4/11/1978,32,0,0,0,0,4290,5900,5900,134,131,1441142,177,68,D/WB/M/AM R,2,2,2,2,2,1,1,2,3,1,1,11,14,10,8,12,7,10,7,11,11,11,7,12,12,10,13,14,14,14,10,13,14,8,15,10,13,17,16,13,13,12,8,8,18,14,20,16,9,14,10,13,5,12,11,12,16,14,15,15,15,5,D/WB/M/AM R,132,10,17,12,20,1,1,14,17,20,1,17,1,5,17,12,14,20,1,5,17,14,17,2,0,1,0,0,0,0,0,0,0,0,0,0,0,0,0,0,0,0,0,0,0,0,0,0,0,0,0,0,0,0,0,0,0,0,0,0,0,0,0,0,0,0,0,0,0,0,0,0
29/6/2010,David Cortés,6700335,796,8/29/1979,30,0,0,0,0,3969,6250,6250,140,126,2673497,182,70,D/WB R,3,1,1,2,1,1,1,5,1,1,1,7,12,12,4,10,8,13,10,14,14,12,8,13,12,15,12,15,10,13,9,13,16,11,13,15,13,16,16,11,14,10,10,8,10,14,20,15,15,15,13,10,4,15,11,15,15,12,15,13,14,5,D/WB R,112,1,1,6,20,1,1,10,8,20,1,19,1,1,1,6,10,20,1,1,8,10,19,32802,0,1,0,0,0,1,0,0,0,0,0,0,0,0,0,1,0,0,0,0,0,0,0,0,0,0,0,0,0,0,0,0,0,0,0,0,0,0,0,0,0,0,0,0,0,0,0,0
29/6/2010,Danny Simpson,5116936,765,1/4/1987,23,0,0,0,0,3350,6250,6250,138,118,4522259,173,77,D R,1,1,1,1,1,1,1,1,1,1,1,4,11,11,6,13,1,8,4,8,11,10,6,14,12,10,10,12,12,11,8,8,14,12,4,9,10,14,16,17,12,12,7,14,14,17,20,16,10,11,8,10,5,7,10,16,13,14,10,13,13,6,D R,102,1,1,10,20,1,1,14,8,20,1,14,1,1,1,10,14,20,1,1,8,1,14,42,0,1,0,1,0,1,0,0,0,0,0,0,0,0,0,0,0,0,0,0,0,0,0,0,0,0,0,0,0,0,0,0,0,0,0,0,0,0,0,0,0,0,0,0,0,0,0,0
29/6/2010,Danny Coid,122136,765,10/3/1981,28,0,0,0,0,2116,4600,4600,102,92,1425892,181,68,D/WB RL,2,1,3,3,1,3,8,2,2,3,2,10,13,12,8,11,9,6,9,8,11,10,7,11,10,6,6,7,9,9,10,8,12,10,4,11,7,11,13,12,12,11,8,16,11,13,20,11,6,7,4,9,19,19,18,6,18,14,14,15,16,2,D/WB RL,115,1,14,10,20,5,1,18,14,20,1,20,1,10,14,1,18,20,10,14,14,18,20,0,0,0,0,0,0,0,0,0,0,0,0,0,0,0,0,0,0,0,0,0,0,0,0,0,0,0,0,0,0,0,0,0,0,0,0,0,0,0,0,0,0,0,0,0,0,0,0,0
29/6/2010,Danilo,7001090,1651,8/14/1979,30,0,0,0,0,500,4000,4000,100,92,1288384,173,68,D R,3,3,2,1,1,1,1,1,2,1,3,10,12,10,9,11,10,8,10,12,10,10,10,12,11,8,13,10,12,13,9,11,11,10,10,13,11,12,11,12,7,8,8,10,12,12,20,10,8,12,9,10,9,10,10,6,11,10,10,14,13,3,D R,102,1,1,1,20,1,1,1,10,20,1,10,1,1,1,1,11,20,1,1,10,1,10,0,0,0,0,0,0,0,0,0,0,0,0,0,0,0,0,0,0,0,0,0,0,0,0,0,0,0,0,0,0,0,0,0,0,0,0,0,0,0,0,0,0,0,0,0,0,0,0,0
29/6/2010,Daniele Portanova,3801856,776,12/17/1978,31,0,0,0,0,2500,6300,6300,135,132,2303127,185,78,D RC,3,3,3,3,3,2,1,9,1,1,1,7,7,6,9,9,6,16,6,10,16,9,5,14,11,14,13,17,8,14,9,9,20,5,10,11,13,11,14,12,11,18,13,10,15,13,20,14,16,15,8,10,11,10,12,10,18,5,19,11,11,10,D RC,103,1,1,20,20,1,1,1,1,15,1,1,1,1,1,20,1,15,1,1,1,1,1,8796093022208,0,0,0,0,0,0,0,0,0,0,0,0,0,0,0,0,0,0,0,0,0,0,0,0,0,0,0,0,0,0,0,0,0,0,0,0,0,0,0,0,0,0,0,1,0,0,0,0
29/6/2010,Daniele Bonera,3801706,776,5/31/1981,29,16,0,34,0,5250,7350,7350,154,145,14620918,183,74,D RC,2,3,2,3,3,2,3,9,1,1,3,2,13,10,6,12,2,15,8,12,16,13,5,14,12,14,15,13,15,15,10,15,16,5,14,12,16,15,14,14,12,14,11,9,11,14,20,13,14,14,14,10,18,17,13,15,15,15,16,14,15,8,D RC,103,1,1,20,20,1,1,10,1,18,1,14,1,1,1,20,10,18,1,1,1,8,14,0,0,0,0,0,0,0,0,0,0,0,0,0,0,0,0,0,0,0,0,0,0,0,0,0,0,0,0,0,0,0,0,0,0,0,0,0,0,0,0,0,0,0,0,0,0,0,0,0
29/6/2010,Daniel Williams,91003280,771,3/8/1989,21,0,0,0,0,2500,4500,4500,133,105,2239678,180,78,D/DM RLC,1,3,3,2,3,2,3,3,2,3,3,8,7,13,6,14,8,12,6,15,13,12,9,12,14,11,13,9,8,11,10,7,7,8,7,13,11,14,9,10,9,11,14,20,12,13,15,11,10,10,8,9,5,11,10,13,14,9,18,15,12,14,D/DM RLC,326,1,1,20,16,20,1,16,15,15,1,1,1,1,1,1,16,15,15,1,1,1,1,8796093022208,0,0,0,0,0,0,0,0,0,0,0,0,0,0,0,0,0,0,0,0,0,0,0,0,0,0,0,0,0,0,0,0,0,0,0,0,0,0,0,0,0,0,0,1,0,0,0,0
29/6/2010,Daniel Schwaab,35008048,771,8/23/1988,21,0,0,23,1,3900,6600,6600,165,132,5682984,186,75,D/WB R,3,3,2,2,1,2,1,5,2,2,1,10,13,12,4,13,6,10,6,14,12,13,15,12,13,6,12,13,11,11,14,12,17,8,9,11,13,14,14,14,12,12,12,10,14,15,20,17,11,13,3,13,6,15,11,18,15,10,19,19,14,4,D/WB R,112,1,1,12,20,7,1,13,14,20,1,20,1,1,1,12,12,20,1,1,14,13,20,0,0,0,0,0,0,0,0,0,0,0,0,0,0,0,0,0,0,0,0,0,0,0,0,0,0,0,0,0,0,0,0,0,0,0,0,0,0,0,0,0,0,0,0,0,0,0,0,0
29/6/2010,Daniel Estrada,1507539,796,1/3/1987,23,0,0,0,0,3660,5650,5650,132,121,1535647,177,68,D/AM R,3,1,2,2,2,1,2,1,1,2,2,12,13,11,12,9,11,12,12,9,11,11,7,12,12,13,14,12,12,13,11,10,11,10,8,13,9,12,11,14,12,12,11,12,10,14,20,13,10,13,6,9,5,14,13,10,15,11,12,16,15,3,D/AM R,112,1,18,1,20,1,1,9,15,20,1,15,1,9,18,1,1,20,1,1,15,9,15,1099511628288,0,0,0,0,0,0,0,0,0,1,0,0,0,0,0,0,0,0,0,0,0,0,0,0,0,0,0,0,0,0,0,0,0,0,0,0,0,0,0,0,1,0,0,0,0,0,0,0
29/6/2010,Daniel Congré,8431097,769,4/5/1985,25,0,0,5,2,1450,6150,6150,155,137,4011853,184,78,D RC,1,1,1,1,1,3,3,1,2,3,2,5,10,9,6,11,7,16,8,8,16,9,6,13,11,12,14,16,13,13,8,12,17,5,13,6,14,14,14,13,11,15,12,15,13,11,20,14,15,15,12,15,11,12,13,15,17,14,16,15,15,7,D RC,103,1,1,20,20,10,1,12,1,18,1,1,1,1,1,20,12,18,1,1,1,1,1,0,0,0,0,0,0,0,0,0,0,0,0,0,0,0,0,0,0,0,0,0,0,0,0,0,0,0,0,0,0,0,0,0,0,0,0,0,0,0,0,0,0,0,0,0,0,0,0,0
29/6/2010,Daniel Alves,315542,1651,5/6/1983,27,40,3,0,0,7569,8600,8750,179,174,123823809,173,64,D/WB R,2,1,1,1,2,2,2,7,3,1,3,14,16,15,11,15,14,10,14,15,12,15,13,13,15,16,13,15,14,14,16,14,16,15,14,16,12,15,18,17,15,14,6,9,18,18,20,19,13,16,15,12,7,13,17,16,11,13,15,8,10,11,D/WB R,222,1,10,1,19,1,1,7,15,20,1,20,1,1,10,1,7,19,1,1,15,7,20,141836999985186,0,1,0,0,0,1,0,0,0,0,0,1,0,0,0,0,0,0,0,0,0,0,0,0,0,0,0,0,0,0,0,0,0,0,0,0,0,0,0,0,1,0,0,0,0,0,0,1
29/6/2010,Dan Gosling,29007273,765,2/1/1990,20,0,0,2,0,3500,5750,5750,150,122,5648247,178,70,D/DM/M RC,2,1,1,3,1,2,3,3,1,2,1,7,9,13,11,12,8,10,8,2,10,13,9,10,12,9,11,12,14,14,13,12,14,7,14,14,13,13,14,12,12,10,9,12,15,11,20,14,10,15,4,14,7,14,12,12,8,15,15,13,14,2,D/DM/M RC,333,1,13,20,16,20,1,1,20,18,1,10,10,1,13,1,1,16,20,1,18,1,10,17592186044482,0,1,0,0,0,0,1,0,0,0,0,0,0,0,0,0,0,0,0,0,0,0,0,0,0,0,0,0,0,0,0,0,0,0,0,0,0,0,0,0,0,0,0,0,1,0,0,0
29/6/2010,Damiano Ferronetti,829414,776,11/1/1984,25,0,0,5,0,3650,6350,6350,143,132,4781193,185,74,D RC,2,1,1,2,1,1,2,7,2,2,2,3,11,8,8,9,2,16,4,12,15,10,4,15,10,16,15,15,13,13,8,12,15,4,12,8,13,16,15,12,14,14,13,6,13,14,20,14,14,15,13,15,8,15,11,15,18,15,19,14,8,5,D RC,103,1,1,17,20,1,1,1,1,20,1,10,1,1,1,17,9,20,1,1,1,1,10,0,0,0,0,0,0,0,0,0,0,0,0,0,0,0,0,0,0,0,0,0,0,0,0,0,0,0,0,0,0,0,0,0,0,0,0,0,0,0,0,0,0,0,0,0,0,0,0,0
29/6/2010,Damià,7453207,796,4/15/1982,28,0,0,0,0,4225,6400,6400,143,130,2931323,188,79,D/WB/M R,1,2,2,3,2,2,2,4,1,3,1,11,14,13,9,14,6,12,12,11,9,12,8,10,12,13,15,12,14,11,12,11,14,11,8,14,12,15,12,14,11,14,14,7,10,15,20,13,14,14,9,12,10,13,14,15,15,12,15,15,14,8,D/WB/M R,432,1,15,1,16,1,1,1,20,20,1,18,1,1,15,1,1,16,1,1,20,1,18,1099511627776,0,0,0,0,0,0,0,0,0,0,0,0,0,0,0,0,0,0,0,0,0,0,0,0,0,0,0,0,0,0,0,0,0,0,0,0,0,0,0,0,1,0,0,0,0,0,0,0
29/6/2010,Cristian Zaccardo,3801411,776,12/21/1981,28,17,1,21,2,5112,7000,7000,152,143,14606785,183,77,D RC,3,1,1,2,3,2,1,3,2,2,3,9,10,6,9,12,6,16,13,10,16,10,6,16,12,14,16,14,15,15,10,12,15,5,10,12,17,15,15,11,8,10,13,14,12,12,20,15,14,17,10,16,5,12,4,20,18,20,17,17,17,5,D RC,103,1,1,16,20,12,1,13,9,20,3,14,1,1,1,16,13,20,7,4,9,2,14,140758963191808,0,0,0,0,0,0,0,0,0,0,0,0,0,0,0,0,0,0,0,0,0,0,0,0,0,0,0,0,0,0,0,0,1,0,1,0,0,0,0,0,0,0,0,0,0,0,0,1
29/6/2010,Collin Benjamin,5341264,36,8/3/1978,31,36,0,0,0,3250,6800,6850,127,127,1110374,184,79,WB/DM/M RC,3,3,3,2,3,3,2,6,3,1,2,6,10,8,8,10,7,13,9,12,15,10,10,13,12,17,10,16,13,10,11,8,12,5,12,8,12,18,17,15,15,12,14,12,11,14,20,16,16,15,5,13,16,18,16,13,11,12,12,5,5,7,WB/DM/M RC,333,1,1,20,14,20,1,9,18,18,1,16,1,1,1,1,1,14,15,1,18,9,16,0,0,0,0,0,0,0,0,0,0,0,0,0,0,0,0,0,0,0,0,0,0,0,0,0,0,0,0,0,0,0,0,0,0,0,0,0,0,0,0,0,0,0,0,0,0,0,0,0
29/6/2010,Clemens Fritz,6001338,771,12/7/1980,29,22,2,1,0,4356,6900,6900,142,132,37213979,183,81,D/WB/M R,1,2,3,3,1,3,1,3,1,1,3,9,11,9,4,12,6,8,7,14,12,13,8,15,12,10,14,14,12,14,10,12,11,5,10,9,12,17,9,14,12,16,10,14,8,16,20,12,14,9,8,12,16,16,13,13,9,12,12,15,13,7,D/WB/M R,122,10,14,10,20,10,1,5,17,20,1,20,1,5,14,1,5,20,1,5,17,5,20,1048586,0,1,0,1,0,0,0,0,0,0,0,0,0,0,0,0,0,0,0,0,1,0,0,0,0,0,0,0,0,0,0,0,0,0,0,0,0,0,0,0,0,0,0,0,0,0,0,0
29/6/2010,Claudemir,315153,1651,8/17/1984,25,0,0,0,0,2500,5200,5200,110,104,173075,170,63,D/WB R,1,2,3,2,1,1,1,3,1,1,2,14,9,10,7,10,12,12,12,13,10,10,9,9,9,9,8,5,11,12,10,7,10,7,10,9,12,12,14,13,15,10,9,12,14,15,20,16,10,10,11,11,8,10,13,13,11,7,12,12,11,8,D/WB R,112,1,1,10,20,10,1,1,1,20,1,16,1,1,1,1,1,20,1,1,1,1,16,770,0,1,0,0,0,0,0,0,1,1,0,0,0,0,0,0,0,0,0,0,0,0,0,0,0,0,0,0,0,0,0,0,0,0,0,0,0,0,0,0,0,0,0,0,0,0,0,0
29/6/2010,Cicinho,3300310,1651,6/24/1980,30,15,1,0,0,4900,7000,7350,156,140,8560595,172,68,D/WB/M R,2,3,2,2,2,2,1,5,3,3,3,13,15,15,12,16,12,10,13,14,10,15,10,11,14,13,13,15,13,11,13,13,15,14,10,17,8,14,13,16,16,13,6,5,16,15,20,14,11,12,12,16,10,12,5,16,13,16,13,8,12,13,D/WB/M R,232,1,13,1,19,1,1,7,16,20,1,20,1,1,13,1,7,19,1,1,16,7,20,17180918306,0,1,0,0,0,1,0,0,0,1,0,0,0,0,0,0,0,0,0,0,1,0,0,0,0,0,0,0,0,0,0,0,0,0,1,0,0,0,0,0,0,0,0,0,0,0,0,0
29/6/2010,Christos Melissis,682476,772,12/1/1982,27,2,0,0,0,2500,5750,5750,125,115,298035,184,72,D RC,2,2,2,2,3,2,3,1,3,3,2,5,8,8,7,9,4,13,6,10,14,9,5,14,9,12,13,13,12,12,8,12,16,10,9,10,12,13,14,13,12,12,14,7,16,14,20,14,14,12,8,13,5,16,5,13,15,16,18,15,14,6,D RC,103,1,1,20,20,12,1,7,1,15,10,5,1,1,1,20,7,15,1,1,1,1,5,2251799813685248,0,0,0,0,0,0,0,0,0,0,0,0,0,0,0,0,0,0,0,0,0,0,0,0,0,0,0,0,0,0,0,0,0,0,0,0,0,0,0,0,0,0,0,0,0,0,0,0
29/6/2010,Christopher Schorch,35012895,771,1/30/1989,21,0,0,0,0,3250,5750,5750,138,115,2971443,189,83,D RC,3,3,1,3,1,2,3,4,3,1,1,5,9,7,4,11,4,16,5,16,12,9,5,13,11,12,9,13,5,9,5,10,10,5,8,6,10,13,14,13,9,12,15,16,12,15,20,11,17,10,6,9,11,9,14,6,12,11,10,6,5,1,D RC,103,1,1,20,20,5,1,10,1,16,1,7,1,1,1,20,10,16,1,1,1,1,7,0,0,0,0,0,0,0,0,0,0,0,0,0,0,0,0,0,0,0,0,0,0,0,0,0,0,0,0,0,0,0,0,0,0,0,0,0,0,0,0,0,0,0,0,0,0,0,0,0
29/6/2010,Christophe Jallet,8427430,769,10/31/1983,26,0,0,0,0,4970,6350,6350,150,141,8885516,178,65,D/WB/M R,2,2,1,3,3,1,1,1,3,2,2,10,13,11,8,11,13,9,12,12,11,14,12,14,11,9,13,14,14,14,13,13,16,8,12,12,13,16,15,15,13,12,9,8,16,14,20,20,10,16,9,13,6,16,10,13,15,16,16,16,18,5,D/WB/M R,122,1,12,14,20,14,1,10,18,20,1,18,1,1,12,10,10,20,10,1,18,10,18,137438953474,0,1,0,0,0,0,0,0,0,0,0,0,0,0,0,0,0,0,0,0,0,0,0,0,0,0,0,0,0,0,0,0,0,0,0,0,0,1,0,0,0,0,0,0,0,0,0,0
29/6/2010,Christian Träsch,35003512,771,8/1/1987,22,1,0,0,0,2750,6850,6850,151,148,19298213,180,74,D/WB/DM/M RLC,3,2,2,3,1,3,3,1,3,1,2,9,12,8,6,7,9,6,15,15,17,10,9,17,7,16,15,17,9,17,8,12,13,5,12,9,13,19,18,15,10,10,11,16,17,13,20,18,11,18,4,15,6,18,10,17,10,10,12,14,2,2,D/WB/DM/M RLC,446,1,1,20,19,19,1,18,20,19,1,18,1,1,1,10,18,19,20,12,15,16,18,154618856000,0,0,0,0,0,0,1,0,0,1,0,0,0,0,0,1,0,0,0,0,0,0,0,0,0,0,0,0,0,0,0,0,0,0,1,0,0,1,0,0,0,0,0,0,0,0,0,0
29/6/2010,Christian Maggio,6100081,776,2/11/1982,28,6,0,2,0,2000,7400,7400,159,150,17312919,184,79,WB/M R,3,3,1,3,3,1,1,3,3,1,2,10,14,11,12,13,4,14,9,13,9,14,2,13,13,14,12,17,11,14,11,12,10,7,10,18,16,17,17,17,17,12,12,5,15,17,20,15,13,12,4,17,12,11,10,15,15,15,15,18,10,20,WB/M R,422,1,15,1,14,1,1,1,20,20,1,18,1,1,15,1,1,14,1,1,20,1,18,134217762,0,1,0,0,0,1,0,0,0,0,0,0,0,0,0,0,0,0,0,0,0,0,0,0,0,0,0,1,0,0,0,0,0,0,0,0,0,0,0,0,0,0,0,0,0,0,0,0
29/6/2010,Chris Baird,5102412,785,2/25/1982,28,44,0,6,1,4290,6500,6200,135,131,10210585,181,75,D RC,2,1,3,1,3,3,3,4,1,3,3,5,11,8,5,13,6,14,8,11,16,13,7,15,12,11,14,15,14,13,10,14,14,9,13,13,16,15,15,12,10,12,12,5,14,12,20,15,14,15,8,14,6,16,10,9,17,15,15,13,16,1,D RC,103,1,1,20,20,15,1,1,15,20,1,8,1,1,1,20,13,20,15,1,1,1,5,283467841536,0,0,0,0,0,0,0,0,0,0,0,0,0,0,0,0,0,0,0,0,0,0,0,0,0,0,0,0,0,0,0,0,0,1,0,0,0,0,1,0,0,0,0,0,0,0,0,0
29/6/2010,Charles Kaboré,34013978,9,2/9/1988,22,20,1,0,0,4830,6950,6250,165,139,12766689,181,75,DM/M RC,2,3,2,2,1,1,3,1,1,1,3,8,10,12,6,13,6,13,13,8,12,12,11,14,12,16,15,15,13,13,11,13,16,8,14,9,13,14,17,14,12,14,10,8,17,14,20,17,15,13,12,15,5,11,15,15,14,16,13,14,16,7,DM/M RC,423,1,1,20,15,17,1,1,20,15,1,15,1,1,1,8,1,15,20,1,10,1,15,64,0,0,0,0,0,0,1,0,0,0,0,0,0,0,0,0,0,0,0,0,0,0,0,0,0,0,0,0,0,0,0,0,0,0,0,0,0,0,0,0,0,0,0,0,0,0,0,0
29/6/2010,César Azpilicueta,67033300,796,8/28/1989,20,0,0,9,1,4970,7050,6350,163,141,33610183,178,70,D/WB R,2,1,2,1,3,2,1,4,3,1,1,8,15,10,8,12,7,7,10,17,14,12,8,15,12,17,12,16,12,16,8,12,16,8,13,13,13,17,15,15,12,12,9,8,17,15,20,18,11,15,12,14,2,20,15,13,18,11,18,14,11,7,D/WB R,112,1,1,10,20,10,1,10,14,20,1,18,1,1,1,1,10,20,10,8,14,8,18,1126174784749600,0,0,0,0,0,1,0,0,0,0,0,0,0,0,0,0,0,0,0,0,0,0,0,0,0,0,0,0,0,0,0,0,0,0,0,0,0,0,1,0,0,0,0,0,0,0,0,0
29/6/2010,Cerra,7443805,796,6/4/1983,27,0,0,0,0,3600,5250,5250,132,120,1662910,177,68,D RL,2,1,1,1,3,3,3,6,2,1,2,5,11,10,6,10,5,11,9,12,13,11,6,12,10,12,12,12,14,15,8,13,11,7,9,12,14,14,14,13,12,11,7,12,13,13,20,14,12,15,12,12,6,13,12,11,13,11,15,15,10,10,D RL,105,1,1,1,20,1,1,15,5,20,1,14,1,1,1,1,15,20,1,1,5,10,14,32,0,0,0,0,0,1,0,0,0,0,0,0,0,0,0,0,0,0,0,0,0,0,0,0,0,0,0,0,0,0,0,0,0,0,0,0,0,0,0,0,0,0,0,0,0,0,0,0
29/6/2010,Cédric Mongongu,8432567,53,6/22/1989,21,4,0,0,0,3350,6500,5850,165,130,5608290,189,78,D RC,3,1,3,2,3,3,2,5,3,2,3,5,9,9,6,12,6,17,8,5,16,13,8,13,11,13,15,14,13,8,9,13,10,6,11,7,15,15,14,15,10,17,14,7,16,12,20,14,17,14,13,10,7,10,3,15,11,12,7,12,10,8,D RC,103,1,1,20,20,14,1,1,1,15,1,15,1,1,1,20,1,15,1,1,1,1,15,0,0,0,0,0,0,0,0,0,0,0,0,0,0,0,0,0,0,0,0,0,0,0,0,0,0,0,0,0,0,0,0,0,0,0,0,0,0,0,0,0,0,0,0,0,0,0,0,0
29/6/2010,Cédric Hengbart,913665,769,7/13/1980,29,0,0,0,0,1450,6250,6250,142,139,6050758,183,73,D R,1,3,1,3,3,3,3,4,2,2,1,6,13,8,11,11,12,14,13,12,12,11,15,17,11,11,13,14,14,14,9,12,14,6,14,11,14,13,16,14,11,14,11,12,15,11,20,16,14,15,11,15,5,8,10,13,14,14,14,14,14,5,D R,102,1,1,1,20,1,1,13,1,20,1,15,1,1,1,1,13,20,1,1,1,13,15,32,0,0,0,0,0,1,0,0,0,0,0,0,0,0,0,0,0,0,0,0,0,0,0,0,0,0,0,0,0,0,0,0,0,0,0,0,0,0,0,0,0,0,0,0,0,0,0,0
29/6/2010,Ceará,6900550,1651,6/18/1980,30,0,0,0,0,4900,6300,6300,148,140,5137146,175,75,D/WB RL,1,1,3,2,2,3,3,5,2,3,1,12,13,12,6,13,13,9,12,16,12,11,9,13,13,11,13,14,15,12,12,13,16,12,8,11,13,14,16,15,14,13,7,10,15,14,20,16,12,15,9,12,7,12,11,13,12,14,17,14,14,7,D/WB RL,115,1,1,10,20,10,1,15,10,20,1,18,1,1,1,1,15,20,10,8,10,15,18,4294967810,0,1,0,0,0,0,0,0,0,1,0,0,0,0,0,0,0,0,0,0,0,0,0,0,0,0,0,0,0,0,0,0,1,0,0,0,0,0,0,0,0,0,0,0,0,0,0,0
29/6/2010,Carsten Rothenbach,877016,771,9/3/1980,29,0,0,0,0,3000,6350,6350,127,127,1886120,185,82,D/WB RC,1,3,1,2,2,2,2,1,3,3,2,5,12,8,6,11,8,13,9,13,13,10,3,14,8,12,14,14,13,14,7,13,12,7,12,9,13,15,11,10,9,12,13,15,13,12,20,14,15,11,14,13,9,15,9,6,12,14,13,11,6,19,D/WB RC,113,1,5,15,20,14,1,14,10,20,1,19,1,1,5,15,14,20,1,1,10,13,19,0,0,0,0,0,0,0,0,0,0,0,0,0,0,0,0,0,0,0,0,0,0,0,0,0,0,0,0,0,0,0,0,0,0,0,0,0,0,0,0,0,0,0,0,0,0,0,0,0
29/6/2010,Carsten Cullmann,3600836,771,3/5/1976,34,0,0,0,0,2250,4550,4550,130,96,183114,187,82,D RC,2,1,1,1,2,2,3,2,3,3,2,9,9,7,8,7,7,16,8,16,12,8,6,13,8,12,10,16,11,9,7,10,13,8,14,8,12,15,15,11,9,9,15,5,11,10,20,14,14,8,8,10,13,15,3,12,20,9,8,15,14,2,D RC,103,1,1,15,20,5,1,5,5,20,12,14,1,1,1,15,5,20,1,1,5,1,14,0,0,0,0,0,0,0,0,0,0,0,0,0,0,0,0,0,0,0,0,0,0,0,0,0,0,0,0,0,0,0,0,0,0,0,0,0,0,0,0,0,0,0,0,0,0,0,0,0
29/6/2010,Carlos Valencia,14008007,1653,4/28/1989,21,0,0,0,0,1450,4634,5000,124,103,481374,172,62,D/WB R,1,2,1,2,2,2,3,2,1,3,3,13,13,14,8,14,7,6,11,14,8,12,12,8,14,13,11,13,12,10,12,10,15,15,6,16,9,10,11,15,15,12,7,6,13,15,20,13,10,14,5,12,5,13,14,11,13,12,11,11,13,5,D/WB R,112,1,1,1,20,1,1,10,12,20,1,20,1,1,1,1,10,20,1,10,12,10,20,1099511627778,0,1,0,0,0,0,0,0,0,0,0,0,0,0,0,0,0,0,0,0,0,0,0,0,0,0,0,0,0,0,0,0,0,0,0,0,0,0,0,0,1,0,0,0,0,0,0,0
29/6/2010,Carlos Martínez,1511410,796,4/9/1986,24,0,0,0,0,3782,5650,5650,134,123,5784201,188,78,D R,3,3,2,2,3,2,1,5,1,1,2,5,10,12,7,8,5,10,4,10,12,10,5,14,9,16,13,16,14,12,9,12,11,11,10,13,11,14,18,12,9,13,15,11,11,14,20,16,15,14,10,11,9,13,13,14,15,13,14,14,10,6,D R,102,1,1,14,20,1,1,1,9,20,1,15,1,1,1,14,5,20,1,1,9,1,15,0,0,0,0,0,0,0,0,0,0,0,0,0,0,0,0,0,0,0,0,0,0,0,0,0,0,0,0,0,0,0,0,0,0,0,0,0,0,0,0,0,0,0,0,0,0,0,0,0
29/6/2010,Carlos Diogo,5512488,1657,7/18/1983,26,23,0,9,1,4624,7000,6750,151,136,3484636,186,79,D/WB R,1,1,3,1,3,2,3,4,2,3,3,9,13,13,10,15,8,14,13,13,11,13,10,17,13,16,12,17,8,12,12,11,13,12,11,14,12,13,15,11,12,17,12,11,15,14,20,16,12,13,15,13,11,10,12,13,10,14,12,9,6,8,D/WB R,112,1,8,10,20,10,1,5,13,20,4,18,2,1,8,2,5,20,6,1,13,3,18,137438953504,0,0,0,0,0,1,0,0,0,0,0,0,0,0,0,0,0,0,0,0,0,0,0,0,0,0,0,0,0,0,0,0,0,0,0,0,0,1,0,0,0,0,0,0,0,0,0,0
29/6/2010,Carlos Cuéllar,815160,796,8/23/1981,28,0,0,0,0,5184,6750,7200,155,144,39895331,190,84,D RC,2,1,1,3,2,3,3,3,3,2,3,7,3,5,7,12,7,15,5,13,16,4,7,15,12,13,15,14,13,16,7,11,14,2,14,9,17,15,15,13,12,15,15,8,16,12,20,16,15,14,14,12,4,10,15,18,4,12,14,10,12,5,D RC,103,1,1,20,20,1,1,1,1,17,10,1,1,1,1,20,1,17,1,1,1,1,1,137438953536,0,0,0,0,0,0,1,0,0,0,0,0,0,0,0,0,0,0,0,0,0,0,0,0,0,0,0,0,0,0,0,0,0,0,0,0,0,1,0,0,0,0,0,0,0,0,0,0
29/6/2010,Carlitos,734151,788,12/5/1981,28,0,0,0,0,1250,5450,5450,110,109,236141,168,65,D R,3,2,1,2,3,2,2,1,2,2,3,11,16,13,9,11,17,7,12,9,7,8,11,12,13,13,10,14,11,14,10,11,14,8,10,15,10,2,14,15,14,7,8,10,10,14,20,11,10,10,8,10,8,12,10,7,14,12,12,12,14,5,D R,102,1,10,1,20,1,1,1,12,20,1,10,1,1,10,1,10,20,1,1,12,1,10,0,0,0,0,0,0,0,0,0,0,0,0,0,0,0,0,0,0,0,0,0,0,0,0,0,0,0,0,0,0,0,0,0,0,0,0,0,0,0,0,0,0,0,0,0,0,0,0,0
29/6/2010,Carles Puyol,4206586,796,4/13/1978,32,90,3,9,0,7140,8600,8600,177,169,125362916,178,80,D RC,2,2,2,3,2,2,1,9,1,3,3,6,9,8,7,12,6,13,8,12,17,11,8,18,10,18,17,20,16,18,10,13,19,7,18,8,18,20,19,15,14,17,11,8,14,12,20,18,16,18,14,16,13,14,12,16,18,18,18,14,11,6,D RC,103,1,1,20,20,1,1,8,1,15,14,12,1,1,1,20,8,15,1,1,1,1,12,281758444584960,0,0,0,0,0,0,0,0,0,0,0,0,0,0,0,1,0,0,0,0,0,0,0,0,0,0,0,0,0,0,0,0,0,1,0,0,0,0,1,0,0,0,0,0,0,0,0,0
29/6/2010,Camilo Zúñiga,8829100,1653,12/14/1985,24,7,0,15,2,3500,6299,6950,157,140,7898017,172,72,D/WB R,3,3,2,1,1,3,3,4,1,1,3,11,13,15,9,11,8,8,12,13,12,12,10,12,14,14,13,12,14,13,15,12,13,13,10,12,13,14,15,17,15,11,8,9,13,16,20,11,12,15,10,12,9,12,17,16,16,12,13,14,16,9,D/WB R,112,1,1,1,20,1,1,13,14,20,1,20,1,1,1,1,12,20,1,13,14,13,20,1099645845504,0,0,0,0,0,0,0,0,0,0,0,0,0,0,0,0,0,0,0,0,0,0,0,0,0,0,0,1,0,0,0,0,0,0,0,0,0,0,0,0,1,0,0,0,0,0,0,0
29/6/2010,Bruno,814310,796,10/1/1980,29,0,0,0,0,4830,6750,6750,141,139,758333,181,76,D RL,3,1,2,3,2,2,1,6,1,2,3,7,12,11,4,12,9,13,10,13,16,12,9,15,12,15,14,15,11,16,10,13,10,6,11,12,15,16,15,12,11,14,10,9,14,13,20,16,11,17,13,11,7,15,7,12,5,12,9,15,11,14,D RL,105,1,1,12,20,12,1,15,8,20,5,13,1,1,1,9,15,20,5,3,8,8,13,17179869184,0,0,0,0,0,0,0,0,0,0,0,0,0,0,0,0,0,0,0,0,0,0,0,0,0,0,0,0,0,0,0,0,0,0,1,0,0,0,0,0,0,0,0,0,0,0,0,0
29/6/2010,Bruno Patacas,4100289,788,11/30/1977,32,0,0,29,0,2500,6000,6000,126,120,372056,176,73,D R,2,3,3,2,2,1,2,1,2,3,2,11,12,11,6,11,5,8,11,10,10,10,9,14,9,16,12,16,15,13,10,13,15,8,15,15,14,15,16,12,13,13,10,6,12,13,20,14,12,16,7,12,5,5,9,11,16,15,15,15,16,4,D R,102,1,1,1,20,1,1,1,5,20,1,10,1,1,1,1,1,20,1,1,5,1,10,268435458,0,1,0,0,0,0,0,0,0,0,0,0,0,0,0,0,0,0,0,0,0,0,0,0,0,0,0,0,1,0,0,0,0,0,0,0,0,0,0,0,0,0,0,0,0,0,0,0
29/6/2010,Bruno Montelongo,78017667,1657,9/12/1987,22,0,0,3,0,3250,5624,5000,140,125,473610,182,72,D/WB/DM/M RC,3,1,1,2,2,3,2,4,1,3,2,10,11,12,11,12,12,11,8,10,12,12,10,11,13,11,11,13,13,12,12,13,13,9,12,14,12,14,14,12,13,12,11,10,14,14,20,14,12,11,8,12,7,20,13,8,13,12,12,11,14,6,D/WB/DM/M RC,443,5,10,18,17,18,1,13,20,20,1,19,10,1,8,8,13,17,15,6,20,10,19,2147483680,0,0,0,0,0,1,0,0,0,0,0,0,0,0,0,0,0,0,0,0,0,0,0,0,0,0,0,0,0,0,0,1,0,0,0,0,0,0,0,0,0,0,0,0,0,0,0,0
29/6/2010,Briguel,7002206,788,3/8/1979,31,0,0,5,0,1250,5000,5000,107,102,116804,174,70,D RL,1,3,1,3,3,2,9,4,1,3,1,11,12,11,6,11,11,8,10,15,10,10,10,12,12,9,10,9,12,11,9,10,14,10,7,11,12,13,12,14,13,8,7,13,12,13,20,10,9,9,6,10,9,13,11,15,13,10,13,12,9,3,D RL,105,1,5,1,20,1,1,17,10,20,1,10,1,5,1,1,17,20,1,10,10,10,10,17180919809,1,0,0,0,0,0,0,0,0,0,0,1,0,0,0,0,0,0,0,0,1,0,0,0,0,0,0,0,0,0,0,0,0,0,1,0,0,0,0,0,0,0,0,0,0,0,0,0
29/6/2010,Brett Emerton,128804,1435,2/22/1979,31,75,17,0,0,4692,7400,6750,148,137,5149096,185,85,D/M RC,2,2,3,1,1,2,1,1,1,3,3,10,13,10,9,12,11,12,8,8,12,12,6,14,12,16,12,16,12,14,12,10,17,11,15,13,13,17,19,13,12,15,13,8,20,13,20,20,15,17,10,16,7,16,16,13,19,15,17,14,16,1,D/M RC,423,1,10,16,16,10,1,1,20,20,1,1,1,1,10,1,1,16,16,1,20,1,1,17314611200,0,0,0,0,0,0,0,0,0,0,0,0,0,0,0,0,0,0,0,1,0,0,0,0,0,0,0,1,0,0,0,0,0,0,1,0,0,0,0,0,0,0,0,0,0,0,0,0
29/6/2010,Branislav Ivanovic,5743241,802,4/22/1984,26,34,4,37,5,6480,7650,7750,163,161,105617647,185,89,D RC,3,3,3,3,2,2,1,3,3,3,1,7,12,10,10,14,10,16,7,15,15,12,10,17,11,12,15,16,12,14,13,14,15,6,11,14,16,14,15,15,11,14,12,10,10,13,20,16,16,16,10,13,10,14,12,16,11,14,13,15,12,10,D RC,103,1,1,18,20,1,1,12,1,20,1,14,1,1,1,18,12,20,1,1,1,12,14,0,0,0,0,0,0,0,0,0,0,0,0,0,0,0,0,0,0,0,0,0,0,0,0,0,0,0,0,0,0,0,0,0,0,0,0,0,0,0,0,0,0,0,0,0,0,0,0,0
29/6/2010,Blazej Augustyn,29003178,787,1/26/1988,22,0,0,0,0,3192,5084,5500,142,113,1833399,191,89,D/WB RLC,2,2,2,3,3,2,1,1,3,2,2,4,12,7,6,10,9,12,15,10,12,12,9,13,10,13,12,13,10,11,11,12,14,7,8,12,12,11,13,12,12,13,13,6,8,11,20,13,13,12,13,10,8,12,15,12,11,12,15,12,12,14,D/WB RLC,116,1,1,19,20,15,1,20,15,15,1,18,1,1,1,19,20,15,15,1,1,18,14,512,0,0,0,0,0,0,0,0,0,1,0,0,0,0,0,0,0,0,0,0,0,0,0,0,0,0,0,0,0,0,0,0,0,0,0,0,0,0,0,0,0,0,0,0,0,0,0,0
29/6/2010,Besart Ibraimi,8408705,781,12/17/1986,23,0,0,0,0,2250,4750,4250,126,105,5405172,182,86,WB/M RC,3,2,3,1,3,1,3,2,3,2,3,9,12,11,10,12,10,9,11,10,10,14,11,12,17,13,14,7,12,13,11,13,12,11,6,11,10,13,12,10,9,14,9,12,12,9,20,9,11,14,9,10,7,9,13,14,12,13,13,13,11,5,WB/M RC,213,1,10,20,1,10,1,1,20,20,1,20,10,1,1,1,1,1,20,1,20,1,20,0,0,0,0,0,0,0,0,0,0,0,0,0,0,0,0,0,0,0,0,0,0,0,0,0,0,0,0,0,0,0,0,0,0,0,0,0,0,0,0,0,0,0,0,0,0,0,0,0
29/6/2010,Benjamin Angoua,38001740,24,11/28/1986,23,7,1,4,1,3481,5900,5300,140,118,2686252,183,72,D/DM RC,2,2,3,2,2,1,3,8,2,1,1,5,9,6,6,7,5,14,7,10,13,8,6,13,7,13,15,14,15,13,10,12,13,9,6,8,13,15,13,10,12,14,12,10,13,14,20,15,13,15,13,13,8,10,14,12,13,13,14,11,11,7,D/DM RC,113,1,1,20,20,18,1,1,15,15,1,15,1,1,1,20,1,15,15,1,1,1,15,0,0,0,0,0,0,0,0,0,0,0,0,0,0,0,0,0,0,0,0,0,0,0,0,0,0,0,0,0,0,0,0,0,0,0,0,0,0,0,0,0,0,0,0,0,0,0,0,0
29/6/2010,Bakary Soro,8631066,24,12/5/1985,24,0,0,5,0,3300,5750,5150,140,115,2149819,184,74,D/WB RC,3,1,1,2,1,1,2,1,1,2,1,5,11,8,5,8,6,14,6,10,12,9,7,13,9,14,12,13,13,13,8,12,17,7,13,8,13,13,13,13,10,14,12,8,14,11,20,16,14,14,13,11,9,12,8,13,13,12,15,15,15,6,D/WB RC,113,1,1,20,20,12,1,10,8,17,1,17,1,1,1,20,10,17,8,1,1,10,17,0,0,0,0,0,0,0,0,0,0,0,0,0,0,0,0,0,0,0,0,0,0,0,0,0,0,0,0,0,0,0,0,0,0,0,0,0,0,0,0,0,0,0,0,0,0,0,0,0
29/6/2010,Bakary Sagna,8430030,769,2/14/1983,27,23,0,28,0,6480,7250,8000,168,161,-1,181,73,D/WB R,2,1,2,3,3,1,3,2,3,1,3,12,10,11,5,14,7,15,8,8,14,14,5,16,14,12,15,16,15,14,13,14,16,10,9,13,13,15,17,17,14,14,11,10,18,16,20,17,13,17,8,14,5,10,16,16,16,14,14,14,15,9,D/WB R,112,1,1,12,20,1,1,14,1,20,1,18,1,1,1,12,14,20,1,1,1,14,18,403734562,0,1,0,0,0,1,0,0,0,0,0,0,0,0,0,1,0,0,0,0,1,0,0,0,0,0,0,1,1,0,0,0,0,0,0,0,0,0,0,0,0,0,0,0,0,0,0,0
29/6/2010,Baiano,55012136,1651,2/23/1987,23,0,0,0,0,1000,3000,5250,117,108,154843,173,65,D R,2,3,3,1,3,2,1,1,2,3,2,12,13,11,9,12,12,10,12,13,11,11,12,13,13,11,12,10,13,11,10,11,9,10,8,14,11,12,13,14,14,12,10,6,14,14,20,12,12,11,10,10,9,9,11,12,11,11,12,12,12,5,D R,102,1,1,1,20,1,1,10,1,20,1,10,1,1,1,1,10,20,1,1,1,1,10,0,0,0,0,0,0,0,0,0,0,0,0,0,0,0,0,0,0,0,0,0,0,0,0,0,0,0,0,0,0,0,0,0,0,0,0,0,0,0,0,0,0,0,0,0,0,0,0,0
29/6/2010,Atsuto Uchida,788633,116,3/27/1988,22,31,1,12,0,4100,6500,6500,152,130,20318043,176,62,D/WB R,2,3,3,1,1,1,1,3,1,1,1,11,17,13,7,14,10,9,6,13,11,15,8,12,15,13,9,14,9,10,13,13,13,12,7,16,8,17,18,16,17,6,7,9,10,15,20,16,6,14,4,10,7,10,6,10,11,12,15,14,8,8,D/WB R,112,1,1,1,20,1,1,1,12,20,1,18,1,1,1,1,13,20,1,1,12,1,18,1099646894090,0,1,0,1,0,0,0,0,0,0,0,0,0,0,0,0,0,0,0,0,1,0,0,0,0,0,0,1,0,0,0,0,0,0,0,0,0,0,0,0,1,0,0,0,0,0,0,0
29/6/2010,Arne Friedrich,6002074,771,5/29/1979,31,79,1,5,0,5852,8150,8150,153,153,12553294,185,80,D RC,2,2,2,3,1,3,2,6,3,3,1,4,8,7,3,10,5,12,4,13,17,8,7,16,9,12,16,13,15,18,7,10,11,3,12,6,17,19,14,15,9,14,16,9,17,17,20,15,16,11,6,19,11,10,2,4,18,13,20,17,19,6,D RC,103,1,1,20,20,1,1,1,1,17,1,12,1,1,1,20,1,17,1,1,1,1,12,8589967424,0,0,0,0,0,0,1,0,0,0,0,0,0,0,0,1,0,0,0,0,0,0,0,0,0,0,0,0,0,0,0,0,0,1,0,0,0,0,0,0,0,0,0,0,0,0,0,0
29/6/2010,Antonio Buscè,705660,776,12/12/1975,34,0,0,0,0,750,6150,6150,130,128,545896,180,73,D/WB/M/AM R,1,3,3,2,1,1,1,1,2,1,3,10,14,12,11,8,9,7,10,7,11,13,8,8,12,11,11,12,12,12,11,13,14,11,13,12,10,13,11,12,12,12,8,12,12,17,20,16,12,12,8,12,7,11,8,13,16,20,14,13,5,4,D/WB/M/AM R,442,1,20,1,16,1,1,1,20,20,1,16,1,1,20,1,1,16,1,1,20,1,16,0,0,0,0,0,0,0,0,0,0,0,0,0,0,0,0,0,0,0,0,0,0,0,0,0,0,0,0,0,0,0,0,0,0,0,0,0,0,0,0,0,0,0,0,0,0,0,0,0
29/6/2010,Anthony Vanden Borre,8152564,757,10/24/1987,22,22,1,6,2,4096,5759,5750,152,128,880576,185,80,WB/DM/M RC,1,2,1,1,1,2,2,4,1,1,2,14,14,14,10,16,13,10,9,13,12,13,14,15,16,12,16,14,16,7,10,10,16,15,6,16,11,10,11,12,12,15,11,5,17,14,20,16,13,9,12,7,7,19,8,14,7,12,7,11,10,13,WB/DM/M RC,433,1,1,20,15,16,1,10,20,18,7,18,1,1,1,15,5,15,20,10,15,5,18,0,0,0,0,0,0,0,0,0,0,0,0,0,0,0,0,0,0,0,0,0,0,0,0,0,0,0,0,0,0,0,0,0,0,0,0,0,0,0,0,0,0,0,0,0,0,0,0,0
29/6/2010,Anthony Réveillère,3503533,769,11/10/1979,30,6,0,24,1,5625,6750,6750,160,150,20385282,181,76,D R,1,3,1,3,3,1,2,7,1,3,3,14,14,12,6,12,9,13,13,11,14,13,8,14,13,10,14,14,14,14,11,12,16,7,13,10,15,15,14,15,12,14,10,15,14,14,20,15,14,13,10,15,10,10,12,17,16,14,15,14,13,8,D R,102,1,1,1,20,1,1,13,1,20,1,15,1,1,1,1,13,20,1,1,1,13,15,274877906944,0,0,0,0,0,0,0,0,0,0,0,0,0,0,0,0,0,0,0,0,0,0,0,0,0,0,0,0,0,0,0,0,0,0,0,0,0,0,1,0,0,0,0,0,0,0,0,0
29/6/2010,Ângelo,306503,1651,6/12/1981,29,0,0,0,0,2000,5950,6100,123,123,1407138,175,78,D/WB R,1,1,2,3,2,3,3,4,3,3,1,12,13,11,10,7,8,8,11,10,9,13,1,12,11,13,14,10,10,8,13,9,13,9,12,16,10,15,17,17,13,6,9,10,9,16,20,16,12,11,13,11,13,13,14,12,13,12,15,14,13,8,D/WB R,112,1,7,1,20,1,1,1,15,20,1,20,1,1,7,1,13,20,1,1,15,1,20,1099512676354,0,1,0,0,0,0,0,0,0,0,0,0,0,0,0,0,0,0,0,0,1,0,0,0,0,0,0,0,0,0,0,0,0,0,0,0,0,0,0,0,1,0,0,0,0,0,0,0
29/6/2010,Ángel,824089,796,3/10/1981,29,5,0,14,0,5112,7000,7000,148,143,37182239,180,71,D/WB RL,1,2,3,2,1,1,1,2,3,2,3,8,14,11,10,10,6,12,6,6,13,13,10,15,12,14,12,14,11,13,10,12,15,11,12,16,14,15,17,13,11,13,10,14,15,14,20,18,10,15,13,15,10,17,15,13,17,11,12,13,9,7,D/WB RL,115,1,4,5,20,5,1,17,10,20,7,18,1,2,4,5,17,20,3,8,10,15,18,32,0,0,0,0,0,1,0,0,0,0,0,0,0,0,0,0,0,0,0,0,0,0,0,0,0,0,0,0,0,0,0,0,0,0,0,0,0,0,0,0,0,0,0,0,0,0,0,0
29/6/2010,Andy Wilkinson,5107983,765,8/6/1984,25,0,0,0,0,3550,6150,6150,137,128,14972557,181,70,D RC,2,2,3,3,3,3,2,4,3,3,2,7,9,8,7,11,5,14,8,11,13,11,5,14,13,17,12,18,10,13,8,13,15,9,15,9,14,15,16,12,11,12,11,5,14,13,20,15,16,15,17,12,15,16,5,7,15,12,15,10,15,8,D RC,103,1,1,20,20,5,1,14,1,18,1,10,1,1,1,20,14,18,1,1,1,1,10,137438953472,0,0,0,0,0,0,0,0,0,0,0,0,0,0,0,0,0,0,0,0,0,0,0,0,0,0,0,0,0,0,0,0,0,0,0,0,0,1,0,0,0,0,0,0,0,0,0,0
29/6/2010,Andrézinho,2115569,1651,10/9/1981,28,0,0,0,0,3000,5150,6350,135,128,4519195,174,64,D RL,1,3,1,2,2,2,2,6,3,1,2,12,13,11,7,13,13,7,10,11,10,12,7,13,13,13,12,14,8,12,7,12,13,10,4,19,12,12,13,15,12,13,9,15,13,15,20,13,13,11,12,12,7,12,14,12,13,14,14,14,14,7,D RL,105,1,5,1,20,1,1,17,8,20,1,14,1,5,5,1,17,20,1,8,8,14,14,1048608,0,0,0,0,0,1,0,0,0,0,0,0,0,0,0,0,0,0,0,0,1,0,0,0,0,0,0,0,0,0,0,0,0,0,0,0,0,0,0,0,0,0,0,0,0,0,0,0
29/6/2010,Andreas Ibertsberger,5601906,755,7/27/1982,27,14,1,7,0,3700,6000,6400,128,127,4060383,178,77,D RL,2,2,2,1,3,1,2,5,2,1,3,5,8,7,5,10,6,8,9,12,14,9,8,15,10,13,16,12,9,12,7,10,13,6,10,8,14,16,14,14,16,12,10,20,13,13,15,16,11,15,8,13,10,14,13,12,13,12,15,14,15,3,D RL,105,1,1,1,20,1,1,20,1,17,1,14,1,1,1,1,20,17,1,1,1,11,14,1048577,1,0,0,0,0,0,0,0,0,0,0,0,0,0,0,0,0,0,0,0,1,0,0,0,0,0,0,0,0,0,0,0,0,0,0,0,0,0,0,0,0,0,0,0,0,0,0,0
29/6/2010,Andreas Beck,8723862,771,3/13/1987,23,3,0,27,2,3650,7300,7300,161,144,6774224,180,70,D/WB RL,2,2,2,3,3,1,2,3,2,2,1,7,10,12,5,11,5,8,6,10,11,12,8,15,13,16,15,14,10,11,13,15,16,8,12,15,10,17,18,16,15,10,9,15,16,15,20,18,9,13,5,12,6,13,15,12,12,10,17,16,18,2,D/WB RL,115,1,1,12,20,12,1,15,1,20,1,17,1,1,1,10,15,20,1,1,1,12,17,274895732746,0,1,0,1,0,0,0,0,0,0,0,0,0,0,0,0,0,0,0,0,1,0,0,0,1,0,0,0,0,0,0,0,0,0,0,0,0,0,1,0,0,0,0,0,0,0,0,0
29/6/2010,Andrea Rispoli,43017761,776,9/29/1988,21,0,0,2,1,1050,5700,5700,157,119,931124,181,78,D/WB/M RL,1,1,2,3,1,2,2,1,3,1,3,9,13,12,9,10,4,7,10,10,8,11,7,11,14,8,13,7,10,14,10,10,10,11,8,15,11,10,14,15,12,8,5,5,14,15,20,13,10,13,8,12,6,15,8,17,12,5,6,13,9,5,D/WB/M RL,235,1,1,1,18,1,1,17,17,20,1,20,1,1,1,1,13,18,1,13,17,17,20,0,0,0,0,0,0,0,0,0,0,0,0,0,0,0,0,0,0,0,0,0,0,0,0,0,0,0,0,0,0,0,0,0,0,0,0,0,0,0,0,0,0,0,0,0,0,0,0,0
29/6/2010,Andrea Raggi,837002,776,6/24/1984,26,0,0,3,0,3906,6300,6300,138,125,6042783,184,80,D RLC,2,2,2,2,3,1,2,2,3,3,3,5,13,5,4,10,6,13,5,10,13,8,4,13,10,14,13,14,7,10,5,12,12,8,10,10,13,17,13,14,13,11,13,12,9,16,20,15,13,10,14,13,13,13,8,12,6,4,14,12,11,5,D RLC,106,1,1,20,20,1,1,15,1,20,1,10,1,1,1,20,15,20,1,1,1,1,10,0,0,0,0,0,0,0,0,0,0,0,0,0,0,0,0,0,0,0,0,0,0,0,0,0,0,0,0,0,0,0,0,0,0,0,0,0,0,0,0,0,0,0,0,0,0,0,0,0
29/6/2010,Andrea Masiello,7984549,776,2/5/1986,24,0,0,0,0,3500,6650,6650,156,141,4286859,185,75,D RC,1,2,2,1,1,1,2,5,3,2,2,3,8,7,5,10,5,15,5,3,16,10,4,16,10,13,16,15,14,13,8,14,14,12,16,8,16,14,13,13,13,14,13,6,14,13,20,16,15,14,8,14,7,10,14,16,16,3,16,14,11,3,D RC,103,1,1,20,20,1,1,9,1,18,13,1,1,1,1,20,9,18,1,1,1,1,1,0,0,0,0,0,0,0,0,0,0,0,0,0,0,0,0,0,0,0,0,0,0,0,0,0,0,0,0,0,0,0,0,0,0,0,0,0,0,0,0,0,0,0,0,0,0,0,0,0
29/6/2010,Andoni Iraola,824160,796,6/22/1982,28,4,0,1,0,5329,6700,6700,150,146,8160595,182,75,D/WB R,3,1,3,1,1,2,1,8,2,2,2,13,14,15,12,13,14,7,14,9,12,13,15,13,15,12,13,12,14,13,13,12,13,14,14,13,12,14,15,15,14,12,11,10,11,14,20,15,12,14,8,13,10,10,15,16,16,13,16,14,12,7,D/WB R,112,1,11,12,20,10,1,1,13,20,1,19,10,1,11,1,3,20,12,1,13,1,19,43980465111584,0,0,0,0,0,1,0,0,0,1,0,0,0,0,0,0,0,0,0,0,0,0,0,0,0,0,0,0,0,0,0,0,0,0,0,0,0,0,0,0,0,0,0,1,0,1,0,0
29/6/2010,Álvaro González,2001906,1657,10/29/1984,25,11,0,0,0,3969,6750,6750,138,126,3599999,172,66,DM/M RC,1,1,3,3,1,1,1,4,1,3,2,9,12,11,7,13,7,8,14,10,12,12,10,11,13,12,12,13,12,13,12,13,15,8,14,13,12,15,15,14,13,8,6,10,19,12,20,16,12,13,12,12,8,13,13,11,12,12,14,12,12,5,DM/M RC,423,1,6,17,12,17,1,11,20,20,1,15,1,1,6,1,5,12,15,11,20,7,15,0,0,0,0,0,0,0,0,0,0,0,0,0,0,0,0,0,0,0,0,0,0,0,0,0,0,0,0,0,0,0,0,0,0,0,0,0,0,0,0,0,0,0,0,0,0,0,0,0
29/6/2010,Álvaro Arbeloa,7451691,796,1/17/1983,27,16,0,1,0,5700,7550,7550,154,151,39491564,183,78,D RL,1,3,2,1,1,3,1,1,2,1,1,7,11,10,8,12,7,13,10,12,17,12,6,15,11,13,16,14,12,18,9,13,15,8,10,11,17,18,15,11,12,14,12,9,14,14,20,16,12,17,13,13,7,15,14,14,15,10,16,16,14,6,D RL,105,1,1,13,20,4,1,19,4,20,8,10,1,1,1,13,19,20,1,3,4,9,10,0,0,0,0,0,0,0,0,0,0,0,0,0,0,0,0,0,0,0,0,0,0,0,0,0,0,0,0,0,0,0,0,0,0,0,0,0,0,0,0,0,0,0,0,0,0,0,0,0
29/6/2010,Alex,7000784,788,9/6/1979,30,3,0,0,0,3025,5500,5500,115,110,745881,175,74,D/WB R,2,3,3,3,1,1,1,4,2,3,3,11,11,10,10,11,10,9,13,12,10,11,10,13,11,15,12,15,9,11,9,12,16,10,12,13,12,14,14,13,13,10,10,8,12,14,20,12,14,11,10,12,13,12,11,15,14,12,12,9,9,6,D/WB R,112,1,9,1,20,1,1,1,10,20,1,20,1,1,9,1,1,20,1,1,10,1,20,18708894318594,0,1,0,0,0,0,0,0,0,0,0,0,0,0,0,0,0,0,0,0,0,0,0,0,1,0,0,0,0,0,0,0,0,0,1,0,0,0,0,0,1,0,0,0,1,0,0,0
29/6/2010,Alex John-Baptiste,5112061,765,1/31/1986,24,0,0,0,0,2000,5750,5750,141,121,3355131,181,74,D RC,2,2,1,3,1,2,2,4,1,2,3,8,10,5,2,11,9,14,7,8,15,10,2,15,10,11,13,13,14,14,7,14,11,5,8,9,13,9,12,12,8,13,12,10,14,14,20,9,13,16,6,10,9,9,12,12,9,12,12,12,15,4,D RC,103,1,1,20,20,1,1,12,1,20,1,9,1,1,1,20,12,20,1,1,1,1,9,140737488355328,0,0,0,0,0,0,0,0,0,0,0,0,0,0,0,0,0,0,0,0,0,0,0,0,0,0,0,0,0,0,0,0,0,0,0,0,0,0,0,0,0,0,0,0,0,0,0,1
29/6/2010,Alessandro Potenza,837116,776,3/8/1984,26,0,0,27,1,3500,6000,6000,128,120,1999999,185,78,D/WB RC,1,1,1,1,1,1,1,1,1,1,1,8,14,9,10,13,6,16,9,16,14,12,8,14,10,14,12,13,10,10,10,10,13,6,10,7,14,13,13,12,12,16,12,7,11,12,20,13,13,11,13,10,12,13,12,13,12,13,14,12,13,11,D/WB RC,113,1,1,18,20,1,1,12,1,20,1,18,1,1,1,18,12,20,1,1,1,12,18,64,0,0,0,0,0,0,1,0,0,0,0,0,0,0,0,0,0,0,0,0,0,0,0,0,0,0,0,0,0,0,0,0,0,0,0,0,0,0,0,0,0,0,0,0,0,0,0,0
29/6/2010,Aleandro Rosi,7984127,776,5/17/1987,23,0,0,0,0,4225,6500,6500,140,130,4227212,184,80,D/WB/M/AM RL,2,1,2,1,1,2,2,1,3,2,1,3,12,13,11,9,6,10,10,10,11,11,10,11,13,13,11,12,12,11,10,10,11,12,6,14,11,12,16,16,12,11,11,10,14,15,20,13,14,10,15,14,6,18,16,12,12,12,15,13,11,5,D/WB/M/AM RL,245,1,16,6,17,6,1,15,20,20,1,20,3,12,16,4,15,17,6,15,20,15,20,1133872447488,0,0,0,0,0,0,0,0,0,0,0,0,0,0,0,1,0,0,0,0,1,0,0,0,0,0,0,0,0,0,0,0,0,0,0,1,0,0,0,0,1,0,0,0,0,0,0,0
29/6/2010,Albin Ebondo,916421,769,2/23/1984,26,0,0,6,0,1400,6050,6050,142,135,4395157,183,85,D/WB R,2,1,2,3,1,2,3,2,2,2,1,11,14,12,6,12,8,14,10,12,13,11,7,12,12,9,13,13,12,12,11,11,13,8,9,12,12,14,12,16,13,15,11,8,15,15,20,17,15,13,9,14,7,10,12,15,15,14,14,16,16,7,D/WB R,112,1,10,12,20,1,1,1,10,20,1,17,1,1,10,12,1,20,1,1,10,1,17,2,0,1,0,0,0,0,0,0,0,0,0,0,0,0,0,0,0,0,0,0,0,0,0,0,0,0,0,0,0,0,0,0,0,0,0,0,0,0,0,0,0,0,0,0,0,0,0,0
29/6/2010,Alberto Lora,67011231,796,3/25/1987,23,0,0,0,0,1250,2000,2000,147,135,2040026,165,66,D/M RC,3,1,3,3,1,3,1,3,1,2,1,10,13,14,14,14,5,17,14,14,14,16,12,14,13,12,14,13,11,15,14,15,11,11,10,14,13,17,17,14,15,13,5,1,14,14,20,16,16,16,10,12,10,12,7,10,9,8,8,18,16,14,D/M RC,113,5,15,20,20,1,1,5,20,20,1,15,15,1,15,1,5,20,20,1,15,5,15,0,0,0,0,0,0,0,0,0,0,0,0,0,0,0,0,0,0,0,0,0,0,0,0,0,0,0,0,0,0,0,0,0,0,0,0,0,0,0,0,0,0,0,0,0,0,0,0,0
29/6/2010,Alberto Botía,67024158,796,1/27/1989,21,0,0,1,0,3750,6209,5750,162,138,4475459,187,80,D RC,3,1,2,1,3,3,2,1,3,1,1,4,9,7,8,11,5,15,9,10,14,12,5,15,10,12,15,14,13,15,9,14,12,5,7,5,15,15,14,14,13,15,15,2,13,14,20,15,12,13,9,11,14,10,14,12,15,10,15,12,10,4,D RC,103,1,1,20,20,10,1,1,1,15,1,1,1,1,1,20,1,15,1,1,1,1,1,0,0,0,0,0,0,0,0,0,0,0,0,0,0,0,0,0,0,0,0,0,0,0,0,0,0,0,0,0,0,0,0,0,0,0,0,0,0,0,0,0,0,0,0,0,0,0,0,0
29/6/2010,Alassane Touré,34009553,769,2/9/1989,21,0,0,0,0,50,2250,2250,125,90,228511,183,71,D RC,2,2,2,3,1,3,3,1,1,1,3,4,7,7,4,10,3,12,5,8,9,12,4,14,6,4,12,10,8,12,7,10,11,9,3,10,9,12,15,14,14,14,11,5,13,14,20,11,11,10,7,10,10,10,8,6,17,11,12,9,14,12,D RC,103,1,1,20,20,1,1,1,1,15,1,1,1,1,1,20,1,15,1,1,1,1,1,0,0,0,0,0,0,0,0,0,0,0,0,0,0,0,0,0,0,0,0,0,0,0,0,0,0,0,0,0,0,0,0,0,0,0,0,0,0,0,0,0,0,0,0,0,0,0,0,0
29/6/2010,Alan Hutton,5204786,793,11/30/1984,25,15,0,7,0,5112,7250,6750,150,143,12569381,185,84,D/WB R,2,1,1,3,1,2,1,5,3,2,3,5,13,13,12,12,8,16,10,16,13,14,8,14,14,17,12,17,11,13,11,12,15,6,12,11,13,14,16,15,12,10,12,12,12,15,20,13,15,13,12,15,8,16,13,13,13,10,12,12,9,11,D/WB R,222,1,1,14,19,1,1,1,1,20,1,20,1,1,1,14,1,19,1,1,1,1,20,34,0,1,0,0,0,1,0,0,0,0,0,0,0,0,0,0,0,0,0,0,0,0,0,0,0,0,0,0,0,0,0,0,0,0,0,0,0,0,0,0,0,0,0,0,0,0,0,0
29/6/2010,Ala-Eddine Yahia,916024,51,9/26/1981,28,15,0,0,0,3900,6400,5750,136,128,2577973,186,81,D/WB RC,3,2,3,2,2,3,2,8,2,1,2,5,9,7,8,7,8,16,12,9,15,11,8,14,7,15,15,16,12,12,7,12,15,7,13,7,12,12,14,13,9,16,13,12,13,11,20,14,16,13,15,14,10,7,10,12,13,13,15,14,14,7,D/WB RC,113,1,1,20,20,8,1,10,1,16,1,16,1,1,1,20,10,16,1,1,1,10,16,32800,0,0,0,0,0,1,0,0,0,0,0,0,0,0,0,1,0,0,0,0,0,0,0,0,0,0,0,0,0,0,0,0,0,0,0,0,0,0,0,0,0,0,0,0,0,0,0,0
29/6/2010,Ahmed Elmohammady,12009828,16,9/9/1987,22,28,0,0,0,3900,6400,6400,149,129,2110834,180,75,D/WB/M R,3,3,2,3,2,1,3,1,2,2,3,13,14,13,11,13,13,14,12,14,9,11,10,12,14,15,14,14,10,8,11,13,15,13,12,13,8,12,12,15,15,12,14,6,15,15,20,14,13,9,12,12,7,11,10,14,12,10,9,4,8,8,D/WB/M R,232,10,15,10,19,1,1,1,18,20,1,20,1,1,15,1,1,19,1,1,18,1,20,70540542869504,0,0,0,0,0,0,0,0,0,0,0,0,0,0,0,0,0,0,0,0,0,0,0,0,0,0,0,0,0,0,0,0,0,0,0,1,0,1,0,0,0,0,0,0,0,0,1,0
29/6/2010,Adriano,315865,1651,10/26/1984,25,3,0,0,0,5476,7150,7250,158,148,123829271,172,67,D/WB/M/AM RL,1,1,1,2,2,2,3,3,3,3,2,14,15,15,11,13,11,7,13,10,11,13,12,11,14,12,13,13,14,13,11,13,15,12,10,16,11,12,13,16,14,9,7,17,10,13,20,12,12,13,8,14,15,18,15,15,9,11,12,11,11,8,D/WB/M/AM RL,445,1,18,5,16,5,1,20,20,15,1,18,1,18,10,1,16,15,1,20,10,18,15,549756862497,1,0,0,0,0,1,0,0,0,0,0,0,0,0,0,0,0,0,0,0,1,0,0,0,0,0,0,0,0,0,0,0,0,0,0,0,0,0,0,1,0,0,0,0,0,0,0,0
29/6/2010,Adrián Gunino,78023109,1657,2/3/1989,21,0,0,15,0,2500,4904,4900,135,109,123122,172,67,D R,1,2,2,3,1,3,3,2,1,2,2,7,12,11,4,12,7,10,7,14,11,12,8,10,12,15,10,13,11,12,11,10,12,11,4,12,10,13,14,15,13,8,7,14,13,14,20,13,8,11,8,9,6,14,7,6,14,11,7,1,2,8,D R,102,1,1,1,20,1,1,14,1,20,1,15,1,1,1,1,14,20,1,1,1,11,15,0,0,0,0,0,0,0,0,0,0,0,0,0,0,0,0,0,0,0,0,0,0,0,0,0,0,0,0,0,0,0,0,0,0,0,0,0,0,0,0,0,0,0,0,0,0,0,0,0
29/6/2010,Abel,4101966,788,12/22/1978,31,0,0,0,0,2250,5950,5950,121,119,602840,178,78,D R,2,1,1,2,2,2,3,1,3,3,3,12,13,10,8,10,9,10,10,12,12,11,11,12,11,12,12,14,14,14,11,11,11,8,10,12,13,14,14,11,12,11,10,7,11,10,20,13,11,12,8,10,11,9,11,12,13,11,14,14,14,3,D R,102,1,1,1,20,1,1,5,1,20,1,10,1,1,1,1,5,20,1,1,1,1,10,17180919810,0,1,0,0,0,0,0,0,0,0,0,1,0,0,0,0,0,0,0,0,1,0,0,0,0,0,0,0,0,0,0,0,0,0,1,0,0,0,0,0,0,0,0,0,0,0,0,0
29/6/2010,Abdoulay Konko,7987468,769,3/9/1984,26,0,0,0,0,4830,6500,6000,148,139,144492258,183,75,D/WB/M RC,2,1,2,3,3,2,3,5,3,1,1,9,13,11,8,10,7,13,8,8,15,12,5,14,11,15,12,15,13,11,9,13,13,8,6,14,13,14,14,14,16,10,10,11,9,15,20,16,16,13,12,11,17,18,6,11,8,9,14,14,12,4,D/WB/M RC,123,1,1,15,20,14,1,9,17,20,1,18,1,1,1,15,7,20,10,9,17,9,18,2,0,1,0,0,0,0,0,0,0,0,0,0,0,0,0,0,0,0,0,0,0,0,0,0,0,0,0,0,0,0,0,0,0,0,0,0,0,0,0,0,0,0,0,0,0,0,0,0
