GameDate,Name,UID,NationID,Born,Age,IntCaps,IntGoals,U21Caps,U21Goals,WorldReputation,HomeReputation,CurrentReputation,PA,CA,Price,Height,Weight,PositionsString,GK.AerialAbility,GK.CommandOfArea,GK.Communication,GK.Eccentricity,GK.Handling,GK.Kicking,GK.OneOnOnes,GK.Reflexes,GK.RushingOut,GK.TendencyToPunch,GK.Throwing,Tech.Corners,Tech.Crossing,Tech.Dribbling,Tech.Finishing,Tech.FirstTouch,Tech.Freekicks,Tech.Heading,Tech.LongShots,Tech.Longthrows,Tech.Marking,Tech.Passing,Tech.PenaltyTaking,Tech.Tackling,Tech.Technique,Mental.Aggression,Mental.Anticipation,Mental.Bravery,Mental.Composure,Mental.Concentration,Mental.Vision,Mental.Decisions,Mental.Determination,Mental.Flair,Mental.Leadership,Mental.OffTheBall,Mental.Positioning,Mental.Teamwork,Mental.Workrate,Phy.Acceleration,Phy.Agility,Phy.Balance,Phy.Jumping,Phy.LeftFoot,Phy.NaturalFitness,Phy.Pace,Phy.RightFoot,Phy.Stamina,Phy.Strength,Hidden.Consistency,Hidden.Dirtiness,Hidden.ImportantMatches,Hidden.InjuryProness,Hidden.Versatility,Personality.Adaptability,Personality.Ambition,Personality.Loyalty,Personality.Pressure,Personality.Professional,Personality.Sportsmanship,Personality.Temperament,Personality.Controversy,Positions.Defender,Positions.WingBack,Positions.Midfielder,Positions.AttackingMidfielder,Positions.Right,Positions.Left,Positions.Centre,Positions.PositionsDesc,Positions.PositionsDescVal,Positions.Goalkeeper,Positions.Sweeper,Positions.Striker,Positions.AttackingMidCentral,Positions.AttackingMidLeft,Positions.AttackingMidRight,Positions.DefenderCentral,Positions.DefenderLeft,Positions.DefenderRight,Positions.DefensiveMidfielder,Positions.MidfielderCentral,Positions.MidfielderLeft,Positions.MidfielderRight,Positions.WingBackLeft,Positions.WingBackRight,PPMVal,PPM0,PPM1,PPM2,PPM3,PPM4,PPM5,PPM6,PPM7,PPM8,PPM9,PPM10,PPM11,PPM12,PPM13,PPM14,PPM15,PPM16,PPM17,PPM18,PPM19,PPM20,PPM21,PPM22,PPM23,PPM24,PPM25,PPM26,PPM27,PPM28,PPM29,PPM30,PPM31,PPM32,PPM33,PPM34,PPM35,PPM36,PPM37,PPM38,PPM39,PPM40,PPM41,PPM42,PPM43,PPM44,PPM45,PPM46,PPM47
13/6/2011,Zeljko Brkic,5775744,802,7/9/1986,24,5,0,11,0,4750,6750,6350,147,126,2927893,196,93,GK ,12,18,17,7,15,11,13,14,9,9,13,4,10,9,5,6,9,9,9,10,8,4,12,10,10,14,13,9,14,10,5,8,12,9,17,12,13,9,13,11,11,9,17,5,13,12,20,13,15,14,7,11,8,10,13,14,13,13,13,11,12,8,1,1,1,1,1,1,1,GK ,0,20,1,1,1,1,1,1,1,1,1,1,1,1,1,1,0,0,0,0,0,0,0,0,0,0,0,0,0,0,0,0,0,0,0,0,0,0,0,0,0,0,0,0,0,0,0,0,0,0,0,0,0,0,0,0,0,0,0,0,0,0,0,0,0
13/6/2011,Zacharie Boucher,85018050,769,3/7/1992,19,0,0,0,0,1150,2350,2350,147,94,877289,178,72,GK ,7,10,10,7,11,7,13,14,13,11,8,7,2,3,3,8,10,3,2,2,1,7,2,1,8,7,13,11,12,12,8,11,9,2,8,3,11,10,7,14,15,12,9,1,15,11,20,12,11,14,7,15,5,1,9,16,13,10,7,7,10,10,1,1,1,1,1,1,1,GK ,0,20,1,1,1,1,1,1,1,1,1,1,1,1,1,1,0,0,0,0,0,0,0,0,0,0,0,0,0,0,0,0,0,0,0,0,0,0,0,0,0,0,0,0,0,0,0,0,0,0,0,0,0,0,0,0,0,0,0,0,0,0,0,0,0
13/6/2011,Yoel,67010473,796,8/28/1988,22,0,0,2,0,3000,5000,5000,132,104,972439,186,78,GK ,9,10,13,4,11,10,15,14,8,13,14,3,1,1,1,8,7,10,1,3,1,8,2,2,7,12,11,8,10,10,7,14,13,1,8,2,8,2,8,10,9,10,12,15,10,10,20,10,10,10,9,10,10,10,7,14,15,10,9,12,7,8,1,1,1,1,1,1,1,GK ,0,20,1,1,1,1,1,1,1,1,1,1,1,1,1,1,0,0,0,0,0,0,0,0,0,0,0,0,0,0,0,0,0,0,0,0,0,0,0,0,0,0,0,0,0,0,0,0,0,0,0,0,0,0,0,0,0,0,0,0,0,0,0,0,0
13/6/2011,Yoann Collas,85056995,769,6/16/1992,18,0,0,0,0,1100,2200,2200,103,88,741990,188,85,GK ,13,10,8,8,10,11,12,10,8,11,7,6,1,1,2,9,8,1,3,2,1,8,3,2,9,8,10,13,11,11,8,11,12,6,9,3,11,10,6,9,11,14,14,1,14,8,20,14,14,14,8,10,6,1,10,12,14,9,11,13,13,6,1,1,1,1,1,1,1,GK ,0,20,1,1,1,1,1,1,1,1,1,1,1,1,1,1,0,0,0,0,0,0,0,0,0,0,0,0,0,0,0,0,0,0,0,0,0,0,0,0,0,0,0,0,0,0,0,0,0,0,0,0,0,0,0,0,0,0,0,0,0,0,0,0,0
13/6/2011,Yelco,67011254,796,1/23/1990,21,0,0,0,0,1900,4150,4150,116,83,88257,188,80,GK ,4,13,7,12,14,10,14,14,11,9,13,3,2,1,1,8,7,3,1,1,2,2,2,2,6,8,11,11,8,10,3,11,8,2,10,3,11,1,3,11,11,14,13,9,15,13,20,2,5,10,9,10,3,10,17,12,11,11,15,17,7,17,1,1,1,1,1,1,1,GK ,0,20,1,1,1,1,1,1,1,1,1,1,1,1,1,1,0,0,0,0,0,0,0,0,0,0,0,0,0,0,0,0,0,0,0,0,0,0,0,0,0,0,0,0,0,0,0,0,0,0,0,0,0,0,0,0,0,0,0,0,0,0,0,0,0
13/6/2011,Wolfgang Hesl,8725953,771,1/13/1986,25,0,0,0,0,1750,5000,5000,138,122,418430,186,85,GK ,13,12,12,8,13,12,14,13,15,7,11,5,2,2,2,7,10,2,3,2,1,2,1,1,7,5,11,12,11,11,9,9,10,12,7,1,13,12,13,12,12,13,14,11,12,13,20,15,15,12,5,8,9,10,7,20,11,12,12,9,5,11,1,1,1,1,1,1,1,GK ,0,20,1,1,1,1,1,1,1,1,1,1,1,1,1,1,0,0,0,0,0,0,0,0,0,0,0,0,0,0,0,0,0,0,0,0,0,0,0,0,0,0,0,0,0,0,0,0,0,0,0,0,0,0,0,0,0,0,0,0,0,0,0,0,0
13/6/2011,Wojciech Szczesny,28009478,787,4/18/1990,21,4,0,7,0,5000,6750,7000,152,140,129178817,195,75,GK ,16,15,12,4,15,9,15,15,16,7,9,5,2,1,2,9,10,7,3,3,3,6,1,1,9,15,11,16,12,13,9,12,16,3,6,4,13,13,13,10,16,12,18,6,12,13,20,10,14,13,5,10,8,10,17,19,15,19,14,10,12,18,1,1,1,1,1,1,1,GK ,0,20,1,1,1,1,1,1,1,1,1,1,1,1,1,1,0,0,0,0,0,0,0,0,0,0,0,0,0,0,0,0,0,0,0,0,0,0,0,0,0,0,0,0,0,0,0,0,0,0,0,0,0,0,0,0,0,0,0,0,0,0,0,0,0
13/6/2011,Wilfredo Caballero,6300460,1649,9/28/1981,29,0,0,2,0,4500,6000,6400,148,137,23122258,185,83,GK ,13,14,14,8,15,12,14,15,15,14,12,8,2,2,2,10,10,1,2,1,1,3,1,2,10,6,12,12,10,12,11,12,15,12,12,7,14,12,13,9,13,13,13,7,12,11,20,10,12,15,4,13,2,10,10,15,10,8,15,15,15,2,1,1,1,1,1,1,1,GK ,0,20,1,1,1,1,1,1,1,1,1,1,1,1,1,1,0,0,0,0,0,0,0,0,0,0,0,0,0,0,0,0,0,0,0,0,0,0,0,0,0,0,0,0,0,0,0,0,0,0,0,0,0,0,0,0,0,0,0,0,0,0,0,0,0
13/6/2011,Wesley Foderingham,28010402,765,1/14/1991,20,0,0,0,0,1200,2500,2500,107,59,11056,186,71,GK ,10,9,10,10,9,9,11,10,8,11,6,2,3,1,3,2,3,2,2,1,3,2,2,2,1,10,4,11,5,8,2,7,9,5,4,3,11,8,6,10,11,7,13,20,10,9,5,5,9,10,8,12,7,10,6,13,11,8,6,9,15,6,1,1,1,1,1,1,1,GK ,0,20,1,1,1,1,1,1,1,1,1,1,1,1,1,1,0,0,0,0,0,0,0,0,0,0,0,0,0,0,0,0,0,0,0,0,0,0,0,0,0,0,0,0,0,0,0,0,0,0,0,0,0,0,0,0,0,0,0,0,0,0,0,0,0
13/6/2011,Wayne Hennessey,5006568,801,1/24/1987,24,32,0,6,0,3750,6750,6700,155,130,10482321,196,73,GK ,15,12,12,4,15,16,12,14,13,12,12,5,2,2,1,7,10,2,1,2,1,3,2,2,6,12,13,12,9,12,7,12,12,1,8,6,11,10,9,10,13,10,18,17,13,8,20,11,15,11,8,13,7,10,10,12,15,14,14,11,15,6,1,1,1,1,1,1,1,GK ,0,20,1,1,1,1,1,1,1,1,1,1,1,1,1,1,0,0,0,0,0,0,0,0,0,0,0,0,0,0,0,0,0,0,0,0,0,0,0,0,0,0,0,0,0,0,0,0,0,0,0,0,0,0,0,0,0,0,0,0,0,0,0,0,0
13/6/2011,Walter Bressan,3801686,776,1/26/1981,30,0,0,0,0,1550,6200,6100,120,110,241579,185,78,GK ,15,11,13,10,14,12,12,14,13,11,12,4,1,1,3,6,8,2,2,2,2,1,3,1,8,4,11,9,11,9,9,14,9,11,8,12,13,11,11,11,11,12,13,2,12,11,20,11,11,14,12,12,5,10,17,5,7,14,9,11,11,2,1,1,1,1,1,1,1,GK ,0,20,1,1,1,1,1,1,1,1,1,1,1,1,1,1,0,0,0,0,0,0,0,0,0,0,0,0,0,0,0,0,0,0,0,0,0,0,0,0,0,0,0,0,0,0,0,0,0,0,0,0,0,0,0,0,0,0,0,0,0,0,0,0,0
13/6/2011,Waldson,19055331,1651,5/12/1990,21,0,0,0,0,500,4840,3250,99,88,287500,184,87,GK ,12,12,14,6,13,10,11,11,13,11,11,2,1,2,1,5,4,1,3,2,3,1,3,3,6,12,10,12,8,11,4,10,12,2,5,5,10,8,11,8,12,12,12,3,13,9,20,12,14,10,3,10,7,10,10,13,14,11,15,15,14,8,1,1,1,1,1,1,1,GK ,0,20,1,1,1,1,1,1,1,1,1,1,1,1,1,1,0,0,0,0,0,0,0,0,0,0,0,0,0,0,0,0,0,0,0,0,0,0,0,0,0,0,0,0,0,0,0,0,0,0,0,0,0,0,0,0,0,0,0,0,0,0,0,0,0
13/6/2011,Vlado Giljen,5790256,62002127,12/7/1989,21,0,0,10,0,2250,5750,5000,123,108,878657,188,85,GK ,11,10,11,4,13,10,13,13,8,8,11,7,11,11,1,12,7,10,2,12,1,1,12,11,14,15,12,13,12,12,12,12,12,12,12,13,11,12,12,10,10,12,11,8,14,10,20,11,10,15,7,11,9,9,14,15,13,14,11,13,13,5,1,1,1,1,1,1,1,GK ,0,20,1,1,1,1,1,1,1,1,1,1,1,1,1,1,0,0,0,0,0,0,0,0,0,0,0,0,0,0,0,0,0,0,0,0,0,0,0,0,0,0,0,0,0,0,0,0,0,0,0,0,0,0,0,0,0,0,0,0,0,0,0,0,0
13/6/2011,Vlada Avramov,132869,802,4/5/1979,32,2,0,0,0,3550,4950,5500,130,110,1854861,187,76,GK ,13,12,13,2,14,13,13,15,12,12,11,7,2,10,1,9,9,2,2,2,1,14,3,2,4,10,12,11,10,7,8,12,15,8,9,13,9,8,10,12,12,8,11,5,11,8,20,12,10,12,6,10,8,10,20,12,13,10,15,12,10,8,1,1,1,1,1,1,1,GK ,0,20,1,1,1,1,1,1,1,1,1,1,1,1,1,1,0,0,0,0,0,0,0,0,0,0,0,0,0,0,0,0,0,0,0,0,0,0,0,0,0,0,0,0,0,0,0,0,0,0,0,0,0,0,0,0,0,0,0,0,0,0,0,0,0
13/6/2011,Vitus Eicher,91012801,771,11/5/1990,20,0,0,0,0,1750,4600,4100,130,92,403122,191,84,GK ,13,13,12,5,12,6,11,12,12,8,7,8,1,2,2,6,10,7,2,3,1,4,1,2,7,9,10,11,8,8,4,11,10,4,7,6,13,9,10,12,11,12,16,20,9,10,5,8,11,10,4,10,2,10,3,14,14,13,9,19,8,7,1,1,1,1,1,1,1,GK ,0,20,1,1,1,1,1,1,1,1,1,1,1,1,1,1,0,0,0,0,0,0,0,0,0,0,0,0,0,0,0,0,0,0,0,0,0,0,0,0,0,0,0,0,0,0,0,0,0,0,0,0,0,0,0,0,0,0,0,0,0,0,0,0,0
13/6/2011,Vito Mannone,5131045,776,3/2/1988,23,0,0,5,0,3000,6000,5750,139,115,3881918,191,74,GK ,12,13,12,12,13,16,11,13,12,14,13,8,2,1,2,7,10,3,2,1,3,2,2,1,8,13,10,14,9,8,12,10,14,5,10,5,10,12,12,10,10,10,14,4,13,10,20,11,15,12,5,10,8,10,15,11,13,8,11,11,9,5,1,1,1,1,1,1,1,GK ,0,20,1,1,1,1,1,1,1,1,1,1,1,1,1,1,0,0,0,0,0,0,0,0,0,0,0,0,0,0,0,0,0,0,0,0,0,0,0,0,0,0,0,0,0,0,0,0,0,0,0,0,0,0,0,0,0,0,0,0,0,0,0,0,0
13/6/2011,Vincenzo Fiorillo,43009042,776,1/13/1990,21,0,0,3,0,2500,5000,5050,131,98,480289,190,74,GK ,9,11,9,6,13,11,10,15,6,11,9,8,2,3,3,3,10,3,3,3,2,3,1,2,3,8,10,10,9,8,8,10,7,3,12,1,9,10,11,11,10,11,12,20,12,10,5,8,10,10,12,10,13,10,11,15,13,10,13,17,12,2,1,1,1,1,1,1,1,GK ,0,20,1,1,1,1,1,1,1,1,1,1,1,1,1,1,0,0,0,0,0,0,0,0,0,0,0,0,0,0,0,0,0,0,0,0,0,0,0,0,0,0,0,0,0,0,0,0,0,0,0,0,0,0,0,0,0,0,0,0,0,0,0,0,0
13/6/2011,Vincent Planté,6200907,769,10/19/1980,30,0,0,0,0,4700,5900,5900,140,132,2687588,189,84,GK ,10,13,13,7,14,11,14,15,11,13,9,4,2,3,1,7,9,3,1,1,1,7,2,2,7,12,12,15,13,13,7,12,14,7,12,2,11,12,10,10,13,15,15,12,15,13,20,13,15,14,12,14,6,1,9,12,16,13,14,10,10,5,1,1,1,1,1,1,1,GK ,0,20,1,1,1,1,1,1,1,1,1,1,1,1,1,1,0,0,0,0,0,0,0,0,0,0,0,0,0,0,0,0,0,0,0,0,0,0,0,0,0,0,0,0,0,0,0,0,0,0,0,0,0,0,0,0,0,0,0,0,0,0,0,0,0
13/6/2011,Vincent Fernandez,11110,769,1/31/1975,36,0,0,5,0,1450,5400,5400,135,120,149118,187,84,GK ,15,13,11,6,14,12,11,13,11,9,10,3,1,2,1,8,6,3,1,3,2,8,2,2,8,7,12,14,14,14,8,11,11,5,13,1,12,12,12,7,9,15,13,5,12,9,20,12,15,14,7,13,9,1,7,11,14,14,14,14,14,8,1,1,1,1,1,1,1,GK ,0,20,1,1,1,1,1,1,1,1,1,1,1,1,1,1,0,0,0,0,0,0,0,0,0,0,0,0,0,0,0,0,0,0,0,0,0,0,0,0,0,0,0,0,0,0,0,0,0,0,0,0,0,0,0,0,0,0,0,0,0,0,0,0,0
13/6/2011,Vincent Enyeama,5410292,38,8/29/1982,28,58,0,0,0,5750,7500,6400,150,142,10256012,182,87,GK ,12,11,15,12,12,17,14,16,14,13,15,10,3,3,8,9,12,2,11,1,2,11,15,12,9,7,11,11,16,14,9,13,18,9,12,2,11,12,7,12,13,16,11,10,13,11,20,12,15,11,7,14,5,1,16,16,12,15,18,18,7,4,1,1,1,1,1,1,1,GK ,0,20,1,1,1,1,1,1,1,1,1,1,1,1,1,1,0,0,0,0,0,0,0,0,0,0,0,0,0,0,0,0,0,0,0,0,0,0,0,0,0,0,0,0,0,0,0,0,0,0,0,0,0,0,0,0,0,0,0,0,0,0,0,0,0
13/6/2011,Vincent Degré,8442412,769,1/3/1989,22,0,0,0,0,1200,2450,2450,130,98,287500,187,88,GK ,14,10,10,7,12,6,11,13,10,12,13,5,1,1,3,7,9,3,1,1,3,7,2,2,7,4,13,13,12,12,7,10,10,7,8,3,10,9,8,12,11,14,13,1,14,9,20,13,14,13,10,10,6,1,12,15,11,6,8,11,13,7,1,1,1,1,1,1,1,GK ,0,20,1,1,1,1,1,1,1,1,1,1,1,1,1,1,0,0,0,0,0,0,0,0,0,0,0,0,0,0,0,0,0,0,0,0,0,0,0,0,0,0,0,0,0,0,0,0,0,0,0,0,0,0,0,0,0,0,0,0,0,0,0,0,0
13/6/2011,Vid Belec,64001280,795,6/6/1990,21,0,0,0,0,2000,4454,4600,136,99,348742,192,93,GK ,11,11,11,11,12,11,12,13,10,12,10,1,3,2,3,5,4,5,3,2,1,5,3,1,5,6,13,11,12,14,9,10,16,3,10,3,12,9,16,7,12,10,16,5,12,8,20,9,11,15,3,15,6,10,16,5,9,15,15,12,13,9,1,1,1,1,1,1,1,GK ,0,20,1,1,1,1,1,1,1,1,1,1,1,1,1,1,0,0,0,0,0,0,0,0,0,0,0,0,0,0,0,0,0,0,0,0,0,0,0,0,0,0,0,0,0,0,0,0,0,0,0,0,0,0,0,0,0,0,0,0,0,0,0,0,0
13/6/2011,Víctor Valdés,824039,796,1/14/1982,29,4,0,10,0,8000,8500,8500,177,172,149999996,183,78,GK ,13,13,14,13,15,12,18,18,17,13,15,6,1,3,3,5,10,1,3,1,1,1,1,1,9,11,14,14,19,15,12,14,18,14,14,1,16,14,14,14,18,14,13,7,13,12,20,16,12,17,12,17,6,1,11,18,13,16,17,11,9,11,1,1,1,1,1,1,1,GK ,0,20,1,1,1,1,1,1,1,1,1,1,1,1,1,1,0,0,0,0,0,0,0,0,0,0,0,0,0,0,0,0,0,0,0,0,0,0,0,0,0,0,0,0,0,0,0,0,0,0,0,0,0,0,0,0,0,0,0,0,0,0,0,0,0
13/6/2011,Vicente Guaita,1510602,796,1/10/1987,24,0,0,0,0,4400,6750,6750,155,140,11182628,191,80,GK ,16,14,14,6,15,14,14,16,16,17,15,7,3,3,2,6,10,8,2,2,1,8,2,1,7,6,10,13,7,15,2,12,15,3,7,2,15,11,9,6,13,12,15,6,13,7,20,13,13,14,4,13,6,10,12,15,13,11,14,15,11,8,1,1,1,1,1,1,1,GK ,0,20,1,1,1,1,1,1,1,1,1,1,1,1,1,1,0,0,0,0,0,0,0,0,0,0,0,0,0,0,0,0,0,0,0,0,0,0,0,0,0,0,0,0,0,0,0,0,0,0,0,0,0,0,0,0,0,0,0,0,0,0,0,0,0
13/6/2011,Valentino Ragnacci,43069826,776,9/8/1992,18,0,0,0,0,250,1250,1250,69,38,4055,186,88,GK ,6,10,6,10,8,7,10,9,11,8,8,4,3,2,1,1,8,2,3,3,1,2,3,1,1,6,3,11,3,7,1,5,8,3,4,2,13,2,3,7,11,12,13,20,8,9,8,3,5,6,9,10,5,8,12,13,12,11,6,18,7,19,1,1,1,1,1,1,1,GK ,0,20,1,1,1,1,1,1,1,1,1,1,1,1,1,1,0,0,0,0,0,0,0,0,0,0,0,0,0,0,0,0,0,0,0,0,0,0,0,0,0,0,0,0,0,0,0,0,0,0,0,0,0,0,0,0,0,0,0,0,0,0,0,0,0
13/6/2011,Ulrich Ramé,640,769,9/19/1972,38,12,0,0,0,5000,5600,5600,160,125,331498,187,85,GK ,10,11,13,3,14,11,14,14,11,10,8,4,1,3,1,11,8,2,11,1,2,7,3,3,11,5,13,16,14,12,7,12,13,3,17,2,13,12,8,7,10,15,13,15,12,6,20,8,15,13,5,14,10,1,19,12,18,16,18,17,16,5,1,1,1,1,1,1,1,GK ,0,20,1,1,1,1,1,1,1,1,1,1,1,1,1,1,281474976710656,0,0,0,0,0,0,0,0,0,0,0,0,0,0,0,0,0,0,0,0,0,0,0,0,0,0,0,0,0,0,0,0,0,0,0,0,0,0,0,0,0,0,0,0,0,0,0,0
13/6/2011,Toño,1511409,796,11/23/1986,24,0,0,0,0,2250,4500,4500,107,93,601008,189,79,GK ,14,13,13,14,12,14,14,12,4,12,11,6,1,3,1,4,10,2,1,3,3,3,1,2,7,15,8,13,10,8,1,10,8,3,11,2,9,3,2,12,11,12,11,9,15,11,20,4,4,10,13,6,4,10,9,12,10,5,10,14,7,14,1,1,1,1,1,1,1,GK ,0,20,1,1,1,1,1,1,1,1,1,1,1,1,1,1,0,0,0,0,0,0,0,0,0,0,0,0,0,0,0,0,0,0,0,0,0,0,0,0,0,0,0,0,0,0,0,0,0,0,0,0,0,0,0,0,0,0,0,0,0,0,0,0,0
13/6/2011,Toni,67034666,796,5/5/1987,24,0,0,0,0,2250,4500,4500,115,94,78475,181,79,GK ,11,11,11,12,11,12,13,10,12,10,13,2,3,1,2,4,7,1,1,2,1,3,2,2,4,10,10,10,10,10,7,10,10,12,8,10,10,9,6,10,12,11,12,10,14,10,20,12,10,11,8,8,3,10,16,7,14,14,9,6,12,4,1,1,1,1,1,1,1,GK ,0,20,1,1,1,1,1,1,1,1,1,1,1,1,1,1,0,0,0,0,0,0,0,0,0,0,0,0,0,0,0,0,0,0,0,0,0,0,0,0,0,0,0,0,0,0,0,0,0,0,0,0,0,0,0,0,0,0,0,0,0,0,0,0,0
13/6/2011,Tommaso Berni,830068,776,3/6/1983,28,0,0,3,0,2500,5150,5700,135,120,1677526,185,80,GK ,12,12,11,5,12,12,12,16,9,5,11,7,3,3,2,2,9,4,3,2,3,6,2,3,4,13,8,12,8,12,4,10,12,2,8,2,12,7,11,10,11,10,12,7,12,9,20,14,15,10,5,8,10,10,8,11,14,9,13,13,12,10,1,1,1,1,1,1,1,GK ,0,20,1,1,1,1,1,1,1,1,1,1,1,1,1,1,0,0,0,0,0,0,0,0,0,0,0,0,0,0,0,0,0,0,0,0,0,0,0,0,0,0,0,0,0,0,0,0,0,0,0,0,0,0,0,0,0,0,0,0,0,0,0,0,0
13/6/2011,Tomeu Nadal,67018559,796,2/8/1989,22,0,0,0,0,2350,4650,4650,125,93,2613734,190,77,GK ,13,11,13,4,12,9,10,13,7,7,13,4,3,3,2,4,7,2,2,1,3,1,1,3,8,15,11,12,8,9,1,11,8,2,2,2,9,1,3,13,13,12,14,9,4,10,20,3,5,10,13,4,4,10,10,13,13,12,10,16,14,1,1,1,1,1,1,1,1,GK ,0,20,1,1,1,1,1,1,1,1,1,1,1,1,1,1,0,0,0,0,0,0,0,0,0,0,0,0,0,0,0,0,0,0,0,0,0,0,0,0,0,0,0,0,0,0,0,0,0,0,0,0,0,0,0,0,0,0,0,0,0,0,0,0,0
13/6/2011,Tomasz Kuszczak,884670,787,3/20/1982,29,10,0,14,0,5000,6750,5500,140,130,5772014,191,84,GK ,16,10,8,5,14,8,15,18,13,14,12,3,3,1,3,10,6,1,3,2,1,6,1,3,6,5,13,14,7,12,4,7,14,1,6,3,14,14,12,15,16,13,17,8,15,11,20,12,14,11,10,8,4,1,14,15,14,12,15,16,14,3,1,1,1,1,1,1,1,GK ,0,20,1,1,1,1,1,1,1,1,1,1,1,1,1,1,17179869184,0,0,0,0,0,0,0,0,0,0,0,0,0,0,0,0,0,0,0,0,0,0,0,0,0,0,0,0,0,0,0,0,0,0,1,0,0,0,0,0,0,0,0,0,0,0,0,0
13/6/2011,Tomasz Bobel,3600898,787,12/29/1974,36,0,0,0,0,1000,3500,3500,115,85,29963,187,74,GK ,10,11,9,6,11,9,11,11,12,9,8,2,1,3,1,6,4,3,1,1,1,1,2,2,7,10,12,12,13,12,4,11,11,1,11,1,12,12,10,8,8,11,12,4,12,9,20,9,11,10,15,10,8,10,14,8,9,12,9,10,11,3,1,1,1,1,1,1,1,GK ,0,20,1,1,1,1,1,1,1,1,1,1,1,1,1,1,0,0,0,0,0,0,0,0,0,0,0,0,0,0,0,0,0,0,0,0,0,0,0,0,0,0,0,0,0,0,0,0,0,0,0,0,0,0,0,0,0,0,0,0,0,0,0,0,0
13/6/2011,Tomas Svedkauskas,47019930,779,6/22/1994,16,0,0,0,0,500,2159,1500,92,48,70939,184,76,GK ,12,7,9,8,8,6,9,11,5,10,9,3,1,1,3,1,5,1,3,2,2,1,1,1,4,4,4,10,11,10,1,9,8,1,7,2,4,1,2,8,9,9,8,8,12,12,20,2,2,4,4,10,11,9,17,7,6,17,11,8,17,8,1,1,1,1,1,1,1,GK ,0,20,1,1,1,1,1,1,1,1,1,1,1,1,1,1,0,0,0,0,0,0,0,0,0,0,0,0,0,0,0,0,0,0,0,0,0,0,0,0,0,0,0,0,0,0,0,0,0,0,0,0,0,0,0,0,0,0,0,0,0,0,0,0,0
13/6/2011,Tomás Mejías,67014134,796,1/30/1989,22,0,0,0,0,3400,4900,4900,123,98,-1,194,81,GK ,12,9,11,9,11,12,13,13,6,12,13,3,2,1,2,2,7,2,3,1,2,1,1,1,1,10,12,11,9,11,1,12,7,3,6,2,10,1,1,9,15,13,14,9,13,11,20,6,14,10,6,9,14,10,14,10,15,12,14,15,9,12,1,1,1,1,1,1,1,GK ,0,20,1,1,1,1,1,1,1,1,1,1,1,1,1,1,0,0,0,0,0,0,0,0,0,0,0,0,0,0,0,0,0,0,0,0,0,0,0,0,0,0,0,0,0,0,0,0,0,0,0,0,0,0,0,0,0,0,0,0,0,0,0,0,0
13/6/2011,Tomas Kosicky,7563766,794,3/11/1986,25,0,0,3,0,2000,5000,5250,121,105,976464,197,93,GK ,8,12,11,8,12,14,11,15,8,11,14,1,1,1,1,5,1,5,1,1,1,5,1,1,5,5,12,10,10,11,10,11,11,5,11,5,13,10,7,9,9,13,19,5,14,8,20,12,14,11,5,10,5,1,12,11,13,10,14,14,14,4,1,1,1,1,1,1,1,GK ,0,20,1,1,1,1,1,1,1,1,1,1,1,1,1,1,0,0,0,0,0,0,0,0,0,0,0,0,0,0,0,0,0,0,0,0,0,0,0,0,0,0,0,0,0,0,0,0,0,0,0,0,0,0,0,0,0,0,0,0,0,0,0,0,0
13/6/2011,Tom Starke,884658,771,3/18/1981,30,0,0,12,0,4650,6700,6700,140,140,9627908,194,91,GK ,13,13,14,12,15,13,15,16,13,8,13,7,2,1,2,7,9,9,3,2,2,11,8,13,8,14,12,13,11,15,5,14,12,2,11,1,15,15,15,10,9,14,16,9,14,11,20,16,17,12,10,13,6,10,7,11,8,10,12,13,15,6,1,1,1,1,1,1,1,GK ,0,20,1,1,1,1,1,1,1,1,1,1,1,1,1,1,0,0,0,0,0,0,0,0,0,0,0,0,0,0,0,0,0,0,0,0,0,0,0,0,0,0,0,0,0,0,0,0,0,0,0,0,0,0,0,0,0,0,0,0,0,0,0,0,0
13/6/2011,Tom Heaton,5112064,765,4/15/1986,25,0,0,3,0,2500,5500,5500,133,117,407758,186,88,GK ,13,13,14,6,14,12,14,14,13,5,12,3,1,2,3,5,4,3,3,1,2,3,2,3,6,7,9,13,8,12,5,11,12,1,4,3,11,10,6,8,13,10,12,8,13,8,20,10,11,12,8,12,4,10,12,12,12,12,14,15,15,2,1,1,1,1,1,1,1,GK ,0,20,1,1,1,1,1,1,1,1,1,1,1,1,1,1,0,0,0,0,0,0,0,0,0,0,0,0,0,0,0,0,0,0,0,0,0,0,0,0,0,0,0,0,0,0,0,0,0,0,0,0,0,0,0,0,0,0,0,0,0,0,0,0,0
13/6/2011,Tobias Sippel,35006814,771,3/22/1988,23,0,0,8,0,2000,6500,6500,145,130,2731412,180,79,GK ,8,11,14,11,15,17,16,16,9,12,8,4,2,1,2,7,7,6,3,3,3,7,3,1,7,8,11,10,11,13,11,10,14,8,11,1,14,14,12,12,14,12,9,3,14,12,20,10,14,14,2,13,8,10,11,14,15,13,13,14,10,11,1,1,1,1,1,1,1,GK ,0,20,1,1,1,1,1,1,1,1,1,1,1,1,1,1,0,0,0,0,0,0,0,0,0,0,0,0,0,0,0,0,0,0,0,0,0,0,0,0,0,0,0,0,0,0,0,0,0,0,0,0,0,0,0,0,0,0,0,0,0,0,0,0,0
13/6/2011,Tobias Duffner,8718029,771,12/5/1983,27,0,0,0,0,750,3700,3700,80,74,187024,187,87,GK ,12,11,12,6,12,10,10,12,8,9,8,5,3,2,3,1,7,1,1,2,3,1,1,1,5,11,7,10,9,11,1,12,10,2,7,1,11,1,8,6,10,11,11,8,15,8,20,13,10,9,11,10,5,9,7,12,10,6,12,14,10,11,1,1,1,1,1,1,1,GK ,0,20,1,1,1,1,1,1,1,1,1,1,1,1,1,1,0,0,0,0,0,0,0,0,0,0,0,0,0,0,0,0,0,0,0,0,0,0,0,0,0,0,0,0,0,0,0,0,0,0,0,0,0,0,0,0,0,0,0,0,0,0,0,0,0
13/6/2011,Tó Figueira,7002198,788,8/30/1978,32,0,0,0,0,500,3500,3500,87,82,77311,185,92,GK ,14,14,14,14,10,13,7,12,4,6,11,3,3,2,1,4,8,1,1,3,2,2,1,1,8,6,9,11,9,4,2,12,10,1,15,3,8,3,5,7,14,13,10,4,12,6,20,3,4,10,9,5,9,10,11,9,14,9,10,9,12,10,1,1,1,1,1,1,1,GK ,0,20,1,1,1,1,1,1,1,1,1,1,1,1,1,1,0,0,0,0,0,0,0,0,0,0,0,0,0,0,0,0,0,0,0,0,0,0,0,0,0,0,0,0,0,0,0,0,0,0,0,0,0,0,0,0,0,0,0,0,0,0,0,0,0
13/6/2011,Timo Ochs,876737,771,10/17/1981,29,0,0,0,0,5000,5950,5950,132,119,1695364,189,81,GK ,10,12,13,5,13,12,12,14,6,14,14,4,3,2,3,7,9,8,1,3,3,11,11,14,11,13,10,12,11,10,12,11,13,7,10,7,13,14,13,13,12,13,12,6,14,11,20,15,13,9,12,12,12,10,13,14,14,12,13,14,12,4,1,1,1,1,1,1,1,GK ,0,20,1,1,1,1,1,1,1,1,1,1,1,1,1,1,0,0,0,0,0,0,0,0,0,0,0,0,0,0,0,0,0,0,0,0,0,0,0,0,0,0,0,0,0,0,0,0,0,0,0,0,0,0,0,0,0,0,0,0,0,0,0,0,0
13/6/2011,Tim Wiese,876623,771,12/17/1981,29,4,0,13,0,6650,8000,8000,165,162,18311812,193,91,GK ,9,9,16,13,17,8,19,19,10,15,9,6,3,2,3,8,8,3,2,2,1,6,3,2,6,17,10,20,15,16,4,12,17,2,12,2,18,13,15,14,10,18,16,9,16,10,20,17,18,17,18,17,9,10,3,13,18,17,10,4,7,15,1,1,1,1,1,1,1,GK ,0,20,1,1,1,1,1,1,1,1,1,1,1,1,1,1,0,0,0,0,0,0,0,0,0,0,0,0,0,0,0,0,0,0,0,0,0,0,0,0,0,0,0,0,0,0,0,0,0,0,0,0,0,0,0,0,0,0,0,0,0,0,0,0,0
13/6/2011,Tim Krumpen,35025643,771,11/28/1988,22,0,0,0,0,1750,4500,4500,118,90,149566,183,74,GK ,11,11,11,6,13,7,10,11,12,9,9,3,3,1,2,12,8,11,2,2,2,11,3,1,11,8,7,9,11,10,7,12,12,8,8,9,10,11,8,11,14,11,11,5,8,9,20,8,12,8,6,7,2,10,3,17,14,13,12,18,14,20,1,1,1,1,1,1,1,GK ,0,20,1,1,1,1,1,1,1,1,1,1,1,1,1,1,0,0,0,0,0,0,0,0,0,0,0,0,0,0,0,0,0,0,0,0,0,0,0,0,0,0,0,0,0,0,0,0,0,0,0,0,0,0,0,0,0,0,0,0,0,0,0,0,0
13/6/2011,Tim Krul,859596,784,4/3/1988,23,2,0,3,0,2750,6550,6550,155,135,14500391,188,74,GK ,14,13,11,13,12,13,17,16,15,13,13,6,1,2,2,11,9,5,2,1,3,8,8,2,8,11,12,15,8,13,8,12,15,2,8,2,13,10,12,13,15,12,14,20,12,8,7,15,10,14,8,15,8,10,16,15,10,12,12,10,8,3,1,1,1,1,1,1,1,GK ,0,20,1,1,1,1,1,1,1,1,1,1,1,1,1,1,17180065792,0,0,0,0,0,0,0,0,0,0,0,0,0,0,0,0,1,1,0,0,0,0,0,0,0,0,0,0,0,0,0,0,0,0,1,0,0,0,0,0,0,0,0,0,0,0,0,0
13/6/2011,Tim Howard,4400374,390,3/6/1979,32,66,0,0,0,6400,7600,7150,160,153,17277273,191,88,GK ,14,14,17,8,16,12,16,17,15,14,15,7,1,1,2,10,10,3,3,3,2,9,2,12,10,14,9,10,8,13,6,12,15,8,8,8,14,12,11,13,18,12,17,6,14,13,20,13,14,14,8,15,3,10,16,15,14,12,16,16,10,7,1,1,1,1,1,1,1,GK ,0,20,1,1,1,1,1,1,1,1,1,1,1,1,1,1,17179869184,0,0,0,0,0,0,0,0,0,0,0,0,0,0,0,0,0,0,0,0,0,0,0,0,0,0,0,0,0,0,0,0,0,0,1,0,0,0,0,0,0,0,0,0,0,0,0,0
13/6/2011,Tiago,4100296,788,4/16/1975,36,0,0,0,0,2500,6250,6250,128,125,690062,180,78,GK ,13,11,12,4,13,13,14,15,13,9,14,4,2,1,3,4,9,3,1,1,3,3,3,3,4,10,14,14,10,14,2,10,13,1,8,1,13,1,8,6,17,16,14,10,17,4,20,5,13,11,9,13,5,10,10,12,15,13,14,15,15,4,1,1,1,1,1,1,1,GK ,0,20,1,1,1,1,1,1,1,1,1,1,1,1,1,1,0,0,0,0,0,0,0,0,0,0,0,0,0,0,0,0,0,0,0,0,0,0,0,0,0,0,0,0,0,0,0,0,0,0,0,0,0,0,0,0,0,0,0,0,0,0,0,0,0
13/6/2011,Thorsten Kirschbaum,35007707,771,4/20/1987,24,0,0,7,0,4250,6100,6100,134,122,1978663,194,88,GK ,11,10,12,7,12,13,14,15,10,8,10,5,1,3,2,8,10,7,3,3,3,8,2,1,8,8,12,13,14,13,10,12,12,4,10,2,12,13,13,8,12,15,16,20,13,11,7,10,15,13,7,13,8,10,8,14,14,10,12,12,13,8,1,1,1,1,1,1,1,GK ,0,20,1,1,1,1,1,1,1,1,1,1,1,1,1,1,0,0,0,0,0,0,0,0,0,0,0,0,0,0,0,0,0,0,0,0,0,0,0,0,0,0,0,0,0,0,0,0,0,0,0,0,0,0,0,0,0,0,0,0,0,0,0,0,0
13/6/2011,Thomas Sørensen,115604,764,6/12/1976,35,94,0,24,0,5750,7250,6750,145,138,5358134,196,89,GK ,12,13,13,7,14,13,14,15,14,14,14,8,1,1,1,9,10,3,3,1,2,10,2,3,10,12,15,13,10,14,5,14,17,3,13,1,14,14,11,9,14,14,16,5,14,4,20,11,12,12,3,15,4,10,18,13,18,15,18,18,10,5,1,1,1,1,1,1,1,GK ,0,20,1,1,1,1,1,1,1,1,1,1,1,1,1,1,0,0,0,0,0,0,0,0,0,0,0,0,0,0,0,0,0,0,0,0,0,0,0,0,0,0,0,0,0,0,0,0,0,0,0,0,0,0,0,0,0,0,0,0,0,0,0,0,0
13/6/2011,Thomas Kraft,35007943,771,7/22/1988,22,0,0,0,0,5150,6700,6700,144,130,6494970,185,83,GK ,10,12,12,6,14,14,15,18,10,13,13,8,3,1,2,8,10,2,2,2,2,8,3,1,7,9,14,11,14,9,6,12,12,9,4,5,11,12,12,11,18,13,13,9,14,11,20,11,10,9,12,10,14,10,7,17,7,13,20,8,13,16,1,1,1,1,1,1,1,GK ,0,20,1,1,1,1,1,1,1,1,1,1,1,1,1,1,0,0,0,0,0,0,0,0,0,0,0,0,0,0,0,0,0,0,0,0,0,0,0,0,0,0,0,0,0,0,0,0,0,0,0,0,0,0,0,0,0,0,0,0,0,0,0,0,0
13/6/2011,Thomas Kessler,894120,771,1/20/1986,25,0,0,0,0,3250,6300,6300,139,126,2568524,195,92,GK ,13,13,13,5,11,13,15,17,12,14,13,3,3,2,3,6,7,4,3,1,1,7,3,1,7,9,13,12,9,12,6,13,10,5,8,5,13,14,10,6,8,15,18,8,15,12,20,14,16,10,5,10,11,10,11,10,14,5,13,12,14,4,1,1,1,1,1,1,1,GK ,0,20,1,1,1,1,1,1,1,1,1,1,1,1,1,1,0,0,0,0,0,0,0,0,0,0,0,0,0,0,0,0,0,0,0,0,0,0,0,0,0,0,0,0,0,0,0,0,0,0,0,0,0,0,0,0,0,0,0,0,0,0,0,0,0
13/6/2011,Thomas Bosmel,85012161,769,4/18/1988,23,0,0,0,0,2850,4250,4250,115,95,1833916,184,70,GK ,11,14,13,5,12,10,13,13,15,8,13,3,1,1,1,3,5,2,1,3,1,8,1,2,7,10,9,13,11,14,8,14,8,5,3,1,9,3,3,5,12,13,12,5,14,8,20,4,9,10,11,10,14,10,8,13,14,1,9,9,5,10,1,1,1,1,1,1,1,GK ,0,20,1,1,1,1,1,1,1,1,1,1,1,1,1,1,0,0,0,0,0,0,0,0,0,0,0,0,0,0,0,0,0,0,0,0,0,0,0,0,0,0,0,0,0,0,0,0,0,0,0,0,0,0,0,0,0,0,0,0,0,0,0,0,0
13/6/2011,Thierry Debès,3504382,769,1/13/1974,37,0,0,0,0,4300,5350,5350,125,119,723084,185,70,GK ,14,11,13,6,13,10,15,14,11,11,8,4,3,1,1,6,6,2,3,2,1,8,3,1,6,14,13,15,12,13,6,11,14,6,16,2,10,13,8,9,11,14,12,5,17,7,20,14,14,14,14,14,8,1,11,12,14,14,15,13,13,7,1,1,1,1,1,1,1,GK ,0,20,1,1,1,1,1,1,1,1,1,1,1,1,1,1,562949953421312,0,0,0,0,0,0,0,0,0,0,0,0,0,0,0,0,0,0,0,0,0,0,0,0,0,0,0,0,0,0,0,0,0,0,0,0,0,0,0,0,0,0,0,0,0,0,0,0
13/6/2011,Thibaut Courtois,18026122,757,5/11/1992,19,0,0,1,0,4500,6500,6250,173,130,24330808,199,87,GK ,19,14,8,5,14,14,13,17,10,5,10,3,1,10,1,10,7,10,3,1,2,14,1,1,15,8,11,13,10,14,8,10,14,14,8,1,13,14,10,11,10,12,19,20,17,10,5,9,12,15,5,18,5,10,10,14,15,19,14,14,14,2,1,1,1,1,1,1,1,GK ,0,20,1,1,1,1,1,1,1,1,1,1,1,1,1,1,0,0,0,0,0,0,0,0,0,0,0,0,0,0,0,0,0,0,0,0,0,0,0,0,0,0,0,0,0,0,0,0,0,0,0,0,0,0,0,0,0,0,0,0,0,0,0,0,0
13/6/2011,Teddy Richert,14253,769,9/21/1974,36,0,0,0,0,4950,6200,6200,145,138,2937148,182,78,GK ,11,14,14,5,13,8,15,16,13,13,15,5,3,1,3,7,10,1,1,1,3,11,1,1,7,7,13,15,14,14,10,13,14,5,14,2,12,13,9,11,13,14,11,5,14,10,20,13,14,15,7,16,13,1,13,12,16,15,17,15,15,8,1,1,1,1,1,1,1,GK ,0,20,1,1,1,1,1,1,1,1,1,1,1,1,1,1,0,0,0,0,0,0,0,0,0,0,0,0,0,0,0,0,0,0,0,0,0,0,0,0,0,0,0,0,0,0,0,0,0,0,0,0,0,0,0,0,0,0,0,0,0,0,0,0,0
13/6/2011,Taborda,7000723,788,6/22/1978,32,0,0,0,0,3500,5500,5500,120,110,247462,189,90,GK ,12,12,10,14,10,13,12,14,13,15,14,3,3,1,1,6,6,7,1,3,2,8,7,3,9,8,9,14,11,11,9,9,12,11,7,5,8,10,11,12,12,12,13,5,14,10,20,11,11,10,10,10,4,10,10,11,14,13,15,13,14,4,1,1,1,1,1,1,1,GK ,0,20,1,1,1,1,1,1,1,1,1,1,1,1,1,1,0,0,0,0,0,0,0,0,0,0,0,0,0,0,0,0,0,0,0,0,0,0,0,0,0,0,0,0,0,0,0,0,0,0,0,0,0,0,0,0,0,0,0,0,0,0,0,0,0
13/6/2011,Sven Ulreich,35008097,771,8/3/1988,22,0,0,3,0,4500,6600,6600,145,132,22063114,192,84,GK ,10,10,13,3,11,12,17,18,8,13,15,8,1,3,3,6,10,5,3,2,3,9,3,3,6,12,13,14,14,11,8,12,10,1,6,2,12,14,13,13,13,15,16,7,9,10,20,12,14,12,3,12,5,10,10,12,15,12,13,10,7,5,1,1,1,1,1,1,1,GK ,0,20,1,1,1,1,1,1,1,1,1,1,1,1,1,1,0,0,0,0,0,0,0,0,0,0,0,0,0,0,0,0,0,0,0,0,0,0,0,0,0,0,0,0,0,0,0,0,0,0,0,0,0,0,0,0,0,0,0,0,0,0,0,0,0
13/6/2011,Sven Neuhaus,3600918,771,4/4/1978,33,0,0,0,0,2000,5400,5400,123,108,1398308,194,90,GK ,10,12,14,17,13,15,12,12,12,12,11,3,2,1,3,11,7,7,1,2,2,7,3,3,7,15,12,13,12,10,4,9,16,4,14,2,10,12,12,10,10,12,16,5,13,10,20,13,12,11,13,13,9,10,8,12,15,11,11,12,6,16,1,1,1,1,1,1,1,GK ,0,20,1,1,1,1,1,1,1,1,1,1,1,1,1,1,0,0,0,0,0,0,0,0,0,0,0,0,0,0,0,0,0,0,0,0,0,0,0,0,0,0,0,0,0,0,0,0,0,0,0,0,0,0,0,0,0,0,0,0,0,0,0,0,0
13/6/2011,Steve Mildenhall,2004914,765,5/13/1978,33,0,0,0,0,1450,4550,4550,103,94,542512,194,90,GK ,11,12,10,9,10,11,10,12,9,13,8,5,2,3,3,2,8,2,1,1,2,1,3,1,7,9,11,11,12,10,11,10,15,1,11,6,11,10,14,8,10,9,10,9,6,6,20,5,12,16,3,10,2,10,6,6,12,7,9,12,8,12,1,1,1,1,1,1,1,GK ,0,20,1,1,1,1,1,1,1,1,1,1,1,1,1,1,0,0,0,0,0,0,0,0,0,0,0,0,0,0,0,0,0,0,0,0,0,0,0,0,0,0,0,0,0,0,0,0,0,0,0,0,0,0,0,0,0,0,0,0,0,0,0,0,0
13/6/2011,Steve Mandanda,8428461,769,3/28/1985,26,14,0,17,0,6500,8000,7200,170,160,13000000,185,82,GK ,13,13,15,7,16,10,15,18,14,8,12,8,3,8,5,8,10,8,12,1,3,8,3,2,8,5,13,15,16,15,6,14,16,8,16,3,14,13,14,14,17,14,12,1,16,13,20,15,15,16,5,14,4,1,11,16,14,17,16,16,16,7,1,1,1,1,1,1,1,GK ,0,20,1,1,1,1,1,1,1,1,1,1,1,1,1,1,0,0,0,0,0,0,0,0,0,0,0,0,0,0,0,0,0,0,0,0,0,0,0,0,0,0,0,0,0,0,0,0,0,0,0,0,0,0,0,0,0,0,0,0,0,0,0,0,0
13/6/2011,Steve Harper,2004343,765,3/14/1975,36,0,0,0,0,3750,6500,6500,140,130,20024310,188,83,GK ,15,10,10,6,15,14,14,13,8,7,14,7,2,3,2,8,9,8,1,2,3,5,1,5,5,7,10,14,11,14,5,16,11,1,9,4,15,9,12,7,11,14,14,8,9,7,20,14,12,16,15,13,7,1,5,5,20,12,18,18,16,2,1,1,1,1,1,1,1,GK ,0,20,1,1,1,1,1,1,1,1,1,1,1,1,1,1,1073741824,0,0,0,0,0,0,0,0,0,0,0,0,0,0,0,0,0,0,0,0,0,0,0,0,0,0,0,0,0,0,1,0,0,0,0,0,0,0,0,0,0,0,0,0,0,0,0,0
13/6/2011,Stephen Henderson,5006843,789,5/2/1988,23,0,0,8,0,2250,4850,4850,130,104,1150000,188,87,GK ,12,13,13,4,14,11,14,14,12,4,5,2,1,2,1,3,6,3,3,2,1,2,3,1,3,13,8,6,12,12,1,10,12,3,10,2,12,3,7,7,13,13,13,7,7,7,20,7,10,14,3,10,6,10,13,13,12,14,12,14,13,3,1,1,1,1,1,1,1,GK ,0,20,1,1,1,1,1,1,1,1,1,1,1,1,1,1,0,0,0,0,0,0,0,0,0,0,0,0,0,0,0,0,0,0,0,0,0,0,0,0,0,0,0,0,0,0,0,0,0,0,0,0,0,0,0,0,0,0,0,0,0,0,0,0,0
13/6/2011,Stephen Bywater,110144,765,6/7/1981,30,0,0,6,0,2400,4100,4100,120,104,50272,188,81,GK ,14,10,10,13,11,7,13,15,7,2,10,3,2,1,1,12,5,8,2,1,2,13,9,3,13,11,9,14,8,10,8,11,9,1,8,1,13,11,9,9,14,10,16,7,10,9,20,10,12,10,12,9,13,10,8,12,9,14,12,9,4,12,1,1,1,1,1,1,1,GK ,0,20,1,1,1,1,1,1,1,1,1,1,1,1,1,1,0,0,0,0,0,0,0,0,0,0,0,0,0,0,0,0,0,0,0,0,0,0,0,0,0,0,0,0,0,0,0,0,0,0,0,0,0,0,0,0,0,0,0,0,0,0,0,0,0
13/6/2011,Stéphane Ruffier,8428608,769,9/27/1986,24,1,0,4,0,5200,7250,6500,160,145,13195020,187,89,GK ,14,15,13,9,14,9,15,17,13,12,8,5,2,2,3,7,10,2,1,3,2,6,2,1,7,9,14,17,13,13,8,13,16,6,12,1,12,12,13,14,14,16,13,1,16,12,20,8,16,14,9,16,5,1,5,16,14,14,15,15,12,9,1,1,1,1,1,1,1,GK ,0,20,1,5,1,1,1,1,1,1,1,1,1,1,1,1,0,0,0,0,0,0,0,0,0,0,0,0,0,0,0,0,0,0,0,0,0,0,0,0,0,0,0,0,0,0,0,0,0,0,0,0,0,0,0,0,0,0,0,0,0,0,0,0,0
13/6/2011,Stephan Flauder,35011510,771,5/30/1986,25,0,0,0,0,3400,4650,4650,105,93,145028,197,90,GK ,12,12,10,4,12,10,9,12,7,6,8,2,1,1,1,4,5,1,3,1,1,1,3,1,4,15,8,12,7,9,1,10,8,3,13,2,12,1,1,9,16,13,16,10,11,8,20,4,6,10,9,10,7,10,5,9,18,18,8,7,6,20,1,1,1,1,1,1,1,GK ,0,20,1,1,1,1,1,1,1,1,1,1,1,1,1,1,2199023255552,0,0,0,0,0,0,0,0,0,0,0,0,0,0,0,0,0,0,0,0,0,0,0,0,0,0,0,0,0,0,0,0,0,0,0,0,0,0,0,0,0,1,0,0,0,0,0,0
13/6/2011,Stephan Andersen,928283,764,11/26/1981,29,7,0,21,0,4650,6750,5700,135,126,1578598,190,82,GK ,14,12,12,5,13,16,15,13,10,9,12,3,3,3,3,7,3,7,3,8,3,9,4,6,5,12,11,13,10,9,6,11,13,1,11,2,13,14,13,9,16,12,16,6,16,8,20,10,13,13,4,15,7,1,12,13,13,14,14,14,12,11,1,1,1,1,1,1,1,GK ,0,20,1,1,1,1,1,1,1,1,1,1,1,1,1,1,0,0,0,0,0,0,0,0,0,0,0,0,0,0,0,0,0,0,0,0,0,0,0,0,0,0,0,0,0,0,0,0,0,0,0,0,0,0,0,0,0,0,0,0,0,0,0,0,0
13/6/2011,Stefano Sorrentino,703341,776,3/28/1979,32,0,0,0,0,5000,6750,6750,142,140,8351478,186,84,GK ,13,13,12,8,15,16,13,17,13,10,10,5,3,2,2,10,9,8,2,2,1,10,1,2,10,9,15,11,13,15,7,13,16,3,10,1,12,12,14,11,14,11,12,5,15,7,20,15,14,15,7,16,6,10,17,15,10,13,12,12,13,10,1,1,1,1,1,1,1,GK ,0,20,1,1,1,1,1,1,1,1,1,1,1,1,1,1,0,0,0,0,0,0,0,0,0,0,0,0,0,0,0,0,0,0,0,0,0,0,0,0,0,0,0,0,0,0,0,0,0,0,0,0,0,0,0,0,0,0,0,0,0,0,0,0,0
13/6/2011,Steeve Elana,914342,769,7/11/1980,30,0,0,0,0,4600,5800,5800,132,129,3324111,187,85,GK ,11,12,12,8,13,7,13,16,12,7,11,5,1,1,1,7,10,3,7,1,3,6,3,2,7,6,14,14,13,13,6,13,14,6,12,2,13,12,13,14,16,14,13,1,17,12,20,14,14,15,6,15,6,1,5,13,14,14,15,17,17,6,1,1,1,1,1,1,1,GK ,0,20,1,1,1,1,1,1,1,1,1,1,1,1,1,1,0,0,0,0,0,0,0,0,0,0,0,0,0,0,0,0,0,0,0,0,0,0,0,0,0,0,0,0,0,0,0,0,0,0,0,0,0,0,0,0,0,0,0,0,0,0,0,0,0
13/6/2011,Sofiane Khedairia,8448719,5,4/1/1989,22,0,0,4,0,1200,4800,2400,125,96,35426,187,87,GK ,13,11,8,9,12,9,11,14,13,14,8,4,3,2,6,8,6,9,3,2,2,7,3,2,8,12,11,14,10,11,7,10,16,7,11,6,8,10,8,11,13,14,14,1,14,10,20,8,13,14,12,12,6,1,14,14,12,12,14,11,11,7,1,1,1,1,1,1,1,GK ,0,20,1,1,1,1,1,1,1,1,1,1,1,1,1,1,0,0,0,0,0,0,0,0,0,0,0,0,0,0,0,0,0,0,0,0,0,0,0,0,0,0,0,0,0,0,0,0,0,0,0,0,0,0,0,0,0,0,0,0,0,0,0,0,0
13/6/2011,Simone Colombi,43017867,776,7/1/1991,19,0,0,0,0,2250,4700,4700,150,95,1631574,186,80,GK ,10,11,11,5,12,9,11,12,9,10,10,1,2,1,1,5,1,4,1,1,1,4,1,1,4,15,11,11,11,13,6,13,16,5,8,4,11,8,9,10,13,12,13,5,15,10,20,10,11,15,5,10,5,1,13,15,11,15,16,12,17,11,1,1,1,1,1,1,1,GK ,0,20,1,1,1,1,1,1,1,1,1,1,1,1,1,1,0,0,0,0,0,0,0,0,0,0,0,0,0,0,0,0,0,0,0,0,0,0,0,0,0,0,0,0,0,0,0,0,0,0,0,0,0,0,0,0,0,0,0,0,0,0,0,0,0
13/6/2011,Simon Sluga,24024493,761,3/17/1993,18,0,0,0,0,1300,4350,3900,112,84,263230,184,83,GK ,13,7,9,16,11,13,12,13,11,11,10,1,3,3,3,2,4,1,3,1,2,2,3,3,7,4,7,13,9,11,2,13,9,1,12,1,11,1,3,7,11,11,8,10,17,6,20,7,6,7,5,7,13,9,14,14,11,5,11,5,6,10,1,1,1,1,1,1,1,GK ,0,20,1,1,1,1,1,1,1,1,1,1,1,1,1,1,0,0,0,0,0,0,0,0,0,0,0,0,0,0,0,0,0,0,0,0,0,0,0,0,0,0,0,0,0,0,0,0,0,0,0,0,0,0,0,0,0,0,0,0,0,0,0,0,0
13/6/2011,Simon Pontdemé,34001205,769,5/4/1988,23,0,0,0,0,2300,3650,3650,135,109,2353304,186,81,GK ,14,11,11,7,12,10,13,13,13,7,8,5,2,1,1,7,8,3,2,2,3,7,3,3,7,7,12,13,12,12,9,12,14,5,11,1,10,11,7,10,12,14,13,5,14,9,20,12,14,13,7,13,9,1,11,13,14,12,15,15,15,5,1,1,1,1,1,1,1,GK ,0,20,1,1,1,1,1,1,1,1,1,1,1,1,1,1,0,0,0,0,0,0,0,0,0,0,0,0,0,0,0,0,0,0,0,0,0,0,0,0,0,0,0,0,0,0,0,0,0,0,0,0,0,0,0,0,0,0,0,0,0,0,0,0,0
13/6/2011,Simon Mignolet,8167246,757,3/6/1988,23,3,0,9,0,4750,7205,6400,156,131,22704692,193,88,GK ,13,13,9,7,16,15,17,15,14,10,11,7,2,1,1,11,10,8,3,3,2,14,2,2,12,12,12,8,13,10,10,12,9,3,10,3,12,12,13,12,12,12,16,6,14,12,20,12,12,13,13,8,7,10,17,11,14,14,12,7,13,4,1,1,1,1,1,1,1,GK ,0,20,1,1,1,1,1,1,1,1,1,1,1,1,1,1,0,0,0,0,0,0,0,0,0,0,0,0,0,0,0,0,0,0,0,0,0,0,0,0,0,0,0,0,0,0,0,0,0,0,0,0,0,0,0,0,0,0,0,0,0,0,0,0,0
13/6/2011,Simon Jentzsch,8205,771,5/4/1976,35,0,0,12,0,5000,6500,6500,145,130,2587813,196,97,GK ,13,14,13,4,16,12,14,13,11,12,14,8,1,2,2,6,10,2,3,2,2,5,3,3,6,12,10,12,12,11,5,12,14,2,15,2,14,12,11,9,8,18,13,5,15,8,20,14,18,16,8,14,5,10,10,14,16,14,16,12,14,6,1,1,1,1,1,1,1,GK ,0,20,1,1,1,1,1,1,1,1,1,1,1,1,1,1,0,0,0,0,0,0,0,0,0,0,0,0,0,0,0,0,0,0,0,0,0,0,0,0,0,0,0,0,0,0,0,0,0,0,0,0,0,0,0,0,0,0,0,0,0,0,0,0,0
13/6/2011,Shay Given,2014402,789,4/20/1976,35,116,0,0,0,6300,8000,7250,162,152,8403106,186,84,GK ,13,12,15,8,16,14,16,18,13,14,12,6,2,5,2,9,8,5,1,3,2,10,1,10,9,9,15,12,15,15,6,15,14,8,15,3,12,12,12,8,14,15,14,10,13,8,20,14,9,18,6,15,12,1,19,17,16,15,14,17,17,3,1,1,1,1,1,1,1,GK ,0,20,1,1,1,1,1,1,1,1,1,1,1,1,1,1,0,0,0,0,0,0,0,0,0,0,0,0,0,0,0,0,0,0,0,0,0,0,0,0,0,0,0,0,0,0,0,0,0,0,0,0,0,0,0,0,0,0,0,0,0,0,0,0,0
13/6/2011,Sergio Romero,961299,1649,2/22/1987,24,11,0,23,0,6750,7000,7000,165,145,12618828,191,86,GK ,12,14,16,15,13,14,17,16,16,13,14,2,2,6,1,5,4,5,2,12,2,8,3,7,9,10,11,15,13,12,12,10,17,15,12,1,15,12,13,9,13,13,17,5,16,15,20,15,14,7,7,15,4,1,13,15,10,16,11,11,12,9,1,1,1,1,1,1,1,GK ,0,20,1,1,1,1,1,1,1,1,1,1,1,1,1,1,131072,0,0,0,0,0,0,0,0,0,0,0,0,0,0,0,0,0,1,0,0,0,0,0,0,0,0,0,0,0,0,0,0,0,0,0,0,0,0,0,0,0,0,0,0,0,0,0,0
13/6/2011,Sergio Garabato,67067061,796,5/16/1989,22,0,0,0,0,2000,4250,4250,112,85,289562,187,97,GK ,13,12,10,11,12,8,10,10,9,15,7,3,2,2,1,4,8,3,1,3,3,9,1,3,9,11,11,12,10,11,1,9,12,1,12,1,10,3,7,7,10,13,12,8,12,8,20,9,15,10,6,10,6,10,12,14,12,13,11,10,7,18,1,1,1,1,1,1,1,GK ,0,20,1,1,1,1,1,1,1,1,1,1,1,1,1,1,0,0,0,0,0,0,0,0,0,0,0,0,0,0,0,0,0,0,0,0,0,0,0,0,0,0,0,0,0,0,0,0,0,0,0,0,0,0,0,0,0,0,0,0,0,0,0,0,0
13/6/2011,Sergio Asenjo,67006488,796,6/28/1989,21,0,0,10,0,4900,6850,6850,160,138,86097323,184,85,GK ,13,15,12,7,12,15,14,16,13,7,11,8,3,3,1,5,10,3,2,2,1,2,1,3,4,10,15,13,6,12,5,11,13,15,10,6,13,12,12,13,16,13,13,5,12,14,20,16,14,13,8,14,14,10,9,15,13,15,17,15,18,9,1,1,1,1,1,1,1,GK ,0,20,1,1,1,1,1,1,1,1,1,1,1,1,1,1,0,0,0,0,0,0,0,0,0,0,0,0,0,0,0,0,0,0,0,0,0,0,0,0,0,0,0,0,0,0,0,0,0,0,0,0,0,0,0,0,0,0,0,0,0,0,0,0,0
13/6/2011,Sergio Álvarez,1501545,796,8/3/1986,24,0,0,0,0,2500,4500,4500,113,93,679101,179,75,GK ,10,7,15,6,9,11,11,11,6,9,10,6,2,3,1,5,10,2,2,3,2,2,3,1,5,6,12,10,6,13,3,15,7,2,10,3,7,2,4,9,14,16,10,10,13,9,20,6,9,10,11,10,17,10,9,9,14,14,11,7,7,8,1,1,1,1,1,1,1,GK ,0,20,1,1,1,1,1,1,1,1,1,1,1,1,1,1,0,0,0,0,0,0,0,0,0,0,0,0,0,0,0,0,0,0,0,0,0,0,0,0,0,0,0,0,0,0,0,0,0,0,0,0,0,0,0,0,0,0,0,0,0,0,0,0,0
13/6/2011,Serginho,734389,788,12/6/1982,28,0,0,0,0,1000,4500,4500,118,104,283483,192,85,GK ,13,13,11,11,13,13,13,13,10,8,10,5,3,2,3,1,7,1,3,3,3,1,2,2,5,12,9,11,8,12,1,13,6,3,14,1,11,1,1,11,10,13,12,7,12,10,20,5,4,10,11,10,10,10,17,15,15,11,7,13,14,9,1,1,1,1,1,1,1,GK ,0,20,1,1,1,1,1,1,1,1,1,1,1,1,1,1,0,0,0,0,0,0,0,0,0,0,0,0,0,0,0,0,0,0,0,0,0,0,0,0,0,0,0,0,0,0,0,0,0,0,0,0,0,0,0,0,0,0,0,0,0,0,0,0,0
13/6/2011,Sébastien Frey,3801487,769,3/18/1980,31,2,0,4,0,6250,6500,7100,145,142,12694309,189,89,GK ,12,8,12,16,11,15,18,18,8,17,13,6,1,3,2,5,10,5,1,8,7,10,1,2,7,15,15,14,16,14,9,14,18,5,13,5,11,13,11,12,15,12,16,5,15,13,20,15,13,17,7,16,6,10,18,18,16,18,17,11,17,8,1,1,1,1,1,1,1,GK ,0,20,1,1,1,1,1,1,1,1,1,1,1,1,1,1,0,0,0,0,0,0,0,0,0,0,0,0,0,0,0,0,0,0,0,0,0,0,0,0,0,0,0,0,0,0,0,0,0,0,0,0,0,0,0,0,0,0,0,0,0,0,0,0,0
13/6/2011,Sebastian Mielitz,92002690,771,7/18/1989,21,0,0,0,0,2250,5250,5250,133,105,5213013,188,73,GK ,14,9,10,7,13,13,14,14,11,12,14,2,1,3,2,3,6,2,3,2,3,2,2,2,3,8,8,11,14,11,1,13,12,1,12,1,11,3,7,14,16,13,14,8,11,10,20,5,5,10,3,8,11,10,12,14,10,8,12,18,14,7,1,1,1,1,1,1,1,GK ,0,20,1,1,1,1,1,1,1,1,1,1,1,1,1,1,0,0,0,0,0,0,0,0,0,0,0,0,0,0,0,0,0,0,0,0,0,0,0,0,0,0,0,0,0,0,0,0,0,0,0,0,0,0,0,0,0,0,0,0,0,0,0,0,0
13/6/2011,Sebastian Lange,35007369,771,10/16/1987,23,0,0,0,0,1500,4000,4000,95,80,26228,186,79,GK ,7,12,9,13,10,12,12,14,6,4,13,6,3,2,2,3,8,2,3,2,2,1,1,2,5,13,11,10,10,13,3,9,7,3,14,1,13,3,3,8,9,11,13,3,6,9,20,3,5,10,9,10,8,10,17,13,13,8,12,15,16,11,1,1,1,1,1,1,1,GK ,0,20,1,1,1,1,1,1,1,1,1,1,1,1,1,1,0,0,0,0,0,0,0,0,0,0,0,0,0,0,0,0,0,0,0,0,0,0,0,0,0,0,0,0,0,0,0,0,0,0,0,0,0,0,0,0,0,0,0,0,0,0,0,0,0
13/6/2011,Scott Loach,5122978,765,5/27/1988,23,0,0,14,0,4500,6000,6000,141,117,2990673,186,88,GK ,14,12,14,12,15,13,12,15,12,12,8,5,3,1,3,9,10,2,2,2,3,1,3,1,4,10,7,13,11,11,7,12,14,11,8,3,11,13,12,7,9,13,14,11,13,9,20,7,7,14,8,14,13,10,6,15,10,15,13,10,16,2,1,1,1,1,1,1,1,GK ,0,20,1,1,1,1,1,1,1,1,1,1,1,1,1,1,0,0,0,0,0,0,0,0,0,0,0,0,0,0,0,0,0,0,0,0,0,0,0,0,0,0,0,0,0,0,0,0,0,0,0,0,0,0,0,0,0,0,0,0,0,0,0,0,0
13/6/2011,Sascha Kirschstein,6000619,771,6/9/1980,31,0,0,0,0,4550,5800,5800,120,116,558284,196,90,GK ,9,10,13,12,14,11,11,15,12,8,12,7,1,1,1,8,9,7,1,2,2,10,2,1,9,15,12,13,12,10,6,11,15,1,14,1,12,11,12,11,11,12,18,8,15,11,20,13,16,8,18,10,7,10,10,17,9,17,12,3,9,16,1,1,1,1,1,1,1,GK ,0,20,1,1,1,1,1,1,1,1,1,1,1,1,1,1,2199023386624,0,0,0,0,0,0,0,0,0,0,0,0,0,0,0,0,0,1,0,0,0,0,0,0,0,0,0,0,0,0,0,0,0,0,0,0,0,0,0,0,0,1,0,0,0,0,0,0
13/6/2011,Samuel Radlinger,16024019,755,11/7/1992,18,0,0,2,0,2500,4250,4250,123,85,1423822,196,86,GK ,14,9,9,5,9,9,12,12,9,7,8,5,3,2,3,7,10,1,2,3,1,3,1,1,4,7,9,8,7,10,1,9,4,1,12,3,11,1,7,10,11,8,14,5,13,10,20,12,12,7,11,6,10,9,11,20,13,13,9,15,11,6,1,1,1,1,1,1,1,GK ,0,20,1,1,1,1,1,1,1,1,1,1,1,1,1,1,0,0,0,0,0,0,0,0,0,0,0,0,0,0,0,0,0,0,0,0,0,0,0,0,0,0,0,0,0,0,0,0,0,0,0,0,0,0,0,0,0,0,0,0,0,0,0,0,0
13/6/2011,Samir Ujkani,18003625,752,7/5/1988,22,8,0,7,0,1000,5984,6350,151,133,1112180,186,88,GK ,13,9,13,12,12,11,15,15,5,2,10,1,1,1,1,1,1,10,1,1,1,10,1,1,8,2,12,9,10,18,1,10,15,9,12,1,15,12,12,12,13,13,13,12,11,12,20,15,12,12,9,11,1,10,14,15,12,12,15,12,12,1,1,1,1,1,1,1,1,GK ,0,20,1,1,1,1,1,1,1,1,1,1,1,1,1,1,0,0,0,0,0,0,0,0,0,0,0,0,0,0,0,0,0,0,0,0,0,0,0,0,0,0,0,0,0,0,0,0,0,0,0,0,0,0,0,0,0,0,0,0,0,0,0,0,0
13/6/2011,Samir Handanovic,7582392,795,7/14/1984,26,51,0,7,0,5750,7800,7750,165,156,17389740,193,88,GK ,15,12,10,8,16,12,14,18,13,14,7,4,3,1,2,7,8,7,3,2,2,6,2,2,6,14,19,16,16,11,8,17,14,9,13,6,15,11,9,13,17,15,15,6,15,10,20,9,16,15,7,18,4,10,11,14,14,20,15,11,11,9,1,1,1,1,1,1,1,GK ,0,20,1,1,1,1,1,1,1,1,1,1,1,1,1,1,0,0,0,0,0,0,0,0,0,0,0,0,0,0,0,0,0,0,0,0,0,0,0,0,0,0,0,0,0,0,0,0,0,0,0,0,0,0,0,0,0,0,0,0,0,0,0,0,0
13/6/2011,Salvatore Sirigu,1401013,776,1/12/1987,24,2,0,4,0,5500,7250,7250,170,150,24346732,192,80,GK ,12,9,14,5,17,12,15,17,9,13,12,7,3,6,2,10,10,7,1,1,1,8,3,2,10,10,12,15,15,14,6,14,15,7,13,3,13,16,17,11,14,14,16,5,13,12,20,14,15,17,8,15,7,10,15,18,15,14,16,16,13,2,1,1,1,1,1,1,1,GK ,0,20,1,1,1,1,1,1,1,1,1,1,1,1,1,1,0,0,0,0,0,0,0,0,0,0,0,0,0,0,0,0,0,0,0,0,0,0,0,0,0,0,0,0,0,0,0,0,0,0,0,0,0,0,0,0,0,0,0,0,0,0,0,0,0
13/6/2011,Ruud Boffin,8161348,757,11/5/1987,23,0,0,0,0,4000,4814,5250,130,107,460204,196,86,GK ,13,11,11,5,12,11,12,14,7,8,11,4,1,2,1,5,6,3,2,2,3,2,1,3,10,9,14,7,12,10,3,12,9,3,4,2,14,2,4,14,13,13,16,8,11,11,20,8,6,10,11,7,6,10,14,8,17,12,14,8,8,10,1,1,1,1,1,1,1,GK ,0,20,1,1,1,1,1,1,1,1,1,1,1,1,1,1,0,0,0,0,0,0,0,0,0,0,0,0,0,0,0,0,0,0,0,0,0,0,0,0,0,0,0,0,0,0,0,0,0,0,0,0,0,0,0,0,0,0,0,0,0,0,0,0,0
13/6/2011,Rui Rêgo,4100636,788,7/5/1980,30,0,0,0,0,1000,5250,5250,112,109,482722,176,76,GK ,11,11,12,6,15,12,14,15,11,12,13,1,2,3,3,7,4,2,2,2,2,1,2,1,3,10,12,14,9,11,2,14,12,1,7,1,14,2,7,9,9,12,6,8,12,8,20,5,6,10,6,10,15,10,9,6,13,13,14,14,14,5,1,1,1,1,1,1,1,GK ,0,20,1,1,1,1,1,1,1,1,1,1,1,1,1,1,0,0,0,0,0,0,0,0,0,0,0,0,0,0,0,0,0,0,0,0,0,0,0,0,0,0,0,0,0,0,0,0,0,0,0,0,0,0,0,0,0,0,0,0,0,0,0,0,0
13/6/2011,Rui Patrício,55000929,788,2/15/1988,23,3,0,12,0,5500,7000,7000,164,140,24999999,188,84,GK ,13,13,13,5,14,14,14,17,11,13,14,6,2,1,1,10,10,4,3,12,1,11,1,3,9,12,10,12,15,14,2,11,14,2,10,2,15,10,15,12,15,16,16,20,15,8,5,14,15,12,9,13,9,10,12,12,16,12,16,16,16,4,1,1,1,1,1,1,1,GK ,0,20,1,1,1,1,1,1,1,1,1,1,1,1,1,1,0,0,0,0,0,0,0,0,0,0,0,0,0,0,0,0,0,0,0,0,0,0,0,0,0,0,0,0,0,0,0,0,0,0,0,0,0,0,0,0,0,0,0,0,0,0,0,0,0
13/6/2011,Rubinho,302583,1651,8/4/1982,28,0,0,0,0,5000,5000,5500,143,110,3635749,186,82,GK ,13,12,11,9,14,10,15,11,13,12,8,6,1,3,3,3,10,1,3,1,2,6,2,3,5,9,11,15,13,11,8,10,13,9,8,9,12,11,10,10,12,10,14,11,15,10,20,9,10,16,13,14,5,10,18,12,14,13,14,12,11,10,1,1,1,1,1,1,1,GK ,0,20,1,1,1,1,1,1,1,1,1,1,1,1,1,1,0,0,0,0,0,0,0,0,0,0,0,0,0,0,0,0,0,0,0,0,0,0,0,0,0,0,0,0,0,0,0,0,0,0,0,0,0,0,0,0,0,0,0,0,0,0,0,0,0
13/6/2011,Rubén,7451904,796,6/22/1984,26,0,0,1,0,3750,5750,5750,131,117,2999999,187,81,GK ,12,13,13,10,13,12,13,14,15,6,12,6,1,3,1,6,10,2,1,2,2,3,3,2,4,5,12,12,8,12,9,12,11,4,11,11,13,9,13,8,12,11,14,5,11,9,20,9,10,12,6,10,10,10,10,12,12,14,14,12,9,7,1,1,1,1,1,1,1,GK ,0,20,1,1,1,1,1,1,1,1,1,1,1,1,1,1,0,0,0,0,0,0,0,0,0,0,0,0,0,0,0,0,0,0,0,0,0,0,0,0,0,0,0,0,0,0,0,0,0,0,0,0,0,0,0,0,0,0,0,0,0,0,0,0,0
13/6/2011,Rubén Pérez,67009094,796,8/7/1980,30,0,0,0,0,4150,6000,6000,130,124,1290774,185,82,GK ,11,12,12,9,14,13,13,14,12,12,12,5,1,1,1,8,10,1,3,3,2,2,3,3,5,9,12,13,12,9,11,13,14,13,14,8,14,13,11,8,12,10,11,5,12,9,20,13,11,14,15,13,11,10,15,18,16,10,14,16,10,12,1,1,1,1,1,1,1,GK ,0,20,1,1,1,1,1,1,1,1,1,1,1,1,1,1,0,0,0,0,0,0,0,0,0,0,0,0,0,0,0,0,0,0,0,0,0,0,0,0,0,0,0,0,0,0,0,0,0,0,0,0,0,0,0,0,0,0,0,0,0,0,0,0,0
13/6/2011,Rubén Miño,67018886,796,1/18/1989,22,0,0,1,0,3250,5750,5750,130,116,4627483,191,87,GK ,11,12,12,5,13,12,14,15,14,8,11,7,2,1,3,8,10,6,2,3,3,8,1,2,6,7,12,13,12,10,9,11,10,3,7,3,11,12,11,10,14,13,15,6,12,12,20,13,11,11,3,10,9,10,5,9,12,13,11,8,11,10,1,1,1,1,1,1,1,GK ,0,20,1,1,1,1,1,1,1,1,1,1,1,1,1,1,0,0,0,0,0,0,0,0,0,0,0,0,0,0,0,0,0,0,0,0,0,0,0,0,0,0,0,0,0,0,0,0,0,0,0,0,0,0,0,0,0,0,0,0,0,0,0,0,0
13/6/2011,Rouven Sattelmaier,35012323,771,8/7/1987,23,0,0,0,0,1250,4500,4500,124,100,701057,186,85,GK ,8,8,7,6,12,10,14,14,9,11,9,2,3,3,2,6,4,2,3,3,1,1,1,2,7,11,9,13,9,13,1,14,9,2,5,1,14,3,3,11,11,11,12,14,17,11,20,4,12,10,6,10,9,10,6,11,17,12,13,5,9,8,1,1,1,1,1,1,1,GK ,0,20,1,1,1,1,1,1,1,1,1,1,1,1,1,1,0,0,0,0,0,0,0,0,0,0,0,0,0,0,0,0,0,0,0,0,0,0,0,0,0,0,0,0,0,0,0,0,0,0,0,0,0,0,0,0,0,0,0,0,0,0,0,0,0
13/6/2011,Ross Turnbull,5113381,765,1/4/1985,26,0,0,0,0,2750,5500,5500,145,127,7335590,193,93,GK ,14,12,13,5,14,13,14,14,10,7,11,7,2,2,1,4,10,3,2,3,1,7,2,1,1,3,10,13,12,12,4,11,15,1,12,2,11,13,14,7,11,11,17,10,8,9,20,10,17,12,1,10,5,10,9,14,10,11,16,15,10,5,1,1,1,1,1,1,1,GK ,0,20,1,1,1,1,1,1,1,1,1,1,1,1,1,1,0,0,0,0,0,0,0,0,0,0,0,0,0,0,0,0,0,0,0,0,0,0,0,0,0,0,0,0,0,0,0,0,0,0,0,0,0,0,0,0,0,0,0,0,0,0,0,0,0
13/6/2011,Ron-Robert Zieler,5127684,771,2/12/1989,22,0,0,0,0,5500,7300,7300,167,145,21989859,188,83,GK ,16,18,8,5,15,11,14,13,18,10,11,6,2,1,1,12,10,8,3,3,2,9,3,2,12,6,16,12,17,16,7,12,12,3,8,1,15,17,14,15,10,12,16,15,11,10,20,12,13,15,5,13,8,1,12,14,13,17,14,16,19,4,1,1,1,1,1,1,1,GK ,0,20,1,1,1,1,1,1,1,1,1,1,1,1,1,1,0,0,0,0,0,0,0,0,0,0,0,0,0,0,0,0,0,0,0,0,0,0,0,0,0,0,0,0,0,0,0,0,0,0,0,0,0,0,0,0,0,0,0,0,0,0,0,0,0
13/6/2011,Romuald Peiser,3600636,769,8/3/1979,31,0,0,0,0,3000,5200,5750,121,118,2470763,187,79,GK ,12,13,12,7,12,9,12,15,13,10,11,8,2,2,1,6,10,1,3,1,3,6,1,3,7,5,10,13,12,12,5,11,14,6,12,3,10,7,12,9,11,13,12,8,15,9,20,9,13,14,11,10,9,1,11,12,17,14,16,14,15,5,1,1,1,1,1,1,1,GK ,0,20,1,1,1,1,1,1,1,1,1,1,1,1,1,1,0,0,0,0,0,0,0,0,0,0,0,0,0,0,0,0,0,0,0,0,0,0,0,0,0,0,0,0,0,0,0,0,0,0,0,0,0,0,0,0,0,0,0,0,0,0,0,0,0
13/6/2011,Roman Weidenfeller,6000546,771,8/6/1980,30,0,0,3,0,6000,7250,7250,151,150,39648990,188,85,GK ,9,16,16,11,14,12,18,17,12,14,10,7,1,3,3,6,9,1,1,3,1,6,1,1,6,17,14,16,14,14,7,14,15,5,15,5,15,14,10,6,12,12,15,20,15,8,7,15,15,17,16,18,8,10,8,16,14,14,15,5,4,14,1,1,1,1,1,1,1,GK ,0,20,1,1,1,1,1,1,1,1,1,1,1,1,1,1,0,0,0,0,0,0,0,0,0,0,0,0,0,0,0,0,0,0,0,0,0,0,0,0,0,0,0,0,0,0,0,0,0,0,0,0,0,0,0,0,0,0,0,0,0,0,0,0,0
13/6/2011,Romain Salin,8428670,769,7/29/1984,26,0,0,0,0,1500,3450,5000,112,102,1360874,185,70,GK ,14,10,13,6,9,7,11,14,10,8,8,6,3,1,2,7,10,1,3,2,3,6,3,3,7,10,11,14,12,12,6,10,13,7,12,2,12,14,8,11,13,14,12,20,14,8,10,13,11,12,10,14,6,1,8,11,11,11,14,14,14,5,1,1,1,1,1,1,1,GK ,0,20,1,1,1,1,1,1,1,1,1,1,1,1,1,1,0,0,0,0,0,0,0,0,0,0,0,0,0,0,0,0,0,0,0,0,0,0,0,0,0,0,0,0,0,0,0,0,0,0,0,0,0,0,0,0,0,0,0,0,0,0,0,0,0
13/6/2011,Romain Ruffier,85010417,769,10/4/1989,21,0,0,0,0,1600,3200,3200,125,97,539534,186,79,GK ,14,10,10,7,11,12,13,13,11,9,6,4,1,3,1,8,9,3,10,3,2,8,2,3,8,8,7,13,12,12,8,9,14,6,8,3,8,12,9,12,11,14,13,1,15,9,20,13,14,14,8,7,5,1,10,11,13,11,15,15,15,5,1,1,1,1,1,1,1,GK ,0,20,1,1,1,1,1,1,1,1,1,1,1,1,1,1,0,0,0,0,0,0,0,0,0,0,0,0,0,0,0,0,0,0,0,0,0,0,0,0,0,0,0,0,0,0,0,0,0,0,0,0,0,0,0,0,0,0,0,0,0,0,0,0,0
13/6/2011,Romain Lejeune,34011548,769,5/21/1991,20,0,0,0,0,50,1750,1750,115,70,29187,182,81,GK ,13,10,11,5,9,13,13,11,7,4,10,4,2,3,3,6,9,1,3,3,2,2,2,3,6,11,7,14,8,5,1,10,9,3,7,3,7,2,3,8,12,13,10,1,16,7,20,3,13,10,8,10,8,1,17,19,14,10,10,14,12,7,1,1,1,1,1,1,1,GK ,0,20,1,1,1,1,1,1,1,1,1,1,1,1,1,1,0,0,0,0,0,0,0,0,0,0,0,0,0,0,0,0,0,0,0,0,0,0,0,0,0,0,0,0,0,0,0,0,0,0,0,0,0,0,0,0,0,0,0,0,0,0,0,0,0
13/6/2011,Roberto,1510293,796,2/10/1986,25,0,0,6,0,4050,6550,6550,146,131,22167580,191,76,GK ,11,8,12,4,13,13,14,17,7,14,15,2,1,3,2,8,7,8,1,1,1,10,3,2,6,8,12,13,11,14,7,12,14,4,10,2,14,13,13,8,14,13,16,9,13,11,20,13,12,12,6,14,5,10,10,14,8,9,16,16,14,6,1,1,1,1,1,1,1,GK ,0,20,1,1,1,1,1,1,1,1,1,1,1,1,1,1,0,0,0,0,0,0,0,0,0,0,0,0,0,0,0,0,0,0,0,0,0,0,0,0,0,0,0,0,0,0,0,0,0,0,0,0,0,0,0,0,0,0,0,0,0,0,0,0,0
13/6/2011,Roberto Santamaría,1502114,796,2/27/1985,26,0,0,0,0,4150,6000,6000,138,123,1122463,184,70,GK ,12,11,12,11,13,14,14,15,11,10,11,5,2,3,3,6,8,2,2,1,1,12,1,3,11,10,13,10,12,13,11,13,14,13,13,3,10,10,10,11,15,10,12,5,10,12,20,11,10,12,10,12,8,10,12,18,5,10,8,12,12,15,1,1,1,1,1,1,1,GK ,0,20,1,1,1,1,1,1,1,1,1,1,1,1,1,1,0,0,0,0,0,0,0,0,0,0,0,0,0,0,0,0,0,0,0,0,0,0,0,0,0,0,0,0,0,0,0,0,0,0,0,0,0,0,0,0,0,0,0,0,0,0,0,0,0
13/6/2011,Robert Green,107539,765,1/19/1980,31,11,0,0,0,6000,7300,7150,150,148,7084742,191,93,GK ,12,13,12,8,14,13,13,16,13,11,12,4,1,4,4,7,8,8,2,3,2,8,6,12,8,5,10,14,12,14,12,13,19,3,10,1,15,7,12,12,16,15,15,12,14,11,20,14,14,14,2,17,8,10,12,14,15,14,16,14,10,4,1,1,1,1,1,1,1,GK ,0,20,1,1,1,1,1,1,1,1,1,1,1,1,1,1,0,0,0,0,0,0,0,0,0,0,0,0,0,0,0,0,0,0,0,0,0,0,0,0,0,0,0,0,0,0,0,0,0,0,0,0,0,0,0,0,0,0,0,0,0,0,0,0,0
13/6/2011,Robert Almer,5603091,755,3/20/1984,27,0,0,3,0,4600,4949,5500,120,110,1202593,194,86,GK ,8,12,12,10,10,14,15,15,13,17,12,7,2,3,1,5,10,1,1,2,2,1,3,3,7,8,10,10,9,9,5,11,12,7,9,1,13,13,10,11,11,11,16,20,10,11,9,13,13,9,5,12,13,10,11,10,7,8,13,12,5,8,1,1,1,1,1,1,1,GK ,0,20,1,1,1,1,1,1,1,1,1,1,1,1,1,1,0,0,0,0,0,0,0,0,0,0,0,0,0,0,0,0,0,0,0,0,0,0,0,0,0,0,0,0,0,0,0,0,0,0,0,0,0,0,0,0,0,0,0,0,0,0,0,0,0
13/6/2011,Rob Lainton,28011689,765,10/12/1989,21,0,0,0,0,2250,4250,4250,135,93,1802204,185,79,GK ,11,12,12,6,12,10,12,10,10,9,11,3,1,3,2,5,8,3,3,2,3,2,2,2,5,8,9,8,10,9,10,10,10,4,5,8,11,10,8,11,10,11,13,10,11,11,20,12,12,9,3,6,3,10,9,8,20,9,10,6,15,11,1,1,1,1,1,1,1,GK ,0,20,1,1,1,1,1,1,1,1,1,1,1,1,1,1,0,0,0,0,0,0,0,0,0,0,0,0,0,0,0,0,0,0,0,0,0,0,0,0,0,0,0,0,0,0,0,0,0,0,0,0,0,0,0,0,0,0,0,0,0,0,0,0,0
13/6/2011,Ricardo,4201715,796,12/30/1971,39,2,0,0,0,5200,6700,6700,149,140,900685,187,88,GK ,13,15,14,12,14,10,15,15,13,8,11,5,2,1,2,6,10,7,3,1,2,9,1,3,8,7,14,14,10,16,4,14,16,4,12,3,15,12,13,6,13,14,14,20,12,8,5,12,15,17,4,15,9,10,11,15,14,6,15,15,9,3,1,1,1,1,1,1,1,GK ,0,20,1,1,1,1,1,1,1,1,1,1,1,1,1,1,0,0,0,0,0,0,0,0,0,0,0,0,0,0,0,0,0,0,0,0,0,0,0,0,0,0,0,0,0,0,0,0,0,0,0,0,0,0,0,0,0,0,0,0,0,0,0,0,0
13/6/2011,Ricardo Ribeiro,55013833,788,1/27/1990,21,0,0,0,0,150,2250,2250,100,70,2918,183,73,GK ,8,12,8,8,10,11,10,14,4,6,9,4,3,1,3,2,9,3,1,2,2,2,3,3,4,6,10,12,13,11,1,12,7,2,13,1,12,3,3,7,6,7,11,8,11,11,20,8,5,6,8,8,13,9,12,1,13,7,11,6,14,12,1,1,1,1,1,1,1,GK ,0,20,1,1,1,1,1,1,1,1,1,1,1,1,1,1,0,0,0,0,0,0,0,0,0,0,0,0,0,0,0,0,0,0,0,0,0,0,0,0,0,0,0,0,0,0,0,0,0,0,0,0,0,0,0,0,0,0,0,0,0,0,0,0,0
13/6/2011,Ricardo Ferreira,55006866,788,12/3/1989,21,0,0,0,0,500,1500,1500,117,88,86343,188,76,GK ,13,9,13,16,11,13,7,13,6,9,9,5,1,3,1,4,7,1,3,3,1,1,1,2,3,6,9,12,9,10,1,11,8,3,11,1,8,2,2,10,11,10,13,17,12,11,20,3,5,10,15,10,6,10,7,16,9,5,18,14,6,10,1,1,1,1,1,1,1,GK ,0,20,1,1,1,1,1,1,1,1,1,1,1,1,1,1,0,0,0,0,0,0,0,0,0,0,0,0,0,0,0,0,0,0,0,0,0,0,0,0,0,0,0,0,0,0,0,0,0,0,0,0,0,0,0,0,0,0,0,0,0,0,0,0,0
13/6/2011,Ricardo Andrade,1033189,1651,6/22/1977,33,0,0,0,0,1400,4900,4250,98,90,16070,187,79,GK ,14,12,14,11,13,13,11,5,8,6,8,3,3,1,3,5,8,2,3,1,1,2,3,1,4,7,10,10,10,13,3,13,15,1,12,3,14,3,10,5,13,12,15,8,9,5,20,4,9,10,12,10,3,10,9,13,12,9,4,8,10,9,1,1,1,1,1,1,1,GK ,0,20,1,1,1,1,1,1,1,1,1,1,1,1,1,1,0,0,0,0,0,0,0,0,0,0,0,0,0,0,0,0,0,0,0,0,0,0,0,0,0,0,0,0,0,0,0,0,0,0,0,0,0,0,0,0,0,0,0,0,0,0,0,0,0
13/6/2011,René Renno,3601880,771,2/19/1979,32,0,0,0,0,2750,5150,5500,110,103,285320,186,78,GK ,12,11,13,7,12,10,12,12,8,12,10,4,2,2,3,8,7,7,2,2,2,10,3,2,6,11,13,11,14,10,9,10,12,3,8,1,11,13,13,11,10,10,12,5,13,8,20,13,12,11,5,8,3,9,14,14,5,14,13,15,9,4,1,1,1,1,1,1,1,GK ,0,20,1,1,1,1,1,1,1,1,1,1,1,1,1,1,0,0,0,0,0,0,0,0,0,0,0,0,0,0,0,0,0,0,0,0,0,0,0,0,0,0,0,0,0,0,0,0,0,0,0,0,0,0,0,0,0,0,0,0,0,0,0,0,0
13/6/2011,Rene Gilmartin,5006572,789,5/31/1987,24,0,0,2,0,1400,4250,4250,111,88,455408,196,86,GK ,12,9,7,4,12,14,11,12,7,6,8,6,2,1,2,2,8,1,3,2,3,2,1,3,1,11,9,12,9,13,1,14,14,2,5,1,11,2,9,6,12,11,16,20,7,5,4,4,12,10,4,7,8,8,12,16,7,8,12,10,11,12,1,1,1,1,1,1,1,GK ,0,20,1,1,1,1,1,1,1,1,1,1,1,1,1,1,0,0,0,0,0,0,0,0,0,0,0,0,0,0,0,0,0,0,0,0,0,0,0,0,0,0,0,0,0,0,0,0,0,0,0,0,0,0,0,0,0,0,0,0,0,0,0,0,0
13/6/2011,René Adler,890482,771,1/15/1985,26,10,0,4,0,6750,7750,7750,175,163,12541575,190,85,GK ,10,10,13,5,16,11,17,18,14,12,10,3,3,2,1,11,7,7,2,1,1,10,3,2,11,12,15,13,16,16,6,14,18,7,13,1,18,16,15,15,17,12,15,14,18,12,20,16,12,12,3,15,14,10,14,17,14,16,18,17,15,4,1,1,1,1,1,1,1,GK ,0,20,1,1,1,1,1,1,1,1,1,1,1,1,1,1,0,0,0,0,0,0,0,0,0,0,0,0,0,0,0,0,0,0,0,0,0,0,0,0,0,0,0,0,0,0,0,0,0,0,0,0,0,0,0,0,0,0,0,0,0,0,0,0,0
13/6/2011,Rémy Vercoutre,3504014,769,6/26/1980,30,0,0,0,0,4800,6050,6050,136,134,3661844,185,78,GK ,11,14,12,6,14,12,14,15,13,14,10,5,3,2,3,8,8,11,8,3,1,7,2,2,8,11,13,15,12,12,7,12,9,5,14,3,13,15,10,13,14,14,12,1,15,12,20,13,14,13,11,13,8,1,17,14,16,10,17,9,9,11,1,1,1,1,1,1,1,GK ,0,20,1,1,1,1,1,1,1,1,1,1,1,1,1,1,0,0,0,0,0,0,0,0,0,0,0,0,0,0,0,0,0,0,0,0,0,0,0,0,0,0,0,0,0,0,0,0,0,0,0,0,0,0,0,0,0,0,0,0,0,0,0,0,0
13/6/2011,Rémy Riou,8435072,769,8/6/1987,23,0,0,6,0,4400,5500,5500,145,122,7539841,191,81,GK ,10,9,12,7,14,13,13,16,11,8,10,4,3,2,3,9,7,3,10,1,2,7,3,2,9,9,12,13,12,11,8,11,12,6,9,1,13,11,9,13,14,16,15,1,14,11,20,15,14,12,9,14,7,1,8,15,13,11,15,15,14,8,1,1,1,1,1,1,1,GK ,0,20,1,1,1,1,1,1,1,1,1,1,1,1,1,1,0,0,0,0,0,0,0,0,0,0,0,0,0,0,0,0,0,0,0,0,0,0,0,0,0,0,0,0,0,0,0,0,0,0,0,0,0,0,0,0,0,0,0,0,0,0,0,0,0
13/6/2011,Rémi Pillot,85028013,769,7/27/1990,20,0,0,0,0,1350,2700,2700,145,108,1934866,187,80,GK ,15,10,11,6,12,9,13,12,9,10,11,6,3,2,1,8,9,3,2,3,1,8,1,3,8,8,14,13,13,13,11,12,15,6,11,3,11,9,7,11,10,15,13,1,14,9,20,14,13,14,8,10,6,1,17,15,13,13,14,14,14,6,1,1,1,1,1,1,1,GK ,0,20,1,1,1,1,1,1,1,1,1,1,1,1,1,1,0,0,0,0,0,0,0,0,0,0,0,0,0,0,0,0,0,0,0,0,0,0,0,0,0,0,0,0,0,0,0,0,0,0,0,0,0,0,0,0,0,0,0,0,0,0,0,0,0
13/6/2011,Régis Gurtner,8434157,769,12/8/1986,24,0,0,0,0,1700,3400,3400,120,103,396259,183,80,GK ,10,10,10,7,12,7,11,15,11,10,10,1,2,3,3,7,5,2,1,2,3,7,3,1,7,8,14,13,12,12,6,11,14,6,8,2,11,12,9,12,13,14,11,1,15,11,20,15,14,14,8,13,5,1,7,12,16,13,15,15,15,6,1,1,1,1,1,1,1,GK ,0,20,1,1,1,1,1,1,1,1,1,1,1,1,1,1,0,0,0,0,0,0,0,0,0,0,0,0,0,0,0,0,0,0,0,0,0,0,0,0,0,0,0,0,0,0,0,0,0,0,0,0,0,0,0,0,0,0,0,0,0,0,0,0,0
13/6/2011,Raúl,67127965,796,1/27/1991,20,0,0,0,0,2250,4000,4000,129,85,852189,186,86,GK ,4,14,9,5,14,8,10,13,12,8,13,2,2,3,1,5,4,7,2,3,3,3,2,1,1,9,10,8,12,14,1,13,14,1,12,2,11,2,9,10,11,9,13,20,12,9,8,5,9,14,12,12,8,9,5,14,10,10,16,14,14,6,1,1,1,1,1,1,1,GK ,0,20,1,1,1,1,1,1,1,1,1,1,1,1,1,1,0,0,0,0,0,0,0,0,0,0,0,0,0,0,0,0,0,0,0,0,0,0,0,0,0,0,0,0,0,0,0,0,0,0,0,0,0,0,0,0,0,0,0,0,0,0,0,0,0
13/6/2011,Raúl Moreno,4209255,796,11/21/1979,31,0,0,0,0,2750,4950,4950,116,98,118329,184,76,GK ,9,11,13,9,11,5,13,15,11,13,5,1,3,2,2,4,5,2,3,3,2,3,1,2,2,5,13,13,10,10,5,13,8,4,15,4,10,12,13,10,14,7,10,5,6,14,20,13,13,10,4,13,10,10,12,13,5,11,11,14,5,7,1,1,1,1,1,1,1,GK ,0,20,1,1,1,1,1,1,1,1,1,1,1,1,1,1,0,0,0,0,0,0,0,0,0,0,0,0,0,0,0,0,0,0,0,0,0,0,0,0,0,0,0,0,0,0,0,0,0,0,0,0,0,0,0,0,0,0,0,0,0,0,0,0,0
13/6/2011,Raúl Fernández,67018270,796,3/13/1988,23,0,0,0,0,3500,5500,5500,135,115,2352810,193,88,GK ,15,12,9,6,13,13,11,15,9,6,10,8,2,1,2,3,10,3,1,1,2,2,3,1,2,4,12,12,13,13,4,12,11,2,11,3,13,4,7,9,13,13,17,10,16,10,20,5,15,10,9,9,14,10,12,13,14,10,7,12,5,12,1,1,1,1,1,1,1,GK ,0,20,1,1,1,1,1,1,1,1,1,1,1,1,1,1,0,0,0,0,0,0,0,0,0,0,0,0,0,0,0,0,0,0,0,0,0,0,0,0,0,0,0,0,0,0,0,0,0,0,0,0,0,0,0,0,0,0,0,0,0,0,0,0,0
13/6/2011,Raphael Schäfer,3601466,771,1/30/1979,32,0,0,0,0,5800,6700,6700,142,140,8628329,190,86,GK ,10,12,15,4,12,11,16,16,10,13,11,8,1,3,1,7,10,8,2,2,3,11,2,2,10,7,15,13,11,13,8,13,12,5,17,2,14,16,11,13,14,13,12,20,14,11,8,14,14,19,5,15,6,10,8,15,12,10,15,14,12,7,1,1,1,1,1,1,1,GK ,0,20,1,1,1,1,1,1,1,1,1,1,1,1,1,1,0,0,0,0,0,0,0,0,0,0,0,0,0,0,0,0,0,0,0,0,0,0,0,0,0,0,0,0,0,0,0,0,0,0,0,0,0,0,0,0,0,0,0,0,0,0,0,0,0
13/6/2011,Ramazan Özcan,5605704,755,6/28/1984,26,1,0,25,0,4200,5750,5700,128,118,1385341,186,84,GK ,8,7,15,12,12,18,14,14,7,8,18,4,2,3,3,7,9,1,2,1,3,6,1,3,7,11,9,16,12,9,5,7,11,3,12,1,10,16,12,13,10,14,12,6,17,8,20,15,16,13,5,10,13,10,13,13,12,8,8,13,9,13,1,1,1,1,1,1,1,GK ,0,20,1,1,1,1,1,1,1,1,1,1,1,1,1,1,0,0,0,0,0,0,0,0,0,0,0,0,0,0,0,0,0,0,0,0,0,0,0,0,0,0,0,0,0,0,0,0,0,0,0,0,0,0,0,0,0,0,0,0,0,0,0,0,0
13/6/2011,Ralf Fährmann,35016396,771,9/27/1988,22,0,0,1,0,4550,6300,6800,139,126,21102806,194,89,GK ,14,13,9,6,13,12,16,15,12,7,13,5,2,1,3,10,9,3,3,1,1,10,3,1,11,15,11,13,10,12,8,12,11,5,5,2,12,9,12,10,12,12,15,6,16,12,20,10,16,11,8,11,8,10,7,11,9,11,11,10,10,9,1,1,1,1,1,1,1,GK ,0,20,1,1,1,1,1,1,1,1,1,1,1,1,1,1,0,0,0,0,0,0,0,0,0,0,0,0,0,0,0,0,0,0,0,0,0,0,0,0,0,0,0,0,0,0,0,0,0,0,0,0,0,0,0,0,0,0,0,0,0,0,0,0,0
13/6/2011,Rafael,55028089,788,3/1/1992,19,0,0,0,0,250,1000,1000,75,65,4453,182,77,GK ,13,7,10,16,7,10,11,13,6,11,9,3,3,1,3,3,6,1,1,2,2,3,1,3,5,4,8,10,8,14,3,8,8,1,1,2,14,1,3,11,8,9,8,1,10,9,20,6,4,7,4,10,12,10,9,14,18,10,12,13,14,20,1,1,1,1,1,1,1,GK ,0,20,1,1,1,1,1,1,1,1,1,1,1,1,1,1,0,0,0,0,0,0,0,0,0,0,0,0,0,0,0,0,0,0,0,0,0,0,0,0,0,0,0,0,0,0,0,0,0,0,0,0,0,0,0,0,0,0,0,0,0,0,0,0,0
13/6/2011,Rafael Romo,86005935,1658,2/25/1990,21,3,0,18,0,2500,5750,5400,145,114,2445301,197,85,GK ,11,10,8,9,11,13,16,16,5,12,8,4,2,3,3,11,8,9,2,3,1,12,2,1,12,13,12,13,11,12,6,11,17,5,11,3,12,8,9,11,17,8,16,6,14,9,20,8,10,13,13,13,6,10,16,16,11,16,12,10,10,8,1,1,1,1,1,1,1,GK ,0,20,1,1,1,1,1,1,1,1,1,1,1,1,1,1,0,0,0,0,0,0,0,0,0,0,0,0,0,0,0,0,0,0,0,0,0,0,0,0,0,0,0,0,0,0,0,0,0,0,0,0,0,0,0,0,0,0,0,0,0,0,0,0,0
13/6/2011,Rafael Bracalli,312055,1651,5/5/1981,30,0,0,0,0,1500,5500,6300,131,128,5325142,185,76,GK ,13,12,14,5,14,13,14,16,12,12,14,7,2,1,3,7,10,3,1,2,3,1,2,3,6,10,10,10,14,12,2,14,13,2,15,1,14,10,15,13,11,10,14,8,16,10,20,10,11,14,10,16,12,10,13,11,15,14,14,14,15,6,1,1,1,1,1,1,1,GK ,0,20,1,1,1,1,1,1,1,1,1,1,1,1,1,1,0,0,0,0,0,0,0,0,0,0,0,0,0,0,0,0,0,0,0,0,0,0,0,0,0,0,0,0,0,0,0,0,0,0,0,0,0,0,0,0,0,0,0,0,0,0,0,0,0
13/6/2011,Radek Cerny,116428,763,2/18/1976,35,3,0,11,0,3800,5665,5500,130,103,1092369,187,87,GK ,10,7,8,11,14,10,15,16,12,19,11,4,3,2,3,7,8,3,2,3,2,2,1,3,3,6,11,8,11,12,6,11,14,14,7,2,11,10,7,10,12,14,15,20,13,8,5,8,15,11,7,11,3,10,10,9,15,18,15,12,14,11,1,1,1,1,1,1,1,GK ,0,20,1,1,1,1,1,1,1,1,1,1,1,1,1,1,17179869184,0,0,0,0,0,0,0,0,0,0,0,0,0,0,0,0,0,0,0,0,0,0,0,0,0,0,0,0,0,0,0,0,0,0,1,0,0,0,0,0,0,0,0,0,0,0,0,0
13/6/2011,Quim,1855,788,11/13/1975,35,32,0,7,0,4500,6750,6750,137,136,4703662,184,76,GK ,12,12,14,6,13,14,14,17,11,14,14,6,2,1,3,5,10,2,2,2,2,2,2,2,10,14,13,14,14,9,2,14,17,2,13,2,16,2,12,7,16,15,14,4,10,5,20,16,14,14,9,13,6,1,13,16,16,10,16,17,15,3,1,1,1,1,1,1,1,GK ,0,20,1,1,1,1,1,1,1,1,1,1,1,1,1,1,0,0,0,0,0,0,0,0,0,0,0,0,0,0,0,0,0,0,0,0,0,0,0,0,0,0,0,0,0,0,0,0,0,0,0,0,0,0,0,0,0,0,0,0,0,0,0,0,0
13/6/2011,Quentin Westberg,8428730,390,4/25/1986,25,0,0,21,0,2350,5300,4750,130,106,2896596,183,78,GK ,9,9,11,6,12,14,12,14,11,7,11,4,1,2,1,7,8,3,3,1,2,6,1,3,7,15,12,12,12,12,6,11,17,6,12,2,12,12,12,12,10,14,11,5,14,9,20,13,13,13,15,10,8,1,13,13,13,11,13,14,9,16,1,1,1,1,1,1,1,GK ,0,20,1,1,1,1,1,1,1,1,1,1,1,1,1,1,0,0,0,0,0,0,0,0,0,0,0,0,0,0,0,0,0,0,0,0,0,0,0,0,0,0,0,0,0,0,0,0,0,0,0,0,0,0,0,0,0,0,0,0,0,0,0,0,0
13/6/2011,Przemyslaw Frackowiak,96026799,787,1/7/1994,17,0,0,0,0,1000,3824,2500,111,85,681007,188,83,GK ,9,11,10,6,9,8,11,13,10,8,9,3,3,1,3,2,7,1,1,1,2,1,2,3,4,14,9,14,9,10,2,12,14,3,11,1,5,1,9,10,11,14,14,10,8,11,20,9,10,11,6,5,7,10,8,14,15,11,13,9,6,6,1,1,1,1,1,1,1,GK ,0,20,1,1,1,1,1,1,1,1,1,1,1,1,1,1,0,0,0,0,0,0,0,0,0,0,0,0,0,0,0,0,0,0,0,0,0,0,0,0,0,0,0,0,0,0,0,0,0,0,0,0,0,0,0,0,0,0,0,0,0,0,0,0,0
13/6/2011,Pinho,7004851,788,12/26/1971,39,0,0,0,0,500,4000,4000,80,45,0,181,79,GK ,8,6,10,3,9,10,9,10,10,10,9,2,2,2,1,2,4,2,3,3,3,1,3,2,3,9,9,11,10,11,1,8,16,3,6,1,9,2,10,6,12,10,9,20,14,5,7,2,3,9,8,10,8,10,10,11,15,15,14,15,15,5,1,1,1,1,1,1,1,GK ,0,20,1,1,1,1,1,1,1,1,1,1,1,1,1,1,0,0,0,0,0,0,0,0,0,0,0,0,0,0,0,0,0,0,0,0,0,0,0,0,0,0,0,0,0,0,0,0,0,0,0,0,0,0,0,0,0,0,0,0,0,0,0,0,0
13/6/2011,Pierrick Cros,85056628,769,6/23/1991,19,0,0,0,0,4400,5550,5550,150,123,16178544,185,75,GK ,13,11,12,11,13,12,13,13,15,11,8,8,1,3,3,10,10,2,2,2,3,8,1,3,10,8,13,15,14,14,9,12,13,6,9,1,10,11,8,15,14,14,13,1,15,12,20,14,13,14,8,14,8,1,5,14,13,16,14,14,14,5,1,1,1,1,1,1,1,GK ,0,20,1,5,1,1,1,1,1,1,1,1,1,1,1,1,0,0,0,0,0,0,0,0,0,0,0,0,0,0,0,0,0,0,0,0,0,0,0,0,0,0,0,0,0,0,0,0,0,0,0,0,0,0,0,0,0,0,0,0,0,0,0,0,0
13/6/2011,Pierre Kleinheider,91002423,771,11/7/1989,21,0,0,0,0,1000,4000,4000,95,80,203187,190,85,GK ,8,11,16,15,13,7,10,16,9,6,10,1,1,1,2,7,6,7,10,2,7,14,2,2,10,12,15,8,9,9,5,7,7,5,8,4,8,3,4,7,12,9,6,5,10,11,20,6,7,11,8,8,7,10,11,12,8,9,11,7,8,13,1,1,1,1,1,1,1,GK ,0,20,1,1,1,1,1,1,1,1,1,1,1,1,1,1,0,0,0,0,0,0,0,0,0,0,0,0,0,0,0,0,0,0,0,0,0,0,0,0,0,0,0,0,0,0,0,0,0,0,0,0,0,0,0,0,0,0,0,0,0,0,0,0,0
13/6/2011,Phillip Kühn,92035604,771,9/2/1992,18,0,0,0,0,2250,4250,4250,103,85,409423,189,95,GK ,14,10,13,13,12,12,10,14,6,13,11,6,2,3,2,4,9,2,2,3,3,3,2,1,6,7,4,11,9,12,3,9,9,3,12,1,12,2,4,12,9,9,15,2,6,10,20,3,6,10,8,10,9,9,6,13,17,6,16,14,14,20,1,1,1,1,1,1,1,GK ,0,20,1,1,1,1,1,1,1,1,1,1,1,1,1,1,0,0,0,0,0,0,0,0,0,0,0,0,0,0,0,0,0,0,0,0,0,0,0,0,0,0,0,0,0,0,0,0,0,0,0,0,0,0,0,0,0,0,0,0,0,0,0,0,0
13/6/2011,Philipp Heerwagen,890283,771,4/13/1983,28,0,0,0,0,4000,5650,5650,130,113,751978,193,89,GK ,13,11,12,6,13,12,13,14,11,9,11,6,3,3,2,9,9,3,3,3,1,11,3,2,8,8,10,11,17,9,4,11,12,11,11,10,12,12,12,11,12,12,14,5,11,8,20,11,12,9,4,9,2,10,5,11,14,12,13,14,13,6,1,1,1,1,1,1,1,GK ,0,20,1,1,1,1,1,1,1,1,1,1,1,1,1,1,0,0,0,0,0,0,0,0,0,0,0,0,0,0,0,0,0,0,0,0,0,0,0,0,0,0,0,0,0,0,0,0,0,0,0,0,0,0,0,0,0,0,0,0,0,0,0,0,0
13/6/2011,Petr Cech,5640119,763,5/20/1982,29,83,0,15,0,8600,9000,9000,182,173,229999992,196,90,GK ,15,12,14,3,18,18,17,17,14,7,12,6,1,3,2,13,10,3,1,2,2,13,1,3,13,5,16,14,14,19,8,13,13,5,8,7,16,13,15,9,16,15,19,20,17,9,11,14,12,16,3,14,14,1,19,14,14,16,18,13,19,3,1,1,1,1,1,1,1,GK ,0,20,1,1,1,1,1,1,1,1,1,1,1,1,1,1,0,0,0,0,0,0,0,0,0,0,0,0,0,0,0,0,0,0,0,0,0,0,0,0,0,0,0,0,0,0,0,0,0,0,0,0,0,0,0,0,0,0,0,0,0,0,0,0,0
13/6/2011,Peter Gulácsi,28018193,773,5/6/1990,21,0,0,1,0,2200,5000,4900,114,95,834071,191,83,GK ,9,8,8,5,9,13,13,15,10,12,6,2,3,3,3,6,7,1,2,2,2,2,2,2,3,6,9,9,8,10,9,11,10,5,12,1,11,8,4,7,11,11,14,10,10,9,20,9,13,13,11,12,14,10,14,15,5,8,14,10,10,7,1,1,1,1,1,1,1,GK ,0,20,1,1,1,1,1,1,1,1,1,1,1,1,1,1,0,0,0,0,0,0,0,0,0,0,0,0,0,0,0,0,0,0,0,0,0,0,0,0,0,0,0,0,0,0,0,0,0,0,0,0,0,0,0,0,0,0,0,0,0,0,0,0,0
13/6/2011,Peter Brezovan,5640845,794,12/9/1979,31,0,0,0,0,2500,4400,4400,89,88,69262,198,96,GK ,16,16,8,6,7,10,9,11,5,8,13,2,2,1,2,6,7,7,3,1,2,9,2,2,6,7,12,13,9,12,5,8,9,8,7,2,9,9,8,12,7,15,18,12,4,4,20,4,12,9,6,10,7,10,15,9,10,7,8,10,9,5,1,1,1,1,1,1,1,GK ,0,20,1,1,1,1,1,1,1,1,1,1,1,1,1,1,0,0,0,0,0,0,0,0,0,0,0,0,0,0,0,0,0,0,0,0,0,0,0,0,0,0,0,0,0,0,0,0,0,0,0,0,0,0,0,0,0,0,0,0,0,0,0,0,0
13/6/2011,Pedro Trigueira,744217,788,1/4/1988,23,0,0,0,0,1000,3750,3750,86,80,9822,192,91,GK ,11,11,9,10,11,8,8,10,8,7,10,2,1,1,2,6,7,4,1,3,3,3,2,1,2,6,14,11,9,7,3,15,8,3,5,1,14,3,5,8,14,14,15,5,13,9,20,4,6,10,12,10,15,10,11,3,9,8,17,12,15,12,1,1,1,1,1,1,1,GK ,0,20,1,1,1,1,1,1,1,1,1,1,1,1,1,1,0,0,0,0,0,0,0,0,0,0,0,0,0,0,0,0,0,0,0,0,0,0,0,0,0,0,0,0,0,0,0,0,0,0,0,0,0,0,0,0,0,0,0,0,0,0,0,0,0
13/6/2011,Pedro Guedes,55041580,788,1/3/1995,16,0,0,0,0,500,2500,2500,116,65,415684,184,72,GK ,11,10,8,11,9,12,8,13,8,7,10,3,3,3,2,3,5,1,2,2,2,2,2,1,3,13,8,10,4,10,1,10,6,2,6,1,10,1,1,5,11,11,9,1,8,9,20,2,4,10,6,5,11,9,13,14,10,10,13,14,9,13,1,1,1,1,1,1,1,GK ,0,20,1,1,1,1,1,1,1,1,1,1,1,1,1,1,0,0,0,0,0,0,0,0,0,0,0,0,0,0,0,0,0,0,0,0,0,0,0,0,0,0,0,0,0,0,0,0,0,0,0,0,0,0,0,0,0,0,0,0,0,0,0,0,0
13/6/2011,Peçanha,8830559,1651,1/11/1980,31,0,0,0,0,3000,6000,6000,125,121,4942568,182,75,GK ,12,13,12,7,13,14,12,14,13,10,13,7,1,3,2,10,9,3,1,3,1,11,1,3,11,12,11,12,12,10,2,11,17,3,12,2,12,2,12,12,13,10,13,20,14,12,5,6,10,10,10,10,4,10,12,12,14,15,16,15,16,6,1,1,1,1,1,1,1,GK ,0,20,1,1,1,1,1,1,1,1,1,1,1,1,1,1,0,0,0,0,0,0,0,0,0,0,0,0,0,0,0,0,0,0,0,0,0,0,0,0,0,0,0,0,0,0,0,0,0,0,0,0,0,0,0,0,0,0,0,0,0,0,0,0,0
13/6/2011,Paulo Santos,532,788,12/11/1972,38,1,0,0,0,2000,5300,5300,104,104,172063,180,86,GK ,11,10,11,12,11,12,13,14,13,12,12,2,2,14,1,6,5,1,17,1,3,10,1,13,11,14,10,10,10,11,1,7,16,3,6,2,12,8,13,10,14,9,10,7,14,11,20,14,8,13,5,12,6,1,11,14,13,9,10,8,3,7,1,1,1,1,1,1,1,GK ,0,20,1,1,1,1,1,1,1,1,1,1,1,1,1,1,196608,0,0,0,0,0,0,0,0,0,0,0,0,0,0,0,0,1,1,0,0,0,0,0,0,0,0,0,0,0,0,0,0,0,0,0,0,0,0,0,0,0,0,0,0,0,0,0,0
13/6/2011,Paulo Lopes,115925,788,6/29/1978,32,0,0,15,0,1500,5000,3500,110,108,138136,183,73,GK ,11,11,10,7,13,14,10,14,9,7,11,4,1,2,1,5,7,2,2,3,2,1,3,2,2,3,7,15,14,5,1,12,14,1,14,1,13,13,12,7,13,13,10,8,9,6,20,9,9,14,6,9,7,10,12,13,13,12,15,14,13,9,1,1,1,1,1,1,1,GK ,0,20,1,1,1,1,1,1,1,1,1,1,1,1,1,1,0,0,0,0,0,0,0,0,0,0,0,0,0,0,0,0,0,0,0,0,0,0,0,0,0,0,0,0,0,0,0,0,0,0,0,0,0,0,0,0,0,0,0,0,0,0,0,0,0
13/6/2011,Paul Smith,5101546,765,12/17/1979,31,0,0,0,0,2500,5500,5500,121,110,350058,191,89,GK ,15,7,11,5,12,5,13,13,12,5,13,3,2,3,2,10,2,2,3,3,1,3,4,7,15,4,12,14,12,9,4,11,17,4,5,2,14,8,15,11,15,15,15,10,10,10,20,17,14,13,6,10,6,10,3,17,12,12,18,15,13,3,1,1,1,1,1,1,1,GK ,0,20,1,1,1,1,1,1,1,1,1,1,1,1,1,1,0,0,0,0,0,0,0,0,0,0,0,0,0,0,0,0,0,0,0,0,0,0,0,0,0,0,0,0,0,0,0,0,0,0,0,0,0,0,0,0,0,0,0,0,0,0,0,0,0
13/6/2011,Paul Robinson,108640,765,10/15/1979,31,41,0,14,0,5900,7600,7600,158,149,17586013,194,90,GK ,15,14,16,5,15,20,17,16,6,12,10,3,2,3,3,8,6,6,2,1,3,10,12,4,6,2,10,10,10,11,7,11,13,1,15,2,14,8,8,8,15,12,16,11,6,8,20,10,16,14,5,13,5,3,14,15,15,15,18,17,12,7,1,1,1,1,1,1,1,GK ,0,20,1,1,1,1,1,1,1,1,1,1,1,1,1,1,2199023255552,0,0,0,0,0,0,0,0,0,0,0,0,0,0,0,0,0,0,0,0,0,0,0,0,0,0,0,0,0,0,0,0,0,0,0,0,0,0,0,0,0,1,0,0,0,0,0,0
13/6/2011,Paul Rachubka,5100702,765,5/21/1981,30,0,0,0,0,2600,5250,5100,123,111,1150000,186,85,GK ,12,12,12,4,13,12,16,15,11,6,13,3,3,2,2,7,7,3,3,1,1,1,3,2,12,7,10,9,9,10,10,11,15,3,3,3,12,13,14,12,12,11,12,5,12,4,20,13,8,13,2,11,7,3,12,14,12,15,16,14,11,6,1,1,1,1,1,1,1,GK ,0,20,1,1,1,1,1,1,1,1,1,1,1,1,1,1,0,0,0,0,0,0,0,0,0,0,0,0,0,0,0,0,0,0,0,0,0,0,0,0,0,0,0,0,0,0,0,0,0,0,0,0,0,0,0,0,0,0,0,0,0,0,0,0,0
13/6/2011,Patrick Rakovsky,91100535,771,6/2/1993,18,0,0,0,0,3250,5000,5500,113,100,11253379,187,86,GK ,10,14,9,5,12,12,10,14,9,6,10,1,1,2,2,5,4,2,3,2,3,2,3,2,7,6,6,13,8,11,3,12,9,3,8,3,14,1,4,6,12,14,14,20,14,9,5,4,6,9,7,10,12,9,7,16,11,13,9,13,8,9,1,1,1,1,1,1,1,GK ,0,20,1,1,1,1,1,1,1,1,1,1,1,1,1,1,0,0,0,0,0,0,0,0,0,0,0,0,0,0,0,0,0,0,0,0,0,0,0,0,0,0,0,0,0,0,0,0,0,0,0,0,0,0,0,0,0,0,0,0,0,0,0,0,0
13/6/2011,Patrick Nettekoven,35009341,771,1/21/1987,24,0,0,0,0,200,2550,2550,75,61,50281,185,77,GK ,10,10,11,4,8,7,6,9,10,11,8,5,3,1,3,1,7,2,3,3,1,3,1,3,5,6,9,11,10,9,4,11,10,3,6,3,10,9,9,9,10,9,14,1,9,10,20,11,12,8,7,10,8,9,7,6,10,13,7,16,5,18,1,1,1,1,1,1,1,GK ,0,20,1,1,1,1,1,1,1,1,1,1,1,1,1,1,0,0,0,0,0,0,0,0,0,0,0,0,0,0,0,0,0,0,0,0,0,0,0,0,0,0,0,0,0,0,0,0,0,0,0,0,0,0,0,0,0,0,0,0,0,0,0,0,0
13/6/2011,Patric Klandt,890578,771,9/29/1983,27,0,0,0,0,3700,6000,6000,128,120,751815,184,80,GK ,13,13,12,8,12,13,10,14,11,7,11,3,2,2,3,6,7,2,2,1,2,2,3,3,6,7,12,13,8,13,7,12,12,3,12,3,14,13,10,10,13,15,12,5,13,8,20,11,13,13,9,12,14,10,4,13,9,11,13,14,13,5,1,1,1,1,1,1,1,GK ,0,20,1,1,1,1,1,1,1,1,1,1,1,1,1,1,0,0,0,0,0,0,0,0,0,0,0,0,0,0,0,0,0,0,0,0,0,0,0,0,0,0,0,0,0,0,0,0,0,0,0,0,0,0,0,0,0,0,0,0,0,0,0,0,0
13/6/2011,Papa Coulibaly,34009802,41,3/2/1988,23,0,0,0,0,2800,5129,5100,140,114,5851613,194,92,GK ,16,13,12,7,10,11,14,13,12,14,13,6,2,3,1,6,10,2,3,3,2,6,3,3,6,12,12,14,10,10,6,7,13,5,8,3,10,10,12,14,12,18,17,1,15,11,20,13,18,13,11,10,6,1,11,13,14,11,11,15,15,6,1,1,1,1,1,1,1,GK ,0,20,1,1,1,1,1,1,1,1,1,1,1,1,1,1,0,0,0,0,0,0,0,0,0,0,0,0,0,0,0,0,0,0,0,0,0,0,0,0,0,0,0,0,0,0,0,0,0,0,0,0,0,0,0,0,0,0,0,0,0,0,0,0,0
13/6/2011,Paes,2110609,1651,12/11/1982,28,0,0,0,0,1000,5250,5250,115,106,411500,189,87,GK ,14,14,10,5,12,14,14,14,4,5,14,3,1,3,2,10,7,2,1,3,2,1,2,2,10,7,8,11,14,8,1,14,10,3,2,1,14,1,5,12,11,14,14,5,11,7,20,4,5,9,4,5,8,9,6,15,9,7,13,8,11,2,1,1,1,1,1,1,1,GK ,0,20,1,1,1,1,1,1,1,1,1,1,1,1,1,1,0,0,0,0,0,0,0,0,0,0,0,0,0,0,0,0,0,0,0,0,0,0,0,0,0,0,0,0,0,0,0,0,0,0,0,0,0,0,0,0,0,0,0,0,0,0,0,0,0
13/6/2011,Paddy Kenny,4001574,789,5/17/1978,33,7,0,0,0,4000,6500,6500,138,133,9437152,186,94,GK ,12,12,13,12,14,15,15,14,14,8,10,5,3,3,2,5,7,8,2,1,1,8,3,2,10,10,14,16,13,15,10,12,13,2,12,3,13,15,12,9,11,10,12,5,5,7,20,16,17,15,10,13,5,1,11,13,15,16,6,13,10,16,1,1,1,1,1,1,1,GK ,0,20,1,1,1,1,1,1,1,1,1,1,1,1,1,1,65536,0,0,0,0,0,0,0,0,0,0,0,0,0,0,0,0,1,0,0,0,0,0,0,0,0,0,0,0,0,0,0,0,0,0,0,0,0,0,0,0,0,0,0,0,0,0,0,0
13/6/2011,Pablo Alcolea,67063854,796,3/26/1989,22,0,0,0,0,1650,3650,3650,101,73,586349,184,78,GK ,8,9,7,4,12,8,10,13,12,7,9,6,3,1,2,5,8,2,2,2,3,6,1,3,5,6,7,9,8,10,4,8,10,4,5,2,9,8,8,8,13,8,10,5,13,9,20,11,10,13,4,11,12,10,10,10,12,10,6,14,4,13,1,1,1,1,1,1,1,GK ,0,20,1,1,1,1,1,1,1,1,1,1,1,1,1,1,0,0,0,0,0,0,0,0,0,0,0,0,0,0,0,0,0,0,0,0,0,0,0,0,0,0,0,0,0,0,0,0,0,0,0,0,0,0,0,0,0,0,0,0,0,0,0,0,0
13/6/2011,Oumar Sissoko,8432910,31,9/13/1987,23,0,0,2,0,3350,5700,5100,135,114,1286520,187,84,GK ,14,12,10,8,12,9,14,13,11,15,9,4,1,2,3,7,9,1,1,3,2,6,1,3,7,7,12,13,13,13,6,11,14,5,10,2,10,12,9,13,13,16,13,1,14,11,20,14,16,14,7,13,8,1,13,14,14,13,15,16,16,5,1,1,1,1,1,1,1,GK ,0,20,1,1,1,1,1,1,1,1,1,1,1,1,1,1,0,0,0,0,0,0,0,0,0,0,0,0,0,0,0,0,0,0,0,0,0,0,0,0,0,0,0,0,0,0,0,0,0,0,0,0,0,0,0,0,0,0,0,0,0,0,0,0,0
13/6/2011,Oriol Torres,67112982,796,5/17/1991,20,0,0,0,0,1250,3250,3250,90,70,33717,180,80,GK ,10,8,11,15,11,10,9,10,9,8,10,2,2,3,2,3,6,2,3,2,2,1,1,1,4,15,7,11,8,11,1,10,7,2,10,2,13,1,1,12,12,13,9,8,13,8,20,3,4,10,8,6,13,9,5,17,17,4,13,5,9,7,1,1,1,1,1,1,1,GK ,0,20,1,1,1,1,1,1,1,1,1,1,1,1,1,1,0,0,0,0,0,0,0,0,0,0,0,0,0,0,0,0,0,0,0,0,0,0,0,0,0,0,0,0,0,0,0,0,0,0,0,0,0,0,0,0,0,0,0,0,0,0,0,0,0
13/6/2011,Olivier Sorin,911853,769,4/16/1981,30,0,0,0,0,5100,6300,6300,145,139,7458395,188,76,GK ,13,14,16,5,12,16,14,12,13,10,11,4,2,2,2,8,9,2,11,2,3,7,2,1,8,9,12,15,13,14,11,13,16,6,15,3,14,12,8,11,13,14,14,1,14,10,20,14,14,14,9,14,7,1,7,14,14,14,15,13,13,5,1,1,1,1,1,1,1,GK ,0,20,1,1,1,1,1,1,1,1,1,1,1,1,1,1,0,0,0,0,0,0,0,0,0,0,0,0,0,0,0,0,0,0,0,0,0,0,0,0,0,0,0,0,0,0,0,0,0,0,0,0,0,0,0,0,0,0,0,0,0,0,0,0,0
13/6/2011,Oliver Baumann,35017377,771,6/2/1990,21,0,0,5,0,4500,6250,6250,160,135,9383966,187,83,GK ,14,11,14,12,15,11,16,16,9,8,9,8,1,3,1,2,10,3,2,1,2,2,2,2,1,15,11,11,9,13,13,12,10,2,12,2,12,13,11,12,13,13,12,10,15,11,20,10,11,16,9,12,4,10,5,15,13,16,17,17,12,9,1,1,1,1,1,1,1,GK ,0,20,1,1,1,1,1,1,1,1,1,1,1,1,1,1,0,0,0,0,0,0,0,0,0,0,0,0,0,0,0,0,0,0,0,0,0,0,0,0,0,0,0,0,0,0,0,0,0,0,0,0,0,0,0,0,0,0,0,0,0,0,0,0,0
13/6/2011,Ole Söderberg,8119984,797,7/20/1990,20,0,0,0,0,2000,4000,3950,107,86,1031104,191,85,GK ,10,8,10,8,12,12,10,14,10,8,14,6,3,1,1,7,9,5,2,3,2,9,1,3,9,9,9,8,8,10,8,8,13,3,8,3,10,10,11,9,11,13,14,20,13,8,8,11,10,9,3,10,8,10,11,15,11,11,7,8,7,7,1,1,1,1,1,1,1,GK ,0,20,1,1,1,1,1,1,1,1,1,1,1,1,1,1,0,0,0,0,0,0,0,0,0,0,0,0,0,0,0,0,0,0,0,0,0,0,0,0,0,0,0,0,0,0,0,0,0,0,0,0,0,0,0,0,0,0,0,0,0,0,0,0,0
13/6/2011,Oka Nikolov,4803,781,5/25/1974,37,5,0,0,0,4250,5804,6450,132,129,1571457,188,86,GK ,14,14,13,9,14,11,13,15,13,13,12,6,2,2,3,5,10,1,3,2,2,2,3,3,7,7,12,14,12,14,4,11,10,3,11,3,13,10,11,11,12,11,14,4,15,8,20,11,13,10,6,12,7,10,14,10,20,9,10,8,7,7,1,1,1,1,1,1,1,GK ,0,20,1,1,1,1,1,1,1,1,1,1,1,1,1,1,0,0,0,0,0,0,0,0,0,0,0,0,0,0,0,0,0,0,0,0,0,0,0,0,0,0,0,0,0,0,0,0,0,0,0,0,0,0,0,0,0,0,0,0,0,0,0,0,0
13/6/2011,Oier Olazabal,67029330,796,10/11/1989,21,0,0,0,0,2500,5450,5450,135,109,732714,190,95,GK ,15,12,11,4,12,14,9,14,13,5,14,4,1,2,2,7,9,4,3,2,2,8,3,1,7,7,12,10,12,9,6,11,6,7,8,4,13,12,11,10,12,15,16,20,14,11,5,13,13,15,3,9,3,10,9,20,11,11,7,9,10,7,1,1,1,1,1,1,1,GK ,0,20,1,1,1,1,1,1,1,1,1,1,1,1,1,1,0,0,0,0,0,0,0,0,0,0,0,0,0,0,0,0,0,0,0,0,0,0,0,0,0,0,0,0,0,0,0,0,0,0,0,0,0,0,0,0,0,0,0,0,0,0,0,0,0
13/6/2011,Nílson,301928,9,12/26/1975,35,0,0,0,0,2000,6400,6100,130,122,836732,183,80,GK ,11,13,12,8,13,13,14,16,10,13,11,5,1,3,2,8,7,3,2,3,2,2,2,1,7,3,8,13,10,10,3,10,12,3,10,2,11,6,11,8,14,14,14,5,18,6,20,10,12,9,8,8,6,10,12,12,11,9,12,13,14,6,1,1,1,1,1,1,1,GK ,0,20,1,1,1,1,1,1,1,1,1,1,1,1,1,1,0,0,0,0,0,0,0,0,0,0,0,0,0,0,0,0,0,0,0,0,0,0,0,0,0,0,0,0,0,0,0,0,0,0,0,0,0,0,0,0,0,0,0,0,0,0,0,0,0
13/6/2011,Nils Zumbeel,91014663,771,1/19/1990,21,0,0,0,0,250,3750,3750,95,75,9847,192,0,GK ,13,13,11,6,12,12,11,11,8,10,10,3,1,3,2,1,7,1,3,1,2,2,1,3,3,4,9,12,9,9,1,8,7,1,10,3,11,1,1,9,11,13,14,1,13,10,20,3,4,9,3,7,12,9,7,13,7,18,13,8,11,8,1,1,1,1,1,1,1,GK ,0,20,1,1,1,1,1,1,1,1,1,1,1,1,1,1,0,0,0,0,0,0,0,0,0,0,0,0,0,0,0,0,0,0,0,0,0,0,0,0,0,0,0,0,0,0,0,0,0,0,0,0,0,0,0,0,0,0,0,0,0,0,0,0,0
13/6/2011,Niklas Jakusch,91104071,771,12/20/1989,21,0,0,0,0,650,3250,3250,93,65,3882,187,80,GK ,12,4,7,12,12,10,8,10,12,12,9,5,1,3,2,2,8,1,2,2,3,1,2,2,1,11,9,11,8,9,1,12,8,1,1,1,12,1,2,9,14,13,12,5,8,11,20,2,4,7,9,10,10,10,6,2,11,17,13,15,7,13,1,1,1,1,1,1,1,GK ,0,20,1,1,1,1,1,1,1,1,1,1,1,1,1,1,0,0,0,0,0,0,0,0,0,0,0,0,0,0,0,0,0,0,0,0,0,0,0,0,0,0,0,0,0,0,0,0,0,0,0,0,0,0,0,0,0,0,0,0,0,0,0,0,0
13/6/2011,Niklas Hartmann,91017867,771,12/9/1989,21,0,0,0,0,1750,3500,3500,85,70,3812,189,85,GK ,10,10,9,10,9,10,11,12,14,11,7,2,1,3,1,1,5,1,1,1,3,1,1,2,4,8,2,9,8,10,1,11,9,2,12,1,12,1,2,12,15,14,12,1,13,7,20,3,3,10,6,10,14,9,14,11,15,15,15,8,4,10,1,1,1,1,1,1,1,GK ,0,20,1,1,1,1,1,1,1,1,1,1,1,1,1,1,0,0,0,0,0,0,0,0,0,0,0,0,0,0,0,0,0,0,0,0,0,0,0,0,0,0,0,0,0,0,0,0,0,0,0,0,0,0,0,0,0,0,0,0,0,0,0,0,0
13/6/2011,Nicolas,19001680,1651,4/12/1988,23,0,0,0,0,750,4950,4950,112,87,518801,182,75,GK ,13,9,8,3,13,13,8,13,11,9,13,7,3,3,1,5,10,1,3,3,2,1,3,1,8,6,9,14,7,7,2,9,13,1,2,3,13,2,7,12,16,14,13,1,16,8,20,5,5,10,12,8,13,9,10,11,14,12,12,8,11,8,1,1,1,1,1,1,1,GK ,0,20,1,1,1,1,1,1,1,1,1,1,1,1,1,1,0,0,0,0,0,0,0,0,0,0,0,0,0,0,0,0,0,0,0,0,0,0,0,0,0,0,0,0,0,0,0,0,0,0,0,0,0,0,0,0,0,0,0,0,0,0,0,0,0
13/6/2011,Nicolas Penneteau,3503528,769,2/28/1981,30,0,0,13,0,4900,6100,6100,140,135,6286340,185,78,GK ,12,12,14,9,14,12,13,15,11,16,13,6,1,3,1,6,10,1,2,3,1,8,1,3,6,9,13,17,9,12,7,12,15,6,14,3,14,12,12,13,13,14,12,20,16,10,1,14,14,13,9,15,8,1,5,14,15,13,15,13,13,7,1,1,1,1,1,1,1,GK ,0,20,1,1,1,1,1,1,1,1,1,1,1,1,1,1,0,0,0,0,0,0,0,0,0,0,0,0,0,0,0,0,0,0,0,0,0,0,0,0,0,0,0,0,0,0,0,0,0,0,0,0,0,0,0,0,0,0,0,0,0,0,0,0,0
13/6/2011,Nicolas Douchez,3503633,769,4/22/1980,31,0,0,0,0,5200,6500,6500,145,143,7469862,186,81,GK ,15,14,14,6,14,12,13,15,9,12,11,8,1,1,2,7,10,2,1,1,3,9,2,2,7,8,12,15,13,13,8,12,15,6,12,1,13,12,8,11,13,15,13,12,17,9,20,14,15,14,8,15,5,1,5,15,14,13,16,14,14,7,1,1,1,1,1,1,1,GK ,0,20,1,1,1,1,1,1,1,1,1,1,1,1,1,1,0,0,0,0,0,0,0,0,0,0,0,0,0,0,0,0,0,0,0,0,0,0,0,0,0,0,0,0,0,0,0,0,0,0,0,0,0,0,0,0,0,0,0,0,0,0,0,0,0
13/6/2011,Nicolas Caraux,85085640,769,3/4/1991,20,0,0,0,0,1100,2250,2250,102,90,200479,187,79,GK ,13,7,10,6,11,8,13,12,11,14,8,1,2,3,1,7,6,1,3,3,2,8,1,3,7,11,11,12,11,11,8,10,14,6,8,1,10,3,7,9,11,14,13,1,13,8,20,12,13,14,11,10,8,1,6,13,13,13,16,15,15,5,1,1,1,1,1,1,1,GK ,0,20,1,1,1,1,1,1,1,1,1,1,1,1,1,1,0,0,0,0,0,0,0,0,0,0,0,0,0,0,0,0,0,0,0,0,0,0,0,0,0,0,0,0,0,0,0,0,0,0,0,0,0,0,0,0,0,0,0,0,0,0,0,0,0
13/6/2011,Nicola Ravaglia,43002866,776,12/12/1988,22,0,0,0,0,1250,4850,4850,137,115,2425564,184,75,GK ,11,12,13,14,13,10,11,15,12,10,9,7,3,3,2,9,10,8,2,1,2,9,1,2,8,9,12,9,9,13,7,12,12,1,12,1,13,7,8,9,12,10,12,5,14,8,20,9,10,13,6,12,4,10,11,18,15,8,18,14,7,3,1,1,1,1,1,1,1,GK ,0,20,1,1,1,1,1,1,1,1,1,1,1,1,1,1,0,0,0,0,0,0,0,0,0,0,0,0,0,0,0,0,0,0,0,0,0,0,0,0,0,0,0,0,0,0,0,0,0,0,0,0,0,0,0,0,0,0,0,0,0,0,0,0,0
13/6/2011,Nicola Pavarini,702294,776,2/24/1974,37,0,0,0,0,2750,5500,5500,135,110,518805,190,81,GK ,12,10,10,6,14,12,12,13,12,8,9,5,1,3,2,4,10,3,3,2,3,3,3,2,4,10,12,13,11,14,3,14,10,2,5,1,10,10,5,7,12,12,12,5,16,10,20,6,5,10,5,10,5,10,14,14,8,9,16,15,10,11,1,1,1,1,1,1,1,GK ,0,20,1,1,1,1,1,1,1,1,1,1,1,1,1,1,0,0,0,0,0,0,0,0,0,0,0,0,0,0,0,0,0,0,0,0,0,0,0,0,0,0,0,0,0,0,0,0,0,0,0,0,0,0,0,0,0,0,0,0,0,0,0,0,0
13/6/2011,Nico Burchert,35008172,771,6/24/1987,23,0,0,0,0,1250,3750,3750,90,75,26525,192,82,GK ,13,11,6,5,10,9,8,12,9,8,12,4,1,1,3,3,8,1,3,2,1,2,1,1,4,15,11,12,7,14,1,14,10,1,5,3,10,1,5,10,9,9,15,5,11,7,20,4,12,10,14,10,4,10,6,12,7,9,8,10,9,6,1,1,1,1,1,1,1,GK ,0,20,1,1,1,1,1,1,1,1,1,1,1,1,1,1,0,0,0,0,0,0,0,0,0,0,0,0,0,0,0,0,0,0,0,0,0,0,0,0,0,0,0,0,0,0,0,0,0,0,0,0,0,0,0,0,0,0,0,0,0,0,0,0,0
13/6/2011,Neto,19030933,1651,7/19/1989,21,0,0,0,0,3750,7040,6400,158,128,8413811,191,83,GK ,14,13,13,6,14,8,14,14,14,13,10,5,2,2,2,10,7,5,2,1,2,9,3,3,8,8,12,12,11,13,12,12,13,1,8,2,13,11,12,13,15,13,13,7,14,12,20,12,13,8,8,10,6,10,8,13,15,13,13,14,14,6,1,1,1,1,1,1,1,GK ,0,20,1,1,1,1,1,1,1,1,1,1,1,1,1,1,0,0,0,0,0,0,0,0,0,0,0,0,0,0,0,0,0,0,0,0,0,0,0,0,0,0,0,0,0,0,0,0,0,0,0,0,0,0,0,0,0,0,0,0,0,0,0,0,0
13/6/2011,Neil Sullivan,2016130,793,2/24/1970,41,28,0,0,0,2850,5250,5350,140,97,287500,189,94,GK ,14,14,14,1,15,8,10,4,6,5,7,5,2,1,2,7,10,2,2,3,3,4,2,1,12,12,11,15,14,11,6,12,17,4,12,7,15,15,16,3,5,9,13,10,13,2,20,13,14,14,8,12,5,10,15,14,14,14,19,19,16,12,1,1,1,1,1,1,1,GK ,0,20,1,1,1,1,1,1,1,1,1,1,1,1,1,1,0,0,0,0,0,0,0,0,0,0,0,0,0,0,0,0,0,0,0,0,0,0,0,0,0,0,0,0,0,0,0,0,0,0,0,0,0,0,0,0,0,0,0,0,0,0,0,0,0
13/6/2011,Neil Etheridge,5006680,141,2/7/1990,21,22,0,0,0,1700,4400,3600,120,80,1668933,191,94,GK ,11,12,11,7,13,10,12,13,12,6,8,3,1,2,3,7,8,7,1,1,1,6,1,1,5,12,9,8,8,9,5,11,10,2,7,10,10,5,5,5,10,11,10,10,9,3,20,8,10,8,1,9,3,9,8,14,9,6,15,10,11,13,1,1,1,1,1,1,1,GK ,0,20,1,1,1,1,1,1,1,1,1,1,1,1,1,1,0,0,0,0,0,0,0,0,0,0,0,0,0,0,0,0,0,0,0,0,0,0,0,0,0,0,0,0,0,0,0,0,0,0,0,0,0,0,0,0,0,0,0,0,0,0,0,0,0
13/6/2011,Murta,734677,788,7/21/1979,31,0,0,0,0,100,2000,2000,90,85,26001,184,87,GK ,14,14,14,7,12,14,12,5,4,10,11,3,3,3,1,6,5,3,2,3,3,1,3,2,7,7,10,11,9,11,1,12,9,3,12,1,14,1,4,7,11,11,8,4,13,4,20,4,4,10,5,10,12,8,13,13,12,14,13,15,10,13,1,1,1,1,1,1,1,GK ,0,20,1,1,1,1,1,1,1,1,1,1,1,1,1,1,0,0,0,0,0,0,0,0,0,0,0,0,0,0,0,0,0,0,0,0,0,0,0,0,0,0,0,0,0,0,0,0,0,0,0,0,0,0,0,0,0,0,0,0,0,0,0,0,0
13/6/2011,Morten Jensen,8728477,771,9/20/1987,23,0,0,0,0,500,4250,4250,105,85,267321,188,90,GK ,8,11,12,7,7,11,11,14,11,7,7,4,2,2,3,3,6,3,1,3,1,1,2,2,4,11,10,10,6,10,1,14,9,3,4,2,14,1,4,8,14,12,15,4,8,6,20,5,6,10,4,10,13,10,11,11,8,11,14,16,11,10,1,1,1,1,1,1,1,GK ,0,20,1,1,1,1,1,1,1,1,1,1,1,1,1,1,0,0,0,0,0,0,0,0,0,0,0,0,0,0,0,0,0,0,0,0,0,0,0,0,0,0,0,0,0,0,0,0,0,0,0,0,0,0,0,0,0,0,0,0,0,0,0,0,0
13/6/2011,Morgan De Sanctis,11265,776,3/26/1977,34,1,0,7,0,6050,7700,7700,155,154,10987461,190,86,GK ,16,16,16,12,13,10,19,16,17,14,15,1,1,1,3,12,4,6,2,1,1,10,1,1,5,9,13,14,8,13,8,11,15,1,13,3,15,15,15,13,15,12,15,5,11,8,20,9,12,13,7,13,7,10,16,17,10,8,14,10,15,13,1,1,1,1,1,1,1,GK ,0,20,1,1,1,1,1,1,1,1,1,1,1,1,1,1,2199023255552,0,0,0,0,0,0,0,0,0,0,0,0,0,0,0,0,0,0,0,0,0,0,0,0,0,0,0,0,0,0,0,0,0,0,0,0,0,0,0,0,0,1,0,0,0,0,0,0
13/6/2011,Moreira,7004818,788,3/20/1982,29,0,0,22,0,4000,6750,6500,134,130,2242500,184,78,GK ,14,13,14,5,14,15,13,15,13,9,15,5,2,1,3,5,10,1,3,1,2,3,3,1,6,8,14,12,17,10,2,10,13,2,5,3,15,2,8,12,16,14,13,8,9,11,20,5,12,10,14,10,8,10,13,15,16,12,16,18,18,4,1,1,1,1,1,1,1,GK ,0,20,1,1,1,1,1,1,1,1,1,1,1,1,1,1,0,0,0,0,0,0,0,0,0,0,0,0,0,0,0,0,0,0,0,0,0,0,0,0,0,0,0,0,0,0,0,0,0,0,0,0,0,0,0,0,0,0,0,0,0,0,0,0,0
13/6/2011,Mohamed Amsif,35017348,771,2/7/1989,22,0,0,0,0,2250,4750,4750,115,95,765740,187,90,GK ,13,9,8,11,11,13,12,13,12,6,13,2,1,2,2,2,7,2,2,3,1,1,1,2,6,3,12,10,9,8,2,13,8,3,10,2,11,1,2,7,12,13,14,16,17,8,20,3,5,10,13,10,13,10,8,12,13,10,15,12,10,6,1,1,1,1,1,1,1,GK ,0,20,1,1,1,1,1,1,1,1,1,1,1,1,1,1,0,0,0,0,0,0,0,0,0,0,0,0,0,0,0,0,0,0,0,0,0,0,0,0,0,0,0,0,0,0,0,0,0,0,0,0,0,0,0,0,0,0,0,0,0,0,0,0,0
13/6/2011,Mitchell Langerak,15004041,1435,8/22/1988,22,0,0,5,0,3250,6000,6100,140,119,6879108,192,81,GK ,15,12,11,6,13,11,13,17,10,10,11,3,1,1,3,7,6,6,2,2,3,7,3,2,8,9,12,11,9,9,5,12,13,2,4,3,11,12,12,7,15,12,15,5,11,10,20,13,13,11,5,3,4,10,8,12,8,9,10,10,12,6,1,1,1,1,1,1,1,GK ,0,20,1,1,1,1,1,1,1,1,1,1,1,1,1,1,0,0,0,0,0,0,0,0,0,0,0,0,0,0,0,0,0,0,0,0,0,0,0,0,0,0,0,0,0,0,0,0,0,0,0,0,0,0,0,0,0,0,0,0,0,0,0,0,0
13/6/2011,Miro Varvodic,662889,761,5/15/1989,22,0,0,0,0,2500,3500,5400,124,108,2843123,191,84,GK ,12,9,8,13,15,10,13,15,8,5,12,6,2,1,2,6,8,8,1,3,2,4,2,1,3,10,11,12,8,8,9,8,10,1,7,2,11,13,10,14,15,12,15,6,12,14,20,8,13,8,5,10,4,10,9,11,11,10,10,11,13,7,1,1,1,1,1,1,1,GK ,0,20,1,1,1,1,1,1,1,1,1,1,1,1,1,1,0,0,0,0,0,0,0,0,0,0,0,0,0,0,0,0,0,0,0,0,0,0,0,0,0,0,0,0,0,0,0,0,0,0,0,0,0,0,0,0,0,0,0,0,0,0,0,0,0
13/6/2011,Mikkel Andersen,1700454,764,12/17/1988,22,0,0,6,0,2000,5450,4900,130,98,733590,195,80,GK ,12,11,12,8,13,12,13,15,10,7,10,8,1,2,1,7,10,1,1,1,3,9,2,1,8,5,12,12,13,7,2,10,16,1,13,1,6,2,11,8,10,8,17,4,6,7,20,5,13,10,12,10,16,10,13,18,19,11,15,14,13,13,1,1,1,1,1,1,1,GK ,0,20,1,1,1,1,1,1,1,1,1,1,1,1,1,1,2199023255552,0,0,0,0,0,0,0,0,0,0,0,0,0,0,0,0,0,0,0,0,0,0,0,0,0,0,0,0,0,0,0,0,0,0,0,0,0,0,0,0,0,1,0,0,0,0,0,0
13/6/2011,Mikel Saizar,7450698,796,1/18/1983,28,0,0,0,0,2000,4750,4750,103,100,82840,188,87,GK ,13,9,11,1,11,11,11,13,9,17,7,6,2,3,1,4,9,1,1,3,2,3,3,3,4,5,9,14,10,13,2,10,9,3,8,1,14,3,4,14,11,12,11,10,10,11,20,8,5,10,13,10,7,10,10,19,12,7,10,8,6,8,1,1,1,1,1,1,1,GK ,0,20,1,1,1,1,1,1,1,1,1,1,1,1,1,1,0,0,0,0,0,0,0,0,0,0,0,0,0,0,0,0,0,0,0,0,0,0,0,0,0,0,0,0,0,0,0,0,0,0,0,0,0,0,0,0,0,0,0,0,0,0,0,0,0
13/6/2011,Mike Pollitt,113013,765,2/29/1972,39,0,0,0,0,3500,5650,5650,125,120,322275,194,97,GK ,12,12,12,5,13,12,12,15,11,8,11,3,3,2,1,10,5,1,1,4,6,7,1,5,16,7,13,14,14,14,11,10,15,4,10,7,11,10,12,12,11,14,13,5,13,8,20,13,14,14,5,12,1,3,14,15,5,12,14,13,15,12,1,1,1,1,1,1,1,GK ,0,20,1,1,1,1,1,1,1,1,1,1,1,1,1,1,562949953421312,0,0,0,0,0,0,0,0,0,0,0,0,0,0,0,0,0,0,0,0,0,0,0,0,0,0,0,0,0,0,0,0,0,0,0,0,0,0,0,0,0,0,0,0,0,0,0,0
13/6/2011,Mika,55024519,788,3/8/1991,20,0,0,0,0,3250,5250,5250,126,105,7272563,190,82,GK ,11,12,10,7,11,14,14,14,7,12,12,5,2,2,1,3,7,2,3,2,1,1,3,1,6,9,9,14,6,10,2,9,16,3,10,3,10,2,10,11,13,15,16,20,16,11,5,6,15,12,12,12,10,10,14,12,13,13,14,14,14,5,1,1,1,1,1,1,1,GK ,0,20,1,1,1,1,1,1,1,1,1,1,1,1,1,1,0,0,0,0,0,0,0,0,0,0,0,0,0,0,0,0,0,0,0,0,0,0,0,0,0,0,0,0,0,0,0,0,0,0,0,0,0,0,0,0,0,0,0,0,0,0,0,0,0
13/6/2011,Miguel,55028349,788,1/12/1992,19,0,0,0,0,200,600,600,100,60,2893,189,83,GK ,12,9,6,9,7,9,11,12,8,11,10,5,1,1,2,1,8,1,3,2,2,1,2,3,5,10,7,8,4,12,1,12,8,1,5,1,12,1,1,7,11,12,9,8,12,5,20,2,2,10,9,8,5,7,13,14,14,13,12,9,16,5,1,1,1,1,1,1,1,GK ,0,20,1,1,1,1,1,1,1,1,1,1,1,1,1,1,0,0,0,0,0,0,0,0,0,0,0,0,0,0,0,0,0,0,0,0,0,0,0,0,0,0,0,0,0,0,0,0,0,0,0,0,0,0,0,0,0,0,0,0,0,0,0,0,0
13/6/2011,Miguel María Aragón,67093361,796,6/1/1987,24,0,0,0,0,500,4000,4000,90,80,54239,182,73,GK ,13,10,13,11,9,10,8,13,9,13,11,4,1,1,3,5,6,1,1,3,1,2,3,2,7,3,5,13,10,11,1,13,9,2,10,3,9,2,3,7,8,9,11,9,9,8,20,6,13,10,7,4,6,9,14,7,12,10,7,5,6,12,1,1,1,1,1,1,1,GK ,0,20,1,1,1,1,1,1,1,1,1,1,1,1,1,1,0,0,0,0,0,0,0,0,0,0,0,0,0,0,0,0,0,0,0,0,0,0,0,0,0,0,0,0,0,0,0,0,0,0,0,0,0,0,0,0,0,0,0,0,0,0,0,0,0
13/6/2011,Miguel Ángel Moyà,824545,796,4/2/1984,27,0,0,11,0,4850,6650,6650,151,136,2266972,187,82,GK ,12,14,13,6,15,11,12,16,13,9,12,7,1,2,2,7,10,5,2,2,2,9,1,3,9,11,13,15,12,13,3,12,10,5,12,2,13,11,12,9,15,14,14,5,13,11,20,15,14,11,12,14,12,10,11,10,10,12,10,5,4,1,1,1,1,1,1,1,1,GK ,0,20,1,1,1,1,1,1,1,1,1,1,1,1,1,1,0,0,0,0,0,0,0,0,0,0,0,0,0,0,0,0,0,0,0,0,0,0,0,0,0,0,0,0,0,0,0,0,0,0,0,0,0,0,0,0,0,0,0,0,0,0,0,0,0
13/6/2011,Mickaël Landreau,401022,769,5/14/1979,32,11,0,43,0,7000,6704,6700,150,149,13335911,184,80,GK ,10,14,13,11,14,15,14,17,13,9,12,6,1,2,2,10,10,2,12,2,3,11,14,3,10,8,17,13,14,12,9,13,14,12,15,2,14,14,11,14,16,15,12,1,14,12,20,14,15,16,8,15,6,1,7,16,16,12,17,14,13,9,1,1,1,1,1,1,1,GK ,0,20,1,1,1,1,1,1,1,1,1,1,1,1,1,1,0,0,0,0,0,0,0,0,0,0,0,0,0,0,0,0,0,0,0,0,0,0,0,0,0,0,0,0,0,0,0,0,0,0,0,0,0,0,0,0,0,0,0,0,0,0,0,0,0
13/6/2011,Mickaël Fabre,834679,5,7/15/1984,26,0,0,0,0,2600,5264,3900,135,117,266314,181,79,GK ,10,12,13,5,13,7,11,15,14,10,10,7,2,1,1,6,10,3,1,2,3,6,2,3,6,8,11,13,13,13,6,12,14,6,12,1,13,7,12,14,14,13,10,1,15,13,20,14,13,16,8,14,5,10,7,15,12,13,14,14,14,7,1,1,1,1,1,1,1,GK ,0,20,1,1,1,1,1,1,1,1,1,1,1,1,1,1,0,0,0,0,0,0,0,0,0,0,0,0,0,0,0,0,0,0,0,0,0,0,0,0,0,0,0,0,0,0,0,0,0,0,0,0,0,0,0,0,0,0,0,0,0,0,0,0,0
13/6/2011,Mickaël Caradec,8429684,769,4/29/1982,29,0,0,0,0,1150,2300,2300,105,92,32722,190,80,GK ,13,12,11,6,10,10,11,11,10,12,10,5,2,3,2,7,9,1,3,2,3,8,3,3,7,8,12,13,10,10,8,9,13,5,8,1,10,9,6,12,11,15,15,1,13,7,20,11,14,13,8,14,7,1,13,11,9,12,14,14,14,5,1,1,1,1,1,1,1,GK ,0,20,1,1,1,1,1,1,1,1,1,1,1,1,1,1,0,0,0,0,0,0,0,0,0,0,0,0,0,0,0,0,0,0,0,0,0,0,0,0,0,0,0,0,0,0,0,0,0,0,0,0,0,0,0,0,0,0,0,0,0,0,0,0,0
13/6/2011,Michel Vorm,857204,784,10/20/1983,27,7,0,2,0,6150,6800,6800,152,142,11032046,181,85,GK ,17,13,13,11,14,12,13,14,11,10,12,6,3,2,3,10,9,8,3,3,2,9,1,1,12,8,12,14,13,13,12,12,14,2,12,2,12,13,14,14,13,13,10,10,11,14,20,13,14,14,7,13,9,10,7,14,16,13,16,16,17,12,1,1,1,1,1,1,1,GK ,0,20,1,1,1,1,1,1,1,1,1,1,1,1,1,1,0,0,0,0,0,0,0,0,0,0,0,0,0,0,0,0,0,0,0,0,0,0,0,0,0,0,0,0,0,0,0,0,0,0,0,0,0,0,0,0,0,0,0,0,0,0,0,0,0
13/6/2011,Michael Rensing,890610,771,5/14/1984,27,0,0,18,0,5500,6850,6850,145,137,15029726,190,92,GK ,12,9,12,4,13,12,17,19,10,19,13,4,2,3,3,5,8,7,1,2,2,7,1,2,6,8,15,12,15,9,8,11,10,2,9,1,11,15,12,14,14,15,16,12,15,14,20,15,14,14,5,17,4,10,8,10,14,16,16,12,13,8,1,1,1,1,1,1,1,GK ,0,20,1,1,1,1,1,1,1,1,1,1,1,1,1,1,0,0,0,0,0,0,0,0,0,0,0,0,0,0,0,0,0,0,0,0,0,0,0,0,0,0,0,0,0,0,0,0,0,0,0,0,0,0,0,0,0,0,0,0,0,0,0,0,0
13/6/2011,Michael Ratajczak,884663,771,4/16/1982,29,0,0,0,0,4500,5700,5700,118,114,545569,187,84,GK ,11,11,13,6,15,13,14,13,11,12,14,6,3,3,2,8,10,10,2,2,2,7,3,2,8,8,12,12,10,10,5,10,12,4,10,3,12,12,10,9,11,13,15,5,12,11,20,11,13,6,5,10,8,10,12,9,10,11,11,8,12,12,1,1,1,1,1,1,1,GK ,0,20,1,1,1,1,1,1,1,1,1,1,1,1,1,1,0,0,0,0,0,0,0,0,0,0,0,0,0,0,0,0,0,0,0,0,0,0,0,0,0,0,0,0,0,0,0,0,0,0,0,0,0,0,0,0,0,0,0,0,0,0,0,0,0
13/6/2011,Michael Poke,5112737,765,11/21/1985,25,0,0,0,0,2250,4200,4200,100,84,56871,186,78,GK ,11,10,8,4,12,10,13,12,10,13,10,1,3,2,2,8,6,7,3,2,2,9,1,2,8,9,7,12,8,8,4,9,12,11,10,3,9,9,10,10,10,11,13,8,12,10,20,10,12,14,8,16,7,8,12,7,15,10,15,13,14,5,1,1,1,1,1,1,1,GK ,0,20,1,1,1,1,1,1,1,1,1,1,1,1,1,1,0,0,0,0,0,0,0,0,0,0,0,0,0,0,0,0,0,0,0,0,0,0,0,0,0,0,0,0,0,0,0,0,0,0,0,0,0,0,0,0,0,0,0,0,0,0,0,0,0
13/6/2011,Michaël Ménétrier,3503874,769,9/23/1978,32,0,0,0,0,1100,3450,3450,115,110,48947,190,81,GK ,14,14,14,9,12,8,12,13,11,5,7,4,2,1,1,8,8,1,2,3,1,9,1,2,8,11,12,13,13,13,6,12,13,6,13,1,9,2,8,10,9,16,15,1,8,10,20,12,14,14,11,10,8,1,7,13,11,14,13,13,15,8,1,1,1,1,1,1,1,GK ,0,20,1,1,1,1,1,1,1,1,1,1,1,1,1,1,0,0,0,0,0,0,0,0,0,0,0,0,0,0,0,0,0,0,0,0,0,0,0,0,0,0,0,0,0,0,0,0,0,0,0,0,0,0,0,0,0,0,0,0,0,0,0,0,0
13/6/2011,Michael Melka,6001954,771,7/9/1978,32,0,0,0,0,4500,5500,5500,120,110,22888,195,97,GK ,10,10,12,5,14,12,11,13,11,15,10,7,3,1,1,7,10,2,3,3,3,2,1,2,9,10,13,11,12,10,6,13,12,6,14,3,13,13,12,9,10,15,17,20,13,8,4,13,15,15,5,13,5,10,6,10,14,11,14,14,6,3,1,1,1,1,1,1,1,GK ,0,20,1,1,1,1,1,1,1,1,1,1,1,1,1,1,0,0,0,0,0,0,0,0,0,0,0,0,0,0,0,0,0,0,0,0,0,0,0,0,0,0,0,0,0,0,0,0,0,0,0,0,0,0,0,0,0,0,0,0,0,0,0,0,0
13/6/2011,Michael Langer,8707876,755,1/6/1985,26,0,0,4,0,3250,5250,5500,120,110,699928,196,95,GK ,10,10,10,12,13,12,11,15,11,9,14,4,3,2,2,6,7,2,1,3,2,2,1,2,3,12,12,14,9,6,3,14,11,3,6,2,14,2,6,14,11,14,16,3,18,10,20,6,14,11,15,10,11,10,13,13,11,10,9,11,9,11,1,1,1,1,1,1,1,GK ,0,20,1,1,1,1,1,1,1,1,1,1,1,1,1,1,0,0,0,0,0,0,0,0,0,0,0,0,0,0,0,0,0,0,0,0,0,0,0,0,0,0,0,0,0,0,0,0,0,0,0,0,0,0,0,0,0,0,0,0,0,0,0,0,0
13/6/2011,Michael Esser,35021348,771,11/22/1987,23,0,0,0,0,2750,4200,4200,105,84,31963,198,97,GK ,11,11,12,11,11,12,12,12,12,11,13,2,3,1,3,13,4,12,1,3,2,13,1,2,6,12,12,7,10,14,12,6,10,12,9,8,6,13,13,10,12,13,19,5,11,8,20,10,12,8,3,8,3,9,6,10,13,12,8,9,7,12,1,1,1,1,1,1,1,GK ,0,20,1,1,1,1,1,1,1,1,1,1,1,1,1,1,0,0,0,0,0,0,0,0,0,0,0,0,0,0,0,0,0,0,0,0,0,0,0,0,0,0,0,0,0,0,0,0,0,0,0,0,0,0,0,0,0,0,0,0,0,0,0,0,0
13/6/2011,Michael Agazzi,836913,776,7/3/1984,26,0,0,0,0,4600,6550,6550,140,131,8174797,189,85,GK ,12,11,10,11,13,11,13,16,8,16,13,7,1,3,1,9,9,12,3,1,2,11,3,1,9,12,11,15,13,13,9,10,12,7,9,8,17,10,12,11,14,14,14,8,14,11,20,14,13,12,5,11,6,10,8,10,16,14,15,19,12,10,1,1,1,1,1,1,1,GK ,0,20,1,1,1,1,1,1,1,1,1,1,1,1,1,1,17179869184,0,0,0,0,0,0,0,0,0,0,0,0,0,0,0,0,0,0,0,0,0,0,0,0,0,0,0,0,0,0,0,0,0,0,1,0,0,0,0,0,0,0,0,0,0,0,0,0
13/6/2011,Maximilian Riedmüller,92002556,771,1/4/1988,23,0,0,0,0,1250,4000,4000,120,98,41743,186,86,GK ,13,8,13,10,10,12,13,15,6,11,9,7,3,1,2,1,10,1,2,3,2,2,2,3,3,12,10,10,8,11,2,13,9,3,10,2,13,1,3,8,14,13,14,8,13,8,20,3,5,6,8,10,12,10,10,14,10,7,14,13,8,11,1,1,1,1,1,1,1,GK ,0,20,1,1,1,1,1,1,1,1,1,1,1,1,1,1,0,0,0,0,0,0,0,0,0,0,0,0,0,0,0,0,0,0,0,0,0,0,0,0,0,0,0,0,0,0,0,0,0,0,0,0,0,0,0,0,0,0,0,0,0,0,0,0,0
13/6/2011,Maximilian Böhmann,91016940,771,6/24/1989,21,0,0,0,0,1250,3000,3000,85,60,1324,194,85,GK ,13,7,9,13,10,11,8,13,6,14,9,4,3,1,1,1,6,1,2,3,3,1,1,3,4,6,9,12,7,6,1,10,9,1,12,3,11,1,2,9,12,13,15,1,14,7,20,3,6,8,4,10,7,10,13,16,14,11,12,10,17,7,1,1,1,1,1,1,1,GK ,0,20,1,1,1,1,1,1,1,1,1,1,1,1,1,1,0,0,0,0,0,0,0,0,0,0,0,0,0,0,0,0,0,0,0,0,0,0,0,0,0,0,0,0,0,0,0,0,0,0,0,0,0,0,0,0,0,0,0,0,0,0,0,0,0
13/6/2011,Maxime Hautbois,85045880,769,1/3/1991,20,0,0,0,0,900,1850,1850,109,75,151189,182,70,GK ,13,10,10,12,9,12,9,10,4,7,8,4,1,2,2,4,8,1,1,2,1,1,1,3,4,9,6,14,8,5,1,10,9,2,10,3,8,1,3,13,16,15,11,1,13,12,20,2,3,10,14,10,5,10,14,10,6,13,12,8,8,8,1,1,1,1,1,1,1,GK ,0,20,1,1,1,1,1,1,1,1,1,1,1,1,1,1,0,0,0,0,0,0,0,0,0,0,0,0,0,0,0,0,0,0,0,0,0,0,0,0,0,0,0,0,0,0,0,0,0,0,0,0,0,0,0,0,0,0,0,0,0,0,0,0,0
13/6/2011,Max Grün,8728395,771,4/5/1987,24,0,0,0,0,2700,6000,6000,136,120,1767267,191,85,GK ,13,10,7,10,13,12,15,17,16,8,11,3,2,7,1,8,8,3,2,1,2,8,1,7,7,16,16,12,14,13,6,10,17,9,6,3,13,11,10,11,14,11,16,9,16,10,20,13,10,13,7,15,7,10,14,11,9,16,16,11,11,3,1,1,1,1,1,1,1,GK ,0,20,1,1,1,1,1,1,1,1,1,1,1,1,1,1,0,0,0,0,0,0,0,0,0,0,0,0,0,0,0,0,0,0,0,0,0,0,0,0,0,0,0,0,0,0,0,0,0,0,0,0,0,0,0,0,0,0,0,0,0,0,0,0,0
13/6/2011,Mattia Perin,43044345,776,11/10/1992,18,0,0,2,0,3000,4634,4250,144,103,1176645,188,84,GK ,13,10,10,14,13,10,11,11,12,14,12,2,1,2,2,8,5,3,1,2,2,8,3,1,9,3,11,15,10,10,8,10,12,2,10,3,11,2,7,12,12,11,14,8,15,12,20,6,9,10,7,10,5,10,12,13,14,14,13,12,13,6,1,1,1,1,1,1,1,GK ,0,20,1,1,1,1,1,1,1,1,1,1,1,1,1,1,0,0,0,0,0,0,0,0,0,0,0,0,0,0,0,0,0,0,0,0,0,0,0,0,0,0,0,0,0,0,0,0,0,0,0,0,0,0,0,0,0,0,0,0,0,0,0,0,0
13/6/2011,Matthew Gilks,5111984,793,6/4/1982,29,0,0,0,0,3250,6250,6250,124,120,6111589,186,77,GK ,13,15,15,3,15,13,12,13,7,8,8,6,1,3,1,4,10,2,2,1,3,3,2,2,3,5,12,14,11,11,8,9,12,2,7,3,12,9,11,9,13,12,13,1,10,9,20,12,13,9,2,14,5,10,6,14,12,12,11,12,10,2,1,1,1,1,1,1,1,GK ,0,20,1,1,1,1,1,1,1,1,1,1,1,1,1,1,0,0,0,0,0,0,0,0,0,0,0,0,0,0,0,0,0,0,0,0,0,0,0,0,0,0,0,0,0,0,0,0,0,0,0,0,0,0,0,0,0,0,0,0,0,0,0,0,0
13/6/2011,Matos,55010782,788,2/15/1979,32,0,0,0,0,1000,4000,4000,100,95,218239,191,91,GK ,11,10,10,5,11,13,13,13,11,12,11,4,3,2,2,6,9,1,1,3,2,2,3,3,6,11,12,10,12,10,1,13,15,2,5,1,13,2,9,6,11,12,15,20,11,8,8,3,6,10,9,10,3,10,11,13,15,12,16,15,15,4,1,1,1,1,1,1,1,GK ,0,20,1,1,1,1,1,1,1,1,1,1,1,1,1,1,0,0,0,0,0,0,0,0,0,0,0,0,0,0,0,0,0,0,0,0,0,0,0,0,0,0,0,0,0,0,0,0,0,0,0,0,0,0,0,0,0,0,0,0,0,0,0,0,0
13/6/2011,Mathieu Moreau,834686,769,2/22/1983,28,0,0,0,0,1250,2800,4550,115,95,62072,190,85,GK ,12,10,10,12,12,7,14,13,9,11,7,2,3,1,3,8,6,3,1,3,1,7,2,1,8,13,11,13,12,10,6,9,14,4,12,2,11,1,9,9,11,15,12,1,13,11,20,7,15,14,11,10,10,1,12,16,11,12,14,14,11,10,1,1,1,1,1,1,1,GK ,0,20,1,1,1,1,1,1,1,1,1,1,1,1,1,1,0,0,0,0,0,0,0,0,0,0,0,0,0,0,0,0,0,0,0,0,0,0,0,0,0,0,0,0,0,0,0,0,0,0,0,0,0,0,0,0,0,0,0,0,0,0,0,0,0
13/6/2011,Mathias Schober,500632,771,4/8/1976,35,0,0,0,0,3750,6400,6150,132,123,1355855,191,94,GK ,13,15,12,3,14,9,12,13,10,4,8,4,1,3,3,9,9,1,3,1,2,9,3,3,10,10,12,16,15,13,5,11,13,2,14,3,13,15,12,9,7,14,17,20,18,8,6,13,18,15,12,10,3,10,5,8,16,14,16,9,19,4,1,1,1,1,1,1,1,GK ,0,20,1,1,1,1,1,1,1,1,1,1,1,1,1,1,0,0,0,0,0,0,0,0,0,0,0,0,0,0,0,0,0,0,0,0,0,0,0,0,0,0,0,0,0,0,0,0,0,0,0,0,0,0,0,0,0,0,0,0,0,0,0,0,0
13/6/2011,Mathias Moritz,91002297,771,2/21/1988,23,0,0,0,0,900,3200,3200,89,68,8993,186,76,GK ,9,9,9,8,12,11,9,10,8,6,8,5,1,2,3,4,8,2,2,2,3,2,2,1,2,11,10,8,10,9,3,8,12,3,8,3,10,8,5,9,11,8,13,4,7,10,20,8,12,8,13,6,10,10,8,9,14,11,11,12,12,7,1,1,1,1,1,1,1,GK ,0,20,1,1,1,1,1,1,1,1,1,1,1,1,1,1,0,0,0,0,0,0,0,0,0,0,0,0,0,0,0,0,0,0,0,0,0,0,0,0,0,0,0,0,0,0,0,0,0,0,0,0,0,0,0,0,0,0,0,0,0,0,0,0,0
13/6/2011,Massimiliano Benassi,3802252,776,11/11/1981,29,0,0,0,0,1000,5500,5500,115,110,1218780,180,77,GK ,8,10,12,6,14,10,13,16,14,14,10,6,1,1,3,4,9,3,3,2,2,2,3,2,4,10,13,12,10,12,6,10,13,3,6,12,11,8,8,12,16,10,8,5,10,12,20,3,10,9,6,8,9,10,14,18,11,16,12,9,10,11,1,1,1,1,1,1,1,GK ,0,20,1,1,1,1,1,1,1,1,1,1,1,1,1,1,0,0,0,0,0,0,0,0,0,0,0,0,0,0,0,0,0,0,0,0,0,0,0,0,0,0,0,0,0,0,0,0,0,0,0,0,0,0,0,0,0,0,0,0,0,0,0,0,0
13/6/2011,Marwin Hitz,69000798,798,9/18/1987,23,0,0,2,0,3900,5174,5750,140,115,2930123,192,89,GK ,14,12,11,6,8,14,11,14,10,6,13,6,2,3,1,4,10,3,3,2,2,2,3,2,7,10,10,14,14,13,3,14,9,3,8,2,12,2,5,9,13,12,16,11,10,6,20,8,7,10,4,10,5,10,9,8,6,11,9,7,10,10,1,1,1,1,1,1,1,GK ,0,20,1,1,1,1,1,1,1,1,1,1,1,1,1,1,0,0,0,0,0,0,0,0,0,0,0,0,0,0,0,0,0,0,0,0,0,0,0,0,0,0,0,0,0,0,0,0,0,0,0,0,0,0,0,0,0,0,0,0,0,0,0,0,0
13/6/2011,Marvin Gladrow,91013441,771,4/10/1990,21,0,0,0,0,1500,4000,4000,102,80,66212,191,82,GK ,13,9,11,5,11,10,8,12,6,17,8,3,1,1,1,3,6,1,2,2,2,2,1,2,6,6,10,11,7,9,1,13,8,1,10,2,11,1,2,12,16,15,13,9,12,9,20,4,3,9,7,10,5,10,6,12,12,17,13,10,8,17,1,1,1,1,1,1,1,GK ,0,20,1,1,1,1,1,1,1,1,1,1,1,1,1,1,0,0,0,0,0,0,0,0,0,0,0,0,0,0,0,0,0,0,0,0,0,0,0,0,0,0,0,0,0,0,0,0,0,0,0,0,0,0,0,0,0,0,0,0,0,0,0,0,0
13/6/2011,Márton Fülöp,143552,773,5/3/1983,28,24,0,11,0,4250,6500,6050,135,120,2928611,199,92,GK ,14,12,12,8,15,10,16,14,10,16,10,7,1,2,2,7,10,4,1,1,3,4,2,3,8,11,12,10,9,13,5,10,15,7,9,1,13,14,10,10,13,12,19,7,12,10,20,10,11,14,6,9,7,10,17,14,8,12,12,13,14,13,1,1,1,1,1,1,1,GK ,0,20,1,1,1,1,1,1,1,1,1,1,1,1,1,1,0,0,0,0,0,0,0,0,0,0,0,0,0,0,0,0,0,0,0,0,0,0,0,0,0,0,0,0,0,0,0,0,0,0,0,0,0,0,0,0,0,0,0,0,0,0,0,0,0
13/6/2011,Martin Männel,35005913,771,3/16/1988,23,0,0,0,0,5000,5850,5850,137,117,615506,184,83,GK ,10,11,14,14,16,10,14,15,11,13,13,6,2,3,2,9,10,6,1,1,2,9,2,3,9,14,11,14,10,11,7,10,14,3,11,3,12,12,12,9,12,11,12,3,12,10,20,10,10,12,8,10,11,10,6,17,13,12,14,13,8,9,1,1,1,1,1,1,1,GK ,0,20,1,1,1,1,1,1,1,1,1,1,1,1,1,1,2199023255552,0,0,0,0,0,0,0,0,0,0,0,0,0,0,0,0,0,0,0,0,0,0,0,0,0,0,0,0,0,0,0,0,0,0,0,0,0,0,0,0,0,1,0,0,0,0,0,0
13/6/2011,Markus Scholz,91013280,771,5/17/1988,23,0,0,0,0,250,3000,3000,75,60,6566,196,99,GK ,6,9,8,8,11,8,10,13,9,4,10,4,1,3,1,1,6,1,1,2,1,1,1,2,6,11,7,9,7,10,1,10,7,1,11,3,9,1,2,13,11,12,16,9,13,10,20,3,8,10,9,4,8,9,14,10,9,13,17,14,16,11,1,1,1,1,1,1,1,GK ,0,20,1,1,1,1,1,1,1,1,1,1,1,1,1,1,0,0,0,0,0,0,0,0,0,0,0,0,0,0,0,0,0,0,0,0,0,0,0,0,0,0,0,0,0,0,0,0,0,0,0,0,0,0,0,0,0,0,0,0,0,0,0,0,0
13/6/2011,Markus Miller,883440,771,4/8/1982,29,0,0,0,0,4000,6450,6450,134,129,3532497,189,92,GK ,13,14,13,8,13,12,12,15,12,11,10,7,1,3,2,6,10,2,1,3,1,7,2,8,6,9,9,15,12,12,4,14,13,4,15,5,14,13,11,7,11,12,15,7,14,8,20,14,15,12,6,12,8,10,5,14,14,11,13,10,12,9,1,1,1,1,1,1,1,GK ,0,20,1,1,1,1,1,1,1,1,1,1,1,1,1,1,0,0,0,0,0,0,0,0,0,0,0,0,0,0,0,0,0,0,0,0,0,0,0,0,0,0,0,0,0,0,0,0,0,0,0,0,0,0,0,0,0,0,0,0,0,0,0,0,0
13/6/2011,Markus Krauss,35007302,771,9/16/1987,23,0,0,0,0,2000,4100,4100,106,82,101124,195,88,GK ,14,14,10,4,10,10,10,10,8,8,10,4,1,3,2,7,7,2,2,2,1,8,3,3,6,10,10,11,10,10,4,10,8,2,4,1,10,12,11,8,8,11,16,3,15,8,20,17,13,10,4,10,3,10,7,7,10,10,11,10,10,4,1,1,1,1,1,1,1,GK ,0,20,1,1,1,1,1,1,1,1,1,1,1,1,1,1,0,0,0,0,0,0,0,0,0,0,0,0,0,0,0,0,0,0,0,0,0,0,0,0,0,0,0,0,0,0,0,0,0,0,0,0,0,0,0,0,0,0,0,0,0,0,0,0,0
13/6/2011,Mark Schwarzer,2000300,1435,10/6/1972,38,89,0,0,0,6050,7250,6850,150,145,1526160,196,96,GK ,12,11,14,3,17,12,15,17,8,9,17,9,5,1,3,9,9,6,3,3,3,8,3,12,13,10,12,11,13,13,12,12,16,3,7,11,13,14,13,11,13,12,15,11,10,12,20,14,14,13,9,14,12,10,18,14,18,13,17,18,18,6,1,1,1,1,1,1,1,GK ,0,20,1,1,1,1,1,1,1,1,1,1,1,1,1,1,0,0,0,0,0,0,0,0,0,0,0,0,0,0,0,0,0,0,0,0,0,0,0,0,0,0,0,0,0,0,0,0,0,0,0,0,0,0,0,0,0,0,0,0,0,0,0,0,0
13/6/2011,Mark Howard,5120117,765,9/21/1986,24,0,0,0,0,1750,4250,4250,117,100,56700,183,77,GK ,12,12,8,6,13,12,14,13,9,4,11,3,1,3,3,4,6,1,1,2,3,3,3,3,1,6,11,13,9,9,7,9,14,1,6,1,10,13,11,11,11,10,10,5,10,11,20,15,9,12,2,12,5,10,9,15,12,8,15,14,13,1,1,1,1,1,1,1,1,GK ,0,20,1,1,1,1,1,1,1,1,1,1,1,1,1,1,0,0,0,0,0,0,0,0,0,0,0,0,0,0,0,0,0,0,0,0,0,0,0,0,0,0,0,0,0,0,0,0,0,0,0,0,0,0,0,0,0,0,0,0,0,0,0,0,0
13/6/2011,Mark Halstead,28018767,765,9/17/1990,20,0,0,0,0,1100,3500,3500,129,67,25694,186,84,GK ,4,10,10,5,7,12,11,12,13,17,11,5,1,1,2,1,8,1,2,3,3,1,1,1,3,10,4,8,11,10,1,12,8,2,8,1,8,1,1,11,13,12,9,9,14,10,20,2,2,10,10,10,14,7,7,9,7,12,14,10,14,11,1,1,1,1,1,1,1,GK ,0,20,1,1,1,1,1,1,1,1,1,1,1,1,1,1,0,0,0,0,0,0,0,0,0,0,0,0,0,0,0,0,0,0,0,0,0,0,0,0,0,0,0,0,0,0,0,0,0,0,0,0,0,0,0,0,0,0,0,0,0,0,0,0,0
13/6/2011,Mark Bunn,5108797,765,11/16/1984,26,0,0,0,0,3600,6000,6000,130,124,5238727,183,78,GK ,13,12,13,5,15,14,12,17,12,9,8,3,1,3,1,4,5,3,3,3,2,3,3,1,5,8,12,11,12,12,3,10,14,6,7,1,13,12,8,11,13,12,10,7,12,9,20,13,9,14,5,13,3,10,12,12,12,13,14,11,9,7,1,1,1,1,1,1,1,GK ,0,20,1,1,1,1,1,1,1,1,1,1,1,1,1,1,17179869184,0,0,0,0,0,0,0,0,0,0,0,0,0,0,0,0,0,0,0,0,0,0,0,0,0,0,0,0,0,0,0,0,0,0,1,0,0,0,0,0,0,0,0,0,0,0,0,0
13/6/2011,Marjan Petkovic,890597,771,5/22/1979,32,0,0,0,0,3750,5500,5500,115,110,676965,187,86,GK ,13,12,13,9,14,9,11,14,10,7,11,4,3,2,1,3,8,2,3,3,2,2,1,3,8,10,10,13,13,8,3,14,9,2,6,2,12,3,4,8,12,13,14,3,14,7,20,7,12,10,9,10,7,10,11,10,12,5,7,15,14,18,1,1,1,1,1,1,1,GK ,0,20,1,1,1,1,1,1,1,1,1,1,1,1,1,1,0,0,0,0,0,0,0,0,0,0,0,0,0,0,0,0,0,0,0,0,0,0,0,0,0,0,0,0,0,0,0,0,0,0,0,0,0,0,0,0,0,0,0,0,0,0,0,0,0
13/6/2011,Mario,67009720,796,4/30/1988,23,0,0,0,0,3750,5750,5750,140,118,4078824,184,74,GK ,13,12,13,7,11,6,14,15,10,13,10,3,1,2,1,7,6,8,3,1,2,7,1,3,7,7,12,12,11,12,10,12,11,9,7,10,12,13,13,13,16,13,13,5,14,13,20,13,12,9,5,11,10,10,14,13,11,11,14,14,14,8,1,1,1,1,1,1,1,GK ,0,20,1,1,1,1,1,1,1,1,1,1,1,1,1,1,0,0,0,0,0,0,0,0,0,0,0,0,0,0,0,0,0,0,0,0,0,0,0,0,0,0,0,0,0,0,0,0,0,0,0,0,0,0,0,0,0,0,0,0,0,0,0,0,0
13/6/2011,Mario Cassano,833223,776,10/8/1983,27,0,0,0,0,2500,5750,4750,108,93,374049,185,74,GK ,10,12,13,3,8,7,13,14,11,12,11,2,3,3,2,12,6,10,2,2,1,10,1,4,12,11,9,9,9,7,12,14,15,3,12,5,8,16,11,10,10,12,11,5,18,9,20,15,10,11,7,12,10,10,12,11,9,8,10,7,10,10,1,1,1,1,1,1,1,GK ,0,20,1,1,1,1,1,1,1,1,1,1,1,1,1,1,0,0,0,0,0,0,0,0,0,0,0,0,0,0,0,0,0,0,0,0,0,0,0,0,0,0,0,0,0,0,0,0,0,0,0,0,0,0,0,0,0,0,0,0,0,0,0,0,0
13/6/2011,Mariano Barbosa,955202,1649,7/27/1984,26,0,0,4,0,4500,5850,5850,145,125,1936161,188,81,GK ,12,13,13,12,14,7,15,15,12,9,14,1,3,4,1,5,1,4,1,5,3,8,4,5,5,9,13,11,10,10,8,12,11,10,13,1,14,13,11,10,15,15,15,5,10,11,20,13,13,16,4,13,10,1,11,13,13,9,14,14,16,9,1,1,1,1,1,1,1,GK ,0,20,1,1,1,1,1,1,1,1,1,1,1,1,1,1,0,0,0,0,0,0,0,0,0,0,0,0,0,0,0,0,0,0,0,0,0,0,0,0,0,0,0,0,0,0,0,0,0,0,0,0,0,0,0,0,0,0,0,0,0,0,0,0,0
13/6/2011,Mariano Andújar,950224,1649,7/30/1983,27,4,0,0,0,6000,7100,6900,148,138,9864692,194,87,GK ,14,14,13,6,14,10,13,17,14,9,16,1,1,6,1,8,2,10,1,1,1,12,1,11,8,10,13,13,15,12,11,10,14,3,11,1,13,12,13,11,14,14,16,5,14,10,20,13,13,14,6,14,7,1,15,14,12,15,19,13,15,5,1,1,1,1,1,1,1,GK ,0,20,1,1,1,1,1,1,1,1,1,1,1,1,1,1,0,0,0,0,0,0,0,0,0,0,0,0,0,0,0,0,0,0,0,0,0,0,0,0,0,0,0,0,0,0,0,0,0,0,0,0,0,0,0,0,0,0,0,0,0,0,0,0,0
13/6/2011,Marian Unger,890986,771,11/17/1983,27,0,0,0,0,1750,4800,4800,99,96,199955,187,76,GK ,10,10,12,6,9,10,13,14,10,11,12,4,3,2,2,5,9,3,1,3,1,7,2,3,5,7,11,11,11,11,7,10,10,4,14,2,11,11,12,11,12,12,14,2,12,10,20,11,11,12,4,10,5,10,11,10,7,11,13,13,15,6,1,1,1,1,1,1,1,GK ,0,20,1,1,1,1,1,1,1,1,1,1,1,1,1,1,0,0,0,0,0,0,0,0,0,0,0,0,0,0,0,0,0,0,0,0,0,0,0,0,0,0,0,0,0,0,0,0,0,0,0,0,0,0,0,0,0,0,0,0,0,0,0,0,0
13/6/2011,Marek Stech,25003489,763,1/28/1990,21,0,0,2,0,1600,4250,4250,127,92,142846,191,89,GK ,9,8,7,13,9,12,12,14,12,13,12,2,3,2,3,6,5,1,3,1,1,2,3,2,3,13,9,11,9,13,2,11,7,2,13,3,10,1,1,12,15,14,13,10,12,7,20,2,5,10,13,10,9,10,12,9,10,8,6,13,12,9,1,1,1,1,1,1,1,GK ,0,20,1,1,1,1,1,1,1,1,1,1,1,1,1,1,0,0,0,0,0,0,0,0,0,0,0,0,0,0,0,0,0,0,0,0,0,0,0,0,0,0,0,0,0,0,0,0,0,0,0,0,0,0,0,0,0,0,0,0,0,0,0,0,0
13/6/2011,Marcus Hahnemann,1200279,390,6/15/1972,38,9,0,0,0,5000,6750,6150,138,124,139596,191,99,GK ,12,13,11,4,13,12,17,13,9,6,13,2,3,1,3,2,7,2,3,2,2,2,2,2,7,11,11,14,10,13,13,10,14,4,8,3,15,8,9,7,13,9,13,5,15,7,20,13,16,14,4,14,10,10,18,12,16,16,18,18,10,6,1,1,1,1,1,1,1,GK ,0,20,1,1,1,1,1,1,1,1,1,1,1,1,1,1,283673999966208,0,0,0,0,0,0,0,0,0,0,0,0,0,0,0,0,0,0,0,0,0,0,0,0,0,0,0,0,0,0,0,0,0,0,0,0,0,0,0,0,0,1,0,0,0,0,0,0
13/6/2011,Marcos,3300732,1651,6/21/1976,34,0,0,0,0,3250,5500,5850,120,117,667928,187,84,GK ,14,13,11,9,12,14,13,14,13,12,13,6,1,2,1,6,10,1,2,2,3,10,1,2,5,4,14,12,7,13,1,13,12,2,16,2,13,2,6,10,12,13,13,10,13,9,20,11,6,11,11,10,3,10,15,13,16,15,13,14,14,5,1,1,1,1,1,1,1,GK ,0,20,1,1,1,1,1,1,1,1,1,1,1,1,1,1,0,0,0,0,0,0,0,0,0,0,0,0,0,0,0,0,0,0,0,0,0,0,0,0,0,0,0,0,0,0,0,0,0,0,0,0,0,0,0,0,0,0,0,0,0,0,0,0,0
13/6/2011,Marco,55002304,788,1/12/1987,24,0,0,0,0,750,4000,4000,98,90,76792,182,80,GK ,10,13,13,10,12,12,12,13,5,8,10,2,2,1,2,2,5,1,2,2,1,1,3,3,4,8,11,13,12,7,1,9,14,2,12,1,8,1,8,11,11,11,9,5,14,8,20,7,5,10,7,10,7,10,10,14,14,14,13,14,14,5,1,1,1,1,1,1,1,GK ,0,20,1,1,1,1,1,1,1,1,1,1,1,1,1,1,0,0,0,0,0,0,0,0,0,0,0,0,0,0,0,0,0,0,0,0,0,0,0,0,0,0,0,0,0,0,0,0,0,0,0,0,0,0,0,0,0,0,0,0,0,0,0,0,0
13/6/2011,Marco Storari,11252,776,11/7/1977,33,0,0,0,0,5500,7100,7100,150,145,9216383,187,76,GK ,17,12,10,12,15,8,11,18,14,12,10,6,3,3,1,9,10,10,1,2,2,12,2,6,9,10,15,13,15,15,3,15,15,5,11,6,16,5,10,10,15,11,16,5,15,8,20,17,12,17,7,14,3,10,15,17,14,16,16,14,14,14,1,1,1,1,1,1,1,GK ,0,20,1,1,1,1,1,1,1,1,1,1,1,1,1,1,0,0,0,0,0,0,0,0,0,0,0,0,0,0,0,0,0,0,0,0,0,0,0,0,0,0,0,0,0,0,0,0,0,0,0,0,0,0,0,0,0,0,0,0,0,0,0,0,0
13/6/2011,Marco Sejna,6001765,771,3/20/1972,39,0,0,0,0,1750,5250,5250,115,105,149931,188,90,GK ,14,12,9,8,10,13,14,14,6,6,13,2,3,1,2,7,7,2,1,2,1,1,1,2,4,14,9,14,9,6,2,14,9,1,13,1,14,1,5,8,11,12,15,5,6,11,20,8,6,10,13,3,10,10,8,12,6,13,2,14,14,19,1,1,1,1,1,1,1,GK ,0,20,1,1,1,1,1,1,1,1,1,1,1,1,1,1,0,0,0,0,0,0,0,0,0,0,0,0,0,0,0,0,0,0,0,0,0,0,0,0,0,0,0,0,0,0,0,0,0,0,0,0,0,0,0,0,0,0,0,0,0,0,0,0,0
13/6/2011,Marco Knaller,5607306,755,3/26/1987,24,0,0,5,0,1100,5750,5550,132,111,1116475,192,85,GK ,11,11,11,10,12,10,13,15,11,12,9,3,2,2,2,10,7,10,1,2,2,10,2,1,10,10,12,14,10,11,5,10,12,5,8,1,13,10,12,11,13,14,16,5,11,10,20,11,12,10,10,10,5,10,12,12,10,12,13,11,10,10,1,1,1,1,1,1,1,GK ,0,20,1,1,1,1,1,1,1,1,1,1,1,1,1,1,0,0,0,0,0,0,0,0,0,0,0,0,0,0,0,0,0,0,0,0,0,0,0,0,0,0,0,0,0,0,0,0,0,0,0,0,0,0,0,0,0,0,0,0,0,0,0,0,0
13/6/2011,Marco Farabbi,43020757,776,7/20/1991,19,0,0,0,0,250,2500,2500,95,60,441860,186,86,GK ,4,11,7,8,12,9,12,13,13,8,10,3,3,3,2,2,6,1,2,1,1,1,2,1,4,4,6,10,6,7,1,11,8,3,6,3,13,1,3,11,10,13,13,5,12,9,20,2,5,10,7,3,8,10,6,15,16,12,14,14,10,10,1,1,1,1,1,1,1,GK ,0,20,1,1,1,1,1,1,1,1,1,1,1,1,1,1,0,0,0,0,0,0,0,0,0,0,0,0,0,0,0,0,0,0,0,0,0,0,0,0,0,0,0,0,0,0,0,0,0,0,0,0,0,0,0,0,0,0,0,0,0,0,0,0,0
13/6/2011,Marco Amelia,3804679,776,4/2/1982,29,9,0,19,0,5500,6500,7000,148,140,9523422,190,90,GK ,15,14,14,8,15,12,14,15,14,16,13,1,1,1,2,9,1,4,1,7,1,5,1,1,6,8,13,14,10,12,2,13,16,1,11,3,14,11,13,7,15,14,16,8,14,10,20,16,12,13,4,10,8,1,11,15,14,14,13,16,15,9,1,1,1,1,1,1,1,GK ,0,20,1,1,1,1,1,1,1,1,1,1,1,1,1,1,0,0,0,0,0,0,0,0,0,0,0,0,0,0,0,0,0,0,0,0,0,0,0,0,0,0,0,0,0,0,0,0,0,0,0,0,0,0,0,0,0,0,0,0,0,0,0,0,0
13/6/2011,Marcelo Valverde,19037409,1651,11/21/1989,21,0,0,0,0,500,4750,4750,120,95,739188,185,75,GK ,10,10,10,3,12,11,11,11,10,12,11,1,3,2,1,7,4,3,1,1,1,1,2,2,10,8,9,10,9,10,1,10,12,3,7,1,12,11,7,12,12,11,10,8,11,11,20,6,11,10,7,10,10,10,13,12,12,10,12,13,12,8,1,1,1,1,1,1,1,GK ,0,20,1,1,1,1,1,1,1,1,1,1,1,1,1,1,0,0,0,0,0,0,0,0,0,0,0,0,0,0,0,0,0,0,0,0,0,0,0,0,0,0,0,0,0,0,0,0,0,0,0,0,0,0,0,0,0,0,0,0,0,0,0,0,0
13/6/2011,Marcelo Boeck,311045,1651,11/28/1984,26,0,0,0,0,3000,5500,5900,133,118,2349936,191,85,GK ,14,14,10,8,13,11,13,13,9,11,12,8,2,2,3,9,10,1,3,1,3,1,2,2,12,6,12,15,11,13,1,11,17,3,9,2,13,9,14,8,13,12,16,10,14,9,20,9,13,11,13,10,10,10,11,17,16,13,18,14,15,10,1,1,1,1,1,1,1,GK ,0,20,1,1,1,1,1,1,1,1,1,1,1,1,1,1,0,0,0,0,0,0,0,0,0,0,0,0,0,0,0,0,0,0,0,0,0,0,0,0,0,0,0,0,0,0,0,0,0,0,0,0,0,0,0,0,0,0,0,0,0,0,0,0,0
13/6/2011,Marcel Hölscher,91018449,771,6/12/1991,20,0,0,0,0,200,3250,3250,91,65,6710,182,78,GK ,5,10,12,6,11,7,7,12,5,7,8,3,1,3,2,5,8,1,2,1,1,1,1,2,2,10,8,11,3,12,1,6,8,3,12,2,7,1,1,11,15,13,9,5,8,8,20,4,2,8,5,2,5,7,13,4,12,14,13,12,5,19,1,1,1,1,1,1,1,GK ,0,20,1,1,1,1,1,1,1,1,1,1,1,1,1,1,0,0,0,0,0,0,0,0,0,0,0,0,0,0,0,0,0,0,0,0,0,0,0,0,0,0,0,0,0,0,0,0,0,0,0,0,0,0,0,0,0,0,0,0,0,0,0,0,0
13/6/2011,Marc-André ter Stegen,35017428,771,4/30/1992,19,0,0,0,0,5000,7050,7050,178,147,23797842,189,84,GK ,12,15,16,5,11,16,13,14,17,12,15,5,1,2,2,12,10,7,3,1,3,10,3,1,12,11,14,16,15,15,9,12,19,5,14,2,11,13,10,14,12,13,16,15,12,10,20,10,12,16,7,12,8,10,4,19,15,17,18,12,8,5,1,1,1,1,1,1,1,GK ,0,20,1,1,1,1,1,1,1,1,1,1,1,1,1,1,0,0,0,0,0,0,0,0,0,0,0,0,0,0,0,0,0,0,0,0,0,0,0,0,0,0,0,0,0,0,0,0,0,0,0,0,0,0,0,0,0,0,0,0,0,0,0,0,0
13/6/2011,Marc Ziegler,500141,771,6/13/1976,35,0,0,0,0,3400,6200,6200,130,124,3929328,192,89,GK ,13,13,12,5,10,12,13,16,12,12,11,6,2,1,3,5,10,1,1,2,1,9,3,1,9,8,14,13,11,14,3,12,14,4,10,3,13,14,14,13,11,12,14,4,13,12,20,13,13,12,11,12,13,10,11,16,10,15,14,12,8,6,1,1,1,1,1,1,1,GK ,0,20,1,1,1,1,1,1,1,1,1,1,1,1,1,1,0,0,0,0,0,0,0,0,0,0,0,0,0,0,0,0,0,0,0,0,0,0,0,0,0,0,0,0,0,0,0,0,0,0,0,0,0,0,0,0,0,0,0,0,0,0,0,0,0
13/6/2011,Marc Vidal,85057582,769,6/3/1991,20,0,0,0,0,2450,4950,4950,141,110,2100634,187,80,GK ,12,11,7,7,13,10,13,13,10,11,8,7,2,1,2,9,10,1,1,1,1,8,3,1,9,8,13,13,13,13,9,12,16,6,7,2,11,11,8,12,13,15,13,5,15,11,20,13,14,15,8,10,8,1,13,14,14,14,15,15,15,6,1,1,1,1,1,1,1,GK ,0,20,1,1,1,1,1,1,1,1,1,1,1,1,1,1,0,0,0,0,0,0,0,0,0,0,0,0,0,0,0,0,0,0,0,0,0,0,0,0,0,0,0,0,0,0,0,0,0,0,0,0,0,0,0,0,0,0,0,0,0,0,0,0,0
13/6/2011,Manuel Salz,8721529,771,8/6/1985,25,0,0,0,0,750,4500,4500,123,103,447986,185,78,GK ,10,9,5,6,12,10,8,13,12,8,14,3,1,1,2,11,6,13,3,2,1,14,2,1,13,10,10,14,10,11,8,11,10,8,10,11,12,12,11,12,14,11,13,12,8,12,20,11,13,9,6,10,15,10,12,13,9,8,8,12,11,6,1,1,1,1,1,1,1,GK ,0,20,1,1,1,1,1,1,1,1,1,1,1,1,1,1,0,0,0,0,0,0,0,0,0,0,0,0,0,0,0,0,0,0,0,0,0,0,0,0,0,0,0,0,0,0,0,0,0,0,0,0,0,0,0,0,0,0,0,0,0,0,0,0,0
13/6/2011,Manuel Riemann,35014447,771,9/9/1988,22,0,0,0,0,2750,5000,5000,123,100,461409,185,82,GK ,8,12,12,11,10,11,14,13,10,11,8,6,2,2,2,3,10,1,1,2,3,1,1,2,4,15,10,11,10,13,3,14,10,2,10,1,13,2,6,11,11,11,14,5,8,10,20,11,14,10,7,5,1,10,12,13,18,9,16,12,12,20,1,1,1,1,1,1,1,GK ,0,20,1,1,1,1,1,1,1,1,1,1,1,1,1,1,0,0,0,0,0,0,0,0,0,0,0,0,0,0,0,0,0,0,0,0,0,0,0,0,0,0,0,0,0,0,0,0,0,0,0,0,0,0,0,0,0,0,0,0,0,0,0,0,0
13/6/2011,Manuel Neuer,8718372,771,3/27/1986,25,20,0,20,0,8350,9200,9200,186,174,229999992,192,90,GK ,17,18,9,9,11,19,17,16,19,8,20,5,3,1,3,12,10,9,3,1,3,12,3,3,11,10,19,15,13,12,10,10,15,6,11,2,18,16,12,14,15,16,18,14,12,10,20,12,17,14,9,17,8,10,6,10,17,18,13,10,14,8,1,1,1,1,1,1,1,GK ,0,20,1,1,1,1,1,1,1,1,1,1,1,1,1,1,0,0,0,0,0,0,0,0,0,0,0,0,0,0,0,0,0,0,0,0,0,0,0,0,0,0,0,0,0,0,0,0,0,0,0,0,0,0,0,0,0,0,0,0,0,0,0,0,0
13/6/2011,Manuel Almunia,4203301,796,5/19/1977,34,0,0,0,0,5750,6750,6800,147,140,4328282,191,80,GK ,14,11,10,6,15,13,15,16,16,11,14,1,3,2,2,10,6,10,3,2,2,13,3,3,9,5,11,14,6,13,12,11,12,2,12,5,13,11,11,13,16,13,15,8,13,10,20,13,13,12,4,7,12,1,15,13,15,8,16,13,14,4,1,1,1,1,1,1,1,GK ,0,20,1,1,1,1,1,1,1,1,1,1,1,1,1,1,0,0,0,0,0,0,0,0,0,0,0,0,0,0,0,0,0,0,0,0,0,0,0,0,0,0,0,0,0,0,0,0,0,0,0,0,0,0,0,0,0,0,0,0,0,0,0,0,0
13/6/2011,Manu Herrera,7452379,796,9/29/1981,29,0,0,0,0,3850,5850,5850,130,121,522442,182,75,GK ,13,14,11,7,14,11,13,13,13,13,10,4,3,2,1,8,8,8,1,3,2,5,3,3,7,11,11,13,10,13,2,14,12,3,11,1,13,1,7,10,14,12,13,3,12,9,20,11,12,12,4,14,5,10,13,11,14,15,12,13,8,5,1,1,1,1,1,1,1,GK ,0,20,1,1,1,1,1,1,1,1,1,1,1,1,1,1,0,0,0,0,0,0,0,0,0,0,0,0,0,0,0,0,0,0,0,0,0,0,0,0,0,0,0,0,0,0,0,0,0,0,0,0,0,0,0,0,0,0,0,0,0,0,0,0,0
13/6/2011,Mansur Faqiryar,35022951,106,1/3/1986,25,5,0,0,0,400,1950,2200,84,63,10325,171,0,GK ,12,5,11,6,12,10,12,12,4,13,9,3,1,1,3,4,7,1,2,3,2,1,1,2,4,13,5,10,8,9,1,11,8,3,11,1,12,1,1,8,13,9,3,8,17,8,20,3,2,9,7,10,9,10,13,13,15,6,16,6,13,11,1,1,1,1,1,1,1,GK ,0,20,1,1,1,1,1,1,1,1,1,1,1,1,1,1,0,0,0,0,0,0,0,0,0,0,0,0,0,0,0,0,0,0,0,0,0,0,0,0,0,0,0,0,0,0,0,0,0,0,0,0,0,0,0,0,0,0,0,0,0,0,0,0,0
13/6/2011,Manolo Reina,1509742,796,4/1/1985,26,0,0,0,0,3750,6250,6250,137,128,2594517,185,80,GK ,13,12,12,6,13,13,14,15,14,12,12,8,2,3,1,6,10,7,2,3,2,7,2,2,5,13,9,14,12,12,7,12,12,8,12,8,11,13,12,10,14,13,13,7,12,9,20,13,15,14,10,14,4,1,13,12,13,11,12,13,13,9,1,1,1,1,1,1,1,GK ,0,20,1,1,1,1,1,1,1,1,1,1,1,1,1,1,0,0,0,0,0,0,0,0,0,0,0,0,0,0,0,0,0,0,0,0,0,0,0,0,0,0,0,0,0,0,0,0,0,0,0,0,0,0,0,0,0,0,0,0,0,0,0,0,0
13/6/2011,Mamadou Samassa,34008820,769,2/16/1990,21,0,0,0,0,1250,2550,2550,135,103,72526,197,81,GK ,12,10,9,8,11,7,13,14,10,13,7,5,2,2,6,6,10,12,12,3,1,7,1,1,6,9,12,13,13,13,7,11,14,6,10,3,10,12,9,12,13,18,17,1,16,9,20,15,15,13,9,12,5,1,10,14,16,13,12,15,15,7,1,1,1,1,1,1,1,GK ,0,20,1,5,1,1,1,1,1,1,1,1,1,1,1,1,0,0,0,0,0,0,0,0,0,0,0,0,0,0,0,0,0,0,0,0,0,0,0,0,0,0,0,0,0,0,0,0,0,0,0,0,0,0,0,0,0,0,0,0,0,0,0,0,0
13/6/2011,Maikel Aerts,3233,784,6/26/1976,34,0,0,0,0,3700,5500,5500,127,115,848287,196,91,GK ,12,12,11,10,11,11,11,12,12,11,13,8,3,2,3,12,10,10,2,1,2,6,1,12,10,10,12,15,12,11,12,11,16,12,12,3,11,13,15,11,11,15,13,20,6,11,10,12,15,13,10,10,2,10,13,12,5,7,12,12,19,6,1,1,1,1,1,1,1,GK ,0,20,1,1,1,1,1,1,1,1,1,1,1,1,1,1,0,0,0,0,0,0,0,0,0,0,0,0,0,0,0,0,0,0,0,0,0,0,0,0,0,0,0,0,0,0,0,0,0,0,0,0,0,0,0,0,0,0,0,0,0,0,0,0,0
13/6/2011,Maarten Stekelenburg,850879,784,9/22/1982,28,40,0,0,0,6850,7750,7750,167,156,28661020,194,84,GK ,15,14,12,9,16,15,14,16,13,6,14,8,2,3,1,9,10,5,3,1,3,11,1,3,14,10,14,13,15,14,13,14,16,2,14,3,15,15,14,12,14,14,15,7,18,12,20,17,15,13,4,16,11,10,12,18,18,15,18,14,17,3,1,1,1,1,1,1,1,GK ,0,20,1,1,1,1,1,1,1,1,1,1,1,1,1,1,0,0,0,0,0,0,0,0,0,0,0,0,0,0,0,0,0,0,0,0,0,0,0,0,0,0,0,0,0,0,0,0,0,0,0,0,0,0,0,0,0,0,0,0,0,0,0,0,0
13/6/2011,Luke Steele,5512100,765,9/24/1984,26,0,0,0,0,2700,5250,5250,120,100,1504249,188,77,GK ,10,14,9,5,11,9,13,15,10,14,11,9,8,2,3,7,7,1,1,2,1,2,2,3,12,1,11,12,11,7,6,5,10,3,4,10,11,14,16,11,14,13,12,5,15,12,20,9,15,6,2,15,1,10,10,13,10,9,14,12,10,2,1,1,1,1,1,1,1,GK ,0,20,1,1,1,1,1,1,1,1,1,1,1,1,1,1,0,0,0,0,0,0,0,0,0,0,0,0,0,0,0,0,0,0,0,0,0,0,0,0,0,0,0,0,0,0,0,0,0,0,0,0,0,0,0,0,0,0,0,0,0,0,0,0,0
13/6/2011,Lukasz Fabianski,718272,787,4/18/1985,26,17,0,2,0,4500,6250,6500,157,138,12847280,190,84,GK ,14,12,9,10,16,12,15,17,17,17,15,7,3,1,1,10,10,11,2,1,2,7,2,13,10,8,11,13,8,10,12,11,16,1,12,1,12,15,13,14,16,13,15,5,12,13,20,11,12,12,12,9,7,10,15,16,15,6,15,18,12,6,1,1,1,1,1,1,1,GK ,0,20,1,1,1,1,1,1,1,1,1,1,1,1,1,1,0,0,0,0,0,0,0,0,0,0,0,0,0,0,0,0,0,0,0,0,0,0,0,0,0,0,0,0,0,0,0,0,0,0,0,0,0,0,0,0,0,0,0,0,0,0,0,0,0
13/6/2011,Lukas Kruse,890500,771,7/9/1983,27,0,0,0,0,4050,5500,5500,112,110,674672,185,79,GK ,11,13,12,8,12,13,12,13,12,10,11,5,2,3,2,3,8,1,3,3,2,1,1,2,5,12,9,10,11,11,3,12,11,2,12,3,11,3,6,8,13,13,12,5,14,8,20,8,13,10,6,6,7,10,9,14,16,7,14,10,12,12,1,1,1,1,1,1,1,GK ,0,20,1,1,1,1,1,1,1,1,1,1,1,1,1,1,0,0,0,0,0,0,0,0,0,0,0,0,0,0,0,0,0,0,0,0,0,0,0,0,0,0,0,0,0,0,0,0,0,0,0,0,0,0,0,0,0,0,0,0,0,0,0,0,0
13/6/2011,Luiz Carlos,320554,1651,5/24/1988,23,0,0,0,0,500,4950,4750,105,95,891841,191,86,GK ,10,12,11,10,13,10,12,12,10,8,9,5,1,1,1,6,8,3,1,2,3,2,3,2,8,6,13,12,7,6,2,14,16,1,9,1,14,10,11,14,10,11,17,20,12,10,5,6,8,10,12,2,12,10,6,6,5,11,15,14,8,7,1,1,1,1,1,1,1,GK ,0,20,1,1,1,1,1,1,1,1,1,1,1,1,1,1,0,0,0,0,0,0,0,0,0,0,0,0,0,0,0,0,0,0,0,0,0,0,0,0,0,0,0,0,0,0,0,0,0,0,0,0,0,0,0,0,0,0,0,0,0,0,0,0,0
13/6/2011,Luis Robles,72004192,390,9/11/1984,26,1,0,0,0,3400,5830,5100,129,106,461943,185,87,GK ,11,14,8,11,13,10,14,14,13,13,12,7,3,2,2,8,10,2,1,2,3,2,1,3,4,8,8,10,7,12,7,11,9,2,12,1,12,13,11,8,12,12,13,4,11,10,20,11,11,11,2,13,9,10,11,14,9,12,12,15,10,12,1,1,1,1,1,1,1,GK ,0,20,1,1,1,1,1,1,1,1,1,1,1,1,1,1,0,0,0,0,0,0,0,0,0,0,0,0,0,0,0,0,0,0,0,0,0,0,0,0,0,0,0,0,0,0,0,0,0,0,0,0,0,0,0,0,0,0,0,0,0,0,0,0,0
13/6/2011,Lucas Veronese,85033650,769,2/6/1991,20,0,0,0,0,1300,2600,2600,159,105,765358,188,76,GK ,11,12,10,7,11,14,13,13,4,7,9,4,3,2,3,8,9,3,3,1,1,1,1,2,8,7,12,11,10,12,3,14,10,3,8,2,9,2,7,15,13,14,14,1,15,12,20,12,11,14,7,10,5,1,9,15,14,8,11,10,7,15,1,1,1,1,1,1,1,GK ,0,20,1,1,1,1,1,1,1,1,1,1,1,1,1,1,0,0,0,0,0,0,0,0,0,0,0,0,0,0,0,0,0,0,0,0,0,0,0,0,0,0,0,0,0,0,0,0,0,0,0,0,0,0,0,0,0,0,0,0,0,0,0,0,0
13/6/2011,Luca Castellazzi,700702,776,7/19/1975,35,0,0,0,0,5000,6600,6600,145,132,2805294,192,89,GK ,10,13,13,11,16,13,13,16,8,14,15,5,3,3,2,10,10,10,11,2,2,12,1,1,12,10,15,10,15,14,10,14,14,3,15,2,13,11,10,8,10,11,15,20,15,10,5,12,10,12,6,14,8,10,12,15,10,17,12,5,9,15,1,1,1,1,1,1,1,GK ,0,20,1,1,1,1,1,1,1,1,1,1,1,1,1,1,0,0,0,0,0,0,0,0,0,0,0,0,0,0,0,0,0,0,0,0,0,0,0,0,0,0,0,0,0,0,0,0,0,0,0,0,0,0,0,0,0,0,0,0,0,0,0,0,0
13/6/2011,Luca Anania,3801461,776,6/21/1980,30,0,0,0,0,1200,4300,4400,95,95,51107,183,76,GK ,11,12,13,5,14,8,13,13,11,9,12,6,1,2,2,5,10,4,2,2,2,2,1,2,5,8,9,8,9,10,10,11,11,11,10,7,13,10,11,10,12,10,11,20,11,10,10,8,10,11,5,11,8,10,14,11,15,5,15,13,14,20,1,1,1,1,1,1,1,GK ,0,20,1,1,1,1,1,1,1,1,1,1,1,1,1,1,0,0,0,0,0,0,0,0,0,0,0,0,0,0,0,0,0,0,0,0,0,0,0,0,0,0,0,0,0,0,0,0,0,0,0,0,0,0,0,0,0,0,0,0,0,0,0,0,0
13/6/2011,Loris Karius,28047501,771,6/22/1993,17,0,0,0,0,1500,3284,3250,128,73,769028,187,75,GK ,10,11,8,12,11,10,10,10,14,15,11,6,3,1,1,7,10,6,2,3,2,6,3,2,7,11,9,8,7,10,5,11,5,3,6,2,8,10,7,9,7,8,12,5,11,8,20,12,8,10,9,10,5,9,13,11,13,12,14,10,13,16,1,1,1,1,1,1,1,GK ,0,20,1,1,1,1,1,1,1,1,1,1,1,1,1,1,0,0,0,0,0,0,0,0,0,0,0,0,0,0,0,0,0,0,0,0,0,0,0,0,0,0,0,0,0,0,0,0,0,0,0,0,0,0,0,0,0,0,0,0,0,0,0,0,0
13/6/2011,Lorenzo Squizzi,6956,776,6/20/1974,36,0,0,0,0,2500,5500,5500,116,110,571755,191,89,GK ,11,11,11,10,12,12,12,12,10,8,11,6,6,6,6,3,6,10,10,2,14,12,6,13,4,11,14,13,10,14,5,10,16,3,9,1,15,16,16,10,10,10,14,6,12,11,20,13,10,15,13,12,14,6,10,9,15,11,12,9,14,5,1,1,1,1,1,1,1,GK ,0,20,1,1,1,1,1,1,1,1,1,1,1,1,1,1,0,0,0,0,0,0,0,0,0,0,0,0,0,0,0,0,0,0,0,0,0,0,0,0,0,0,0,0,0,0,0,0,0,0,0,0,0,0,0,0,0,0,0,0,0,0,0,0,0
13/6/2011,Lionel Cappone,3503840,769,2/8/1979,32,0,0,0,0,1600,5450,5450,125,122,3381820,182,74,GK ,14,12,12,5,12,14,13,15,10,11,9,7,1,1,3,6,10,2,1,3,2,8,1,2,6,10,12,15,12,12,6,12,11,5,11,2,13,8,13,9,11,14,11,1,15,7,20,9,14,14,10,14,13,1,9,12,14,13,14,14,14,6,1,1,1,1,1,1,1,GK ,0,20,1,1,1,1,1,1,1,1,1,1,1,1,1,1,0,0,0,0,0,0,0,0,0,0,0,0,0,0,0,0,0,0,0,0,0,0,0,0,0,0,0,0,0,0,0,0,0,0,0,0,0,0,0,0,0,0,0,0,0,0,0,0,0
13/6/2011,Lewis Price,5110802,801,7/19/1984,26,8,0,10,0,2050,4500,4500,110,91,118228,191,85,GK ,8,10,9,3,12,5,10,14,12,2,13,1,2,1,2,7,4,3,1,2,2,13,1,2,2,14,14,10,13,9,3,10,14,8,4,1,14,10,10,10,12,13,16,6,13,14,20,12,13,13,5,10,5,10,14,13,18,11,13,15,16,2,1,1,1,1,1,1,1,GK ,0,20,1,1,1,1,1,1,1,1,1,1,1,1,1,1,0,0,0,0,0,0,0,0,0,0,0,0,0,0,0,0,0,0,0,0,0,0,0,0,0,0,0,0,0,0,0,0,0,0,0,0,0,0,0,0,0,0,0,0,0,0,0,0,0
13/6/2011,Leonardo Franco,4206726,1649,5/20/1978,33,4,0,6,0,4300,6300,6300,146,124,1337639,188,79,GK ,13,10,14,6,12,16,9,13,12,14,15,2,3,7,2,10,5,6,1,2,2,9,3,2,6,9,13,13,15,13,6,13,10,4,14,3,13,12,11,7,11,16,14,11,12,9,20,13,13,14,6,13,10,10,15,16,9,12,14,10,10,10,1,1,1,1,1,1,1,GK ,0,20,1,1,1,1,1,1,1,1,1,1,1,1,1,1,0,0,0,0,0,0,0,0,0,0,0,0,0,0,0,0,0,0,0,0,0,0,0,0,0,0,0,0,0,0,0,0,0,0,0,0,0,0,0,0,0,0,0,0,0,0,0,0,0
13/6/2011,Lee Grant,5101667,765,1/27/1983,28,0,0,4,0,3500,5800,5800,135,112,2873850,191,84,GK ,12,12,9,4,11,17,9,15,12,9,10,3,3,2,3,12,8,7,3,3,3,12,2,1,10,9,11,14,11,13,10,10,10,12,6,12,14,11,11,9,14,9,14,5,9,9,20,9,9,11,10,12,5,10,5,15,5,11,11,7,14,9,1,1,1,1,1,1,1,GK ,0,20,1,1,1,1,1,1,1,1,1,1,1,1,1,1,17179869184,0,0,0,0,0,0,0,0,0,0,0,0,0,0,0,0,0,0,0,0,0,0,0,0,0,0,0,0,0,0,0,0,0,0,1,0,0,0,0,0,0,0,0,0,0,0,0,0
13/6/2011,Lee Camp,5104585,785,8/22/1984,26,2,0,0,0,3100,6150,6100,135,122,3840542,186,75,GK ,14,11,13,11,14,12,12,15,11,7,11,4,1,2,1,11,6,2,2,2,2,10,1,3,11,9,12,12,10,12,12,9,8,3,13,12,13,11,8,11,14,13,13,5,12,12,20,13,11,13,4,14,4,10,8,12,14,6,12,12,7,10,1,1,1,1,1,1,1,GK ,0,20,1,1,1,1,1,1,1,1,1,1,1,1,1,1,2199023321088,0,0,0,0,0,0,0,0,0,0,0,0,0,0,0,0,1,0,0,0,0,0,0,0,0,0,0,0,0,0,0,0,0,0,0,0,0,0,0,0,0,1,0,0,0,0,0,0
13/6/2011,Leandro,67063096,796,2/28/1989,22,0,0,0,0,2000,4500,4500,115,100,778019,186,77,GK ,13,11,9,8,11,12,11,14,11,12,10,3,1,2,2,8,6,3,3,2,3,3,2,3,5,5,9,10,5,9,9,9,11,14,8,4,10,11,7,11,17,10,14,1,9,11,20,12,15,11,5,10,3,10,16,11,15,13,16,17,10,9,1,1,1,1,1,1,1,GK ,0,20,1,1,1,1,1,1,1,1,1,1,1,1,1,1,0,0,0,0,0,0,0,0,0,0,0,0,0,0,0,0,0,0,0,0,0,0,0,0,0,0,0,0,0,0,0,0,0,0,0,0,0,0,0,0,0,0,0,0,0,0,0,0,0
13/6/2011,Laurent Pionnier,916633,769,5/24/1982,29,0,0,0,0,4200,5300,5300,128,118,2698425,184,76,GK ,11,12,13,5,13,12,14,14,11,11,11,3,2,2,3,10,8,1,3,1,2,9,1,1,10,7,12,13,13,13,8,11,15,6,12,3,10,12,7,11,12,14,12,1,14,10,20,13,13,14,7,14,10,1,8,12,17,14,16,14,14,7,1,1,5,5,5,1,1,GK ,0,20,1,1,1,1,5,1,1,1,1,1,1,5,1,1,0,0,0,0,0,0,0,0,0,0,0,0,0,0,0,0,0,0,0,0,0,0,0,0,0,0,0,0,0,0,0,0,0,0,0,0,0,0,0,0,0,0,0,0,0,0,0,0,0
13/6/2011,Lars Unnerstall,91018384,771,7/20/1990,20,0,0,0,0,1750,4750,4750,129,95,851321,198,100,GK ,13,11,11,6,12,13,11,13,10,15,12,5,1,2,1,7,10,2,2,2,3,1,3,1,4,7,8,9,7,11,1,13,8,2,6,1,9,2,2,12,12,11,17,2,10,7,20,4,7,10,8,10,3,10,4,13,10,12,6,17,14,8,1,1,1,1,1,1,1,GK ,0,20,1,1,1,1,1,1,1,1,1,1,1,1,1,1,0,0,0,0,0,0,0,0,0,0,0,0,0,0,0,0,0,0,0,0,0,0,0,0,0,0,0,0,0,0,0,0,0,0,0,0,0,0,0,0,0,0,0,0,0,0,0,0,0
13/6/2011,Landry Bonnefoi,914405,769,9/20/1983,27,0,0,1,0,2300,3550,3550,118,108,402997,184,72,GK ,11,12,12,10,13,7,11,14,10,15,10,2,3,3,6,8,7,12,1,2,3,7,2,1,8,9,12,14,12,12,7,11,14,6,11,2,10,12,9,12,14,14,12,20,14,10,1,13,12,14,9,14,9,1,11,15,11,11,13,11,13,9,1,1,1,1,1,1,1,GK ,0,20,1,1,1,1,1,1,1,1,1,1,1,1,1,1,0,0,0,0,0,0,0,0,0,0,0,0,0,0,0,0,0,0,0,0,0,0,0,0,0,0,0,0,0,0,0,0,0,0,0,0,0,0,0,0,0,0,0,0,0,0,0,0,0
13/6/2011,Kossi Agassa,915526,50,7/2/1978,32,52,0,0,0,4500,6050,5000,120,110,507786,190,86,GK ,15,12,12,13,11,6,14,15,12,10,8,4,1,1,1,7,9,3,1,3,2,7,1,1,7,10,12,13,12,10,7,9,11,6,13,1,11,13,8,11,12,17,15,1,12,9,20,10,17,13,10,16,7,1,12,12,13,13,13,14,14,6,1,1,1,1,1,1,1,GK ,0,20,1,1,1,1,1,1,1,1,1,1,1,1,1,1,0,0,0,0,0,0,0,0,0,0,0,0,0,0,0,0,0,0,0,0,0,0,0,0,0,0,0,0,0,0,0,0,0,0,0,0,0,0,0,0,0,0,0,0,0,0,0,0,0
13/6/2011,Koen Casteels,18010782,757,6/25/1992,18,0,0,0,0,2950,5000,5000,137,107,16053008,196,81,GK ,15,10,12,8,12,14,10,12,11,8,15,4,2,3,3,12,9,8,1,3,2,12,1,1,7,13,9,8,10,14,14,10,15,2,1,3,14,3,10,10,10,12,15,7,12,12,20,7,8,10,7,10,16,9,13,15,15,8,14,14,14,7,1,1,1,1,1,1,1,GK ,0,20,1,1,1,1,1,1,1,1,1,1,1,1,1,1,0,0,0,0,0,0,0,0,0,0,0,0,0,0,0,0,0,0,0,0,0,0,0,0,0,0,0,0,0,0,0,0,0,0,0,0,0,0,0,0,0,0,0,0,0,0,0,0,0
13/6/2011,Kiko Casilla,1508841,796,10/2/1986,24,0,0,1,0,3700,5500,5500,138,118,3126422,192,83,GK ,11,9,11,6,12,15,12,14,10,5,9,3,2,2,1,7,8,2,3,2,2,1,1,1,9,10,13,12,11,11,7,11,7,2,9,2,13,3,5,9,13,13,16,11,13,10,20,10,14,12,5,12,5,10,6,8,10,7,15,4,6,11,1,1,1,1,1,1,1,GK ,0,20,1,1,1,1,1,1,1,1,1,1,1,1,1,1,0,0,0,0,0,0,0,0,0,0,0,0,0,0,0,0,0,0,0,0,0,0,0,0,0,0,0,0,0,0,0,0,0,0,0,0,0,0,0,0,0,0,0,0,0,0,0,0,0
13/6/2011,Keylor Navas,8826969,366,12/15/1986,24,27,0,0,0,4500,6500,6150,142,129,969472,186,78,GK ,12,14,10,8,13,10,13,15,5,12,11,7,3,2,2,3,9,1,3,3,1,10,3,2,4,12,14,14,11,14,9,14,10,3,10,1,14,2,8,10,14,13,14,11,13,11,20,13,12,10,10,10,5,10,9,11,7,7,15,10,13,10,1,1,1,1,1,1,1,GK ,0,20,1,1,1,1,1,1,1,1,1,1,1,1,1,1,0,0,0,0,0,0,0,0,0,0,0,0,0,0,0,0,0,0,0,0,0,0,0,0,0,0,0,0,0,0,0,0,0,0,0,0,0,0,0,0,0,0,0,0,0,0,0,0,0
13/6/2011,Kevin Trapp,35018013,771,7/8/1990,20,0,0,5,0,1000,6650,6650,158,133,12468304,189,83,GK ,14,12,12,11,13,10,15,17,12,13,11,5,1,1,3,11,9,10,2,2,1,11,2,3,11,7,12,14,13,12,7,13,9,6,8,1,13,13,13,11,13,13,15,5,14,10,20,12,13,12,1,13,4,10,13,13,12,11,11,12,8,8,1,1,1,1,1,1,1,GK ,0,20,1,1,1,1,1,1,1,1,1,1,1,1,1,1,0,0,0,0,0,0,0,0,0,0,0,0,0,0,0,0,0,0,0,0,0,0,0,0,0,0,0,0,0,0,0,0,0,0,0,0,0,0,0,0,0,0,0,0,0,0,0,0,0
13/6/2011,Kévin Olimpa,8440946,769,3/10/1988,23,0,0,6,0,4050,5100,5100,135,114,3061227,186,81,GK ,14,11,13,9,12,6,15,14,11,8,6,6,3,2,1,6,10,1,1,2,2,7,2,1,6,9,12,15,14,11,7,11,15,5,10,1,11,11,13,13,14,14,13,1,13,9,20,13,14,12,9,14,8,1,5,17,14,11,9,12,12,13,1,1,1,1,1,1,1,GK ,0,20,1,1,1,1,1,1,1,1,1,1,1,1,1,1,0,0,0,0,0,0,0,0,0,0,0,0,0,0,0,0,0,0,0,0,0,0,0,0,0,0,0,0,0,0,0,0,0,0,0,0,0,0,0,0,0,0,0,0,0,0,0,0,0
13/6/2011,Kevin Gensch,92016067,771,3/11/1993,18,0,0,0,0,50,1500,1500,91,41,286,193,75,GK ,4,6,11,8,9,7,10,10,6,5,7,2,1,3,1,2,6,1,2,1,3,1,3,2,2,6,3,9,9,9,1,6,8,2,6,1,8,1,2,10,8,8,14,16,4,9,20,1,4,6,9,10,7,9,5,1,12,18,10,15,9,8,1,1,1,1,1,1,1,GK ,0,20,1,1,1,1,1,1,1,1,1,1,1,1,1,1,0,0,0,0,0,0,0,0,0,0,0,0,0,0,0,0,0,0,0,0,0,0,0,0,0,0,0,0,0,0,0,0,0,0,0,0,0,0,0,0,0,0,0,0,0,0,0,0,0
13/6/2011,Kévin Aubeneau,34008814,769,2/10/1989,22,0,0,0,0,1450,2900,2900,115,89,168831,186,76,GK ,13,12,9,7,12,8,11,12,10,7,6,2,2,1,3,7,6,2,1,1,2,7,2,3,7,8,12,13,11,13,6,11,14,6,7,1,9,8,8,11,11,13,13,1,15,8,20,14,13,15,8,14,5,1,10,12,16,14,14,14,14,6,1,1,1,1,1,1,1,GK ,0,20,1,1,1,1,1,1,1,1,1,1,1,1,1,1,0,0,0,0,0,0,0,0,0,0,0,0,0,0,0,0,0,0,0,0,0,0,0,0,0,0,0,0,0,0,0,0,0,0,0,0,0,0,0,0,0,0,0,0,0,0,0,0,0
13/6/2011,Kelvin Davis,2003901,765,9/29/1976,34,0,0,3,0,3000,5500,5500,125,103,767287,186,78,GK ,13,11,11,10,11,7,13,14,10,11,13,3,2,1,1,2,8,2,2,2,2,3,3,2,6,9,10,11,10,9,11,10,12,9,14,9,10,13,11,10,13,13,14,7,15,10,20,9,13,16,5,12,6,10,11,10,15,13,16,16,15,5,1,1,1,1,1,1,1,GK ,0,20,1,1,1,1,1,1,1,1,1,1,1,1,1,1,0,0,0,0,0,0,0,0,0,0,0,0,0,0,0,0,0,0,0,0,0,0,0,0,0,0,0,0,0,0,0,0,0,0,0,0,0,0,0,0,0,0,0,0,0,0,0,0,0
13/6/2011,Keiren Westwood,5002586,789,10/23/1984,26,7,0,0,0,4550,6700,6150,143,128,7890042,188,87,GK ,14,15,11,4,15,13,14,18,9,2,9,3,1,3,2,4,7,1,2,1,1,1,3,3,9,4,9,15,11,12,6,7,13,5,12,9,8,6,9,10,15,13,15,20,12,8,5,17,12,13,3,7,6,10,11,19,12,14,13,11,13,4,1,1,1,1,1,1,1,GK ,0,20,1,1,1,1,1,1,1,1,1,1,1,1,1,1,0,0,0,0,0,0,0,0,0,0,0,0,0,0,0,0,0,0,0,0,0,0,0,0,0,0,0,0,0,0,0,0,0,0,0,0,0,0,0,0,0,0,0,0,0,0,0,0,0
13/6/2011,Kasper Schmeichel,5114022,764,11/5/1986,24,0,0,26,0,3350,5354,5750,150,119,2005936,183,83,GK ,12,10,13,10,14,17,15,15,12,16,13,3,2,3,2,10,7,2,2,2,3,8,2,3,9,6,10,11,10,12,3,9,15,1,10,3,10,11,12,10,15,8,13,8,15,10,20,13,9,12,17,11,6,10,16,14,10,12,17,17,16,4,1,1,1,1,1,1,1,GK ,0,20,1,1,1,1,1,1,1,1,1,1,1,1,1,1,2199023255552,0,0,0,0,0,0,0,0,0,0,0,0,0,0,0,0,0,0,0,0,0,0,0,0,0,0,0,0,0,0,0,0,0,0,0,0,0,0,0,0,0,1,0,0,0,0,0,0
13/6/2011,Karl Darlow,29021698,765,10/8/1990,20,0,0,0,0,1000,2500,3250,110,75,46187,188,89,GK ,11,10,10,4,12,13,9,12,6,8,11,4,1,2,2,1,8,1,2,3,1,2,1,2,2,1,8,9,10,12,9,10,10,3,7,1,6,5,8,3,8,9,12,9,10,7,20,8,8,3,2,3,3,9,5,5,9,6,9,12,15,8,1,1,1,1,1,1,1,GK ,0,20,1,1,1,1,1,1,1,1,1,1,1,1,1,1,0,0,0,0,0,0,0,0,0,0,0,0,0,0,0,0,0,0,0,0,0,0,0,0,0,0,0,0,0,0,0,0,0,0,0,0,0,0,0,0,0,0,0,0,0,0,0,0,0
13/6/2011,Jussi Jääskeläinen,103453,768,4/19/1975,36,56,0,14,0,6250,8250,7250,155,144,3446173,190,81,GK ,14,13,14,5,14,8,15,15,13,9,9,7,3,1,2,7,10,3,2,3,2,7,3,1,12,10,16,15,11,16,4,13,13,6,15,12,14,8,9,11,17,15,16,7,12,9,20,11,12,17,4,15,2,10,16,12,15,17,18,15,16,4,1,1,1,1,1,1,1,GK ,0,20,1,1,1,1,1,1,1,1,1,1,1,1,1,1,2199023255552,0,0,0,0,0,0,0,0,0,0,0,0,0,0,0,0,0,0,0,0,0,0,0,0,0,0,0,0,0,0,0,0,0,0,0,0,0,0,0,0,0,1,0,0,0,0,0,0
13/6/2011,Júlio Sérgio,311291,1651,11/8/1978,32,0,0,0,0,4750,6500,6750,150,135,1731532,187,80,GK ,12,14,11,6,14,13,14,17,14,10,12,8,2,1,1,10,10,2,3,2,3,11,3,3,10,11,13,13,11,9,11,13,16,1,18,1,14,11,14,9,14,12,14,20,13,11,8,10,11,11,5,14,10,10,12,16,13,19,20,13,12,7,1,1,1,1,1,1,1,GK ,0,20,1,1,1,1,1,1,1,1,1,1,1,1,1,1,0,0,0,0,0,0,0,0,0,0,0,0,0,0,0,0,0,0,0,0,0,0,0,0,0,0,0,0,0,0,0,0,0,0,0,0,0,0,0,0,0,0,0,0,0,0,0,0,0
13/6/2011,Júlio César,2107808,1651,9/2/1986,24,0,0,0,0,2500,6500,6500,145,129,669518,192,85,GK ,13,13,13,4,13,13,12,16,15,10,13,1,2,2,1,6,4,1,3,2,1,1,2,3,6,7,12,13,13,13,1,13,17,3,5,1,13,9,14,9,11,13,15,12,16,8,20,9,6,15,11,13,10,10,15,13,14,11,14,14,12,11,1,1,1,1,1,1,1,GK ,0,20,1,1,1,1,1,1,1,1,1,1,1,1,1,1,0,0,0,0,0,0,0,0,0,0,0,0,0,0,0,0,0,0,0,0,0,0,0,0,0,0,0,0,0,0,0,0,0,0,0,0,0,0,0,0,0,0,0,0,0,0,0,0,0
13/6/2011,Julián Speroni,3101140,1649,5/18/1979,32,0,0,0,0,3250,6000,6000,135,120,2873850,186,87,GK ,11,14,10,11,13,11,15,15,14,12,10,6,3,7,1,3,10,3,2,2,1,6,4,10,4,5,12,12,10,9,11,11,14,13,5,12,11,13,8,10,16,12,12,5,15,10,20,14,7,13,2,13,3,10,12,11,14,11,15,13,15,3,1,1,1,1,1,1,1,GK ,0,20,1,1,1,1,1,1,1,1,1,1,1,1,1,1,0,0,0,0,0,0,0,0,0,0,0,0,0,0,0,0,0,0,0,0,0,0,0,0,0,0,0,0,0,0,0,0,0,0,0,0,0,0,0,0,0,0,0,0,0,0,0,0,0
13/6/2011,Julian Böttger,35023842,771,10/6/1988,22,0,0,0,0,950,3500,3500,96,70,14048,187,80,GK ,7,13,10,9,10,11,11,12,12,8,9,3,1,3,1,4,8,1,1,2,3,2,3,3,4,9,10,14,9,10,1,13,9,1,12,2,7,1,3,9,10,7,13,2,9,10,20,3,5,10,12,2,5,10,8,12,9,7,13,9,13,13,1,1,1,1,1,1,1,GK ,0,20,1,1,1,1,1,1,1,1,1,1,1,1,1,1,0,0,0,0,0,0,0,0,0,0,0,0,0,0,0,0,0,0,0,0,0,0,0,0,0,0,0,0,0,0,0,0,0,0,0,0,0,0,0,0,0,0,0,0,0,0,0,0,0
13/6/2011,Juanma,824562,796,6/27/1980,30,0,0,0,0,2500,5000,5000,120,100,1167485,186,78,GK ,10,12,10,4,11,9,11,13,11,12,11,3,2,2,2,9,5,1,2,1,3,1,3,3,6,5,12,11,14,13,5,12,13,10,11,2,12,11,11,6,11,13,13,5,12,6,20,12,14,13,5,12,6,10,12,14,12,11,14,7,11,8,1,1,1,1,1,1,1,GK ,0,20,1,1,1,1,1,1,1,1,1,1,1,1,1,1,0,0,0,0,0,0,0,0,0,0,0,0,0,0,0,0,0,0,0,0,0,0,0,0,0,0,0,0,0,0,0,0,0,0,0,0,0,0,0,0,0,0,0,0,0,0,0,0,0
13/6/2011,Juan Pablo,813688,796,9/2/1978,32,0,0,0,0,4600,6500,6500,136,135,5999999,187,85,GK ,11,13,14,7,15,9,13,15,11,13,10,4,3,1,2,5,9,1,3,3,3,2,2,1,5,6,12,13,13,15,10,14,16,1,15,1,11,11,11,11,16,11,15,20,10,10,5,14,13,15,5,14,7,10,12,13,11,11,15,12,11,8,1,1,1,1,1,1,1,GK ,0,20,1,1,1,1,1,1,1,1,1,1,1,1,1,1,0,0,0,0,0,0,0,0,0,0,0,0,0,0,0,0,0,0,0,0,0,0,0,0,0,0,0,0,0,0,0,0,0,0,0,0,0,0,0,0,0,0,0,0,0,0,0,0,0
13/6/2011,Juan Pablo Carrizo,954171,1649,5/6/1984,27,12,0,3,0,6250,7000,6750,151,135,12178827,187,88,GK ,10,13,14,16,14,15,17,17,10,14,13,7,2,10,1,9,10,7,1,1,2,11,2,1,10,7,12,17,11,7,9,10,18,2,12,2,11,13,12,8,13,16,15,9,15,9,20,15,17,15,3,13,5,10,9,18,15,13,17,17,11,15,1,1,1,1,1,1,1,GK ,0,20,1,1,1,1,1,1,1,1,1,1,1,1,1,1,2199023255552,0,0,0,0,0,0,0,0,0,0,0,0,0,0,0,0,0,0,0,0,0,0,0,0,0,0,0,0,0,0,0,0,0,0,0,0,0,0,0,0,0,1,0,0,0,0,0,0
13/6/2011,Juan Carlos,1503797,796,7/27/1987,23,0,0,0,0,4100,6100,6100,139,123,737458,180,78,GK ,10,12,10,12,12,11,17,15,13,10,12,6,3,3,3,8,9,6,1,2,3,10,3,2,8,8,12,11,12,12,6,11,10,4,10,2,13,13,12,12,15,11,10,11,13,13,20,12,11,14,7,14,4,10,12,14,8,14,10,11,5,20,1,1,1,1,1,1,1,GK ,0,20,1,1,1,1,1,1,1,1,1,1,1,1,1,1,0,0,0,0,0,0,0,0,0,0,0,0,0,0,0,0,0,0,0,0,0,0,0,0,0,0,0,0,0,0,0,0,0,0,0,0,0,0,0,0,0,0,0,0,0,0,0,0,0
13/6/2011,Juan Calatayud,7444657,796,12/21/1979,31,0,0,0,0,4500,6400,6400,136,131,3093128,191,84,GK ,6,9,14,11,7,14,16,17,10,12,15,7,1,3,1,11,9,14,12,3,1,12,3,1,10,14,11,13,11,14,9,13,12,1,15,3,13,12,12,11,16,15,16,10,14,11,20,13,14,14,7,14,5,10,15,10,12,5,16,14,11,4,1,1,1,1,1,1,1,GK ,0,20,1,1,1,1,1,1,1,1,1,1,1,1,1,1,0,0,0,0,0,0,0,0,0,0,0,0,0,0,0,0,0,0,0,0,0,0,0,0,0,0,0,0,0,0,0,0,0,0,0,0,0,0,0,0,0,0,0,0,0,0,0,0,0
13/6/2011,José Xavier,55037385,1658,3/9/1990,21,0,0,0,0,50,150,50,88,46,34782,180,73,GK ,12,10,3,12,13,9,6,12,4,13,10,3,2,2,1,1,7,1,1,3,3,1,3,3,6,11,6,6,7,7,1,7,6,1,5,1,13,1,2,4,11,10,10,7,9,3,20,3,3,9,12,10,8,10,10,8,7,9,14,9,11,5,1,1,1,1,1,1,1,GK ,0,20,1,1,1,1,1,1,1,1,1,1,1,1,1,1,0,0,0,0,0,0,0,0,0,0,0,0,0,0,0,0,0,0,0,0,0,0,0,0,0,0,0,0,0,0,0,0,0,0,0,0,0,0,0,0,0,0,0,0,0,0,0,0,0
13/6/2011,José Manuel Reina,6701096,796,8/31/1982,28,22,0,20,0,8500,8600,8600,180,175,55276684,190,85,GK ,14,13,14,5,16,15,15,18,16,13,15,7,1,7,2,12,10,10,1,2,3,15,1,1,7,13,13,14,15,15,11,14,15,5,15,3,18,2,10,14,15,12,17,10,12,15,20,15,14,16,9,15,2,10,19,16,18,13,15,16,13,9,1,1,1,1,1,1,1,GK ,0,20,1,1,1,1,1,1,1,1,1,1,1,1,1,1,0,0,0,0,0,0,0,0,0,0,0,0,0,0,0,0,0,0,0,0,0,0,0,0,0,0,0,0,0,0,0,0,0,0,0,0,0,0,0,0,0,0,0,0,0,0,0,0,0
13/6/2011,José Manuel Pinto,4200616,796,11/8/1975,35,0,0,0,0,4750,6850,6850,142,132,3054583,183,84,GK ,13,12,12,9,13,11,13,15,14,17,13,1,1,1,1,10,1,1,1,1,1,1,1,1,5,13,12,14,7,12,11,11,14,7,13,2,13,16,15,13,14,13,13,6,13,14,20,12,14,13,11,14,12,1,8,10,14,11,15,5,6,4,1,1,1,1,1,1,1,GK ,0,20,1,1,1,1,1,1,1,1,1,1,1,1,1,1,0,0,0,0,0,0,0,0,0,0,0,0,0,0,0,0,0,0,0,0,0,0,0,0,0,0,0,0,0,0,0,0,0,0,0,0,0,0,0,0,0,0,0,0,0,0,0,0,0
13/6/2011,José Juan,6701831,796,11/30/1979,31,0,0,0,0,2500,4500,4500,105,100,709581,182,80,GK ,10,12,14,13,12,10,11,12,12,12,10,3,1,2,1,4,5,2,1,2,2,3,3,3,5,6,13,12,7,12,2,11,8,3,15,1,14,3,3,10,10,14,11,5,17,5,20,6,5,10,5,8,5,10,7,10,16,5,12,13,7,4,1,1,1,1,1,1,1,GK ,0,20,1,1,1,1,1,1,1,1,1,1,1,1,1,1,0,0,0,0,0,0,0,0,0,0,0,0,0,0,0,0,0,0,0,0,0,0,0,0,0,0,0,0,0,0,0,0,0,0,0,0,0,0,0,0,0,0,0,0,0,0,0,0,0
13/6/2011,José Antonio Salcedo,18039613,796,10/1/1990,20,0,0,0,0,1750,4250,4250,99,85,935432,185,80,GK ,10,12,11,12,9,11,11,9,5,4,10,3,1,1,3,2,6,1,3,1,2,1,3,3,2,13,7,11,5,8,1,9,16,1,14,3,13,2,10,12,13,11,11,5,8,6,20,3,12,8,10,10,6,8,14,16,13,12,11,15,10,7,1,1,1,1,1,1,1,GK ,0,20,1,1,1,1,1,1,1,1,1,1,1,1,1,1,0,0,0,0,0,0,0,0,0,0,0,0,0,0,0,0,0,0,0,0,0,0,0,0,0,0,0,0,0,0,0,0,0,0,0,0,0,0,0,0,0,0,0,0,0,0,0,0,0
13/6/2011,Joris Delle,34000463,769,3/29/1990,21,0,0,0,0,2500,3800,3800,148,115,1084556,190,84,GK ,16,12,12,5,13,9,12,14,7,10,7,2,1,3,1,7,6,1,1,3,2,7,1,1,7,12,13,14,12,12,7,12,15,7,12,2,8,11,8,10,13,16,15,20,13,7,1,13,16,14,12,14,12,1,11,13,14,14,17,15,15,5,1,1,1,1,1,1,1,GK ,0,20,1,1,1,1,1,1,1,1,1,1,1,1,1,1,0,0,0,0,0,0,0,0,0,0,0,0,0,0,0,0,0,0,0,0,0,0,0,0,0,0,0,0,0,0,0,0,0,0,0,0,0,0,0,0,0,0,0,0,0,0,0,0,0
13/6/2011,Jorge Sanmiguel,4210266,796,8/30/1978,32,0,0,0,0,1600,3750,3750,85,80,26588,195,92,GK ,14,13,11,11,9,13,6,8,12,12,9,1,1,3,2,4,6,2,2,1,1,6,1,1,6,15,10,12,9,12,2,10,12,1,10,3,9,8,11,10,11,9,10,20,9,9,5,9,9,7,7,10,10,1,10,15,10,10,14,16,18,11,1,1,1,1,1,1,1,GK ,0,20,1,1,1,1,1,1,1,1,1,1,1,1,1,1,0,0,0,0,0,0,0,0,0,0,0,0,0,0,0,0,0,0,0,0,0,0,0,0,0,0,0,0,0,0,0,0,0,0,0,0,0,0,0,0,0,0,0,0,0,0,0,0,0
13/6/2011,Jorge Palatsí,67127648,796,2/18/1988,23,0,0,0,0,1250,2750,2750,80,56,331705,178,76,GK ,13,9,11,3,10,10,7,11,10,7,8,3,1,3,3,3,4,1,3,2,2,2,1,3,5,6,9,6,8,8,1,8,9,1,14,2,8,2,3,6,7,8,8,8,14,4,20,6,4,10,5,10,8,10,6,6,6,13,12,12,13,9,1,1,1,1,1,1,1,GK ,0,20,1,1,1,1,1,1,1,1,1,1,1,1,1,1,0,0,0,0,0,0,0,0,0,0,0,0,0,0,0,0,0,0,0,0,0,0,0,0,0,0,0,0,0,0,0,0,0,0,0,0,0,0,0,0,0,0,0,0,0,0,0,0,0
13/6/2011,Jorge Larrosa,1510084,796,12/16/1985,25,0,0,0,0,2250,3750,3750,93,80,27570,181,72,GK ,11,10,7,4,12,8,13,13,9,7,10,4,2,2,2,7,8,5,1,3,3,8,3,3,7,4,9,7,12,10,4,7,10,4,4,3,9,10,7,12,15,10,12,4,9,11,20,12,9,15,5,13,17,10,12,10,16,12,12,7,10,5,1,1,1,1,1,1,1,GK ,0,20,1,1,1,1,1,1,1,1,1,1,1,1,1,1,0,0,0,0,0,0,0,0,0,0,0,0,0,0,0,0,0,0,0,0,0,0,0,0,0,0,0,0,0,0,0,0,0,0,0,0,0,0,0,0,0,0,0,0,0,0,0,0,0
13/6/2011,Jorge Baptista,8874150,788,4/2/1977,34,0,0,0,0,1250,5000,5000,102,100,314906,186,87,GK ,12,12,14,7,11,12,13,14,12,12,14,1,2,1,2,1,5,2,2,2,2,1,1,2,3,11,8,11,6,9,1,8,14,1,10,1,11,1,8,8,13,13,12,5,14,7,20,5,13,10,5,10,7,10,10,11,12,13,15,15,14,5,1,1,1,1,1,1,1,GK ,0,20,1,1,1,1,1,1,1,1,1,1,1,1,1,1,0,0,0,0,0,0,0,0,0,0,0,0,0,0,0,0,0,0,0,0,0,0,0,0,0,0,0,0,0,0,0,0,0,0,0,0,0,0,0,0,0,0,0,0,0,0,0,0,0
13/6/2011,Jordi Masip,67038645,796,1/3/1989,22,0,0,0,0,1500,4750,4750,110,97,1218801,180,80,GK ,13,13,13,8,13,12,13,13,6,11,10,6,2,3,2,2,8,1,1,1,1,1,2,2,2,9,10,14,10,7,1,10,9,2,3,1,13,1,3,6,11,10,8,9,12,9,20,2,6,10,9,10,5,10,12,9,7,9,6,7,8,9,1,1,1,1,1,1,1,GK ,0,20,1,1,1,1,1,1,1,1,1,1,1,1,1,1,0,0,0,0,0,0,0,0,0,0,0,0,0,0,0,0,0,0,0,0,0,0,0,0,0,0,0,0,0,0,0,0,0,0,0,0,0,0,0,0,0,0,0,0,0,0,0,0,0
13/6/2011,Jordi Codina,7443104,796,4/27/1982,29,0,0,0,0,4450,6450,6450,140,130,1629526,188,81,GK ,16,14,13,6,13,13,14,14,11,8,11,4,2,3,1,6,9,8,1,2,1,10,1,3,8,11,11,13,8,12,2,12,14,4,10,3,12,13,13,12,12,13,15,6,15,12,20,13,13,13,7,11,10,10,9,11,13,12,13,12,13,8,1,1,1,1,1,1,1,GK ,0,20,1,1,1,1,1,1,1,1,1,1,1,1,1,1,0,0,0,0,0,0,0,0,0,0,0,0,0,0,0,0,0,0,0,0,0,0,0,0,0,0,0,0,0,0,0,0,0,0,0,0,0,0,0,0,0,0,0,0,0,0,0,0,0
13/6/2011,Jordane Anceaux,85094502,769,6/7/1991,20,0,0,0,0,900,1850,1850,104,75,110279,188,89,GK ,6,7,8,7,14,7,11,12,13,12,11,1,1,2,1,7,4,2,3,1,1,3,2,1,7,13,11,13,8,11,3,12,8,2,3,1,10,3,4,5,13,13,13,1,9,8,20,3,6,10,8,10,11,1,10,18,13,5,6,18,13,20,1,1,1,1,1,1,1,GK ,0,20,1,1,1,1,1,1,1,1,1,1,1,1,1,1,0,0,0,0,0,0,0,0,0,0,0,0,0,0,0,0,0,0,0,0,0,0,0,0,0,0,0,0,0,0,0,0,0,0,0,0,0,0,0,0,0,0,0,0,0,0,0,0,0
13/6/2011,Jordan Fernand,85042901,769,6/16/1989,21,0,0,0,0,1100,2200,2200,110,88,44224,180,76,GK ,13,11,9,8,12,6,11,11,9,3,12,6,3,3,1,6,9,5,2,1,3,5,11,1,6,8,11,12,9,12,4,11,14,1,7,3,9,6,12,12,11,13,10,1,13,14,20,10,13,13,6,10,17,1,8,13,16,14,15,14,14,5,1,1,1,1,1,1,1,GK ,0,20,1,1,1,1,1,1,1,1,1,1,1,1,1,1,0,0,0,0,0,0,0,0,0,0,0,0,0,0,0,0,0,0,0,0,0,0,0,0,0,0,0,0,0,0,0,0,0,0,0,0,0,0,0,0,0,0,0,0,0,0,0,0,0
13/6/2011,Jonathan Milliéras,85085866,769,5/19/1993,18,0,0,0,0,1050,2150,2150,111,86,1297177,190,85,GK ,12,8,11,12,9,13,13,13,6,13,8,2,2,2,1,5,4,1,2,1,2,6,1,2,5,14,6,13,8,10,4,11,8,5,7,3,8,1,2,9,13,14,14,1,14,7,20,4,13,9,11,4,7,1,11,14,5,9,6,13,5,14,1,1,1,1,1,1,1,GK ,0,20,1,1,1,1,1,1,1,1,1,1,1,1,1,1,0,0,0,0,0,0,0,0,0,0,0,0,0,0,0,0,0,0,0,0,0,0,0,0,0,0,0,0,0,0,0,0,0,0,0,0,0,0,0,0,0,0,0,0,0,0,0,0,0
13/6/2011,Jonathan Ligali,29046742,769,5/28/1991,20,0,0,0,0,1050,3650,3650,124,86,2286163,183,82,GK ,14,9,9,5,11,8,11,11,11,8,6,3,3,1,2,7,8,3,2,1,3,6,3,1,7,6,12,12,13,13,7,11,14,5,7,3,10,11,9,10,9,14,11,1,15,8,20,12,14,14,13,15,5,1,10,15,14,14,14,14,14,6,1,1,1,1,1,1,1,GK ,0,20,1,1,1,1,1,1,1,1,1,1,1,1,1,1,0,0,0,0,0,0,0,0,0,0,0,0,0,0,0,0,0,0,0,0,0,0,0,0,0,0,0,0,0,0,0,0,0,0,0,0,0,0,0,0,0,0,0,0,0,0,0,0,0
13/6/2011,Jonathan Bond,28049772,801,5/19/1993,18,0,0,1,0,1500,3824,3000,117,85,3081971,196,77,GK ,10,9,12,7,10,9,10,12,10,9,8,5,3,2,3,1,7,1,3,3,2,2,3,3,3,6,8,14,7,12,1,12,12,2,1,3,11,2,7,10,12,12,17,10,12,9,20,3,9,9,9,8,11,9,7,14,11,9,10,9,11,6,1,1,1,1,1,1,1,GK ,0,20,1,1,1,1,1,1,1,1,1,1,1,1,1,1,0,0,0,0,0,0,0,0,0,0,0,0,0,0,0,0,0,0,0,0,0,0,0,0,0,0,0,0,0,0,0,0,0,0,0,0,0,0,0,0,0,0,0,0,0,0,0,0,0
13/6/2011,Jonas Mendes,55041557,23,11/20/1989,21,0,0,0,0,500,3599,2500,91,80,178038,191,80,GK ,11,13,10,6,8,10,12,14,6,5,12,4,1,2,1,4,6,1,3,1,3,3,3,1,6,7,11,9,9,9,1,8,7,3,2,2,13,2,3,13,12,14,15,9,9,10,20,4,7,10,12,10,13,10,7,14,9,6,14,18,11,7,1,1,1,1,1,1,1,GK ,0,20,1,1,1,1,1,1,1,1,1,1,1,1,1,1,0,0,0,0,0,0,0,0,0,0,0,0,0,0,0,0,0,0,0,0,0,0,0,0,0,0,0,0,0,0,0,0,0,0,0,0,0,0,0,0,0,0,0,0,0,0,0,0,0
13/6/2011,Johny Placide,8442435,769,1/29/1988,23,0,0,7,0,3500,5250,5250,145,117,1081005,181,84,GK ,13,12,12,7,13,8,12,16,14,15,11,4,3,3,2,7,7,2,3,2,3,8,3,2,7,9,13,13,12,10,6,10,15,7,11,2,10,12,9,14,15,14,10,1,15,12,20,14,14,13,9,15,6,1,14,15,15,12,10,14,14,7,1,1,1,1,1,1,1,GK ,0,20,1,1,1,1,1,1,1,1,1,1,1,1,1,1,0,0,0,0,0,0,0,0,0,0,0,0,0,0,0,0,0,0,0,0,0,0,0,0,0,0,0,0,0,0,0,0,0,0,0,0,0,0,0,0,0,0,0,0,0,0,0,0,0
13/6/2011,John Ruddy,5123017,765,10/24/1986,24,0,0,0,0,2900,6200,6200,135,124,9116818,194,97,GK ,14,15,15,11,14,13,12,16,15,11,11,7,3,1,2,5,10,2,1,3,2,6,2,3,9,6,10,14,10,9,4,10,16,3,2,6,11,12,6,7,13,12,16,12,12,9,20,13,15,11,4,8,5,10,1,15,8,12,12,12,13,5,1,1,1,1,1,1,1,GK ,0,20,1,1,1,1,1,1,1,1,1,1,1,1,1,1,0,0,0,0,0,0,0,0,0,0,0,0,0,0,0,0,0,0,0,0,0,0,0,0,0,0,0,0,0,0,0,0,0,0,0,0,0,0,0,0,0,0,0,0,0,0,0,0,0
13/6/2011,Johannes Höcker,8707848,771,1/10/1985,26,0,0,0,0,1750,2750,2750,110,75,30508,182,75,GK ,13,10,9,14,13,8,13,10,11,6,8,1,3,1,1,4,4,1,2,1,1,1,3,1,3,11,9,13,6,9,2,10,8,2,8,1,13,2,2,9,11,10,10,3,12,8,20,4,3,10,13,5,10,10,6,5,15,12,12,13,16,5,1,1,1,1,1,1,1,GK ,0,20,1,1,1,1,1,1,1,1,1,1,1,1,1,1,0,0,0,0,0,0,0,0,0,0,0,0,0,0,0,0,0,0,0,0,0,0,0,0,0,0,0,0,0,0,0,0,0,0,0,0,0,0,0,0,0,0,0,0,0,0,0,0,0
13/6/2011,Johannes Focher,35011181,771,1/20/1990,21,0,0,0,0,2000,4500,4500,108,90,731766,199,94,GK ,11,9,11,8,11,14,12,13,10,12,11,3,1,1,1,5,7,6,2,3,2,6,1,1,6,9,10,11,12,9,3,13,9,2,7,1,10,3,6,4,10,11,18,5,13,8,20,11,15,10,9,10,8,10,6,11,13,12,15,5,9,5,1,1,1,1,1,1,1,GK ,0,20,1,1,1,1,1,1,1,1,1,1,1,1,1,1,0,0,0,0,0,0,0,0,0,0,0,0,0,0,0,0,0,0,0,0,0,0,0,0,0,0,0,0,0,0,0,0,0,0,0,0,0,0,0,0,0,0,0,0,0,0,0,0,0
13/6/2011,Johan Liébus,912637,769,11/5/1978,32,0,0,0,0,3350,5100,5100,125,114,385447,185,84,GK ,8,12,12,5,14,11,15,13,12,10,7,2,2,1,2,7,6,2,3,3,1,7,3,3,7,6,12,13,13,13,7,10,16,6,13,3,12,13,8,11,14,14,12,1,8,9,20,12,14,13,6,14,15,1,7,13,11,11,16,14,14,5,1,1,1,1,1,1,1,GK ,0,20,1,1,1,1,1,1,1,1,1,1,1,1,1,1,0,0,0,0,0,0,0,0,0,0,0,0,0,0,0,0,0,0,0,0,0,0,0,0,0,0,0,0,0,0,0,0,0,0,0,0,0,0,0,0,0,0,0,0,0,0,0,0,0
13/6/2011,Johan Hartock,8437660,769,2/17/1987,24,0,0,0,0,1250,4499,2500,120,100,580404,189,83,GK ,14,11,12,9,11,6,13,13,11,9,8,4,3,3,1,6,6,2,1,1,3,6,1,3,6,8,12,13,11,11,6,9,12,5,8,3,9,10,8,13,14,15,14,1,13,11,20,12,15,11,8,14,10,1,10,12,14,13,12,15,15,6,1,1,1,1,1,1,1,GK ,0,20,1,1,1,1,1,1,1,1,1,1,1,1,1,1,0,0,0,0,0,0,0,0,0,0,0,0,0,0,0,0,0,0,0,0,0,0,0,0,0,0,0,0,0,0,0,0,0,0,0,0,0,0,0,0,0,0,0,0,0,0,0,0,0
13/6/2011,Joel Robles,67037306,796,6/17/1990,20,0,0,0,0,3750,5800,5800,145,116,7174887,195,85,GK ,15,13,13,6,15,11,12,12,8,10,13,13,2,2,1,8,17,3,1,1,1,1,3,1,3,5,7,11,6,12,8,11,10,3,10,1,12,8,7,9,12,16,15,5,10,7,20,10,14,14,15,12,5,10,13,9,12,11,11,15,10,6,1,1,1,1,1,1,1,GK ,0,20,1,1,1,1,1,1,1,1,1,1,1,1,1,1,0,0,0,0,0,0,0,0,0,0,0,0,0,0,0,0,0,0,0,0,0,0,0,0,0,0,0,0,0,0,0,0,0,0,0,0,0,0,0,0,0,0,0,0,0,0,0,0,0
13/6/2011,Joe Murphy,4000858,789,8/21/1981,29,2,0,14,0,3100,5750,5500,121,115,2163943,188,80,GK ,12,12,10,11,14,13,11,15,9,10,10,1,1,3,3,7,5,2,1,1,2,11,2,1,12,12,9,16,9,10,3,14,9,3,11,2,10,10,6,8,13,10,13,20,13,7,5,11,11,14,7,14,3,10,14,12,9,13,12,9,14,14,1,1,1,1,1,1,1,GK ,0,20,1,1,1,1,1,1,1,1,1,1,1,1,1,1,0,0,0,0,0,0,0,0,0,0,0,0,0,0,0,0,0,0,0,0,0,0,0,0,0,0,0,0,0,0,0,0,0,0,0,0,0,0,0,0,0,0,0,0,0,0,0,0,0
13/6/2011,Joe Lewis,5119950,765,10/6/1987,23,0,0,5,0,4250,6250,5750,150,115,2609568,199,85,GK ,14,12,11,6,13,11,14,17,10,10,10,4,3,2,3,3,6,1,3,1,3,3,3,2,7,6,8,11,11,8,6,10,14,4,8,4,10,12,12,9,13,13,18,10,13,11,20,11,12,12,4,12,1,10,1,15,11,12,13,14,10,3,1,1,1,1,1,1,1,GK ,0,20,1,1,1,1,1,1,1,1,1,1,1,1,1,1,0,0,0,0,0,0,0,0,0,0,0,0,0,0,0,0,0,0,0,0,0,0,0,0,0,0,0,0,0,0,0,0,0,0,0,0,0,0,0,0,0,0,0,0,0,0,0,0,0
13/6/2011,Joe Hart,5119142,765,4/19/1987,24,11,0,21,0,6250,8000,7900,172,155,114999996,191,81,GK ,16,15,15,14,15,14,17,19,15,18,14,7,2,1,1,10,10,7,2,3,2,8,13,1,7,10,10,13,9,13,3,13,16,4,8,2,12,12,11,10,16,12,16,10,13,7,20,15,12,14,4,13,7,10,7,14,12,18,12,7,15,5,1,1,1,1,1,1,1,GK ,0,20,1,1,1,1,1,1,1,1,1,1,1,1,1,1,65536,0,0,0,0,0,0,0,0,0,0,0,0,0,0,0,0,1,0,0,0,0,0,0,0,0,0,0,0,0,0,0,0,0,0,0,0,0,0,0,0,0,0,0,0,0,0,0,0
13/6/2011,Joe Day,29021885,765,8/13/1990,20,0,0,0,0,50,1750,1750,106,58,350000,191,75,GK ,9,8,11,5,9,9,10,10,14,12,8,5,3,3,2,3,10,3,1,1,1,6,1,2,4,6,8,12,9,10,1,9,17,2,14,1,10,1,12,5,10,9,12,20,12,7,5,7,11,18,6,10,13,10,4,4,11,12,18,17,17,1,1,1,1,1,1,1,1,GK ,0,20,1,1,1,1,1,1,1,1,1,1,1,1,1,1,0,0,0,0,0,0,0,0,0,0,0,0,0,0,0,0,0,0,0,0,0,0,0,0,0,0,0,0,0,0,0,0,0,0,0,0,0,0,0,0,0,0,0,0,0,0,0,0,0
13/6/2011,Jesús Cabrero,824262,796,7/28/1981,29,0,0,0,0,3600,5100,5100,105,102,352543,186,89,GK ,12,12,14,10,13,9,14,13,10,15,12,5,1,2,3,7,7,1,1,2,1,1,2,3,4,15,10,10,8,10,1,10,6,1,13,3,14,3,2,12,11,14,14,5,11,11,20,7,7,10,6,10,7,10,14,9,16,9,10,11,13,12,1,1,1,1,1,1,1,GK ,0,20,1,1,1,1,1,1,1,1,1,1,1,1,1,1,0,0,0,0,0,0,0,0,0,0,0,0,0,0,0,0,0,0,0,0,0,0,0,0,0,0,0,0,0,0,0,0,0,0,0,0,0,0,0,0,0,0,0,0,0,0,0,0,0
13/6/2011,Jessy Moulin,919617,769,1/13/1986,25,0,0,0,0,1350,3250,3250,135,110,1090765,184,80,GK ,14,12,14,9,12,13,11,15,11,10,8,5,3,2,3,7,7,1,3,3,2,6,3,3,7,11,9,13,13,13,6,11,10,6,12,1,10,11,11,7,9,14,12,1,14,8,20,10,14,15,11,15,5,10,14,12,11,5,13,15,15,16,1,1,1,1,1,1,1,GK ,0,20,1,1,1,1,1,1,1,1,1,1,1,1,1,1,0,0,0,0,0,0,0,0,0,0,0,0,0,0,0,0,0,0,0,0,0,0,0,0,0,0,0,0,0,0,0,0,0,0,0,0,0,0,0,0,0,0,0,0,0,0,0,0,0
13/6/2011,Jérémy Sopalski,911523,769,2/6/1981,30,0,0,0,0,1150,3650,3650,120,112,389496,187,81,GK ,15,12,12,7,13,9,13,13,9,12,7,5,1,2,1,7,10,3,2,2,2,6,1,1,7,8,12,13,13,13,6,12,15,5,11,3,11,6,11,11,10,14,13,1,15,9,20,10,14,16,8,14,11,1,7,12,13,13,15,14,14,6,1,1,1,1,1,1,1,GK ,0,20,1,1,1,1,1,1,1,1,1,1,1,1,1,1,0,0,0,0,0,0,0,0,0,0,0,0,0,0,0,0,0,0,0,0,0,0,0,0,0,0,0,0,0,0,0,0,0,0,0,0,0,0,0,0,0,0,0,0,0,0,0,0,0
13/6/2011,Jérémy Aymes,34001035,769,7/12/1988,22,0,0,0,0,450,2250,2250,115,90,23324,189,85,GK ,14,11,11,6,10,8,12,11,9,13,11,5,3,1,1,6,7,2,1,1,1,7,2,1,6,9,11,11,9,8,2,14,6,5,8,2,11,1,2,12,9,14,14,1,8,10,20,6,14,13,14,10,5,1,13,11,6,14,13,13,10,14,1,1,1,1,1,1,1,GK ,0,20,1,1,1,1,1,1,1,1,1,1,1,1,1,1,0,0,0,0,0,0,0,0,0,0,0,0,0,0,0,0,0,0,0,0,0,0,0,0,0,0,0,0,0,0,0,0,0,0,0,0,0,0,0,0,0,0,0,0,0,0,0,0,0
13/6/2011,Jérémie Janot,3502744,769,10/11/1977,33,0,0,0,0,4850,6100,6100,144,136,1468868,176,75,GK ,11,13,14,10,13,7,16,16,15,17,13,6,3,1,3,8,10,2,3,1,3,8,1,1,8,9,13,16,13,13,8,12,14,8,15,2,11,13,11,14,17,12,8,20,13,13,1,13,12,14,9,15,7,1,4,14,19,12,17,17,14,10,1,1,1,1,1,1,1,GK ,0,20,1,1,1,1,1,1,1,1,1,1,1,1,1,1,0,0,0,0,0,0,0,0,0,0,0,0,0,0,0,0,0,0,0,0,0,0,0,0,0,0,0,0,0,0,0,0,0,0,0,0,0,0,0,0,0,0,0,0,0,0,0,0,0
13/6/2011,Jens Grahl,35012145,771,9/22/1988,22,0,0,0,0,1500,4800,4800,130,96,506353,193,93,GK ,10,10,9,6,12,10,13,14,11,11,12,5,2,1,3,7,9,5,3,3,3,7,2,2,7,7,9,12,8,9,7,9,10,2,8,3,9,9,8,12,14,9,16,15,12,10,20,9,9,10,5,10,6,10,11,13,13,14,17,7,4,15,1,1,1,1,1,1,1,GK ,0,20,1,1,1,1,1,1,1,1,1,1,1,1,1,1,0,0,0,0,0,0,0,0,0,0,0,0,0,0,0,0,0,0,0,0,0,0,0,0,0,0,0,0,0,0,0,0,0,0,0,0,0,0,0,0,0,0,0,0,0,0,0,0,0
13/6/2011,Jed Steer,28025341,765,9/23/1992,18,0,0,2,0,1150,2250,2500,131,77,1911760,191,85,GK ,10,9,12,1,11,9,11,12,2,4,10,5,3,2,2,4,10,1,2,3,2,3,2,2,4,1,10,12,8,9,10,9,14,1,4,8,11,10,10,1,11,11,10,9,13,1,20,9,9,9,1,7,2,8,8,16,13,7,12,11,15,2,1,1,1,1,1,1,1,GK ,0,20,1,1,1,1,1,1,1,1,1,1,1,1,1,1,0,0,0,0,0,0,0,0,0,0,0,0,0,0,0,0,0,0,0,0,0,0,0,0,0,0,0,0,0,0,0,0,0,0,0,0,0,0,0,0,0,0,0,0,0,0,0,0,0
13/6/2011,Jean-Louis Leca,8431708,769,9/21/1985,25,0,0,0,0,4100,5150,5150,125,115,2386708,180,75,GK ,10,13,13,9,12,9,12,14,15,14,7,1,3,1,3,7,5,3,1,3,1,7,3,1,7,8,12,14,13,12,7,12,14,5,12,1,13,13,13,13,14,13,10,1,14,11,20,12,12,12,8,14,6,1,9,13,14,13,16,14,14,5,1,1,1,1,1,1,1,GK ,0,20,1,1,1,1,1,1,1,1,1,1,1,1,1,1,0,0,0,0,0,0,0,0,0,0,0,0,0,0,0,0,0,0,0,0,0,0,0,0,0,0,0,0,0,0,0,0,0,0,0,0,0,0,0,0,0,0,0,0,0,0,0,0,0
13/6/2011,Jean-François Gillet,201496,757,5/31/1979,32,6,0,37,0,5000,6750,7000,150,140,11559874,181,81,GK ,12,13,13,8,14,12,15,18,12,12,10,5,3,5,7,8,13,3,12,1,13,12,3,6,8,4,12,13,11,13,5,13,15,8,17,10,14,14,13,10,17,10,12,20,14,10,5,10,11,9,10,10,8,16,15,16,20,12,18,18,12,1,1,1,1,1,1,1,1,GK ,0,20,1,1,1,1,1,1,1,1,1,1,1,1,1,1,0,0,0,0,0,0,0,0,0,0,0,0,0,0,0,0,0,0,0,0,0,0,0,0,0,0,0,0,0,0,0,0,0,0,0,0,0,0,0,0,0,0,0,0,0,0,0,0,0
13/6/2011,Jean-Daniel Padovani,3500301,769,1/17/1980,31,0,0,0,0,2500,3850,3850,125,117,1366083,182,78,GK ,9,14,13,8,12,7,14,15,12,16,6,8,1,2,2,5,10,3,3,2,3,7,1,1,5,11,13,14,12,11,9,10,14,6,13,3,11,11,8,12,13,14,11,16,16,10,20,14,14,13,11,12,5,1,10,12,15,11,13,14,14,10,1,1,1,1,1,1,1,GK ,0,20,1,1,1,1,1,1,1,1,1,1,1,1,1,1,0,0,0,0,0,0,0,0,0,0,0,0,0,0,0,0,0,0,0,0,0,0,0,0,0,0,0,0,0,0,0,0,0,0,0,0,0,0,0,0,0,0,0,0,0,0,0,0,0
13/6/2011,Javi Varas,1503045,796,9/10/1982,28,0,0,0,0,4600,6650,6650,146,136,19999999,182,73,GK ,15,14,15,6,14,16,13,15,15,8,14,6,3,3,3,6,9,3,2,1,3,3,1,1,9,14,12,13,15,14,4,14,13,1,6,1,15,2,9,12,14,12,12,3,12,15,20,14,12,14,6,10,8,10,12,12,16,11,14,15,14,6,1,1,1,1,1,1,1,GK ,0,20,1,1,1,1,1,1,1,1,1,1,1,1,1,1,0,0,0,0,0,0,0,0,0,0,0,0,0,0,0,0,0,0,0,0,0,0,0,0,0,0,0,0,0,0,0,0,0,0,0,0,0,0,0,0,0,0,0,0,0,0,0,0,0
13/6/2011,Javi Jiménez,67038540,796,6/8/1987,24,0,0,0,0,3400,5550,5550,125,110,950534,183,77,GK ,10,12,14,7,10,13,13,14,7,6,14,3,3,2,3,3,7,2,1,3,1,3,3,1,2,6,11,14,11,14,6,14,10,2,10,2,14,12,13,5,12,11,13,5,11,6,20,8,12,10,11,10,11,10,7,14,6,14,6,6,8,2,1,1,1,1,1,1,1,GK ,0,20,1,1,1,1,1,1,1,1,1,1,1,1,1,1,0,0,0,0,0,0,0,0,0,0,0,0,0,0,0,0,0,0,0,0,0,0,0,0,0,0,0,0,0,0,0,0,0,0,0,0,0,0,0,0,0,0,0,0,0,0,0,0,0
13/6/2011,Javi González,67149017,796,3/31/1992,19,0,0,0,0,1000,2500,2500,103,60,230478,182,85,GK ,4,10,11,7,11,9,11,13,8,6,10,7,3,3,1,5,10,2,1,1,3,1,3,2,3,11,6,10,4,9,2,11,8,2,12,2,9,2,2,5,6,4,8,8,8,4,20,1,3,9,15,10,10,7,9,16,6,13,12,7,5,14,1,1,1,1,1,1,1,GK ,0,20,1,1,1,1,1,1,1,1,1,1,1,1,1,1,0,0,0,0,0,0,0,0,0,0,0,0,0,0,0,0,0,0,0,0,0,0,0,0,0,0,0,0,0,0,0,0,0,0,0,0,0,0,0,0,0,0,0,0,0,0,0,0,0
13/6/2011,Jaume Doménech,67102156,796,11/5/1990,20,0,0,0,0,750,2250,2250,71,46,59891,186,90,GK ,11,8,8,8,7,7,9,10,8,13,5,1,2,3,3,1,5,1,3,3,2,1,1,2,2,11,5,8,4,10,1,8,8,3,4,2,10,1,1,2,16,12,12,7,10,2,20,2,3,9,3,2,7,10,13,4,11,13,7,9,9,20,1,1,1,1,1,1,1,GK ,0,20,1,1,1,1,1,1,1,1,1,1,1,1,1,1,0,0,0,0,0,0,0,0,0,0,0,0,0,0,0,0,0,0,0,0,0,0,0,0,0,0,0,0,0,0,0,0,0,0,0,0,0,0,0,0,0,0,0,0,0,0,0,0,0
13/6/2011,Jason Steele,5108155,765,8/18/1990,20,0,0,1,0,3750,6000,6000,146,113,7177566,194,79,GK ,16,13,10,3,13,16,12,14,10,6,12,8,3,2,3,6,10,2,3,3,1,10,3,3,6,1,10,10,12,10,6,10,14,1,2,1,11,7,5,10,12,10,16,10,10,12,20,13,11,9,2,10,2,10,5,13,15,13,17,15,19,3,1,1,1,1,1,1,1,GK ,0,20,1,1,1,1,1,1,1,1,1,1,1,1,1,1,0,0,0,0,0,0,0,0,0,0,0,0,0,0,0,0,0,0,0,0,0,0,0,0,0,0,0,0,0,0,0,0,0,0,0,0,0,0,0,0,0,0,0,0,0,0,0,0,0
13/6/2011,Jasmin Fejzic,8721524,759,5/15/1986,25,0,0,0,0,1100,5000,5000,110,98,203239,197,98,GK ,12,12,12,9,10,17,10,11,8,12,9,3,2,3,2,1,5,1,2,1,3,1,17,2,4,13,6,12,8,9,1,12,8,3,12,3,11,1,2,12,13,12,15,12,7,9,20,5,6,10,5,10,20,10,12,4,15,10,9,6,9,14,1,1,1,1,1,1,1,GK ,0,20,1,1,1,1,1,1,1,1,1,1,1,1,1,1,0,0,0,0,0,0,0,0,0,0,0,0,0,0,0,0,0,0,0,0,0,0,0,0,0,0,0,0,0,0,0,0,0,0,0,0,0,0,0,0,0,0,0,0,0,0,0,0,0
13/6/2011,Jaroslav Drobný,133067,763,10/18/1979,31,4,0,16,0,5900,6299,6750,147,140,51939762,192,90,GK ,17,18,16,3,14,16,10,12,12,11,13,3,3,2,2,7,7,10,2,3,3,5,2,2,6,10,10,17,13,16,5,10,15,3,14,2,11,16,8,8,6,17,17,6,12,7,20,12,18,14,6,11,12,10,17,15,10,18,18,15,18,10,1,1,1,1,1,1,1,GK ,0,20,1,1,1,1,1,1,1,1,1,1,1,1,1,1,0,0,0,0,0,0,0,0,0,0,0,0,0,0,0,0,0,0,0,0,0,0,0,0,0,0,0,0,0,0,0,0,0,0,0,0,0,0,0,0,0,0,0,0,0,0,0,0,0
13/6/2011,Jan Oblak,64016316,795,1/7/1993,18,0,0,7,0,2500,5400,4750,141,108,1819876,185,77,GK ,15,10,11,7,14,15,15,12,8,13,14,2,3,1,3,4,4,4,1,1,1,2,1,2,7,10,8,14,10,10,2,7,9,1,1,1,8,4,4,15,16,15,13,11,15,14,20,6,5,10,11,7,11,9,11,10,7,13,10,12,12,9,1,1,1,1,1,1,1,GK ,0,20,1,1,1,1,1,1,1,1,1,1,1,1,1,1,0,0,0,0,0,0,0,0,0,0,0,0,0,0,0,0,0,0,0,0,0,0,0,0,0,0,0,0,0,0,0,0,0,0,0,0,0,0,0,0,0,0,0,0,0,0,0,0,0
13/6/2011,Jan Mucha,143744,794,12/5/1982,28,28,0,0,0,5250,7250,6500,150,135,6880119,189,87,GK ,12,12,14,7,13,13,16,14,13,14,12,6,1,2,3,10,10,3,2,1,3,2,1,3,8,5,13,12,14,13,7,14,18,8,13,2,14,13,14,10,12,12,14,8,16,8,20,10,12,19,3,17,2,10,18,15,10,17,15,15,12,7,1,1,1,1,1,1,1,GK ,0,20,1,1,1,1,1,1,1,1,1,1,1,1,1,1,0,0,0,0,0,0,0,0,0,0,0,0,0,0,0,0,0,0,0,0,0,0,0,0,0,0,0,0,0,0,0,0,0,0,0,0,0,0,0,0,0,0,0,0,0,0,0,0,0
13/6/2011,Jamie Ashdown,5512093,765,11/30/1980,30,0,0,0,0,3500,5750,5750,120,115,1150000,191,93,GK ,13,11,11,8,14,9,13,14,9,4,11,5,6,5,6,12,7,12,5,5,8,11,9,7,6,12,12,15,12,12,8,12,15,2,12,1,13,10,12,10,10,12,16,20,14,12,5,14,12,13,4,11,12,6,10,13,10,10,14,10,13,11,1,1,1,1,1,1,1,GK ,0,20,1,1,1,1,1,1,1,1,1,1,1,1,1,1,0,0,0,0,0,0,0,0,0,0,0,0,0,0,0,0,0,0,0,0,0,0,0,0,0,0,0,0,0,0,0,0,0,0,0,0,0,0,0,0,0,0,0,0,0,0,0,0,0
13/6/2011,Jaime,6704092,796,12/10/1980,30,0,0,0,0,3650,5650,5650,125,120,3204709,188,80,GK ,12,12,12,11,12,5,13,15,10,15,12,3,2,2,2,7,7,3,3,3,2,1,2,2,2,9,12,11,12,10,9,11,10,13,12,3,12,12,9,10,18,10,14,20,10,11,11,12,11,13,10,14,5,10,12,12,9,12,14,12,12,4,1,1,1,1,1,1,1,GK ,0,20,1,1,1,1,1,1,1,1,1,1,1,1,1,1,0,0,0,0,0,0,0,0,0,0,0,0,0,0,0,0,0,0,0,0,0,0,0,0,0,0,0,0,0,0,0,0,0,0,0,0,0,0,0,0,0,0,0,0,0,0,0,0,0
13/6/2011,Jack Butland,28044979,765,3/10/1993,18,0,0,0,0,1500,4150,4150,164,83,2300000,194,75,GK ,11,9,10,7,10,9,11,12,8,7,8,4,1,1,1,4,7,3,3,3,3,7,2,2,9,8,9,12,12,9,8,9,9,5,7,10,8,10,10,13,12,10,12,4,13,12,20,12,9,10,5,8,5,9,14,12,9,11,9,9,14,10,1,1,1,1,1,1,1,GK ,0,20,1,1,1,1,1,1,1,1,1,1,1,1,1,1,0,0,0,0,0,0,0,0,0,0,0,0,0,0,0,0,0,0,0,0,0,0,0,0,0,0,0,0,0,0,0,0,0,0,0,0,0,0,0,0,0,0,0,0,0,0,0,0,0
13/6/2011,Ivan Pelizzoli,3801694,776,11/18/1980,30,2,0,17,0,5000,5500,5500,108,106,1000000,197,89,GK ,12,9,10,7,12,10,13,13,9,14,11,2,2,1,3,9,6,14,1,1,3,9,3,1,9,11,13,13,10,7,10,12,12,5,10,1,15,12,9,9,13,13,19,5,12,10,20,16,10,8,5,12,8,10,8,14,14,7,13,14,14,15,1,1,1,1,1,1,1,GK ,0,20,1,1,1,1,1,1,1,1,1,1,1,1,1,1,4294967296,0,0,0,0,0,0,0,0,0,0,0,0,0,0,0,0,0,0,0,0,0,0,0,0,0,0,0,0,0,0,0,0,1,0,0,0,0,0,0,0,0,0,0,0,0,0,0,0
13/6/2011,Iván Gómez,812683,796,2/2/1980,31,0,0,0,0,500,3500,3500,100,72,3121,187,81,GK ,11,9,9,11,9,10,11,10,12,12,7,3,2,2,1,3,5,1,2,1,3,2,1,3,3,7,12,10,8,11,1,13,6,2,5,2,14,1,2,8,13,14,10,9,8,4,20,4,4,10,7,10,8,10,6,6,13,16,9,16,11,7,1,1,1,1,1,1,1,GK ,0,20,1,1,1,1,1,1,1,1,1,1,1,1,1,1,0,0,0,0,0,0,0,0,0,0,0,0,0,0,0,0,0,0,0,0,0,0,0,0,0,0,0,0,0,0,0,0,0,0,0,0,0,0,0,0,0,0,0,0,0,0,0,0,0
13/6/2011,Iván Cuéllar,7451366,796,5/25/1984,27,0,0,1,0,4450,6450,6450,140,129,4742184,185,75,GK ,16,12,12,12,14,15,13,15,11,10,14,5,1,1,3,11,10,8,2,1,3,10,1,2,8,11,10,11,8,12,10,11,10,12,8,7,14,12,13,14,13,14,12,20,12,13,5,11,10,13,10,13,14,10,7,6,15,11,7,9,8,16,1,1,1,1,1,1,1,GK ,0,20,1,1,1,1,1,1,1,1,1,1,1,1,1,1,0,0,0,0,0,0,0,0,0,0,0,0,0,0,0,0,0,0,0,0,0,0,0,0,0,0,0,0,0,0,0,0,0,0,0,0,0,0,0,0,0,0,0,0,0,0,0,0,0
13/6/2011,Ismael,67011169,796,1/23/1989,22,0,0,0,0,1300,2800,2800,80,61,123558,182,76,GK ,9,8,7,4,10,10,13,11,7,16,6,3,1,1,3,2,6,2,3,1,1,2,3,2,5,10,4,8,4,9,5,9,10,13,5,10,11,6,10,10,11,10,13,4,4,11,20,5,7,13,5,14,5,10,7,9,8,11,12,7,7,10,1,1,1,1,1,1,1,GK ,0,20,1,1,1,1,1,1,1,1,1,1,1,1,1,1,0,0,0,0,0,0,0,0,0,0,0,0,0,0,0,0,0,0,0,0,0,0,0,0,0,0,0,0,0,0,0,0,0,0,0,0,0,0,0,0,0,0,0,0,0,0,0,0,0
13/6/2011,Ismael Falcón,1501515,796,4/24/1984,27,0,0,0,0,4150,6150,6150,136,126,5410488,181,78,GK ,12,13,12,4,12,12,16,16,12,9,10,5,2,3,3,7,10,3,3,2,2,10,3,1,8,10,13,11,11,13,5,13,14,1,13,1,12,12,8,8,14,14,10,7,14,8,20,10,14,14,2,14,5,10,5,10,13,11,12,14,15,5,1,1,1,1,1,1,1,GK ,0,20,1,1,1,1,1,1,1,1,1,1,1,1,1,1,0,0,0,0,0,0,0,0,0,0,0,0,0,0,0,0,0,0,0,0,0,0,0,0,0,0,0,0,0,0,0,0,0,0,0,0,0,0,0,0,0,0,0,0,0,0,0,0,0
13/6/2011,Iñaki Goitia,7443227,796,3/2/1982,29,0,0,0,0,4350,6350,6350,147,127,3071560,188,81,GK ,8,11,13,10,15,12,15,13,10,9,14,1,1,1,1,3,1,1,1,1,1,1,1,1,8,11,13,12,12,12,3,13,11,2,16,1,14,2,8,12,13,13,15,2,12,12,20,13,13,10,6,10,8,1,7,12,14,10,14,12,12,7,1,1,1,1,1,1,1,GK ,0,20,1,1,1,1,1,1,1,1,1,1,1,1,1,1,0,0,0,0,0,0,0,0,0,0,0,0,0,0,0,0,0,0,0,0,0,0,0,0,0,0,0,0,0,0,0,0,0,0,0,0,0,0,0,0,0,0,0,0,0,0,0,0,0
13/6/2011,Iker Casillas,6700151,796,5/20/1981,30,111,0,5,0,8750,9000,9000,185,180,-1,185,84,GK ,12,14,15,5,16,11,17,20,16,13,17,8,3,3,1,7,10,6,2,2,3,11,1,2,9,6,15,13,18,17,8,15,19,3,16,2,15,16,12,15,19,13,12,20,15,13,8,13,14,16,5,17,7,10,14,19,19,10,20,19,18,3,1,1,1,1,1,1,1,GK ,0,20,1,1,1,1,1,1,1,1,1,1,1,1,1,1,0,0,0,0,0,0,0,0,0,0,0,0,0,0,0,0,0,0,0,0,0,0,0,0,0,0,0,0,0,0,0,0,0,0,0,0,0,0,0,0,0,0,0,0,0,0,0,0,0
13/6/2011,Ignacio Zabal,1512304,796,2/14/1987,24,0,0,0,0,3250,5750,5750,135,110,2918142,194,89,GK ,14,14,14,9,11,10,12,13,12,11,10,4,2,1,1,2,6,3,2,1,3,2,3,3,2,14,10,9,10,14,10,13,10,6,7,10,9,15,15,10,13,10,17,5,13,8,20,14,13,12,6,12,7,10,14,10,13,10,15,15,6,6,1,1,1,1,1,1,1,GK ,0,20,1,1,1,1,1,1,1,1,1,1,1,1,1,1,0,0,0,0,0,0,0,0,0,0,0,0,0,0,0,0,0,0,0,0,0,0,0,0,0,0,0,0,0,0,0,0,0,0,0,0,0,0,0,0,0,0,0,0,0,0,0,0,0
13/6/2011,Ibrahima Koné,12013946,24,12/5/1989,21,0,0,0,0,2100,4229,4200,131,94,194824,190,83,GK ,13,9,9,7,11,10,12,14,9,9,8,5,2,3,2,7,10,2,1,1,2,6,2,3,7,8,12,14,10,10,6,9,14,6,7,2,8,2,9,12,12,16,15,1,15,9,20,14,14,10,5,10,8,1,8,12,13,11,14,15,15,6,1,1,1,1,1,1,1,GK ,0,20,1,1,1,1,1,1,1,1,1,1,1,1,1,1,0,0,0,0,0,0,0,0,0,0,0,0,0,0,0,0,0,0,0,0,0,0,0,0,0,0,0,0,0,0,0,0,0,0,0,0,0,0,0,0,0,0,0,0,0,0,0,0,0
13/6/2011,Ian Mackay,67000281,796,7/14/1986,24,0,0,0,0,3200,5000,5000,120,100,767474,181,80,GK ,9,14,12,13,14,12,10,12,8,7,6,4,2,2,3,3,8,3,2,3,2,1,2,2,5,11,8,13,10,9,1,14,8,3,13,2,14,2,3,7,13,12,8,5,16,7,20,8,6,10,5,5,13,10,9,9,14,9,16,14,7,1,1,1,1,1,1,1,1,GK ,0,20,1,1,1,1,1,1,1,1,1,1,1,1,1,1,0,0,0,0,0,0,0,0,0,0,0,0,0,0,0,0,0,0,0,0,0,0,0,0,0,0,0,0,0,0,0,0,0,0,0,0,0,0,0,0,0,0,0,0,0,0,0,0,0
13/6/2011,Hugo Ventura,55004190,788,1/14/1988,23,0,0,14,0,1500,5000,5000,130,109,27444,185,79,GK ,13,12,13,5,13,11,12,13,13,10,13,1,2,3,3,5,6,1,2,1,1,3,3,2,6,7,11,14,11,9,2,14,14,2,12,1,11,2,9,10,13,14,12,8,6,8,20,6,4,10,3,10,4,10,12,11,15,13,14,14,15,5,1,1,1,1,1,1,1,GK ,0,20,1,1,1,1,1,1,1,1,1,1,1,1,1,1,0,0,0,0,0,0,0,0,0,0,0,0,0,0,0,0,0,0,0,0,0,0,0,0,0,0,0,0,0,0,0,0,0,0,0,0,0,0,0,0,0,0,0,0,0,0,0,0,0
13/6/2011,Hugo Lloris,8428653,769,12/26/1986,24,23,0,9,0,7750,7650,7650,185,170,58461489,188,78,GK ,16,15,12,7,17,12,14,18,16,12,12,5,1,1,2,8,10,1,10,2,2,8,3,8,8,10,14,17,15,15,11,14,15,6,12,3,15,14,12,14,16,15,14,20,15,13,8,15,13,17,10,15,6,1,9,15,15,18,17,18,18,4,1,1,1,1,1,1,1,GK ,0,20,1,1,1,1,1,1,1,1,1,1,1,1,1,1,0,0,0,0,0,0,0,0,0,0,0,0,0,0,0,0,0,0,0,0,0,0,0,0,0,0,0,0,0,0,0,0,0,0,0,0,0,0,0,0,0,0,0,0,0,0,0,0,0
13/6/2011,Hilário,900068,788,10/21/1975,35,1,0,0,0,5250,6000,6000,130,125,2805432,189,88,GK ,10,12,12,5,13,8,10,15,12,10,12,5,1,2,3,8,9,2,3,2,3,5,3,13,10,14,13,12,15,13,13,13,17,3,14,2,14,9,16,10,16,15,15,5,8,10,20,17,8,17,10,14,4,10,13,16,16,16,20,19,17,1,1,1,1,1,1,1,1,GK ,0,20,1,1,1,1,1,1,1,1,1,1,1,1,1,1,0,0,0,0,0,0,0,0,0,0,0,0,0,0,0,0,0,0,0,0,0,0,0,0,0,0,0,0,0,0,0,0,0,0,0,0,0,0,0,0,0,0,0,0,0,0,0,0,0
13/6/2011,Henning Bortel,92021719,771,4/16/1992,19,0,0,0,0,750,3000,3000,116,69,42514,188,73,GK ,10,11,9,7,12,8,9,11,12,11,8,3,3,2,3,2,7,2,1,2,1,2,2,2,6,10,8,7,9,10,2,14,8,1,11,2,10,3,4,8,10,8,12,4,7,9,20,9,11,7,14,6,11,7,7,7,8,9,11,10,10,6,1,1,1,1,1,1,1,GK ,0,20,1,1,1,1,1,1,1,1,1,1,1,1,1,1,0,0,0,0,0,0,0,0,0,0,0,0,0,0,0,0,0,0,0,0,0,0,0,0,0,0,0,0,0,0,0,0,0,0,0,0,0,0,0,0,0,0,0,0,0,0,0,0,0
13/6/2011,Hélton,3300221,1651,5/18/1978,33,3,0,0,0,4000,7000,7300,150,146,21691705,186,74,GK ,14,14,15,15,12,16,11,16,12,9,16,8,1,3,1,12,10,1,1,2,3,12,3,3,9,10,13,15,9,13,1,13,13,3,17,1,13,1,9,12,16,15,16,8,17,11,20,14,16,15,6,10,6,10,12,12,14,8,16,17,15,4,1,1,1,1,1,1,1,GK ,0,20,1,1,1,1,1,1,1,1,1,1,1,1,1,1,2199023255552,0,0,0,0,0,0,0,0,0,0,0,0,0,0,0,0,0,0,0,0,0,0,0,0,0,0,0,0,0,0,0,0,0,0,0,0,0,0,0,0,0,1,0,0,0,0,0,0
13/6/2011,Heinz Müller,3601043,771,5/30/1978,33,0,0,0,0,4250,6500,6500,140,140,1744188,193,88,GK ,13,14,13,15,16,8,14,17,10,13,11,5,1,3,2,6,8,3,2,1,2,6,1,3,4,13,13,12,10,15,8,12,11,12,9,11,14,15,5,13,13,13,16,5,12,14,20,10,14,12,8,8,3,10,12,13,8,12,9,10,17,17,1,1,1,1,1,1,1,GK ,0,20,1,1,1,1,1,1,1,1,1,1,1,1,1,1,0,0,0,0,0,0,0,0,0,0,0,0,0,0,0,0,0,0,0,0,0,0,0,0,0,0,0,0,0,0,0,0,0,0,0,0,0,0,0,0,0,0,0,0,0,0,0,0,0
13/6/2011,Hans-Jörg Butt,3600703,771,5/28/1974,37,4,0,0,0,6550,7000,7000,155,145,1837583,191,91,GK ,14,14,14,5,15,14,14,15,12,15,13,5,3,3,2,9,8,9,1,1,2,10,19,3,9,10,17,13,14,20,12,13,16,10,12,3,14,12,12,7,8,11,14,8,16,7,20,16,12,17,2,18,2,1,6,14,16,15,18,17,15,6,1,1,1,1,1,1,1,GK ,0,20,1,1,1,1,1,1,1,1,1,1,1,1,1,1,0,0,0,0,0,0,0,0,0,0,0,0,0,0,0,0,0,0,0,0,0,0,0,0,0,0,0,0,0,0,0,0,0,0,0,0,0,0,0,0,0,0,0,0,0,0,0,0,0
13/6/2011,Hamdi Kasraoui,8627189,51,1/18/1983,28,35,0,0,0,4750,6490,5300,130,118,1347310,182,87,GK ,13,13,13,10,11,8,14,14,12,14,11,5,3,5,1,7,10,3,2,3,3,8,1,7,7,8,13,15,12,12,8,11,16,2,15,1,11,13,9,10,13,15,11,20,14,8,1,13,15,13,8,14,7,1,7,14,15,14,15,15,15,7,1,1,1,1,1,1,1,GK ,0,20,1,1,1,1,1,1,1,1,1,1,1,1,1,1,0,0,0,0,0,0,0,0,0,0,0,0,0,0,0,0,0,0,0,0,0,0,0,0,0,0,0,0,0,0,0,0,0,0,0,0,0,0,0,0,0,0,0,0,0,0,0,0,0
13/6/2011,Guy Roland Ndy Assembe,8439286,11,2/28/1986,25,4,0,0,0,5250,6500,5850,148,130,4113796,184,79,GK ,12,11,13,7,13,10,14,16,11,11,10,5,2,1,2,7,10,1,1,1,3,7,2,3,7,7,15,14,12,12,8,12,14,6,12,1,13,12,9,13,16,14,12,1,15,11,20,13,14,15,7,15,5,1,7,15,14,14,15,17,17,6,5,1,1,1,1,1,5,GK ,0,20,1,1,1,1,1,5,1,1,1,1,1,1,1,1,0,0,0,0,0,0,0,0,0,0,0,0,0,0,0,0,0,0,0,0,0,0,0,0,0,0,0,0,0,0,0,0,0,0,0,0,0,0,0,0,0,0,0,0,0,0,0,0,0
13/6/2011,Gustavo Munúa,115027,1657,1/27/1978,33,25,0,0,0,5000,6500,6500,142,132,8599901,189,86,GK ,12,11,12,6,13,15,14,15,13,10,14,9,3,1,1,10,13,1,1,1,3,12,14,12,8,11,11,14,13,10,10,12,14,2,12,1,13,12,12,9,14,13,14,8,13,12,20,12,13,9,16,12,6,10,12,13,15,12,11,6,2,16,1,1,1,1,1,1,1,GK ,0,20,1,1,1,1,1,1,1,1,1,1,1,1,1,1,0,0,0,0,0,0,0,0,0,0,0,0,0,0,0,0,0,0,0,0,0,0,0,0,0,0,0,0,0,0,0,0,0,0,0,0,0,0,0,0,0,0,0,0,0,0,0,0,0
13/6/2011,Guillermo Ochoa,5666492,379,7/13/1985,25,45,0,0,0,5250,7500,6550,154,142,7772709,185,78,GK ,15,10,12,10,15,9,12,14,10,5,14,5,5,4,4,14,7,10,4,3,3,11,10,13,12,7,15,14,17,15,10,14,16,7,9,5,16,14,15,9,16,14,11,5,12,9,20,12,14,13,5,14,12,1,13,16,10,15,17,18,14,9,1,1,1,1,1,1,1,GK ,0,20,1,1,1,1,1,1,1,1,1,1,1,1,1,1,0,0,0,0,0,0,0,0,0,0,0,0,0,0,0,0,0,0,0,0,0,0,0,0,0,0,0,0,0,0,0,0,0,0,0,0,0,0,0,0,0,0,0,0,0,0,0,0,0
13/6/2011,Guilherme,2103803,1651,1/22/1985,26,0,0,0,0,500,4600,3750,102,88,22629,189,82,GK ,13,9,12,4,11,13,12,13,7,8,11,3,1,2,3,3,8,1,3,2,1,1,2,2,6,7,9,11,6,13,1,13,9,2,10,2,9,2,3,7,15,12,15,5,15,8,20,8,5,10,10,10,5,10,8,20,13,12,3,8,9,11,1,1,1,1,1,1,1,GK ,0,20,1,1,1,1,1,1,1,1,1,1,1,1,1,1,0,0,0,0,0,0,0,0,0,0,0,0,0,0,0,0,0,0,0,0,0,0,0,0,0,0,0,0,0,0,0,0,0,0,0,0,0,0,0,0,0,0,0,0,0,0,0,0,0
13/6/2011,Gorka Iraizoz,824204,796,3/6/1981,30,0,0,0,0,5000,7250,7250,152,147,15168516,191,93,GK ,15,16,14,10,14,13,14,16,10,9,12,3,1,2,3,6,8,2,3,1,2,3,3,3,9,11,13,14,10,14,4,12,15,1,13,3,15,12,5,8,13,11,15,5,14,9,20,15,17,12,4,14,7,10,13,15,16,17,18,16,14,7,1,1,1,1,1,1,1,GK ,0,20,1,1,1,1,1,1,1,1,1,1,1,1,1,1,0,0,0,0,0,0,0,0,0,0,0,0,0,0,0,0,0,0,0,0,0,0,0,0,0,0,0,0,0,0,0,0,0,0,0,0,0,0,0,0,0,0,0,0,0,0,0,0,0
13/6/2011,Gomes,310870,1651,2/15/1981,30,6,0,15,0,6400,7250,7250,163,152,39382544,190,87,GK ,17,13,11,18,13,6,17,20,15,17,18,6,3,2,1,12,10,3,1,2,3,2,1,3,11,2,14,12,14,13,12,9,15,3,11,10,16,14,13,11,17,15,16,5,14,11,20,15,15,11,3,14,7,10,14,13,14,15,16,12,16,12,1,1,1,1,1,1,1,GK ,0,20,1,1,1,1,1,1,1,1,1,1,1,1,1,1,2199023255552,0,0,0,0,0,0,0,0,0,0,0,0,0,0,0,0,0,0,0,0,0,0,0,0,0,0,0,0,0,0,0,0,0,0,0,0,0,0,0,0,0,1,0,0,0,0,0,0
13/6/2011,Giorgio Frezzolini,7921,776,1/21/1976,35,0,0,0,0,2000,5000,5000,111,100,754461,186,80,GK ,11,12,12,8,12,11,11,14,8,11,12,4,1,2,3,7,6,5,1,3,3,9,1,2,10,12,10,8,10,13,5,11,16,4,11,3,12,8,10,7,12,11,14,5,12,8,20,8,12,14,5,14,5,10,12,10,12,10,15,13,14,10,1,1,1,1,1,1,1,GK ,0,20,1,1,1,1,1,1,1,1,1,1,1,1,1,1,0,0,0,0,0,0,0,0,0,0,0,0,0,0,0,0,0,0,0,0,0,0,0,0,0,0,0,0,0,0,0,0,0,0,0,0,0,0,0,0,0,0,0,0,0,0,0,0,0
13/6/2011,Giorgi Makaridze,29024419,770,3/31/1990,21,5,0,0,0,3900,5450,4900,140,109,932092,190,80,GK ,14,13,10,8,12,7,13,14,10,16,8,6,1,2,3,6,8,1,2,3,2,8,3,3,6,8,12,14,8,10,9,9,13,7,9,2,12,12,9,14,13,16,15,1,13,12,20,14,14,12,8,16,8,1,11,14,13,16,14,15,15,6,1,1,1,1,1,1,1,GK ,0,20,1,1,1,1,1,1,1,1,1,1,1,1,1,1,0,0,0,0,0,0,0,0,0,0,0,0,0,0,0,0,0,0,0,0,0,0,0,0,0,0,0,0,0,0,0,0,0,0,0,0,0,0,0,0,0,0,0,0,0,0,0,0,0
13/6/2011,Gianluigi Buffon,11133,776,1/28/1978,33,105,0,11,0,7900,8200,8200,194,159,22262277,190,80,GK ,17,15,16,16,17,12,18,16,17,10,12,1,1,1,1,9,1,1,1,1,1,7,10,1,4,6,14,12,16,13,8,15,17,2,15,1,17,9,14,13,14,9,14,6,12,9,20,10,10,16,7,18,18,1,20,14,20,17,16,15,20,4,1,1,1,1,1,1,1,GK ,0,20,1,1,1,1,1,1,1,1,1,1,1,1,1,1,565166156546048,0,0,0,0,0,0,0,0,0,0,0,0,0,0,0,0,0,0,0,0,0,0,0,0,0,0,0,0,0,0,0,0,0,0,1,0,0,0,0,0,0,1,0,0,0,0,0,0
13/6/2011,Gianluca Pegolo,3802076,776,3/25/1981,30,0,0,3,0,2500,5750,5750,121,119,2083696,183,76,GK ,11,11,15,9,12,11,11,14,14,14,12,6,1,2,1,3,10,1,2,2,1,10,1,2,1,11,13,10,13,10,11,11,15,8,12,3,13,14,11,13,15,12,12,20,10,12,5,12,12,13,10,18,14,10,13,15,15,15,20,15,13,10,1,1,1,1,1,1,1,GK ,0,20,1,1,1,1,1,1,1,1,1,1,1,1,1,1,0,0,0,0,0,0,0,0,0,0,0,0,0,0,0,0,0,0,0,0,0,0,0,0,0,0,0,0,0,0,0,0,0,0,0,0,0,0,0,0,0,0,0,0,0,0,0,0,0
13/6/2011,Gianluca Curci,7982788,776,7/12/1985,25,0,0,21,0,4500,6000,6000,130,120,1194442,191,90,GK ,15,10,8,8,14,11,16,16,12,15,13,1,1,1,1,1,1,2,8,1,1,11,1,9,13,7,13,14,11,9,11,9,12,5,6,1,14,11,13,9,14,13,15,5,14,9,20,12,13,12,1,12,4,1,12,10,15,12,16,15,18,2,1,1,1,1,1,1,1,GK ,0,20,1,1,1,1,1,1,1,1,1,1,1,1,1,1,0,0,0,0,0,0,0,0,0,0,0,0,0,0,0,0,0,0,0,0,0,0,0,0,0,0,0,0,0,0,0,0,0,0,0,0,0,0,0,0,0,0,0,0,0,0,0,0,0
13/6/2011,Giacomo Bindi,7982910,776,1/2/1987,24,0,0,0,0,250,3500,3650,105,80,38274,190,83,GK ,10,10,10,11,12,12,12,14,11,11,9,2,1,3,2,8,7,6,1,1,1,7,2,2,5,8,7,12,7,7,9,8,13,8,4,6,9,6,6,10,12,10,12,5,12,9,20,10,9,8,7,7,7,9,14,8,12,12,13,11,5,5,1,1,1,1,1,1,1,GK ,0,20,1,1,1,1,1,1,1,1,1,1,1,1,1,1,0,0,0,0,0,0,0,0,0,0,0,0,0,0,0,0,0,0,0,0,0,0,0,0,0,0,0,0,0,0,0,0,0,0,0,0,0,0,0,0,0,0,0,0,0,0,0,0,0
13/6/2011,Gerhard Tremmel,6000579,771,11/16/1978,32,0,0,0,0,4050,6000,6000,134,120,6164360,190,89,GK ,10,13,14,4,13,7,14,14,10,12,12,7,1,1,1,8,9,1,3,3,2,4,2,3,4,12,13,12,12,12,5,10,15,8,15,1,13,14,14,12,12,11,14,7,15,11,20,16,15,11,9,14,4,10,9,14,20,12,17,10,10,11,1,1,1,1,1,1,1,GK ,0,20,1,1,1,1,1,1,1,1,1,1,1,1,1,1,0,0,0,0,0,0,0,0,0,0,0,0,0,0,0,0,0,0,0,0,0,0,0,0,0,0,0,0,0,0,0,0,0,0,0,0,0,0,0,0,0,0,0,0,0,0,0,0,0
13/6/2011,Geoffrey Lembet,85050446,13,9/23/1988,22,5,0,0,0,1200,4319,2400,125,96,101280,185,75,GK ,14,10,10,6,10,10,12,13,12,7,7,7,1,1,2,7,10,2,2,1,3,7,3,1,7,12,13,12,9,9,8,11,17,2,9,3,8,12,7,14,13,14,12,20,14,11,5,12,12,13,6,10,7,1,13,13,14,13,18,15,15,5,1,1,1,1,1,1,1,GK ,0,20,1,1,1,1,1,1,1,1,1,1,1,1,1,1,0,0,0,0,0,0,0,0,0,0,0,0,0,0,0,0,0,0,0,0,0,0,0,0,0,0,0,0,0,0,0,0,0,0,0,0,0,0,0,0,0,0,0,0,0,0,0,0,0
13/6/2011,Geoffrey Jourdren,918869,769,2/4/1986,25,0,0,8,0,2050,6050,6050,148,135,6045008,181,73,GK ,12,12,12,9,13,12,14,17,14,13,8,6,2,2,2,9,10,3,1,3,1,7,3,2,9,9,14,15,11,14,7,12,16,7,10,2,13,12,11,15,16,13,10,1,16,12,20,15,12,14,9,16,7,1,14,14,15,17,13,13,13,5,1,1,1,1,1,1,1,GK ,0,20,1,1,1,1,1,1,1,1,1,1,1,1,1,1,0,0,0,0,0,0,0,0,0,0,0,0,0,0,0,0,0,0,0,0,0,0,0,0,0,0,0,0,0,0,0,0,0,0,0,0,0,0,0,0,0,0,0,0,0,0,0,0,0
13/6/2011,Gennaro Bracigliano,6200649,769,3/1/1980,31,0,0,0,0,4700,5850,5850,140,130,3653341,183,82,GK ,12,13,12,11,13,11,14,16,12,15,8,7,2,3,1,8,10,8,8,1,2,8,3,1,8,9,13,16,14,12,8,12,15,6,16,6,11,13,11,12,14,15,11,1,12,11,20,13,14,12,9,15,12,1,5,15,18,13,17,14,12,9,1,1,1,1,1,1,1,GK ,0,20,1,5,1,1,1,1,1,1,1,1,1,1,1,1,0,0,0,0,0,0,0,0,0,0,0,0,0,0,0,0,0,0,0,0,0,0,0,0,0,0,0,0,0,0,0,0,0,0,0,0,0,0,0,0,0,0,0,0,0,0,0,0,0
13/6/2011,Gary Woods,28002952,765,10/1/1990,20,0,0,0,0,1500,4400,4400,127,97,2656525,185,77,GK ,12,10,10,4,13,12,11,13,12,4,11,1,1,3,1,8,6,2,2,2,3,10,2,4,5,10,9,8,10,12,5,11,11,1,5,1,10,6,8,12,14,12,13,7,10,12,20,10,10,12,17,10,6,1,10,10,10,10,14,11,15,2,1,1,1,1,1,1,1,GK ,0,20,1,1,1,1,1,1,1,1,1,1,1,1,1,1,0,0,0,0,0,0,0,0,0,0,0,0,0,0,0,0,0,0,0,0,0,0,0,0,0,0,0,0,0,0,0,0,0,0,0,0,0,0,0,0,0,0,0,0,0,0,0,0,0
13/6/2011,Gábor Király,3600731,773,4/1/1976,35,81,0,0,0,5500,7040,6400,140,128,901043,191,91,GK ,14,13,14,13,14,11,15,15,15,11,12,6,3,2,1,9,10,12,1,1,2,6,7,13,6,17,14,13,10,10,3,12,16,15,9,5,10,9,10,11,12,10,16,20,16,10,14,16,13,11,4,13,6,10,17,14,14,16,15,10,5,12,1,1,1,1,1,1,1,GK ,0,20,1,1,1,1,1,1,1,1,1,1,1,1,1,1,0,0,0,0,0,0,0,0,0,0,0,0,0,0,0,0,0,0,0,0,0,0,0,0,0,0,0,0,0,0,0,0,0,0,0,0,0,0,0,0,0,0,0,0,0,0,0,0,0
13/6/2011,Frank Fielding,28000479,765,4/4/1988,23,0,0,12,0,4400,5900,5900,142,118,4023390,186,77,GK ,11,14,11,8,15,10,13,16,15,3,10,4,1,3,1,6,9,3,1,2,1,1,2,1,5,5,11,15,9,10,11,11,14,8,11,3,9,12,15,11,12,7,13,7,12,9,20,12,12,15,3,11,3,10,4,14,13,12,14,16,16,2,1,1,1,1,1,1,1,GK ,0,20,1,1,1,1,1,1,1,1,1,1,1,1,1,1,0,0,0,0,0,0,0,0,0,0,0,0,0,0,0,0,0,0,0,0,0,0,0,0,0,0,0,0,0,0,0,0,0,0,0,0,0,0,0,0,0,0,0,0,0,0,0,0,0
13/6/2011,Francisco Linares,67142522,796,1/9/1991,20,0,0,0,0,1350,3850,3850,131,77,3425,180,70,GK ,12,12,9,8,10,12,12,12,11,7,11,1,2,3,2,4,4,1,1,1,3,1,1,2,1,8,7,11,8,9,1,12,7,1,12,2,9,1,1,10,13,13,8,8,12,11,20,5,4,10,4,9,14,10,9,14,9,12,10,9,13,11,1,1,1,1,1,1,1,GK ,0,20,1,1,1,1,1,1,1,1,1,1,1,1,1,1,0,0,0,0,0,0,0,0,0,0,0,0,0,0,0,0,0,0,0,0,0,0,0,0,0,0,0,0,0,0,0,0,0,0,0,0,0,0,0,0,0,0,0,0,0,0,0,0,0
13/6/2011,Francisco Dorronsoro,1510905,796,5/22/1985,26,0,0,0,0,1700,4200,4200,100,84,32243,180,70,GK ,8,8,9,11,11,11,9,11,8,9,10,3,3,1,2,8,6,5,2,3,3,9,3,3,8,7,9,11,6,10,4,8,10,3,9,2,10,7,8,11,15,9,10,5,11,10,20,12,8,13,6,7,12,10,11,13,11,13,11,12,12,12,1,1,1,1,1,1,1,GK ,0,20,1,1,1,1,1,1,1,1,1,1,1,1,1,1,0,0,0,0,0,0,0,0,0,0,0,0,0,0,0,0,0,0,0,0,0,0,0,0,0,0,0,0,0,0,0,0,0,0,0,0,0,0,0,0,0,0,0,0,0,0,0,0,0
13/6/2011,Francesco De Luca,43020661,776,11/21/1989,21,0,0,0,0,1000,3200,3200,80,66,39583,185,80,GK ,11,9,11,9,10,11,12,10,6,13,9,5,1,1,1,2,7,1,2,1,3,1,1,1,2,8,5,9,13,6,2,7,8,2,3,3,7,1,2,11,15,15,9,3,12,8,20,3,6,10,10,8,12,8,8,19,8,12,12,9,10,10,1,1,1,1,1,1,1,GK ,0,20,1,1,1,1,1,1,1,1,1,1,1,1,1,1,0,0,0,0,0,0,0,0,0,0,0,0,0,0,0,0,0,0,0,0,0,0,0,0,0,0,0,0,0,0,0,0,0,0,0,0,0,0,0,0,0,0,0,0,0,0,0,0,0
13/6/2011,Francesco Cattenari,43026556,776,1/17/1990,21,0,0,0,0,50,3000,3000,80,60,24416,189,79,GK ,9,8,8,2,10,8,9,10,6,7,11,2,3,1,1,3,4,2,2,3,2,2,1,2,3,8,8,6,10,10,3,7,9,2,5,4,10,10,10,9,10,7,11,10,10,9,20,13,12,10,2,8,2,9,5,10,8,7,10,10,8,2,1,1,1,1,1,1,1,GK ,0,20,1,1,1,1,1,1,1,1,1,1,1,1,1,1,0,0,0,0,0,0,0,0,0,0,0,0,0,0,0,0,0,0,0,0,0,0,0,0,0,0,0,0,0,0,0,0,0,0,0,0,0,0,0,0,0,0,0,0,0,0,0,0,0
13/6/2011,Francesco Benussi,3804748,776,10/15/1981,29,0,0,0,0,5000,5750,5750,120,116,2720560,188,80,GK ,14,12,11,6,11,8,11,16,14,14,8,1,1,3,5,9,1,1,1,1,1,11,3,1,11,12,12,14,10,15,9,14,10,3,8,1,9,10,12,10,14,13,14,5,12,12,20,13,13,9,1,10,10,1,12,15,13,14,13,13,15,1,1,1,1,1,1,1,1,GK ,0,20,1,1,1,1,1,1,1,1,1,1,1,1,1,1,2199023255552,0,0,0,0,0,0,0,0,0,0,0,0,0,0,0,0,0,0,0,0,0,0,0,0,0,0,0,0,0,0,0,0,0,0,0,0,0,0,0,0,0,1,0,0,0,0,0,0
13/6/2011,Francesco Antonioli,1667,776,9/14/1969,41,0,0,29,0,4250,6500,6800,150,136,267346,188,82,GK ,13,13,8,6,17,13,15,17,16,18,12,5,2,2,1,7,10,2,1,3,3,2,1,3,5,9,12,10,13,13,8,12,11,3,8,1,13,7,12,11,13,12,16,10,12,8,20,17,15,18,7,14,12,10,12,9,15,12,20,15,11,9,1,1,1,1,1,1,1,GK ,0,20,1,1,1,1,1,1,1,1,1,1,1,1,1,1,0,0,0,0,0,0,0,0,0,0,0,0,0,0,0,0,0,0,0,0,0,0,0,0,0,0,0,0,0,0,0,0,0,0,0,0,0,0,0,0,0,0,0,0,0,0,0,0,0
13/6/2011,Fonseca,8878344,788,1/5/1985,26,0,0,0,0,500,3250,3250,95,85,6510,182,80,GK ,8,11,10,14,13,11,8,11,5,12,9,4,1,2,1,2,7,1,2,2,2,2,1,3,7,11,9,12,11,12,1,12,7,1,14,3,13,1,3,9,13,11,7,8,10,6,20,7,8,10,5,10,9,10,7,14,5,11,9,14,14,5,1,1,1,1,1,1,1,GK ,0,20,1,1,1,1,1,1,1,1,1,1,1,1,1,1,0,0,0,0,0,0,0,0,0,0,0,0,0,0,0,0,0,0,0,0,0,0,0,0,0,0,0,0,0,0,0,0,0,0,0,0,0,0,0,0,0,0,0,0,0,0,0,0,0
13/6/2011,Florian Kapp,92023936,771,11/13/1987,23,0,0,0,0,50,3000,3000,84,60,4010,184,0,GK ,12,12,10,8,12,6,10,12,10,10,7,5,2,1,3,5,7,1,3,2,1,1,1,1,2,4,5,11,7,7,1,12,9,3,10,2,12,1,2,5,11,10,12,1,14,7,20,3,3,8,15,10,7,9,11,13,9,5,11,14,14,1,1,1,1,1,1,1,1,GK ,0,20,1,1,1,1,1,1,1,1,1,1,1,1,1,1,0,0,0,0,0,0,0,0,0,0,0,0,0,0,0,0,0,0,0,0,0,0,0,0,0,0,0,0,0,0,0,0,0,0,0,0,0,0,0,0,0,0,0,0,0,0,0,0,0
13/6/2011,Florian Bague,8447598,769,7/27/1984,26,0,0,0,0,3450,5150,5150,125,115,1010155,180,75,GK ,14,13,12,7,14,8,13,14,11,10,8,7,3,1,3,7,10,1,2,1,2,7,3,1,7,7,14,12,13,13,8,13,14,5,12,2,11,12,14,10,11,13,10,1,11,12,20,9,11,15,7,7,9,1,9,12,13,13,14,14,16,6,1,1,1,1,1,1,1,GK ,0,20,1,1,1,1,1,1,1,1,1,1,1,1,1,1,0,0,0,0,0,0,0,0,0,0,0,0,0,0,0,0,0,0,0,0,0,0,0,0,0,0,0,0,0,0,0,0,0,0,0,0,0,0,0,0,0,0,0,0,0,0,0,0,0
13/6/2011,Florent Perraud,911841,769,6/11/1982,29,0,0,0,0,2250,3400,3400,115,104,107990,183,78,GK ,11,11,11,6,12,9,14,14,11,8,8,7,3,3,1,7,10,2,2,3,1,6,1,1,7,8,11,12,13,13,6,11,14,6,9,2,10,12,9,11,11,13,10,1,14,14,20,13,13,14,8,14,7,1,10,11,13,13,15,15,15,6,1,1,1,1,1,1,1,GK ,0,20,1,1,1,1,1,1,1,1,1,1,1,1,1,1,0,0,0,0,0,0,0,0,0,0,0,0,0,0,0,0,0,0,0,0,0,0,0,0,0,0,0,0,0,0,0,0,0,0,0,0,0,0,0,0,0,0,0,0,0,0,0,0,0
13/6/2011,Florent Chaigneau,144181,769,3/21/1984,27,0,0,1,0,2250,4500,4500,120,101,2665815,197,94,GK ,15,11,13,7,10,10,12,12,10,13,8,1,3,1,2,1,3,1,1,3,1,7,1,3,4,9,10,13,11,10,6,9,15,5,10,3,10,11,7,9,11,18,18,1,14,8,20,13,18,13,9,15,7,10,12,13,11,6,10,12,12,9,1,1,1,1,1,1,1,GK ,0,20,1,1,1,1,1,1,1,1,1,1,1,1,1,1,0,0,0,0,0,0,0,0,0,0,0,0,0,0,0,0,0,0,0,0,0,0,0,0,0,0,0,0,0,0,0,0,0,0,0,0,0,0,0,0,0,0,0,0,0,0,0,0,0
13/6/2011,Flavio Roma,6065,776,6/21/1974,36,3,0,0,0,4500,5900,5900,150,118,1744610,191,86,GK ,13,15,15,7,14,15,13,12,10,11,9,1,1,1,1,8,1,4,1,8,1,7,1,1,4,6,12,14,13,13,4,12,14,1,14,4,12,10,13,4,8,14,16,5,10,5,20,12,14,14,6,13,15,1,16,7,17,13,18,15,15,5,1,1,1,1,1,1,1,GK ,0,20,1,1,1,1,1,1,1,1,1,1,1,1,1,1,562949953421312,0,0,0,0,0,0,0,0,0,0,0,0,0,0,0,0,0,0,0,0,0,0,0,0,0,0,0,0,0,0,0,0,0,0,0,0,0,0,0,0,0,0,0,0,0,0,0,0
13/6/2011,Ferreira,55025018,788,10/19/1980,30,0,0,0,0,250,2000,2000,75,67,1213,184,81,GK ,12,9,7,9,12,9,5,12,4,9,8,5,2,3,1,2,8,1,3,1,2,1,3,1,1,9,7,10,5,9,1,12,8,3,6,2,10,1,2,11,11,10,10,9,5,7,20,1,2,10,6,10,5,10,15,13,11,14,14,12,13,4,1,1,1,1,1,1,1,GK ,0,20,1,1,1,1,1,1,1,1,1,1,1,1,1,1,0,0,0,0,0,0,0,0,0,0,0,0,0,0,0,0,0,0,0,0,0,0,0,0,0,0,0,0,0,0,0,0,0,0,0,0,0,0,0,0,0,0,0,0,0,0,0,0,0
13/6/2011,Fernando,67066950,796,6/10/1990,21,0,0,0,0,1500,3500,3500,108,70,39617,185,79,GK ,13,8,8,4,9,12,10,13,14,14,7,1,2,1,2,1,4,1,2,1,1,1,2,3,4,5,10,9,9,11,1,8,4,2,10,1,11,1,1,12,14,13,9,8,17,8,20,4,3,10,12,9,6,9,8,5,13,13,15,8,10,16,1,1,1,1,1,1,1,GK ,0,20,1,1,1,1,1,1,1,1,1,1,1,1,1,1,0,0,0,0,0,0,0,0,0,0,0,0,0,0,0,0,0,0,0,0,0,0,0,0,0,0,0,0,0,0,0,0,0,0,0,0,0,0,0,0,0,0,0,0,0,0,0,0,0
13/6/2011,Fernando Maestro,4210688,796,4/15/1974,37,0,0,0,0,2450,4950,4950,105,99,60243,184,77,GK ,11,12,13,14,12,9,11,13,4,5,9,1,1,1,1,10,1,2,1,2,1,9,4,1,9,12,10,11,13,10,9,8,11,1,15,1,12,10,10,10,11,10,13,5,12,8,20,10,10,17,5,12,8,1,14,11,13,18,17,12,8,16,1,1,1,1,1,1,1,GK ,0,20,1,1,1,1,1,1,1,1,1,1,1,1,1,1,0,0,0,0,0,0,0,0,0,0,0,0,0,0,0,0,0,0,0,0,0,0,0,0,0,0,0,0,0,0,0,0,0,0,0,0,0,0,0,0,0,0,0,0,0,0,0,0,0
13/6/2011,Felipe,67011244,796,1/10/1988,23,0,0,0,0,2750,5000,5000,130,100,57557,187,86,GK ,15,9,7,6,12,8,15,17,11,10,9,6,1,1,3,5,9,3,3,2,1,3,2,1,6,14,10,14,6,7,6,7,10,13,11,10,7,8,9,13,16,6,13,6,13,10,20,9,14,6,5,10,7,10,8,7,8,18,12,12,13,3,1,1,1,1,1,1,1,GK ,0,20,1,1,1,1,1,1,1,1,1,1,1,1,1,1,0,0,0,0,0,0,0,0,0,0,0,0,0,0,0,0,0,0,0,0,0,0,0,0,0,0,0,0,0,0,0,0,0,0,0,0,0,0,0,0,0,0,0,0,0,0,0,0,0
13/6/2011,Federico Marchetti,829683,776,2/7/1983,28,8,0,0,0,5500,6750,7000,144,140,5433498,190,83,GK ,13,13,12,8,14,13,13,14,14,7,12,8,2,2,3,9,10,14,3,3,3,9,3,1,9,11,13,15,13,13,3,12,10,8,14,7,12,13,12,12,15,14,14,6,16,12,20,13,13,13,4,10,7,10,8,18,7,9,5,14,9,8,1,1,1,1,1,1,1,GK ,0,20,1,1,1,1,1,1,1,1,1,1,1,1,1,1,0,0,0,0,0,0,0,0,0,0,0,0,0,0,0,0,0,0,0,0,0,0,0,0,0,0,0,0,0,0,0,0,0,0,0,0,0,0,0,0,0,0,0,0,0,0,0,0,0
13/6/2011,Federico Davià,43066650,776,4/24/1993,18,0,0,0,0,450,2350,2250,104,58,58120,187,89,GK ,13,8,3,4,12,13,11,11,10,10,10,2,3,2,1,6,6,1,1,2,3,1,3,2,1,13,5,7,9,13,2,13,9,3,3,1,6,1,3,5,6,9,12,8,10,5,20,6,5,9,12,4,7,6,14,15,12,7,12,9,11,8,1,1,1,1,1,1,1,GK ,0,20,1,1,1,1,1,1,1,1,1,1,1,1,1,1,0,0,0,0,0,0,0,0,0,0,0,0,0,0,0,0,0,0,0,0,0,0,0,0,0,0,0,0,0,0,0,0,0,0,0,0,0,0,0,0,0,0,0,0,0,0,0,0,0
13/6/2011,Federico Agliardi,3804787,776,2/11/1983,28,0,0,9,0,3050,5400,5400,122,108,3917300,190,80,GK ,12,11,12,3,13,11,11,13,13,8,12,1,1,1,1,3,1,9,1,1,5,1,1,4,9,11,11,10,10,11,1,11,17,2,4,6,13,10,13,8,12,10,14,5,12,6,20,13,11,16,6,11,7,1,16,13,16,13,16,13,11,5,1,1,1,1,1,1,1,GK ,0,20,1,1,1,1,1,1,1,1,1,1,1,1,1,1,0,0,0,0,0,0,0,0,0,0,0,0,0,0,0,0,0,0,0,0,0,0,0,0,0,0,0,0,0,0,0,0,0,0,0,0,0,0,0,0,0,0,0,0,0,0,0,0,0
13/6/2011,Fabricio,67008770,796,12/31/1987,23,0,0,0,0,4250,6400,6400,135,128,9999999,180,67,GK ,15,13,13,8,12,13,14,14,12,12,13,7,3,3,3,5,10,1,3,2,3,3,2,3,9,6,11,11,11,14,6,12,11,13,6,5,12,12,13,12,13,12,12,5,14,12,20,15,12,11,6,13,6,10,10,13,13,14,13,15,11,12,1,1,1,1,1,1,1,GK ,0,20,1,1,1,1,1,1,1,1,1,1,1,1,1,1,0,0,0,0,0,0,0,0,0,0,0,0,0,0,0,0,0,0,0,0,0,0,0,0,0,0,0,0,0,0,0,0,0,0,0,0,0,0,0,0,0,0,0,0,0,0,0,0,0
13/6/2011,Fábio Santos,55041887,788,11/14/1992,18,0,0,0,0,250,1500,1500,101,75,841487,187,80,GK ,4,9,10,9,12,10,12,13,6,6,7,4,3,2,3,1,6,1,2,1,2,1,3,2,6,6,6,9,4,7,1,13,9,3,4,1,13,1,3,10,12,11,12,20,14,9,9,3,5,10,11,8,8,7,11,12,8,13,6,14,7,3,1,1,1,1,1,1,1,GK ,0,20,1,1,1,1,1,1,1,1,1,1,1,1,1,1,0,0,0,0,0,0,0,0,0,0,0,0,0,0,0,0,0,0,0,0,0,0,0,0,0,0,0,0,0,0,0,0,0,0,0,0,0,0,0,0,0,0,0,0,0,0,0,0,0
13/6/2011,Fabio Rigamonti,43091167,776,1/1/1995,16,0,0,0,0,450,2400,2200,54,44,3700,188,82,GK ,9,4,10,12,8,7,8,13,11,12,6,3,3,3,1,2,3,1,3,3,3,1,3,1,1,7,4,11,6,7,2,6,7,2,9,2,7,1,1,4,14,14,9,7,13,5,20,3,4,10,11,10,17,4,10,2,12,5,13,12,6,13,1,1,1,1,1,1,1,GK ,0,20,1,1,1,1,1,1,1,1,1,1,1,1,1,1,0,0,0,0,0,0,0,0,0,0,0,0,0,0,0,0,0,0,0,0,0,0,0,0,0,0,0,0,0,0,0,0,0,0,0,0,0,0,0,0,0,0,0,0,0,0,0,0,0
13/6/2011,Fabien Farnolle,916476,769,2/5/1985,26,0,0,0,0,1400,2300,2300,110,93,17558,196,95,GK ,14,11,11,7,13,9,11,12,8,7,6,3,3,2,1,7,8,2,1,3,1,6,3,1,7,12,13,13,11,11,6,8,13,5,11,3,10,12,6,5,8,18,18,1,14,7,20,12,18,14,11,8,6,1,8,12,15,11,14,14,14,6,1,1,1,1,1,1,1,GK ,0,20,1,1,1,1,1,1,1,1,1,1,1,1,1,1,0,0,0,0,0,0,0,0,0,0,0,0,0,0,0,0,0,0,0,0,0,0,0,0,0,0,0,0,0,0,0,0,0,0,0,0,0,0,0,0,0,0,0,0,0,0,0,0,0
13/6/2011,Fabien Audard,3504506,769,3/28/1978,33,0,0,0,0,2100,6200,6200,145,138,6213571,188,89,GK ,15,13,13,4,15,14,12,14,7,10,8,4,1,2,3,7,7,2,2,3,1,10,3,8,7,9,11,15,13,13,8,12,14,6,13,1,13,12,12,11,12,16,14,20,13,11,7,12,16,15,9,7,11,10,13,13,17,15,14,14,14,6,1,1,1,1,1,1,1,GK ,0,20,1,1,1,1,1,1,1,1,1,1,1,1,1,1,0,0,0,0,0,0,0,0,0,0,0,0,0,0,0,0,0,0,0,0,0,0,0,0,0,0,0,0,0,0,0,0,0,0,0,0,0,0,0,0,0,0,0,0,0,0,0,0,0
13/6/2011,Fabiano,19030218,1651,2/29/1988,23,0,0,0,0,1750,5350,5350,130,107,1199198,197,90,GK ,13,10,10,10,11,12,12,12,13,11,11,7,2,2,3,4,10,10,2,1,1,1,2,1,7,13,12,14,10,11,7,11,12,1,10,5,11,12,12,8,12,15,18,3,16,8,20,14,17,12,10,7,7,10,7,14,15,10,12,8,8,20,1,1,1,1,1,1,1,GK ,0,20,1,1,1,1,1,1,1,1,1,1,1,1,1,1,0,0,0,0,0,0,0,0,0,0,0,0,0,0,0,0,0,0,0,0,0,0,0,0,0,0,0,0,0,0,0,0,0,0,0,0,0,0,0,0,0,0,0,0,0,0,0,0,0
13/6/2011,Fabian Giefer,29022522,771,5/17/1990,21,0,0,0,0,3000,6100,6100,145,122,3544845,196,93,GK ,13,13,10,6,12,14,12,14,12,10,9,7,1,3,1,8,10,6,1,3,2,7,1,1,7,8,12,13,9,12,6,11,12,4,6,1,14,13,12,10,12,16,18,8,12,9,20,13,18,12,3,10,4,10,6,12,14,13,13,14,16,3,1,1,1,1,1,1,1,GK ,0,20,1,1,1,1,1,1,1,1,1,1,1,1,1,1,0,0,0,0,0,0,0,0,0,0,0,0,0,0,0,0,0,0,0,0,0,0,0,0,0,0,0,0,0,0,0,0,0,0,0,0,0,0,0,0,0,0,0,0,0,0,0,0,0
13/6/2011,Enver Marina,35007708,752,1/27/1977,34,0,0,0,0,2500,4004,4450,100,89,38654,185,79,GK ,10,12,14,16,8,10,14,8,13,6,10,3,1,3,1,7,6,1,3,3,2,4,2,3,8,8,9,12,10,7,3,14,9,2,5,2,12,3,4,7,16,14,12,3,12,4,20,9,10,8,14,4,13,8,6,7,15,14,13,5,6,14,1,1,1,1,1,1,1,GK ,0,20,1,1,1,1,1,1,1,1,1,1,1,1,1,1,0,0,0,0,0,0,0,0,0,0,0,0,0,0,0,0,0,0,0,0,0,0,0,0,0,0,0,0,0,0,0,0,0,0,0,0,0,0,0,0,0,0,0,0,0,0,0,0,0
13/6/2011,Enrico Tonozzi,43072030,776,10/1/1993,17,0,0,0,0,50,3149,3000,80,70,6954,189,86,GK ,9,9,6,8,12,10,13,9,8,4,10,3,2,3,2,6,4,1,2,1,2,1,1,2,1,3,5,10,6,11,1,7,8,3,10,1,5,2,3,11,17,13,9,8,12,7,20,3,7,8,10,10,11,10,10,5,11,8,8,8,16,9,1,1,1,1,1,1,1,GK ,0,20,1,1,1,1,1,1,1,1,1,1,1,1,1,1,0,0,0,0,0,0,0,0,0,0,0,0,0,0,0,0,0,0,0,0,0,0,0,0,0,0,0,0,0,0,0,0,0,0,0,0,0,0,0,0,0,0,0,0,0,0,0,0,0
13/6/2011,Eñaut Zubikarai,7450701,796,2/26/1984,27,0,0,0,0,3900,5750,5750,135,119,1948975,184,84,GK ,14,9,12,7,13,14,12,15,9,7,12,5,2,3,2,9,7,7,2,1,1,14,1,1,10,12,9,13,10,13,13,12,10,5,11,5,13,3,6,8,12,10,11,7,9,9,20,6,14,12,3,10,12,10,11,14,14,13,6,13,5,5,1,1,1,1,1,1,1,GK ,0,20,1,1,1,1,1,1,1,1,1,1,1,1,1,1,0,0,0,0,0,0,0,0,0,0,0,0,0,0,0,0,0,0,0,0,0,0,0,0,0,0,0,0,0,0,0,0,0,0,0,0,0,0,0,0,0,0,0,0,0,0,0,0,0
13/6/2011,Emiliano Viviano,7989257,776,12/1/1985,25,6,0,11,0,5500,7550,7550,167,150,5782453,195,88,GK ,17,16,13,10,15,14,15,17,15,8,14,1,1,1,1,12,1,10,13,1,1,11,1,1,10,8,14,15,13,14,8,11,15,8,12,14,12,11,14,7,14,10,15,2,14,13,20,7,7,14,2,16,3,1,15,13,15,12,18,16,12,4,1,1,1,1,1,1,1,GK ,0,20,1,1,1,1,1,1,1,1,1,1,1,1,1,1,0,0,0,0,0,0,0,0,0,0,0,0,0,0,0,0,0,0,0,0,0,0,0,0,0,0,0,0,0,0,0,0,0,0,0,0,0,0,0,0,0,0,0,0,0,0,0,0,0
13/6/2011,Emanuele Belardi,700355,776,10/9/1977,33,0,0,0,0,3000,6000,6000,128,115,1216507,187,80,GK ,13,11,13,12,12,13,12,14,11,8,11,5,2,1,2,10,10,8,3,3,1,10,1,2,8,11,13,14,12,13,9,11,15,8,11,5,12,10,14,10,14,12,15,5,14,9,20,10,11,15,9,9,8,10,13,13,14,17,13,12,12,7,1,1,1,1,1,1,1,GK ,0,20,1,1,1,1,1,1,1,1,1,1,1,1,1,1,0,0,0,0,0,0,0,0,0,0,0,0,0,0,0,0,0,0,0,0,0,0,0,0,0,0,0,0,0,0,0,0,0,0,0,0,0,0,0,0,0,0,0,0,0,0,0,0,0
13/6/2011,Elisson,2111964,1651,3/26/1987,24,0,0,0,0,750,4350,4350,130,109,144819,186,88,GK ,11,12,10,3,11,16,12,12,13,3,18,7,3,3,3,9,10,1,2,2,3,9,3,2,9,9,10,12,10,11,4,10,10,2,11,3,11,9,9,10,12,13,14,8,12,10,20,11,13,10,8,10,12,10,6,10,8,8,6,12,13,14,1,1,1,1,1,1,1,GK ,0,20,1,1,1,1,1,1,1,1,1,1,1,1,1,1,0,0,0,0,0,0,0,0,0,0,0,0,0,0,0,0,0,0,0,0,0,0,0,0,0,0,0,0,0,0,0,0,0,0,0,0,0,0,0,0,0,0,0,0,0,0,0,0,0
13/6/2011,Eduardo,6704882,796,1/28/1979,32,0,0,0,0,3800,5900,5900,125,117,1527324,181,75,GK ,12,9,12,7,12,14,12,14,14,10,10,5,3,1,2,7,7,2,2,3,3,9,6,2,6,6,10,13,12,12,4,10,8,5,12,3,12,11,9,12,17,10,11,5,13,13,20,13,11,15,8,14,7,10,12,2,15,13,10,13,7,10,1,1,1,1,1,1,1,GK ,0,20,1,1,1,1,1,1,1,1,1,1,1,1,1,1,0,0,0,0,0,0,0,0,0,0,0,0,0,0,0,0,0,0,0,0,0,0,0,0,0,0,0,0,0,0,0,0,0,0,0,0,0,0,0,0,0,0,0,0,0,0,0,0,0
13/6/2011,Eduardo Gottardi,8833674,1651,10/18/1985,25,0,0,0,0,2500,4700,5500,127,114,1013978,193,80,GK ,15,13,12,12,13,9,14,16,15,14,9,6,2,3,3,2,10,2,2,2,1,2,1,1,2,12,11,14,14,9,3,14,11,1,12,3,13,1,6,7,12,14,16,9,10,5,20,7,13,12,12,10,12,10,4,11,16,14,15,12,14,10,1,1,1,1,1,1,1,GK ,0,20,1,1,1,1,1,1,1,1,1,1,1,1,1,1,0,0,0,0,0,0,0,0,0,0,0,0,0,0,0,0,0,0,0,0,0,0,0,0,0,0,0,0,0,0,0,0,0,0,0,0,0,0,0,0,0,0,0,0,0,0,0,0,0
13/6/2011,Dudu Aouate,2013467,775,10/17/1977,33,60,0,12,0,6000,7500,7000,148,141,11001316,188,84,GK ,11,10,14,12,15,15,14,15,15,11,15,1,3,7,7,9,7,11,8,7,8,12,5,13,9,14,5,17,7,15,12,8,14,7,16,9,14,4,10,14,16,15,14,5,9,10,20,11,13,14,16,16,8,7,16,16,10,15,13,8,7,15,1,1,1,1,1,1,1,GK ,0,20,1,1,1,1,1,1,1,1,1,1,1,1,1,1,0,0,0,0,0,0,0,0,0,0,0,0,0,0,0,0,0,0,0,0,0,0,0,0,0,0,0,0,0,0,0,0,0,0,0,0,0,0,0,0,0,0,0,0,0,0,0,0,0
13/6/2011,Douglas,55011415,11,2/17/1986,25,0,0,0,0,1500,2500,2500,120,95,53895,190,85,GK ,13,10,10,6,12,11,9,13,14,8,12,6,3,1,2,3,10,1,2,3,1,1,3,3,5,6,8,13,8,9,1,11,16,3,3,3,12,1,9,10,9,10,15,20,10,10,5,7,12,7,5,9,8,10,16,15,16,14,15,16,17,5,1,1,1,1,1,1,1,GK ,0,20,1,1,1,1,1,1,1,1,1,1,1,1,1,1,0,0,0,0,0,0,0,0,0,0,0,0,0,0,0,0,0,0,0,0,0,0,0,0,0,0,0,0,0,0,0,0,0,0,0,0,0,0,0,0,0,0,0,0,0,0,0,0,0
13/6/2011,Douglas Jesus,310765,1651,3/9/1983,28,0,0,0,0,2250,6150,6150,132,123,1587143,188,83,GK ,13,11,12,3,12,12,12,14,14,12,12,5,1,1,2,11,10,11,3,2,3,10,2,1,12,7,12,12,12,11,3,11,10,2,11,1,14,12,12,11,12,14,15,10,16,12,20,13,14,10,7,2,11,10,11,10,13,12,10,9,12,11,1,1,1,1,1,1,1,GK ,0,20,1,1,1,1,1,1,1,1,1,1,1,1,1,1,0,0,0,0,0,0,0,0,0,0,0,0,0,0,0,0,0,0,0,0,0,0,0,0,0,0,0,0,0,0,0,0,0,0,0,0,0,0,0,0,0,0,0,0,0,0,0,0,0
13/6/2011,Dorus de Vries,850121,784,12/29/1980,30,0,0,0,0,3000,5900,5500,130,121,5059625,180,76,GK ,12,15,15,8,14,12,13,15,8,8,15,7,3,1,3,4,10,2,1,2,2,2,3,1,7,9,8,12,12,12,8,12,15,7,8,8,8,6,10,9,11,14,12,1,12,8,20,14,15,15,1,14,4,10,13,17,12,14,15,7,12,12,1,1,1,1,1,1,1,GK ,0,20,1,1,1,1,1,1,1,1,1,1,1,1,1,1,196608,0,0,0,0,0,0,0,0,0,0,0,0,0,0,0,0,1,1,0,0,0,0,0,0,0,0,0,0,0,0,0,0,0,0,0,0,0,0,0,0,0,0,0,0,0,0,0,0
13/6/2011,Donovan Léon,85049252,769,11/3/1992,18,0,0,0,0,1300,2600,2600,135,105,2618778,186,88,GK ,9,9,7,7,12,15,13,14,9,8,10,5,2,1,3,10,10,1,11,1,1,7,3,3,10,7,10,13,11,11,9,10,12,1,6,2,11,9,6,13,15,14,13,1,15,12,20,12,14,14,7,10,7,1,12,15,9,11,10,15,15,6,1,1,1,1,1,1,1,GK ,0,20,1,1,1,1,1,1,1,1,1,1,1,1,1,1,0,0,0,0,0,0,0,0,0,0,0,0,0,0,0,0,0,0,0,0,0,0,0,0,0,0,0,0,0,0,0,0,0,0,0,0,0,0,0,0,0,0,0,0,0,0,0,0,0
13/6/2011,Doni,3300874,1651,10/22/1979,31,10,0,0,0,5500,6500,6500,140,130,9327596,194,91,GK ,13,13,12,15,14,13,14,15,15,10,14,1,1,8,1,5,1,5,6,2,1,9,1,13,7,10,15,15,16,10,10,14,13,8,7,1,13,13,15,11,10,13,15,8,13,9,20,11,14,14,1,12,11,1,14,13,14,14,16,15,18,3,1,1,1,1,1,1,1,GK ,0,20,1,1,1,1,1,1,1,1,1,1,1,1,1,1,0,0,0,0,0,0,0,0,0,0,0,0,0,0,0,0,0,0,0,0,0,0,0,0,0,0,0,0,0,0,0,0,0,0,0,0,0,0,0,0,0,0,0,0,0,0,0,0,0
13/6/2011,Dirk Orlishausen,8728168,771,8/15/1982,28,0,0,0,0,3350,5600,5600,115,112,1700467,197,94,GK ,13,15,12,10,14,9,13,12,13,10,12,5,1,1,1,5,8,4,3,3,3,5,3,2,4,11,10,10,12,14,5,10,8,5,13,5,12,12,11,9,11,13,18,4,13,8,20,11,14,13,6,11,6,10,8,12,12,13,13,12,12,8,1,1,1,1,1,1,1,GK ,0,20,1,1,1,1,1,1,1,1,1,1,1,1,1,1,0,0,0,0,0,0,0,0,0,0,0,0,0,0,0,0,0,0,0,0,0,0,0,0,0,0,0,0,0,0,0,0,0,0,0,0,0,0,0,0,0,0,0,0,0,0,0,0,0
13/6/2011,Diego,3300795,1651,5/11/1979,32,0,0,0,0,3250,6250,5900,120,118,922739,188,84,GK ,13,13,10,3,14,12,13,15,12,14,12,1,1,2,2,6,5,1,3,1,2,2,3,1,11,10,10,13,9,9,1,11,13,2,7,1,12,11,13,11,12,12,17,20,14,9,13,12,12,11,3,12,7,10,13,11,16,12,18,18,18,4,1,1,1,1,1,1,1,GK ,0,20,1,1,1,1,1,1,1,1,1,1,1,1,1,1,0,0,0,0,0,0,0,0,0,0,0,0,0,0,0,0,0,0,0,0,0,0,0,0,0,0,0,0,0,0,0,0,0,0,0,0,0,0,0,0,0,0,0,0,0,0,0,0,0
13/6/2011,Diego Mariño,67066947,796,5/9/1990,21,0,0,2,0,3600,5600,5600,159,112,3507721,185,75,GK ,11,10,9,4,13,11,12,15,10,7,13,7,3,1,1,8,10,6,2,1,1,10,3,1,9,8,11,12,10,12,5,9,10,6,8,2,16,11,11,9,14,10,12,11,13,11,20,12,10,13,6,14,6,10,7,8,16,17,7,10,5,5,1,1,1,1,1,1,1,GK ,0,20,1,1,1,1,1,1,1,1,1,1,1,1,1,1,0,0,0,0,0,0,0,0,0,0,0,0,0,0,0,0,0,0,0,0,0,0,0,0,0,0,0,0,0,0,0,0,0,0,0,0,0,0,0,0,0,0,0,0,0,0,0,0,0
13/6/2011,Diego López,6701938,796,11/3/1981,29,1,0,0,0,5700,7650,7650,157,153,16892789,196,87,GK ,18,13,13,7,15,14,11,17,14,9,14,5,2,3,3,7,10,9,3,1,2,9,1,1,8,6,13,15,12,15,6,13,15,5,10,2,15,10,10,8,13,17,17,11,15,10,20,14,16,16,7,12,7,10,14,17,13,14,15,15,12,10,1,1,1,1,1,1,1,GK ,0,20,1,1,1,1,1,1,1,1,1,1,1,1,1,1,0,0,0,0,0,0,0,0,0,0,0,0,0,0,0,0,0,0,0,0,0,0,0,0,0,0,0,0,0,0,0,0,0,0,0,0,0,0,0,0,0,0,0,0,0,0,0,0,0
13/6/2011,Diego Benaglio,5720118,798,9/8/1983,27,35,0,0,0,6750,7865,7150,157,143,35657459,194,89,GK ,12,15,14,8,14,9,16,16,12,8,10,8,3,2,1,11,10,6,2,2,1,8,1,2,11,6,14,10,15,11,7,12,14,4,13,2,16,17,10,15,17,12,17,8,14,10,20,14,12,14,5,14,5,10,15,16,12,15,17,16,17,3,1,1,1,1,1,1,1,GK ,0,20,1,1,1,1,1,1,1,1,1,1,1,1,1,1,0,0,0,0,0,0,0,0,0,0,0,0,0,0,0,0,0,0,0,0,0,0,0,0,0,0,0,0,0,0,0,0,0,0,0,0,0,0,0,0,0,0,0,0,0,0,0,0,0
13/6/2011,Diego Alves,2100185,1651,6/24/1985,25,0,0,3,0,6250,7000,7500,165,153,21493575,188,83,GK ,15,13,13,5,14,14,14,16,14,10,14,6,1,3,2,7,10,2,3,2,3,11,1,3,12,9,12,13,14,13,1,13,16,13,13,2,14,9,14,14,17,14,15,20,12,13,5,13,10,16,6,13,10,10,6,13,15,8,15,14,13,14,1,1,1,1,1,1,1,GK ,0,20,1,1,1,1,1,1,1,1,1,1,1,1,1,1,0,0,0,0,0,0,0,0,0,0,0,0,0,0,0,0,0,0,0,0,0,0,0,0,0,0,0,0,0,0,0,0,0,0,0,0,0,0,0,0,0,0,0,0,0,0,0,0,0
13/6/2011,Didier Ovono,8525389,19,1/23/1983,28,53,0,0,0,5200,7000,5800,135,129,2770098,186,82,GK ,12,12,13,12,13,14,11,16,12,14,11,4,1,1,2,11,9,1,1,3,2,8,2,1,11,8,13,11,14,11,8,12,16,7,15,3,12,13,9,13,14,13,13,5,14,12,20,13,13,14,8,14,7,1,10,14,12,14,13,15,15,6,1,1,1,1,1,1,1,GK ,0,20,1,1,1,1,1,1,1,1,1,1,1,1,1,1,0,0,0,0,0,0,0,0,0,0,0,0,0,0,0,0,0,0,0,0,0,0,0,0,0,0,0,0,0,0,0,0,0,0,0,0,0,0,0,0,0,0,0,0,0,0,0,0,0
13/6/2011,Dennis Eilhoff,876783,771,7/31/1982,28,0,0,0,0,3500,5750,5750,120,115,606033,190,86,GK ,11,14,13,12,13,13,14,14,13,10,11,6,2,2,3,9,10,1,2,2,1,1,2,2,7,7,11,10,9,10,12,11,11,9,7,12,13,12,13,10,10,11,14,5,12,13,20,11,14,10,9,7,10,10,5,11,15,14,12,13,14,8,1,1,1,1,1,1,1,GK ,0,20,1,1,1,1,1,1,1,1,1,1,1,1,1,1,0,0,0,0,0,0,0,0,0,0,0,0,0,0,0,0,0,0,0,0,0,0,0,0,0,0,0,0,0,0,0,0,0,0,0,0,0,0,0,0,0,0,0,0,0,0,0,0,0
13/6/2011,Denis Petric,8442200,802,5/24/1988,23,0,0,0,0,1400,5600,4050,138,112,589506,186,80,GK ,11,14,11,9,14,12,10,13,9,10,7,6,1,1,1,8,10,3,3,3,2,7,2,3,8,7,12,14,11,13,8,11,14,5,11,2,10,7,8,10,13,14,13,20,10,8,5,14,14,14,7,14,11,1,7,13,14,13,16,14,14,6,1,1,1,1,1,1,1,GK ,0,20,1,1,1,1,1,1,1,1,1,1,1,1,1,1,0,0,0,0,0,0,0,0,0,0,0,0,0,0,0,0,0,0,0,0,0,0,0,0,0,0,0,0,0,0,0,0,0,0,0,0,0,0,0,0,0,0,0,0,0,0,0,0,0
13/6/2011,Dejan Stojanovic,16047341,781,7/19/1993,17,0,0,3,0,250,4500,4500,137,95,7565134,196,89,GK ,14,8,8,10,11,9,12,13,10,7,10,2,1,3,2,6,6,3,2,1,1,3,2,2,4,9,8,11,8,13,2,6,10,3,10,1,14,2,7,12,11,10,16,20,12,12,5,12,12,8,13,10,12,10,6,16,13,13,10,4,9,5,1,1,1,1,1,1,1,GK ,0,20,1,1,1,1,1,1,1,1,1,1,1,1,1,1,0,0,0,0,0,0,0,0,0,0,0,0,0,0,0,0,0,0,0,0,0,0,0,0,0,0,0,0,0,0,0,0,0,0,0,0,0,0,0,0,0,0,0,0,0,0,0,0,0
13/6/2011,Declan Rudd,28011400,765,1/16/1991,20,0,0,1,0,2250,4500,4750,135,95,1744290,191,85,GK ,12,12,11,1,11,13,11,11,2,4,10,3,2,3,3,4,7,1,1,2,2,2,10,1,3,7,10,12,11,10,9,11,15,1,9,1,11,11,6,1,12,12,14,10,13,4,20,11,12,9,1,9,2,10,7,14,14,11,14,12,16,1,1,1,1,1,1,1,1,GK ,0,20,1,1,1,1,1,1,1,1,1,1,1,1,1,1,0,0,0,0,0,0,0,0,0,0,0,0,0,0,0,0,0,0,0,0,0,0,0,0,0,0,0,0,0,0,0,0,0,0,0,0,0,0,0,0,0,0,0,0,0,0,0,0,0
13/6/2011,Davide Petrachi,7990028,776,8/14/1986,24,0,0,0,0,2000,5000,5000,125,100,1218232,184,83,GK ,8,8,8,5,13,8,10,14,7,13,10,6,3,2,2,4,10,3,3,1,1,2,1,2,3,8,9,11,13,12,2,13,13,3,7,2,13,10,13,12,14,14,13,10,12,12,20,9,9,10,10,11,13,10,11,13,16,14,15,14,14,4,1,1,1,1,1,1,1,GK ,0,20,1,1,1,1,1,1,1,1,1,1,1,1,1,1,0,0,0,0,0,0,0,0,0,0,0,0,0,0,0,0,0,0,0,0,0,0,0,0,0,0,0,0,0,0,0,0,0,0,0,0,0,0,0,0,0,0,0,0,0,0,0,0,0
13/6/2011,David Yelldell,895934,390,10/1/1981,29,1,0,0,0,2500,5950,5950,122,119,631229,194,88,GK ,11,12,15,11,13,10,13,15,14,6,14,7,1,2,3,3,10,6,3,2,2,4,2,1,3,9,14,15,10,11,3,13,15,3,12,2,12,10,5,7,11,14,16,5,14,7,20,9,14,10,8,12,9,10,13,14,14,10,9,14,12,12,1,1,1,1,1,1,1,GK ,0,20,1,1,1,1,1,1,1,1,1,1,1,1,1,1,0,0,0,0,0,0,0,0,0,0,0,0,0,0,0,0,0,0,0,0,0,0,0,0,0,0,0,0,0,0,0,0,0,0,0,0,0,0,0,0,0,0,0,0,0,0,0,0,0
13/6/2011,David Valle,6705537,796,5/27/1978,33,0,0,0,0,2250,5250,5250,113,106,174629,190,77,GK ,9,11,12,15,9,11,12,13,11,6,8,7,3,2,3,9,9,1,2,3,3,11,1,1,8,9,9,13,9,14,9,12,9,3,12,3,13,11,12,9,13,10,14,20,12,11,7,8,12,13,5,12,2,10,10,9,18,6,6,8,13,16,1,1,1,1,1,1,1,GK ,0,20,1,1,1,1,1,1,1,1,1,1,1,1,1,1,0,0,0,0,0,0,0,0,0,0,0,0,0,0,0,0,0,0,0,0,0,0,0,0,0,0,0,0,0,0,0,0,0,0,0,0,0,0,0,0,0,0,0,0,0,0,0,0,0
13/6/2011,David Stockdale,5113004,765,9/20/1985,25,0,0,0,0,3850,6800,6400,142,128,3685707,194,84,GK ,15,12,13,9,13,16,12,15,15,14,13,8,3,3,2,8,10,8,2,1,2,9,1,2,9,7,13,12,14,11,6,10,9,5,9,8,11,12,15,11,12,9,14,9,13,15,20,13,11,12,3,10,7,10,6,13,10,13,11,11,9,12,1,1,1,1,1,1,1,GK ,0,20,1,1,1,1,1,1,1,1,1,1,1,1,1,1,0,0,0,0,0,0,0,0,0,0,0,0,0,0,0,0,0,0,0,0,0,0,0,0,0,0,0,0,0,0,0,0,0,0,0,0,0,0,0,0,0,0,0,0,0,0,0,0,0
13/6/2011,David Preece,2005239,765,8/26/1976,34,0,0,0,0,2250,4600,4600,107,96,390934,188,78,GK ,12,8,10,9,13,5,12,13,12,10,12,4,4,4,4,10,4,11,5,14,4,9,10,11,4,16,11,18,12,10,2,11,16,1,16,1,10,3,11,4,12,14,13,6,14,6,20,10,12,12,7,14,8,1,18,16,18,10,13,15,14,10,1,1,1,1,1,1,1,GK ,0,20,1,1,1,1,1,1,1,1,1,1,1,1,1,1,0,0,0,0,0,0,0,0,0,0,0,0,0,0,0,0,0,0,0,0,0,0,0,0,0,0,0,0,0,0,0,0,0,0,0,0,0,0,0,0,0,0,0,0,0,0,0,0,0
13/6/2011,David Ospina,8835677,1653,8/31/1988,22,15,0,12,0,5850,7200,6500,165,144,16677723,183,79,GK ,15,14,14,11,13,14,14,17,12,11,9,7,3,3,3,10,10,2,2,2,1,8,2,2,10,10,13,14,14,14,8,13,14,7,11,3,11,12,9,13,15,14,12,1,15,11,20,13,14,15,10,15,7,1,14,16,12,17,15,15,15,6,1,1,1,1,1,1,1,GK ,0,20,1,5,1,1,1,1,1,1,1,1,1,1,1,1,0,0,0,0,0,0,0,0,0,0,0,0,0,0,0,0,0,0,0,0,0,0,0,0,0,0,0,0,0,0,0,0,0,0,0,0,0,0,0,0,0,0,0,0,0,0,0,0,0
13/6/2011,David Oberhauser,85051277,769,11/29/1990,20,0,0,0,0,450,2000,2000,101,80,47439,184,79,GK ,12,12,7,15,12,12,8,12,10,6,10,8,3,2,1,4,10,2,2,1,3,2,3,2,4,6,8,14,10,14,1,7,9,2,11,3,13,1,4,11,9,9,12,5,16,9,20,4,4,10,13,8,11,10,13,9,16,5,10,10,14,3,1,1,1,1,1,1,1,GK ,0,20,1,1,1,1,1,1,1,1,1,1,1,1,1,1,0,0,0,0,0,0,0,0,0,0,0,0,0,0,0,0,0,0,0,0,0,0,0,0,0,0,0,0,0,0,0,0,0,0,0,0,0,0,0,0,0,0,0,0,0,0,0,0,0
13/6/2011,David Marshall,5204716,793,3/5/1985,26,5,0,10,0,3750,6200,6050,138,120,4026196,191,83,GK ,11,7,8,2,14,10,14,15,8,10,6,6,1,1,1,4,8,1,2,2,1,3,3,3,6,11,13,15,14,14,7,14,16,5,8,3,13,13,9,9,14,12,15,7,13,10,20,16,14,15,9,15,2,10,14,13,17,14,16,12,15,3,1,1,1,1,1,1,1,GK ,0,20,1,1,1,1,1,1,1,1,1,1,1,1,1,1,0,0,0,0,0,0,0,0,0,0,0,0,0,0,0,0,0,0,0,0,0,0,0,0,0,0,0,0,0,0,0,0,0,0,0,0,0,0,0,0,0,0,0,0,0,0,0,0,0
13/6/2011,David Hohs,35016094,771,3/16/1988,23,0,0,0,0,4050,5450,5450,126,109,531686,185,84,GK ,12,9,12,10,12,10,12,13,12,13,12,3,3,3,2,8,7,10,2,3,1,11,3,3,10,12,12,14,9,10,8,11,13,6,7,7,12,13,13,11,11,15,14,8,11,11,20,14,14,15,5,10,7,9,6,17,8,9,14,16,11,19,1,1,1,1,1,1,1,GK ,0,20,1,1,1,1,1,1,1,1,1,1,1,1,1,1,0,0,0,0,0,0,0,0,0,0,0,0,0,0,0,0,0,0,0,0,0,0,0,0,0,0,0,0,0,0,0,0,0,0,0,0,0,0,0,0,0,0,0,0,0,0,0,0,0
13/6/2011,David Forde,550760,789,12/20/1979,31,1,0,0,0,2450,5489,5750,122,122,1468948,189,85,GK ,13,13,15,6,15,13,13,17,10,14,11,2,2,2,2,3,4,2,3,2,2,3,1,3,8,5,10,14,9,8,6,13,15,3,6,8,9,9,11,9,11,12,14,9,10,8,20,12,8,14,3,13,8,10,7,10,13,16,13,14,19,6,1,1,1,1,1,1,1,GK ,0,20,1,1,1,1,1,1,1,1,1,1,1,1,1,1,0,0,0,0,0,0,0,0,0,0,0,0,0,0,0,0,0,0,0,0,0,0,0,0,0,0,0,0,0,0,0,0,0,0,0,0,0,0,0,0,0,0,0,0,0,0,0,0,0
13/6/2011,David De Navas,6701465,796,12/7/1976,34,0,0,0,0,2250,5000,5000,105,105,178786,186,85,GK ,13,11,11,11,13,10,11,12,11,7,8,5,3,1,1,3,10,1,3,2,1,2,1,2,2,14,9,14,10,11,11,12,11,8,14,13,13,1,5,10,12,13,13,6,14,7,20,10,11,13,8,8,11,10,10,16,10,14,10,14,6,8,1,1,1,1,1,1,1,GK ,0,20,1,1,1,1,1,1,1,1,1,1,1,1,1,1,0,0,0,0,0,0,0,0,0,0,0,0,0,0,0,0,0,0,0,0,0,0,0,0,0,0,0,0,0,0,0,0,0,0,0,0,0,0,0,0,0,0,0,0,0,0,0,0,0
13/6/2011,David De Gea,67030171,796,11/7/1990,20,0,0,13,0,6000,7350,7600,180,154,88040623,188,71,GK ,17,16,11,4,16,15,14,16,4,8,12,5,2,2,3,15,10,6,1,3,1,12,1,3,9,7,12,11,9,13,10,14,16,5,10,10,16,11,9,11,17,12,16,5,10,14,20,12,12,12,5,15,5,10,10,14,17,10,13,12,13,7,1,1,1,1,1,1,1,GK ,0,20,1,1,1,1,1,1,1,1,1,1,1,1,1,1,0,0,0,0,0,0,0,0,0,0,0,0,0,0,0,0,0,0,0,0,0,0,0,0,0,0,0,0,0,0,0,0,0,0,0,0,0,0,0,0,0,0,0,0,0,0,0,0,0
13/6/2011,David Cobeño,824099,796,4/6/1982,29,0,0,0,0,4100,6100,6100,138,126,2601770,187,82,GK ,15,12,10,10,12,14,16,14,10,8,11,6,2,2,3,5,8,3,3,2,1,3,1,1,5,12,12,11,9,9,3,12,10,2,10,3,14,10,8,10,13,15,13,5,16,9,20,13,16,15,11,13,5,10,12,7,14,13,13,9,12,13,1,1,1,1,1,1,1,GK ,0,20,1,1,1,1,1,1,1,1,1,1,1,1,1,1,0,0,0,0,0,0,0,0,0,0,0,0,0,0,0,0,0,0,0,0,0,0,0,0,0,0,0,0,0,0,0,0,0,0,0,0,0,0,0,0,0,0,0,0,0,0,0,0,0
13/6/2011,Danny Coyne,2018970,801,8/27/1973,37,16,0,9,0,3000,5200,5200,122,104,287500,183,83,GK ,10,8,18,3,13,8,11,14,11,10,7,8,3,2,3,7,10,6,3,3,3,7,2,3,5,5,7,8,12,14,8,11,14,1,12,2,14,14,9,8,14,8,10,8,11,6,20,14,11,14,2,12,10,9,14,12,17,13,15,14,13,4,1,1,1,1,1,1,1,GK ,0,20,1,1,1,1,1,1,1,1,1,1,1,1,1,1,0,0,0,0,0,0,0,0,0,0,0,0,0,0,0,0,0,0,0,0,0,0,0,0,0,0,0,0,0,0,0,0,0,0,0,0,0,0,0,0,0,0,0,0,0,0,0,0,0
13/6/2011,Daniel Zacher,35010960,771,11/4/1988,22,0,0,0,0,750,2750,2750,83,55,2613,195,88,GK ,10,11,11,8,9,11,7,12,10,13,9,2,2,1,1,4,4,1,3,3,1,1,2,2,2,9,3,8,9,9,1,9,7,1,7,3,12,1,2,6,9,8,16,1,13,6,20,3,6,10,6,10,15,10,9,9,9,15,15,5,17,11,1,1,1,1,1,1,1,GK ,0,20,1,1,1,1,1,1,1,1,1,1,1,1,1,1,0,0,0,0,0,0,0,0,0,0,0,0,0,0,0,0,0,0,0,0,0,0,0,0,0,0,0,0,0,0,0,0,0,0,0,0,0,0,0,0,0,0,0,0,0,0,0,0,0
13/6/2011,Daniel Strähle,27060860,771,3/27/1991,20,0,0,0,0,500,3500,3500,100,70,26568,192,81,GK ,13,8,12,11,9,4,12,14,11,11,13,5,1,1,2,7,9,1,3,2,2,4,2,2,8,5,10,9,7,10,3,11,13,1,8,3,10,3,8,13,10,7,14,3,12,12,20,3,8,9,12,7,3,10,10,11,10,8,16,12,6,18,1,1,1,1,1,1,1,GK ,0,20,1,1,1,1,1,1,1,1,1,1,1,1,1,1,0,0,0,0,0,0,0,0,0,0,0,0,0,0,0,0,0,0,0,0,0,0,0,0,0,0,0,0,0,0,0,0,0,0,0,0,0,0,0,0,0,0,0,0,0,0,0,0,0
13/6/2011,Daniel Schwabke,35014362,771,7/19/1989,21,0,0,0,0,1000,4450,4450,112,94,1405200,188,78,GK ,12,8,11,7,12,11,13,15,7,13,9,8,1,2,1,5,10,8,1,1,1,6,1,1,4,8,10,10,14,12,1,8,5,2,8,1,10,1,2,12,9,10,16,20,16,12,5,7,9,10,8,10,8,10,1,9,9,5,12,7,14,12,1,1,1,1,1,1,1,GK ,0,20,1,1,1,1,1,1,1,1,1,1,1,1,1,1,0,0,0,0,0,0,0,0,0,0,0,0,0,0,0,0,0,0,0,0,0,0,0,0,0,0,0,0,0,0,0,0,0,0,0,0,0,0,0,0,0,0,0,0,0,0,0,0,0
13/6/2011,Daniel Rothe,876620,771,2/25/1981,30,0,0,0,0,500,3000,3000,87,70,5874,189,86,GK ,7,9,11,11,9,8,13,13,12,17,10,7,1,2,2,3,10,1,3,2,3,1,1,2,4,6,9,11,8,6,1,13,7,1,4,1,13,2,2,6,10,10,9,3,7,6,20,3,6,10,14,10,6,10,4,18,4,12,15,9,7,17,1,1,1,1,1,1,1,GK ,0,20,1,1,1,1,1,1,1,1,1,1,1,1,1,1,0,0,0,0,0,0,0,0,0,0,0,0,0,0,0,0,0,0,0,0,0,0,0,0,0,0,0,0,0,0,0,0,0,0,0,0,0,0,0,0,0,0,0,0,0,0,0,0,0
13/6/2011,Daniel Haas,890330,771,8/1/1983,27,0,0,0,0,3350,5750,5750,126,113,1336668,188,82,GK ,11,12,12,7,11,12,13,13,11,13,11,3,2,3,1,8,6,1,3,3,2,8,1,2,8,10,9,12,12,12,3,11,13,3,10,1,11,6,11,12,13,11,15,5,12,12,20,11,14,14,8,10,7,10,9,12,13,10,12,12,13,8,1,1,1,1,1,1,1,GK ,0,20,1,1,1,1,1,1,1,1,1,1,1,1,1,1,0,0,0,0,0,0,0,0,0,0,0,0,0,0,0,0,0,0,0,0,0,0,0,0,0,0,0,0,0,0,0,0,0,0,0,0,0,0,0,0,0,0,0,0,0,0,0,0,0
13/6/2011,Daniel Davari,91002407,771,1/6/1988,23,0,0,0,0,2500,4350,4350,100,87,393299,192,87,GK ,13,12,9,16,13,10,6,10,11,5,10,3,2,3,2,4,6,3,2,1,3,2,2,1,4,11,12,14,11,11,11,8,10,7,11,11,12,13,12,11,14,2,7,5,10,4,20,7,5,9,3,8,3,8,8,8,12,16,10,17,13,12,1,1,1,1,1,1,1,GK ,0,20,1,1,1,1,1,1,1,1,1,1,1,1,1,1,0,0,0,0,0,0,0,0,0,0,0,0,0,0,0,0,0,0,0,0,0,0,0,0,0,0,0,0,0,0,0,0,0,0,0,0,0,0,0,0,0,0,0,0,0,0,0,0,0
13/6/2011,Dani,7442792,796,7/30/1983,27,0,0,0,0,3250,5400,5400,128,114,1251791,182,77,GK ,14,13,14,11,11,12,13,14,8,15,11,7,2,2,3,5,10,3,1,2,1,2,2,2,5,10,12,14,9,13,4,13,9,11,5,1,13,2,3,15,13,13,13,3,14,13,20,8,14,14,3,8,12,10,11,11,14,12,11,13,10,7,1,1,1,1,1,1,1,GK ,0,20,1,1,1,1,1,1,1,1,1,1,1,1,1,1,0,0,0,0,0,0,0,0,0,0,0,0,0,0,0,0,0,0,0,0,0,0,0,0,0,0,0,0,0,0,0,0,0,0,0,0,0,0,0,0,0,0,0,0,0,0,0,0,0
13/6/2011,Dani Mallo,8909,796,1/25/1979,32,0,0,1,0,3750,5250,5250,115,110,498623,185,78,GK ,13,13,15,6,12,11,11,12,9,10,11,1,1,5,4,5,3,4,5,2,2,5,4,7,9,9,12,12,12,11,8,10,12,4,8,2,12,13,11,12,12,10,10,5,12,10,20,13,11,14,8,11,13,1,11,17,16,14,15,16,13,8,1,1,1,1,1,1,1,GK ,0,20,1,1,1,1,1,1,1,1,1,1,1,1,1,1,0,0,0,0,0,0,0,0,0,0,0,0,0,0,0,0,0,0,0,0,0,0,0,0,0,0,0,0,0,0,0,0,0,0,0,0,0,0,0,0,0,0,0,0,0,0,0,0,0
13/6/2011,Dani Jiménez,67131764,796,3/5/1990,21,0,0,0,0,1750,4250,4250,131,90,1371529,179,72,GK ,13,12,10,9,13,10,11,13,6,11,12,5,2,2,3,6,9,1,2,1,1,1,2,3,7,14,11,11,10,13,1,13,8,3,13,3,9,2,3,9,8,6,5,9,6,6,20,5,3,10,6,10,4,10,13,3,15,5,13,9,11,6,1,1,1,1,1,1,1,GK ,0,20,1,1,1,1,1,1,1,1,1,1,1,1,1,1,0,0,0,0,0,0,0,0,0,0,0,0,0,0,0,0,0,0,0,0,0,0,0,0,0,0,0,0,0,0,0,0,0,0,0,0,0,0,0,0,0,0,0,0,0,0,0,0,0
13/6/2011,Dani Hernández,67011215,1658,10/21/1985,25,3,0,0,0,2250,4750,4750,125,95,149025,196,85,GK ,12,13,11,4,11,10,6,12,9,7,11,5,2,1,2,6,10,5,2,3,3,8,3,2,6,7,11,11,11,13,7,11,10,4,8,3,13,11,12,6,12,13,20,5,12,9,20,11,13,15,7,12,4,10,10,3,7,7,10,9,1,10,1,1,1,1,1,1,1,GK ,0,20,1,1,1,1,1,1,1,1,1,1,1,1,1,1,0,0,0,0,0,0,0,0,0,0,0,0,0,0,0,0,0,0,0,0,0,0,0,0,0,0,0,0,0,0,0,0,0,0,0,0,0,0,0,0,0,0,0,0,0,0,0,0,0
13/6/2011,Damien Perquis,8439216,769,3/8/1986,25,0,0,0,0,1300,2600,2600,125,105,163509,184,82,GK ,13,11,11,7,15,8,13,13,10,9,7,1,2,3,3,7,5,2,3,3,2,6,3,1,7,13,13,12,13,13,6,13,13,4,12,1,9,3,8,9,9,14,12,1,14,8,20,4,14,15,6,15,7,1,10,12,10,12,14,14,14,6,1,1,1,1,1,1,1,GK ,0,20,1,1,1,1,1,1,1,1,1,1,1,1,1,1,0,0,0,0,0,0,0,0,0,0,0,0,0,0,0,0,0,0,0,0,0,0,0,0,0,0,0,0,0,0,0,0,0,0,0,0,0,0,0,0,0,0,0,0,0,0,0,0,0
13/6/2011,Damien Grégorini,3502506,769,3/2/1979,32,0,0,2,0,4850,6050,6050,135,135,5594984,194,90,GK ,11,9,15,8,15,13,14,14,8,9,10,6,3,1,2,6,10,8,3,2,3,7,3,6,6,7,12,15,12,13,9,13,15,5,16,1,12,11,11,12,9,17,17,15,13,9,20,13,17,15,7,12,7,1,13,12,16,15,14,13,17,6,1,1,1,1,1,1,1,GK ,0,20,1,1,1,1,1,1,1,1,1,1,1,1,1,1,0,0,0,0,0,0,0,0,0,0,0,0,0,0,0,0,0,0,0,0,0,0,0,0,0,0,0,0,0,0,0,0,0,0,0,0,0,0,0,0,0,0,0,0,0,0,0,0,0
13/6/2011,Da Costa,317738,1651,11/12/1983,27,0,0,0,0,2000,4500,5200,115,103,490929,186,81,GK ,13,12,8,4,13,11,9,14,7,7,11,5,1,2,2,5,10,1,1,3,3,1,1,1,10,9,7,11,9,12,12,11,13,7,10,2,12,11,10,9,13,10,13,9,13,8,20,13,11,13,4,12,3,10,8,13,16,14,12,12,12,6,1,1,1,1,1,1,1,GK ,0,20,1,1,1,1,1,1,1,1,1,1,1,1,1,1,0,0,0,0,0,0,0,0,0,0,0,0,0,0,0,0,0,0,0,0,0,0,0,0,0,0,0,0,0,0,0,0,0,0,0,0,0,0,0,0,0,0,0,0,0,0,0,0,0
13/6/2011,Cristiano,55017603,788,11/29/1990,20,0,0,3,0,750,4500,4500,128,90,2689378,195,90,GK ,13,8,12,8,9,13,13,13,14,6,12,3,3,1,1,7,8,3,3,3,1,1,2,2,6,12,9,11,14,6,3,14,6,1,1,1,9,1,3,13,15,13,15,9,12,8,20,4,6,9,7,3,6,10,11,18,14,7,14,6,12,7,1,1,1,1,1,1,1,GK ,0,20,1,1,1,1,1,1,1,1,1,1,1,1,1,1,0,0,0,0,0,0,0,0,0,0,0,0,0,0,0,0,0,0,0,0,0,0,0,0,0,0,0,0,0,0,0,0,0,0,0,0,0,0,0,0,0,0,0,0,0,0,0,0,0
13/6/2011,Cristiano Lupatelli,4606,776,6/21/1978,32,0,0,2,0,2000,5200,5200,112,104,1412241,189,87,GK ,14,12,11,8,15,10,16,14,16,14,13,1,1,4,1,12,4,6,4,1,4,6,1,6,5,10,7,12,7,10,2,11,5,11,11,3,10,11,10,8,10,10,14,5,12,6,20,5,9,14,8,14,7,1,14,10,9,12,15,13,16,5,1,1,1,1,1,1,1,GK ,0,20,1,1,1,1,1,1,1,1,1,1,1,1,1,1,0,0,0,0,0,0,0,0,0,0,0,0,0,0,0,0,0,0,0,0,0,0,0,0,0,0,0,0,0,0,0,0,0,0,0,0,0,0,0,0,0,0,0,0,0,0,0,0,0
13/6/2011,Cristian Puggioni,3804723,776,1/17/1981,30,0,0,0,0,1250,6250,6250,130,125,3201286,187,81,GK ,14,14,13,4,17,13,14,15,15,14,8,1,1,1,1,6,1,7,1,1,1,1,1,1,8,10,13,12,9,13,11,13,16,13,16,10,12,9,10,9,11,10,13,5,10,9,20,10,8,13,11,12,6,1,16,12,17,15,17,14,10,6,1,1,1,1,1,1,1,GK ,0,20,1,1,1,1,1,1,1,1,1,1,1,1,1,1,0,0,0,0,0,0,0,0,0,0,0,0,0,0,0,0,0,0,0,0,0,0,0,0,0,0,0,0,0,0,0,0,0,0,0,0,0,0,0,0,0,0,0,0,0,0,0,0,0
13/6/2011,Cristian Alvarez,955103,1649,11/13/1985,25,0,0,0,0,3500,6000,6200,140,128,2601372,187,88,GK ,13,12,12,11,14,10,13,15,12,7,11,6,3,2,1,6,9,3,3,2,3,3,2,1,9,14,8,15,9,12,9,9,15,7,9,11,12,15,17,15,15,11,14,7,15,13,20,11,11,12,7,8,9,10,14,11,12,15,13,12,10,13,1,1,1,1,1,1,1,GK ,0,20,1,1,1,1,1,1,1,1,1,1,1,1,1,1,0,0,0,0,0,0,0,0,0,0,0,0,0,0,0,0,0,0,0,0,0,0,0,0,0,0,0,0,0,0,0,0,0,0,0,0,0,0,0,0,0,0,0,0,0,0,0,0,0
13/6/2011,Costinha,55037384,788,1/19/1984,27,0,0,0,0,50,1100,1400,51,41,310,188,0,GK ,9,11,6,8,6,8,8,10,10,9,6,6,2,2,2,1,8,1,1,1,3,1,3,2,1,10,4,9,7,8,1,12,8,3,9,3,11,1,1,8,12,12,11,7,8,2,20,1,4,10,14,10,7,9,7,12,7,13,7,14,10,9,1,1,1,1,1,1,1,GK ,0,20,1,1,1,1,1,1,1,1,1,1,1,1,1,1,0,0,0,0,0,0,0,0,0,0,0,0,0,0,0,0,0,0,0,0,0,0,0,0,0,0,0,0,0,0,0,0,0,0,0,0,0,0,0,0,0,0,0,0,0,0,0,0,0
13/6/2011,Costel Pantilimon,7540617,790,2/1/1987,24,13,0,12,0,6000,6750,6250,150,127,2235932,200,103,GK ,18,14,14,6,13,12,12,13,11,13,14,2,3,3,1,11,4,12,2,3,1,9,7,3,8,9,12,12,13,12,5,9,12,6,12,1,13,11,9,9,8,15,20,9,10,9,20,13,16,12,6,13,3,10,10,13,16,13,13,12,14,4,1,1,1,1,1,1,1,GK ,0,20,1,1,1,1,1,1,1,1,1,1,1,1,1,1,0,0,0,0,0,0,0,0,0,0,0,0,0,0,0,0,0,0,0,0,0,0,0,0,0,0,0,0,0,0,0,0,0,0,0,0,0,0,0,0,0,0,0,0,0,0,0,0,0
13/6/2011,Colin Doyle,5119852,789,6/12/1985,26,1,0,4,0,2500,5500,5500,132,116,2300000,196,92,GK ,13,15,12,6,14,11,12,13,12,10,12,6,2,2,2,5,9,2,2,1,1,6,3,3,8,11,7,13,8,10,7,10,8,5,11,10,14,12,13,9,11,11,16,11,13,7,20,6,13,11,8,5,3,10,12,7,10,12,10,11,12,4,1,1,1,1,1,1,1,GK ,0,20,1,1,1,1,1,1,1,1,1,1,1,1,1,1,0,0,0,0,0,0,0,0,0,0,0,0,0,0,0,0,0,0,0,0,0,0,0,0,0,0,0,0,0,0,0,0,0,0,0,0,0,0,0,0,0,0,0,0,0,0,0,0,0
13/6/2011,Cody Cropper,28060175,390,2/16/1993,18,0,0,1,0,1600,3750,3250,131,65,1420249,194,98,GK ,12,9,6,10,8,9,13,13,4,10,9,8,3,1,2,3,10,1,3,1,2,1,1,3,3,7,5,9,4,12,1,13,6,2,10,2,10,1,1,11,9,6,15,9,7,13,20,2,7,8,14,5,13,9,6,8,8,12,15,14,5,11,1,1,1,1,1,1,1,GK ,0,20,1,1,1,1,1,1,1,1,1,1,1,1,1,1,0,0,0,0,0,0,0,0,0,0,0,0,0,0,0,0,0,0,0,0,0,0,0,0,0,0,0,0,0,0,0,0,0,0,0,0,0,0,0,0,0,0,0,0,0,0,0,0,0
13/6/2011,Claudio Bravo,5251774,1652,4/13/1983,28,47,0,0,0,6000,7250,7250,154,145,16537674,184,84,GK ,17,12,12,11,15,16,11,17,14,12,16,11,7,9,3,9,15,7,1,2,1,16,11,3,12,12,11,13,11,12,13,12,14,10,13,4,14,11,7,9,14,14,11,8,16,7,20,13,14,14,8,10,4,10,12,13,15,13,17,13,13,4,1,1,1,1,1,1,1,GK ,0,20,1,1,1,1,1,1,1,1,1,1,1,1,1,1,0,0,0,0,0,0,0,0,0,0,0,0,0,0,0,0,0,0,0,0,0,0,0,0,0,0,0,0,0,0,0,0,0,0,0,0,0,0,0,0,0,0,0,0,0,0,0,0,0
13/6/2011,Christopher Sommerer,35023461,771,3/5/1991,20,0,0,0,0,2500,4000,4000,105,80,411334,187,80,GK ,13,10,12,9,11,10,13,14,12,12,11,2,3,1,3,7,7,1,3,1,3,3,3,3,4,8,5,13,14,7,1,14,9,1,7,1,9,3,3,11,6,7,15,6,12,11,20,3,5,10,9,6,10,9,14,14,15,7,14,5,16,19,1,1,1,1,1,1,1,GK ,0,20,1,1,1,1,1,1,1,1,1,1,1,1,1,1,0,0,0,0,0,0,0,0,0,0,0,0,0,0,0,0,0,0,0,0,0,0,0,0,0,0,0,0,0,0,0,0,0,0,0,0,0,0,0,0,0,0,0,0,0,0,0,0,0
13/6/2011,Christopher Heimeroth,884077,771,8/1/1981,29,0,0,4,0,3750,5700,5700,121,114,1310300,194,91,GK ,12,9,8,1,13,10,15,14,8,14,13,8,2,3,3,8,10,3,2,2,1,7,2,2,9,8,9,12,10,10,5,12,10,4,7,5,14,12,12,12,14,14,16,8,15,7,20,13,14,13,8,12,7,10,8,13,13,12,14,13,5,7,1,1,1,1,1,1,1,GK ,0,20,1,1,1,1,1,1,1,1,1,1,1,1,1,1,0,0,0,0,0,0,0,0,0,0,0,0,0,0,0,0,0,0,0,0,0,0,0,0,0,0,0,0,0,0,0,0,0,0,0,0,0,0,0,0,0,0,0,0,0,0,0,0,0
13/6/2011,Christophe Marichez,8655,769,12/12/1974,36,0,0,0,0,4000,5050,5050,132,112,178616,182,75,GK ,11,10,13,3,13,12,13,13,6,6,8,2,3,1,3,7,5,1,14,2,2,10,3,1,7,8,13,15,12,12,8,12,14,5,15,3,11,12,11,11,10,14,10,1,13,9,20,12,12,12,8,12,9,1,8,10,15,13,16,14,14,7,1,1,1,1,1,1,1,GK ,0,20,1,1,1,1,1,1,1,1,1,1,1,1,1,1,0,0,0,0,0,0,0,0,0,0,0,0,0,0,0,0,0,0,0,0,0,0,0,0,0,0,0,0,0,0,0,0,0,0,0,0,0,0,0,0,0,0,0,0,0,0,0,0,0
13/6/2011,Christian Wetklo,6001866,771,1/11/1980,31,0,0,0,0,3000,5250,6250,135,133,5534394,190,90,GK ,14,10,13,10,14,11,16,16,8,10,12,6,3,3,3,5,10,3,1,3,1,11,1,12,11,12,12,11,11,10,8,14,9,7,13,11,14,12,12,10,11,12,15,3,13,12,20,18,19,12,8,12,8,10,11,14,14,10,12,10,6,8,1,1,1,1,1,1,1,GK ,0,20,1,1,1,1,1,1,1,1,1,1,1,1,1,1,0,0,0,0,0,0,0,0,0,0,0,0,0,0,0,0,0,0,0,0,0,0,0,0,0,0,0,0,0,0,0,0,0,0,0,0,0,0,0,0,0,0,0,0,0,0,0,0,0
13/6/2011,Christian Vander,3600996,771,10/24/1980,30,0,0,0,0,3500,5400,5400,125,118,1657191,195,90,GK ,15,11,11,5,13,8,12,16,13,11,12,6,3,2,1,11,8,2,1,1,1,11,3,13,9,9,12,11,12,10,3,12,9,5,9,2,12,17,13,14,12,12,13,3,14,11,20,13,12,11,7,11,11,10,12,5,15,7,15,14,14,2,1,1,1,1,1,1,1,GK ,0,20,1,1,1,1,1,1,1,1,1,1,1,1,1,1,0,0,0,0,0,0,0,0,0,0,0,0,0,0,0,0,0,0,0,0,0,0,0,0,0,0,0,0,0,0,0,0,0,0,0,0,0,0,0,0,0,0,0,0,0,0,0,0,0
13/6/2011,Christian Meyer,35005610,771,3/1/1987,24,0,0,0,0,250,2500,2500,70,50,3636,184,78,GK ,12,7,7,4,7,11,7,10,6,6,5,2,3,3,2,3,6,1,2,1,1,1,3,2,3,10,7,7,7,10,1,12,8,3,12,3,11,1,2,11,11,11,7,8,14,8,20,6,5,7,11,3,13,10,9,7,6,17,17,12,12,6,1,1,1,1,1,1,1,GK ,0,20,1,1,1,1,1,1,1,1,1,1,1,1,1,1,0,0,0,0,0,0,0,0,0,0,0,0,0,0,0,0,0,0,0,0,0,0,0,0,0,0,0,0,0,0,0,0,0,0,0,0,0,0,0,0,0,0,0,0,0,0,0,0,0
13/6/2011,Christian Abbiati,705280,776,7/8/1977,33,4,0,20,0,6500,7250,7700,162,154,21202722,191,92,GK ,15,13,14,5,14,15,14,18,13,17,13,1,1,1,1,8,1,3,1,1,1,12,1,1,7,7,14,16,13,13,9,13,14,1,13,1,15,10,14,11,14,13,15,5,10,12,20,15,12,15,5,13,14,1,14,15,15,14,15,16,18,11,1,1,1,1,1,1,1,GK ,0,20,1,1,1,1,1,1,1,1,1,1,1,1,1,1,17179869184,0,0,0,0,0,0,0,0,0,0,0,0,0,0,0,0,0,0,0,0,0,0,0,0,0,0,0,0,0,0,0,0,0,0,1,0,0,0,0,0,0,0,0,0,0,0,0,0
13/6/2011,Chris Weale,5102137,765,2/9/1982,29,0,0,0,0,2500,5350,5350,114,105,1150000,188,84,GK ,14,12,7,8,11,10,13,14,11,14,11,1,3,1,1,8,3,1,2,3,3,7,1,1,11,7,10,10,7,8,11,10,14,1,12,3,13,10,15,11,12,7,14,20,9,11,10,10,10,10,4,8,10,10,12,9,14,7,17,11,14,4,1,1,1,1,1,1,1,GK ,0,20,1,1,1,1,1,1,1,1,1,1,1,1,1,1,0,0,0,0,0,0,0,0,0,0,0,0,0,0,0,0,0,0,0,0,0,0,0,0,0,0,0,0,0,0,0,0,0,0,0,0,0,0,0,0,0,0,0,0,0,0,0,0,0
13/6/2011,Chris Dunn,28003598,765,10/23/1987,23,0,0,0,0,1400,3900,3900,105,75,264370,196,88,GK ,11,10,9,2,12,7,11,14,7,9,10,1,1,1,1,10,1,4,1,1,1,9,1,1,10,2,9,8,7,7,7,9,15,1,3,1,9,11,10,8,10,10,17,20,7,9,9,10,12,9,1,10,1,1,5,8,12,7,15,14,15,1,1,1,1,1,1,1,1,GK ,0,20,1,1,1,1,1,1,1,1,1,1,1,1,1,1,0,0,0,0,0,0,0,0,0,0,0,0,0,0,0,0,0,0,0,0,0,0,0,0,0,0,0,0,0,0,0,0,0,0,0,0,0,0,0,0,0,0,0,0,0,0,0,0,0
13/6/2011,Chema,7445190,796,4/25/1980,31,0,0,0,0,3000,5650,5650,127,117,628201,187,85,GK ,12,12,10,10,11,11,12,15,11,10,10,6,1,3,1,5,8,1,1,3,2,1,3,3,4,11,11,12,12,12,5,12,13,10,13,5,12,14,11,11,14,13,15,11,14,9,20,9,10,12,6,12,9,10,12,15,14,8,15,14,10,4,1,1,1,1,1,1,1,GK ,0,20,1,1,1,1,1,1,1,1,1,1,1,1,1,1,0,0,0,0,0,0,0,0,0,0,0,0,0,0,0,0,0,0,0,0,0,0,0,0,0,0,0,0,0,0,0,0,0,0,0,0,0,0,0,0,0,0,0,0,0,0,0,0,0
13/6/2011,Cheick N'Diaye,8444545,41,2/15/1985,26,6,0,0,0,4050,6250,5100,135,114,2943061,191,82,GK ,16,14,12,8,11,14,13,13,11,6,8,4,1,2,2,8,8,2,11,1,3,7,3,1,8,8,15,14,13,13,8,9,14,7,8,3,8,12,8,7,11,16,16,1,13,10,20,12,16,12,8,10,7,10,14,14,14,14,15,14,14,5,1,1,1,1,1,1,1,GK ,0,20,1,1,1,1,1,1,1,1,1,1,1,1,1,1,0,0,0,0,0,0,0,0,0,0,0,0,0,0,0,0,0,0,0,0,0,0,0,0,0,0,0,0,0,0,0,0,0,0,0,0,0,0,0,0,0,0,0,0,0,0,0,0,0
13/6/2011,César,14676,796,9/2/1971,39,1,0,0,0,5250,6950,6950,151,140,510538,185,85,GK ,12,13,15,7,15,13,14,16,12,8,13,5,1,3,3,6,10,5,3,3,3,9,2,2,8,11,12,14,10,12,5,13,16,7,13,3,13,13,12,10,15,13,12,4,15,10,20,10,14,16,16,8,8,10,10,14,14,13,18,7,9,8,1,1,1,1,1,1,1,GK ,0,20,1,1,1,1,1,1,1,1,1,1,1,1,1,1,562949953486848,0,0,0,0,0,0,0,0,0,0,0,0,0,0,0,0,1,0,0,0,0,0,0,0,0,0,0,0,0,0,0,0,0,0,0,0,0,0,0,0,0,0,0,0,0,0,0,0
13/6/2011,Cédric Carrasso,6200366,769,12/30/1981,29,1,0,0,0,6300,7800,7000,158,156,14101579,187,87,GK ,13,14,12,7,15,11,16,17,13,17,12,4,3,2,3,7,8,2,1,2,1,7,8,3,7,10,14,17,15,15,7,14,17,7,13,1,13,14,15,13,15,17,13,1,13,12,20,14,16,16,10,16,11,1,12,14,15,16,16,14,13,6,1,1,1,1,1,1,1,GK ,0,20,1,1,1,1,1,1,1,1,1,1,1,1,1,1,0,0,0,0,0,0,0,0,0,0,0,0,0,0,0,0,0,0,0,0,0,0,0,0,0,0,0,0,0,0,0,0,0,0,0,0,0,0,0,0,0,0,0,0,0,0,0,0,0
13/6/2011,Casto,824564,796,6/18/1982,28,0,0,0,0,4150,6150,6150,130,123,2597426,182,78,GK ,10,11,13,12,13,12,13,15,14,13,12,7,3,3,2,6,10,1,3,3,3,1,3,1,5,8,13,12,12,13,1,12,12,7,12,2,12,13,12,13,13,10,11,2,13,11,20,13,12,12,5,11,7,10,10,13,11,9,13,12,12,7,1,1,1,1,1,1,1,GK ,0,20,1,1,1,1,1,1,1,1,1,1,1,1,1,1,0,0,0,0,0,0,0,0,0,0,0,0,0,0,0,0,0,0,0,0,0,0,0,0,0,0,0,0,0,0,0,0,0,0,0,0,0,0,0,0,0,0,0,0,0,0,0,0,0
13/6/2011,Cássio,3300416,1651,8/12/1980,30,0,0,0,0,2500,5850,5500,113,109,1009484,184,72,GK ,11,12,11,7,13,12,13,15,10,11,11,1,2,3,1,6,4,3,3,3,2,2,1,3,8,4,11,14,11,9,3,8,10,1,13,3,10,12,11,12,14,14,14,10,15,14,20,14,15,12,12,10,10,10,12,8,17,11,15,12,16,6,1,1,1,1,1,1,1,GK ,0,20,1,1,1,1,1,1,1,1,1,1,1,1,1,1,0,0,0,0,0,0,0,0,0,0,0,0,0,0,0,0,0,0,0,0,0,0,0,0,0,0,0,0,0,0,0,0,0,0,0,0,0,0,0,0,0,0,0,0,0,0,0,0,0
13/6/2011,Casper Ankergren,926045,764,11/9/1979,31,0,0,3,0,4200,5100,5100,115,104,372858,191,92,GK ,9,7,10,11,13,10,12,16,13,7,9,6,3,3,1,10,8,7,2,3,3,11,3,1,9,11,11,13,12,13,9,12,14,4,11,7,13,8,8,6,12,14,16,8,12,6,20,7,12,16,8,16,7,10,19,13,14,14,15,6,14,3,1,1,1,1,1,1,1,GK ,0,20,1,1,1,1,1,1,1,1,1,1,1,1,1,1,65536,0,0,0,0,0,0,0,0,0,0,0,0,0,0,0,0,1,0,0,0,0,0,0,0,0,0,0,0,0,0,0,0,0,0,0,0,0,0,0,0,0,0,0,0,0,0,0,0
13/6/2011,Carlos Kameni,917333,11,2/18/1984,27,32,0,0,0,6000,7500,7200,155,144,5999999,188,86,GK ,15,11,12,15,12,11,17,19,13,16,13,6,1,2,2,4,8,3,1,1,1,3,1,1,5,7,16,14,16,11,1,12,16,14,11,2,11,1,11,12,17,11,16,6,14,13,20,9,11,15,5,15,6,10,16,18,12,10,16,15,13,12,1,1,1,1,1,1,1,GK ,0,20,1,1,1,1,1,1,1,1,1,1,1,1,1,1,0,0,0,0,0,0,0,0,0,0,0,0,0,0,0,0,0,0,0,0,0,0,0,0,0,0,0,0,0,0,0,0,0,0,0,0,0,0,0,0,0,0,0,0,0,0,0,0,0
13/6/2011,Carlos Arias,5240024,1650,2/18/1980,31,28,0,0,0,3250,5750,5500,123,122,2056970,182,77,GK ,12,11,13,3,13,12,14,13,12,10,11,6,2,1,3,5,10,3,2,1,2,13,1,3,10,6,10,12,9,12,11,12,10,7,11,3,12,13,15,11,13,12,11,10,12,12,20,13,11,13,5,11,13,10,18,14,13,11,6,13,5,10,1,1,1,1,1,1,1,GK ,0,20,1,1,1,1,1,1,1,1,1,1,1,1,1,1,0,0,0,0,0,0,0,0,0,0,0,0,0,0,0,0,0,0,0,0,0,0,0,0,0,0,0,0,0,0,0,0,0,0,0,0,0,0,0,0,0,0,0,0,0,0,0,0,0
13/6/2011,Carlo Pinsoglio,43006598,776,3/16/1990,21,0,0,8,0,1250,4300,4350,141,98,361596,192,72,GK ,11,11,11,7,12,11,11,13,11,12,8,8,1,1,1,8,10,10,2,1,3,10,2,2,8,9,9,10,11,12,6,11,11,7,8,5,16,7,8,11,11,12,17,20,13,12,5,9,11,9,4,11,4,10,12,19,7,5,13,8,14,20,1,1,1,1,1,1,1,GK ,0,20,1,1,1,1,1,1,1,1,1,1,1,1,1,1,0,0,0,0,0,0,0,0,0,0,0,0,0,0,0,0,0,0,0,0,0,0,0,0,0,0,0,0,0,0,0,0,0,0,0,0,0,0,0,0,0,0,0,0,0,0,0,0,0
13/6/2011,Carlo Nash,2005019,765,9/13/1973,37,0,0,0,0,2750,5500,5750,132,120,572439,196,90,GK ,11,12,9,12,11,12,11,13,13,15,13,1,3,3,1,5,6,6,2,3,3,10,2,6,11,10,11,17,10,12,9,11,13,11,11,1,11,8,10,11,15,9,16,8,12,10,20,11,11,15,4,12,12,10,10,12,8,13,8,12,10,18,1,1,1,1,1,1,1,GK ,0,20,1,1,1,1,1,1,1,1,1,1,1,1,1,1,0,0,0,0,0,0,0,0,0,0,0,0,0,0,0,0,0,0,0,0,0,0,0,0,0,0,0,0,0,0,0,0,0,0,0,0,0,0,0,0,0,0,0,0,0,0,0,0,0
13/6/2011,Carlo Masciullo,43080235,776,1/7/1993,18,0,0,0,0,50,1400,1450,53,36,10226,186,89,GK ,12,12,2,10,8,5,9,8,9,13,4,2,2,3,3,1,5,1,2,1,3,1,1,2,2,12,3,9,3,8,1,8,9,3,10,2,9,1,2,8,13,13,9,6,11,4,20,2,6,8,12,10,5,6,10,3,7,13,8,12,1,4,1,1,1,1,1,1,1,GK ,0,20,1,1,1,1,1,1,1,1,1,1,1,1,1,1,0,0,0,0,0,0,0,0,0,0,0,0,0,0,0,0,0,0,0,0,0,0,0,0,0,0,0,0,0,0,0,0,0,0,0,0,0,0,0,0,0,0,0,0,0,0,0,0,0
13/6/2011,Carlo Cudicini,8448,776,9/6/1973,37,0,0,1,0,5750,6750,6250,166,132,1072112,185,80,GK ,11,11,13,6,13,13,15,14,13,13,13,7,2,3,2,9,10,1,3,2,2,9,1,12,14,8,16,13,15,11,13,10,18,12,10,10,13,14,16,13,13,15,14,10,14,12,20,16,13,16,5,14,12,10,18,14,20,15,15,16,17,1,1,1,1,1,1,1,1,GK ,0,20,1,1,1,1,1,1,1,1,1,1,1,1,1,1,0,0,0,0,0,0,0,0,0,0,0,0,0,0,0,0,0,0,0,0,0,0,0,0,0,0,0,0,0,0,0,0,0,0,0,0,0,0,0,0,0,0,0,0,0,0,0,0,0
13/6/2011,Carl Ikeme,5113496,38,6/8/1986,25,0,0,0,0,2500,5000,5000,130,110,1108459,188,87,GK ,13,12,12,5,12,11,13,13,11,3,9,8,2,2,3,10,10,2,1,10,1,1,3,1,8,10,10,12,7,10,2,11,10,2,5,1,12,10,8,8,14,12,15,14,10,7,20,12,15,10,2,6,15,10,8,10,12,10,10,10,8,5,1,1,1,1,1,1,1,GK ,0,20,1,1,1,1,1,1,1,1,1,1,1,1,1,1,0,0,0,0,0,0,0,0,0,0,0,0,0,0,0,0,0,0,0,0,0,0,0,0,0,0,0,0,0,0,0,0,0,0,0,0,0,0,0,0,0,0,0,0,0,0,0,0,0
13/6/2011,Bruno Veríssimo,727405,788,4/7/1976,35,0,0,0,0,500,3500,4500,100,98,164290,183,80,GK ,3,10,11,5,13,13,10,14,10,11,12,6,3,2,3,5,8,1,3,3,1,1,2,1,3,8,8,13,9,12,1,12,15,1,10,1,12,1,8,7,12,12,7,7,9,7,20,5,12,9,9,3,10,10,6,10,15,12,14,14,14,5,1,1,1,1,1,1,1,GK ,0,20,1,1,1,1,1,1,1,1,1,1,1,1,1,1,0,0,0,0,0,0,0,0,0,0,0,0,0,0,0,0,0,0,0,0,0,0,0,0,0,0,0,0,0,0,0,0,0,0,0,0,0,0,0,0,0,0,0,0,0,0,0,0,0
13/6/2011,Brian Murphy,5107440,789,5/7/1983,28,0,0,3,0,2000,5250,5250,122,106,4234678,183,84,GK ,11,12,12,8,12,10,13,14,8,15,8,5,1,1,1,12,7,3,1,1,3,6,1,10,8,8,11,12,12,10,8,9,16,4,8,2,13,8,13,12,14,10,12,11,12,11,20,14,12,15,5,13,5,10,12,14,12,8,18,17,13,5,1,1,1,1,1,1,1,GK ,0,20,1,1,1,1,1,1,1,1,1,1,1,1,1,1,0,0,0,0,0,0,0,0,0,0,0,0,0,0,0,0,0,0,0,0,0,0,0,0,0,0,0,0,0,0,0,0,0,0,0,0,0,0,0,0,0,0,0,0,0,0,0,0,0
13/6/2011,Brian Jensen,7200444,764,6/8/1975,36,0,0,0,0,4000,5000,6000,121,109,637331,186,78,GK ,11,10,10,14,14,7,17,16,12,14,8,3,3,2,2,3,5,3,3,1,2,2,3,2,5,12,11,17,10,11,2,8,15,1,8,1,11,2,10,5,11,13,13,20,17,5,3,13,16,10,2,13,7,10,14,13,15,8,10,15,8,15,1,1,1,1,1,1,1,GK ,0,20,1,1,1,1,1,1,1,1,1,1,1,1,1,1,562949953421312,0,0,0,0,0,0,0,0,0,0,0,0,0,0,0,0,0,0,0,0,0,0,0,0,0,0,0,0,0,0,0,0,0,0,0,0,0,0,0,0,0,0,0,0,0,0,0,0
13/6/2011,Brad Jones,123711,1435,3/19/1982,29,3,0,6,0,4500,6000,5600,125,114,9509083,191,78,GK ,13,12,10,3,13,14,14,13,18,13,15,6,3,2,3,8,8,1,2,14,3,8,3,3,9,9,12,10,10,12,6,12,3,2,7,9,13,8,7,8,8,12,15,20,8,12,9,14,13,10,2,10,15,10,17,7,10,6,18,16,18,2,1,1,1,1,1,1,1,GK ,0,20,1,1,1,1,1,1,1,1,1,1,1,1,1,1,0,0,0,0,0,0,0,0,0,0,0,0,0,0,0,0,0,0,0,0,0,0,0,0,0,0,0,0,0,0,0,0,0,0,0,0,0,0,0,0,0,0,0,0,0,0,0,0,0
13/6/2011,Brad Guzan,980785,390,9/9/1984,26,19,0,5,0,3750,6350,6150,150,130,2325027,193,95,GK ,10,10,11,8,15,12,14,15,12,10,10,7,3,2,3,9,10,8,1,2,3,10,1,2,9,6,17,12,12,13,9,11,17,3,14,2,14,14,12,14,13,12,15,20,8,8,12,13,16,10,7,10,9,10,16,17,14,11,17,18,13,3,1,1,1,1,1,1,1,GK ,0,20,1,1,1,1,1,1,1,1,1,1,1,1,1,1,0,0,0,0,0,0,0,0,0,0,0,0,0,0,0,0,0,0,0,0,0,0,0,0,0,0,0,0,0,0,0,0,0,0,0,0,0,0,0,0,0,0,0,0,0,0,0,0,0
13/6/2011,Brad Friedel,1200452,390,5/18/1971,40,82,0,0,0,6350,8100,7400,160,147,984054,188,92,GK ,11,11,14,3,13,14,16,16,13,11,13,8,1,3,2,9,10,6,3,1,3,7,2,2,8,8,14,15,15,16,7,14,16,1,11,1,14,15,14,7,14,14,14,8,16,8,20,15,16,17,12,15,1,10,19,15,19,17,20,16,15,1,1,1,1,1,1,1,1,GK ,0,20,1,1,1,1,1,1,1,1,1,1,1,1,1,1,562949953421312,0,0,0,0,0,0,0,0,0,0,0,0,0,0,0,0,0,0,0,0,0,0,0,0,0,0,0,0,0,0,0,0,0,0,0,0,0,0,0,0,0,0,0,0,0,0,0,0
13/6/2011,Boy Waterman,853642,784,1/24/1984,27,0,0,4,0,4550,5250,5700,124,114,1793435,188,83,GK ,14,11,11,13,14,15,13,12,16,8,13,6,2,2,3,9,8,5,2,3,2,10,3,2,12,6,9,12,9,7,11,10,13,12,7,2,12,13,11,11,14,14,13,5,12,12,20,13,12,5,8,10,12,10,7,15,13,12,12,12,5,17,1,1,1,1,1,1,1,GK ,0,20,1,1,1,1,1,1,1,1,1,1,1,1,1,1,4294967296,0,0,0,0,0,0,0,0,0,0,0,0,0,0,0,0,0,0,0,0,0,0,0,0,0,0,0,0,0,0,0,0,1,0,0,0,0,0,0,0,0,0,0,0,0,0,0,0
13/6/2011,Bogdan Lobont,120515,790,1/18/1978,33,63,0,9,0,6000,7150,6500,145,130,3952545,185,78,GK ,11,12,13,13,12,15,9,15,10,9,15,7,1,3,3,8,10,2,1,2,1,14,3,3,13,10,12,12,12,14,14,11,14,15,14,9,11,15,16,11,11,9,11,5,15,12,20,15,10,18,4,16,7,10,16,14,14,15,14,17,15,5,1,1,1,1,1,1,1,GK ,0,20,1,1,1,1,1,1,1,1,1,1,1,1,1,1,0,0,0,0,0,0,0,0,0,0,0,0,0,0,0,0,0,0,0,0,0,0,0,0,0,0,0,0,0,0,0,0,0,0,0,0,0,0,0,0,0,0,0,0,0,0,0,0,0
13/6/2011,Boaz Myhill,5106486,801,11/9/1982,28,10,0,0,0,3600,5750,6150,137,125,3667349,191,92,GK ,14,8,10,8,15,12,13,18,8,14,5,7,3,3,2,7,9,1,1,1,2,11,1,3,7,9,8,16,12,14,8,10,12,8,8,10,11,11,11,9,14,13,13,12,12,10,20,12,10,16,3,12,1,10,19,16,14,8,14,8,10,5,1,1,1,1,1,1,1,GK ,0,20,1,1,1,1,1,1,1,1,1,1,1,1,1,1,1073741824,0,0,0,0,0,0,0,0,0,0,0,0,0,0,0,0,0,0,0,0,0,0,0,0,0,0,0,0,0,0,1,0,0,0,0,0,0,0,0,0,0,0,0,0,0,0,0,0
13/6/2011,Bertrand Laquait,3503393,769,4/13/1977,34,0,0,3,0,1600,5750,5750,134,128,1014347,184,79,GK ,13,12,12,5,13,11,13,16,12,16,9,7,3,1,3,7,10,2,15,2,2,7,2,1,7,5,12,13,14,13,6,13,14,5,14,3,11,3,9,11,14,13,12,5,16,14,20,13,13,16,5,16,5,1,15,14,15,17,15,15,12,5,1,1,1,1,1,1,1,GK ,0,20,1,1,1,1,1,1,1,1,1,1,1,1,1,1,0,0,0,0,0,0,0,0,0,0,0,0,0,0,0,0,0,0,0,0,0,0,0,0,0,0,0,0,0,0,0,0,0,0,0,0,0,0,0,0,0,0,0,0,0,0,0,0,0
13/6/2011,Bernd Leno,92012109,771,3/4/1992,19,0,0,0,0,2750,6700,6700,152,134,8876041,190,79,GK ,13,11,10,5,15,14,15,16,12,13,11,5,2,3,2,8,8,3,2,1,3,11,3,1,11,8,13,13,12,14,7,11,13,2,8,2,13,11,11,12,15,12,16,7,12,11,20,15,11,13,4,13,4,10,6,13,12,13,14,10,13,5,1,1,1,1,1,1,1,GK ,0,20,1,1,1,1,1,1,1,1,1,1,1,1,1,1,0,0,0,0,0,0,0,0,0,0,0,0,0,0,0,0,0,0,0,0,0,0,0,0,0,0,0,0,0,0,0,0,0,0,0,0,0,0,0,0,0,0,0,0,0,0,0,0,0
13/6/2011,Bernardo,4200257,796,7/6/1979,31,0,0,0,0,3250,5650,5650,115,105,1562344,188,86,GK ,14,10,10,11,11,11,11,12,13,11,8,1,1,3,1,6,1,6,1,2,1,14,11,5,11,10,12,15,10,13,9,10,15,2,7,3,13,14,15,9,12,14,16,3,14,9,20,12,14,6,12,8,5,1,12,18,14,11,11,16,12,7,1,1,1,1,1,1,1,GK ,0,20,1,1,1,1,1,1,1,1,1,1,1,1,1,1,0,0,0,0,0,0,0,0,0,0,0,0,0,0,0,0,0,0,0,0,0,0,0,0,0,0,0,0,0,0,0,0,0,0,0,0,0,0,0,0,0,0,0,0,0,0,0,0,0
13/6/2011,Benoît Costil,919964,769,7/3/1987,23,0,0,0,0,3900,5850,5850,150,130,8425053,187,83,GK ,13,13,13,10,14,10,14,14,13,12,8,6,2,2,1,7,10,2,1,1,3,8,1,1,7,8,13,13,14,13,11,12,15,7,10,2,15,12,12,13,12,15,13,1,16,12,20,14,15,15,8,15,7,1,11,16,14,14,14,14,11,6,1,1,1,1,1,1,1,GK ,0,20,1,1,1,1,1,1,1,1,1,1,1,1,1,1,0,0,0,0,0,0,0,0,0,0,0,0,0,0,0,0,0,0,0,0,0,0,0,0,0,0,0,0,0,0,0,0,0,0,0,0,0,0,0,0,0,0,0,0,0,0,0,0,0
13/6/2011,Benjamin Siegrist,28038177,798,1/31/1992,19,0,0,0,0,2500,4400,4400,150,96,3320049,193,76,GK ,15,12,10,7,14,10,12,14,12,15,8,3,3,3,3,7,7,5,2,3,2,8,2,1,11,7,9,10,10,11,1,8,9,3,3,2,12,3,4,8,11,14,18,8,13,8,20,7,9,9,17,10,7,10,14,11,11,10,11,13,9,8,1,1,1,1,1,1,1,GK ,0,20,1,1,1,1,1,1,1,1,1,1,1,1,1,1,0,0,0,0,0,0,0,0,0,0,0,0,0,0,0,0,0,0,0,0,0,0,0,0,0,0,0,0,0,0,0,0,0,0,0,0,0,0,0,0,0,0,0,0,0,0,0,0,0
13/6/2011,Benjamin Lecomte,85041077,769,4/26/1991,20,0,0,0,0,1400,2800,2800,139,102,3241138,184,78,GK ,14,10,7,9,11,11,11,13,9,10,12,3,2,3,1,11,5,1,2,2,2,2,2,3,11,7,10,10,11,14,2,14,14,3,14,1,9,1,9,12,13,14,12,1,12,14,20,8,13,10,7,5,12,1,11,9,14,2,15,15,15,5,1,1,1,1,1,1,1,GK ,0,20,1,1,1,1,1,1,1,1,1,1,1,1,1,1,0,0,0,0,0,0,0,0,0,0,0,0,0,0,0,0,0,0,0,0,0,0,0,0,0,0,0,0,0,0,0,0,0,0,0,0,0,0,0,0,0,0,0,0,0,0,0,0,0
13/6/2011,Benjamin Later,92017789,771,8/30/1986,24,0,0,0,0,50,3250,3250,80,65,10550,194,84,GK ,12,11,10,5,11,9,9,11,14,10,7,2,3,3,1,2,4,1,2,2,1,1,3,1,1,11,7,10,7,12,1,10,9,1,3,3,10,1,3,9,6,8,14,5,8,5,20,7,5,10,12,5,12,9,5,3,10,9,15,15,13,12,1,1,1,1,1,1,1,GK ,0,20,1,1,1,1,1,1,1,1,1,1,1,1,1,1,0,0,0,0,0,0,0,0,0,0,0,0,0,0,0,0,0,0,0,0,0,0,0,0,0,0,0,0,0,0,0,0,0,0,0,0,0,0,0,0,0,0,0,0,0,0,0,0,0
13/6/2011,Benjamin Kirsten,35004387,771,6/2/1987,24,0,0,0,0,3000,4900,4900,115,98,590599,182,75,GK ,14,14,10,8,10,8,14,15,12,8,10,8,1,1,1,6,10,1,3,3,1,3,1,1,8,11,11,14,6,14,3,14,9,3,11,2,12,1,4,6,10,13,11,3,7,10,20,8,8,10,17,5,10,10,6,10,12,8,14,17,12,7,1,1,1,1,1,1,1,GK ,0,20,1,1,1,1,1,1,1,1,1,1,1,1,1,1,0,0,0,0,0,0,0,0,0,0,0,0,0,0,0,0,0,0,0,0,0,0,0,0,0,0,0,0,0,0,0,0,0,0,0,0,0,0,0,0,0,0,0,0,0,0,0,0,0
13/6/2011,Benjamin Bertrand,85082471,769,6/24/1992,18,0,0,0,0,900,1800,1800,120,72,1217836,187,87,GK ,10,10,5,8,10,12,13,11,6,6,11,4,1,1,1,3,7,1,1,1,1,1,3,3,4,6,8,9,6,10,1,13,9,1,1,3,13,1,3,11,12,10,15,1,11,8,20,3,5,8,7,10,11,1,7,2,6,5,12,15,11,10,1,1,1,1,1,1,1,GK ,0,20,1,1,1,1,1,1,1,1,1,1,1,1,1,1,0,0,0,0,0,0,0,0,0,0,0,0,0,0,0,0,0,0,0,0,0,0,0,0,0,0,0,0,0,0,0,0,0,0,0,0,0,0,0,0,0,0,0,0,0,0,0,0,0
13/6/2011,Ben Foster,5104413,765,4/3/1983,28,5,0,0,0,5500,6750,6950,155,140,9200000,188,80,GK ,16,12,12,10,16,14,14,17,15,9,16,1,1,1,1,9,1,2,1,1,1,6,8,2,8,6,13,12,9,12,5,10,16,1,5,8,12,8,8,10,15,13,16,20,16,9,9,14,13,12,2,14,12,1,13,15,14,10,16,15,17,2,1,1,1,1,1,1,1,GK ,0,20,1,1,1,1,1,1,1,1,1,1,1,1,1,1,17179869184,0,0,0,0,0,0,0,0,0,0,0,0,0,0,0,0,0,0,0,0,0,0,0,0,0,0,0,0,0,0,0,0,0,0,1,0,0,0,0,0,0,0,0,0,0,0,0,0
13/6/2011,Bartosz Bialkowski,718036,787,7/6/1987,23,0,0,6,0,2000,3500,4500,126,92,99237,194,83,GK ,13,12,10,9,13,12,13,13,10,6,11,2,3,1,2,2,5,1,3,1,3,2,3,2,7,10,7,9,7,9,10,9,12,11,7,3,9,10,11,9,10,10,14,6,13,9,20,6,11,14,8,14,9,10,12,12,11,10,12,11,14,10,1,1,1,1,1,1,1,GK ,0,20,1,1,1,1,1,1,1,1,1,1,1,1,1,1,0,0,0,0,0,0,0,0,0,0,0,0,0,0,0,0,0,0,0,0,0,0,0,0,0,0,0,0,0,0,0,0,0,0,0,0,0,0,0,0,0,0,0,0,0,0,0,0,0
13/6/2011,Barel Mouko,8433747,49,4/5/1979,32,16,0,0,0,2550,5900,3900,120,118,1401546,177,71,GK ,11,13,14,11,12,9,12,16,12,11,13,5,2,1,2,7,9,2,6,2,2,9,13,2,7,5,15,13,13,11,7,11,15,7,14,3,9,13,12,11,15,11,8,1,13,14,20,13,11,13,5,13,7,1,13,12,12,13,15,15,15,9,1,1,1,1,1,1,1,GK ,0,20,1,1,1,1,1,1,1,1,1,1,1,1,1,1,0,0,0,0,0,0,0,0,0,0,0,0,0,0,0,0,0,0,0,0,0,0,0,0,0,0,0,0,0,0,0,0,0,0,0,0,0,0,0,0,0,0,0,0,0,0,0,0,0
13/6/2011,Baptiste Reynet,85076550,769,10/28/1990,20,0,0,0,0,2650,5354,5350,124,119,9804154,185,85,GK ,14,9,12,7,12,11,13,15,11,6,7,7,1,3,3,9,10,2,3,2,3,7,1,7,9,8,13,13,14,14,6,12,16,6,11,2,12,11,8,11,13,15,12,1,15,9,20,13,15,14,8,14,5,1,8,13,13,15,14,14,14,5,1,1,1,1,1,1,1,GK ,0,20,1,1,1,1,1,1,1,1,1,1,1,1,1,1,0,0,0,0,0,0,0,0,0,0,0,0,0,0,0,0,0,0,0,0,0,0,0,0,0,0,0,0,0,0,0,0,0,0,0,0,0,0,0,0,0,0,0,0,0,0,0,0,0
13/6/2011,Baba Tchagouni,12012407,50,12/31/1990,20,1,0,0,0,1350,5050,2750,126,101,3317507,186,81,GK ,13,11,11,7,14,12,11,11,9,8,7,8,3,2,1,6,10,1,2,2,1,8,2,3,6,12,11,13,14,14,7,11,17,6,9,3,8,2,12,7,11,14,13,1,15,9,20,6,14,14,13,10,5,1,14,12,11,13,15,15,15,6,1,1,1,1,1,1,1,GK ,0,20,1,1,1,1,1,1,1,1,1,1,1,1,1,1,0,0,0,0,0,0,0,0,0,0,0,0,0,0,0,0,0,0,0,0,0,0,0,0,0,0,0,0,0,0,0,0,0,0,0,0,0,0,0,0,0,0,0,0,0,0,0,0,0
13/6/2011,Aykut Özer,92019102,799,1/1/1993,18,0,0,0,0,500,4250,4250,119,85,537661,189,78,GK ,13,10,5,10,13,13,11,13,13,8,11,7,1,3,2,7,9,1,3,2,1,2,3,1,4,4,8,10,6,12,2,12,8,3,7,3,11,1,2,9,11,9,13,6,12,7,20,4,4,10,5,9,14,9,7,12,13,5,14,13,7,9,1,1,1,1,1,1,1,GK ,0,20,1,1,1,1,1,1,1,1,1,1,1,1,1,1,0,0,0,0,0,0,0,0,0,0,0,0,0,0,0,0,0,0,0,0,0,0,0,0,0,0,0,0,0,0,0,0,0,0,0,0,0,0,0,0,0,0,0,0,0,0,0,0,0
13/6/2011,Assis,55017365,1651,10/4/1989,21,0,0,0,0,500,750,3500,111,83,47428,187,85,GK ,13,10,13,11,10,13,12,12,11,10,10,4,2,3,3,8,6,2,1,3,3,2,2,1,4,6,9,14,9,6,1,9,9,1,12,1,12,1,3,8,11,9,11,10,17,6,20,7,3,10,5,10,10,9,11,17,7,6,9,6,7,14,1,1,1,1,1,1,1,GK ,0,20,1,1,1,1,1,1,1,1,1,1,1,1,1,1,0,0,0,0,0,0,0,0,0,0,0,0,0,0,0,0,0,0,0,0,0,0,0,0,0,0,0,0,0,0,0,0,0,0,0,0,0,0,0,0,0,0,0,0,0,0,0,0,0
13/6/2011,Asmir Begovic,5123112,759,6/20/1987,23,4,0,0,0,5400,6650,6900,163,139,12638115,196,84,GK ,16,13,14,11,14,14,13,16,14,10,11,5,3,2,2,11,10,3,1,3,2,14,12,3,9,12,10,14,12,12,13,13,14,7,12,2,12,10,9,10,12,8,20,7,15,10,20,12,14,15,8,14,3,10,12,11,8,8,8,9,10,12,1,1,1,1,1,1,1,GK ,0,20,1,1,1,1,1,1,1,1,1,1,1,1,1,1,0,0,0,0,0,0,0,0,0,0,0,0,0,0,0,0,0,0,0,0,0,0,0,0,0,0,0,0,0,0,0,0,0,0,0,0,0,0,0,0,0,0,0,0,0,0,0,0,0
13/6/2011,Asier Riesgo,823587,796,10/6/1983,27,0,0,10,0,4350,6500,6500,140,130,3234834,185,76,GK ,15,12,10,6,15,11,15,15,10,12,9,5,3,2,3,7,10,3,1,2,1,8,3,3,7,13,12,15,11,13,3,12,13,7,10,5,13,10,10,12,13,12,14,7,14,10,20,13,13,14,7,14,6,10,14,14,10,14,14,13,8,12,1,1,1,1,1,1,1,GK ,0,20,1,1,1,1,1,1,1,1,1,1,1,1,1,1,0,0,0,0,0,0,0,0,0,0,0,0,0,0,0,0,0,0,0,0,0,0,0,0,0,0,0,0,0,0,0,0,0,0,0,0,0,0,0,0,0,0,0,0,0,0,0,0,0
13/6/2011,Artur,312053,1651,1/25/1981,30,0,0,0,0,5800,6344,7050,143,141,34356129,192,90,GK ,15,14,12,4,16,14,15,16,11,11,13,6,3,2,1,8,10,1,2,2,1,9,14,12,8,10,10,15,10,14,4,13,14,11,12,3,14,14,12,7,10,10,15,6,14,9,20,13,13,14,8,10,6,4,16,12,10,10,17,13,13,6,1,1,1,1,1,1,1,GK ,0,20,1,1,1,1,1,1,1,1,1,1,1,1,1,1,0,0,0,0,0,0,0,0,0,0,0,0,0,0,0,0,0,0,0,0,0,0,0,0,0,0,0,0,0,0,0,0,0,0,0,0,0,0,0,0,0,0,0,0,0,0,0,0,0
13/6/2011,Artur Boruc,713854,787,2/20/1980,31,37,0,0,0,6000,6750,6950,141,139,12541395,194,88,GK ,15,13,16,20,15,14,16,18,15,11,14,5,1,1,2,1,8,2,2,1,2,2,13,3,5,12,13,13,14,4,11,11,14,3,11,8,11,12,12,7,15,10,15,5,10,9,20,7,14,11,8,17,7,10,17,15,18,8,4,6,6,20,1,1,1,1,1,1,1,GK ,0,20,1,1,1,1,1,1,1,1,1,1,1,1,1,1,0,0,0,0,0,0,0,0,0,0,0,0,0,0,0,0,0,0,0,0,0,0,0,0,0,0,0,0,0,0,0,0,0,0,0,0,0,0,0,0,0,0,0,0,0,0,0,0,0
13/6/2011,Arran Lee-Barrett,5104396,765,2/28/1984,27,0,0,0,0,2000,4750,4500,110,92,758208,188,77,GK ,10,10,14,1,11,12,13,13,10,4,12,5,1,1,1,4,8,3,2,3,2,3,2,3,8,12,10,10,7,10,7,10,12,7,8,8,7,10,8,10,10,13,14,7,10,10,20,11,10,8,10,8,1,10,10,9,10,9,10,9,8,2,1,1,1,1,1,1,1,GK ,0,20,1,1,1,1,1,1,1,1,1,1,1,1,1,1,0,0,0,0,0,0,0,0,0,0,0,0,0,0,0,0,0,0,0,0,0,0,0,0,0,0,0,0,0,0,0,0,0,0,0,0,0,0,0,0,0,0,0,0,0,0,0,0,0
13/6/2011,Arnaud Balijon,917113,769,6/17/1983,27,0,0,0,0,2650,4000,4000,130,120,896231,182,78,GK ,13,14,12,6,14,12,12,15,11,15,9,4,2,1,2,8,7,2,1,2,2,7,2,1,8,8,14,14,13,13,7,12,10,7,12,1,14,12,8,10,8,14,11,1,15,7,20,14,13,15,8,10,6,1,6,11,14,10,14,14,14,14,1,1,1,1,1,1,1,GK ,0,20,1,1,1,1,1,1,1,1,1,1,1,1,1,1,0,0,0,0,0,0,0,0,0,0,0,0,0,0,0,0,0,0,0,0,0,0,0,0,0,0,0,0,0,0,0,0,0,0,0,0,0,0,0,0,0,0,0,0,0,0,0,0,0
13/6/2011,Antonio Rosati,831722,776,3/26/1983,28,0,0,0,0,4500,6750,6750,142,135,4985076,195,90,GK ,18,14,14,10,13,13,13,18,7,15,12,1,1,5,1,10,1,5,5,1,5,6,7,5,8,12,15,13,11,12,5,11,14,3,5,3,12,10,13,8,11,11,18,5,16,10,20,13,17,12,7,13,10,13,9,15,14,15,14,15,15,4,1,1,1,1,1,1,1,GK ,0,20,1,1,1,1,1,1,1,1,1,1,1,1,1,1,0,0,0,0,0,0,0,0,0,0,0,0,0,0,0,0,0,0,0,0,0,0,0,0,0,0,0,0,0,0,0,0,0,0,0,0,0,0,0,0,0,0,0,0,0,0,0,0,0
13/6/2011,Antonio Mirante,830119,776,7/8/1983,27,0,0,0,0,5250,6900,6900,145,138,11007927,188,78,GK ,16,10,10,6,15,10,12,17,10,11,8,3,1,1,2,8,6,2,2,1,3,1,6,2,13,2,12,13,14,14,5,14,8,9,9,2,14,8,12,11,18,16,15,5,10,11,20,9,13,12,8,12,3,10,13,11,7,10,15,7,11,6,1,1,1,1,1,1,1,GK ,0,20,1,1,1,1,1,1,1,1,1,1,1,1,1,1,0,0,0,0,0,0,0,0,0,0,0,0,0,0,0,0,0,0,0,0,0,0,0,0,0,0,0,0,0,0,0,0,0,0,0,0,0,0,0,0,0,0,0,0,0,0,0,0,0
13/6/2011,António Filipe,8871521,788,4/14/1985,26,0,0,0,0,500,1500,3000,97,90,271457,190,82,GK ,12,10,12,12,12,8,9,10,8,12,9,2,3,2,2,1,7,1,1,2,2,1,2,1,2,14,8,10,12,11,1,12,6,3,11,2,12,1,1,11,16,13,13,9,13,9,20,2,5,9,3,7,10,10,13,13,13,11,13,15,5,14,1,1,1,1,1,1,1,GK ,0,20,1,1,1,1,1,1,1,1,1,1,1,1,1,1,0,0,0,0,0,0,0,0,0,0,0,0,0,0,0,0,0,0,0,0,0,0,0,0,0,0,0,0,0,0,0,0,0,0,0,0,0,0,0,0,0,0,0,0,0,0,0,0,0
13/6/2011,Antonio Donnarumma,43028661,776,7/7/1990,20,0,0,0,0,250,3850,3850,116,85,114714,192,96,GK ,9,8,9,12,11,11,13,12,12,10,7,1,1,1,1,1,1,1,1,1,1,5,1,1,1,13,8,11,9,10,4,9,15,1,5,1,9,5,12,8,12,13,17,5,15,10,20,14,15,12,8,7,9,1,10,15,16,13,17,14,15,6,1,1,1,1,1,1,1,GK ,0,20,1,1,1,1,1,1,1,1,1,1,1,1,1,1,0,0,0,0,0,0,0,0,0,0,0,0,0,0,0,0,0,0,0,0,0,0,0,0,0,0,0,0,0,0,0,0,0,0,0,0,0,0,0,0,0,0,0,0,0,0,0,0,0
13/6/2011,Antonio Donateo,43091122,776,2/28/1994,17,0,0,0,0,50,1950,1550,46,31,1235,185,83,GK ,3,9,6,7,8,8,5,11,13,4,8,3,2,3,2,4,4,1,3,2,2,1,1,2,2,10,3,8,3,11,1,9,5,1,5,1,10,1,1,3,13,12,13,6,15,3,20,1,4,7,15,10,4,9,11,11,12,6,10,14,11,7,1,1,1,1,1,1,1,GK ,0,20,1,1,1,1,1,1,1,1,1,1,1,1,1,1,0,0,0,0,0,0,0,0,0,0,0,0,0,0,0,0,0,0,0,0,0,0,0,0,0,0,0,0,0,0,0,0,0,0,0,0,0,0,0,0,0,0,0,0,0,0,0,0,0
13/6/2011,Antonio Doblas,6701756,796,8/5/1980,30,0,0,0,0,3800,6300,6300,140,128,699674,184,78,GK ,9,11,13,9,12,13,15,16,13,8,14,2,1,2,2,7,4,6,3,1,1,10,6,3,7,9,12,13,10,13,8,12,12,4,13,3,12,13,14,10,15,12,11,9,12,11,20,13,11,16,8,16,10,10,10,11,14,13,15,14,16,7,1,1,1,1,1,1,1,GK ,0,20,1,1,1,1,1,1,1,1,1,1,1,1,1,1,0,0,0,0,0,0,0,0,0,0,0,0,0,0,0,0,0,0,0,0,0,0,0,0,0,0,0,0,0,0,0,0,0,0,0,0,0,0,0,0,0,0,0,0,0,0,0,0,0
13/6/2011,Antonio Adán,7458290,796,5/13/1987,24,0,0,1,0,4350,6250,6250,144,127,-1,190,88,GK ,11,12,13,6,13,11,12,17,10,10,11,2,2,1,3,7,6,4,1,3,2,9,1,2,6,10,12,13,10,13,3,12,13,4,8,2,14,12,13,9,13,14,15,20,13,10,7,13,16,16,6,12,12,10,10,13,15,8,13,11,12,5,1,1,1,1,1,1,1,GK ,0,20,1,1,1,1,1,1,1,1,1,1,1,1,1,1,0,0,0,0,0,0,0,0,0,0,0,0,0,0,0,0,0,0,0,0,0,0,0,0,0,0,0,0,0,0,0,0,0,0,0,0,0,0,0,0,0,0,0,0,0,0,0,0,0
13/6/2011,Anthony Loustalot,85057578,769,3/30/1992,19,0,0,0,0,1100,3950,3950,115,88,2834684,183,77,GK ,14,8,8,6,10,10,12,12,9,9,7,6,1,3,1,8,10,1,3,1,1,8,3,2,8,11,13,14,12,12,11,10,14,6,6,1,9,2,9,11,11,13,11,1,15,7,20,6,13,14,11,14,11,10,12,14,14,14,16,16,16,5,1,1,1,1,1,1,1,GK ,0,20,1,1,1,1,1,1,1,1,1,1,1,1,1,1,0,0,0,0,0,0,0,0,0,0,0,0,0,0,0,0,0,0,0,0,0,0,0,0,0,0,0,0,0,0,0,0,0,0,0,0,0,0,0,0,0,0,0,0,0,0,0,0,0
13/6/2011,Anthony Lopes,85003956,788,10/1/1990,20,0,0,0,0,1150,4250,2100,141,85,104931,184,81,GK ,14,10,10,7,11,10,10,13,7,9,7,6,1,3,2,7,10,3,3,3,3,7,3,2,7,11,9,14,11,11,9,12,9,3,9,1,10,2,4,8,8,14,12,20,11,11,1,8,14,14,7,8,16,1,9,3,15,8,19,10,13,14,1,1,1,1,1,1,1,GK ,0,20,1,1,1,1,1,1,1,1,1,1,1,1,1,1,0,0,0,0,0,0,0,0,0,0,0,0,0,0,0,0,0,0,0,0,0,0,0,0,0,0,0,0,0,0,0,0,0,0,0,0,0,0,0,0,0,0,0,0,0,0,0,0,0
13/6/2011,Andy Lonergan,134134,765,10/19/1983,27,0,0,0,0,2900,5750,5750,130,115,2167964,191,77,GK ,11,10,9,8,14,10,17,16,11,8,13,3,2,2,3,8,7,3,2,3,3,2,3,1,4,7,8,12,9,12,6,10,13,2,9,1,12,11,5,9,11,12,16,20,9,9,8,10,12,10,7,10,16,10,5,12,15,10,14,12,14,5,1,1,1,1,1,1,1,GK ,0,20,1,1,1,1,1,1,1,1,1,1,1,1,1,1,0,0,0,0,0,0,0,0,0,0,0,0,0,0,0,0,0,0,0,0,0,0,0,0,0,0,0,0,0,0,0,0,0,0,0,0,0,0,0,0,0,0,0,0,0,0,0,0,0
13/6/2011,Andy Hubert,91005022,771,12/29/1990,20,0,0,0,0,1500,3950,3950,105,79,55784,192,75,GK ,13,6,7,8,11,10,12,13,4,4,11,3,2,3,2,2,6,2,2,3,3,1,2,1,4,6,3,11,7,10,1,11,7,1,13,3,13,1,2,5,12,9,15,3,14,6,20,3,5,10,3,10,10,9,13,10,13,15,18,12,12,10,1,1,1,1,1,1,1,GK ,0,20,1,1,1,1,1,1,1,1,1,1,1,1,1,1,0,0,0,0,0,0,0,0,0,0,0,0,0,0,0,0,0,0,0,0,0,0,0,0,0,0,0,0,0,0,0,0,0,0,0,0,0,0,0,0,0,0,0,0,0,0,0,0,0
13/6/2011,Andrés,67015052,796,12/17/1986,24,0,0,0,0,4250,6250,6250,145,127,3280974,184,86,GK ,10,12,11,6,14,11,13,16,11,9,13,6,1,1,2,8,8,6,2,3,2,10,3,3,9,10,12,13,11,13,6,12,8,6,10,2,11,11,13,10,14,13,11,11,13,12,20,13,15,16,7,11,7,10,15,13,11,16,9,10,14,14,1,1,1,1,1,1,1,GK ,0,20,1,1,1,1,1,1,1,1,1,1,1,1,1,1,0,0,0,0,0,0,0,0,0,0,0,0,0,0,0,0,0,0,0,0,0,0,0,0,0,0,0,0,0,0,0,0,0,0,0,0,0,0,0,0,0,0,0,0,0,0,0,0,0
13/6/2011,Andrés Palop,14664,796,10/22/1973,37,0,0,0,0,5100,6750,6750,155,134,2423467,184,75,GK ,13,14,15,8,13,14,15,14,12,14,14,8,3,3,3,4,10,2,2,2,1,1,3,2,8,9,13,15,11,10,3,12,18,3,18,3,13,14,13,8,11,11,13,2,10,10,20,10,12,15,19,13,11,10,14,12,18,16,15,6,5,13,1,1,1,1,1,1,1,GK ,0,20,1,1,1,1,1,1,1,1,1,1,1,1,1,1,65536,0,0,0,0,0,0,0,0,0,0,0,0,0,0,0,0,1,0,0,0,0,0,0,0,0,0,0,0,0,0,0,0,0,0,0,0,0,0,0,0,0,0,0,0,0,0,0,0
13/6/2011,Andreas Luthe,35006335,771,3/10/1987,24,0,0,0,0,4000,5900,5900,135,118,2239965,194,90,GK ,13,12,13,11,12,12,12,15,10,11,11,4,2,2,2,11,8,3,1,2,2,10,3,1,6,11,11,11,10,15,14,11,10,9,16,10,7,14,15,10,13,12,17,5,12,9,20,13,12,14,5,15,5,10,10,10,10,10,10,12,14,2,1,1,1,1,1,1,1,GK ,0,20,1,1,1,1,1,1,1,1,1,1,1,1,1,1,0,0,0,0,0,0,0,0,0,0,0,0,0,0,0,0,0,0,0,0,0,0,0,0,0,0,0,0,0,0,0,0,0,0,0,0,0,0,0,0,0,0,0,0,0,0,0,0,0
13/6/2011,Andreas Lengsfeld,35005008,771,5/16/1986,25,0,0,0,0,750,4100,4100,95,82,19118,186,87,GK ,8,8,12,9,11,11,12,13,13,8,10,4,2,3,3,7,8,1,1,2,3,1,2,2,5,9,9,9,10,10,9,9,10,9,10,7,7,11,10,10,10,11,15,5,12,10,20,12,14,8,6,9,11,10,4,12,6,9,16,6,11,14,1,1,1,1,1,1,1,GK ,0,20,1,1,1,1,1,1,1,1,1,1,1,1,1,1,0,0,0,0,0,0,0,0,0,0,0,0,0,0,0,0,0,0,0,0,0,0,0,0,0,0,0,0,0,0,0,0,0,0,0,0,0,0,0,0,0,0,0,0,0,0,0,0,0
13/6/2011,Andrea Seculin,43007283,776,7/14/1990,20,0,0,4,0,850,2450,4900,125,95,384808,185,78,GK ,11,11,11,11,10,8,10,16,11,11,9,7,2,2,2,4,10,2,3,3,1,1,1,1,7,11,8,14,12,10,5,8,13,11,5,5,10,9,13,12,13,12,14,5,13,9,20,9,13,7,7,9,7,10,11,15,10,9,15,13,16,2,1,1,1,1,1,1,1,GK ,0,20,1,1,1,1,1,1,1,1,1,1,1,1,1,1,0,0,0,0,0,0,0,0,0,0,0,0,0,0,0,0,0,0,0,0,0,0,0,0,0,0,0,0,0,0,0,0,0,0,0,0,0,0,0,0,0,0,0,0,0,0,0,0,0
13/6/2011,Andrea Sala,43075155,776,1/6/1993,18,0,0,0,0,50,2850,2850,72,62,65705,186,89,GK ,14,6,10,12,10,11,10,14,12,13,10,7,1,2,1,4,10,1,3,2,3,1,1,3,4,13,6,10,6,9,1,8,7,1,4,1,6,1,2,9,11,8,14,8,9,5,20,3,5,8,10,10,10,7,14,15,8,13,14,9,5,9,1,1,1,1,1,1,1,GK ,0,20,1,1,1,1,1,1,1,1,1,1,1,1,1,1,0,0,0,0,0,0,0,0,0,0,0,0,0,0,0,0,0,0,0,0,0,0,0,0,0,0,0,0,0,0,0,0,0,0,0,0,0,0,0,0,0,0,0,0,0,0,0,0,0
13/6/2011,Andrea Consigli,7990128,776,1/27/1987,24,0,0,24,0,4750,6500,6750,156,134,8788209,187,77,GK ,13,12,12,5,13,12,13,17,11,14,10,1,1,1,1,9,1,3,1,1,1,10,1,1,11,8,14,15,10,13,8,11,15,5,10,1,13,11,13,11,17,13,15,5,10,11,20,13,13,13,1,10,4,1,10,17,18,7,17,15,18,10,1,1,1,1,1,1,1,GK ,0,20,1,1,1,1,1,1,1,1,1,1,1,1,1,1,0,0,0,0,0,0,0,0,0,0,0,0,0,0,0,0,0,0,0,0,0,0,0,0,0,0,0,0,0,0,0,0,0,0,0,0,0,0,0,0,0,0,0,0,0,0,0,0,0
13/6/2011,Andrea Cano,703318,776,4/18/1976,35,0,0,0,0,3000,5000,5000,116,109,413895,185,82,GK ,10,11,10,9,16,9,14,15,9,6,12,4,1,3,2,12,6,1,4,3,3,12,1,3,5,5,12,11,10,11,8,13,16,2,13,2,11,7,11,7,11,12,11,8,4,5,20,10,6,10,3,10,10,10,3,14,15,11,8,10,18,6,1,1,1,1,1,1,1,GK ,0,20,1,1,1,1,1,1,1,1,1,1,1,1,1,1,0,0,0,0,0,0,0,0,0,0,0,0,0,0,0,0,0,0,0,0,0,0,0,0,0,0,0,0,0,0,0,0,0,0,0,0,0,0,0,0,0,0,0,0,0,0,0,0,0
13/6/2011,Andrea Campagnolo,3801592,776,6/17/1978,32,0,0,0,0,2250,5450,5450,119,109,1396996,184,80,GK ,13,11,11,10,13,12,13,15,13,14,14,4,3,4,2,5,7,10,14,1,3,6,8,2,5,11,12,12,11,11,12,11,15,7,7,9,11,12,11,9,9,10,12,5,11,9,20,9,12,12,12,15,11,1,10,11,11,9,20,12,9,4,1,1,1,1,1,1,1,GK ,0,20,1,1,1,1,1,1,1,1,1,1,1,1,1,1,0,0,0,0,0,0,0,0,0,0,0,0,0,0,0,0,0,0,0,0,0,0,0,0,0,0,0,0,0,0,0,0,0,0,0,0,0,0,0,0,0,0,0,0,0,0,0,0,0
13/6/2011,André Poggenborg,890487,771,9/17/1983,27,0,0,0,0,1250,4450,4450,100,89,123164,186,86,GK ,13,12,13,15,12,7,9,11,10,5,9,4,3,2,2,1,8,1,2,1,1,1,1,3,6,8,7,13,10,8,1,11,8,2,10,1,13,1,2,7,13,13,13,4,7,6,20,1,10,10,8,10,6,10,5,12,13,12,6,11,6,6,1,1,1,1,1,1,1,GK ,0,20,1,1,1,1,1,1,1,1,1,1,1,1,1,1,0,0,0,0,0,0,0,0,0,0,0,0,0,0,0,0,0,0,0,0,0,0,0,0,0,0,0,0,0,0,0,0,0,0,0,0,0,0,0,0,0,0,0,0,0,0,0,0,0
13/6/2011,André Lenz,3601266,771,11/19/1973,37,0,0,0,0,3350,5500,5750,127,115,520987,191,93,GK ,11,12,14,9,14,11,11,14,11,15,11,6,2,3,2,7,10,2,1,3,1,8,1,12,8,10,11,14,11,11,3,9,13,3,12,3,12,10,12,11,12,12,13,4,13,11,20,12,13,12,7,10,14,10,9,13,14,13,12,13,13,7,1,1,1,1,1,1,1,GK ,0,20,1,1,1,1,1,1,1,1,1,1,1,1,1,1,0,0,0,0,0,0,0,0,0,0,0,0,0,0,0,0,0,0,0,0,0,0,0,0,0,0,0,0,0,0,0,0,0,0,0,0,0,0,0,0,0,0,0,0,0,0,0,0,0
13/6/2011,Andrade,306170,1651,3/30/1979,32,0,0,0,0,4150,5200,5200,130,116,3636415,190,85,GK ,11,9,13,14,12,7,12,15,11,18,13,8,2,8,3,8,10,8,2,1,3,6,7,1,8,8,11,15,13,10,9,12,14,8,12,1,11,12,11,12,14,15,15,5,14,9,20,12,16,12,8,12,5,10,15,12,12,9,16,12,13,5,1,1,1,1,1,1,1,GK ,0,20,1,1,1,1,1,1,1,1,1,1,1,1,1,1,0,0,0,0,0,0,0,0,0,0,0,0,0,0,0,0,0,0,0,0,0,0,0,0,0,0,0,0,0,0,0,0,0,0,0,0,0,0,0,0,0,0,0,0,0,0,0,0,0
13/6/2011,Anders Lindegaard,930416,764,4/13/1984,27,4,0,0,0,5000,7000,6750,159,135,15007499,193,80,GK ,15,13,13,6,14,16,12,14,12,7,10,4,1,1,2,8,9,1,2,3,3,8,3,3,9,4,12,14,14,12,3,13,15,3,10,2,14,14,10,7,14,10,15,9,14,9,20,8,13,14,12,14,8,10,12,18,6,11,15,14,10,16,1,1,1,1,1,1,1,GK ,0,20,1,1,1,1,1,1,1,1,1,1,1,1,1,1,0,0,0,0,0,0,0,0,0,0,0,0,0,0,0,0,0,0,0,0,0,0,0,0,0,0,0,0,0,0,0,0,0,0,0,0,0,0,0,0,0,0,0,0,0,0,0,0,0
13/6/2011,Alphonse Areola,85027976,769,2/27/1993,18,0,0,0,0,1300,2600,2600,174,104,6050389,191,88,GK ,14,9,10,9,14,9,12,12,11,8,6,8,2,2,3,6,10,2,11,1,1,8,3,2,6,8,12,12,12,12,6,11,14,8,9,1,10,11,5,13,12,17,15,1,13,9,20,13,17,14,8,13,10,1,11,14,14,15,15,17,17,5,5,5,1,1,1,5,1,GK ,0,20,1,1,1,1,1,1,5,1,1,1,1,1,5,1,0,0,0,0,0,0,0,0,0,0,0,0,0,0,0,0,0,0,0,0,0,0,0,0,0,0,0,0,0,0,0,0,0,0,0,0,0,0,0,0,0,0,0,0,0,0,0,0,0
13/6/2011,Ali Al-Habsi,761727,130,12/30/1981,29,70,0,0,0,5000,7590,6700,150,138,12637166,194,88,GK ,14,16,10,10,13,12,15,15,11,10,14,7,2,1,1,13,10,2,1,17,1,14,3,1,13,8,15,14,13,15,5,13,14,6,9,9,11,9,8,10,14,14,16,8,10,10,20,13,13,16,2,17,6,10,18,13,11,14,11,14,10,6,1,1,1,1,1,1,1,GK ,0,20,1,1,1,1,1,1,1,1,1,1,1,1,1,1,0,0,0,0,0,0,0,0,0,0,0,0,0,0,0,0,0,0,0,0,0,0,0,0,0,0,0,0,0,0,0,0,0,0,0,0,0,0,0,0,0,0,0,0,0,0,0,0,0
13/6/2011,Alexis Thébaux,918781,769,3/17/1985,26,0,0,2,0,4650,5850,5850,136,130,5081758,185,81,GK ,12,13,14,7,13,15,12,16,12,14,8,8,1,2,2,8,10,2,12,1,3,7,1,2,8,8,12,14,12,12,6,13,14,6,11,2,12,11,11,13,13,14,12,1,15,10,20,13,14,15,8,14,6,1,5,13,12,11,15,15,15,7,1,1,1,1,1,1,1,GK ,0,20,1,1,1,1,1,1,1,1,1,1,1,1,1,1,0,0,0,0,0,0,0,0,0,0,0,0,0,0,0,0,0,0,0,0,0,0,0,0,0,0,0,0,0,0,0,0,0,0,0,0,0,0,0,0,0,0,0,0,0,0,0,0,0
13/6/2011,Alexandros Tzorvas,687055,772,8/12/1982,28,13,0,2,0,5000,6500,6500,135,130,5584473,190,79,GK ,11,12,14,6,13,12,12,17,8,13,12,7,3,2,2,6,10,3,1,1,1,7,1,2,8,13,13,14,9,12,9,9,17,2,12,1,12,1,12,14,16,13,15,5,10,14,20,7,11,10,4,13,4,10,5,14,7,13,17,14,8,8,1,1,1,1,1,1,1,GK ,0,20,1,1,1,1,1,1,1,1,1,1,1,1,1,1,0,0,0,0,0,0,0,0,0,0,0,0,0,0,0,0,0,0,0,0,0,0,0,0,0,0,0,0,0,0,0,0,0,0,0,0,0,0,0,0,0,0,0,0,0,0,0,0,0
13/6/2011,Alexander Stolz,8713618,771,10/13/1983,27,0,0,0,0,2500,5750,5750,120,118,1606819,189,85,GK ,16,12,12,4,12,10,15,16,9,9,11,7,2,3,1,8,10,2,2,2,3,4,3,3,6,5,13,14,10,7,2,15,9,1,6,3,14,3,4,11,12,12,15,4,13,12,20,9,13,10,5,10,9,10,6,8,16,14,10,11,14,14,1,1,1,1,1,1,1,GK ,0,20,1,1,1,1,1,1,1,1,1,1,1,1,1,1,0,0,0,0,0,0,0,0,0,0,0,0,0,0,0,0,0,0,0,0,0,0,0,0,0,0,0,0,0,0,0,0,0,0,0,0,0,0,0,0,0,0,0,0,0,0,0,0,0
13/6/2011,Alexander Stephan,8707687,771,9/15/1986,24,0,0,0,0,3000,5500,5000,130,110,1786350,189,81,GK ,11,12,12,13,12,12,13,13,13,10,12,4,1,2,2,11,7,9,2,1,3,11,2,1,10,11,12,9,11,9,9,11,13,5,6,7,12,13,11,12,12,14,16,7,13,12,20,14,14,10,7,10,4,10,7,12,6,8,15,6,6,13,1,1,1,1,1,1,1,GK ,0,20,1,1,1,1,1,1,1,1,1,1,1,1,1,1,0,0,0,0,0,0,0,0,0,0,0,0,0,0,0,0,0,0,0,0,0,0,0,0,0,0,0,0,0,0,0,0,0,0,0,0,0,0,0,0,0,0,0,0,0,0,0,0,0
13/6/2011,Alexander Schwolow,91105570,771,6/2/1992,19,0,0,0,0,1000,4050,4050,104,91,835626,190,71,GK ,13,11,10,11,10,12,10,12,12,4,9,5,1,1,3,4,9,2,3,1,2,1,1,3,3,7,5,10,10,13,1,13,8,1,4,3,10,1,3,8,16,14,13,12,9,10,20,7,5,10,8,10,7,9,17,20,12,16,15,14,11,6,1,1,1,1,1,1,1,GK ,0,20,1,1,1,1,1,1,1,1,1,1,1,1,1,1,0,0,0,0,0,0,0,0,0,0,0,0,0,0,0,0,0,0,0,0,0,0,0,0,0,0,0,0,0,0,0,0,0,0,0,0,0,0,0,0,0,0,0,0,0,0,0,0,0
13/6/2011,Alexander Manninger,2000348,755,6/4/1977,34,32,0,0,0,4500,6750,6750,145,135,2454331,188,84,GK ,13,9,12,5,15,12,12,15,7,12,13,1,1,1,1,7,1,10,1,1,1,10,8,12,10,10,10,14,12,14,12,15,16,8,8,8,14,12,1,9,15,11,15,9,14,10,20,14,14,12,4,12,6,1,15,17,14,16,16,15,14,4,1,1,1,1,1,1,1,GK ,0,20,1,1,1,1,1,1,1,1,1,1,1,1,1,1,0,0,0,0,0,0,0,0,0,0,0,0,0,0,0,0,0,0,0,0,0,0,0,0,0,0,0,0,0,0,0,0,0,0,0,0,0,0,0,0,0,0,0,0,0,0,0,0,0
13/6/2011,Alexander Jäger,91105571,771,12/27/1986,24,0,0,0,0,750,2500,2500,90,70,46054,186,85,GK ,12,11,7,14,10,10,8,12,7,6,8,2,1,3,2,4,7,1,1,2,2,1,1,2,1,11,7,10,8,11,1,11,9,2,7,3,11,1,3,8,8,11,10,8,16,7,20,7,7,10,8,10,5,10,5,14,10,16,15,16,13,13,1,1,1,1,1,1,1,GK ,0,20,1,1,1,1,1,1,1,1,1,1,1,1,1,1,0,0,0,0,0,0,0,0,0,0,0,0,0,0,0,0,0,0,0,0,0,0,0,0,0,0,0,0,0,0,0,0,0,0,0,0,0,0,0,0,0,0,0,0,0,0,0,0,0
13/6/2011,Alex McCarthy,8601160,765,12/3/1989,21,0,0,3,0,3000,5350,5350,140,105,1306211,194,79,GK ,15,8,7,5,12,15,10,14,8,9,12,5,3,2,1,10,9,1,3,2,1,10,3,2,14,5,9,10,7,9,7,10,10,2,5,3,11,1,7,12,15,10,15,15,12,10,20,12,10,10,2,10,5,10,18,20,8,10,13,16,13,11,1,1,1,1,1,1,1,GK ,0,20,1,1,1,1,1,1,1,1,1,1,1,1,1,1,0,0,0,0,0,0,0,0,0,0,0,0,0,0,0,0,0,0,0,0,0,0,0,0,0,0,0,0,0,0,0,0,0,0,0,0,0,0,0,0,0,0,0,0,0,0,0,0,0
13/6/2011,Alex Calderoni,3802150,776,5/31/1976,35,0,0,0,0,2150,4900,4900,121,102,850776,182,77,GK ,11,11,10,11,13,10,10,12,12,14,10,2,1,3,1,8,6,3,2,2,3,1,2,2,4,15,9,14,11,11,11,10,13,5,10,9,14,10,15,7,13,14,12,20,11,10,5,11,15,13,11,13,11,10,9,12,14,11,17,14,15,1,1,1,1,1,1,1,1,GK ,0,20,1,1,1,1,1,1,1,1,1,1,1,1,1,1,0,0,0,0,0,0,0,0,0,0,0,0,0,0,0,0,0,0,0,0,0,0,0,0,0,0,0,0,0,0,0,0,0,0,0,0,0,0,0,0,0,0,0,0,0,0,0,0,0
13/6/2011,Alessio Scarpi,12082,776,4/19/1973,38,0,0,0,0,4500,5850,5850,125,114,436913,188,81,GK ,12,10,13,4,13,13,13,12,9,12,12,1,1,1,1,1,1,1,1,1,1,6,2,2,5,7,14,15,14,10,8,10,13,2,18,5,15,12,8,10,11,13,15,5,14,10,20,14,12,8,7,15,4,1,10,10,17,13,18,15,10,3,1,1,1,1,1,1,1,GK ,0,20,1,1,1,1,1,1,1,1,1,1,1,1,1,1,0,0,0,0,0,0,0,0,0,0,0,0,0,0,0,0,0,0,0,0,0,0,0,0,0,0,0,0,0,0,0,0,0,0,0,0,0,0,0,0,0,0,0,0,0,0,0,0,0
13/6/2011,Alejandro,67136048,796,4/20/1990,21,0,0,0,0,1100,2600,2600,92,62,1150,181,75,GK ,9,11,11,6,11,8,8,11,8,10,9,4,3,1,3,1,6,2,1,3,1,1,3,2,2,15,6,10,5,13,1,6,8,2,13,3,10,2,2,9,12,9,7,2,13,10,20,5,10,8,15,7,15,8,10,5,8,8,8,7,6,14,1,1,1,1,1,1,1,GK ,0,20,1,1,1,1,1,1,1,1,1,1,1,1,1,1,0,0,0,0,0,0,0,0,0,0,0,0,0,0,0,0,0,0,0,0,0,0,0,0,0,0,0,0,0,0,0,0,0,0,0,0,0,0,0,0,0,0,0,0,0,0,0,0,0
13/6/2011,Alberto Maria Fontana,706751,776,12/2/1974,36,0,0,0,0,50,4500,4500,95,95,461779,188,83,GK ,11,12,12,16,10,9,12,10,15,13,8,8,3,1,3,3,10,2,2,2,3,6,3,2,8,15,10,13,10,13,2,11,20,2,13,2,12,13,14,10,13,10,9,5,10,9,20,15,10,12,2,18,8,9,11,8,15,15,17,20,12,1,1,1,1,1,1,1,1,GK ,0,20,1,1,1,1,1,1,1,1,1,1,1,1,1,1,0,0,0,0,0,0,0,0,0,0,0,0,0,0,0,0,0,0,0,0,0,0,0,0,0,0,0,0,0,0,0,0,0,0,0,0,0,0,0,0,0,0,0,0,0,0,0,0,0
13/6/2011,Alberto García,1507660,796,2/9/1985,26,0,0,0,0,3050,5000,5000,115,104,1005339,182,77,GK ,11,10,11,9,12,9,12,14,12,11,11,4,3,3,1,7,9,2,2,3,1,3,1,2,3,4,12,10,10,13,6,10,10,8,9,7,11,10,9,11,15,11,12,5,13,12,20,14,12,12,9,9,17,10,8,13,14,11,10,6,13,13,1,1,1,1,1,1,1,GK ,0,20,1,1,1,1,1,1,1,1,1,1,1,1,1,1,0,0,0,0,0,0,0,0,0,0,0,0,0,0,0,0,0,0,0,0,0,0,0,0,0,0,0,0,0,0,0,0,0,0,0,0,0,0,0,0,0,0,0,0,0,0,0,0,0
13/6/2011,Alberto Gallinetta,43029907,776,4/16/1992,19,0,0,0,0,1000,3350,3350,86,75,1175458,195,90,GK ,13,11,12,9,12,12,9,8,11,9,12,1,3,3,2,3,6,1,1,3,2,1,3,3,4,6,10,9,6,13,1,11,9,1,9,1,14,3,4,4,8,10,15,5,14,6,20,8,6,9,6,10,10,8,13,14,14,6,18,14,12,9,1,1,1,1,1,1,1,GK ,0,20,1,1,1,1,1,1,1,1,1,1,1,1,1,1,0,0,0,0,0,0,0,0,0,0,0,0,0,0,0,0,0,0,0,0,0,0,0,0,0,0,0,0,0,0,0,0,0,0,0,0,0,0,0,0,0,0,0,0,0,0,0,0,0
13/6/2011,Alberto Cifuentes,6705830,796,5/29/1979,32,0,0,0,0,3350,5250,5250,117,109,249336,189,79,GK ,11,12,12,7,12,13,12,14,13,12,7,3,2,3,3,5,4,2,3,2,3,3,3,1,4,10,6,11,6,12,1,12,9,12,13,3,14,3,5,13,14,10,10,4,11,7,20,9,13,14,8,10,7,10,11,12,13,9,7,10,9,10,1,1,1,1,1,1,1,GK ,0,20,1,1,1,1,1,1,1,1,1,1,1,1,1,1,0,0,0,0,0,0,0,0,0,0,0,0,0,0,0,0,0,0,0,0,0,0,0,0,0,0,0,0,0,0,0,0,0,0,0,0,0,0,0,0,0,0,0,0,0,0,0,0,0
13/6/2011,Albano Bizzarri,108425,1649,11/9/1977,33,0,0,0,0,5000,5950,6350,140,125,1715189,193,89,GK ,12,13,15,16,13,12,15,15,15,16,12,8,1,3,2,5,10,5,1,3,1,5,2,1,5,10,14,11,13,13,10,10,15,8,8,2,17,10,12,10,11,12,16,5,12,10,20,14,12,15,5,17,10,10,14,15,11,15,15,19,12,10,1,1,1,1,1,1,1,GK ,0,20,1,1,1,1,1,1,1,1,1,1,1,1,1,1,0,0,0,0,0,0,0,0,0,0,0,0,0,0,0,0,0,0,0,0,0,0,0,0,0,0,0,0,0,0,0,0,0,0,0,0,0,0,0,0,0,0,0,0,0,0,0,0,0
13/6/2011,Aitor Fernández,67054783,796,5/3/1991,20,0,0,0,0,2000,4250,4250,137,93,1541723,182,70,GK ,13,11,9,4,12,14,12,14,15,8,9,2,2,2,2,3,7,3,1,3,3,2,3,3,5,13,9,13,10,9,11,11,9,2,6,3,9,2,4,12,13,14,11,9,10,8,20,5,6,10,7,10,12,9,9,1,6,12,8,11,13,9,1,1,1,1,1,1,1,GK ,0,20,1,1,1,1,1,1,1,1,1,1,1,1,1,1,0,0,0,0,0,0,0,0,0,0,0,0,0,0,0,0,0,0,0,0,0,0,0,0,0,0,0,0,0,0,0,0,0,0,0,0,0,0,0,0,0,0,0,0,0,0,0,0,0
13/6/2011,Ahmed Ghazi,43093059,16,1/8/1995,16,0,0,0,0,50,1550,1650,58,33,3027,188,83,GK ,3,11,4,8,12,10,8,7,5,10,10,2,2,2,1,2,4,1,3,3,3,1,2,2,2,8,3,10,8,8,1,7,8,2,10,3,6,1,1,5,14,12,11,7,14,3,20,5,3,6,12,8,10,8,10,18,14,11,15,7,6,7,1,1,1,1,1,1,1,GK ,0,20,1,1,1,1,1,1,1,1,1,1,1,1,1,1,0,0,0,0,0,0,0,0,0,0,0,0,0,0,0,0,0,0,0,0,0,0,0,0,0,0,0,0,0,0,0,0,0,0,0,0,0,0,0,0,0,0,0,0,0,0,0,0,0
13/6/2011,Adriano,19014043,1651,3/12/1983,28,0,0,0,0,1000,5400,3200,121,105,258814,187,78,GK ,12,11,11,3,10,11,13,12,8,11,11,6,2,2,2,8,10,4,3,2,1,4,2,1,9,5,13,11,11,14,12,15,15,8,10,2,11,8,13,10,13,9,13,8,17,6,20,12,12,12,10,12,12,10,12,14,16,16,17,14,14,7,1,1,1,1,1,1,1,GK ,0,20,1,1,1,1,1,1,1,1,1,1,1,1,1,1,0,0,0,0,0,0,0,0,0,0,0,0,0,0,0,0,0,0,0,0,0,0,0,0,0,0,0,0,0,0,0,0,0,0,0,0,0,0,0,0,0,0,0,0,0,0,0,0,0
13/6/2011,Adriano Basso,6900126,1651,4/18/1975,36,0,0,0,0,3250,4700,4900,130,114,330923,185,74,GK ,13,13,8,9,13,11,14,14,10,13,13,5,3,3,1,9,10,2,1,2,2,10,2,2,9,2,13,8,12,13,9,11,17,11,10,2,13,4,9,8,14,7,13,5,18,9,20,19,14,14,4,14,10,10,12,16,9,14,9,13,17,12,1,1,1,1,1,1,1,GK ,0,20,1,1,1,1,1,1,1,1,1,1,1,1,1,1,2199023255552,0,0,0,0,0,0,0,0,0,0,0,0,0,0,0,0,0,0,0,0,0,0,0,0,0,0,0,0,0,0,0,0,0,0,0,0,0,0,0,0,0,1,0,0,0,0,0,0
13/6/2011,Adrián Murcia,67013847,796,7/7/1991,19,0,0,0,0,1500,3250,3250,90,65,22993,185,77,GK ,8,13,10,3,9,13,10,13,8,3,8,1,3,1,2,3,4,1,1,1,1,1,3,2,7,4,7,10,7,7,2,5,7,1,8,3,12,2,2,7,15,15,13,8,15,9,20,4,4,7,11,9,10,7,6,12,11,5,13,9,13,7,1,1,1,1,1,1,1,GK ,0,20,1,1,1,1,1,1,1,1,1,1,1,1,1,1,0,0,0,0,0,0,0,0,0,0,0,0,0,0,0,0,0,0,0,0,0,0,0,0,0,0,0,0,0,0,0,0,0,0,0,0,0,0,0,0,0,0,0,0,0,0,0,0,0
13/6/2011,Adam Legzdins,103737,765,11/23/1986,24,0,0,0,0,1900,4800,4800,128,96,780403,183,78,GK ,10,11,10,9,13,11,13,14,10,6,10,2,3,3,1,4,4,1,2,3,1,3,2,2,2,9,10,13,4,9,6,9,11,10,6,2,9,10,9,9,11,11,14,13,12,7,20,5,13,9,8,13,4,10,13,13,7,12,10,10,10,3,1,1,1,1,1,1,1,GK ,0,20,1,1,1,1,1,1,1,1,1,1,1,1,1,1,0,0,0,0,0,0,0,0,0,0,0,0,0,0,0,0,0,0,0,0,0,0,0,0,0,0,0,0,0,0,0,0,0,0,0,0,0,0,0,0,0,0,0,0,0,0,0,0,0
13/6/2011,Adam Federici,1301880,1435,1/31/1985,26,4,0,5,0,3750,6100,6100,140,123,3512872,188,90,GK ,15,11,8,8,15,16,15,16,7,6,11,5,1,2,3,14,10,1,1,3,2,13,2,2,14,9,11,10,10,9,12,9,12,5,7,7,10,9,8,10,14,12,15,10,13,9,20,9,16,14,5,16,5,10,18,10,12,10,15,15,10,10,1,1,1,1,1,1,1,GK ,0,20,1,1,1,1,1,1,1,1,1,1,1,1,1,1,0,0,0,0,0,0,0,0,0,0,0,0,0,0,0,0,0,0,0,0,0,0,0,0,0,0,0,0,0,0,0,0,0,0,0,0,0,0,0,0,0,0,0,0,0,0,0,0,0
13/6/2011,Ádám Bogdán,38000461,773,9/27/1987,23,0,0,7,0,3400,5500,5500,156,112,3309625,194,90,GK ,13,13,11,4,13,13,12,12,13,11,12,5,1,2,1,7,7,2,1,2,3,11,1,3,11,14,14,13,12,12,8,12,8,5,7,8,13,11,9,11,13,11,16,5,9,11,20,11,15,12,3,6,4,10,8,10,11,9,11,13,14,7,1,1,1,1,1,1,1,GK ,0,20,1,1,1,1,1,1,1,1,1,1,1,1,1,1,0,0,0,0,0,0,0,0,0,0,0,0,0,0,0,0,0,0,0,0,0,0,0,0,0,0,0,0,0,0,0,0,0,0,0,0,0,0,0,0,0,0,0,0,0,0,0,0,0
13/6/2011,Abdoulaye Keita,34011754,769,8/19/1990,20,0,0,0,0,2400,4859,4850,140,108,2155854,188,83,GK ,13,11,10,8,12,13,13,14,12,10,6,4,2,1,2,9,9,3,3,3,3,7,1,1,9,7,12,13,11,11,8,10,14,6,8,2,10,11,8,12,13,15,14,1,13,7,20,13,15,14,7,13,10,1,5,14,9,13,15,13,13,11,1,1,1,1,1,1,1,GK ,0,20,1,1,1,1,1,1,1,1,1,1,1,1,1,1,0,0,0,0,0,0,0,0,0,0,0,0,0,0,0,0,0,0,0,0,0,0,0,0,0,0,0,0,0,0,0,0,0,0,0,0,0,0,0,0,0,0,0,0,0,0,0,0,0
13/6/2011,Abdoulaye Diallo,85058785,769,3/30/1992,19,0,0,0,0,2300,4634,4600,142,103,1893982,189,80,GK ,11,10,12,7,10,12,13,15,11,7,14,7,2,3,1,7,9,2,3,2,1,3,1,2,7,13,12,14,12,12,2,9,10,1,8,1,7,2,8,11,11,15,14,1,15,8,20,13,15,14,4,10,5,1,12,7,13,5,8,14,14,14,1,1,1,1,1,1,1,GK ,0,20,1,1,1,1,1,1,1,1,1,1,1,1,1,1,0,0,0,0,0,0,0,0,0,0,0,0,0,0,0,0,0,0,0,0,0,0,0,0,0,0,0,0,0,0,0,0,0,0,0,0,0,0,0,0,0,0,0,0,0,0,0,0,0
