GameDate,FMRTEVersion,Name,UID,NationID,Born,Age,IntCaps,IntGoals,U21Caps,U21Goals,WorldReputation,HomeReputation,CurrentReputation,PA,CA,Price,Height,Weight,PositionsString,GK.AerialAbility,GK.CommandOfArea,GK.Communication,GK.Eccentricity,GK.Handling,GK.Kicking,GK.OneOnOnes,GK.Reflexes,GK.RushingOut,GK.TendencyToPunch,GK.Throwing,Tech.Corners,Tech.Crossing,Tech.Dribbling,Tech.Finishing,Tech.FirstTouch,Tech.Freekicks,Tech.Heading,Tech.LongShots,Tech.Longthrows,Tech.Marking,Tech.Passing,Tech.PenaltyTaking,Tech.Tackling,Tech.Technique,Mental.Aggression,Mental.Anticipation,Mental.Bravery,Mental.Composure,Mental.Concentration,Mental.Vision,Mental.Decisions,Mental.Determination,Mental.Flair,Mental.Leadership,Mental.OffTheBall,Mental.Positioning,Mental.Teamwork,Mental.Workrate,Phy.Acceleration,Phy.Agility,Phy.Balance,Phy.Jumping,Phy.LeftFoot,Phy.NaturalFitness,Phy.Pace,Phy.RightFoot,Phy.Stamina,Phy.Strength,Hidden.Consistency,Hidden.Dirtiness,Hidden.ImportantMatches,Hidden.InjuryProness,Hidden.Versatility,Personality.Adaptability,Personality.Ambition,Personality.Loyalty,Personality.Pressure,Personality.Professional,Personality.Sportsmanship,Personality.Temperament,Personality.Controversy,Positions.Defender,Positions.WingBack,Positions.Midfielder,Positions.AttackingMidfielder,Positions.Right,Positions.Left,Positions.Centre,Positions.PositionsDesc,Positions.PositionsDescVal,Positions.Goalkeeper,Positions.Sweeper,Positions.Striker,Positions.AttackingMidCentral,Positions.AttackingMidLeft,Positions.AttackingMidRight,Positions.DefenderCentral,Positions.DefenderLeft,Positions.DefenderRight,Positions.DefensiveMidfielder,Positions.MidfielderCentral,Positions.MidfielderLeft,Positions.MidfielderRight,Positions.WingBackLeft,Positions.WingBackRight,PPMVal,PPM0,PPM1,PPM2,PPM3,PPM4,PPM5,PPM6,PPM7,PPM8,PPM9,PPM10,PPM11,PPM12,PPM13,PPM14,PPM15,PPM16,PPM17,PPM18,PPM19,PPM20,PPM21,PPM22,PPM23,PPM24,PPM25,PPM26,PPM27,PPM28,PPM29,PPM30,PPM31,PPM32,PPM33,PPM34,PPM35,PPM36,PPM37,PPM38,PPM39,PPM40,PPM41,PPM42,PPM43,PPM44,PPM45,PPM46,PPM47,name,Market Value,age,height,position,foot,current club,16/17 games,16/17 goals/conceded,16/17 assists/clean,16/17 minutes,17/18 games,17/18 goals/conceded,17/18 assists/clean,17/18 minutes,18/19 games,18/19 goals/conceded,18/19 assists/clean,18/19 minutes,19/20 games,19/20 goals/conceded,19/20 assists/clean,19/20 minutes,20/21 games,20/21 goals/conceded,20/21 assists/clean,20/21 minutes,current league
19-06-17,18.3.4.28,Khaled Adénon,12000121,7,28-Jul-85,31,50,2,0,0,3500,6050,6050,124,121,1466580,181,70,D C,1,4,3,3,2,2,1,2,2,2,3,6,8,7,6,10,6,15,10,6,14,10,6,14,10,12,13,14,11,12,8,13,14,9,12,7,12,13,15,12,11,14,14,8,13,13,20,14,12,13,13,13,7,12,11,13,14,16,13,14,15,7,20,10,7,1,12,1,20,D C,101,1,1,1,1,1,1,20,1,12,10,7,1,1,1,10,0,0,0,0,0,0,0,0,0,0,0,0,0,0,0,0,0,0,0,0,0,0,0,0,0,0,0,0,0,0,0,0,0,0,0,0,0,0,0,0,0,0,0,0,0,0,0,0,0,Khaled Adénon,£450Th. ,35,180,Defender - Centre-Back,right,US Avranches,37,1,0,3330,36,0,1,3099,25,0,0,2111,1,0,0,90,5,0,0,450,Ligue 1
19-06-17,18.3.4.28,Edson Mexer,12013851,35,08-Sep-88,28,36,1,0,0,4800,6550,6550,138,131,11391915,188,79,D C,2,1,1,1,3,2,1,2,4,2,2,7,7,8,8,11,10,15,9,9,14,11,10,15,11,15,14,14,12,14,8,11,13,6,10,8,14,12,12,14,13,15,14,8,14,13,20,15,14,13,9,13,12,9,13,13,13,13,14,13,13,4,20,1,1,1,10,1,20,D C,101,1,1,1,1,1,1,20,1,10,10,1,1,1,1,1,2.74878E+11,0,0,0,0,0,0,0,0,0,0,0,0,0,0,0,0,0,0,0,0,0,0,0,0,0,0,0,0,0,0,0,0,0,0,0,0,0,0,1,0,0,0,0,0,0,0,0,0,,,,,,,,,,,,,,,,,,,,,,,,,,,,
19-06-17,18.3.4.28,Aymen Abdennour,12014167,51,06-Aug-89,27,49,1,10,1,5250,7000,6250,150,131,2565387,187,88,D C,1,3,1,1,4,2,2,1,2,3,1,5,9,10,6,7,7,16,12,12,16,10,8,16,10,18,12,17,10,15,9,12,16,8,12,8,13,15,16,8,9,18,14,20,13,10,8,15,18,10,15,13,14,11,12,15,11,13,14,11,11,8,20,8,4,1,1,10,20,D C,101,1,1,1,1,1,1,20,10,1,10,1,4,1,8,1,4.50389E+15,0,0,0,0,0,0,1,0,0,0,0,0,0,0,0,1,0,0,0,0,0,0,0,0,0,0,0,0,0,0,0,0,0,0,1,0,0,0,1,0,0,0,0,0,0,0,0,0,Aymen Abdennour,£3.60m ,31,187,Defender - Centre-Back,left,Umm Salal SC,14,0,0,967,14,0,0,1069,6,0,0,445,12,0,0,902,1,0,0,90,Ligue 1
19-06-17,18.3.4.28,Ramy Bensebaďni,12038706,5,16-Apr-95,22,5,0,3,0,3800,6050,6050,139,121,5131128,186,75,D/DM LC,1,1,1,1,3,1,2,3,2,2,2,10,11,10,8,12,9,10,9,11,12,11,5,13,12,7,13,14,12,13,10,12,14,10,8,10,12,13,14,13,11,12,14,20,11,14,6,14,12,12,11,11,4,13,11,14,11,12,12,8,8,4,20,12,14,1,1,19,20,D/DM LC,114,1,1,1,1,1,1,20,19,1,16,14,13,1,12,1,0,0,0,0,0,0,0,0,0,0,0,0,0,0,0,0,0,0,0,0,0,0,0,0,0,0,0,0,0,0,0,0,0,0,0,0,0,0,0,0,0,0,0,0,0,0,0,0,0,Ramy Bensebaini,£7.20m ,25,186,Defender - Left-Back,left,Borussia Mönchengladbach,26,0,0,1851,34,1,1,2725,39,3,1,3292,26,5,5,1768,6,2,0,446,Ligue 1
19-06-17,18.3.4.28,Oussama Haddadi,12056232,51,28-Jan-92,25,3,0,0,0,3750,6050,6050,125,119,3204938,188,83,D LC,2,3,1,3,1,3,3,1,4,2,1,11,12,13,10,12,11,11,10,13,11,12,10,14,13,12,13,12,12,11,12,12,3,12,9,12,9,14,13,15,13,13,13,20,12,12,6,13,13,12,9,12,7,11,13,13,13,11,12,9,14,6,20,14,1,1,1,20,15,D LC,104,1,1,1,1,1,1,15,20,1,1,1,1,1,14,1,0,0,0,0,0,0,0,0,0,0,0,0,0,0,0,0,0,0,0,0,0,0,0,0,0,0,0,0,0,0,0,0,0,0,0,0,0,0,0,0,0,0,0,0,0,0,0,0,0,Oussama Haddadi,£2.70m ,28,184,Defender - Left-Back,left,Kasimpasa,27,0,5,2299,34,1,1,2619,39,2,2,3152,34,1,6,3063,5,0,0,404,Ligue 1
19-06-17,18.3.4.28,Marcelo,19033601,1651,20-May-87,30,0,0,4,0,5033,6091,6950,140,139,232186002,191,85,D C,1,4,2,2,1,4,3,2,2,1,3,4,4,7,7,8,4,17,6,6,15,12,7,15,10,13,15,16,14,14,8,14,13,7,17,8,15,12,12,10,10,14,16,10,14,10,20,14,16,16,12,13,6,5,14,14,12,12,15,10,10,8,20,1,1,1,1,1,20,D C,101,1,1,1,1,1,1,20,1,1,10,1,1,1,1,1,2.74878E+11,0,0,0,0,0,0,0,0,0,0,0,0,0,0,0,0,0,1,0,0,0,0,0,0,0,0,0,0,0,0,0,0,0,0,0,0,0,0,1,0,0,0,0,0,0,0,0,0,Marcelo,£54.00m ,32,174,Defender - Left-Back,left,Real Madrid,47,3,13,3878,44,5,11,3671,34,3,6,2858,23,2,7,1884,3,0,1,270,LaLiga
19-06-17,18.3.4.28,Pablo,19125312,1651,21-Jun-91,25,0,0,0,0,3750,6750,6000,133,133,3053056,188,79,D C,1,3,4,1,2,1,2,1,3,1,2,2,6,8,7,11,7,15,8,7,14,9,9,13,8,14,12,16,12,13,6,12,11,8,10,8,13,13,13,13,13,13,16,14,13,13,20,14,16,12,12,11,13,10,5,10,9,15,12,8,13,9,20,1,1,1,1,1,20,D C,101,1,11,1,1,1,1,20,1,1,1,1,1,1,1,1,0,0,0,0,0,0,0,0,0,0,0,0,0,0,0,0,0,0,0,0,0,0,0,0,0,0,0,0,0,0,0,0,0,0,0,0,0,0,0,0,0,0,0,0,0,0,0,0,0,Pablo,£2.70m ,29,188,Defender - Centre-Back,right,FC Girondins Bordeaux,28,0,0,2381,15,0,3,1292,39,1,2,3203,28,4,0,2445,5,0,0,390,Ligue 1
19-06-17,18.3.4.28,Marquinhos,19163495,1651,14-May-94,23,19,0,0,0,7000,8000,7800,175,156,172709061,183,72,D RC,1,3,3,1,1,2,2,2,1,3,1,4,11,10,8,14,4,15,10,7,15,13,8,16,14,14,15,15,15,16,12,15,18,10,12,8,16,17,15,14,13,16,13,10,14,15,20,15,13,16,8,15,8,15,15,15,12,14,17,15,16,7,20,1,1,1,15,1,20,D RC,103,1,1,1,1,1,1,20,1,15,10,1,1,1,1,1,8589967360,0,0,0,0,0,0,0,0,0,0,0,0,0,0,0,1,0,0,0,0,0,0,0,0,0,0,0,0,0,0,0,0,0,1,0,0,0,0,0,0,0,0,0,0,0,0,0,0,Marquinhos,£49.50m ,26,183,Defender - Centre-Back,right,Paris Saint-Germain,44,4,0,3849,41,2,3,3613,44,4,2,3861,37,6,1,3043,5,1,0,433,Ligue 1
19-06-17,18.3.4.28,Diego Carlos,19188567,1651,15-Mar-93,24,0,0,0,0,3900,6000,6500,139,130,10540251,185,79,D C,3,4,1,2,3,3,3,4,1,2,1,5,5,7,7,11,9,14,8,10,14,12,10,15,12,16,13,14,13,13,8,12,13,9,9,8,13,13,14,13,13,15,12,9,15,13,20,15,15,15,12,13,6,8,13,13,11,11,16,12,10,11,20,1,8,1,1,1,20,D C,101,1,1,1,1,1,1,20,1,1,15,8,1,1,1,1,0,0,0,0,0,0,0,0,0,0,0,0,0,0,0,0,0,0,0,0,0,0,0,0,0,0,0,0,0,0,0,0,0,0,0,0,0,0,0,0,0,0,0,0,0,0,0,0,0,Diego Carlos,£9.00m ,27,186,Defender - Centre-Back,right,Sevilla FC,39,2,0,3402,29,1,0,2382,40,1,0,3514,45,2,1,3961,7,0,0,660,Ligue 1
19-06-17,18.3.4.28,Marlon,19189110,1651,07-Sep-95,21,0,0,13,0,3750,6750,6250,154,125,5938488,185,81,D/DM C,3,2,3,1,2,2,2,3,2,3,3,7,8,13,7,13,8,12,8,8,13,12,11,13,13,15,11,13,11,11,13,13,13,13,10,10,13,12,14,12,11,14,13,12,12,13,20,13,15,11,15,10,11,11,17,12,12,12,13,12,11,11,20,1,10,1,1,1,20,D/DM C,111,1,1,1,1,1,1,20,1,1,18,10,1,1,1,1,0,0,0,0,0,0,0,0,0,0,0,0,0,0,0,0,0,0,0,0,0,0,0,0,0,0,0,0,0,0,0,0,0,0,0,0,0,0,0,0,0,0,0,0,0,0,0,0,0,Marlon,£5.40m ,25,182,Defender - Centre-Back,right,US Sassuolo,30,0,0,2303,27,0,0,2159,18,1,0,1510,23,0,0,1818,0,0,0,0,Ligue 1
19-06-17,18.3.4.28,Jemerson,19190099,1651,24-Aug-92,24,1,0,0,0,6000,7250,7250,154,145,63051804,184,77,D C,2,2,1,2,1,3,2,3,2,2,3,6,10,11,8,12,7,15,9,11,14,13,10,16,12,14,15,16,13,13,12,13,14,12,11,9,14,14,14,14,13,15,13,10,16,14,20,14,15,14,11,14,5,10,13,14,15,14,15,14,15,7,20,8,1,1,10,1,20,D C,101,1,1,1,1,1,1,20,1,10,1,1,1,1,1,8,4295000064,0,0,0,0,0,0,0,0,0,0,0,0,0,0,0,1,0,0,0,0,0,0,0,0,0,0,0,0,0,0,0,0,1,0,0,0,0,0,0,0,0,0,0,0,0,0,0,0,Jemerson,£16.20m ,28,184,Defender - Centre-Back,right,AS Monaco,54,2,1,4917,44,2,0,3846,35,0,1,3166,15,0,0,1240,nan,nan,nan,nan,Ligue 1
19-06-17,18.3.4.28,Kader Mangane,2018587,41,23-Mar-83,34,23,1,3,0,3750,6050,6300,152,126,232186002,193,90,D C,4,2,2,1,2,1,1,3,1,3,2,3,6,8,8,11,10,16,8,5,13,10,7,14,10,14,14,16,12,13,9,13,14,6,13,7,13,14,15,9,11,15,15,8,14,10,20,14,16,14,13,15,8,8,15,14,12,12,12,12,13,7,20,1,1,1,1,1,20,D C,101,1,1,1,1,1,1,20,1,1,13,1,1,1,1,1,3.51844E+13,0,0,0,0,0,0,0,0,0,0,0,0,0,0,0,1,0,0,0,0,0,0,0,0,0,0,0,0,0,0,0,0,0,0,0,0,0,0,0,0,0,0,0,0,0,1,0,0,Kader Mangane,£450Th. ,37,193,Defender - Centre-Back,right,Retired,21,1,0,1724,21,1,1,1839,nan,nan,nan,nan,nan,nan,nan,nan,nan,nan,nan,nan,Ligue 1
19-06-17,18.3.4.28,Mateo Pavlovic,24004743,761,09-Jun-90,27,0,0,10,1,3500,5700,5400,110,108,782736,196,91,D C,3,3,2,2,3,3,3,1,1,1,3,3,5,8,6,9,5,14,7,8,13,10,5,12,10,10,13,14,12,12,7,10,13,6,9,6,12,14,10,9,8,13,18,8,17,11,20,12,16,13,12,10,7,4,11,10,12,9,13,7,10,7,20,1,1,1,1,1,20,D C,101,1,10,7,1,1,1,20,1,1,1,1,1,1,1,1,0,0,0,0,0,0,0,0,0,0,0,0,0,0,0,0,0,0,0,0,0,0,0,0,0,0,0,0,0,0,0,0,0,0,0,0,0,0,0,0,0,0,0,0,0,0,0,0,0,Mateo Pavlovic,£1.13m ,30,194,Defender - Centre-Back,right,SCO Angers,16,1,1,1127,28,3,0,2326,32,2,1,2667,15,0,0,1199,4,0,0,297,Ligue 1
19-06-17,18.3.4.28,Dante,316742,1651,18-Oct-83,33,13,2,0,0,5250,6500,7000,160,140,232186002,187,82,D C,4,2,3,4,2,1,2,3,1,2,2,6,10,12,8,14,7,15,7,12,15,15,10,17,13,12,15,18,16,14,14,12,18,16,15,6,14,13,10,8,10,17,14,20,15,10,12,14,16,13,14,15,7,10,16,14,9,16,14,7,8,13,20,10,1,1,1,12,20,D C,101,1,1,1,1,1,1,20,12,1,1,1,1,1,10,1,2.20332E+12,0,0,0,0,0,0,0,0,0,0,0,0,0,0,0,1,0,0,0,0,0,0,0,0,0,0,0,0,0,0,0,0,1,0,0,0,0,0,0,0,0,1,0,0,0,0,0,0,Dante,£1.35m ,37,188,Defender - Centre-Back,left,OGC Nice,39,0,3,3510,48,2,1,4270,37,1,1,3347,25,1,1,2250,9,2,0,810,Ligue 1
19-06-17,18.3.4.28,Hilton,3301316,1651,13-Sep-77,39,0,0,0,0,3700,6050,6350,149,127,232186002,180,78,D C,1,2,2,2,3,2,3,1,2,1,1,5,9,10,7,12,7,15,10,9,15,13,10,14,12,12,15,14,15,14,11,14,16,6,15,9,15,15,12,8,10,15,11,8,14,8,20,10,15,15,12,14,6,10,15,14,15,14,18,13,13,8,20,1,1,1,1,1,20,D C,101,1,13,1,1,1,1,20,1,1,1,1,1,1,1,1,1.37439E+11,0,0,0,0,0,0,0,0,0,0,0,0,0,0,0,0,0,0,0,0,0,0,0,0,0,0,0,0,0,0,0,0,0,0,0,0,0,1,0,0,0,0,0,0,0,0,0,0,Hilton,£225Th. ,43,180,Defender - Centre-Back,right,Montpellier HSC,34,1,0,2986,31,0,0,2820,37,0,2,3323,33,1,2,2924,6,0,0,448,Ligue 1
19-06-17,18.3.4.28,Ismaël Traoré,34002642,24,18-Aug-86,30,2,0,0,0,3900,6300,6300,129,126,232186002,185,75,D C,2,3,3,3,1,2,3,3,2,1,2,4,10,8,6,10,6,14,7,7,14,11,6,14,9,13,13,14,11,12,12,12,14,8,11,12,13,13,13,15,12,15,12,8,15,13,20,14,15,14,7,14,7,6,18,13,15,14,14,14,14,6,20,1,1,1,1,1,20,D C,101,1,1,1,1,1,1,20,1,1,1,1,1,1,1,1,9.07097E+12,0,0,0,0,0,0,0,0,0,0,0,0,0,0,0,0,0,0,0,0,0,0,0,0,0,0,0,0,0,0,0,0,0,0,0,0,0,0,1,0,0,0,0,1,0,0,0,0,Ismaël Traoré,£1.35m ,34,184,Defender - Centre-Back,right,SCO Angers,35,1,1,3082,32,3,1,2857,31,3,2,2670,24,0,0,2143,8,3,1,720,Ligue 1
19-06-17,18.3.4.28,Adil Rami,34004844,769,27-Dec-85,31,33,1,0,0,5750,7150,7150,154,143,232186002,190,88,D C,2,3,2,3,2,3,2,1,3,1,2,5,7,9,8,10,7,16,11,9,15,13,5,16,12,17,15,17,13,13,11,12,16,7,10,10,14,15,16,11,12,16,16,8,15,13,20,15,16,13,15,14,10,12,14,15,12,14,12,13,11,15,20,1,1,1,7,1,20,D C,101,1,1,1,1,1,1,20,1,7,5,1,1,1,1,1,1.15293E+18,0,0,0,0,0,0,0,0,0,0,0,0,0,0,0,0,0,0,0,0,0,0,0,0,0,0,0,0,0,0,0,0,0,0,0,0,0,0,0,0,0,0,0,1,0,0,0,0,Adil Rami,£6.30m ,34,191,Defender - Centre-Back,right,Boavista FC,33,0,0,2845,54,2,2,4814,21,1,1,1800,7,0,0,556,3,0,0,186,Ligue 1
19-06-17,18.3.4.28,Damien Da Silva,34005782,769,17-May-88,29,0,0,0,0,3900,6450,6450,129,129,8133794,183,81,D/DM C,2,3,3,2,3,2,1,2,3,1,1,5,5,6,8,12,6,14,8,6,15,11,6,14,11,14,14,16,14,14,10,13,14,5,14,8,14,16,15,10,11,15,13,6,11,13,20,15,15,14,14,14,9,8,14,14,10,13,15,13,15,6,20,10,1,1,12,1,20,D/DM C,111,1,1,1,1,1,1,20,1,12,16,1,1,1,1,10,0,0,0,0,0,0,0,0,0,0,0,0,0,0,0,0,0,0,0,0,0,0,0,0,0,0,0,0,0,0,0,0,0,0,0,0,0,0,0,0,0,0,0,0,0,0,0,0,0,Damien Da Silva,£4.95m ,32,184,Defender - Centre-Back,right,Stade Rennais FC,36,0,1,3169,36,4,0,3196,49,3,1,4405,32,1,2,2935,8,2,0,720,Ligue 1
19-06-17,18.3.4.28,Cheik M'Bengue,34009535,41,23-Jul-88,28,33,0,0,0,4000,6400,6300,135,126,6301369,183,80,D/WB LC,2,2,2,1,3,4,3,2,1,2,2,7,11,9,6,11,8,13,7,12,13,8,7,15,10,14,14,15,13,12,9,11,14,8,8,10,10,13,16,15,13,14,11,20,15,15,5,16,15,10,14,14,7,10,14,14,14,14,15,14,14,6,20,17,10,1,1,20,15,D/WB LC,114,1,1,1,1,1,1,15,20,1,1,1,10,1,17,1,1.37439E+11,1,0,0,0,0,0,0,0,0,0,0,0,0,0,0,0,0,0,0,0,0,0,0,0,0,0,0,0,0,0,0,0,0,0,0,0,0,1,0,0,0,0,0,0,0,0,0,0,Cheikh M'Bengue,£1.80m ,32,183,Defender - Left-Back,left,Without Club,17,0,1,1363,10,0,0,818,15,0,1,1235,nan,nan,nan,nan,nan,nan,nan,nan,Ligue 1
19-06-17,18.3.4.28,Maxime Le Marchand,34009617,769,11-Oct-89,27,0,0,0,0,3600,6250,6250,126,125,5021260,185,77,D LC,2,4,3,3,2,2,3,1,3,1,1,7,12,10,6,11,7,14,5,11,13,12,6,14,12,17,13,15,12,14,10,13,14,7,8,10,13,14,14,11,12,14,13,20,12,13,8,15,14,15,12,14,10,12,17,14,16,12,15,14,14,5,20,10,10,1,1,15,20,D LC,104,1,1,1,1,1,1,20,15,1,12,10,1,1,10,1,0,0,0,0,0,0,0,0,0,0,0,0,0,0,0,0,0,0,0,0,0,0,0,0,0,0,0,0,0,0,0,0,0,0,0,0,0,0,0,0,0,0,0,0,0,0,0,0,0,Maxime Le Marchand,£3.60m ,31,185,Defender - Centre-Back,left,Fulham FC,13,1,0,973,41,0,3,3570,29,0,1,2452,15,0,0,398,4,0,0,302,Ligue 1
19-06-17,18.3.4.28,Neven Subotic,35013755,802,10-Dec-88,28,36,2,0,0,4250,6250,6750,148,135,15029734,193,88,D C,3,2,1,2,1,1,2,2,3,3,1,3,6,6,8,10,11,15,11,8,16,10,9,16,9,10,14,17,12,11,10,13,11,6,11,7,16,14,8,9,8,10,18,10,12,11,20,12,16,15,10,13,14,2,18,12,16,12,17,11,8,6,20,1,1,1,1,1,20,D C,101,1,1,1,1,1,1,20,1,1,1,1,1,1,1,1,0,0,0,0,0,0,0,0,0,0,0,0,0,0,0,0,0,0,0,0,0,0,0,0,0,0,0,0,0,0,0,0,0,0,0,0,0,0,0,0,0,0,0,0,0,0,0,0,0,Neven Subotic,£4.50m ,31,193,Defender - Centre-Back,right,Denizlispor,14,1,0,1059,21,2,0,1800,28,1,0,2362,23,1,0,1971,3,1,0,270,Bundesliga
19-06-17,18.3.4.28,Benjamin Angoua,38001740,24,28-Nov-86,30,17,1,4,0,3950,5550,5900,121,118,1883934,183,73,D RC,1,1,1,1,1,1,1,1,1,1,1,4,8,6,6,8,5,14,7,10,15,7,6,14,8,14,12,16,10,12,10,11,13,9,8,8,12,15,14,11,12,14,11,10,13,14,20,15,14,14,13,13,8,12,14,12,13,13,14,11,11,7,20,14,7,1,15,13,20,D RC,103,1,1,1,1,1,1,20,13,15,14,7,1,1,12,14,32832,0,0,0,0,0,0,1,0,0,0,0,0,0,0,0,1,0,0,0,0,0,0,0,0,0,0,0,0,0,0,0,0,0,0,0,0,0,0,0,0,0,0,0,0,0,0,0,0,Benjamin Angoua,£900Th. ,33,183,Defender - Centre-Back,right,Stade Briochin,39,1,2,3434,nan,nan,nan,nan,7,0,0,532,17,1,0,1487,9,1,0,810,Ligue 1
19-06-17,18.3.4.28,Kelvin Amian,48031443,769,08-Feb-98,19,0,0,2,0,2001,5004,5000,144,112,899166,180,78,D RC,4,1,3,2,3,3,1,4,1,1,3,8,11,9,7,13,3,11,10,13,13,11,5,13,11,12,13,11,13,12,12,13,11,1,7,11,12,12,12,13,13,13,9,6,16,13,20,13,12,13,4,12,5,10,12,8,10,11,12,13,15,3,20,1,1,1,20,14,18,D RC,103,1,1,1,1,1,1,18,14,20,11,1,1,1,1,1,0,0,0,0,0,0,0,0,0,0,0,0,0,0,0,0,0,0,0,0,0,0,0,0,0,0,0,0,0,0,0,0,0,0,0,0,0,0,0,0,0,0,0,0,0,0,0,0,0,Kelvin Amian,£4.50m ,22,180,Defender - Right-Back,right,FC Toulouse,24,0,0,2015,40,1,1,3514,34,0,1,3002,22,0,2,1810,8,1,0,720,Ligue 1
19-06-17,18.3.4.28,Nordi Mukiele,48034615,769,01-Nov-97,19,0,0,0,0,3600,6200,6200,136,124,11802666,185,74,D RC,2,4,2,1,4,1,3,3,3,2,1,8,10,8,6,11,6,13,5,11,15,12,9,14,10,12,13,14,11,13,10,11,12,8,8,10,13,14,15,13,14,15,12,6,14,14,20,14,13,13,7,13,5,12,19,13,12,12,13,13,15,7,20,1,1,1,19,1,20,D RC,103,1,1,1,1,1,1,20,1,19,13,1,1,1,1,1,0,0,0,0,0,0,0,0,0,0,0,0,0,0,0,0,0,0,0,0,0,0,0,0,0,0,0,0,0,0,0,0,0,0,0,0,0,0,0,0,0,0,0,0,0,0,0,0,0,Nordi Mukiele,£12.60m ,22,187,Defender - Right-Back,right,RB Leipzig,37,0,1,3273,39,0,1,3321,31,1,1,1901,37,3,3,2659,6,0,0,429,Ligue 1
19-06-17,18.3.4.28,Yves Dabila,48036489,24,01-Jan-97,20,0,0,0,0,1250,5000,5000,102,100,768920,184,75,D/DM C,2,1,3,1,1,1,2,2,2,1,1,4,5,9,6,11,5,12,8,8,13,12,6,12,12,13,11,14,10,11,8,10,14,7,8,7,12,12,13,12,12,13,11,6,14,13,20,14,13,13,8,9,6,8,12,12,12,13,13,14,13,6,20,1,1,1,1,1,20,D/DM C,111,1,1,1,1,1,1,20,1,1,16,1,1,1,1,1,0,0,0,0,0,0,0,0,0,0,0,0,0,0,0,0,0,0,0,0,0,0,0,0,0,0,0,0,0,0,0,0,0,0,0,0,0,0,0,0,0,0,0,0,0,0,0,0,0,,,,,,,,,,,,,,,,,,,,,,,,,,,,
19-06-17,18.3.4.28,Mouctar Diakhaby,48036643,769,19-Dec-96,20,0,0,2,1,3950,6200,6200,144,124,9614854,190,80,D C,2,1,2,1,2,3,2,1,1,3,1,6,6,6,6,10,6,16,6,6,13,11,10,13,10,10,13,16,12,11,8,12,15,8,10,8,13,14,14,11,10,15,17,7,14,11,20,14,16,10,10,11,5,8,13,12,12,11,15,16,16,2,20,1,1,1,1,1,20,D C,101,1,1,1,1,1,1,20,1,1,12,1,1,1,1,1,0,0,0,0,0,0,0,0,0,0,0,0,0,0,0,0,0,0,0,0,0,0,0,0,0,0,0,0,0,0,0,0,0,0,0,0,0,0,0,0,0,0,0,0,0,0,0,0,0,Mouctar Diakhaby,£9.00m ,23,192,Defender - Centre-Back,right,Valencia CF,34,5,2,3040,21,2,0,1490,38,3,0,2841,29,0,0,2048,7,0,0,583,Ligue 1
19-06-17,18.3.4.28,Elisha Owusu,48036651,21,07-Nov-97,19,0,0,0,0,1250,5000,5000,145,100,1080279,179,63,DM C,3,1,1,2,2,2,2,1,2,1,3,5,5,8,5,11,5,11,9,4,12,11,6,13,11,13,12,13,10,11,10,11,12,5,13,10,14,14,15,12,10,13,10,6,14,12,20,14,13,8,11,10,7,11,7,11,13,12,12,11,11,6,15,1,15,1,1,1,15,DM C,301,1,1,1,1,1,1,15,1,1,20,15,1,1,1,1,64,0,0,0,0,0,0,1,0,0,0,0,0,0,0,0,0,0,0,0,0,0,0,0,0,0,0,0,0,0,0,0,0,0,0,0,0,0,0,0,0,0,0,0,0,0,0,0,0,Elisha Owusu,£90Th. ,22,182,Midfielder - Defensive Midfield,right,KAA Gent,nan,nan,nan,nan,0,0,0,0,35,0,1,2990,41,0,0,3442,10,0,0,819,Ligue 1
19-06-17,18.3.4.28,Alexander Djiku,48036760,769,09-Dec-94,22,0,0,0,0,3800,6250,6250,131,125,4846362,182,74,D RC,1,1,1,3,1,3,2,3,1,2,3,7,11,10,7,11,7,13,7,11,14,12,8,13,12,15,12,15,13,14,8,12,13,10,9,10,13,13,14,13,12,15,11,10,14,12,20,14,14,12,12,11,7,11,10,14,14,12,13,12,14,7,20,1,1,1,15,1,20,D RC,103,1,1,1,1,1,1,20,1,15,13,1,1,1,1,1,0,0,0,0,0,0,0,0,0,0,0,0,0,0,0,0,0,0,0,0,0,0,0,0,0,0,0,0,0,0,0,0,0,0,0,0,0,0,0,0,0,0,0,0,0,0,0,0,0,Alexander Djiku,£7.20m ,26,182,Defender - Centre-Back,right,RC Strasbourg Alsace,24,1,0,1939,33,0,0,3000,35,1,0,3137,33,2,1,2737,7,0,0,506,Ligue 1
19-06-17,18.3.4.28,Malang Sarr,48036830,769,23-Jan-99,18,0,0,0,0,3950,5750,5950,156,119,6492559,182,73,D LC,1,3,2,1,1,3,3,2,3,1,3,6,11,12,7,13,7,13,7,8,11,12,5,13,13,11,11,14,13,13,11,12,15,12,7,8,11,13,15,13,12,14,10,20,14,14,10,14,12,12,8,8,7,7,18,14,14,12,14,11,15,6,20,1,1,1,1,17,20,D LC,104,1,1,1,1,1,1,20,17,1,1,1,1,1,1,1,0,0,0,0,0,0,0,0,0,0,0,0,0,0,0,0,0,0,0,0,0,0,0,0,0,0,0,0,0,0,0,0,0,0,0,0,0,0,0,0,0,0,0,0,0,0,0,0,0,Malang Sarr,£13.50m ,21,182,Defender - Centre-Back,left,FC Porto,32,1,2,2658,29,0,0,1985,38,1,1,3294,20,1,0,1541,2,0,0,91,Ligue 1
19-06-17,18.3.4.28,Félix Eboa Eboa,48036875,11,19-Apr-97,20,1,0,0,0,3500,5750,5750,134,115,4036280,186,80,D/DM C,3,2,3,2,2,2,2,2,2,3,4,7,10,9,6,12,6,13,8,13,11,12,7,14,12,14,11,15,12,10,11,12,14,6,12,7,9,13,14,13,11,12,14,8,14,14,20,13,16,13,12,14,5,15,10,11,10,12,9,11,17,8,20,1,1,1,10,1,20,D/DM C,111,1,1,1,1,1,1,20,1,10,17,1,1,1,1,1,0,0,0,0,0,0,0,0,0,0,0,0,0,0,0,0,0,0,0,0,0,0,0,0,0,0,0,0,0,0,0,0,0,0,0,0,0,0,0,0,0,0,0,0,0,0,0,0,0,Félix Eboa Eboa,£2.70m ,23,186,Defender - Centre-Back,right,EA Guingamp,6,1,0,540,25,1,0,1695,33,3,0,3087,14,0,0,1098,2,0,0,167,Ligue 1
19-06-17,18.3.4.28,Joris Gnagnon,48036969,24,13-Jan-97,20,0,0,0,0,4450,6350,6350,145,127,16026284,182,89,D C,1,4,1,3,2,2,2,2,3,1,1,5,8,9,5,12,5,14,6,6,14,12,8,14,12,13,13,17,12,12,9,12,12,8,13,8,12,13,14,11,11,16,13,8,16,13,20,16,17,12,4,10,6,11,9,14,11,13,11,14,14,6,20,1,10,1,10,1,20,D C,101,1,1,1,1,1,1,20,1,10,15,10,1,1,1,1,2.19902E+12,0,0,0,0,0,0,0,0,0,0,0,0,0,0,0,0,0,0,0,0,0,0,0,0,0,0,0,0,0,0,0,0,0,0,0,0,0,0,0,0,0,1,0,0,0,0,0,0,Joris Gnagnon,£13.50m ,23,182,Defender - Centre-Back,right,Sevilla FC,30,2,0,2598,41,2,1,3322,16,0,0,1254,31,2,1,2226,nan,nan,nan,nan,Ligue 1
19-06-17,18.3.4.28,Moussa Niakhaté,48037362,769,08-Mar-96,21,0,0,0,0,3350,5750,5750,131,114,3334366,190,80,D LC,3,1,2,1,4,3,2,2,3,2,1,12,12,10,9,11,7,13,8,12,12,11,9,13,11,13,11,13,11,13,10,12,9,7,8,10,11,13,12,13,12,14,15,20,13,14,6,13,14,12,6,10,5,13,13,11,12,13,11,11,19,8,20,10,1,1,1,20,15,D LC,104,1,1,1,1,1,1,15,20,1,13,1,1,1,10,1,0,0,0,0,0,0,0,0,0,0,0,0,0,0,0,0,0,0,0,0,0,0,0,0,0,0,0,0,0,0,0,0,0,0,0,0,0,0,0,0,0,0,0,0,0,0,0,0,0,Moussa Niakhaté,£4.50m ,24,190,Defender - Centre-Back,left,1.FSV Mainz 05,36,1,2,3063,38,0,1,3374,34,1,1,2792,34,1,2,3060,5,0,0,437,Ligue 1
19-06-17,18.3.4.28,Boubacar Kamara,48043084,769,23-Nov-99,17,0,0,0,0,3000,5300,5300,150,106,2205660,192,0,D C,3,1,1,3,2,1,3,1,3,3,2,6,8,10,6,11,6,12,6,1,12,12,3,12,12,12,13,14,13,11,11,10,10,8,9,10,10,13,13,13,13,13,13,8,14,13,20,12,11,10,5,8,8,10,8,14,12,12,11,11,13,8,20,1,1,1,10,1,20,D C,101,1,1,1,1,1,1,20,1,10,14,1,1,1,1,1,0,0,0,0,0,0,0,0,0,0,0,0,0,0,0,0,0,0,0,0,0,0,0,0,0,0,0,0,0,0,0,0,0,0,0,0,0,0,0,0,0,0,0,0,0,0,0,0,0,Boubacar Kamara,£3.15m ,20,184,Midfielder - Defensive Midfield,right,Olympique Marseille,1,0,0,82,18,0,1,1450,37,1,0,2867,28,2,2,2501,8,0,0,686,Ligue 1
19-06-17,18.3.4.28,Yoann Salmier,49031215,917496,21-Nov-92,24,1,0,0,0,3500,5950,5950,126,119,3289182,188,85,D C,1,2,1,2,2,3,3,3,3,1,2,9,7,8,4,11,11,12,6,6,12,10,6,12,11,14,12,13,11,13,6,12,13,8,8,11,12,13,12,11,12,14,14,7,13,12,20,14,14,13,9,11,6,11,10,13,14,12,13,10,17,5,20,1,1,1,1,1,20,D C,101,1,1,1,1,1,1,20,1,1,1,1,1,1,1,1,0,0,0,0,0,0,0,0,0,0,0,0,0,0,0,0,0,0,0,0,0,0,0,0,0,0,0,0,0,0,0,0,0,0,0,0,0,0,0,0,0,0,0,0,0,0,0,0,0,Yoann Salmier,£360Th. ,27,188,Defender - Centre-Back,right,ES Troyes AC,26,0,0,1961,19,0,0,1587,36,0,0,3247,29,1,0,2589,8,0,0,563,Ligue 1
19-06-17,18.3.4.28,Anthony Caci,49034179,769,01-Jul-97,19,0,0,0,0,1500,4750,4750,128,95,568173,184,70,DM C,1,4,2,1,1,2,2,3,3,3,1,8,7,6,11,10,7,13,13,7,7,9,6,9,11,10,8,10,11,9,12,8,11,13,11,11,9,9,11,17,17,13,11,12,6,17,20,10,8,10,7,8,10,10,16,12,12,10,12,12,15,1,15,1,12,1,1,1,15,DM C,301,1,1,1,1,1,1,15,1,1,20,12,1,1,1,1,0,0,0,0,0,0,0,0,0,0,0,0,0,0,0,0,0,0,0,0,0,0,0,0,0,0,0,0,0,0,0,0,0,0,0,0,0,0,0,0,0,0,0,0,0,0,0,0,0,Anthony Caci, ,23,184,Defender - Left-Back,right,RC Strasbourg Alsace,3,0,0,118,0,0,0,0,34,0,1,2811,10,1,4,722,5,0,1,330,Ligue 1
19-06-17,18.3.4.28,Oumar Solet,49037684,769,07-Feb-00,17,0,0,0,0,1250,4500,4500,146,90,446026,192,81,D/DM C,1,3,3,2,1,3,2,4,1,2,2,8,8,6,6,10,8,12,7,4,9,10,4,14,8,12,12,12,10,7,6,14,10,1,9,6,8,8,10,12,7,13,16,6,14,9,20,8,14,12,7,10,8,8,10,13,11,10,10,11,15,2,20,1,1,1,1,1,20,D/DM C,111,1,1,1,1,1,1,20,1,1,17,1,1,1,1,1,0,0,0,0,0,0,0,0,0,0,0,0,0,0,0,0,0,0,0,0,0,0,0,0,0,0,0,0,0,0,0,0,0,0,0,0,0,0,0,0,0,0,0,0,0,0,0,0,0,Oumar Solet,£900Th. ,20,192,Defender - Centre-Back,right,Red Bull Salzburg,nan,nan,nan,nan,13,0,0,1076,27,1,0,2400,10,1,0,731,1,0,0,7,Ligue 1
19-06-17,18.3.4.28,Nicolas Cozza,49037761,769,08-Jan-99,18,0,0,0,0,3000,5300,5300,125,106,1972369,178,72,D C,3,1,1,2,2,1,4,2,2,1,1,5,6,3,6,12,1,10,10,11,12,9,8,13,10,10,13,13,12,11,13,12,11,9,10,10,12,12,11,12,13,13,10,20,11,12,6,11,10,10,7,10,9,10,8,11,8,10,10,12,11,8,20,1,1,1,1,1,20,D C,101,1,1,1,1,1,1,20,1,1,1,1,1,1,1,1,0,0,0,0,0,0,0,0,0,0,0,0,0,0,0,0,0,0,0,0,0,0,0,0,0,0,0,0,0,0,0,0,0,0,0,0,0,0,0,0,0,0,0,0,0,0,0,0,0,Nicolas Cozza,£900Th. ,21,178,Defender - Centre-Back,left,Montpellier HSC,nan,nan,nan,nan,12,1,2,753,14,0,1,1161,8,0,0,624,3,0,0,248,Ligue 1
19-06-17,18.3.4.28,Bakaye Dibassy,50034547,769,11-Aug-89,27,0,0,0,0,3500,5850,5850,125,117,1856217,183,74,D LC,3,3,2,1,3,2,4,1,2,1,1,8,11,11,9,10,7,13,13,12,14,12,7,13,11,12,11,11,10,10,10,12,15,9,11,12,13,12,14,14,12,12,13,20,13,12,6,12,13,12,8,12,11,11,12,14,12,14,12,11,12,7,20,15,10,7,1,20,17,D LC,104,1,1,1,1,7,1,17,20,1,1,1,10,1,15,1,0,0,0,0,0,0,0,0,0,0,0,0,0,0,0,0,0,0,0,0,0,0,0,0,0,0,0,0,0,0,0,0,0,0,0,0,0,0,0,0,0,0,0,0,0,0,0,0,0,Bakaye Dibassy,£3.60m ,31,183,Defender - Centre-Back,left,Minnesota United FC,37,5,1,3255,35,1,2,3002,37,1,1,3124,33,2,0,2758,nan,nan,nan,nan,Ligue 1
19-06-17,18.3.4.28,Oswaldo Vizcarrondo,5300083,1658,31-May-84,33,80,7,7,0,3800,6450,6200,130,124,232186002,191,85,D C,1,1,2,4,2,1,3,3,2,1,3,6,4,6,5,12,8,15,7,7,14,11,9,13,12,14,11,14,10,11,10,14,11,6,13,10,13,13,15,9,8,14,16,8,12,10,20,12,15,13,14,4,10,11,8,13,13,12,11,10,9,11,20,1,1,1,1,1,20,D C,101,1,18,1,1,1,1,20,1,1,1,1,1,1,1,1,0,0,0,0,0,0,0,0,0,0,0,0,0,0,0,0,0,0,0,0,0,0,0,0,0,0,0,0,0,0,0,0,0,0,0,0,0,0,0,0,0,0,0,0,0,0,0,0,0,Oswaldo Vizcarrondo,£450Th. ,36,191,Defender - Centre-Back,both,AS Sautron,23,0,0,1666,20,0,0,1714,4,0,0,360,nan,nan,nan,nan,nan,nan,nan,nan,Ligue 1
19-06-17,18.3.4.28,Igor Lewczuk,54005591,787,30-May-85,32,2,0,0,0,3950,6250,6050,125,121,1725823,187,83,D C,2,2,3,2,1,3,3,3,1,1,1,8,11,10,8,11,8,16,8,13,15,10,11,14,8,17,13,16,14,11,5,11,13,9,9,9,13,12,13,11,8,16,14,8,14,10,20,13,15,14,15,12,5,8,14,14,11,11,14,12,13,5,20,6,1,1,13,1,20,D C,101,1,1,1,1,1,1,20,1,13,10,1,1,1,1,6,1073774624,0,0,0,0,0,1,0,0,0,0,0,0,0,0,0,1,0,0,0,0,0,0,0,0,0,0,0,0,0,0,1,0,0,0,0,0,0,0,0,0,0,0,0,0,0,0,0,0,Igor Lewczuk,£900Th. ,35,189,Defender - Centre-Back,right,Legia Warszawa,46,2,1,4034,9,0,0,615,13,0,0,998,34,2,0,2782,7,0,0,551,Ligue 1
19-06-17,18.3.4.28,Pedro Mendes,55009672,788,01-Oct-90,26,0,0,9,1,3850,6050,6400,129,128,6467512,187,78,D C,1,3,3,2,3,1,1,2,2,1,2,7,10,10,6,12,9,14,11,10,13,13,6,14,10,14,13,14,13,13,13,12,13,9,12,12,13,15,14,12,12,15,14,8,12,12,20,14,14,13,11,9,6,10,12,9,14,9,12,10,6,12,20,1,1,1,13,1,20,D C,101,1,1,1,1,1,1,20,1,13,12,1,1,1,1,1,0,0,0,0,0,0,0,0,0,0,0,0,0,0,0,0,0,0,0,0,0,0,0,0,0,0,0,0,0,0,0,0,0,0,0,0,0,0,0,0,0,0,0,0,0,0,0,0,0,Pedro Mendes,£3.15m ,30,186,Defender - Centre-Back,right,Montpellier HSC,20,0,0,1757,39,1,1,3290,32,1,1,2743,18,1,0,1534,6,0,0,535,Ligue 1
19-06-17,18.3.4.28,Edgar Ié,55060508,788,01-May-94,23,0,0,3,1,3700,5750,6200,129,124,7887635,180,80,D RC,2,2,1,3,1,1,3,2,1,2,2,7,9,10,6,11,8,13,8,10,12,10,9,14,12,13,12,11,11,12,8,11,11,9,9,9,12,13,12,14,15,10,10,10,12,13,20,14,13,13,12,10,10,16,14,15,10,12,12,11,11,6,20,10,1,1,16,13,20,D RC,103,1,11,1,1,1,1,20,13,16,9,1,1,1,8,10,4294967296,0,0,0,0,0,0,0,0,0,0,0,0,0,0,0,0,0,0,0,0,0,0,0,0,0,0,0,0,0,0,0,0,1,0,0,0,0,0,0,0,0,0,0,0,0,0,0,0,Edgar Ié,£2.70m ,26,182,Defender - Centre-Back,right,Trabzonspor,26,0,0,2111,37,1,1,3342,21,0,0,1380,21,0,0,1661,6,0,0,399,Ligue 1
19-06-17,18.3.4.28,Milan Bisevac,5763744,802,31-Aug-83,33,19,0,9,0,3500,6250,6050,144,120,232186002,185,85,D C,1,3,1,3,1,1,2,1,1,2,3,5,10,9,8,11,11,15,13,9,14,12,10,14,11,14,15,16,12,11,9,11,17,7,12,9,15,13,10,8,9,15,13,10,13,9,20,13,15,11,15,12,13,10,11,13,11,13,18,15,13,5,20,1,1,1,9,8,20,D C,101,1,15,1,1,1,1,20,8,9,1,1,1,1,1,1,2.74878E+11,0,0,0,0,0,0,0,0,0,0,0,0,0,0,0,0,0,0,0,0,0,0,0,0,0,0,0,0,0,0,0,0,0,0,0,0,0,0,1,0,0,0,0,0,0,0,0,0,Milan Bisevac,£450Th. ,37,185,Defender - Centre-Back,right,Unknown,21,0,0,1835,10,0,0,711,7,1,0,555,nan,nan,nan,nan,nan,nan,nan,nan,Ligue 1
19-06-17,18.3.4.28,Kamil Glik,67030699,787,03-Feb-88,29,51,3,14,3,7000,7550,7550,152,151,90981047,190,80,D C,2,3,3,3,3,4,3,1,3,2,1,3,5,7,10,10,6,18,11,10,15,11,12,17,9,17,15,18,13,14,11,14,18,7,16,6,15,15,14,11,10,17,16,7,17,13,20,15,18,16,14,16,4,6,14,15,16,17,18,13,14,6,20,1,1,1,1,1,20,D C,101,1,12,1,1,1,1,20,1,1,1,1,1,1,1,1,4.50374E+15,0,0,0,0,0,0,0,0,0,0,0,0,0,0,0,1,0,0,0,0,0,0,0,0,0,0,0,0,0,0,0,0,0,0,0,0,0,1,0,0,0,0,0,0,0,0,0,0,Kamil Glik,£16.20m ,32,190,Defender - Centre-Back,right,Benevento Calcio,53,8,3,4740,48,4,4,4320,42,1,0,3826,24,1,0,2160,5,0,0,450,Ligue 1
19-06-17,18.3.4.28,Rolando,744475,788,31-Aug-85,31,19,0,7,0,4750,6450,6750,140,129,232186002,189,77,D C,1,2,1,3,3,2,3,4,1,3,2,5,8,7,10,10,9,15,9,8,14,12,10,15,10,15,14,13,13,14,10,12,14,10,14,11,13,14,15,8,10,12,16,10,16,10,20,14,16,13,11,13,7,10,10,14,13,13,15,13,13,7,20,1,1,1,1,1,20,D C,101,1,5,1,1,1,1,20,1,1,5,1,1,1,1,1,32768,0,0,0,0,0,0,0,0,0,0,0,0,0,0,0,1,0,0,0,0,0,0,0,0,0,0,0,0,0,0,0,0,0,0,0,0,0,0,0,0,0,0,0,0,0,0,0,0,Rolando,£675Th. ,35,189,Defender - Centre-Back,right,SC Braga,35,4,0,3187,46,2,0,3819,14,0,0,1105,3,0,0,84,0,0,0,0,Ligue 1
19-06-17,18.3.4.28,Junior Alonso,79024221,1655,09-Feb-93,24,13,1,0,0,3500,6200,6200,144,124,6621007,180,83,D LC,3,1,2,2,1,3,2,1,4,2,2,9,12,7,7,8,12,11,12,14,13,8,5,14,7,14,14,15,8,11,11,12,11,6,11,8,13,13,14,13,9,14,14,20,14,12,13,13,15,11,14,11,7,11,15,10,12,12,12,9,7,8,20,5,1,1,1,17,20,D LC,104,1,1,1,1,1,1,20,17,1,1,1,1,1,5,1,0,0,0,0,0,0,0,0,0,0,0,0,0,0,0,0,0,0,0,0,0,0,0,0,0,0,0,0,0,0,0,0,0,0,0,0,0,0,0,0,0,0,0,0,0,0,0,0,0,Júnior Alonso,£1.80m ,27,184,Defender - Centre-Back,left,Clube Atlético Mineiro,14,0,1,1136,38,3,0,3168,27,0,0,2061,37,0,3,3151,nan,nan,nan,nan,Ligue 1
19-06-17,18.3.4.28,Andrea Raggi,837002,776,24-Jun-84,32,0,0,3,0,5750,6500,6600,136,132,4268860,187,82,D RLC,2,3,3,3,1,1,3,3,2,1,3,5,11,8,7,10,6,15,9,14,15,10,8,16,9,16,14,17,12,15,8,12,17,9,17,11,13,15,13,11,11,16,14,6,13,12,20,13,15,13,14,15,8,14,14,14,16,16,16,12,11,7,20,10,1,1,17,16,20,D RLC,106,1,1,1,1,1,1,20,16,17,1,1,1,1,9,10,5.62967E+14,0,0,0,0,0,0,1,0,0,0,0,0,0,0,0,1,0,1,0,0,0,0,0,0,0,0,0,0,0,0,0,0,0,0,1,0,0,0,0,0,0,0,0,0,0,0,0,0,Andrea Raggi,£450Th. ,36,187,Defender - Centre-Back,right,Without Club,37,0,2,2611,28,1,0,2300,11,0,0,945,nan,nan,nan,nan,nan,nan,nan,nan,Ligue 1
19-06-17,18.3.4.28,Chidozie Awaziem,84125462,38,01-Jan-97,20,2,0,0,0,3700,5500,5900,135,113,1131764,189,78,D/DM C,1,2,1,3,1,1,3,3,3,1,2,7,8,9,7,9,6,12,8,8,12,12,6,13,11,15,13,14,11,10,8,12,14,6,9,11,11,13,14,13,12,12,13,7,14,13,20,12,13,13,6,12,5,13,16,13,13,13,15,14,12,5,20,1,13,1,12,1,20,D/DM C,111,1,1,1,1,1,1,20,1,12,19,13,1,1,1,1,0,0,0,0,0,0,0,0,0,0,0,0,0,0,0,0,0,0,0,0,0,0,0,0,0,0,0,0,0,0,0,0,0,0,0,0,0,0,0,0,0,0,0,0,0,0,0,0,0,Chidozie Awaziem,£5.40m ,23,189,Defender - Centre-Back,right,Boavista FC,35,0,2,3049,23,1,0,1537,21,0,1,1727,29,0,0,2293,4,0,0,360,Ligue 1
19-06-17,18.3.4.28,Daniel Congré,8431097,769,05-Apr-85,32,0,0,7,2,3900,6350,6350,134,127,232186002,185,80,D C,2,1,1,3,3,1,2,3,1,1,3,5,10,9,6,11,7,15,8,8,14,12,6,14,11,14,14,16,12,12,8,11,17,5,14,7,15,14,14,11,11,15,13,8,15,11,20,14,15,14,12,15,8,13,10,14,17,13,16,15,15,7,20,1,1,1,13,1,20,D C,101,1,1,1,1,1,1,20,1,13,1,1,1,1,1,1,0,0,0,0,0,0,0,0,0,0,0,0,0,0,0,0,0,0,0,0,0,0,0,0,0,0,0,0,0,0,0,0,0,0,0,0,0,0,0,0,0,0,0,0,0,0,0,0,0,Daniel Congré,£675Th. ,35,185,Defender - Centre-Back,right,Montpellier HSC,25,1,0,1904,39,2,0,3293,39,2,2,3473,29,0,1,2422,8,2,0,720,Ligue 1
19-06-17,18.3.4.28,Loďc Perrin,8433507,769,07-Aug-85,31,0,0,0,0,4000,6550,6550,140,129,232186002,180,76,D C,4,2,2,2,3,3,2,3,1,2,1,5,12,10,8,12,9,14,11,10,14,12,7,15,11,11,14,13,14,14,12,13,14,6,14,7,15,15,15,11,12,14,11,8,14,10,20,14,13,16,8,14,10,14,11,14,19,13,16,15,15,5,20,12,14,7,14,10,20,D C,101,1,1,1,1,1,7,20,10,14,15,14,1,7,10,12,0,0,0,0,0,0,0,0,0,0,0,0,0,0,0,0,0,0,0,0,0,0,0,0,0,0,0,0,0,0,0,0,0,0,0,0,0,0,0,0,0,0,0,0,0,0,0,0,0,Loïc Perrin,£3.60m ,35,181,Defender - Centre-Back,right,Retired,40,4,2,3446,28,0,1,2465,32,2,1,2790,30,0,0,2464,nan,nan,nan,nan,Ligue 1
19-06-17,18.3.4.28,Jérémy Sorbon,8440046,769,05-Aug-83,33,0,0,0,0,3800,6350,6350,128,127,232186002,183,79,D C,1,1,1,3,2,1,2,3,3,2,3,5,10,6,6,9,6,15,7,11,14,10,7,13,10,13,15,15,14,14,9,13,16,6,14,8,12,13,16,11,12,16,11,8,16,12,20,15,15,14,8,12,5,15,11,15,17,13,17,14,14,5,20,1,1,1,1,1,20,D C,101,1,1,1,1,1,1,20,1,1,1,1,1,1,1,1,2.74878E+11,0,0,0,0,0,0,0,0,0,0,0,0,0,0,0,0,0,0,0,0,0,0,0,0,0,0,0,0,0,0,0,0,0,0,0,0,0,0,1,0,0,0,0,0,0,0,0,0,Jérémy Sorbon,£900Th. ,37,183,Defender - Centre-Back,right,EA Guingamp,37,1,0,3336,32,0,0,2817,37,1,0,3109,10,0,0,897,7,0,0,553,Ligue 1
19-06-17,18.3.4.28,Romain Genevois,8443040,375,28-Oct-87,29,10,0,1,0,3850,6250,6250,127,125,4846362,182,79,D RC,4,1,3,4,3,1,4,1,1,2,2,5,9,9,9,11,6,13,8,12,14,9,8,14,11,14,14,15,11,13,7,12,16,8,8,9,13,13,14,15,12,13,11,6,14,14,20,15,15,12,14,13,7,15,11,13,10,11,8,13,16,5,20,15,12,1,15,1,20,D RC,103,1,1,8,1,1,1,20,1,15,10,1,1,12,1,15,32,0,0,0,0,0,1,0,0,0,0,0,0,0,0,0,0,0,0,0,0,0,0,0,0,0,0,0,0,0,0,0,0,0,0,0,0,0,0,0,0,0,0,0,0,0,0,0,0,Romain Genevois,£1.80m ,32,182,Defender - Centre-Back,right,Without Club,16,0,0,1129,26,1,1,2024,6,0,0,358,nan,nan,nan,nan,nan,nan,nan,nan,Ligue 1
19-06-17,18.3.4.28,Grégory Sertic,8443655,761,05-Aug-89,27,0,0,0,0,4000,6250,6000,134,125,2051036,183,76,D/DM C,1,2,4,3,3,3,4,2,1,2,2,13,12,12,7,14,14,12,13,5,12,14,12,10,14,6,13,14,13,14,14,13,15,10,12,10,12,13,14,10,12,14,9,10,11,10,20,14,14,12,7,13,8,15,13,14,12,11,14,13,13,6,18,1,15,7,7,7,18,D/DM C,321,1,1,1,7,1,1,18,1,1,20,15,7,7,1,1,4194304,0,0,0,0,0,0,0,0,0,0,0,0,0,0,0,0,0,0,0,0,0,0,1,0,0,0,0,0,0,0,0,0,0,0,0,0,0,0,0,0,0,0,0,0,0,0,0,0,Grégory Sertic,£3.60m ,31,183,Midfielder - Defensive Midfield,right,Without Club,28,1,1,2319,13,0,0,716,17,0,0,1103,nan,nan,nan,nan,nan,nan,nan,nan,Ligue 1
19-06-17,18.3.4.28,François Bellugou,8445734,769,25-Apr-87,30,0,0,0,0,3900,6050,6050,126,121,232186002,188,75,DM/M C,1,2,3,2,1,3,2,2,3,2,1,4,8,10,6,13,7,14,9,6,13,12,8,14,13,12,14,13,14,13,13,12,14,6,13,8,14,15,15,9,12,14,14,10,13,10,20,16,12,13,12,15,9,11,10,14,13,12,15,12,13,6,15,1,18,1,1,1,18,DM/M C,311,1,1,1,1,1,1,15,1,1,20,18,1,1,1,1,1.75922E+13,0,0,0,0,0,1,0,0,0,0,0,0,0,0,0,0,0,0,0,0,0,0,0,0,0,0,0,0,0,0,0,0,0,0,0,0,0,0,0,0,0,0,0,0,1,0,0,0,François Bellugou,£1.35m ,33,188,Midfielder - Defensive Midfield,right,AJ Auxerre,28,0,0,1547,34,1,0,2494,20,0,0,1653,27,0,1,2372,3,0,0,29,Ligue 1
19-06-17,18.3.4.28,Paul Baysse,8448625,769,18-May-88,29,0,0,6,1,4500,6550,6550,144,131,10187001,185,82,D RC,1,2,2,2,3,1,2,3,4,3,2,4,12,7,7,11,6,15,9,13,14,13,6,14,11,15,14,17,13,14,11,13,13,7,12,8,14,16,15,12,12,8,13,8,12,11,20,14,15,13,6,15,10,8,12,15,12,12,13,14,14,5,20,10,1,1,16,8,20,D RC,103,1,1,1,1,1,1,20,8,16,1,1,1,1,8,10,0,0,0,0,0,0,0,0,0,0,0,0,0,0,0,0,0,0,0,0,0,0,0,0,0,0,0,0,0,0,0,0,0,0,0,0,0,0,0,0,0,0,0,0,0,0,0,0,0,Paul Baysse,£2.25m ,32,185,Defender - Centre-Back,right,FC Girondins Bordeaux,25,2,1,2126,24,1,0,1896,26,0,0,2273,0,0,0,0,7,0,0,512,LaLiga
19-06-17,18.3.4.28,Kévin Théophile-Catherine,8449438,769,28-Oct-89,27,0,0,1,0,3950,6300,6300,135,126,5265144,180,77,D RC,2,2,1,3,3,3,3,1,2,1,1,7,12,12,6,11,7,13,11,11,13,10,7,12,11,12,13,14,12,11,10,11,15,9,8,8,13,13,14,16,12,14,12,8,14,14,20,15,14,12,12,13,5,14,11,8,14,9,12,13,14,6,20,15,1,1,20,13,16,D RC,103,1,1,1,1,1,1,16,13,20,8,1,1,1,10,15,1.09951E+12,0,1,0,0,0,1,0,0,0,0,0,0,0,0,0,0,0,0,0,0,0,0,0,0,0,0,0,0,0,0,0,0,0,0,0,0,0,0,0,0,1,0,0,0,0,0,0,0,Kévin Théophile-Catherine,£3.60m ,30,183,Defender - Centre-Back,right,GNK Dinamo Zagreb,42,0,2,3719,27,0,1,2374,32,1,0,2898,26,1,2,2307,9,0,0,689,Ligue 1
19-06-17,18.3.4.28,Bakary Koné,85000226,9,27-Apr-88,29,73,0,0,0,3900,6200,6200,138,124,3794972,188,82,D C,3,2,3,1,2,1,2,1,2,3,1,4,6,8,6,11,7,15,7,7,13,12,10,17,11,15,14,15,10,12,7,10,14,7,9,8,14,13,14,12,13,10,16,6,12,12,20,13,15,12,16,16,6,6,14,15,13,12,11,11,13,8,20,1,1,1,1,1,20,D C,101,1,1,1,1,1,1,20,1,1,1,1,1,1,1,1,1.37439E+11,0,0,0,0,0,1,0,0,0,0,0,0,0,0,0,0,0,0,0,0,0,0,0,0,0,0,0,0,0,0,0,0,0,0,0,0,0,1,0,0,0,0,0,0,0,0,0,0,Bakary Koné,£1.35m ,32,188,Defender - Centre-Back,right,Kerala Blasters FC,7,0,0,603,33,1,1,2972,18,0,0,1340,0,0,0,0,nan,nan,nan,nan,Ligue 1
19-06-17,18.3.4.28,Romain Thomas,85006426,769,12-Jun-88,29,0,0,0,0,3950,6450,6450,131,129,9734592,193,84,D C,1,3,3,2,3,1,2,4,3,4,3,4,8,8,9,10,6,14,7,8,14,12,6,14,11,12,13,14,12,14,12,12,14,6,11,8,14,15,13,11,11,16,16,20,12,12,8,14,15,14,12,13,6,10,8,13,15,12,16,15,14,6,20,1,1,1,1,14,20,D C,101,1,1,1,1,1,1,20,14,1,10,1,1,1,1,1,0,0,0,0,0,0,0,0,0,0,0,0,0,0,0,0,0,0,0,0,0,0,0,0,0,0,0,0,0,0,0,0,0,0,0,0,0,0,0,0,0,0,0,0,0,0,0,0,0,Romain Thomas,£3.15m ,32,193,Defender - Centre-Back,right,SCO Angers,42,1,0,3748,32,2,0,2832,29,2,1,2484,31,2,3,2651,5,0,0,420,Ligue 1
19-06-17,18.3.4.28,Ibrahim Amadou,85027975,11,06-Apr-93,24,0,0,0,0,4250,6450,6450,139,129,11362228,184,81,D/DM C,1,1,1,1,2,2,1,1,3,2,3,4,11,9,6,12,6,14,11,7,13,12,8,14,12,14,12,15,13,13,12,12,14,8,14,11,13,14,16,12,12,15,12,8,14,12,20,14,16,14,13,15,10,15,18,14,12,12,14,13,13,7,19,13,12,1,13,1,19,D/DM C,321,1,1,1,1,1,1,19,1,13,20,12,1,1,1,13,0,0,0,0,0,0,0,0,0,0,0,0,0,0,0,0,0,0,0,0,0,0,0,0,0,0,0,0,0,0,0,0,0,0,0,0,0,0,0,0,0,0,0,0,0,0,0,0,0,Ibrahim Amadou,£3.15m ,27,183,Midfielder - Defensive Midfield,right,SCO Angers,41,2,1,3434,32,0,0,2591,32,0,1,1736,23,0,0,1708,2,0,0,180,Ligue 1
19-06-17,18.3.4.28,Adama Soumaoro,85032346,769,18-Jun-92,25,0,0,0,0,3900,6250,6250,129,125,6009488,187,93,D/DM C,2,1,3,1,1,1,2,1,2,3,3,4,5,6,6,11,6,15,8,6,15,10,6,13,9,14,13,17,13,14,7,11,15,5,8,6,13,14,16,9,10,18,13,8,15,12,20,16,18,13,14,14,11,10,12,13,15,13,13,10,15,6,20,1,12,1,1,1,20,D/DM C,111,1,1,1,1,1,1,20,1,1,16,12,1,1,1,1,32768,0,0,0,0,0,0,0,0,0,0,0,0,0,0,0,1,0,0,0,0,0,0,0,0,0,0,0,0,0,0,0,0,0,0,0,0,0,0,0,0,0,0,0,0,0,0,0,0,Adama Soumaoro,£2.70m ,28,186,Defender - Centre-Back,right,LOSC Lille,33,1,0,2820,15,0,0,1284,22,0,1,1825,19,2,0,1472,2,0,0,20,Ligue 1
19-06-17,18.3.4.28,Fallou Diagne,85033117,41,14-Aug-89,27,3,0,0,0,4000,6050,6050,128,121,3891855,185,80,D C,1,3,2,2,3,2,1,2,2,4,2,5,9,11,8,11,6,12,8,10,14,11,12,14,12,16,12,17,14,9,9,10,15,13,9,7,10,8,12,15,13,17,14,8,13,16,20,13,14,11,12,11,4,10,12,12,13,10,10,8,7,14,20,10,10,1,14,12,20,D C,101,1,1,1,1,1,1,20,12,14,13,10,1,1,8,10,1.41734E+11,0,0,0,0,0,0,0,0,0,0,0,0,0,0,0,0,0,0,0,0,0,0,0,0,0,0,0,0,0,0,0,0,1,0,0,0,0,1,0,0,0,0,0,0,0,0,0,0,Fallou Diagne,£1.35m ,31,185,Defender - Centre-Back,right,Without Club,17,0,0,1409,30,1,1,2332,14,0,0,1081,5,0,0,390,nan,nan,nan,nan,Ligue 1
19-06-17,18.3.4.28,Kenny Lala,85051366,769,03-Oct-91,25,0,0,0,0,3800,6400,6400,129,128,8470046,178,77,D/WB RC,2,2,2,1,3,3,3,1,3,3,3,5,13,11,7,12,6,12,8,12,10,11,13,12,12,12,12,14,13,12,11,12,15,10,10,13,11,14,15,14,12,15,10,7,16,15,20,16,14,14,11,13,5,8,18,15,12,13,13,12,14,6,20,16,1,1,20,13,15,D/WB RC,113,1,1,1,1,1,1,15,13,20,1,1,1,1,13,16,134217728,0,0,0,0,0,0,0,0,0,0,0,0,0,0,0,0,0,0,0,0,0,0,0,0,0,0,0,1,0,0,0,0,0,0,0,0,0,0,0,0,0,0,0,0,0,0,0,0,Kenny Lala,£4.50m ,29,178,Defender - Right-Back,right,RC Strasbourg Alsace,40,1,3,3600,37,3,6,3166,40,5,10,3460,33,2,1,2540,8,1,0,694,Ligue 1
19-06-17,18.3.4.28,Christopher Jullien,85051582,769,22-Mar-93,24,0,0,0,0,3900,6450,6450,140,128,9678295,196,88,D C,3,1,3,2,2,1,1,3,3,4,2,4,7,6,10,10,4,17,7,10,13,11,5,13,10,14,13,13,8,12,6,12,11,5,16,6,13,14,9,13,12,13,17,7,13,15,20,14,15,13,13,13,7,10,7,14,12,7,10,14,14,10,20,8,1,1,10,1,20,D C,101,1,1,5,1,1,1,20,1,10,1,1,1,1,1,8,0,0,0,0,0,0,0,0,0,0,0,0,0,0,0,0,0,0,0,0,0,0,0,0,0,0,0,0,0,0,0,0,0,0,0,0,0,0,0,0,0,0,0,0,0,0,0,0,0,Christopher Jullien,£5.40m ,27,196,Defender - Centre-Back,right,Celtic FC,37,5,1,3360,36,2,3,3118,35,1,0,3105,46,7,2,4000,7,2,2,630,Ligue 1
19-06-17,18.3.4.28,Koffi Djidji,85052013,769,30-Nov-92,24,0,0,0,0,3800,6350,6350,131,127,9078929,184,71,D C,1,2,3,1,3,1,3,3,2,4,2,4,10,10,6,11,6,14,8,7,14,11,6,13,11,12,12,13,12,11,12,13,14,6,9,10,13,13,14,15,13,14,13,8,12,14,20,13,14,13,12,14,15,8,7,13,13,10,10,11,10,7,20,12,1,1,12,13,20,D C,101,1,1,1,1,1,1,20,13,12,12,1,1,1,10,12,2.74878E+11,0,0,0,0,0,0,0,0,0,0,0,0,0,0,0,0,0,0,0,0,0,0,0,0,0,0,0,0,0,0,0,0,0,0,0,0,0,0,1,0,0,0,0,0,0,0,0,0,Koffi Djidji,£3.15m ,27,184,Defender - Centre-Back,right,FC Crotone,30,0,0,2675,31,0,0,2597,19,0,0,1569,19,0,0,1005,nan,nan,nan,nan,Ligue 1
19-06-17,18.3.4.28,Jonathan Rivierez,85055657,769,18-May-89,28,0,0,0,0,3600,5500,5500,116,109,847791,181,79,D/WB RC,2,2,3,1,3,3,1,3,1,4,3,5,12,10,5,10,6,11,7,8,12,9,7,12,11,13,13,14,13,12,9,9,13,9,7,8,13,13,13,15,12,13,10,5,13,13,20,15,14,14,13,5,6,10,10,13,13,13,14,14,14,5,20,16,1,1,20,10,17,D/WB RC,113,1,1,1,1,1,1,17,10,20,1,1,1,1,10,16,0,0,0,0,0,0,0,0,0,0,0,0,0,0,0,0,0,0,0,0,0,0,0,0,0,0,0,0,0,0,0,0,0,0,0,0,0,0,0,0,0,0,0,0,0,0,0,0,0,Jonathan Rivierez,£720Th. ,31,182,Defender - Centre-Back,right,SM Caen,18,0,1,1418,28,0,2,2271,20,0,0,1129,33,2,0,2924,8,0,0,720,Ligue 1
19-06-17,18.3.4.28,Prince-Désir Gouano,85058610,769,24-Dec-93,23,0,0,0,0,3500,6350,6350,135,127,8210509,186,78,D C,1,2,2,1,2,2,2,2,1,2,3,6,6,6,7,10,3,15,7,10,14,9,10,14,10,12,14,16,11,12,6,13,14,7,7,12,14,14,13,11,13,14,14,9,15,13,20,14,14,13,14,13,9,8,14,15,10,10,12,15,15,12,20,1,1,1,10,1,20,D C,101,1,13,1,1,1,1,20,1,10,10,1,1,1,1,1,0,0,0,0,0,0,0,0,0,0,0,0,0,0,0,0,0,0,0,0,0,0,0,0,0,0,0,0,0,0,0,0,0,0,0,0,0,0,0,0,0,0,0,0,0,0,0,0,0,Prince Gouano,£2.70m ,26,186,Defender - Centre-Back,right,Amiens SC,14,0,0,809,34,0,0,2931,32,1,0,2801,3,0,0,270,nan,nan,nan,nan,Ligue 1
19-06-17,18.3.4.28,Papy Djilobodji,85059351,41,01-Dec-88,28,15,0,0,0,5000,6700,6350,140,127,18569483,193,82,D C,1,2,2,3,4,2,2,1,1,1,2,5,9,9,8,10,8,12,11,8,12,12,7,15,13,14,11,17,14,14,10,11,16,8,12,10,10,8,12,13,10,15,17,20,15,15,14,13,15,14,15,14,7,8,12,17,12,15,14,10,9,10,20,1,1,1,1,1,20,D C,101,1,1,1,1,1,1,20,1,1,12,1,1,1,1,1,1.40742E+14,0,0,0,0,0,0,0,0,0,0,0,0,0,0,0,0,0,0,0,0,0,0,0,0,0,0,0,0,0,0,0,0,1,0,0,0,0,0,0,0,0,0,0,0,0,0,0,1,Papy Djilobodji,£4.95m ,31,193,Defender - Centre-Back,left,Gaziantep FK,23,0,0,2027,33,1,2,3000,5,1,0,295,36,6,2,3036,6,0,0,495,Ligue 1
19-06-17,18.3.4.28,Christophe Kerbrat,85059655,769,02-Aug-86,30,0,0,0,0,3800,6300,6300,128,126,232186002,185,74,D/DM C,1,2,2,2,2,1,1,2,3,3,1,5,12,7,6,10,7,14,12,5,14,12,6,13,11,14,13,17,13,16,12,13,13,9,8,9,14,14,15,13,12,15,12,6,17,11,20,15,13,14,14,15,5,13,7,14,19,15,14,11,12,6,20,10,10,1,10,1,20,D/DM C,111,1,1,1,1,1,1,20,1,10,17,10,1,1,1,10,1.37439E+11,0,0,0,0,0,0,0,0,0,0,0,0,0,0,0,0,0,0,0,0,0,0,0,0,0,0,0,0,0,0,0,0,0,0,0,0,0,1,0,0,0,0,0,0,0,0,0,0,Christophe Kerbrat,£1.80m ,34,183,Defender - Centre-Back,right,Stade Briochin,42,0,1,3736,40,1,0,3564,30,0,0,2593,18,0,1,1424,nan,nan,nan,nan,Ligue 1
19-06-17,18.3.4.28,Wesley Lautoa,85060157,129532,25-Aug-87,29,0,0,0,0,3800,6200,6200,128,124,4318048,184,85,D/DM C,3,1,1,2,1,3,1,1,1,1,1,4,8,8,6,12,6,14,8,5,13,12,6,14,12,11,13,14,13,12,11,11,13,7,14,10,15,16,12,12,11,15,12,20,13,11,7,14,16,13,11,13,13,12,13,14,13,14,15,14,14,6,20,1,7,1,1,14,20,D/DM C,111,1,1,1,1,1,1,20,14,1,18,7,1,1,1,1,0,0,0,0,0,0,0,0,0,0,0,0,0,0,0,0,0,0,0,0,0,0,0,0,0,0,0,0,0,0,0,0,0,0,0,0,0,0,0,0,0,0,0,0,0,0,0,0,0,Wesley Lautoa,£1.80m ,33,184,Defender - Centre-Back,left,Dijon FCO,26,2,0,1955,10,0,0,621,40,0,1,3449,27,1,1,2262,8,0,0,398,Ligue 1
19-06-17,18.3.4.28,Nicolas Pallois,85074521,769,19-Sep-87,29,0,0,0,0,3800,6300,6300,137,126,6672037,190,85,D C,1,2,1,1,2,1,1,2,1,2,1,5,8,8,7,7,7,15,10,9,15,7,6,14,8,18,13,19,10,14,8,10,15,6,12,7,13,14,16,11,11,17,13,20,15,13,8,15,17,12,17,14,9,8,14,14,14,6,10,8,8,12,20,10,1,1,1,14,20,D C,101,1,1,1,1,1,1,20,14,1,1,1,1,1,10,1,8.79609E+12,0,0,1,0,0,1,0,0,0,0,0,0,0,0,0,0,0,1,0,0,0,0,0,0,0,0,0,0,0,0,0,0,0,0,0,0,0,0,0,0,0,0,0,1,0,0,0,0,Nicolas Pallois,£3.15m ,33,189,Defender - Centre-Back,left,FC Nantes,39,2,1,3487,31,0,2,2705,31,2,0,2790,22,0,0,1980,7,0,0,630,Ligue 1
19-06-17,18.3.4.28,Christophe Hérelle,85076637,769,22-Aug-92,24,0,0,0,0,3500,6250,6250,129,125,6720288,188,75,D/DM RC,2,2,4,1,3,2,3,3,1,3,1,4,10,7,5,10,7,13,10,5,14,11,6,14,13,14,14,15,12,12,8,13,12,5,6,10,14,13,14,13,13,15,14,5,15,12,20,14,14,12,10,12,7,12,9,13,10,7,12,10,10,8,20,13,1,1,16,1,20,D/DM RC,113,1,1,1,1,1,1,20,1,16,16,1,1,1,1,13,0,0,0,0,0,0,0,0,0,0,0,0,0,0,0,0,0,0,0,0,0,0,0,0,0,0,0,0,0,0,0,0,0,0,0,0,0,0,0,0,0,0,0,0,0,0,0,0,0,Christophe Hérelle,£5.40m ,28,188,Defender - Centre-Back,right,Stade Brest 29,36,0,0,2829,35,0,0,3049,34,0,0,3028,18,3,0,1363,5,0,0,433,Ligue 1
19-06-17,18.3.4.28,Ismaël Diomandé,85079061,24,28-Aug-92,24,17,1,0,0,3500,5750,5750,127,115,2677373,180,75,DM C,1,1,2,2,3,1,3,1,1,3,1,5,12,12,6,11,7,13,12,6,12,12,6,12,11,13,13,15,11,11,12,9,15,7,12,8,12,14,16,14,13,15,10,8,15,13,20,15,14,14,13,12,7,11,7,12,14,13,14,13,13,6,15,1,13,1,1,1,15,DM C,301,1,1,1,1,1,1,15,1,1,20,13,1,1,1,1,64,0,0,0,0,0,0,1,0,0,0,0,0,0,0,0,0,0,0,0,0,0,0,0,0,0,0,0,0,0,0,0,0,0,0,0,0,0,0,0,0,0,0,0,0,0,0,0,0,Ismaël Diomandé,£900Th. ,28,183,Midfielder - Defensive Midfield,right,Caykur Rizespor,14,0,0,969,17,3,1,1251,20,0,1,1439,24,0,0,1765,nan,nan,nan,nan,Ligue 1
19-06-17,18.3.4.28,Théo Pellenard,85080137,769,04-Mar-94,23,0,0,0,0,3500,5750,5750,126,115,2208067,182,71,D LC,3,3,1,3,1,2,4,1,3,1,2,7,10,12,6,12,11,12,5,13,13,13,6,13,11,12,13,14,10,11,13,12,10,13,12,11,12,13,12,11,13,12,12,20,17,12,8,13,9,11,14,10,10,13,13,9,13,13,12,10,8,6,20,14,10,8,10,20,15,D LC,104,1,1,1,1,8,1,15,20,10,1,1,10,1,14,8,0,0,0,0,0,0,0,0,0,0,0,0,0,0,0,0,0,0,0,0,0,0,0,0,0,0,0,0,0,0,0,0,0,0,0,0,0,0,0,0,0,0,0,0,0,0,0,0,0,Théo Pellenard,£1.80m ,26,182,Defender - Left-Back,left,Without Club,9,0,0,682,21,0,1,1637,6,0,0,495,11,0,0,656,nan,nan,nan,nan,Ligue 1
19-06-17,18.3.4.28,Jimmy Giraudon,85081075,769,16-Jan-92,25,0,0,0,0,3500,5950,5950,123,119,2659946,184,66,D C,3,2,2,1,1,2,3,2,3,1,1,5,6,9,7,11,8,15,12,7,15,14,7,12,11,12,14,15,13,10,9,12,5,8,5,10,14,15,12,11,11,14,13,6,15,11,20,13,14,13,9,11,7,10,18,12,13,13,11,12,15,7,20,1,12,1,1,1,20,D C,101,1,1,1,1,1,1,20,1,1,15,12,1,1,1,1,4194304,0,0,0,0,0,0,0,0,0,0,0,0,0,0,0,0,0,0,0,0,0,0,1,0,0,0,0,0,0,0,0,0,0,0,0,0,0,0,0,0,0,0,0,0,0,0,0,0,Jimmy Giraudon,£900Th. ,28,184,Defender - Centre-Back,right,ES Troyes AC,38,2,0,3375,28,0,0,2392,38,0,2,3358,27,0,1,2430,8,0,0,715,Ligue 1
19-06-17,18.3.4.28,Pablo Martinez,85095411,769,21-Feb-89,28,0,0,0,0,3600,6100,6100,125,122,4066228,182,77,D LC,3,4,1,2,2,3,4,3,1,4,3,5,11,10,6,11,10,13,11,8,13,11,8,13,12,14,13,14,12,13,8,12,16,8,7,10,12,13,15,13,14,13,11,20,15,14,8,15,13,13,12,13,8,12,11,12,14,12,13,12,14,6,20,15,10,1,1,17,20,D LC,104,1,1,1,1,1,1,20,17,1,10,1,10,1,15,1,0,0,0,0,0,0,0,0,0,0,0,0,0,0,0,0,0,0,0,0,0,0,0,0,0,0,0,0,0,0,0,0,0,0,0,0,0,0,0,0,0,0,0,0,0,0,0,0,0,Pablo Martinez,£720Th. ,31,182,Defender - Centre-Back,left,Nîmes Olympique,13,0,0,911,25,0,1,2235,38,3,2,3419,28,2,1,2478,4,0,1,305,Ligue 1
19-06-17,18.3.4.28,Frédéric Guilbert,85096693,769,24-Dec-94,22,0,0,1,0,4000,6200,6200,136,124,9154263,177,68,D RC,2,1,2,1,1,2,3,3,3,2,1,5,12,9,7,12,8,13,10,16,11,12,8,14,12,12,13,12,12,12,10,13,14,11,13,11,12,13,14,13,14,13,11,10,14,12,20,12,14,12,11,12,8,14,13,12,14,12,14,12,12,5,20,12,1,1,18,1,20,D RC,103,1,13,1,1,1,1,20,1,18,11,1,1,1,1,12,0,0,0,0,0,0,0,0,0,0,0,0,0,0,0,0,0,0,0,0,0,0,0,0,0,0,0,0,0,0,0,0,0,0,0,0,0,0,0,0,0,0,0,0,0,0,0,0,0,Frédéric Guilbert,£5.40m ,25,178,Defender - Right-Back,right,Aston Villa,29,0,1,2458,42,1,3,3840,38,1,2,3291,29,2,2,2352,2,0,0,180,Ligue 1
19-06-17,18.3.4.28,Baďssama Sankoh,85097012,22,20-Mar-92,25,14,0,0,0,3250,5800,5800,121,116,2200882,180,73,D RC,2,2,3,1,1,2,3,2,2,1,3,5,10,8,5,11,6,13,9,6,14,12,5,13,11,10,12,13,11,13,9,11,14,8,7,8,11,13,14,15,12,14,10,6,15,14,20,13,14,12,7,7,8,11,10,12,15,9,13,10,13,6,20,10,1,1,19,1,20,D RC,103,1,1,1,1,1,1,20,1,19,14,1,1,1,1,10,0,0,0,0,0,0,0,0,0,0,0,0,0,0,0,0,0,0,0,0,0,0,0,0,0,0,0,0,0,0,0,0,0,0,0,0,0,0,0,0,0,0,0,0,0,0,0,0,0,Baissama Sankoh,£720Th. ,28,180,Midfielder - Defensive Midfield,right,Nea Salamina Famagusta,21,0,0,1462,30,0,0,1922,19,0,0,927,10,4,0,805,3,0,0,158,Ligue 1
19-06-17,18.3.4.28,Steeve Yago,85100394,9,16-Dec-92,24,36,0,0,0,3750,6100,6000,129,119,3287468,180,77,D RC,3,2,3,3,3,3,3,3,2,3,1,6,11,11,6,13,7,11,5,8,14,10,9,12,9,15,14,17,10,12,8,13,14,7,8,7,10,13,15,15,13,13,10,5,14,14,20,15,14,10,15,11,7,11,12,12,14,15,13,12,14,2,20,15,1,1,20,10,19,D RC,103,1,1,1,1,1,1,19,10,20,1,1,1,1,10,15,0,0,0,0,0,0,0,0,0,0,0,0,0,0,0,0,0,0,0,0,0,0,0,0,0,0,0,0,0,0,0,0,0,0,0,0,0,0,0,0,0,0,0,0,0,0,0,0,0,Steeve Yago,£1.80m ,27,178,Defender - Centre-Back,right,SM Caen,24,0,1,2072,27,0,0,2076,14,0,1,1206,18,0,0,1492,6,0,0,405,Ligue 1
19-06-17,18.3.4.28,Almamy Touré,85122415,31,28-Apr-96,21,0,0,0,0,5550,6000,6550,156,131,15000571,184,80,D RC,1,2,2,3,2,1,1,3,1,1,4,8,15,13,8,13,8,16,9,12,13,13,10,13,13,12,13,12,12,13,12,12,14,12,9,14,13,14,13,14,13,14,12,7,13,14,20,14,14,13,7,15,11,13,15,15,16,14,16,17,17,5,20,14,1,1,20,12,16,D RC,103,1,1,1,1,1,1,16,12,20,10,1,1,1,10,14,2.79174E+11,0,1,0,0,0,1,0,0,0,0,0,0,0,0,0,0,0,0,0,0,1,0,0,0,0,0,0,0,0,0,0,0,1,0,0,0,0,0,1,0,0,0,0,0,0,0,0,0,Almamy Touré,£7.20m ,24,183,Defender - Right-Back,right,Eintracht Frankfurt,27,0,5,1981,27,1,6,1872,12,0,0,880,29,1,4,2370,4,0,0,317,Ligue 1
19-06-17,18.3.4.28,Cédric Yambéré,85128056,13,06-Nov-90,26,1,0,0,0,3350,5800,5800,120,116,2200882,191,81,D C,3,3,1,3,2,1,1,2,2,3,1,4,5,10,8,7,6,11,6,10,12,10,5,12,7,16,13,16,11,13,7,10,14,5,12,10,13,13,12,13,13,16,16,7,16,14,20,14,14,13,13,15,6,12,13,6,14,8,8,13,7,4,20,1,8,1,1,1,20,D C,101,1,10,1,1,1,1,20,1,1,15,8,1,1,1,1,21508423680,0,0,0,0,0,0,0,0,0,0,0,0,0,0,0,1,0,0,0,0,0,0,0,0,0,1,0,0,0,0,0,0,1,0,1,0,0,0,0,0,0,0,0,0,0,0,0,0,Cédric Yambéré,£2.25m ,29,191,Defender - Centre-Back,right,Without Club,22,1,0,1628,33,3,1,2920,38,0,0,3253,30,3,0,2394,nan,nan,nan,nan,Ligue 1
19-06-17,18.3.4.28,Jérémy Gélin,85133955,769,24-Apr-97,20,0,0,0,0,3000,5500,5500,136,110,2344787,182,77,D/DM C,3,3,1,1,2,2,1,3,3,1,1,3,8,7,5,11,6,13,7,6,11,12,7,13,12,8,13,11,7,12,11,16,12,3,12,7,12,12,13,12,11,14,12,10,15,12,20,13,12,12,8,13,11,10,15,14,11,9,14,15,15,7,18,1,12,1,1,1,18,D/DM C,321,1,1,1,1,1,1,18,1,1,20,12,1,1,1,1,0,0,0,0,0,0,0,0,0,0,0,0,0,0,0,0,0,0,0,0,0,0,0,0,0,0,0,0,0,0,0,0,0,0,0,0,0,0,0,0,0,0,0,0,0,0,0,0,0,Jérémy Gélin,£7.20m ,23,183,Defender - Centre-Back,right,Royal Antwerp FC,nan,nan,nan,nan,38,0,2,3094,33,0,0,1811,18,1,0,1301,3,0,0,270,Ligue 1
19-06-17,18.3.4.28,Kévin N'Doram,85135790,769,22-Jan-96,21,0,0,2,0,3800,5700,5900,145,118,4123002,185,80,DM/M C,3,3,3,1,1,2,3,1,1,2,2,5,6,11,7,12,5,13,8,7,13,12,8,14,12,13,13,14,12,14,11,12,14,10,11,7,12,15,13,13,12,14,13,8,15,13,20,14,14,13,8,13,6,11,13,13,17,14,15,14,15,4,15,1,17,1,1,1,17,DM/M C,311,1,1,1,1,1,1,15,1,1,20,17,1,1,1,1,64,0,0,0,0,0,0,1,0,0,0,0,0,0,0,0,0,0,0,0,0,0,0,0,0,0,0,0,0,0,0,0,0,0,0,0,0,0,0,0,0,0,0,0,0,0,0,0,0,Kévin N'Doram,£5.40m ,24,185,Midfielder - Defensive Midfield,right,FC Metz,8,1,1,619,16,0,1,1080,5,0,0,283,22,0,0,1826,nan,nan,nan,nan,Ligue 1
19-06-17,18.3.4.28,Bryan Passi,85140255,769,05-Aug-97,19,0,0,0,0,1750,4700,4700,111,94,597723,189,78,D RC,1,2,3,3,3,2,1,1,3,2,1,5,7,10,8,9,10,11,6,2,11,11,5,10,11,10,10,11,5,11,10,11,10,2,7,11,13,11,12,12,11,13,14,5,14,12,20,10,11,10,10,6,7,10,15,12,11,12,10,11,19,6,20,1,1,1,17,1,20,D RC,103,1,1,1,1,1,1,20,1,17,15,1,1,1,1,1,0,0,0,0,0,0,0,0,0,0,0,0,0,0,0,0,0,0,0,0,0,0,0,0,0,0,0,0,0,0,0,0,0,0,0,0,0,0,0,0,0,0,0,0,0,0,0,0,0,Bryan Passi, ,23,189,Defender - Centre-Back,right,Chamois Niortais FC,3,0,0,143,1,0,0,90,0,0,0,0,17,0,1,1501,3,0,0,260,Ligue 1
19-06-17,18.3.4.28,Issa Diop,85140415,769,09-Jan-97,20,0,0,4,0,4250,6300,6300,142,125,14479470,194,92,D C,3,3,2,2,1,1,1,3,1,2,2,3,3,5,6,10,5,16,10,8,12,11,4,16,11,14,13,12,10,13,10,12,15,3,14,13,13,14,14,12,10,15,17,5,16,13,20,12,16,13,13,12,5,7,17,14,13,11,12,13,14,7,20,1,1,1,1,1,20,D C,101,1,1,1,1,1,1,20,1,1,1,1,1,1,1,1,0,0,0,0,0,0,0,0,0,0,0,0,0,0,0,0,0,0,0,0,0,0,0,0,0,0,0,0,0,0,0,0,0,0,0,0,0,0,0,0,0,0,0,0,0,0,0,0,0,Issa Diop,£19.80m ,23,194,Defender - Centre-Back,right,West Ham United,31,2,2,2820,41,3,1,3690,38,2,0,3420,35,3,1,3036,3,0,0,270,Ligue 1
19-06-17,18.3.4.28,Presnel Kimpembe,85141999,769,13-Aug-95,21,0,0,11,0,5750,6800,6800,164,136,22258433,186,72,D C,2,1,1,2,2,3,1,3,1,2,3,4,10,10,7,13,6,14,6,9,14,13,8,15,13,16,14,15,15,15,10,13,14,8,8,10,14,15,14,13,14,15,13,20,15,14,10,15,13,14,9,15,6,10,18,16,14,13,15,16,14,7,20,10,1,1,1,12,20,D C,101,1,1,1,1,1,1,20,12,1,7,1,1,1,10,1,0,0,0,0,0,0,0,0,0,0,0,0,0,0,0,0,0,0,0,0,0,0,0,0,0,0,0,0,0,0,0,0,0,0,0,0,0,0,0,0,0,0,0,0,0,0,0,0,0,Presnel Kimpembe,£27.00m ,25,189,Defender - Centre-Back,left,Paris Saint-Germain,28,0,0,2474,38,0,0,3252,36,1,1,3076,28,0,0,2334,8,0,0,605,Ligue 1
19-06-17,18.3.4.28,Ernest Seka,85145735,769,22-Jun-87,29,0,0,0,0,3500,6050,6050,124,121,3433057,185,84,D C,1,3,1,2,1,4,3,2,3,3,2,3,6,6,7,10,5,14,5,4,14,9,9,13,9,14,13,15,13,12,8,12,14,8,15,6,13,12,14,12,12,15,13,6,15,12,20,15,16,13,12,7,6,7,17,14,12,13,14,8,10,10,20,1,1,1,10,10,20,D C,101,1,1,1,1,1,1,20,10,10,1,1,1,1,1,1,32768,0,0,0,0,0,0,0,0,0,0,0,0,0,0,0,1,0,0,0,0,0,0,0,0,0,0,0,0,0,0,0,0,0,0,0,0,0,0,0,0,0,0,0,0,0,0,0,0,Ernest Seka,£540Th. ,33,185,Defender - Centre-Back,right,AS Nancy-Lorraine,38,3,1,3282,31,1,1,2624,38,0,1,3275,23,1,1,2040,6,0,0,540,Ligue 1
19-06-17,18.3.4.28,Steven Fortes,85146318,12,17-Apr-92,25,2,0,0,0,3750,5800,5800,124,115,2188155,192,85,D C,3,1,1,2,3,1,3,2,3,2,1,3,6,8,7,10,4,14,5,4,12,10,6,13,9,14,13,14,12,11,6,12,15,9,12,12,11,11,14,13,12,15,15,6,15,14,20,14,15,10,13,13,8,8,7,14,13,12,15,9,13,10,20,1,1,1,12,1,20,D C,101,1,1,1,1,1,1,20,1,12,10,1,1,1,1,1,32,0,0,0,0,0,1,0,0,0,0,0,0,0,0,0,0,0,0,0,0,0,0,0,0,0,0,0,0,0,0,0,0,0,0,0,0,0,0,0,0,0,0,0,0,0,0,0,0,Steven Fortes,£900Th. ,28,192,Defender - Centre-Back,right,RC Lens,27,1,0,2416,2,0,0,154,24,0,0,2054,15,0,0,1265,2,0,0,134,Ligue 1
19-06-17,18.3.4.28,Thiago Silva,8833628,1651,22-Sep-84,32,63,5,4,0,7250,8000,8050,174,161,232186002,183,79,D C,2,2,2,2,3,2,2,1,1,4,3,4,5,10,7,14,8,16,7,7,17,14,14,16,14,16,16,15,15,16,12,15,17,8,14,10,16,15,16,13,13,16,13,8,15,14,20,15,15,15,7,13,9,8,15,17,14,12,17,18,15,6,20,1,7,1,1,1,20,D C,101,1,10,1,1,1,1,20,1,1,7,7,1,1,1,1,32772,0,0,1,0,0,0,0,0,0,0,0,0,0,0,0,1,0,0,0,0,0,0,0,0,0,0,0,0,0,0,0,0,0,0,0,0,0,0,0,0,0,0,0,0,0,0,0,0,Thiago Silva,£9.00m ,36,183,Defender - Centre-Back,right,Chelsea FC,40,6,2,3465,39,1,0,3356,39,0,1,3328,35,1,1,2725,5,0,0,404,Ligue 1
19-06-17,18.3.4.28,Mathieu Bodmer,910568,769,22-Nov-82,34,0,0,3,0,3600,5750,5750,164,115,232186002,190,90,D/DM C,1,3,3,3,1,2,1,1,2,2,1,8,12,10,8,14,13,14,11,7,13,15,12,12,14,7,14,14,13,12,14,12,14,13,12,8,13,12,10,7,10,14,13,10,9,8,20,11,15,12,7,12,12,18,13,12,14,15,10,16,14,9,20,8,10,7,8,1,20,D/DM C,111,1,12,1,7,1,1,20,1,8,17,10,1,7,1,8,16777856,0,0,0,0,0,0,0,1,0,1,0,0,0,0,0,0,0,0,0,0,0,0,0,0,1,0,0,0,0,0,0,0,0,0,0,0,0,0,0,0,0,0,0,0,0,0,0,0,Mathieu Bodmer,£450Th. ,37,190,Midfielder - Defensive Midfield,right,Retired,30,1,1,1904,14,1,0,478,29,1,0,1247,10,1,2,162,nan,nan,nan,nan,Ligue 1
19-06-17,18.3.4.28,Cédric Varrault,913682,769,30-Jan-80,37,0,0,0,0,3500,5750,5750,121,115,171393,182,70,D C,2,1,3,2,1,1,2,4,2,2,2,8,10,8,6,11,7,12,8,12,13,10,6,14,11,15,13,15,11,13,7,12,12,8,15,7,14,14,14,9,11,14,11,12,12,10,20,12,12,14,15,13,9,10,8,12,14,11,16,12,14,6,20,12,1,1,14,12,20,D C,101,1,1,1,1,1,1,20,12,14,1,1,1,1,10,12,1.37439E+11,0,0,0,0,0,0,0,0,0,0,0,0,0,0,0,0,0,0,0,0,0,0,0,0,0,0,0,0,0,0,0,0,0,0,0,0,0,1,0,0,0,0,0,0,0,0,0,0,Cédric Varrault,£225Th. ,40,182,Defender - Centre-Back,right,JS Saint-Jean Beaulieu,32,3,0,2796,12,1,0,1004,nan,nan,nan,nan,nan,nan,nan,nan,nan,nan,nan,nan,Ligue 1
19-06-17,18.3.4.28,Sékou Baradji,917226,31,24-Apr-84,33,0,0,0,0,3000,5100,5100,111,102,179913,183,77,D/DM C,3,3,4,3,3,3,2,2,4,3,1,9,11,11,7,12,14,10,12,8,10,11,11,11,12,10,12,13,10,10,9,10,14,9,8,12,11,12,13,13,12,14,12,20,15,12,5,13,14,11,10,10,7,14,9,13,12,11,13,9,14,5,17,14,12,1,1,14,17,D/DM C,321,1,1,1,1,1,1,17,14,1,20,12,1,1,14,1,0,0,0,0,0,0,0,0,0,0,0,0,0,0,0,0,0,0,0,0,0,0,0,0,0,0,0,0,0,0,0,0,0,0,0,0,0,0,0,0,0,0,0,0,0,0,0,0,0,Sekou Baradji,£180Th. ,36,183,Midfielder - Defensive Midfield,left,Istres Football Club,nan,nan,nan,nan,2,0,0,35,nan,nan,nan,nan,nan,nan,nan,nan,nan,nan,nan,nan,Ligue 1
19-06-17,18.3.4.28,Jérémy Morel,919538,769,02-Apr-84,33,0,0,0,0,4000,6300,6550,137,131,232186002,172,71,D LC,3,3,1,1,1,2,1,2,3,1,3,6,9,7,5,11,6,12,7,11,14,11,6,14,10,10,16,16,12,12,7,12,16,9,15,9,14,15,15,14,14,14,10,20,14,14,9,15,13,15,11,13,8,12,13,14,17,10,16,15,15,5,20,15,1,1,1,17,20,D LC,104,1,1,1,1,1,1,20,17,1,1,1,1,1,15,1,1.37439E+11,0,0,0,0,0,0,0,0,0,0,0,0,0,0,0,0,0,0,0,0,0,0,0,0,0,0,0,0,0,0,0,0,0,0,0,0,0,1,0,0,0,0,0,0,0,0,0,0,Jérémy Morel,£225Th. ,36,172,Defender - Centre-Back,left,FC Lorient,44,1,4,3938,41,0,0,3544,15,0,0,1334,28,2,1,2466,8,0,0,720,Ligue 1
19-06-17,18.3.4.28,Thomas Mangani,919962,769,29-Apr-87,30,0,0,0,0,3900,6400,6400,129,128,232186002,183,78,D/DM C,1,1,3,3,1,4,2,2,2,2,2,13,8,9,6,12,14,13,10,12,11,12,8,13,12,12,15,13,13,13,11,13,15,6,12,7,13,16,18,12,11,14,12,20,14,11,8,16,14,14,12,14,6,12,11,12,13,12,15,15,15,5,17,14,12,1,1,14,17,D/DM C,321,1,1,1,1,1,1,17,12,1,20,12,12,1,14,1,1.37439E+11,0,0,0,0,0,0,0,0,0,0,0,0,0,0,0,0,0,0,0,0,0,0,0,0,0,0,0,0,0,0,0,0,0,0,0,0,0,1,0,0,0,0,0,0,0,0,0,0,Thomas Mangani,£3.15m ,33,183,Midfielder - Central Midfield,left,SCO Angers,40,6,9,3394,38,2,6,3230,31,3,0,1735,27,2,2,2128,8,1,0,537,Ligue 1
19-06-17,18.3.4.28,François Moubandje,98005085,798,21-Jan-90,27,14,0,2,0,3800,6400,6250,130,124,5642804,180,74,D/WB LC,1,3,1,1,3,4,2,2,3,2,1,10,13,13,6,13,9,12,7,11,13,13,11,12,12,16,14,14,10,10,11,13,4,1,8,11,12,12,13,14,14,13,9,20,15,13,5,15,13,11,3,5,10,12,8,14,10,9,11,11,13,5,20,17,13,1,1,20,15,D/WB LC,114,1,1,1,1,1,1,15,20,1,1,1,13,1,17,1,0,0,0,0,0,0,0,0,0,0,0,0,0,0,0,0,0,0,0,0,0,0,0,0,0,0,0,0,0,0,0,0,0,0,0,0,0,0,0,0,0,0,0,0,0,0,0,0,0,François Moubandje,£2.25m ,30,180,Defender - Left-Back,left,Alanyaspor,36,0,1,3248,25,1,0,2063,22,0,0,1934,16,0,0,1194,7,1,0,616,Ligue 1
19-06-17,18.3.4.28,Javi Martínez,1512305,796,02-Sep-88,28,18,0,24,1,7650,7650,8150,165,163,186515761,190,86,D/DM/M C,2,1,3,1,2,1,3,3,3,3,2,7,10,9,12,14,7,13,10,8,15,13,11,16,14,12,18,14,16,17,12,15,15,9,14,12,17,18,14,9,11,17,16,14,14,12,20,14,16,18,10,18,12,15,14,17,12,16,17,13,13,4,20,1,16,10,8,1,20,D/DM/M C,121,1,1,5,10,1,8,20,1,1,19,16,1,8,1,1,4294967296,0,0,0,0,0,0,0,0,0,0,0,0,0,0,0,0,0,0,0,0,0,0,0,0,0,0,0,0,0,0,0,0,1,0,0,0,0,0,0,0,0,0,0,0,0,0,0,0,Javi Martínez,£36.00m ,32,192,Midfielder - Defensive Midfield,right,Bayern Munich,37,2,1,2975,37,2,2,2738,33,4,0,2257,24,0,0,1015,7,1,0,248,Bundesliga
19-06-17,18.3.4.28,David Alaba,16010162,755,24-Jun-92,24,57,11,5,0,8250,8500,8750,174,170,232186002,178,72,D/WB/M LC,3,1,1,2,4,3,3,3,2,2,3,12,13,12,10,14,15,8,14,13,10,14,15,12,15,17,16,13,15,16,13,15,17,11,12,14,10,18,17,16,14,14,11,20,19,16,9,18,11,18,8,18,6,19,14,17,12,18,15,13,10,10,20,20,17,12,1,20,17,D/WB/M LC,124,1,1,1,12,12,1,16,20,1,14,17,12,1,20,1,135268352,0,0,0,0,0,0,0,0,0,0,0,1,0,0,0,0,0,0,0,0,1,0,0,0,0,0,0,1,0,0,0,0,0,0,0,0,0,0,0,0,0,0,0,0,0,0,0,0,David Alaba,£45.00m ,28,180,Defender - Centre-Back,left,Bayern Munich,47,5,7,3799,36,2,6,2638,43,3,7,3631,42,2,2,3693,6,0,1,562,Bundesliga
19-06-17,18.3.4.28,Martin Hinteregger,16020469,755,07-Sep-92,24,25,2,13,0,5600,6600,6600,142,132,11933464,184,78,D LC,3,1,3,1,3,3,3,2,1,2,2,5,8,10,9,9,12,12,14,10,16,13,11,14,10,14,16,16,11,10,14,14,10,10,12,8,13,12,10,11,8,16,13,20,11,15,10,12,15,11,9,15,10,12,8,12,15,13,8,12,9,17,20,11,12,1,1,15,20,D LC,104,1,1,1,1,1,1,20,15,1,12,12,1,1,11,1,1.75922E+14,0,0,0,0,0,0,0,0,0,0,0,0,0,0,0,0,0,0,0,0,0,0,0,0,0,0,0,0,0,0,0,0,0,0,0,0,0,0,0,0,0,0,0,0,0,1,0,1,Martin Hinteregger,£9.00m ,28,184,Defender - Centre-Back,left,Eintracht Frankfurt,43,3,0,3883,31,0,0,2744,41,4,0,3588,49,9,3,4259,6,0,0,540,Bundesliga
19-06-17,18.3.4.28,Philipp Lienhart,16130398,755,11-Jul-96,20,0,0,18,1,3750,6250,6250,137,125,6803698,185,81,D C,3,1,1,1,2,3,2,3,1,4,1,4,6,11,6,9,4,14,5,8,12,10,6,12,10,10,14,12,16,16,9,14,11,6,10,7,12,16,12,12,10,13,14,12,17,16,20,14,12,15,7,14,4,7,12,14,13,13,16,15,18,4,20,1,10,1,1,1,20,D C,101,1,12,1,1,1,1,20,1,1,10,10,1,1,1,1,0,0,0,0,0,0,0,0,0,0,0,0,0,0,0,0,0,0,0,0,0,0,0,0,0,0,0,0,0,0,0,0,0,0,0,0,0,0,0,0,0,0,0,0,0,0,0,0,0,Philipp Lienhart,£2.25m ,24,189,Defender - Centre-Back,right,SC Freiburg,26,0,0,2254,14,0,0,1137,16,0,0,709,24,0,1,1946,6,1,0,540,Bundesliga
19-06-17,18.3.4.28,Stefan Posch,16147386,755,14-May-97,20,0,0,4,0,2750,6000,6250,131,120,9819982,188,76,D RC,1,3,3,3,2,3,3,2,1,2,2,3,7,7,6,9,4,13,6,10,13,11,9,12,10,10,12,14,16,13,8,12,12,5,10,6,13,15,10,12,11,11,16,10,13,15,20,12,13,15,7,16,6,10,12,15,10,16,13,15,18,5,20,11,10,1,15,1,20,D RC,103,1,1,1,1,1,1,20,1,15,10,10,1,1,1,11,0,0,0,0,0,0,0,0,0,0,0,0,0,0,0,0,0,0,0,0,0,0,0,0,0,0,0,0,0,0,0,0,0,0,0,0,0,0,0,0,0,0,0,0,0,0,0,0,0,Stefan Posch,£2.25m ,23,188,Defender - Centre-Back,right,TSG 1899 Hoffenheim,30,1,0,2681,17,0,0,1423,24,2,0,2034,30,0,1,2526,6,0,0,509,Bundesliga
19-06-17,18.3.4.28,Dayot Upamecano,16182894,769,27-Oct-98,18,0,0,0,0,5750,6500,6750,167,130,14175499,185,83,D C,1,3,2,2,4,3,3,1,3,1,2,4,8,12,6,10,6,11,8,10,14,13,7,14,12,15,12,16,14,10,12,11,15,11,9,7,10,12,14,14,13,17,14,12,16,18,20,13,16,11,8,13,4,10,13,16,9,11,12,14,10,10,20,1,14,1,1,1,20,D C,101,1,1,1,1,1,1,20,1,1,14,14,1,1,1,1,1.15306E+18,0,0,0,0,0,0,0,0,0,0,0,0,0,0,0,0,0,0,0,0,0,0,0,0,0,0,0,0,0,0,0,0,1,0,0,0,0,0,0,0,0,0,0,0,0,0,0,1,Dayot Upamecano,£27.00m ,22,186,Defender - Centre-Back,right,RB Leipzig,33,0,2,2478,41,3,0,3395,22,0,0,1852,38,0,2,3182,7,1,0,579,Bundesliga
19-06-17,18.3.4.28,Sokratis Papastathopoulos,1804808,772,09-Jun-88,29,73,2,9,2,6700,7250,7700,154,154,116583681,186,85,D C,3,1,2,2,3,3,3,3,1,2,2,5,8,11,4,11,4,12,5,15,19,10,6,19,10,16,14,18,10,16,7,12,16,4,13,8,13,12,14,14,12,18,14,8,17,18,20,15,16,17,10,15,2,14,14,17,8,11,13,12,7,5,20,10,10,1,14,1,20,D C,101,1,10,1,1,1,1,20,1,14,12,10,1,1,1,10,0,0,0,0,0,0,0,0,0,0,0,0,0,0,0,0,0,0,0,0,0,0,0,0,0,0,0,0,0,0,0,0,0,0,0,0,0,0,0,0,0,0,0,0,0,0,0,0,0,,,,,,,,,,,,,,,,,,,,,,,,,,,,
19-06-17,18.3.4.28,Felipe,19037595,1651,15-May-87,30,0,0,0,0,3650,6150,6150,125,123,2822691,193,85,D C,1,2,1,2,2,1,3,3,1,3,3,4,7,9,5,11,9,15,11,5,14,12,8,14,12,12,15,16,14,10,10,12,16,9,11,4,13,11,9,9,9,14,18,20,12,11,8,11,16,10,14,14,17,7,12,13,13,12,11,14,11,11,20,6,1,1,1,6,20,D C,101,1,6,1,1,1,1,20,6,1,1,1,1,1,6,1,0,0,0,0,0,0,0,0,0,0,0,0,0,0,0,0,0,0,0,0,0,0,0,0,0,0,0,0,0,0,0,0,0,0,0,0,0,0,0,0,0,0,0,0,0,0,0,0,0,Felipe,£450Th. ,36,188,Defender - Centre-Back,left,Without Club,33,1,1,2902,30,1,0,2577,31,3,1,2453,16,0,0,1086,nan,nan,nan,nan,Serie A
19-06-17,18.3.4.28,Josip Elez,24021243,761,25-Apr-94,23,0,0,2,0,3700,6200,6200,136,124,3383139,189,89,D C,3,1,3,2,2,3,2,2,1,3,1,4,7,10,7,11,12,15,8,10,13,14,14,12,14,12,14,15,17,10,13,10,11,13,14,7,13,12,8,11,11,13,14,14,14,12,20,12,15,11,6,12,6,8,14,16,9,16,13,12,15,8,20,1,10,1,1,1,20,D C,101,1,1,1,1,1,1,20,1,1,12,10,1,1,1,1,1.15306E+18,0,0,0,0,0,0,0,0,0,0,0,0,0,0,0,0,0,0,0,0,0,0,0,0,0,0,0,0,0,0,0,0,1,0,0,0,0,0,0,0,0,0,0,0,0,0,0,1,Josip Elez,£2.70m ,26,189,Defender - Centre-Back,right,Hannover 96,40,2,4,3574,37,2,0,2869,11,0,0,734,23,0,0,1812,1,0,0,57,Bundesliga
19-06-17,18.3.4.28,Tin Jedvaj,24026928,761,28-Nov-95,21,9,0,5,1,5350,6600,6350,155,132,11105628,184,81,D RLC,1,3,2,4,2,4,1,1,1,2,2,5,11,9,10,12,5,11,9,17,15,13,8,16,12,16,15,17,15,9,10,12,16,9,10,13,11,12,14,12,11,15,12,10,16,14,20,13,13,12,14,12,10,17,14,17,8,12,12,8,10,13,20,15,10,1,17,15,20,D RLC,106,1,1,1,1,1,1,20,15,17,10,10,1,1,13,15,4294967296,0,0,0,0,0,0,0,0,0,0,0,0,0,0,0,0,0,0,0,0,0,0,0,0,0,0,0,0,0,0,0,0,1,0,0,0,0,0,0,0,0,0,0,0,0,0,0,0,Tin Jedvaj,£4.50m ,24,188,Defender - Centre-Back,right,Bayer 04 Leverkusen,23,1,0,1828,10,0,0,597,21,2,0,1470,31,2,0,2642,0,0,0,0,Bundesliga
19-06-17,18.3.4.28,Jannik Vestergaard,27013431,764,03-Aug-92,24,15,1,28,4,5350,6750,6850,145,137,19017474,197,96,D C,1,3,1,2,2,1,3,3,3,2,3,5,6,8,7,9,11,14,10,12,15,10,7,15,8,8,13,16,15,12,8,13,13,6,14,5,14,16,10,8,7,16,18,15,13,14,20,12,18,15,6,13,7,6,13,15,11,14,16,15,11,4,20,1,10,1,1,1,20,D C,101,1,1,6,1,1,1,20,1,1,10,10,1,1,1,1,2.74878E+11,0,0,0,0,0,0,0,0,0,0,0,0,0,0,0,0,0,0,0,0,0,0,0,0,0,0,0,0,0,0,0,0,0,0,0,0,0,0,1,0,0,0,0,0,0,0,0,0,Jannik Vestergaard,£12.60m ,28,199,Defender - Centre-Back,both,Southampton FC,49,4,1,3843,34,3,0,3060,26,0,0,2330,21,1,0,1636,5,1,0,404,Bundesliga
19-06-17,18.3.4.28,Frederik Sřrensen,27020708,764,14-Apr-92,25,1,0,17,0,5500,6250,6500,138,130,7489782,194,88,D RC,1,3,2,2,3,2,1,2,3,1,2,5,8,6,6,8,6,12,9,17,13,10,5,13,8,10,16,13,15,15,9,12,12,6,10,7,15,17,10,11,7,14,18,9,13,15,20,13,16,14,7,14,10,13,16,15,10,17,14,14,18,5,20,12,1,1,18,7,20,D RC,103,1,10,1,1,1,1,20,7,18,1,1,1,1,1,12,2.79173E+11,0,0,0,0,0,0,0,0,0,0,0,0,0,0,0,0,0,0,0,0,0,0,0,0,0,0,0,0,0,0,0,0,1,0,0,0,0,0,1,0,0,0,0,0,0,0,0,0,Frederik Sörensen,£4.05m ,28,194,Defender - Centre-Back,right,1. FC Köln,33,0,3,2890,35,3,2,2632,6,0,0,136,25,1,1,1976,3,0,0,97,Bundesliga
19-06-17,18.3.4.28,Karim Rekik,28068818,784,02-Dec-94,22,1,0,15,1,5650,6650,6650,145,133,18414372,186,79,D LC,1,2,1,2,2,3,2,1,1,3,4,4,10,9,7,12,5,12,6,10,15,13,8,15,13,15,14,17,15,10,12,14,17,8,13,8,11,14,12,13,12,17,14,20,15,11,8,14,16,10,12,12,7,7,14,18,9,12,13,15,12,10,20,11,1,1,1,15,20,D LC,104,1,1,1,1,1,1,20,15,1,1,1,1,1,11,1,0,0,0,0,0,0,0,0,0,0,0,0,0,0,0,0,0,0,0,0,0,0,0,0,0,0,0,0,0,0,0,0,0,0,0,0,0,0,0,0,0,0,0,0,0,0,0,0,0,Karim Rekik,£9.00m ,25,186,Defender - Centre-Back,left,Sevilla FC,12,0,0,1065,31,2,4,2753,27,0,0,2370,16,1,0,1470,1,0,0,90,Bundesliga
19-06-17,18.3.4.28,Milos Veljkovic,28070894,802,26-Sep-95,21,0,0,16,0,3750,6400,6250,144,125,10576395,187,77,D/DM C,2,3,2,3,2,3,1,3,1,1,3,5,7,8,6,12,6,10,7,8,14,12,7,13,11,10,15,12,16,16,9,13,12,6,11,7,15,17,10,10,10,13,14,10,11,12,20,12,13,15,6,15,9,14,16,16,8,14,13,15,18,10,20,1,15,1,1,1,20,D/DM C,111,1,1,1,1,1,1,20,1,1,17,15,1,1,1,1,2.74878E+11,0,0,0,0,0,0,0,0,0,0,0,0,0,0,0,0,0,0,0,0,0,0,0,0,0,0,0,0,0,0,0,0,0,0,0,0,0,0,1,0,0,0,0,0,0,0,0,0,Milos Veljkovic,£5.85m ,25,188,Defender - Centre-Back,both,SV Werder Bremen,29,0,0,2079,34,2,0,3045,27,1,0,2264,28,0,1,2393,4,0,0,360,Bundesliga
19-06-17,18.3.4.28,Reece Oxford,28101903,765,16-Dec-98,18,0,0,0,0,4350,5600,6350,154,122,37638445,191,78,D/DM C,3,2,3,2,2,1,1,2,2,4,3,4,7,8,9,11,6,11,7,10,14,13,9,15,12,14,13,15,13,11,10,10,15,8,12,8,12,14,12,12,11,13,16,10,15,15,20,12,12,12,9,16,7,15,10,13,12,15,11,16,12,10,20,1,14,1,12,1,20,D/DM C,111,1,1,1,1,1,1,20,1,12,16,14,1,1,1,1,0,0,0,0,0,0,0,0,0,0,0,0,0,0,0,0,0,0,0,0,0,0,0,0,0,0,0,0,0,0,0,0,0,0,0,0,0,0,0,0,0,0,0,0,0,0,0,0,0,Reece Oxford,£4.50m ,21,190,Midfielder - Defensive Midfield,right,FC Augsburg,12,0,0,812,11,0,0,666,24,3,2,1913,12,0,0,367,3,0,0,32,Premier League
19-06-17,18.3.4.28,Tony Jantschke,29022529,771,07-Apr-90,27,0,0,18,0,4750,6500,6750,139,135,12324205,177,72,D/WB RC,2,3,2,4,4,3,2,1,2,2,2,5,9,7,5,11,5,12,5,10,14,12,6,15,11,10,17,12,14,17,9,13,12,4,11,7,16,18,12,11,13,11,11,12,14,12,20,14,10,16,5,14,8,16,6,11,17,12,16,16,18,3,20,16,11,1,20,1,18,D/WB RC,113,1,1,1,1,1,1,18,1,20,11,11,1,1,1,16,2.79173E+11,0,0,0,0,0,0,0,0,0,0,0,0,0,0,0,0,0,0,0,0,0,0,0,0,0,0,0,0,0,0,0,0,1,0,0,0,0,0,1,0,0,0,0,0,0,0,0,0,Tony Jantschke,£3.15m ,30,177,Defender - Centre-Back,right,Borussia Mönchengladbach,35,0,0,2533,14,0,1,804,15,0,2,1020,19,0,0,1128,3,0,0,112,Bundesliga
19-06-17,18.3.4.28,Jean-Philippe Gbamin,29114927,24,25-Sep-95,21,2,0,0,0,6250,6250,6750,140,130,23163918,186,83,D/DM/M RC,3,1,3,2,1,4,2,3,1,3,1,6,10,11,8,10,6,12,7,14,14,12,7,15,11,16,12,17,9,13,10,10,14,8,11,8,12,14,16,13,12,15,14,9,17,16,20,16,15,13,10,13,8,17,11,13,13,10,10,15,15,11,17,11,20,1,15,10,20,D/DM/M RC,333,1,1,1,1,1,1,17,10,15,20,20,1,1,6,11,0,0,0,0,0,0,0,0,0,0,0,0,0,0,0,0,0,0,0,0,0,0,0,0,0,0,0,0,0,0,0,0,0,0,0,0,0,0,0,0,0,0,0,0,0,0,0,0,0,Jean-Philippe Gbamin,£13.50m ,25,186,Midfielder - Defensive Midfield,right,Everton FC,31,0,0,2365,31,1,3,2710,33,2,1,2869,2,0,0,135,nan,nan,nan,nan,Bundesliga
19-06-17,18.3.4.28,Benjamin Stambouli,34008684,769,13-Aug-90,26,0,0,14,0,6300,6800,6800,139,136,14207734,180,82,D/DM/M C,1,1,2,3,2,3,3,3,1,1,3,5,9,10,7,13,7,11,8,10,14,12,8,16,13,13,16,16,14,14,10,12,15,8,12,10,14,18,15,10,12,16,11,10,15,12,20,16,15,17,10,16,6,10,12,16,12,13,17,14,14,5,20,1,18,1,1,1,20,D/DM/M C,121,1,10,1,1,1,1,20,1,1,18,18,1,1,1,1,4294967296,0,0,0,0,0,0,0,0,0,0,0,0,0,0,0,0,0,0,0,0,0,0,0,0,0,0,0,0,0,0,0,0,1,0,0,0,0,0,0,0,0,0,0,0,0,0,0,0,Benjamin Stambouli,£8.10m ,30,180,Defender - Centre-Back,right,FC Schalke 04,38,0,0,2312,32,0,2,2508,27,0,2,2314,10,0,0,900,3,0,0,225,Bundesliga
19-06-17,18.3.4.28,Jérôme Boateng,35002579,771,03-Sep-88,28,67,1,15,1,8750,8750,8750,175,175,232186002,192,90,D C,2,1,1,2,3,1,1,1,2,3,2,7,14,11,6,13,5,10,7,16,18,15,7,18,13,10,17,13,16,12,14,15,11,11,11,6,15,12,9,14,13,17,17,18,14,18,20,14,18,16,8,16,8,16,6,14,7,15,11,15,9,13,20,10,8,1,12,12,20,D C,101,1,1,1,1,1,1,20,12,12,8,8,1,1,10,10,1.15306E+18,0,0,0,0,0,0,0,0,0,0,0,0,0,0,0,0,0,0,0,0,0,0,0,0,0,0,0,0,0,0,0,0,0,0,0,0,0,0,0,0,0,0,0,0,0,0,0,1,Jérôme Boateng,£40.50m ,32,192,Defender - Centre-Back,right,Bayern Munich,21,0,1,1465,31,2,4,2621,28,0,2,2419,38,0,2,2806,6,0,0,441,Bundesliga
19-06-17,18.3.4.28,Marc Pfitzner,35005317,771,28-Aug-84,32,0,0,0,0,2250,4450,4450,115,89,1434,183,81,DM/M C,1,1,1,4,3,3,2,2,3,1,1,8,9,8,7,10,9,10,9,6,12,12,14,13,11,18,11,17,12,12,7,10,13,9,15,7,10,13,12,9,9,13,12,9,13,10,20,11,10,14,16,15,13,10,7,8,18,10,14,8,15,5,15,1,18,1,1,1,18,DM/M C,311,1,1,1,1,1,1,15,1,1,20,18,1,1,1,1,0,0,0,0,0,0,0,0,0,0,0,0,0,0,0,0,0,0,0,0,0,0,0,0,0,0,0,0,0,0,0,0,0,0,0,0,0,0,0,0,0,0,0,0,0,0,0,0,0,,,,,,,,,,,,,,,,,,,,,,,,,,,,
19-06-17,18.3.4.28,Dominic Maroh,35007305,795,04-Mar-87,30,7,0,0,0,3900,5900,6400,130,128,4991080,186,85,D C,3,4,4,1,1,3,1,3,1,4,2,4,6,6,6,9,5,13,7,10,16,8,7,16,8,13,12,18,10,15,7,11,15,7,14,6,15,14,12,11,9,16,14,9,14,12,20,13,16,15,8,15,10,6,9,13,15,12,14,13,13,7,20,5,6,1,7,7,20,D C,101,1,13,1,1,1,1,20,7,7,7,6,1,1,5,5,0,0,0,0,0,0,0,0,0,0,0,0,0,0,0,0,0,0,0,0,0,0,0,0,0,0,0,0,0,0,0,0,0,0,0,0,0,0,0,0,0,0,0,0,0,0,0,0,0,Dominic Maroh,£900Th. ,33,186,Defender - Centre-Back,right,KFC Uerdingen 05,15,1,0,844,15,1,0,1221,29,1,1,2595,16,1,0,1224,nan,nan,nan,nan,Bundesliga
19-06-17,18.3.4.28,Sven Bender,35007386,771,27-Apr-89,28,7,0,0,0,5200,6950,7200,148,144,31048161,186,80,D/DM/M C,1,1,3,1,1,2,2,2,1,3,1,6,9,8,7,11,6,12,8,13,15,12,9,18,11,19,15,18,10,16,9,13,18,7,13,8,14,18,19,12,11,15,12,10,17,12,20,18,13,19,10,15,14,9,9,14,16,17,18,13,16,4,20,1,18,1,1,1,20,D/DM/M C,121,1,1,1,1,1,1,20,1,1,18,18,1,1,1,1,2.74895E+11,0,0,0,0,0,0,0,0,0,0,0,0,0,0,0,0,0,0,0,0,0,0,0,0,1,0,0,0,0,0,0,0,0,0,0,0,0,0,1,0,0,0,0,0,0,0,0,0,Sven Bender,£13.50m ,31,186,Defender - Centre-Back,right,Bayer 04 Leverkusen,8,0,1,404,34,2,0,2812,32,0,1,2435,47,4,2,3881,7,0,1,589,Bundesliga
19-06-17,18.3.4.28,Mërgim Mavraj,35007715,752,09-Jun-86,31,36,3,0,0,4450,6700,6450,131,129,4586910,189,83,D C,2,1,1,3,3,3,3,2,3,3,2,5,8,9,8,9,8,14,11,10,15,12,6,14,10,11,15,15,13,13,10,12,12,7,14,7,14,16,10,9,10,14,16,20,13,11,10,13,15,14,9,11,10,9,10,15,12,11,16,14,10,4,20,8,10,1,1,12,20,D C,101,1,1,1,1,1,1,20,12,1,12,10,1,1,8,1,0,0,0,0,0,0,0,0,0,0,0,0,0,0,0,0,0,0,0,0,0,0,0,0,0,0,0,0,0,0,0,0,0,0,0,0,0,0,0,0,0,0,0,0,0,0,0,0,0,Mergim Mavraj,£450Th. ,34,189,Defender - Centre-Back,left,SpVgg Greuther Fürth,33,0,0,3000,18,0,0,1537,21,0,2,1811,24,0,1,2049,4,0,0,291,Bundesliga
19-06-17,18.3.4.28,Mats Hummels,35007944,771,16-Dec-88,28,57,4,21,5,8550,8550,8550,171,171,230711557,191,92,D C,3,1,3,3,2,3,3,1,3,3,1,5,9,12,10,14,8,15,9,8,17,15,11,17,15,12,18,14,19,13,14,17,14,9,14,10,18,16,12,9,11,17,16,14,15,12,20,14,16,16,9,14,6,7,8,13,16,14,17,18,16,10,20,6,1,1,10,1,20,D C,101,1,1,1,1,1,1,20,1,10,12,1,1,1,1,6,1.15292E+18,0,0,0,0,0,0,0,0,0,0,0,0,0,0,1,0,0,0,0,0,0,0,0,0,0,0,0,0,0,0,0,0,1,0,0,0,0,0,0,0,0,0,0,0,0,0,0,0,Mats Hummels,£54.00m ,31,191,Defender - Centre-Back,right,Borussia Dortmund,42,3,3,3260,41,3,4,3491,33,2,2,2849,41,1,3,3483,8,1,0,706,Bundesliga
19-06-17,18.3.4.28,Rico Morack,35008152,771,18-Feb-88,29,0,0,0,0,1500,4250,4250,93,85,2322,186,79,D C,2,1,2,3,3,3,1,1,1,3,1,6,3,4,3,10,5,5,8,2,10,10,1,10,5,9,10,9,8,7,7,14,15,1,8,7,8,7,9,14,14,8,13,10,13,14,20,9,12,12,9,9,9,9,7,14,12,15,16,16,16,6,20,1,14,1,7,1,20,D C,101,1,1,1,1,1,1,20,1,7,14,14,1,1,1,1,0,0,0,0,0,0,0,0,0,0,0,0,0,0,0,0,0,0,0,0,0,0,0,0,0,0,0,0,0,0,0,0,0,0,0,0,0,0,0,0,0,0,0,0,0,0,0,0,0,Ricardo Moura,£180Th. ,31,184,Goalkeeper,right,GD Chaves,26,34,6,2430,0,0,0,0,13,15,3,1094,7,6,2,660,0,0,0,0,Liga NOS
19-06-17,18.3.4.28,Ermin Bicakcic,35013742,759,24-Jan-90,27,19,3,0,0,4928,7219,6450,130,129,7046965,185,81,D RC,3,1,3,3,3,3,1,2,3,2,1,3,6,5,8,8,4,13,4,14,16,9,5,15,8,14,11,18,10,14,7,11,16,5,12,8,13,15,12,11,8,14,14,15,14,16,20,13,17,15,13,13,7,10,11,15,9,13,17,9,14,7,20,11,1,1,15,1,20,D RC,103,1,1,1,1,1,1,20,1,15,1,1,1,1,1,11,32768,0,0,0,0,0,0,0,0,0,0,0,0,0,0,0,1,0,0,0,0,0,0,0,0,0,0,0,0,0,0,0,0,0,0,0,0,0,0,0,0,0,0,0,0,0,0,0,0,Ermin Bicakcic,£1.80m ,30,185,Defender - Centre-Back,right,TSG 1899 Hoffenheim,19,1,1,1171,13,0,1,825,30,1,3,2198,22,2,0,1289,3,1,0,249,Bundesliga
19-06-17,18.3.4.28,Holger Badstuber,35016427,771,13-Mar-89,28,31,1,8,2,5900,7150,6900,158,143,15932666,190,84,D C,2,3,2,2,3,3,1,3,1,3,2,13,12,7,5,11,13,10,7,12,15,14,11,14,12,10,16,11,19,14,12,18,10,6,11,5,16,18,8,10,8,13,16,20,15,12,9,11,14,17,6,14,18,10,9,14,16,12,18,17,12,3,20,8,8,1,1,14,20,D C,101,1,5,1,1,1,1,20,14,1,10,8,1,1,8,1,1.41017E+14,0,0,0,0,0,0,0,0,0,0,0,0,0,0,0,0,0,0,0,0,0,0,0,0,0,0,0,0,0,0,0,0,1,0,0,0,0,0,1,0,0,0,0,0,0,0,0,1,Holger Badstuber,£4.50m ,31,190,Defender - Centre-Back,left,VfB Stuttgart II,16,0,0,1206,28,2,0,2225,12,0,0,697,21,2,0,1825,6,0,0,526,Bundesliga
19-06-17,18.3.4.28,Sebastian Langkamp,35016452,771,15-Jan-88,29,0,0,5,0,4350,6350,6350,128,127,6231688,190,85,D C,2,3,1,3,2,3,4,3,3,2,2,4,7,6,6,8,4,14,4,10,15,10,5,14,8,10,14,13,10,16,7,12,12,5,13,6,15,17,11,10,9,14,16,8,14,12,20,13,16,15,6,15,6,7,8,13,14,13,17,14,16,5,20,8,1,1,5,10,20,D C,101,1,1,1,1,1,1,20,10,5,1,1,1,1,8,3,0,0,0,0,0,0,0,0,0,0,0,0,0,0,0,0,0,0,0,0,0,0,0,0,0,0,0,0,0,0,0,0,0,0,0,0,0,0,0,0,0,0,0,0,0,0,0,0,0,Sebastian Langkamp,£2.25m ,32,191,Defender - Centre-Back,right,Without Club,32,0,0,2794,26,0,0,1701,23,0,0,1533,7,0,0,425,nan,nan,nan,nan,Bundesliga
19-06-17,18.3.4.28,Manuel Gulde,35017406,771,12-Feb-91,26,0,0,0,0,4250,6250,6250,125,125,5434280,184,78,D C,1,1,3,3,3,2,2,2,1,1,1,5,8,7,5,11,6,14,4,10,13,12,7,13,11,10,13,12,13,16,9,14,10,6,10,7,15,15,10,12,11,10,11,12,13,14,20,12,12,16,6,14,15,9,9,12,13,9,13,16,14,8,20,8,12,1,10,10,20,D C,101,1,1,1,1,1,1,20,10,10,12,12,1,1,8,8,0,0,0,0,0,0,0,0,0,0,0,0,0,0,0,0,0,0,0,0,0,0,0,0,0,0,0,0,0,0,0,0,0,0,0,0,0,0,0,0,0,0,0,0,0,0,0,0,0,Manuel Gulde,£2.25m ,29,184,Defender - Centre-Back,right,SC Freiburg,21,0,0,1806,17,1,0,1530,22,1,1,1798,18,1,0,1417,3,0,0,58,Bundesliga
19-06-17,18.3.4.28,Kyriakos Papadopoulos,36017184,772,23-Feb-92,25,25,4,7,2,6200,6500,6700,138,134,13311450,182,79,D C,2,1,3,3,1,3,2,2,3,1,4,4,7,7,5,8,4,15,6,12,18,10,4,18,8,14,12,20,8,11,7,10,20,4,13,6,12,10,15,15,9,18,13,9,12,14,20,14,17,13,12,16,14,6,12,17,13,13,12,8,5,10,20,5,12,1,5,1,20,D C,101,1,5,1,1,1,1,20,1,5,14,12,1,1,1,5,32832,0,0,0,0,0,0,1,0,0,0,0,0,0,0,0,1,0,0,0,0,0,0,0,0,0,0,0,0,0,0,0,0,0,0,0,0,0,0,0,0,0,0,0,0,0,0,0,0,Kyriakos Papadopoulos,£4.50m ,28,185,Defender - Centre-Back,right,Without Club,18,2,0,1416,30,1,1,2700,2,0,0,180,4,0,0,284,nan,nan,nan,nan,Bundesliga
19-06-17,18.3.4.28,Panagiotis Retsos,36105386,772,09-Aug-98,18,0,0,0,0,5650,6400,6650,155,128,25538249,185,76,D RLC,2,2,2,1,3,2,1,3,2,1,3,3,9,9,6,11,6,14,7,12,14,13,7,15,13,14,14,16,15,11,10,11,15,8,12,7,11,15,12,12,13,15,14,10,13,16,20,15,11,13,9,16,6,17,13,17,12,16,14,9,14,5,20,12,10,1,16,16,20,D RLC,106,1,1,1,1,1,1,20,16,16,14,10,1,1,12,12,1.15292E+18,0,0,0,0,0,0,0,0,0,0,0,0,0,0,0,0,0,0,0,0,0,0,0,0,0,0,0,0,0,0,0,0,0,0,0,0,0,0,0,0,0,0,0,0,0,0,0,0,Panagiotis Retsos,£16.20m ,22,186,Defender - Centre-Back,right,AS Saint-Étienne,34,0,0,2712,34,1,3,2437,1,0,0,31,7,0,0,285,2,0,0,138,Bundesliga
19-06-17,18.3.4.28,Jeffrey Bruma,37001807,784,13-Nov-91,25,25,1,19,0,5850,6850,6850,145,137,15379348,190,88,D C,3,3,3,2,1,3,3,4,2,3,4,5,10,11,8,12,11,12,13,10,15,13,9,16,12,12,14,16,14,10,13,10,12,11,13,9,12,12,8,13,11,17,16,10,14,16,20,13,17,12,9,14,8,9,13,15,10,9,16,13,9,8,20,12,10,1,14,1,20,D C,101,1,1,1,1,1,1,20,1,14,10,10,1,1,1,12,1.15306E+18,0,0,0,0,0,0,0,0,0,0,0,0,0,0,0,0,0,0,0,0,0,0,0,0,0,0,0,0,0,0,0,0,1,0,0,0,0,0,0,0,0,0,0,0,0,0,0,1,Jeffrey Bruma,£5.40m ,28,189,Defender - Centre-Back,right,VfL Wolfsburg,22,1,0,1898,13,0,0,1200,12,0,0,893,23,0,0,1955,nan,nan,nan,nan,Bundesliga
19-06-17,18.3.4.28,Jeffrey Gouweleeuw,37004721,784,10-Jul-91,25,0,0,3,0,4650,6400,6650,141,133,10770670,187,78,D C,1,1,3,1,3,2,3,2,3,3,4,7,10,11,8,12,8,12,10,10,13,14,12,14,13,12,16,10,16,11,13,15,12,10,12,8,12,10,13,12,11,13,14,9,15,16,20,13,12,15,6,13,4,9,11,14,12,13,11,16,14,10,20,8,12,1,10,1,20,D C,101,1,15,1,1,1,1,20,1,10,12,12,1,1,1,8,1.15306E+18,0,0,0,0,0,0,0,0,0,0,0,0,0,0,0,0,0,0,0,0,0,0,0,0,0,0,0,0,0,0,0,0,1,0,0,0,0,0,1,0,0,0,0,0,0,0,0,1,Jeffrey Gouweleeuw,£7.20m ,29,187,Defender - Centre-Back,right,FC Augsburg,19,2,1,1640,28,0,1,2475,28,0,3,2422,21,0,1,1642,6,0,0,540,Bundesliga
19-06-17,18.3.4.28,Rick van Drongelen,37058873,784,20-Dec-98,18,0,0,0,0,3550,6050,6050,146,121,10336436,185,81,D LC,1,1,2,2,3,2,1,2,2,2,2,4,10,11,7,8,5,11,9,12,14,10,8,15,8,14,13,16,10,12,10,11,17,8,13,8,12,15,13,12,11,15,14,20,13,15,9,12,14,14,9,15,4,12,14,14,10,15,12,13,10,7,20,14,1,1,1,16,20,D LC,104,1,13,1,1,1,1,20,16,1,9,1,1,1,14,1,0,0,0,0,0,0,0,0,0,0,0,0,0,0,0,0,0,0,0,0,0,0,0,0,0,0,0,0,0,0,0,0,0,0,0,0,0,0,0,0,0,0,0,0,0,0,0,0,0,Rick van Drongelen,£2.70m ,21,188,Defender - Centre-Back,left,Hamburger SV,34,0,1,3071,18,0,0,1442,39,2,0,3401,34,0,2,2907,nan,nan,nan,nan,Bundesliga
19-06-17,18.3.4.28,Luca Caldirola,43008773,776,01-Feb-91,26,0,0,31,1,3900,6150,5900,126,123,3006378,189,79,D LC,1,1,1,1,1,1,1,1,1,1,1,4,7,5,5,10,4,11,4,8,13,10,7,13,9,10,16,10,12,16,8,14,10,4,14,5,15,17,10,10,11,11,14,20,13,12,10,13,12,17,8,16,6,10,12,14,14,12,16,15,17,4,20,11,1,1,1,16,20,D LC,104,1,1,1,1,1,1,20,16,1,1,1,1,1,11,1,2.79173E+11,0,0,0,0,0,0,0,0,0,0,0,0,0,0,0,0,0,0,0,0,0,0,0,0,0,0,0,0,0,0,0,0,1,0,0,0,0,0,1,0,0,0,0,0,0,0,0,0,Luca Caldirola,£900Th. ,29,186,Defender - Centre-Back,left,Benevento Calcio,7,0,0,592,2,0,0,180,16,3,0,1435,34,3,0,2966,5,2,0,450,Bundesliga
19-06-17,18.3.4.28,Ibrahima Konaté,48037822,769,25-May-99,18,0,0,0,0,3000,5250,6000,132,115,8003606,192,84,D C,3,3,2,4,2,1,3,2,3,2,3,4,6,8,6,9,4,11,5,7,12,11,6,12,10,14,10,16,13,11,8,10,13,6,12,6,11,13,12,12,11,13,17,10,14,16,20,11,16,12,8,14,7,9,12,16,8,14,12,11,15,9,20,1,12,1,1,1,20,D C,101,1,1,1,1,1,1,20,1,1,12,12,1,1,1,1,0,0,0,0,0,0,0,0,0,0,0,0,0,0,0,0,0,0,0,0,0,0,0,0,0,0,0,0,0,0,0,0,0,0,0,0,0,0,0,0,0,0,0,0,0,0,0,0,0,Ibrahima Konaté,£7.20m ,21,194,Defender - Centre-Back,right,RB Leipzig,13,1,0,1116,22,0,0,1719,43,3,1,3666,11,0,0,771,2,0,0,25,Bundesliga
19-06-17,18.3.4.28,Dan-Axel Zagadou,48043086,769,03-Jun-99,18,0,0,0,0,3500,5500,6500,156,120,16035392,196,90,D LC,4,4,1,1,1,1,2,2,1,2,1,3,8,9,6,13,4,10,5,10,12,13,7,14,14,11,11,14,17,10,12,12,12,9,12,6,11,14,11,11,10,14,18,20,12,15,9,10,15,13,7,15,7,9,11,15,10,14,12,13,15,8,20,10,1,1,1,15,20,D LC,104,1,1,1,1,1,1,20,15,1,1,1,1,1,10,1,1.15292E+18,0,0,0,0,0,0,0,0,0,0,0,0,0,0,0,0,0,0,0,0,0,0,0,0,0,0,0,0,0,0,0,0,1,0,0,0,0,0,0,0,0,0,0,0,0,0,0,0,Dan-Axel Zagadou,£4.50m ,21,196,Defender - Centre-Back,left,Borussia Dortmund,1,0,0,90,16,1,0,996,23,2,0,1853,22,1,1,1418,nan,nan,nan,nan,Bundesliga
19-06-17,18.3.4.28,Niklas Moisander,518969,768,29-Sep-85,31,59,2,8,1,5550,6550,6550,138,131,232186002,183,75,D C,1,1,1,2,1,1,1,2,1,1,4,4,8,10,7,12,7,12,13,10,14,13,9,14,11,12,15,11,16,14,14,14,12,7,13,8,13,16,10,11,12,14,12,20,16,11,15,14,11,11,7,15,9,8,14,16,12,15,17,15,17,4,20,8,1,1,1,12,20,D C,101,1,1,1,1,1,1,20,12,1,1,1,1,1,8,1,4294967296,0,0,0,0,0,0,0,0,0,0,0,0,0,0,0,0,0,0,0,0,0,0,0,0,0,0,0,0,0,0,0,0,1,0,0,0,0,0,0,0,0,0,0,0,0,0,0,0,Niklas Moisander,£2.25m ,35,183,Defender - Centre-Back,left,SV Werder Bremen,31,0,1,2744,28,2,0,2550,34,0,0,3029,26,1,1,2337,4,0,0,271,Bundesliga
19-06-17,18.3.4.28,Hĺvard Nordtveit,53000623,786,21-Jun-90,26,32,2,24,1,5650,6650,6650,137,133,10770670,188,85,D/DM/M C,3,1,2,2,3,3,1,3,2,2,1,11,11,9,8,10,12,10,13,18,13,13,8,14,10,15,14,16,10,16,10,12,15,7,13,11,12,18,15,11,9,12,14,12,17,14,20,17,14,15,10,15,9,15,17,14,13,13,17,14,16,6,20,8,18,1,12,1,20,D/DM/M C,121,1,12,1,1,1,1,20,1,12,18,18,1,1,1,8,0,0,0,0,0,0,0,0,0,0,0,0,0,0,0,0,0,0,0,0,0,0,0,0,0,0,0,0,0,0,0,0,0,0,0,0,0,0,0,0,0,0,0,0,0,0,0,0,0,Havard Nordtveit,£3.60m ,30,188,Defender - Centre-Back,right,TSG 1899 Hoffenheim,22,0,1,1420,23,0,1,1502,16,1,1,1011,12,0,1,818,nan,nan,nan,nan,Bundesliga
19-06-17,18.3.4.28,Stefan Ilsanker,5610169,755,18-May-89,28,23,0,9,0,4150,6650,6650,133,133,12713766,189,86,D/DM/M C,2,3,2,1,3,1,3,2,3,2,1,8,10,8,6,10,9,13,11,10,14,12,9,17,10,17,15,17,10,17,9,10,17,6,16,12,14,18,16,10,10,16,14,9,17,12,20,17,15,17,12,17,6,13,9,12,15,15,17,12,14,3,16,8,20,1,12,1,20,D/DM/M C,331,1,1,1,1,1,1,16,1,12,20,20,1,1,1,8,2.19904E+12,0,0,0,0,0,0,0,0,0,0,0,0,0,0,0,0,0,0,0,0,0,0,0,0,1,0,0,0,0,0,0,0,0,0,0,0,0,0,0,0,0,1,0,0,0,0,0,0,Stefan Ilsanker,£4.05m ,31,189,Midfielder - Defensive Midfield,right,Eintracht Frankfurt,34,0,1,2764,28,0,1,1697,34,0,1,1900,25,2,1,1702,6,0,0,367,Bundesliga
19-06-17,18.3.4.28,Gojko Kacar,5779401,802,26-Jan-87,30,25,0,15,7,4750,5750,6250,140,125,4313612,185,85,DM/M C,1,2,3,3,2,1,3,3,2,3,2,8,10,12,15,10,9,16,14,12,14,12,10,15,11,17,13,18,10,11,11,11,18,11,12,16,10,12,17,9,12,16,14,10,10,12,20,10,13,10,12,15,16,20,16,8,6,14,10,10,7,12,15,10,20,12,11,1,20,DM/M C,311,1,1,14,12,1,11,15,1,10,20,20,1,11,1,10,1.37439E+11,0,0,0,0,0,0,0,0,0,1,0,0,0,0,0,0,0,0,0,0,0,0,0,0,0,0,0,0,0,0,0,0,0,0,0,0,0,1,0,0,0,0,0,0,0,0,0,0,Gojko Kacar,£450Th. ,33,185,Midfielder - Defensive Midfield,right,Without Club,23,0,1,1184,6,1,0,225,6,0,0,275,nan,nan,nan,nan,nan,nan,nan,nan,Bundesliga
19-06-17,18.3.4.28,Matija Nastasic,62055271,802,28-Mar-93,24,24,0,8,1,6800,6850,7300,162,146,41724056,188,83,D C,3,4,3,3,3,1,1,3,2,1,3,7,10,9,6,12,5,12,6,10,15,13,7,15,13,12,17,13,16,16,12,15,12,8,10,7,16,17,10,12,11,13,14,20,12,15,10,12,14,15,6,13,10,10,17,16,10,14,15,13,16,8,20,12,1,1,1,14,20,D C,101,1,1,1,1,1,1,20,14,1,1,1,1,1,12,1,2.79173E+11,0,0,0,0,0,0,0,0,0,0,0,0,0,0,0,0,0,0,0,0,0,0,0,0,0,0,0,0,0,0,0,0,1,0,0,0,0,0,1,0,0,0,0,0,0,0,0,0,Matija Nastasic,£15.30m ,27,188,Defender - Centre-Back,left,FC Schalke 04,35,0,1,3121,27,0,0,2259,37,1,1,3290,20,0,0,1664,3,0,0,270,Bundesliga
19-06-17,18.3.4.28,Pablo Insua,67139775,796,09-Sep-93,23,0,0,9,0,4750,6500,6250,145,130,7037842,187,76,D C,3,3,2,3,3,3,1,3,3,1,2,3,7,9,8,12,5,13,6,8,14,13,7,15,12,12,16,14,14,15,10,13,14,9,10,8,15,16,12,13,10,10,15,9,15,11,20,13,12,13,8,11,8,6,10,12,14,9,15,10,17,6,20,1,1,1,1,1,20,D C,101,1,1,1,1,1,1,20,1,1,1,1,1,1,1,1,1.15292E+18,0,0,0,0,0,0,0,0,0,0,0,0,0,0,0,0,0,0,0,0,0,0,0,0,0,0,0,0,0,0,0,0,0,0,0,0,0,0,1,0,0,0,0,0,0,0,0,0,Pablo Insua,£2.25m ,27,187,Defender - Centre-Back,right,SD Huesca,30,1,0,1988,1,0,0,26,12,0,0,959,9,0,0,666,2,0,0,180,Bundesliga
19-06-17,18.3.4.28,Jorge Meré,67199429,796,17-Apr-97,20,0,0,16,1,6200,6700,6700,154,134,25982926,182,77,D C,4,2,2,3,3,3,2,2,1,3,2,4,7,11,7,12,4,12,7,10,17,13,6,17,11,14,15,17,13,11,12,10,16,10,11,8,13,12,14,14,13,15,12,12,16,11,20,15,13,12,10,14,5,4,9,16,12,8,14,11,10,7,20,1,1,1,12,7,20,D C,101,1,10,1,1,1,1,20,7,12,12,1,1,1,1,1,0,0,0,0,0,0,0,0,0,0,0,0,0,0,0,0,0,0,0,0,0,0,0,0,0,0,0,0,0,0,0,0,0,0,0,0,0,0,0,0,0,0,0,0,0,0,0,0,0,Jorge Meré,£6.30m ,23,182,Defender - Centre-Back,right,1. FC Köln,32,0,0,2864,26,1,1,2204,28,0,0,2499,13,1,0,824,1,0,0,90,Bundesliga
19-06-17,18.3.4.28,Fabian Lustenberger,69003477,798,02-May-88,29,3,0,25,2,4557,5570,6500,130,130,7905881,180,70,D/DM/M C,1,1,2,3,2,4,2,3,1,2,1,6,9,10,6,11,6,11,8,8,12,13,8,14,12,12,17,10,14,14,10,16,13,6,12,8,15,18,13,12,13,10,9,9,12,12,20,14,9,13,7,15,11,16,12,12,16,13,17,16,14,4,18,1,20,1,1,1,20,D/DM/M C,331,1,1,1,1,1,1,18,1,1,20,20,1,1,1,1,20971520,0,0,0,0,0,0,0,0,0,0,0,0,0,0,0,0,0,0,0,0,0,0,1,0,1,0,0,0,0,0,0,0,0,0,0,0,0,0,0,0,0,0,0,0,0,0,0,0,Fabian Lustenberger,£2.25m ,32,180,Defender - Centre-Back,right,BSC Young Boys,22,0,1,1717,29,0,0,2076,30,0,1,2185,41,1,0,3293,9,0,0,810,Bundesliga
19-06-17,18.3.4.28,Çaglar Söyüncü,70093800,799,23-May-96,21,5,0,1,0,6100,6750,6600,155,132,10792002,187,84,D C,1,1,1,3,1,2,1,1,2,1,2,4,7,9,7,12,5,13,8,8,16,12,8,16,11,14,14,17,12,10,9,10,16,9,11,7,11,13,14,12,12,15,16,14,13,15,20,13,14,13,10,14,6,7,13,15,8,14,12,11,9,5,20,1,10,1,1,1,20,D C,101,1,1,1,1,1,1,20,1,1,10,10,1,1,1,1,0,0,0,0,0,0,0,0,0,0,0,0,0,0,0,0,0,0,0,0,0,0,0,0,0,0,0,0,0,0,0,0,0,0,0,0,0,0,0,0,0,0,0,0,0,0,0,0,0,Caglar Söyüncü,£16.20m ,24,187,Defender - Centre-Back,right,Leicester City,25,0,1,2160,30,1,0,2439,11,0,0,804,42,1,1,3649,4,0,0,360,Bundesliga
19-06-17,18.3.4.28,Carlos Salcedo,72039283,379,29-Sep-93,23,13,0,0,0,4500,6750,6500,137,130,7524540,188,77,D RC,3,4,1,2,2,1,4,1,3,2,3,5,8,9,6,12,5,12,8,14,15,10,9,16,10,15,13,18,10,13,9,10,17,5,11,7,14,12,14,14,12,16,14,11,13,12,20,13,14,12,14,13,5,12,12,14,7,14,10,8,10,12,20,11,1,1,15,10,20,D RC,103,1,1,1,1,1,1,20,10,15,1,1,1,1,6,11,0,0,0,0,0,0,0,0,0,0,0,0,0,0,0,0,0,0,0,0,0,0,0,0,0,0,0,0,0,0,0,0,0,0,0,0,0,0,0,0,0,0,0,0,0,0,0,0,0,Carlos Salcedo,£6.30m ,27,184,Defender - Centre-Back,right,Tigres UANL,23,0,1,1749,24,0,0,1996,32,2,0,2595,23,1,0,1822,10,0,0,708,Bundesliga
19-06-17,18.3.4.28,Makoto Hasebe,778087,116,18-Jan-84,33,104,2,0,0,5200,7200,6700,135,134,232186002,179,72,D/DM/M C,2,1,3,2,3,1,1,3,2,1,2,12,15,10,7,13,9,12,10,10,12,14,9,14,13,12,15,13,15,16,10,14,14,7,15,8,14,18,12,11,14,10,8,12,17,12,20,15,9,16,7,16,5,17,13,10,17,14,19,13,16,1,20,10,18,10,14,1,20,D/DM/M C,121,1,1,1,10,1,8,20,1,14,19,18,1,8,1,10,0,0,0,0,0,0,0,0,0,0,0,0,0,0,0,0,0,0,0,0,0,0,0,0,0,0,0,0,0,0,0,0,0,0,0,0,0,0,0,0,0,0,0,0,0,0,0,0,0,Makoto Hasebe,£900Th. ,36,180,Midfielder - Defensive Midfield,right,Eintracht Frankfurt,25,1,1,2152,29,0,0,2569,44,0,0,3932,39,0,0,3344,5,0,0,450,Bundesliga
19-06-17,18.3.4.28,Lamine Sané,85032367,41,22-Mar-87,30,35,0,0,0,4950,5950,6450,134,129,6342269,192,77,D C,3,1,3,2,2,3,1,1,4,1,1,5,8,8,7,9,6,11,9,12,14,10,7,15,10,14,13,17,9,13,10,11,13,7,14,8,12,10,13,13,11,17,18,6,12,15,20,13,16,13,14,16,14,12,9,12,15,10,10,11,8,15,20,10,15,1,14,1,20,D C,101,1,1,1,1,1,1,20,1,14,15,15,1,1,1,10,0,0,0,0,0,0,0,0,0,0,0,0,0,0,0,0,0,0,0,0,0,0,0,0,0,0,0,0,0,0,0,0,0,0,0,0,0,0,0,0,0,0,0,0,0,0,0,0,0,Lamine Sané,£1.80m ,33,192,Defender - Centre-Back,right,Without Club,28,1,1,2454,29,2,0,2368,30,0,0,2694,1,0,0,1,nan,nan,nan,nan,Bundesliga
19-06-17,18.3.4.28,Simon Falette,85045326,769,19-Feb-92,25,0,0,0,0,4450,6450,6450,133,129,7046965,184,89,D C,4,2,3,3,1,3,3,2,1,1,1,4,10,9,6,11,9,14,10,10,14,13,7,13,12,15,13,17,12,12,12,11,16,9,10,7,11,10,14,13,13,17,13,20,15,16,8,14,16,14,10,13,7,8,12,14,10,12,14,12,8,6,20,10,1,1,1,14,20,D C,101,1,1,1,1,1,1,20,14,1,1,1,1,1,10,1,1.15292E+18,0,0,0,0,0,0,0,0,0,0,0,0,0,0,0,0,0,0,0,0,0,0,0,0,0,0,0,0,0,0,0,0,0,0,0,0,0,0,0,0,0,0,0,0,0,0,0,0,Simon Falette,£3.60m ,28,185,Defender - Centre-Back,left,Hannover 96,39,3,2,3511,29,1,0,2418,14,0,1,1199,13,0,1,1022,2,0,0,180,Bundesliga
19-06-17,18.3.4.28,Salif Sané,85049933,41,25-Aug-90,26,14,0,0,0,5700,6700,6700,137,134,13311450,195,84,D/DM/M C,1,3,2,1,3,2,3,1,1,4,3,5,9,10,7,12,6,12,8,14,14,13,7,17,13,12,10,14,16,9,12,10,8,13,7,9,11,8,9,12,12,16,18,12,13,15,20,14,17,12,14,12,6,10,9,14,10,14,7,10,12,18,20,8,18,5,12,10,20,D/DM/M C,121,1,1,1,5,1,1,20,10,12,18,18,1,1,6,8,0,0,0,0,0,0,0,0,0,0,0,0,0,0,0,0,0,0,0,0,0,0,0,0,0,0,0,0,0,0,0,0,0,0,0,0,0,0,0,0,0,0,0,0,0,0,0,0,0,Salif Sané,£16.20m ,30,196,Defender - Centre-Back,right,FC Schalke 04,31,3,2,2542,34,4,1,3060,40,4,1,3543,16,2,1,1215,4,0,0,314,Bundesliga
19-06-17,18.3.4.28,Marcel Tisserand,85095880,53,10-Jan-93,24,10,0,4,0,5000,6500,6500,138,130,9261558,190,80,D RLC,1,3,2,1,2,1,2,3,1,1,3,6,11,13,7,13,6,11,8,10,15,12,5,15,12,14,14,16,9,11,10,10,16,12,12,9,12,10,14,14,12,15,17,8,15,16,20,13,14,13,8,13,6,14,12,14,7,13,16,14,12,11,20,12,8,8,16,15,20,D RLC,106,1,1,5,1,1,8,20,15,16,1,1,1,8,11,12,34359738368,0,0,0,0,0,0,0,0,0,0,0,0,0,0,0,0,0,0,0,0,0,0,0,0,0,0,0,0,0,0,0,0,0,0,0,1,0,0,0,0,0,0,0,0,0,0,0,0,Marcel Tisserand,£6.75m ,27,190,Defender - Centre-Back,right,Fenerbahce SK,29,0,2,2479,19,0,1,1519,12,1,0,1068,23,1,2,1905,4,0,0,360,Bundesliga
19-06-17,18.3.4.28,Abdou Diallo,85120721,769,04-May-96,21,0,0,4,0,6200,6700,6700,155,134,23167042,188,78,D LC,1,3,3,3,4,3,2,3,4,1,2,4,10,10,6,11,5,14,7,12,15,13,9,14,12,14,13,16,14,10,12,11,14,9,13,7,11,13,12,13,13,16,16,20,14,17,9,12,15,15,8,15,6,13,13,17,11,16,14,12,15,6,20,11,12,1,12,15,20,D LC,104,1,1,1,1,1,1,20,15,12,14,12,1,1,11,8,1.15292E+18,0,0,0,0,0,0,0,0,0,0,0,0,0,0,0,0,0,0,0,0,0,0,0,0,0,0,0,0,0,0,0,0,1,0,0,0,0,0,1,0,0,0,0,0,0,0,0,0,Abdou Diallo,£10.80m ,24,187,Defender - Centre-Back,left,Paris Saint-Germain,11,0,1,951,30,3,1,2686,38,1,1,3257,23,0,1,1588,7,0,0,374,Bundesliga
19-06-17,18.3.4.28,Benjamin Pavard,85120944,769,28-Mar-96,21,0,0,11,0,4950,6200,6450,165,129,7880477,186,76,D RC,2,3,2,3,1,2,2,2,4,1,1,5,9,10,7,12,5,13,9,10,14,14,10,13,14,14,16,14,17,11,13,14,13,9,11,7,15,16,9,9,11,13,14,10,12,11,20,13,12,12,8,15,6,15,12,14,12,10,14,15,17,6,20,11,12,1,16,12,20,D RC,103,1,1,1,1,1,1,20,12,16,14,12,1,1,7,11,1.15306E+18,0,0,0,0,0,0,0,0,0,0,0,0,0,0,0,0,0,0,0,0,0,0,0,0,0,0,0,0,0,0,0,0,1,0,0,0,0,0,0,0,0,0,0,0,0,0,0,1,Benjamin Pavard,£27.00m ,24,186,Defender - Right-Back,right,Bayern Munich,21,1,2,1699,36,1,0,3270,31,0,0,2786,47,4,7,3978,7,0,0,531,Bundesliga
19-06-17,18.3.4.28,Christoph Janker,8713751,771,14-Feb-85,32,0,0,13,0,3050,6050,6050,125,121,1769370,185,78,D RC,2,3,4,1,3,2,3,1,1,2,1,10,9,7,7,10,7,11,8,12,14,11,10,14,10,10,12,13,10,15,8,12,13,7,11,8,14,18,12,10,10,13,12,15,14,11,20,14,13,16,8,15,10,16,6,10,15,12,17,14,16,4,20,14,12,1,16,10,20,D RC,103,1,1,1,1,1,1,20,10,16,12,12,1,1,8,14,0,0,0,0,0,0,0,0,0,0,0,0,0,0,0,0,0,0,0,0,0,0,0,0,0,0,0,0,0,0,0,0,0,0,0,0,0,0,0,0,0,0,0,0,0,0,0,0,0,Christoph Janker,£135Th. ,35,185,Defender - Centre-Back,right,Retired,17,0,0,1265,5,0,0,73,4,0,0,69,nan,nan,nan,nan,nan,nan,nan,nan,Bundesliga
19-06-17,18.3.4.28,Marco Russ,8718185,771,04-Aug-85,31,0,0,0,0,3250,6250,6250,130,125,3466029,190,88,D C,3,1,1,3,2,1,2,4,3,2,1,5,6,9,7,8,8,14,10,12,15,10,7,15,8,14,12,17,9,14,8,10,17,5,14,10,13,15,13,10,8,16,16,10,14,12,20,13,17,13,12,13,4,12,8,10,15,16,14,8,7,13,20,1,12,1,1,1,20,D C,101,1,1,1,1,1,1,20,1,1,14,12,1,1,1,1,512,0,0,0,0,0,0,0,0,0,1,0,0,0,0,0,0,0,0,0,0,0,0,0,0,0,0,0,0,0,0,0,0,0,0,0,0,0,0,0,0,0,0,0,0,0,0,0,0,Marco Russ,£900Th. ,35,190,Defender - Centre-Back,right,Retired,6,0,0,259,25,1,0,1638,9,0,0,670,1,0,0,37,nan,nan,nan,nan,Bundesliga
19-06-17,18.3.4.28,Niko Bungert,8728048,771,24-Oct-86,30,0,0,3,0,4300,6050,6300,129,121,4996827,188,77,D C,2,1,3,3,3,1,2,1,3,1,3,4,7,6,5,8,4,15,6,12,14,9,5,13,8,11,13,12,10,16,7,12,13,4,13,7,14,16,11,13,12,11,14,8,11,15,20,12,11,16,6,13,14,13,4,10,17,12,16,16,14,4,20,10,1,1,14,10,20,D C,101,1,1,1,1,1,1,20,10,14,8,1,1,1,6,10,2.74878E+11,0,0,0,0,0,0,0,0,0,0,0,0,0,0,0,0,0,0,0,0,0,0,0,0,0,0,0,0,0,0,0,0,0,0,0,0,0,0,1,0,0,0,0,0,0,0,0,0,Niko Bungert,£450Th. ,34,188,Defender - Centre-Back,right,Retired,14,2,0,1147,0,0,0,0,8,0,0,288,nan,nan,nan,nan,nan,nan,nan,nan,Bundesliga
19-06-17,18.3.4.28,Naldo,8829862,1651,10-Sep-82,34,4,0,0,0,6850,6850,7350,161,147,232186002,198,89,D C,3,1,2,2,1,2,2,3,4,2,2,4,7,10,8,10,14,18,15,8,14,12,9,13,11,10,17,13,16,14,9,15,15,13,15,10,16,10,12,8,8,13,20,10,16,11,20,12,16,17,8,16,10,10,15,12,14,13,17,14,11,8,20,1,10,1,1,1,20,D C,101,1,8,1,1,1,1,20,1,1,10,10,1,1,1,1,3.54592E+13,0,0,0,0,0,0,0,0,0,1,0,0,0,0,0,0,0,0,0,0,0,0,0,0,0,0,0,0,0,0,0,0,0,0,0,0,0,0,1,0,0,0,0,0,0,1,0,0,Naldo,£900Th. ,32,188,Defender - Centre-Back,right,Antalyaspor,24,2,0,2220,17,0,0,1461,18,1,1,1516,26,0,1,2048,2,0,0,180,LaLiga
19-06-17,18.3.4.28,Ömer Toprak,91000354,799,21-Jul-89,27,26,2,0,0,5350,6750,7350,147,147,66621437,186,83,D C,1,1,1,3,3,2,2,3,2,2,1,5,8,8,10,11,5,13,5,9,16,10,7,15,11,12,17,14,12,15,8,12,11,6,14,7,16,15,12,14,12,15,13,12,14,16,20,13,14,15,6,13,8,10,8,13,13,10,16,16,12,5,20,8,11,1,12,10,20,D C,101,1,1,1,1,1,1,20,10,12,11,11,1,1,8,8,2.79173E+11,0,0,0,0,0,0,0,0,0,0,0,0,0,0,0,0,0,0,0,0,0,0,0,0,0,0,0,0,0,0,0,0,1,0,0,0,0,0,1,0,0,0,0,0,0,0,0,0,Ömer Toprak,£10.80m ,31,187,Defender - Centre-Back,right,SV Werder Bremen,32,1,0,2732,36,0,2,2715,14,0,0,770,13,0,0,898,2,0,0,103,Bundesliga
19-06-17,18.3.4.28,Benjamin Hübner,91004226,771,04-Jul-89,27,0,0,0,0,4800,6550,6800,138,136,14207734,193,85,D C,1,2,2,2,3,1,1,3,2,2,1,5,8,6,7,9,5,14,7,10,16,12,8,16,10,14,16,17,12,15,10,12,17,6,13,7,15,14,10,10,8,14,18,20,13,12,7,13,16,16,8,15,5,13,7,13,10,14,16,10,11,5,20,8,12,1,10,10,20,D C,101,1,1,1,1,1,1,20,10,10,12,12,1,1,8,8,17179869184,0,0,0,0,0,0,0,0,0,0,0,0,0,0,0,0,0,0,0,0,0,0,0,0,0,0,0,0,0,0,0,0,0,0,1,0,0,0,0,0,0,0,0,0,0,0,0,0,Benjamin Hübner,£7.20m ,31,193,Defender - Centre-Back,left,TSG 1899 Hoffenheim,26,3,4,2252,32,4,3,2722,11,0,1,903,27,1,4,2285,nan,nan,nan,nan,Bundesliga
19-06-17,18.3.4.28,Kevin Vogt,91004433,771,23-Sep-91,25,0,0,8,0,4850,6600,6850,141,137,15379348,194,85,D/DM/M C,2,1,2,3,1,1,2,1,2,2,2,6,9,8,7,10,7,11,8,15,12,13,5,13,11,12,12,14,14,13,10,15,15,7,14,9,13,16,12,12,8,14,15,12,13,18,20,14,15,15,10,13,10,15,9,15,12,11,13,10,8,12,20,8,18,10,12,1,20,D/DM/M C,121,1,1,1,10,1,1,20,1,12,18,18,1,1,1,8,1.15292E+18,0,0,0,0,0,0,0,0,0,0,0,0,0,0,0,0,0,0,0,0,0,0,0,0,0,0,0,0,0,0,0,0,0,0,0,0,0,0,0,0,0,0,0,0,0,0,0,0,Kevin Vogt,£10.80m ,29,194,Defender - Centre-Back,right,TSG 1899 Hoffenheim,33,0,0,2805,40,0,1,3533,34,0,0,2934,29,0,0,2453,7,0,0,660,Bundesliga
19-06-17,18.3.4.28,Stefan Bell,91004660,771,24-Aug-91,25,0,0,5,1,6250,6750,6750,139,135,13049159,192,86,D C,1,4,2,2,3,1,3,2,1,3,3,5,8,6,7,9,5,14,5,13,16,10,6,14,9,12,16,15,11,15,8,13,13,6,12,7,15,17,10,10,8,15,16,10,14,13,20,13,16,17,10,16,3,10,9,12,16,14,16,14,18,6,20,10,1,1,14,1,20,D C,101,1,1,1,1,1,1,20,1,14,1,1,1,1,1,10,0,0,0,0,0,0,0,0,0,0,0,0,0,0,0,0,0,0,0,0,0,0,0,0,0,0,0,0,0,0,0,0,0,0,0,0,0,0,0,0,0,0,0,0,0,0,0,0,0,Stefan Bell,£5.40m ,29,192,Defender - Centre-Back,right,1.FSV Mainz 05,38,5,1,3403,28,1,0,2476,27,0,0,2460,1,0,0,67,nan,nan,nan,nan,Bundesliga
19-06-17,18.3.4.28,Willi Orban,91011532,771,03-Nov-92,24,0,0,2,0,6100,6850,7100,150,142,27872986,186,82,D C,1,3,1,1,1,2,1,1,3,3,4,5,7,7,8,11,5,16,8,10,15,12,8,17,10,11,14,17,12,15,9,12,12,6,14,6,15,16,12,11,11,15,14,14,16,13,20,13,14,16,10,15,8,10,10,14,13,16,17,13,15,5,20,8,12,1,10,10,20,D C,101,1,1,1,1,1,1,20,10,10,12,12,1,1,8,8,0,0,0,0,0,0,0,0,0,0,0,0,0,0,0,0,0,0,0,0,0,0,0,0,0,0,0,0,0,0,0,0,0,0,0,0,0,0,0,0,0,0,0,0,0,0,0,0,0,Willi Orban,£13.50m ,27,186,Defender - Centre-Back,right,RB Leipzig,29,3,1,2638,37,4,1,3038,39,4,1,3382,18,1,1,1247,5,1,1,332,Bundesliga
19-06-17,18.3.4.28,Tobias Strobl,91012805,771,12-May-90,27,0,0,0,0,4600,6350,6600,134,132,10186680,188,80,D/DM/M C,1,2,3,2,3,1,2,2,1,1,4,6,11,6,7,10,8,12,11,15,14,12,7,16,10,14,12,16,11,16,9,12,14,6,13,8,14,18,13,10,8,15,14,9,16,12,20,15,16,17,12,15,4,17,11,14,12,15,16,12,16,5,18,10,20,8,14,1,20,D/DM/M C,331,1,1,1,1,1,8,18,1,14,20,20,1,8,1,10,0,0,0,0,0,0,0,0,0,0,0,0,0,0,0,0,0,0,0,0,0,0,0,0,0,0,0,0,0,0,0,0,0,0,0,0,0,0,0,0,0,0,0,0,0,0,0,0,0,Tobias Strobl,£1.80m ,30,188,Midfielder - Defensive Midfield,right,FC Augsburg,37,0,2,2487,4,0,1,113,30,0,4,2385,12,0,1,793,6,0,0,122,Bundesliga
19-06-17,18.3.4.28,Robin Knoche,91100465,771,22-May-92,25,0,0,10,1,4100,6600,6600,135,132,9650541,190,77,D C,3,2,1,3,3,3,2,1,1,4,3,5,8,7,7,10,5,15,6,12,14,11,6,14,10,10,15,13,14,16,9,15,12,4,10,6,16,18,11,9,10,12,15,9,13,11,20,13,13,15,6,15,5,12,8,10,15,13,14,16,18,3,20,8,12,1,10,1,20,D C,101,1,1,1,1,1,1,20,1,10,12,12,1,1,1,8,2.92075E+11,0,0,0,0,0,0,0,0,0,0,0,0,0,0,0,0,0,0,0,0,0,0,0,0,1,0,0,0,0,0,0,0,0,0,1,0,0,0,1,0,0,0,0,0,0,0,0,0,Robin Knoche,£3.15m ,28,190,Defender - Centre-Back,right,1.FC Union Berlin,27,1,1,2141,29,2,2,2583,34,3,0,2974,31,2,0,2438,6,0,0,570,Bundesliga
19-06-17,18.3.4.28,Niklas Süle,91107360,771,03-Sep-95,21,6,0,11,1,6700,7450,7700,168,149,114731717,194,91,D C,3,3,3,3,4,2,3,1,2,2,1,4,6,7,8,10,6,16,10,8,15,12,9,15,10,10,13,16,14,15,10,14,15,6,12,7,15,11,10,11,9,16,17,12,11,17,20,13,18,15,10,17,4,6,10,13,13,17,10,9,10,12,20,1,10,1,1,1,20,D C,101,1,1,1,1,1,1,20,1,1,10,10,1,1,1,1,0,0,0,0,0,0,0,0,0,0,0,0,0,0,0,0,0,0,0,0,0,0,0,0,0,0,0,0,0,0,0,0,0,0,0,0,0,0,0,0,0,0,0,0,0,0,0,0,0,Niklas Süle,£34.20m ,25,195,Defender - Centre-Back,right,Bayern Munich,34,2,3,3007,42,2,2,3017,42,2,0,3507,16,0,1,1151,7,0,0,526,Bundesliga
19-06-17,18.3.4.28,Matthias Ginter,91107789,771,19-Jan-94,23,14,0,18,1,6950,7450,7450,160,144,51026341,190,88,D/DM/M RC,2,3,2,3,3,2,1,1,2,2,3,6,12,7,10,13,7,15,10,14,14,13,11,14,12,11,15,12,16,15,12,16,12,6,10,9,14,17,12,10,9,13,14,12,16,12,20,14,15,13,8,13,7,16,8,15,13,13,16,16,18,3,20,11,17,10,15,1,20,D/DM/M RC,123,1,1,8,10,1,1,20,1,15,17,17,1,1,1,11,1.15292E+18,0,0,0,0,0,0,0,0,0,0,0,0,0,0,0,0,0,0,0,0,0,0,0,0,0,0,0,0,0,0,0,0,1,0,0,0,0,0,1,0,0,0,0,0,0,0,0,0,Matthias Ginter,£22.50m ,26,191,Defender - Centre-Back,right,Borussia Mönchengladbach,42,0,1,3382,37,5,2,3330,29,2,0,2560,36,1,2,3231,7,1,0,630,Bundesliga
19-06-17,18.3.4.28,Kevin Akpoguma,91109389,771,19-Apr-95,22,0,0,7,0,3750,6250,6250,142,125,7537873,192,83,D RLC,3,1,1,2,3,3,2,2,1,1,1,5,9,9,10,11,8,13,11,15,13,10,10,14,11,14,11,15,11,10,9,10,14,11,9,12,11,15,13,13,12,15,17,10,16,16,20,13,14,12,12,12,4,18,9,15,7,11,13,10,11,8,20,14,11,1,16,15,20,D RLC,106,1,1,8,1,1,1,20,15,16,11,11,1,1,13,14,1.15292E+18,0,0,0,0,0,0,0,0,0,0,0,0,0,0,0,0,0,0,0,0,0,0,0,0,0,0,0,0,0,0,0,0,0,0,0,0,0,0,0,0,0,0,0,0,0,0,0,0,Kevin Akpoguma,£7.20m ,25,192,Defender - Centre-Back,right,TSG 1899 Hoffenheim,30,1,0,2611,27,0,1,2126,14,0,0,992,20,0,0,1346,7,0,0,660,Bundesliga
19-06-17,18.3.4.28,Niklas Stark,91109615,771,14-Apr-95,22,0,0,18,2,6400,6900,6900,154,138,18523307,190,81,D/DM/M C,1,4,1,1,2,2,1,1,3,2,3,6,8,7,9,11,7,11,10,10,14,12,8,15,11,14,12,16,11,14,9,12,15,7,14,8,13,18,14,12,12,13,16,12,15,17,20,14,13,14,10,15,8,14,11,14,13,13,17,15,17,4,20,6,18,10,1,10,20,D/DM/M C,121,1,1,1,10,1,1,20,10,1,18,18,1,1,6,1,0,0,0,0,0,0,0,0,0,0,0,0,0,0,0,0,0,0,0,0,0,0,0,0,0,0,0,0,0,0,0,0,0,0,0,0,0,0,0,0,0,0,0,0,0,0,0,0,0,Niklas Stark,£13.50m ,25,190,Defender - Centre-Back,right,Hertha BSC,32,1,2,2667,31,2,2,2634,25,1,0,2170,24,1,0,2065,6,0,0,531,Bundesliga
19-06-17,18.3.4.28,Jonathan Tah,91119700,771,11-Feb-96,21,3,0,4,0,5600,7100,7100,171,142,48509716,192,90,D RC,4,1,1,1,2,3,1,1,3,3,1,6,10,9,5,12,5,12,5,13,15,12,7,14,13,10,14,13,16,10,11,12,10,8,10,5,13,15,9,13,11,16,17,12,14,17,20,13,17,14,6,14,4,10,8,13,7,14,14,16,16,11,20,11,10,1,15,1,20,D RC,103,1,1,1,1,1,1,20,1,15,10,10,1,1,1,11,4294967296,0,0,0,0,0,0,0,0,0,0,0,0,0,0,0,0,0,0,0,0,0,0,0,0,0,0,0,0,0,0,0,0,1,0,0,0,0,0,0,0,0,0,0,0,0,0,0,0,Jonathan Tah,£27.00m ,24,195,Defender - Centre-Back,right,Bayer 04 Leverkusen,26,1,1,2296,33,0,2,2936,38,3,1,3389,39,0,1,3136,2,0,0,41,Bundesliga
19-06-17,18.3.4.28,Thilo Kehrer,91126230,771,21-Sep-96,20,0,0,3,0,4600,6600,6600,152,132,18989773,185,73,D/DM/M C,3,2,1,3,1,2,1,3,2,1,2,6,9,9,6,12,5,15,8,10,12,13,7,16,13,11,13,13,15,10,12,11,10,9,11,7,12,14,11,13,13,12,14,14,16,17,20,14,11,12,10,14,5,17,10,17,6,12,9,14,12,15,20,10,16,1,14,12,20,D/DM/M C,121,1,1,1,1,1,1,20,12,14,16,16,1,1,10,10,4294967296,0,0,0,0,0,0,0,0,0,0,0,0,0,0,0,0,0,0,0,0,0,0,0,0,0,0,0,0,0,0,0,0,1,0,0,0,0,0,0,0,0,0,0,0,0,0,0,0,Thilo Kehrer,£16.20m ,24,186,Defender - Centre-Back,right,Paris Saint-Germain,25,1,2,1605,33,3,2,2760,40,1,2,2953,21,1,0,1554,2,0,0,180,Bundesliga
19-06-17,18.3.4.28,Jannes Horn,91132038,771,06-Feb-97,20,0,0,0,0,3250,6250,6250,147,125,11287334,186,79,D/WB LC,3,3,2,3,1,2,1,3,1,2,1,14,15,9,7,11,12,10,9,15,11,13,9,13,12,13,10,15,12,10,12,11,14,13,9,11,9,13,15,13,10,13,12,20,16,16,9,14,12,13,10,14,6,15,7,13,10,14,12,10,8,10,20,20,12,11,10,20,15,D/WB LC,114,1,1,1,1,11,10,15,20,7,12,12,11,10,20,7,0,0,0,0,0,0,0,0,0,0,0,0,0,0,0,0,0,0,0,0,0,0,0,0,0,0,0,0,0,0,0,0,0,0,0,0,0,0,0,0,0,0,0,0,0,0,0,0,0,Jannes Horn,£2.70m ,23,186,Defender - Left-Back,left,1. FC Köln,17,0,2,1334,15,0,0,1187,19,0,4,1248,24,0,0,1761,6,0,1,512,Bundesliga
19-06-17,18.3.4.28,Lukas Klostermann,91134708,771,03-Jun-96,21,0,0,5,0,4700,6700,6700,151,129,12212575,189,83,D/WB RLC,3,2,3,3,1,1,1,3,3,3,1,7,11,8,8,9,6,12,6,15,13,10,5,14,10,12,14,16,9,12,9,10,14,7,11,10,11,13,14,14,10,15,15,12,16,18,20,14,14,13,8,13,8,16,12,16,7,13,13,15,17,6,20,16,10,10,20,15,18,D/WB RLC,116,1,1,1,1,8,10,18,15,20,8,8,8,10,11,16,0,0,0,0,0,0,0,0,0,0,0,0,0,0,0,0,0,0,0,0,0,0,0,0,0,0,0,0,0,0,0,0,0,0,0,0,0,0,0,0,0,0,0,0,0,0,0,0,0,Lukas Klostermann,£10.80m ,24,189,Defender - Centre-Back,right,RB Leipzig,1,0,0,90,39,1,0,3205,40,5,3,2965,43,4,2,3634,5,0,0,334,Bundesliga
19-06-17,18.3.4.28,Jordan Torunarigha,91137260,771,07-Aug-97,19,0,0,0,0,3300,6050,6300,149,126,12852770,189,77,D LC,1,1,2,3,3,1,1,2,3,3,3,4,9,9,8,11,5,15,7,13,14,13,8,14,12,14,12,16,14,9,12,10,14,8,9,10,11,13,10,14,12,14,16,20,15,17,9,13,13,11,8,13,5,10,10,13,12,16,13,12,15,8,20,11,1,1,1,15,20,D LC,104,1,1,1,1,1,1,20,15,1,1,1,1,1,11,1,0,0,0,0,0,0,0,0,0,0,0,0,0,0,0,0,0,0,0,0,0,0,0,0,0,0,0,0,0,0,0,0,0,0,0,0,0,0,0,0,0,0,0,0,0,0,0,0,0,Jordan Torunarigha,£3.60m ,23,191,Defender - Centre-Back,left,Hertha BSC,18,1,0,1325,25,2,0,1665,17,2,2,1350,23,2,0,1817,2,0,1,180,Bundesliga
19-06-17,18.3.4.28,Waldemar Anton,91137493,771,20-Jul-96,20,0,0,1,0,4100,6350,6600,144,127,10483529,189,75,D/DM/M C,2,3,2,2,3,2,2,1,2,1,3,5,9,7,8,11,5,12,8,10,13,12,7,13,11,12,16,13,15,16,10,14,13,7,10,10,13,16,12,10,10,12,14,10,16,12,20,14,11,15,7,14,4,16,8,12,15,13,17,14,17,5,20,10,17,1,14,12,20,D/DM/M C,121,1,1,1,1,1,1,20,12,14,17,17,1,1,8,10,0,0,0,0,0,0,0,0,0,0,0,0,0,0,0,0,0,0,0,0,0,0,0,0,0,0,0,0,0,0,0,0,0,0,0,0,0,0,0,0,0,0,0,0,0,0,0,0,0,Waldemar Anton,£10.80m ,24,189,Defender - Centre-Back,right,VfB Stuttgart,33,2,3,2770,29,1,0,2458,36,1,0,3240,31,0,1,2780,4,0,0,360,Bundesliga
19-06-17,18.3.4.28,Gideon Jung,91138249,771,12-Sep-94,22,0,0,5,0,4550,6550,6550,137,126,9795974,189,76,D/DM/M C,4,2,2,3,1,3,1,2,3,3,3,5,7,10,7,11,5,10,8,8,15,12,7,16,11,17,12,16,10,13,9,10,14,7,10,8,13,15,17,13,13,12,14,10,15,16,20,16,10,15,12,14,5,14,11,11,12,12,15,15,12,6,17,1,20,1,1,1,20,D/DM/M C,331,1,1,1,1,1,1,17,1,1,20,20,1,1,1,1,16777216,0,0,0,0,0,0,0,0,0,0,0,0,0,0,0,0,0,0,0,0,0,0,0,0,1,0,0,0,0,0,0,0,0,0,0,0,0,0,0,0,0,0,0,0,0,0,0,0,Gideon Jung,£2.70m ,26,189,Defender - Centre-Back,right,Hamburger SV,34,1,1,2791,31,1,1,2616,14,0,1,896,26,1,1,1940,5,0,0,227,Bundesliga
19-06-17,18.3.4.28,Marco Friedl,91143703,755,16-Mar-98,19,0,0,2,1,3250,5750,5750,137,115,3682131,187,71,D/WB LC,4,1,3,2,3,2,3,1,3,1,1,10,12,8,7,11,14,12,10,13,11,13,12,11,13,13,11,13,15,10,12,10,13,7,9,8,10,14,11,12,10,13,15,20,16,15,12,13,11,12,9,13,7,15,12,16,12,13,15,10,8,9,20,16,12,8,1,20,18,D/WB LC,114,1,1,1,1,8,1,18,20,1,12,12,8,1,16,1,5.76461E+17,0,0,0,0,0,0,0,0,0,0,0,0,0,0,0,0,0,0,0,0,0,0,0,0,0,0,0,0,0,0,0,0,0,0,0,0,0,0,0,0,0,0,0,0,0,0,0,0,Marco Friedl,£1.35m ,22,187,Defender - Centre-Back,left,SV Werder Bremen,30,7,3,2662,22,1,1,1700,9,0,1,682,32,2,4,2577,5,0,0,450,Bundesliga
19-06-17,18.3.4.28,Felix Uduokhai,91144514,771,09-Sep-97,19,0,0,0,0,4500,6250,6500,155,125,16037828,192,78,D C,3,3,3,1,3,3,3,3,3,2,2,5,9,9,6,11,5,13,7,10,14,13,9,14,12,14,13,15,13,10,12,10,12,8,10,7,11,14,11,13,12,15,16,20,16,15,12,13,14,11,7,14,4,14,11,16,12,14,13,15,10,6,20,10,12,1,1,14,20,D C,101,1,1,8,1,1,1,20,14,1,12,12,1,1,10,1,1.15306E+18,0,0,0,0,0,0,0,0,0,0,0,0,0,0,0,0,0,0,0,0,0,0,0,0,0,0,0,0,0,0,0,0,0,0,0,0,0,0,0,0,0,0,0,0,0,0,0,1,Felix Uduokhai,£7.20m ,23,192,Defender - Centre-Back,left,FC Augsburg,25,1,0,2169,24,3,0,2001,12,0,0,235,27,0,0,1991,6,1,0,540,Bundesliga
19-06-17,18.3.4.28,Kevin Danso,91144914,755,19-Sep-98,18,0,0,0,0,4700,6450,6200,136,124,12307261,190,80,D/DM/M C,1,1,1,2,2,2,1,2,2,1,3,5,7,8,10,9,5,15,7,17,15,10,10,14,10,14,12,17,10,10,8,9,13,7,10,13,11,12,14,11,11,15,17,10,16,14,20,13,15,11,12,13,4,16,15,17,11,13,12,14,10,6,20,1,16,8,8,1,20,D/DM/M C,121,1,1,10,1,1,8,20,1,1,16,16,1,8,1,1,0,0,0,0,0,0,0,0,0,0,0,0,0,0,0,0,0,0,0,0,0,0,0,0,0,0,0,0,0,0,0,0,0,0,0,0,0,0,0,0,0,0,0,0,0,0,0,0,0,Kevin Danso,£5.40m ,22,190,Defender - Centre-Back,right,Fortuna Düsseldorf,22,6,3,1885,19,2,1,1376,21,1,1,1453,10,0,1,601,4,0,0,355,Bundesliga
19-06-17,18.3.4.28,Robin Koch,91147345,771,17-Jul-96,20,0,0,0,0,4350,6350,6350,136,127,13602502,190,82,D/DM/M C,3,3,3,1,2,2,2,3,1,2,3,4,6,7,6,11,4,14,6,10,13,12,7,13,11,10,14,12,16,12,8,14,13,5,9,8,12,16,11,11,10,12,17,10,13,14,20,13,11,16,7,15,6,17,7,14,12,12,15,15,17,5,20,10,17,1,14,14,20,D/DM/M C,121,1,1,1,1,1,1,20,14,14,17,17,1,1,10,10,0,0,0,0,0,0,0,0,0,0,0,0,0,0,0,0,0,0,0,0,0,0,0,0,0,0,0,0,0,0,0,0,0,0,0,0,0,0,0,0,0,0,0,0,0,0,0,0,0,Robin Koch,£6.30m ,24,191,Defender - Centre-Back,right,Leeds United,27,0,0,2384,32,2,3,2456,25,1,0,1987,34,2,0,2807,6,0,0,540,Bundesliga
19-06-17,18.3.4.28,Florian Baak,91151070,771,18-Mar-99,18,0,0,0,0,2050,4800,5050,113,96,673305,185,75,D RC,2,2,2,1,1,1,3,3,1,2,3,4,6,6,7,8,5,15,6,10,13,9,5,13,8,14,10,16,8,10,7,8,15,5,11,7,10,12,13,11,10,14,14,10,13,13,20,10,13,14,10,12,6,4,10,12,13,14,13,15,12,8,20,11,1,1,15,1,20,D RC,103,1,1,1,1,1,1,20,1,15,1,1,1,1,1,11,0,0,0,0,0,0,0,0,0,0,0,0,0,0,0,0,0,0,0,0,0,0,0,0,0,0,0,0,0,0,0,0,0,0,0,0,0,0,0,0,0,0,0,0,0,0,0,0,0,Florian Baak,£360Th. ,21,191,Defender - Centre-Back,right,FC Winterthur,23,3,0,1857,23,1,1,2023,27,5,2,2325,18,0,0,1567,9,0,0,810,Bundesliga
19-06-17,18.3.4.28,Leon Balogun,92002651,38,28-Jun-88,28,10,0,0,0,4200,6450,6200,126,124,4213024,190,81,D/WB RC,1,3,2,3,1,1,3,3,1,2,2,5,11,9,6,10,5,14,7,18,12,9,6,13,9,14,10,15,9,14,7,10,14,7,11,9,12,13,14,12,10,17,16,13,12,16,20,14,15,16,12,12,12,12,8,14,8,13,12,13,13,7,20,16,9,1,18,1,20,D/WB RC,113,1,1,1,1,1,1,20,1,18,10,9,1,1,1,16,0,0,0,0,0,0,0,0,0,0,0,0,0,0,0,0,0,0,0,0,0,0,0,0,0,0,0,0,0,0,0,0,0,0,0,0,0,0,0,0,0,0,0,0,0,0,0,0,0,Leon Balogun,£1.80m ,32,190,Defender - Centre-Back,right,Rangers FC,21,0,0,1317,15,0,0,1198,10,1,0,801,13,0,0,944,6,0,0,435,Bundesliga
19-06-17,18.3.4.28,Rani Khedira,92017509,771,27-Jan-94,23,0,0,0,0,4400,6150,6400,131,123,8561819,188,84,D/DM/M C,1,3,1,4,2,1,1,1,1,1,1,6,8,9,7,10,6,12,8,10,13,11,9,14,11,17,13,16,10,14,10,11,13,6,11,15,12,18,17,11,10,14,12,10,18,13,20,17,15,15,8,14,5,16,12,15,13,10,16,16,18,5,16,1,20,10,1,1,20,D/DM/M C,331,1,1,1,10,1,1,16,1,1,20,20,1,1,1,1,0,0,0,0,0,0,0,0,0,0,0,0,0,0,0,0,0,0,0,0,0,0,0,0,0,0,0,0,0,0,0,0,0,0,0,0,0,0,0,0,0,0,0,0,0,0,0,0,0,Rani Khedira,£3.15m ,26,188,Midfielder - Defensive Midfield,right,FC Augsburg,10,0,0,155,31,1,1,2370,34,4,1,3022,33,0,2,2680,6,0,0,470,Bundesliga
19-06-17,18.3.4.28,Dominique Heintz,92018444,771,15-Aug-93,23,0,0,8,1,4600,6600,6600,140,132,14216388,190,85,D C,3,3,4,1,3,3,3,1,4,3,1,5,9,7,5,10,6,12,9,13,15,13,9,15,11,10,12,13,15,14,12,15,13,5,10,7,14,16,10,10,8,14,15,20,12,15,9,13,15,13,6,13,5,9,7,12,13,11,16,15,17,5,20,10,1,1,10,14,20,D C,101,1,1,1,1,1,1,20,14,10,1,1,1,1,10,6,1.40737E+14,0,0,0,0,0,0,0,0,0,0,0,0,0,0,0,0,0,0,0,0,0,0,0,0,0,0,0,0,0,0,0,0,0,0,0,0,0,0,0,0,0,0,0,0,0,0,0,1,Dominique Heintz,£6.75m ,27,188,Defender - Centre-Back,left,SC Freiburg,35,0,0,2950,38,1,1,3420,36,1,1,3264,30,0,1,2644,6,0,0,540,Bundesliga
19-06-17,18.3.4.28,Bjarne Thoelke,92025872,771,11-Apr-92,25,0,0,0,0,2150,5400,5650,115,108,815665,190,80,D C,3,3,1,2,3,2,2,1,3,4,1,4,7,7,5,9,4,14,5,10,13,10,6,14,9,14,11,15,10,14,7,11,12,4,9,8,13,15,12,9,8,13,16,9,14,11,20,12,14,12,10,12,10,7,6,13,14,12,15,15,17,7,20,1,1,1,1,1,20,D C,101,1,1,1,1,1,1,20,1,1,10,1,1,1,1,1,0,0,0,0,0,0,0,0,0,0,0,0,0,0,0,0,0,0,0,0,0,0,0,0,0,0,0,0,0,0,0,0,0,0,0,0,0,0,0,0,0,0,0,0,0,0,0,0,0,Bjarne Thoelke,£225Th. ,28,191,Defender - Centre-Back,right,Without Club,24,2,1,1896,5,1,0,450,18,0,0,1454,3,0,0,101,nan,nan,nan,nan,Bundesliga
19-06-17,18.3.4.28,John Brooks,92025938,390,28-Jan-93,24,32,3,4,0,5450,6950,6950,148,139,21963932,193,78,D C,4,4,2,3,1,2,1,4,1,4,3,4,8,10,6,12,4,13,6,10,16,13,7,15,12,10,15,13,15,9,11,12,10,10,13,7,13,13,8,13,11,15,17,20,14,17,8,13,16,11,6,12,9,5,8,10,14,14,12,16,8,11,20,1,1,1,1,1,20,D C,101,1,1,1,1,1,1,20,1,1,1,1,1,1,1,1,1.40742E+14,0,0,0,0,0,0,0,0,0,0,0,0,0,0,0,0,0,0,0,0,0,0,0,0,0,0,0,0,0,0,0,0,1,0,0,0,0,0,0,0,0,0,0,0,0,0,0,1,,,,,,,,,,,,,,,,,,,,,,,,,,,,
19-06-17,18.3.4.28,Alexander Hack,92026384,771,09-Sep-93,23,0,0,0,0,4250,6250,6250,132,125,6836675,193,82,D C,2,3,2,1,3,4,3,2,1,1,1,5,8,6,7,10,5,14,6,10,13,12,7,12,10,10,12,14,10,10,11,12,12,5,8,6,15,13,12,12,11,12,17,20,11,16,9,11,14,13,8,11,6,8,7,13,12,14,10,12,8,10,20,8,10,1,9,12,20,D C,101,1,1,1,1,1,1,20,12,9,10,10,1,1,8,5,1.40737E+14,0,0,0,0,0,0,0,0,0,0,0,0,0,0,0,0,0,0,0,0,0,0,0,0,0,0,0,0,0,0,0,0,0,0,0,0,0,0,0,0,0,0,0,0,0,0,0,1,Alexander Hack,£2.70m ,27,193,Defender - Centre-Back,left,1.FSV Mainz 05,24,1,2,2105,17,1,0,1444,15,1,1,1137,14,0,0,802,2,0,0,98,Bundesliga
19-06-17,18.3.4.28,Marc-Oliver Kempf,92027023,771,28-Jan-95,22,0,0,7,1,4950,6700,6450,147,129,10066806,186,87,D C,3,2,3,2,3,2,1,2,3,1,1,5,9,9,6,12,5,16,6,10,15,13,8,15,13,12,13,16,16,10,13,11,12,7,9,8,12,16,13,9,11,13,14,20,11,16,10,12,15,12,8,12,15,10,9,14,10,11,12,10,14,7,20,1,14,1,1,1,20,D C,101,1,1,1,1,1,1,20,1,1,14,14,1,1,1,1,1.40742E+14,0,0,0,0,0,0,0,0,0,0,0,0,0,0,0,0,0,0,0,0,0,0,0,0,0,0,0,0,0,0,0,0,1,0,0,0,0,0,0,0,0,0,0,0,0,0,0,1,Marc Oliver Kempf,£3.60m ,25,186,Defender - Centre-Back,left,VfB Stuttgart,14,0,0,1236,14,0,1,1018,24,2,0,2115,23,2,4,1789,6,1,0,484,Bundesliga
19-06-17,18.3.4.28,Timo Baumgartl,92065892,771,04-Mar-96,21,0,0,2,0,4350,6350,6350,157,127,6968769,190,81,D C,4,3,1,2,2,2,2,1,2,3,3,4,7,9,6,11,4,12,5,9,13,10,6,14,11,10,14,10,15,13,9,15,9,4,8,6,13,17,12,11,11,10,15,12,12,15,20,13,13,12,5,11,8,6,9,11,13,10,14,16,18,3,20,8,1,1,12,1,20,D C,101,1,1,1,1,1,1,20,1,12,1,1,1,1,1,8,2.74878E+11,0,0,0,0,0,0,0,0,0,0,0,0,0,0,0,0,0,0,0,0,0,0,0,0,0,0,0,0,0,0,0,0,0,0,0,0,0,0,1,0,0,0,0,0,0,0,0,0,Timo Baumgartl,£10.80m ,24,190,Defender - Centre-Back,right,PSV Eindhoven,30,1,1,2700,31,0,0,2820,20,1,0,1800,22,2,0,1773,2,0,0,180,Bundesliga
19-06-17,18.3.4.28,Robert Bauer,92071550,771,09-Apr-95,22,0,0,0,0,4550,6300,6550,136,126,11714518,183,76,D/WB/DM/M RLC,2,2,3,2,3,3,1,1,2,1,3,6,9,7,7,10,6,10,11,16,14,12,8,15,10,15,13,16,10,11,8,10,15,7,11,8,12,13,15,11,10,15,12,12,17,14,20,16,13,14,10,14,7,18,12,17,9,13,15,10,8,8,20,16,18,1,20,16,18,D/WB/DM/M RLC,136,1,1,1,1,1,1,15,16,20,18,18,1,1,12,16,0,0,0,0,0,0,0,0,0,0,0,0,0,0,0,0,0,0,0,0,0,0,0,0,0,0,0,0,0,0,0,0,0,0,0,0,0,0,0,0,0,0,0,0,0,0,0,0,0,Robert Bauer,£2.25m ,25,183,Defender - Right-Back,right,Arsenal Tula,27,1,3,2124,19,0,0,1162,24,0,0,1888,16,1,2,1226,12,0,0,1080,Bundesliga
19-06-17,18.3.4.28,Marcin Kaminski,96008380,787,15-Jan-92,25,4,0,12,0,3000,5500,6000,124,120,3531046,192,82,D C,1,1,2,1,3,1,3,4,3,1,4,6,8,9,8,10,11,10,11,8,12,14,9,12,13,8,13,10,11,11,12,14,9,9,10,8,15,14,9,12,10,11,14,20,13,15,9,13,12,9,5,13,8,14,10,11,14,10,13,15,18,4,20,8,12,1,1,12,20,D C,101,1,1,1,1,1,1,20,12,1,12,12,1,1,8,1,1.76197E+14,0,0,0,0,0,0,0,0,0,0,0,0,0,0,0,0,0,0,0,0,0,0,0,0,0,0,0,0,0,0,0,0,0,0,0,0,0,0,1,0,0,0,0,0,0,1,0,1,Marcin Kaminski,£2.25m ,28,192,Defender - Centre-Back,left,VfB Stuttgart,26,1,0,2291,25,0,0,1339,27,0,1,2430,9,0,1,694,4,0,0,212,Bundesliga
19-06-17,18.3.4.28,David Abraham,960928,1649,16-Jul-86,30,0,0,6,0,5100,6600,6600,134,132,232186002,188,83,D C,4,3,3,1,3,3,2,3,1,1,1,5,6,7,8,9,5,14,5,8,16,10,7,15,10,14,13,17,10,12,7,10,17,9,13,10,12,12,14,14,11,16,16,8,14,18,20,13,15,14,15,11,7,5,13,13,12,14,12,7,7,6,20,1,1,1,1,1,20,D C,101,1,1,1,1,1,1,20,1,1,1,1,1,1,1,1,0,0,0,0,0,0,0,0,0,0,0,0,0,0,0,0,0,0,0,0,0,0,0,0,0,0,0,0,0,0,0,0,0,0,0,0,0,0,0,0,0,0,0,0,0,0,0,0,0,David Abraham,£4.50m ,34,188,Defender - Centre-Back,right,Eintracht Frankfurt,36,1,2,3170,30,0,2,2505,27,0,1,2330,37,3,2,3175,5,0,0,423,Bundesliga
19-06-17,18.3.4.28,Manuel Akanji,98031331,798,19-Jul-95,21,1,0,6,0,5500,7000,7000,162,140,35851830,187,85,D C,1,4,3,4,2,1,1,1,4,3,3,4,8,10,6,12,9,11,11,10,15,13,8,16,12,14,12,15,16,11,13,13,14,9,10,7,11,13,12,14,12,16,15,15,13,17,20,13,14,12,8,14,8,7,12,16,11,13,17,14,12,6,20,8,1,1,12,1,20,D C,101,1,1,1,1,1,1,20,1,12,1,1,1,1,1,8,1.15306E+18,0,0,0,0,0,0,0,0,0,1,0,0,0,0,0,0,0,0,0,0,0,0,0,0,0,0,0,0,0,0,0,0,0,0,0,0,0,0,0,0,0,0,0,0,0,0,0,1,Manuel Akanji,£19.80m ,25,187,Defender - Centre-Back,right,Borussia Dortmund,19,5,1,1683,39,2,2,3344,31,1,0,2775,39,0,2,3190,6,1,0,540,Bundesliga
19-06-17,18.3.4.28,Nico Elvedi,98033057,798,30-Sep-96,20,4,0,1,0,4650,6650,6650,150,133,21193900,188,83,D RC,3,1,4,3,1,1,2,3,1,2,2,5,9,8,6,13,5,12,6,14,14,12,8,15,11,12,15,13,16,12,10,13,12,7,10,9,12,17,12,12,10,14,15,12,14,17,20,13,13,13,8,13,5,17,12,14,10,16,13,15,17,6,20,14,10,1,18,14,20,D RC,103,1,10,1,1,1,1,20,14,18,10,10,1,1,12,14,0,0,0,0,0,0,0,0,0,0,0,0,0,0,0,0,0,0,0,0,0,0,0,0,0,0,0,0,0,0,0,0,0,0,0,0,0,0,0,0,0,0,0,0,0,0,0,0,0,Nico Elvedi,£15.30m ,24,189,Defender - Centre-Back,right,Borussia Mönchengladbach,36,0,0,3116,36,2,3,3184,31,2,1,2715,39,1,0,3249,7,1,0,585,Bundesliga
19-06-17,18.3.4.28,Nicolas Nkoulou,12007662,11,27-Mar-90,27,75,2,3,0,5750,7000,6750,141,136,13518229,184,77,D C,2,2,2,2,1,3,3,3,1,1,1,5,7,9,6,13,6,14,7,8,14,13,7,14,12,12,15,15,14,13,11,13,15,9,14,7,14,15,14,13,13,15,11,8,11,13,20,14,16,12,11,14,9,11,12,15,15,13,16,10,15,7,20,1,1,1,12,1,20,D C,101,1,1,1,1,1,1,20,1,12,12,1,1,1,1,1,2.74878E+11,0,0,0,0,0,0,0,0,0,0,0,0,0,0,0,0,0,0,0,0,0,0,0,0,0,0,0,0,0,0,0,0,0,0,0,0,0,0,1,0,0,0,0,0,0,0,0,0,Nicolas N'Koulou,£9.00m ,30,184,Defender - Centre-Back,right,Torino FC,22,0,1,2040,39,2,0,3439,38,2,0,3370,38,1,0,3275,4,0,0,286,Serie A
19-06-17,18.3.4.28,Bastos,13129531,6,23-Nov-91,25,37,2,0,0,5000,7150,7150,147,143,47186090,180,77,D C,3,3,3,2,3,1,1,3,3,2,2,5,7,10,8,10,8,16,9,10,17,12,8,16,11,18,16,16,12,11,12,12,16,11,11,6,12,14,15,13,13,14,13,9,16,14,20,14,16,14,10,12,8,10,15,13,13,11,16,14,14,4,20,1,1,1,11,1,20,D C,101,1,1,1,1,1,1,20,1,11,10,1,1,1,1,1,1.15292E+18,0,0,0,0,0,0,0,0,0,0,0,0,0,0,0,0,0,0,0,0,0,0,0,0,0,0,0,0,0,0,0,0,0,0,0,0,0,0,0,0,0,0,0,0,0,0,0,0,Bastos,£5.85m ,29,180,Defender - Centre-Back,right,Al-Ain,19,0,0,1394,28,5,0,2039,28,1,0,1821,22,3,1,1285,2,0,0,61,Serie A
19-06-17,18.3.4.28,Jaouad El Yamiq,13175071,34,29-Feb-92,25,0,0,0,0,2750,6050,5850,130,117,2075304,190,74,D C,3,2,1,3,3,3,1,2,2,2,3,4,10,7,4,11,4,15,5,5,14,11,8,14,11,11,13,14,11,12,11,12,12,8,13,8,14,13,10,12,10,12,15,6,15,11,20,13,12,14,9,13,11,11,14,14,10,14,15,14,14,6,20,1,1,1,1,1,20,D C,101,1,1,1,1,1,1,20,1,1,1,1,1,1,1,1,1.46029E+11,0,0,0,0,0,0,0,0,0,0,0,0,0,0,0,0,0,0,0,0,0,0,0,0,0,0,0,0,0,0,0,0,0,1,0,0,0,1,0,0,0,0,0,0,0,0,0,0,Jawad El Yamiq,£810Th. ,28,190,Defender - Centre-Back,right,Real Valladolid CF,29,1,1,2467,15,2,0,1324,23,1,1,1732,18,0,1,1519,4,0,0,273,Serie A
19-06-17,18.3.4.28,Mateo Musacchio,14000745,1649,26-Aug-90,26,6,0,3,0,6300,7200,7550,162,151,86081768,180,75,D C,3,2,2,3,3,1,2,3,3,3,2,6,7,11,8,13,6,16,8,9,16,14,10,17,14,17,15,16,17,13,10,14,16,8,14,6,16,16,15,13,12,10,12,10,13,13,20,12,14,13,10,13,12,10,13,15,12,14,15,11,12,8,20,1,1,1,1,1,20,D C,101,1,11,1,1,1,1,20,1,1,9,1,1,1,1,1,1.37439E+11,0,0,0,0,0,0,0,0,0,0,0,0,0,0,0,0,0,0,0,0,0,0,0,0,0,0,0,0,0,0,0,0,0,0,0,0,0,1,0,0,0,0,0,0,0,0,0,0,Mateo Musacchio,£11.25m ,30,182,Defender - Centre-Back,right,AC Milan,30,0,2,2646,22,1,1,1754,33,1,1,2992,18,0,0,1466,nan,nan,nan,nan,Serie A
19-06-17,18.3.4.28,Fabio Lucioni,1400488,776,25-Sep-87,29,0,0,0,0,1900,5900,5900,125,118,360739,185,75,D C,3,1,2,2,1,3,1,4,2,3,4,5,5,5,10,7,4,13,8,7,15,12,5,14,9,11,12,12,11,14,9,11,13,7,16,7,14,13,12,12,11,14,12,20,8,12,8,14,14,13,8,15,5,9,10,11,14,12,4,2,10,5,20,1,1,1,1,1,20,D C,101,1,1,1,1,1,1,20,1,1,1,1,1,1,1,1,2.74878E+11,0,0,0,1,0,0,0,0,0,0,0,0,0,0,0,0,0,0,0,0,0,0,0,0,0,0,0,0,0,0,0,0,0,0,0,0,0,0,1,0,0,0,0,0,0,0,0,0,Fabio Lucioni,£360Th. ,33,185,Defender - Centre-Back,left,US Lecce,47,3,0,4260,9,0,0,810,25,2,1,2243,37,3,1,3223,6,0,0,540,Serie A
19-06-17,18.3.4.28,Lisandro López,14020962,1649,01-Sep-89,27,4,0,0,0,4800,6650,6800,145,136,7794381,187,83,D C,2,3,1,1,2,2,2,2,1,1,3,4,8,10,8,10,3,17,7,8,15,11,5,16,12,18,16,18,11,12,9,12,17,7,15,12,10,15,15,12,12,14,15,11,14,13,20,13,14,13,12,13,11,9,12,16,8,14,15,13,7,11,20,1,1,1,10,5,20,D C,101,1,1,1,1,1,1,20,5,10,1,1,1,1,1,1,1.15292E+18,0,0,0,0,0,0,0,0,0,0,0,0,0,0,0,0,0,0,0,0,0,0,0,0,0,0,0,0,0,0,0,0,0,0,0,0,0,0,0,0,0,0,0,0,0,0,0,0,Lisandro López,£3.60m ,31,187,Defender - Centre-Back,right,Club Atlético Boca Juniors,17,4,2,1451,9,1,0,639,27,4,0,2460,15,1,1,1201,nan,nan,nan,nan,Serie A
19-06-17,18.3.4.28,José Luis Palomino,14023020,1649,05-Jan-90,27,0,0,0,0,4339,5361,6600,133,129,11306606,187,78,D LC,3,1,2,2,3,1,2,2,2,3,3,6,10,11,6,12,6,14,5,12,14,12,8,14,12,13,12,14,11,11,12,10,13,10,8,11,13,13,13,14,11,14,16,20,15,14,10,13,16,13,10,12,5,7,12,12,10,10,14,11,12,6,20,12,1,1,1,15,20,D LC,104,1,1,1,1,1,1,20,15,1,1,1,1,1,12,1,0,0,0,0,0,0,0,0,0,0,0,0,0,0,0,0,0,0,0,0,0,0,0,0,0,0,0,0,0,0,0,0,0,0,0,0,0,0,0,0,0,0,0,0,0,0,0,0,0,José Luis Palomino,£6.75m ,30,188,Defender - Centre-Back,left,Atalanta BC,40,2,1,3573,35,1,0,2619,39,2,1,3023,38,2,1,3065,6,0,2,358,Serie A
19-06-17,18.3.4.28,Germán Pezzella,14023371,1649,27-Jun-91,25,0,0,7,0,4500,6750,6800,146,136,14862173,187,0,D C,1,2,3,2,3,2,3,4,1,1,2,7,8,8,5,10,7,17,7,8,16,10,7,15,9,13,15,16,13,14,8,12,15,12,14,7,14,13,14,11,11,14,16,8,11,10,20,13,15,14,6,12,10,12,6,13,14,10,15,9,14,12,20,1,1,1,1,1,20,D C,101,1,1,1,1,1,1,20,1,1,1,1,1,1,1,1,0,0,0,0,0,0,0,0,0,0,0,0,0,0,0,0,0,0,0,0,0,0,0,0,0,0,0,0,0,0,0,0,0,0,0,0,0,0,0,0,0,0,0,0,0,0,0,0,0,Germán Pezzella,£11.70m ,29,187,Defender - Centre-Back,right,ACF Fiorentina,37,1,0,3193,35,1,0,3070,35,2,1,3121,34,3,2,2902,2,1,0,109,Serie A
19-06-17,18.3.4.28,Leonardo Bonucci,1410956,776,01-May-87,30,70,5,0,0,8000,8550,8550,174,171,232186002,190,85,D C,2,1,1,1,2,1,2,1,3,1,3,9,9,12,12,13,12,14,12,8,17,17,13,16,13,11,20,17,14,15,15,12,18,13,19,7,20,16,14,11,13,16,14,9,15,14,20,16,15,18,11,13,5,11,14,16,10,14,18,14,9,3,20,1,1,1,1,1,20,D C,101,1,19,1,1,1,1,20,1,1,6,1,1,1,1,1,4.42564E+13,0,0,0,0,0,0,0,0,0,0,0,0,0,0,0,0,0,1,0,0,0,0,0,0,0,0,0,0,0,0,1,0,0,0,0,0,0,0,1,0,0,0,0,1,0,1,0,0,Leonardo Bonucci,£31.50m ,33,190,Defender - Centre-Back,right,Juventus FC,45,5,1,3741,51,2,1,4501,41,3,3,3550,47,4,0,4165,5,1,0,435,Serie A
19-06-17,18.3.4.28,Gabriele Angella,1414164,776,28-Apr-89,28,0,0,4,0,4100,6200,6200,135,124,5978012,189,82,D C,2,2,3,2,4,3,3,2,2,2,3,5,8,9,9,10,4,14,7,10,13,13,8,14,12,13,14,15,13,12,14,10,13,7,13,11,15,11,13,8,12,13,16,11,12,11,20,14,14,13,12,10,6,8,12,13,12,12,11,13,15,6,20,1,1,1,13,1,20,D C,101,1,1,1,1,1,1,20,1,13,1,1,1,1,1,1,8.79609E+12,0,0,0,0,0,0,0,0,0,0,0,0,0,0,0,0,0,0,0,0,0,0,0,0,0,0,0,0,0,0,0,0,0,0,0,0,0,0,0,0,0,0,0,1,0,0,0,0,Gabriele Angella,£900Th. ,31,193,Defender - Centre-Back,right,AC Perugia Calcio,14,1,0,1013,12,0,0,891,25,2,2,1956,16,0,2,1188,7,0,0,630,Serie A
19-06-17,18.3.4.28,Luca Ceppitelli,156330,776,11-Aug-89,27,0,0,0,0,3350,6350,6350,133,127,6100787,189,83,D C,3,1,2,1,3,1,3,1,3,2,2,2,8,5,7,10,3,16,10,9,14,12,3,14,7,13,14,14,12,13,7,13,12,4,10,9,14,12,14,12,10,13,14,10,13,12,20,14,14,12,8,12,5,14,14,15,12,13,14,13,13,9,20,12,1,1,14,1,20,D C,101,1,1,1,1,1,1,20,1,14,1,1,1,1,1,12,0,0,0,0,0,0,0,0,0,0,0,0,0,0,0,0,0,0,0,0,0,0,0,0,0,0,0,0,0,0,0,0,0,0,0,0,0,0,0,0,0,0,0,0,0,0,0,0,0,Luca Ceppitelli,£1.80m ,31,186,Defender - Centre-Back,both,Cagliari Calcio,20,0,0,1781,27,3,0,2229,26,1,1,2235,17,2,0,1338,nan,nan,nan,nan,Serie A
19-06-17,18.3.4.28,Timothy Castagne,18074558,757,05-Dec-95,21,0,0,7,1,4950,6100,6500,145,128,16784002,185,80,D/WB RC,2,1,2,2,1,1,3,3,1,1,4,8,14,10,10,12,9,8,9,12,12,12,7,12,11,14,12,12,14,14,8,13,18,12,12,11,14,15,14,14,11,10,9,8,14,14,20,14,13,13,14,14,11,12,14,12,13,10,14,11,12,1,20,19,12,1,20,13,15,D/WB RC,113,1,1,1,1,1,1,15,13,20,10,1,10,12,12,19,0,0,0,0,0,0,0,0,0,0,0,0,0,0,0,0,0,0,0,0,0,0,0,0,0,0,0,0,0,0,0,0,0,0,0,0,0,0,0,0,0,0,0,0,0,0,0,0,0,Timothy Castagne,£4.50m ,24,180,Defender - Right-Back,right,Leicester City,49,2,1,4289,26,1,3,1995,37,5,4,2671,33,2,3,2157,7,1,2,622,Serie A
19-06-17,18.3.4.28,Senna Miangue,18083551,757,05-Feb-97,20,0,0,4,0,2250,5650,5800,130,116,4876130,192,0,D/WB LC,3,3,2,3,2,2,1,3,3,3,3,5,11,10,6,10,5,12,6,12,12,11,5,12,8,12,12,14,11,12,8,10,8,8,7,11,12,13,14,13,13,12,15,20,15,14,9,15,14,10,11,9,5,9,17,12,12,13,13,12,19,5,20,16,14,1,5,20,15,D/WB LC,114,1,1,1,1,1,1,15,20,5,1,1,14,1,16,1,0,0,0,0,0,0,0,0,0,0,0,0,0,0,0,0,0,0,0,0,0,0,0,0,0,0,0,0,0,0,0,0,0,0,0,0,0,0,0,0,0,0,0,0,0,0,0,0,0,Senna Miangue,£1.35m ,23,192,Defender - Left-Back,left,KAS Eupen,17,0,0,1114,12,0,1,924,6,0,0,439,5,0,0,178,5,0,0,450,Serie A
19-06-17,18.3.4.28,Juan Jesus,19042304,1651,10-Jun-91,26,4,0,23,0,5400,6750,6800,144,136,15235261,185,84,D LC,3,2,2,1,3,1,2,1,1,3,3,4,9,11,6,11,5,13,6,10,15,12,9,15,11,16,13,15,10,9,11,12,13,7,13,9,13,14,15,13,13,17,13,20,15,14,9,16,17,12,13,13,5,12,14,13,14,11,15,12,14,10,20,15,1,1,1,17,20,D LC,104,1,1,1,1,1,1,20,17,1,1,1,1,1,15,1,32768,0,0,0,0,0,0,0,0,0,0,0,0,0,0,0,1,0,0,0,0,0,0,0,0,0,0,0,0,0,0,0,0,0,0,0,0,0,0,0,0,0,0,0,0,0,0,0,0,Juan Jesus,£11.70m ,29,185,Defender - Centre-Back,left,AS Roma,33,0,1,2196,29,0,0,2263,24,1,0,1620,5,0,0,228,1,0,0,70,Serie A
19-06-17,18.3.4.28,Maurício,19043525,1651,20-Sep-88,28,0,0,0,0,5250,6800,6500,143,130,8641668,185,83,D C,1,1,2,2,1,3,2,1,3,4,3,3,7,7,7,12,6,14,8,10,14,12,7,13,11,18,15,16,12,13,6,12,15,8,11,7,14,15,16,13,13,15,12,10,16,13,20,15,13,14,14,13,5,10,15,13,14,12,16,13,11,8,20,1,1,1,13,1,20,D C,101,1,13,1,1,1,1,20,1,13,1,1,1,1,1,1,32768,0,0,0,0,0,0,0,0,0,0,0,0,0,0,0,1,0,0,0,0,0,0,0,0,0,0,0,0,0,0,0,0,0,0,0,0,0,0,0,0,0,0,0,0,0,0,0,0,Maurício,£900Th. ,32,185,Defender - Centre-Back,right,Johor Darul Ta'zim,11,1,0,855,4,0,0,115,23,0,2,1913,9,2,0,774,nan,nan,nan,nan,Serie A
19-06-17,18.3.4.28,Thiago Cionek,19050795,787,21-Apr-86,31,12,0,0,0,3000,6050,6050,124,121,232186002,183,82,D RC,1,2,2,2,2,3,2,1,3,3,1,4,9,9,9,10,6,13,4,9,14,11,9,14,11,14,13,13,13,14,6,13,15,5,12,4,14,11,14,12,11,13,12,8,14,12,20,14,13,14,10,12,5,11,14,15,15,11,17,14,11,2,20,1,1,1,16,1,20,D RC,103,1,1,1,1,1,1,20,1,16,10,1,1,1,1,1,0,0,0,0,0,0,0,0,0,0,0,0,0,0,0,0,0,0,0,0,0,0,0,0,0,0,0,0,0,0,0,0,0,0,0,0,0,0,0,0,0,0,0,0,0,0,0,0,0,Thiago Cionek,£720Th. ,34,183,Defender - Centre-Back,right,Reggina 1914,30,0,0,2387,33,2,0,2862,33,0,2,2727,30,1,2,2345,5,0,0,344,Serie A
19-06-17,18.3.4.28,Rafael Tolói,19052922,1651,10-Oct-90,26,0,0,19,0,4500,6750,7200,147,144,34902770,185,75,D C,3,1,3,4,1,3,1,3,2,3,3,5,8,10,8,12,10,14,11,8,14,12,10,16,12,13,17,13,13,13,10,14,15,13,11,11,14,13,14,13,13,14,13,10,15,14,20,14,14,10,12,13,8,13,10,13,14,15,13,8,9,14,20,1,1,1,12,7,20,D C,101,1,1,1,1,1,1,20,7,12,1,1,1,1,1,1,1.15293E+18,0,0,0,0,0,1,0,0,0,0,0,0,0,0,0,0,0,0,0,0,0,0,0,0,0,0,0,0,0,0,0,0,0,0,0,0,0,1,0,0,0,0,0,1,0,0,0,0,Rafael Tolói,£9.90m ,30,185,Defender - Centre-Back,right,Atalanta BC,35,1,0,2990,39,3,3,3166,29,2,5,2481,40,2,7,3235,5,0,0,404,Serie A
19-06-17,18.3.4.28,Vítor Hugo,19144097,1651,20-May-91,26,0,0,0,0,3750,6800,6800,140,136,26793045,187,80,D C,2,1,3,1,1,2,3,3,4,1,2,9,9,10,8,10,9,15,10,8,13,10,10,14,10,12,15,14,13,14,9,13,12,10,12,9,14,13,13,13,12,9,16,20,13,12,12,14,13,13,12,12,4,7,19,13,12,13,13,12,10,10,20,1,1,1,1,1,20,D C,101,1,1,1,1,1,1,20,1,1,1,1,1,1,1,1,0,0,0,0,0,0,0,0,0,0,0,0,0,0,0,0,0,0,0,0,0,0,0,0,0,0,0,0,0,0,0,0,0,0,0,0,0,0,0,0,0,0,0,0,0,0,0,0,0,Vitor Hugo,£6.75m ,29,187,Defender - Centre-Back,left,Trabzonspor,3,0,0,157,21,1,0,1312,53,0,1,4471,9,0,0,489,2,0,0,180,Serie A
19-06-17,18.3.4.28,Samir,19162857,1651,05-Dec-94,22,0,0,0,0,4000,6450,6450,147,129,14793485,188,88,D LC,1,3,2,2,3,3,3,1,4,3,1,6,9,11,6,11,7,12,7,8,14,12,10,14,11,13,13,12,13,12,10,11,12,12,11,9,13,14,14,14,14,14,12,20,9,14,12,14,14,11,10,11,11,13,19,11,13,13,9,8,14,7,20,1,1,1,1,19,20,D LC,104,1,1,1,1,1,1,20,19,1,1,1,1,1,1,1,64,0,0,0,0,0,0,1,0,0,0,0,0,0,0,0,0,0,0,0,0,0,0,0,0,0,0,0,0,0,0,0,0,0,0,0,0,0,0,0,0,0,0,0,0,0,0,0,0,Samir,£4.95m ,25,188,Defender - Centre-Back,left,Udinese Calcio,21,0,2,1783,31,2,0,2573,22,2,1,1919,22,1,0,1632,5,1,0,430,Serie A
19-06-17,18.3.4.28,Wallace,19189686,1651,14-Oct-94,22,0,0,16,1,4900,7150,7150,159,143,67540874,191,85,D C,2,2,3,4,2,3,2,2,1,1,1,3,5,9,7,12,5,16,5,4,15,11,10,16,11,17,15,17,12,11,8,12,15,10,11,6,15,15,15,13,13,17,16,7,15,13,20,16,17,14,11,12,6,6,14,13,13,14,16,15,13,5,20,1,1,1,9,1,20,D C,101,1,10,1,1,1,1,20,1,9,1,1,1,1,1,1,4295000064,0,0,0,0,0,0,0,0,0,0,0,0,0,0,0,1,0,0,0,0,0,0,0,0,0,0,0,0,0,0,0,0,1,0,0,0,0,0,0,0,0,0,0,0,0,0,0,0,Wallace,£6.75m ,26,191,Defender - Centre-Back,right,Yeni Malatyaspor,30,1,0,2109,17,0,0,1312,20,1,0,1541,16,0,0,1200,3,0,0,270,Serie A
19-06-17,18.3.4.28,Lyanco,19236273,1651,01-Feb-97,20,0,0,0,0,3500,6150,6150,147,123,10158182,187,75,D C,1,2,3,3,2,2,2,3,1,2,1,5,7,8,5,8,6,13,9,4,13,10,11,12,8,14,13,14,14,11,9,16,15,8,8,6,14,14,13,12,13,11,15,10,16,12,20,15,14,13,8,9,2,6,11,14,10,12,12,10,12,16,20,1,1,1,1,1,20,D C,101,1,1,1,1,1,1,20,1,1,1,1,1,1,1,1,0,0,0,0,0,0,0,0,0,0,0,0,0,0,0,0,0,0,0,0,0,0,0,0,0,0,0,0,0,0,0,0,0,0,0,0,0,0,0,0,0,0,0,0,0,0,0,0,0,Lyanco,£3.60m ,23,187,Defender - Centre-Back,right,Torino FC,nan,nan,nan,nan,6,0,0,498,20,1,0,1577,18,0,0,1189,2,0,0,180,Serie A
19-06-17,18.3.4.28,Leandro Castán,2111889,1651,05-Nov-86,30,2,0,0,0,5300,6550,6500,149,130,6532781,184,80,D C,2,3,2,2,3,1,1,3,1,3,2,5,7,6,5,10,8,14,8,12,16,9,10,17,11,16,15,17,9,10,9,13,16,8,13,10,14,14,16,11,10,15,10,20,12,13,8,14,15,12,12,10,12,5,13,12,13,12,16,13,10,5,20,1,1,1,1,1,20,D C,101,1,1,1,1,1,1,20,1,1,1,1,1,1,1,1,1.15292E+18,0,0,0,0,0,1,0,0,0,0,0,0,0,0,0,1,0,0,0,0,0,0,0,0,0,0,0,0,0,0,0,0,0,0,1,0,0,0,0,0,0,0,0,0,0,0,0,0,Leandro Castán,£1.80m ,33,186,Defender - Centre-Back,left,Club de Regatas Vasco da Gama,14,0,0,1176,29,0,1,2435,22,2,1,1975,19,0,0,1710,nan,nan,nan,nan,Serie A
19-06-17,18.3.4.28,Lorenco Simic,24037344,761,15-Jul-96,20,0,0,0,0,3000,5450,5450,129,109,1224205,195,89,D C,1,2,2,1,1,4,1,3,1,3,3,4,7,10,6,11,4,12,9,6,12,10,4,13,10,14,13,14,12,11,7,9,12,7,10,7,12,12,11,12,13,14,17,7,14,11,20,12,15,12,8,8,4,8,12,14,10,12,11,8,6,11,20,1,1,1,1,1,20,D C,101,1,1,1,1,1,1,20,1,1,1,1,1,1,1,1,0,0,0,0,0,0,0,0,0,0,0,0,0,0,0,0,0,0,0,0,0,0,0,0,0,0,0,0,0,0,0,0,0,0,0,0,0,0,0,0,0,0,0,0,0,0,0,0,0,Lorenco Simic,£1.08m ,24,195,Defender - Centre-Back,right,Zaglebie Lubin,16,0,1,1458,21,4,0,1579,8,0,0,233,7,0,1,551,7,2,0,456,Serie A
19-06-17,18.3.4.28,Joachim Andersen,27069975,764,31-May-96,21,0,0,4,0,4600,5351,5900,134,119,5478861,192,90,D C,1,3,1,2,4,2,2,2,3,2,2,7,9,8,7,10,5,14,10,8,12,9,7,13,10,14,11,12,11,13,11,13,13,11,11,11,13,12,12,11,11,13,14,10,11,11,20,12,14,10,9,8,7,8,12,13,8,11,13,16,18,1,20,10,1,1,10,10,20,D C,101,1,1,1,1,1,1,20,10,10,14,1,1,1,10,8,1.37439E+11,0,0,0,0,0,0,0,0,0,0,0,0,0,0,0,0,0,0,0,0,0,0,0,0,0,0,0,0,0,0,0,0,0,0,0,0,0,1,0,0,0,0,0,0,0,0,0,0,Joachim Andersen,£1.35m ,24,192,Defender - Centre-Back,right,Fulham FC,24,2,1,1994,10,0,0,734,34,0,0,3090,32,2,0,2425,3,0,0,191,Serie A
19-06-17,18.3.4.28,Loďck Landre,29022617,769,05-May-92,25,0,0,5,2,3750,5300,5300,132,106,17842,182,78,D RC,1,3,3,1,1,2,4,3,2,1,3,5,10,8,7,10,6,13,11,8,13,8,7,12,9,14,13,17,11,10,6,9,14,8,10,8,11,13,14,13,12,14,11,6,14,14,20,14,15,12,14,14,8,8,11,14,13,11,13,12,13,6,20,10,1,1,18,8,20,D RC,103,1,1,1,1,1,1,20,8,18,12,1,1,1,8,10,8.79609E+12,0,0,0,1,0,0,0,0,0,0,0,0,0,0,0,1,0,0,0,0,0,0,0,0,0,0,0,0,0,0,0,0,0,0,0,0,0,0,0,0,0,0,0,1,0,0,0,0,Loïck Landre,£180Th. ,28,182,Defender - Centre-Back,right,Nîmes Olympique,6,0,0,437,1,0,0,90,24,3,0,1726,14,1,0,1229,7,0,0,552,Serie A
19-06-17,18.3.4.28,Danilo,320236,1651,10-May-84,33,0,0,0,0,4500,6500,6650,143,133,232186002,185,75,D C,4,2,2,1,1,1,3,1,2,2,1,4,7,8,10,11,3,15,9,14,14,9,10,14,10,16,13,17,12,13,8,14,13,11,15,7,15,14,13,12,10,14,13,9,15,13,20,14,14,13,14,14,7,10,13,14,14,15,12,5,7,14,20,1,1,1,1,1,20,D C,101,1,17,1,1,1,1,20,1,1,1,1,1,1,1,1,2.74878E+11,0,0,0,0,0,0,0,0,0,0,0,0,0,0,0,0,0,0,0,0,0,0,0,0,0,0,0,0,0,0,0,0,0,0,0,0,0,0,1,0,0,0,0,0,0,0,0,0,Danilo,£18.00m ,29,184,Defender - Right-Back,right,Juventus FC,25,1,3,2117,38,3,2,2476,22,1,1,1479,32,2,0,2152,5,0,1,450,Premier League
19-06-17,18.3.4.28,Sauli Väisänen,33045787,768,05-Jun-94,23,5,0,9,1,1740,3480,6000,139,120,1704285,190,80,D LC,1,1,2,2,3,3,1,4,4,3,3,6,10,9,6,10,8,14,7,7,13,12,6,14,12,7,13,13,11,12,10,13,14,6,10,9,14,12,12,12,7,13,14,14,11,12,20,13,13,12,7,13,5,10,14,12,12,15,14,16,14,3,20,8,10,1,11,15,20,D LC,104,1,1,1,1,1,1,20,15,11,11,10,1,1,8,6,0,0,0,0,0,0,0,0,0,0,0,0,0,0,0,0,0,0,0,0,0,0,0,0,0,0,0,0,0,0,0,0,0,0,0,0,0,0,0,0,0,0,0,0,0,0,0,0,0,Sauli Väisänen,£360Th. ,26,188,Defender - Centre-Back,right,Chievo Verona,19,0,0,1381,13,0,0,827,27,0,0,2210,16,1,0,1346,nan,nan,nan,nan,Serie A
19-06-17,18.3.4.28,Thomas Heurtaux,34003995,769,03-Jul-88,28,0,0,3,0,4500,6250,6250,137,125,7270047,183,78,D C,1,3,2,4,3,3,2,3,1,2,2,3,5,9,8,11,7,14,10,11,14,10,6,14,12,13,12,12,13,12,10,13,13,9,14,8,14,13,14,13,9,15,12,10,14,13,20,15,14,12,13,12,9,13,15,14,13,14,14,14,14,5,20,1,1,1,13,1,20,D C,101,1,1,1,1,1,1,20,1,13,1,1,1,1,1,1,1.37439E+11,0,0,0,0,0,0,0,0,0,0,0,0,0,0,0,0,0,0,0,0,0,0,0,0,0,0,0,0,0,0,0,0,0,0,0,0,0,1,0,0,0,0,0,0,0,0,0,0,Thomas Heurtaux,£1.62m ,32,183,Defender - Centre-Back,right,Without Club,13,0,1,614,19,0,0,1603,5,0,0,144,9,0,1,565,nan,nan,nan,nan,Serie A
19-06-17,18.3.4.28,Samuel Souprayen,34009619,769,18-Feb-89,28,0,0,3,0,4150,6250,6250,135,125,6866155,187,70,D LC,2,2,3,1,2,1,3,2,1,3,1,6,10,10,6,10,7,14,8,12,15,12,6,13,10,13,13,14,12,12,10,11,14,7,8,9,12,14,14,15,12,15,14,20,15,14,6,14,14,13,12,14,6,11,9,14,13,11,15,15,15,6,20,15,1,1,1,20,17,D LC,104,1,1,1,1,1,1,17,20,1,1,1,1,1,15,1,0,0,0,0,0,0,0,0,0,0,0,0,0,0,0,0,0,0,0,0,0,0,0,0,0,0,0,0,0,0,0,0,0,0,0,0,0,0,0,0,0,0,0,0,0,0,0,0,0,Samuel Souprayen,£630Th. ,31,187,Defender - Centre-Back,left,AJ Auxerre,42,0,3,3760,25,0,0,1881,31,1,1,2768,23,0,1,2043,0,0,0,0,Serie A
19-06-17,18.3.4.28,Benedikt Höwedes,35015879,771,29-Feb-88,29,44,2,22,3,7000,7500,7500,154,150,47167208,188,77,D RC,1,2,1,1,1,1,1,1,4,1,2,4,8,6,8,10,4,16,5,12,18,10,8,18,9,16,14,17,10,18,8,12,17,3,14,8,15,18,12,11,10,15,15,12,16,13,20,16,14,17,10,17,12,14,10,13,17,15,18,16,13,3,20,10,8,1,16,13,20,D RC,103,1,1,1,1,1,1,20,13,16,8,8,1,1,10,10,1.37439E+11,0,0,0,0,0,0,0,0,0,0,0,0,0,0,0,1,0,0,0,0,0,0,0,0,0,0,0,0,0,0,0,0,0,0,0,0,0,1,0,0,0,0,0,0,0,0,0,0,Benedikt Höwedes,£8.10m ,32,188,Defender - Centre-Back,right,Retired,46,2,4,4170,3,1,0,248,26,4,0,2000,24,0,0,2104,nan,nan,nan,nan,Serie A
19-06-17,18.3.4.28,Kostas Manolas,36023421,772,14-Jun-91,26,29,0,5,0,6400,7250,7650,159,153,104096372,189,83,D C,3,3,4,3,2,2,4,2,3,3,3,4,5,8,5,9,6,13,4,8,17,11,8,17,9,17,15,17,16,13,8,14,14,5,11,5,15,12,13,13,12,16,16,8,18,17,20,17,17,13,15,12,4,4,16,12,10,14,11,5,8,13,20,1,1,1,1,1,20,D C,101,1,1,1,1,1,1,20,1,1,1,1,1,1,1,1,8.93783E+12,0,0,0,0,0,0,0,0,0,0,0,0,0,0,0,0,1,0,0,0,0,0,0,0,0,0,0,0,0,0,0,0,1,0,0,0,0,1,0,0,0,0,0,1,0,0,0,0,Konstantinos Manolas,£36.00m ,29,189,Defender - Centre-Back,right,SSC Napoli,45,0,3,3811,40,4,0,3255,35,2,0,3077,35,4,0,2988,4,0,0,315,Serie A
19-06-17,18.3.4.28,Charalabos Lykogiannis,36045542,772,22-Oct-93,23,0,0,9,0,5000,6350,6350,137,128,5795371,186,78,D/WB/M/AM LC,3,1,1,1,3,1,1,2,2,1,3,8,3,10,9,12,12,11,14,13,13,14,11,13,13,14,13,14,12,13,11,11,14,10,9,13,12,13,13,13,12,14,13,20,13,14,7,14,15,13,10,12,6,13,11,10,13,14,14,15,10,6,20,18,16,16,10,20,16,D/WB/M/AM LC,134,1,1,1,10,16,10,16,20,1,10,14,16,6,18,1,512,0,0,0,0,0,0,0,0,0,1,0,0,0,0,0,0,0,0,0,0,0,0,0,0,0,0,0,0,0,0,0,0,0,0,0,0,0,0,0,0,0,0,0,0,0,0,0,0,Charalampos Lykogiannis,£1.80m ,27,190,Defender - Left-Back,left,Cagliari Calcio,36,3,3,3231,33,2,4,2602,12,0,2,917,23,0,1,1607,5,1,1,438,Serie A
19-06-17,18.3.4.28,Stefan de Vrij,37001814,784,05-Feb-92,25,31,3,12,0,6500,7650,7650,163,153,86978301,189,78,D C,3,3,4,3,1,1,1,3,3,3,1,5,6,11,8,12,6,15,8,5,16,13,8,17,12,16,16,14,13,13,13,14,15,12,12,7,15,16,16,12,13,13,15,12,15,13,20,14,16,16,9,15,15,13,16,14,14,16,16,15,16,2,20,1,1,1,8,1,20,D C,101,1,10,1,1,1,1,20,1,8,1,1,1,1,1,1,1.15292E+18,0,0,0,0,0,0,0,0,0,0,0,0,0,0,0,0,0,0,0,0,0,0,0,0,0,0,0,0,0,0,0,0,0,0,0,0,0,0,0,0,0,0,0,0,0,0,0,0,Stefan de Vrij,£36.00m ,28,189,Defender - Centre-Back,right,Inter Milan,31,2,2,2566,47,7,1,4062,36,2,1,3232,46,4,5,3906,4,0,0,360,Serie A
19-06-17,18.3.4.28,Bram Nuytinck,37006661,784,04-May-90,27,0,0,19,2,3700,5950,6250,128,125,6501099,190,80,D C,2,2,1,1,2,3,2,2,1,2,1,10,9,10,6,14,7,14,7,8,13,12,8,14,11,13,15,14,12,13,11,11,15,12,11,12,13,14,12,10,13,15,15,20,14,11,6,10,16,14,12,14,18,13,15,14,11,13,10,14,12,4,20,14,1,1,14,14,20,D C,101,1,1,1,1,1,1,20,14,14,14,1,1,1,14,14,0,0,0,0,0,0,0,0,0,0,0,0,0,0,0,0,0,0,0,0,0,0,0,0,0,0,0,0,0,0,0,0,0,0,0,0,0,0,0,0,0,0,0,0,0,0,0,0,0,Bram Nuytinck,£2.52m ,30,190,Defender - Centre-Back,left,Udinese Calcio,44,1,1,3574,30,1,1,2631,27,0,0,2129,28,0,1,2409,0,0,0,0,Serie A
19-06-17,18.3.4.28,Timo Letschert,37044470,784,25-May-93,24,0,0,3,0,4000,6250,6250,134,125,8038995,188,84,D C,1,1,1,3,2,2,1,3,2,4,2,6,11,11,5,12,16,14,9,9,13,12,6,13,11,18,13,15,12,13,13,12,15,14,15,15,13,14,12,11,10,13,14,9,13,14,20,12,13,13,11,13,8,13,8,14,2,13,12,11,15,15,20,1,8,1,14,14,20,D C,101,1,1,1,1,1,1,20,14,14,14,8,1,1,1,1,1.37439E+11,0,0,0,0,0,0,0,0,1,0,0,0,0,0,0,0,1,1,0,0,0,0,0,0,0,0,0,0,0,0,0,0,0,0,0,0,0,1,0,0,0,0,0,0,0,0,0,0,Timo Letschert,£2.25m ,27,188,Defender - Centre-Back,right,AZ Alkmaar,12,0,0,861,9,0,0,598,33,2,2,2706,24,2,0,1889,3,0,0,270,Serie A
19-06-17,18.3.4.28,Hans Hateboer,37046941,784,09-Jan-94,23,0,0,8,2,4250,5750,6200,134,124,7102905,187,74,D/WB RC,2,1,2,3,2,1,1,2,3,2,3,8,12,9,4,12,7,12,5,8,12,11,7,14,11,16,13,13,13,13,9,13,16,10,10,13,12,14,15,12,13,15,11,7,13,14,20,14,15,12,7,11,5,11,15,14,13,12,13,10,12,7,20,19,13,5,20,1,15,D/WB RC,113,1,1,1,1,1,5,15,1,20,10,1,1,13,1,19,8.79609E+12,0,1,0,0,0,1,0,0,0,0,0,0,0,0,0,0,0,0,0,0,0,0,0,0,0,0,0,0,0,0,0,0,0,0,0,0,0,0,0,0,0,0,0,1,0,0,0,0,Hans Hateboer,£6.30m ,26,185,Defender - Right-Back,right,Atalanta BC,27,2,5,2178,43,0,2,3275,43,6,6,3723,42,2,6,3033,5,2,0,390,Serie A
19-06-17,18.3.4.28,Emiliano Moretti,3802413,776,11-Jun-81,36,2,0,24,0,5350,6500,6550,145,131,232186002,183,78,D LC,2,3,3,4,1,3,3,2,1,3,2,5,10,7,7,12,7,15,7,14,16,13,9,15,12,13,12,14,12,14,9,13,14,6,17,10,14,14,14,11,10,17,11,20,14,10,7,14,15,15,12,15,5,10,14,14,12,10,17,16,12,10,20,9,1,1,1,15,20,D LC,104,1,1,1,1,1,1,20,15,1,1,1,1,1,9,1,64,0,0,0,0,0,0,1,0,0,0,0,0,0,0,0,0,0,0,0,0,0,0,0,0,0,0,0,0,0,0,0,0,0,0,0,0,0,0,0,0,0,0,0,0,0,0,0,0,Emiliano Moretti,£270Th. ,39,182,Defender - Centre-Back,left,Retired,26,1,3,2364,24,0,0,1961,26,0,0,2190,nan,nan,nan,nan,nan,nan,nan,nan,Serie A
19-06-17,18.3.4.28,Alessandro Gamberini,3804551,776,27-Aug-81,35,8,0,4,0,5000,6400,6250,144,125,650109,185,80,D C,2,2,1,2,4,1,1,2,1,1,4,3,5,6,5,9,3,15,2,9,16,10,3,15,8,15,14,14,14,15,6,12,16,3,16,7,14,16,15,10,9,15,13,9,13,12,20,13,14,13,15,14,13,7,12,13,14,14,10,12,11,10,20,1,1,1,1,3,20,D C,101,1,3,1,1,1,1,20,3,1,1,1,1,1,1,1,4294967360,0,0,0,0,0,0,1,0,0,0,0,0,0,0,0,0,0,0,0,0,0,0,0,0,0,0,0,0,0,0,0,0,1,0,0,0,0,0,0,0,0,0,0,0,0,0,0,0,Alessandro Gamberini,£225Th. ,39,185,Defender - Centre-Back,right,Retired,21,1,0,1715,24,0,0,1923,nan,nan,nan,nan,nan,nan,nan,nan,nan,nan,nan,nan,Serie A
19-06-17,18.3.4.28,Simone Romagnoli,43017209,776,09-Feb-90,27,0,0,6,0,3250,6000,6000,128,120,3962464,193,85,D C,2,2,2,3,3,3,2,1,1,2,2,5,7,6,5,11,5,15,7,12,14,10,5,13,8,12,13,13,13,13,10,12,12,5,13,9,13,13,14,11,11,13,16,5,14,12,20,14,14,13,12,13,3,8,10,14,14,11,15,15,14,1,20,1,1,1,1,1,20,D C,101,1,1,1,1,1,1,20,1,1,1,1,1,1,1,1,8589934592,0,0,0,0,0,0,0,0,0,0,0,0,0,0,0,0,0,0,0,0,0,0,0,0,0,0,0,0,0,0,0,0,0,1,0,0,0,0,0,0,0,0,0,0,0,0,0,0,Simone Romagnoli,£1.35m ,30,193,Defender - Centre-Back,right,FC Empoli,40,0,0,3183,29,0,1,2395,35,2,0,3146,33,0,1,2804,5,1,0,450,Serie A
19-06-17,18.3.4.28,Francesco Acerbi,43017499,776,10-Feb-88,29,2,0,0,0,4750,6900,7100,148,142,29277190,192,88,D C,2,1,1,3,3,4,3,1,1,3,2,6,6,9,6,11,4,15,8,6,16,12,4,15,11,12,16,14,12,15,11,14,18,10,13,7,16,14,14,9,8,15,16,20,14,12,10,15,17,14,9,15,12,7,10,15,15,12,14,12,10,2,20,1,1,1,1,1,20,D C,101,1,1,1,1,1,1,20,1,1,1,1,1,1,1,1,2.75952E+11,0,0,0,0,0,0,0,0,0,0,0,0,0,0,0,0,0,0,0,0,0,0,0,0,0,0,0,0,0,0,1,0,0,0,0,0,0,0,1,0,0,0,0,0,0,0,0,0,Francesco Acerbi,£9.00m ,32,192,Defender - Centre-Back,left,SS Lazio,49,4,0,4410,41,0,1,3690,50,3,0,4510,45,2,2,3976,6,0,1,540,Serie A
19-06-17,18.3.4.28,Bartosz Salamon,43017767,787,01-May-91,26,9,0,1,0,3500,6250,6250,134,125,2796172,194,84,D C,3,1,2,3,3,3,3,2,2,1,2,7,9,8,7,12,9,13,11,12,14,13,9,14,13,12,13,12,10,11,10,11,14,7,13,8,14,13,14,12,11,15,17,6,15,12,20,12,14,12,5,14,5,13,16,14,13,11,16,16,14,3,20,1,1,1,1,1,20,D C,101,1,1,1,1,1,1,20,1,1,10,1,1,1,1,1,1.40737E+14,0,0,0,0,0,0,0,0,0,0,0,0,0,0,0,0,0,0,0,0,0,0,0,0,0,0,0,0,0,0,0,0,0,0,0,0,0,0,0,0,0,0,0,0,0,0,0,1,Bartosz Salamon,£1.26m ,29,194,Defender - Centre-Back,right,SPAL,17,0,1,932,22,0,0,1722,21,0,0,1814,8,0,0,366,6,1,0,424,Serie A
19-06-17,18.3.4.28,Vasco Regini,43020251,776,09-Sep-90,26,0,0,5,0,4250,6350,6350,134,127,7564976,185,79,D/WB LC,3,1,2,1,1,3,2,2,3,3,2,5,12,12,7,10,5,14,7,7,13,11,6,13,10,13,14,14,11,12,10,13,12,8,9,12,14,15,15,13,12,15,13,20,14,14,7,16,12,14,10,10,7,12,15,15,14,12,16,10,10,8,20,16,14,1,1,19,20,D/WB LC,114,1,1,1,1,1,1,20,19,1,1,1,14,1,16,1,0,0,0,0,0,0,0,0,0,0,0,0,0,0,0,0,0,0,0,0,0,0,0,0,0,0,0,0,0,0,0,0,0,0,0,0,0,0,0,0,0,0,0,0,0,0,0,0,0,Vasco Regini,£1.62m ,30,185,Defender - Left-Back,left,UC Sampdoria,37,0,4,3037,17,0,0,1351,6,0,0,260,6,0,0,267,1,0,0,6,Serie A
19-06-17,18.3.4.28,Antonio Caracciolo,43020293,776,30-Jun-90,26,0,0,0,0,1750,5800,5800,130,116,2775466,185,73,D/WB RC,2,1,3,1,3,2,2,2,3,3,3,6,12,10,7,10,7,12,8,11,12,11,7,13,12,12,12,10,13,11,9,13,8,11,7,12,12,10,11,12,12,12,13,10,13,14,20,14,13,16,10,13,14,13,10,10,10,5,8,7,5,4,20,17,1,1,17,1,20,D/WB RC,113,1,1,1,1,1,1,20,1,17,1,1,1,1,1,17,2,0,1,0,0,0,0,0,0,0,0,0,0,0,0,0,0,0,0,0,0,0,0,0,0,0,0,0,0,0,0,0,0,0,0,0,0,0,0,0,0,0,0,0,0,0,0,0,0,Antonio Caracciolo,£720Th. ,30,185,Defender - Centre-Back,right,AC Pisa 1909,35,0,0,2870,33,2,0,2855,29,3,0,2472,33,0,0,2911,5,1,0,450,Serie A
19-06-17,18.3.4.28,Marco Capuano,43036505,776,14-Oct-91,25,0,0,18,0,3750,6000,6000,127,120,3962464,186,90,D C,1,4,2,2,2,2,3,2,1,2,1,6,11,7,4,11,7,13,11,14,14,12,5,13,10,15,13,13,13,14,8,11,16,6,13,8,14,14,12,12,10,14,11,20,13,13,8,14,14,14,6,14,10,11,12,13,14,12,15,14,14,5,20,12,1,1,1,14,20,D C,101,1,1,1,1,1,1,20,14,1,1,1,1,1,12,1,1073774656,0,0,0,0,0,0,1,0,0,0,0,0,0,0,0,1,0,0,0,0,0,0,0,0,0,0,0,0,0,0,1,0,0,0,0,0,0,0,0,0,0,0,0,0,0,0,0,0,Marco Capuano,£900Th. ,29,186,Defender - Centre-Back,left,Frosinone Calcio,13,1,1,859,27,0,0,2289,27,0,0,2313,25,2,0,2066,2,0,0,180,Serie A
19-06-17,18.3.4.28,Lorenzo Tonelli,43038530,776,17-Jan-90,27,0,0,1,0,4500,6400,6750,146,135,14098292,183,78,D C,1,1,1,2,2,3,2,2,3,1,3,5,7,6,9,10,6,15,7,10,15,10,5,15,9,15,13,15,14,13,10,13,15,7,13,10,14,13,15,13,12,14,13,9,15,14,20,15,14,15,15,12,13,10,9,12,14,9,15,13,11,6,20,1,1,1,10,1,20,D C,101,1,1,1,1,1,1,20,1,10,1,1,1,1,1,1,0,0,0,0,0,0,0,0,0,0,0,0,0,0,0,0,0,0,0,0,0,0,0,0,0,0,0,0,0,0,0,0,0,0,0,0,0,0,0,0,0,0,0,0,0,0,0,0,0,Lorenzo Tonelli,£4.50m ,30,183,Defender - Centre-Back,right,UC Sampdoria,4,2,0,360,7,1,0,620,20,1,0,1773,9,0,0,705,5,0,0,405,Serie A
19-06-17,18.3.4.28,Matteo Bianchetti,43055102,776,17-Mar-93,24,0,0,21,0,4000,5950,5950,135,119,4512829,189,82,D RC,3,3,1,1,1,3,3,1,2,3,3,7,8,4,6,9,7,14,7,12,14,12,5,14,8,13,14,15,12,15,8,12,15,3,14,5,14,12,13,12,10,11,13,7,12,10,20,12,14,15,13,13,12,10,12,13,14,12,15,12,12,5,20,15,1,1,17,1,20,D RC,103,1,1,1,1,1,1,20,1,17,1,1,1,1,1,15,8.79609E+12,0,0,0,0,0,0,0,0,0,0,0,0,0,0,0,0,0,0,0,0,0,0,0,0,0,0,0,0,0,0,0,0,0,0,0,0,0,0,0,0,0,0,0,1,0,0,0,0,Matteo Bianchetti,£720Th. ,27,189,Defender - Centre-Back,right,US Cremonese,37,0,2,3326,4,0,0,293,21,1,0,1747,36,1,2,3123,4,0,0,360,Serie A
19-06-17,18.3.4.28,Mario Sampirisi,43061338,776,31-Oct-92,24,0,0,1,0,3750,5900,5900,130,118,3918038,188,75,D/WB RC,2,2,3,1,3,2,2,3,3,2,1,6,14,10,8,10,6,13,6,10,14,12,6,13,12,11,11,11,14,12,7,10,14,7,8,6,12,14,14,13,13,13,15,8,15,13,20,14,13,12,8,8,6,14,11,13,12,13,12,11,10,5,20,16,1,1,20,10,18,D/WB RC,113,1,1,1,1,1,1,18,10,20,1,1,1,1,9,16,0,0,0,0,0,0,0,0,0,0,0,0,0,0,0,0,0,0,0,0,0,0,0,0,0,0,0,0,0,0,0,0,0,0,0,0,0,0,0,0,0,0,0,0,0,0,0,0,0,Mario Sampirisi,£810Th. ,27,188,Defender - Right-Back,right,AC Monza,23,1,1,1193,31,0,0,2192,36,0,1,3066,19,1,1,1292,3,0,0,240,Serie A
19-06-17,18.3.4.28,Luca Antei,43063709,776,19-Apr-92,25,0,0,10,0,3900,6200,6200,138,124,642796,188,78,D C,1,1,3,2,3,1,3,2,2,2,1,6,7,8,6,11,7,13,8,13,12,10,6,14,11,14,12,13,12,11,8,10,11,7,10,8,14,13,16,14,13,15,14,11,12,13,20,14,15,13,7,12,6,9,10,12,12,11,14,11,8,2,20,11,1,1,13,1,20,D C,101,1,1,1,1,1,1,20,1,13,1,1,1,1,1,11,1.37439E+11,0,0,0,0,0,0,0,0,0,0,0,0,0,0,0,0,0,0,0,0,0,0,0,0,0,0,0,0,0,0,0,0,0,0,0,0,0,1,0,0,0,0,0,0,0,0,0,0,Luca Antei,£720Th. ,28,186,Defender - Centre-Back,right,Delfino Pescara 1936,18,1,0,1380,8,0,0,594,19,0,0,1606,16,0,0,1147,nan,nan,nan,nan,Serie A
19-06-17,18.3.4.28,Federico Ceccherini,43075133,776,11-May-92,25,0,0,1,0,3250,6650,6250,132,125,7270047,186,75,D C,3,3,1,2,2,4,3,3,1,2,1,6,7,9,8,11,8,13,9,10,14,10,8,14,11,12,14,14,14,12,9,12,12,10,10,12,12,13,12,13,13,12,14,9,10,12,20,14,13,13,9,12,15,11,9,12,14,12,12,13,12,3,20,1,1,1,12,8,20,D C,101,1,1,1,1,1,1,20,8,12,1,1,1,1,1,1,0,0,0,0,0,0,0,0,0,0,0,0,0,0,0,0,0,0,0,0,0,0,0,0,0,0,0,0,0,0,0,0,0,0,0,0,0,0,0,0,0,0,0,0,0,0,0,0,0,Federico Ceccherini,£2.52m ,28,187,Defender - Centre-Back,right,Hellas Verona,36,1,0,3190,38,2,1,3321,17,0,0,1162,17,0,0,1010,5,0,0,415,Serie A
19-06-17,18.3.4.28,Gian Marco Ferrari,43077074,776,15-May-92,25,0,0,0,0,4000,7000,6600,142,132,11505063,189,80,D C,3,3,2,2,1,3,1,1,2,1,2,6,7,8,8,11,6,14,9,9,15,11,7,13,12,12,12,10,11,15,9,14,14,9,12,6,14,12,12,12,11,13,15,20,14,12,8,16,16,14,9,13,4,10,16,15,14,12,15,13,14,8,20,1,1,1,1,1,20,D C,101,1,1,1,1,1,1,20,1,1,1,1,1,1,1,1,1.15292E+18,0,0,0,0,0,0,0,0,0,0,0,0,0,0,0,0,0,0,0,0,0,0,0,0,0,0,0,0,0,0,0,0,0,0,0,0,0,0,0,0,0,0,0,0,0,0,0,0,Gian Marco Ferrari,£9.00m ,28,189,Defender - Centre-Back,left,US Sassuolo,37,3,1,3330,31,2,0,2648,32,4,0,2880,24,0,2,1986,5,0,2,450,Serie A
19-06-17,18.3.4.28,Edoardo Goldaniga,43080121,776,02-Nov-93,23,0,0,2,0,4000,6400,6400,150,128,11940900,188,80,D RC,1,3,1,3,1,1,1,1,1,2,1,4,6,11,6,12,4,15,5,10,13,12,8,14,12,15,16,13,12,10,11,13,15,7,15,6,14,12,12,13,12,15,12,10,13,13,20,12,13,12,10,18,6,10,13,14,15,15,17,14,10,7,20,14,1,1,15,12,20,D RC,103,1,1,1,1,1,1,20,12,15,1,1,1,1,1,14,1.75922E+13,0,0,0,0,0,0,0,0,0,0,0,0,0,0,0,1,0,0,0,0,0,0,0,0,0,0,0,0,0,0,0,0,0,0,0,0,0,0,0,0,0,0,0,0,1,0,0,0,Edoardo Goldaniga,£2.70m ,26,193,Defender - Centre-Back,both,Genoa CFC,30,2,0,2568,14,1,0,1246,30,1,1,2700,14,1,0,900,4,0,1,291,Serie A
19-06-17,18.3.4.28,Mattia Caldara,43081382,776,05-May-94,23,0,0,12,0,4500,7200,7200,170,144,34902770,187,80,D C,3,2,2,3,1,2,1,2,1,2,1,5,6,7,13,11,3,16,7,5,17,12,8,14,10,12,14,13,10,14,7,15,14,7,12,7,15,12,12,13,12,14,14,10,16,13,20,14,13,13,6,11,6,10,19,14,11,14,17,16,12,3,20,1,1,1,9,1,20,D C,101,1,1,1,1,1,1,20,1,9,1,1,1,1,1,1,32832,0,0,0,0,0,0,1,0,0,0,0,0,0,0,0,1,0,0,0,0,0,0,0,0,0,0,0,0,0,0,0,0,0,0,0,0,0,0,0,0,0,0,0,0,0,0,0,0,Mattia Caldara,£22.50m ,26,187,Defender - Centre-Back,right,Atalanta BC,31,7,0,2745,34,3,2,2917,3,0,0,200,21,0,1,1494,1,0,0,45,Serie A
19-06-17,18.3.4.28,Daniele Rugani,43083931,776,29-Jul-94,22,3,0,19,2,5250,7400,7500,170,150,67421319,190,84,D C,3,4,3,2,2,3,2,3,1,1,1,5,8,10,10,13,5,14,7,7,16,14,6,14,12,12,16,13,14,16,12,14,14,10,12,6,16,14,15,12,13,15,14,10,15,14,20,15,14,15,4,14,2,8,13,15,14,15,16,18,20,2,20,1,1,1,8,1,20,D C,101,1,1,1,1,1,1,20,1,8,1,1,1,1,1,1,0,0,0,0,0,0,0,0,0,0,0,0,0,0,0,0,0,0,0,0,0,0,0,0,0,0,0,0,0,0,0,0,0,0,0,0,0,0,0,0,0,0,0,0,0,0,0,0,0,Daniele Rugani,£19.80m ,26,190,Defender - Centre-Back,right,Stade Rennais FC,20,3,0,1558,26,2,1,2225,20,2,0,1711,14,0,0,1047,1,0,0,90,Serie A
19-06-17,18.3.4.28,Mattia Bani,43091093,776,10-Dec-93,23,0,0,0,0,1250,5600,5750,132,115,2865546,188,81,D RC,2,1,1,2,4,2,3,3,1,1,1,8,10,9,8,11,7,12,8,10,13,11,8,14,12,10,13,12,12,12,11,12,12,8,10,11,13,14,12,12,12,11,12,8,12,12,20,14,12,12,10,13,8,12,10,13,14,12,14,15,12,8,20,15,1,1,16,1,20,D RC,103,1,1,1,1,1,1,20,1,16,1,1,1,1,1,15,0,0,0,0,0,0,0,0,0,0,0,0,0,0,0,0,0,0,0,0,0,0,0,0,0,0,0,0,0,0,0,0,0,0,0,0,0,0,0,0,0,0,0,0,0,0,0,0,0,Mattia Bani,£2.25m ,26,188,Defender - Centre-Back,right,Genoa CFC,38,0,1,3336,18,0,0,1526,31,0,0,2627,27,4,0,2211,2,0,0,159,Serie A
19-06-17,18.3.4.28,Alex Ferrari,43093049,776,01-Jul-94,22,0,0,7,0,1350,6550,6000,136,120,5496321,191,80,D/WB RC,1,3,3,2,3,2,2,3,3,1,2,10,10,13,9,11,11,14,9,9,14,12,8,13,12,11,14,12,13,11,10,12,13,12,9,10,13,11,11,13,11,12,13,6,12,13,20,13,13,11,10,10,7,11,11,12,11,12,8,8,10,8,20,16,1,1,18,1,20,D/WB RC,113,1,1,1,1,1,1,20,1,18,1,1,1,1,1,16,0,0,0,0,0,0,0,0,0,0,0,0,0,0,0,0,0,0,0,0,0,0,0,0,0,0,0,0,0,0,0,0,0,0,0,0,0,0,0,0,0,0,0,0,0,0,0,0,0,Alex Ferrari,£1.35m ,26,191,Defender - Centre-Back,right,UC Sampdoria,14,0,1,1219,27,1,0,2295,7,0,0,660,13,0,0,1050,0,0,0,0,Serie A
19-06-17,18.3.4.28,Armando Izzo,43093074,776,02-Mar-92,25,0,0,0,0,4500,6650,6800,145,136,18212265,183,78,D C,1,3,1,2,1,2,1,2,3,3,2,3,9,8,7,12,4,13,8,5,15,13,7,15,13,13,15,14,13,12,10,14,15,6,12,13,15,12,11,14,14,14,12,7,11,14,20,14,13,12,7,12,7,11,8,15,14,13,13,13,15,9,20,9,5,1,11,1,20,D C,101,1,1,1,1,1,1,20,1,11,5,5,1,1,1,9,32768,0,0,0,0,0,0,0,0,0,0,0,0,0,0,0,1,0,0,0,0,0,0,0,0,0,0,0,0,0,0,0,0,0,0,0,0,0,0,0,0,0,0,0,0,0,0,0,0,Armando Izzo,£7.65m ,28,183,Defender - Centre-Back,right,Torino FC,30,0,2,2709,16,1,0,1388,39,4,1,3432,37,3,0,3237,1,0,0,87,Serie A
19-06-17,18.3.4.28,Alessio Romagnoli,43093395,776,12-Jan-95,22,5,0,15,1,5500,7450,7450,170,149,94770756,188,78,D C,1,2,1,2,3,2,2,1,1,2,1,4,9,9,7,12,5,14,6,13,16,12,5,16,12,13,16,14,13,14,12,13,13,5,12,8,15,15,13,12,14,15,15,20,13,14,10,16,14,13,13,13,12,10,13,15,12,13,14,12,14,4,20,1,1,1,1,13,20,D C,101,1,1,1,1,1,1,20,13,1,1,1,1,1,1,1,32768,0,0,0,0,0,0,0,0,0,0,0,0,0,0,0,1,0,0,0,0,0,0,0,0,0,0,0,0,0,0,0,0,0,0,0,0,0,0,0,0,0,0,0,0,0,0,0,0,Alessio Romagnoli,£36.00m ,25,188,Defender - Centre-Back,left,AC Milan,29,1,1,2580,42,3,0,3598,41,2,0,3607,39,1,0,3482,3,0,0,270,Serie A
19-06-17,18.3.4.28,Gianluca Mancini,43093502,776,17-Apr-96,21,0,0,3,0,2500,5950,5950,152,119,5925540,190,0,D C,1,1,2,3,1,2,3,2,1,2,1,7,6,7,5,11,6,13,8,10,14,11,6,14,11,12,14,13,12,13,11,14,16,8,8,6,13,10,13,11,11,14,15,7,14,11,20,12,12,14,11,14,8,8,17,14,11,8,15,14,14,11,20,1,1,1,1,1,20,D C,101,1,1,1,1,1,1,20,1,1,14,1,1,1,1,1,0,0,0,0,0,0,0,0,0,0,0,0,0,0,0,0,0,0,0,0,0,0,0,0,0,0,0,0,0,0,0,0,0,0,0,0,0,0,0,0,0,0,0,0,0,0,0,0,0,Gianluca Mancini,£1.80m ,24,190,Defender - Centre-Back,right,AS Roma,17,1,0,1411,13,1,0,850,35,6,1,2598,41,1,1,3520,5,0,0,450,Serie A
19-06-17,18.3.4.28,Elio Capradossi,43094086,776,11-Mar-96,21,0,0,0,0,1900,5800,5800,135,116,4327339,181,78,D C,1,2,2,3,2,2,3,3,2,3,3,4,6,8,7,10,3,13,4,5,14,12,5,13,11,12,14,12,12,13,8,11,14,5,9,7,14,13,13,13,13,11,12,11,10,13,20,12,11,12,10,12,5,11,7,14,9,14,14,10,12,8,20,1,1,1,1,1,20,D C,101,1,1,1,1,1,1,20,1,1,1,1,1,1,1,1,0,0,0,0,0,0,0,0,0,0,0,0,0,0,0,0,0,0,0,0,0,0,0,0,0,0,0,0,0,0,0,0,0,0,0,0,0,0,0,0,0,0,0,0,0,0,0,0,0,Elio Capradossi,£720Th. ,24,185,Defender - Centre-Back,both,Spezia Calcio,23,0,0,1794,16,0,0,1265,20,3,0,1800,34,2,0,2920,nan,nan,nan,nan,Serie A
19-06-17,18.3.4.28,Kevin Bonifazi,43094128,776,19-May-96,21,0,0,0,0,2600,6300,6300,149,126,11414416,187,84,D RC,3,2,2,1,3,3,2,1,1,2,2,5,5,10,10,6,8,12,7,13,13,11,4,13,12,12,14,10,13,13,10,14,12,9,9,12,14,10,11,14,13,12,15,8,14,13,20,12,14,13,13,12,6,6,12,11,14,13,12,13,11,7,20,1,1,1,17,1,20,D RC,103,1,1,1,1,1,1,20,1,17,1,1,1,1,1,1,0,0,0,0,0,0,0,0,0,0,0,0,0,0,0,0,0,0,0,0,0,0,0,0,0,0,0,0,0,0,0,0,0,0,0,0,0,0,0,0,0,0,0,0,0,0,0,0,0,Kevin Bonifazi,£1.35m ,24,187,Defender - Centre-Back,right,Udinese Calcio,20,3,0,1648,7,0,0,497,28,2,0,2393,21,3,0,1753,1,0,0,8,Serie A
19-06-17,18.3.4.28,Davide Biraschi,43094277,776,02-Jul-94,22,0,0,3,0,3250,5900,5900,135,118,4653547,182,73,D RC,4,2,2,1,1,2,1,3,1,1,4,5,7,5,5,7,7,15,4,8,14,10,7,14,9,14,14,13,12,11,9,11,12,1,10,11,13,14,14,13,12,12,11,6,11,12,20,13,17,11,14,11,8,8,8,11,11,10,13,9,13,7,20,11,1,1,15,8,20,D RC,103,1,1,1,1,1,1,20,8,15,12,1,1,1,1,11,32768,0,0,0,0,0,0,0,0,0,0,0,0,0,0,0,1,0,0,0,0,0,0,0,0,0,0,0,0,0,0,0,0,0,0,0,0,0,0,0,0,0,0,0,0,0,0,0,0,Davide Biraschi,£1.08m ,26,182,Defender - Centre-Back,right,Genoa CFC,10,0,0,646,26,0,1,2046,36,0,2,3053,26,0,1,2181,2,0,0,180,Serie A
19-06-17,18.3.4.28,Stefan Simic,43096729,763,20-Jan-95,22,0,0,10,0,5500,5500,5500,135,110,1559499,187,82,D C,1,2,2,2,3,2,2,3,1,2,1,8,8,8,8,8,7,12,7,9,13,10,10,13,10,12,12,13,12,12,9,11,13,11,11,7,12,14,14,13,12,13,14,6,14,13,20,12,12,14,13,12,14,12,15,13,8,12,14,13,12,7,20,11,1,1,14,1,20,D C,101,1,1,1,1,1,1,20,1,14,8,1,1,1,1,11,0,0,0,0,0,0,0,0,0,0,0,0,0,0,0,0,0,0,0,0,0,0,0,0,0,0,0,0,0,0,0,0,0,0,0,0,0,0,0,0,0,0,0,0,0,0,0,0,0,Stefan Simic,£540Th. ,25,189,Defender - Centre-Back,right,HNK Hajduk Split,32,2,0,2828,10,0,0,641,5,0,0,450,18,1,0,1501,nan,nan,nan,nan,Serie A
19-06-17,18.3.4.28,Francesco Vicari,43115048,776,03-Aug-94,22,0,0,1,0,2250,6000,6000,140,120,1704285,190,80,D C,2,3,2,3,3,3,3,3,1,3,1,4,4,5,6,10,5,14,6,7,15,9,6,13,7,8,12,11,11,12,6,12,13,5,12,5,13,12,10,11,12,11,16,8,15,14,20,15,15,12,7,15,8,5,13,11,10,9,13,11,13,3,20,1,1,1,1,1,20,D C,101,1,1,1,1,1,1,20,1,1,1,1,1,1,1,1,0,0,0,0,0,0,0,0,0,0,0,0,0,0,0,0,0,0,0,0,0,0,0,0,0,0,0,0,0,0,0,0,0,0,0,0,0,0,0,0,0,0,0,0,0,0,0,0,0,Francesco Vicari,£1.80m ,26,190,Defender - Centre-Back,right,SPAL,34,1,1,2776,35,1,1,2951,29,2,1,2383,37,0,0,3171,5,0,0,450,Serie A
19-06-17,18.3.4.28,Filippo Romagna,43152269,776,26-May-97,20,0,0,0,0,1450,6000,6200,135,124,13048778,185,75,D C,3,3,1,4,3,3,3,3,1,3,3,6,5,5,9,7,3,12,5,12,13,11,9,14,10,11,14,12,14,14,12,14,11,10,12,9,14,13,14,12,11,12,13,9,9,12,20,13,12,11,10,12,6,16,7,10,11,10,12,11,14,2,20,1,5,1,1,1,20,D C,101,1,1,1,1,1,1,20,1,1,12,5,1,1,1,1,0,0,0,0,0,0,0,0,0,0,0,0,0,0,0,0,0,0,0,0,0,0,0,0,0,0,0,0,0,0,0,0,0,0,0,0,0,0,0,0,0,0,0,0,0,0,0,0,0,Filippo Romagna,£6.30m ,23,186,Defender - Centre-Back,right,US Sassuolo,20,0,0,1537,24,0,0,2007,21,0,0,1743,18,0,0,1476,nan,nan,nan,nan,Serie A
19-06-17,18.3.4.28,Rolando Mandragora,43159580,776,29-Jun-97,19,0,0,10,0,3500,6000,6350,150,126,6317111,183,76,D/DM/M C,3,2,1,3,3,3,2,1,3,3,2,10,10,10,7,14,12,7,10,3,13,14,11,14,13,10,14,13,11,13,14,12,13,11,15,14,14,11,13,11,12,14,10,20,11,13,9,14,13,16,5,16,10,15,14,11,10,11,12,13,11,8,16,1,19,1,1,1,19,D/DM/M C,331,1,11,1,1,1,1,16,1,1,20,19,1,1,1,1,4194304,0,0,0,0,0,0,0,0,0,0,0,0,0,0,0,0,0,0,0,0,0,0,1,0,0,0,0,0,0,0,0,0,0,0,0,0,0,0,0,0,0,0,0,0,0,0,0,0,Rolando Mandragora,£9.00m ,23,183,Midfielder - Defensive Midfield,left,Udinese Calcio,3,0,0,139,37,2,1,3259,36,3,1,3042,28,3,3,2224,nan,nan,nan,nan,Serie A
19-06-17,18.3.4.28,Bright Gyamfi,43207789,21,20-Jan-96,21,0,0,0,0,1600,5650,5650,138,113,2293757,178,0,D/WB RC,3,3,1,3,1,1,2,3,2,2,2,7,13,11,9,11,9,9,9,13,12,12,9,12,10,13,12,11,12,13,10,11,11,12,9,13,11,11,11,14,12,11,9,10,12,13,20,11,13,12,10,11,10,11,12,10,10,9,11,10,10,10,20,18,7,1,20,10,15,D/WB RC,113,1,1,1,1,1,1,15,10,20,7,7,1,1,1,18,0,0,0,0,0,0,0,0,0,0,0,0,0,0,0,0,0,0,0,0,0,0,0,0,0,0,0,0,0,0,0,0,0,0,0,0,0,0,0,0,0,0,0,0,0,0,0,0,0,Bright Gyamfi,£360Th. ,24,178,Defender - Right-Back,right,AC Reggiana 1919,23,0,1,1258,9,0,0,318,10,0,0,836,4,0,0,326,5,0,0,375,Serie A
19-06-17,18.3.4.28,Alessandro Bastoni,43252460,776,13-Apr-99,18,0,0,0,0,1500,5400,5400,159,108,1944189,190,75,D C,1,2,1,1,1,1,2,2,3,3,2,5,5,7,10,8,5,13,5,5,12,9,8,11,9,13,13,12,13,13,5,12,14,6,10,7,13,12,12,10,10,12,16,20,13,12,9,12,13,15,5,15,4,12,17,13,12,13,15,16,11,5,20,1,1,1,8,14,20,D C,101,1,1,1,1,1,1,20,14,8,8,1,1,1,1,1,0,0,0,0,0,0,0,0,0,0,0,0,0,0,0,0,0,0,0,0,0,0,0,0,0,0,0,0,0,0,0,0,0,0,0,0,0,0,0,0,0,0,0,0,0,0,0,0,0,Alessandro Bastoni,£2.25m ,21,190,Defender - Centre-Back,left,Inter Milan,20,5,0,1654,16,1,0,1167,24,1,0,1684,33,2,1,2560,4,0,1,281,Serie A
19-06-17,18.3.4.28,Vlad Chiriches,57024540,790,14-Nov-89,27,47,0,3,0,5450,7250,7000,146,140,19976523,184,75,D C,3,1,1,3,2,1,3,3,1,2,3,5,11,11,9,13,8,14,7,7,14,12,10,15,11,11,15,13,15,14,13,13,15,14,14,8,14,14,14,11,11,14,13,14,16,13,20,14,14,14,6,17,3,11,16,14,13,13,15,14,10,3,20,1,1,1,14,1,20,D C,101,1,14,1,1,1,1,20,1,14,1,1,1,1,1,1,1.15292E+18,0,0,0,0,0,0,0,0,0,0,0,0,0,0,0,1,0,0,0,0,0,0,0,0,0,0,0,0,0,0,0,0,0,0,0,0,0,0,0,0,0,0,0,0,0,0,0,0,Vlad Chiriches,£4.50m ,30,184,Defender - Centre-Back,right,US Sassuolo,16,2,0,1304,9,0,0,763,6,0,0,372,9,0,0,708,5,1,1,382,Serie A
19-06-17,18.3.4.28,Alin Tosca,57030125,790,14-Mar-92,25,7,0,10,0,4500,6250,6000,135,120,241343,181,81,D LC,3,3,1,1,2,2,3,3,1,3,2,8,10,10,7,11,5,11,6,12,13,13,9,13,11,12,12,13,12,13,12,12,18,5,11,12,13,12,13,12,12,13,13,20,13,12,10,14,13,13,9,13,5,13,14,15,12,10,16,14,14,5,20,14,1,1,1,20,18,D LC,104,1,1,1,1,1,1,18,20,1,1,1,1,1,14,1,0,0,0,0,0,0,0,0,0,0,0,0,0,0,0,0,0,0,0,0,0,0,0,0,0,0,0,0,0,0,0,0,0,0,0,0,0,0,0,0,0,0,0,0,0,0,0,0,0,Alin Tosca,£1.35m ,28,181,Defender - Centre-Back,left,Gaziantep FK,46,0,0,3965,21,0,0,1773,16,0,2,1196,36,0,0,3240,5,0,0,444,Serie A
19-06-17,18.3.4.28,Deian Boldor,57086160,790,03-Feb-95,22,0,0,9,1,3000,5150,5500,135,110,1559499,189,84,D C,1,1,1,4,1,3,1,1,1,3,2,3,6,5,5,7,3,14,6,9,14,10,5,14,10,12,10,11,9,10,7,12,10,5,9,7,13,12,13,11,12,12,14,20,12,13,7,13,15,12,4,9,11,11,12,11,12,10,12,12,9,2,20,1,1,1,1,1,20,D C,101,1,1,1,1,1,1,20,1,1,1,1,1,1,1,1,0,0,0,0,0,0,0,0,0,0,0,0,0,0,0,0,0,0,0,0,0,0,0,0,0,0,0,0,0,0,0,0,0,0,0,0,0,0,0,0,0,0,0,0,0,0,0,0,0,Deian Boldor,£180Th. ,25,189,Defender - Centre-Back,left,Potenza Calcio,15,1,0,1178,1,0,0,90,5,0,0,204,25,0,1,2044,6,0,0,540,Serie A
19-06-17,18.3.4.28,Aleksandar Kolarov,5743340,802,10-Nov-85,31,68,8,11,1,6250,7500,7300,150,146,232186002,187,83,D/WB LC,1,2,2,3,1,3,2,1,1,2,3,16,17,13,12,14,17,17,15,11,13,14,12,13,15,14,15,13,15,12,13,13,13,12,13,14,13,12,12,12,13,15,15,20,15,12,8,14,15,11,13,13,13,12,14,14,13,15,11,12,12,14,20,18,14,1,1,20,16,D/WB LC,114,1,1,1,1,1,1,16,20,1,1,12,14,1,18,1,2.30584E+18,0,0,0,0,0,1,0,0,1,1,0,0,0,0,0,0,0,0,0,0,0,0,0,0,0,0,0,0,0,0,0,0,0,0,1,0,1,0,0,0,0,0,0,0,0,0,0,0,Aleksandar Kolarov,£10.80m ,34,187,Defender - Left-Back,left,Inter Milan,40,1,3,3480,47,3,13,4141,43,9,2,3747,42,7,5,3501,5,0,0,370,Serie A
19-06-17,18.3.4.28,Nenad Tomovic,5768029,802,30-Aug-87,29,22,0,9,1,5100,6350,6700,145,134,15509107,184,79,D/WB RC,3,2,3,2,1,3,2,3,1,1,2,6,11,10,8,12,7,13,8,12,14,12,8,13,11,16,12,15,13,10,11,13,14,10,11,10,15,15,14,14,13,13,11,9,15,14,20,14,15,14,14,13,7,13,13,13,14,12,13,12,15,6,20,17,5,1,19,10,20,D/WB RC,113,1,1,1,1,1,1,20,10,19,1,1,1,5,1,17,0,0,0,0,0,0,0,0,0,0,0,0,0,0,0,0,0,0,0,0,0,0,0,0,0,0,0,0,0,0,0,0,0,0,0,0,0,0,0,0,0,0,0,0,0,0,0,0,0,Nenad Tomović,£1.35m ,33,184,Defender - Centre-Back,right,SPAL,35,0,1,2559,29,0,0,2437,11,1,0,831,25,0,1,1911,6,0,1,524,Serie A
19-06-17,18.3.4.28,Jagos Vukovic,5788642,802,10-Jun-88,29,6,0,8,1,4250,6500,6250,130,125,3846630,195,93,D C,1,2,1,1,2,1,2,1,1,2,1,7,10,10,6,11,10,15,11,12,14,10,14,13,13,14,11,14,15,12,10,11,17,10,13,13,12,11,11,12,11,12,16,20,13,12,10,11,14,10,12,11,10,8,11,16,16,12,14,15,14,10,20,1,1,1,1,10,20,D C,101,1,1,1,1,1,1,20,10,1,10,1,1,1,1,1,0,0,0,0,0,0,0,0,0,0,0,0,0,0,0,0,0,0,0,0,0,0,0,0,0,0,0,0,0,0,0,0,0,0,0,0,0,0,0,0,0,0,0,0,0,0,0,0,0,Jagos Vukovic,£1.80m ,32,195,Defender - Centre-Back,left,Qingdao Huanghai,36,5,1,3133,20,1,1,1669,28,3,1,2431,15,1,1,1350,nan,nan,nan,nan,Serie A
19-06-17,18.3.4.28,Ervin Zukanovic,5797979,759,11-Feb-87,30,21,0,0,0,4750,7250,6700,141,134,12481848,190,85,D LC,2,3,1,1,4,1,1,3,2,2,4,9,11,9,8,10,13,16,12,13,15,12,9,15,10,5,14,13,12,12,10,13,16,9,13,9,14,14,15,9,9,15,16,20,14,13,8,14,15,16,8,10,3,5,14,12,12,14,14,12,14,4,20,15,8,1,1,16,20,D LC,104,1,1,1,1,1,1,20,16,1,1,1,8,1,15,1,17179869184,0,0,0,0,0,0,0,0,0,0,0,0,0,0,0,0,0,0,0,0,0,0,0,0,0,0,0,0,0,0,0,0,0,0,1,0,0,0,0,0,0,0,0,0,0,0,0,0,Ervin Zukanovic,£1.80m ,33,188,Defender - Centre-Back,left,Fatih Karagümrük,19,0,0,1380,31,0,1,2783,27,0,0,2168,6,0,0,473,6,2,1,540,Serie A
19-06-17,18.3.4.28,Andrea Barzagli,6100324,776,08-May-81,36,68,0,15,0,6900,8300,7900,167,158,232186002,187,87,D RC,3,2,2,3,2,1,2,3,1,1,1,2,2,8,3,11,2,14,3,3,20,12,10,16,11,8,18,14,16,19,11,18,18,3,12,5,19,17,14,8,8,18,14,9,10,9,20,11,15,20,3,12,14,5,9,19,15,17,18,18,20,7,20,1,1,1,15,1,20,D RC,103,1,11,1,1,1,1,20,1,15,1,1,1,1,1,1,8589934656,0,0,0,0,0,0,1,0,0,0,0,0,0,0,0,0,0,0,0,0,0,0,0,0,0,0,0,0,0,0,0,0,0,1,0,0,0,0,0,0,0,0,0,0,0,0,0,0,Andrea Barzagli,£900Th. ,39,187,Defender - Centre-Back,right,Retired,39,0,0,2618,38,0,1,2372,10,0,0,367,nan,nan,nan,nan,nan,nan,nan,nan,Serie A
19-06-17,18.3.4.28,Nikola Milenkovic,62191195,802,12-Oct-97,19,1,0,1,0,4000,6100,5750,141,117,5120628,195,91,D C,3,2,1,3,1,2,3,2,2,2,1,5,5,6,6,11,6,14,7,9,14,10,9,13,10,15,11,15,12,11,8,9,11,7,11,10,14,10,12,10,13,14,15,10,16,11,20,15,15,13,11,12,13,9,11,11,11,12,10,10,10,12,20,1,1,1,1,1,20,D C,101,1,1,1,1,1,1,20,1,1,1,1,1,1,1,1,0,0,0,0,0,0,0,0,0,0,0,0,0,0,0,0,0,0,0,0,0,0,0,0,0,0,0,0,0,0,0,0,0,0,0,0,0,0,0,0,0,0,0,0,0,0,0,0,0,Nikola Milenkovic,£8.10m ,23,195,Defender - Centre-Back,right,ACF Fiorentina,40,3,1,3630,17,0,0,1345,38,3,0,3370,41,5,0,3617,5,1,1,450,Serie A
19-06-17,18.3.4.28,Nicolás Burdisso,6300458,1649,12-Apr-81,36,49,2,30,3,5500,6550,6550,155,131,232186002,182,81,D C,1,1,1,1,1,1,1,1,1,1,1,3,7,4,5,9,3,16,7,5,16,9,8,14,10,17,16,18,10,11,9,11,19,5,18,9,14,18,18,11,12,16,13,9,15,11,20,13,14,15,17,17,10,16,18,13,16,10,16,15,16,8,20,1,1,1,9,9,20,D C,101,1,10,1,1,1,1,20,9,9,4,1,1,1,1,1,2.19902E+12,0,0,0,0,0,0,0,0,0,0,0,0,0,0,0,1,0,1,0,0,0,0,0,0,0,0,0,0,0,0,0,0,0,0,0,0,0,0,0,0,0,1,0,0,0,0,0,0,Nicolás Burdisso,£270Th. ,39,183,Defender - Centre-Back,right,Retired,38,0,0,3427,25,0,0,2157,nan,nan,nan,nan,nan,nan,nan,nan,nan,nan,nan,nan,Serie A
19-06-17,18.3.4.28,Milan Skriniar,63013145,794,11-Feb-95,22,9,0,20,3,4250,6900,7300,163,146,85611391,188,80,D C,1,3,1,3,4,1,3,2,3,2,1,5,8,10,10,12,7,15,8,11,16,12,9,14,11,13,15,15,12,11,10,12,16,6,13,10,16,12,14,13,13,14,15,9,12,14,20,16,15,14,10,8,8,10,10,15,11,13,16,12,8,8,20,1,9,1,1,9,20,D C,101,1,1,1,1,1,1,20,9,1,12,9,1,1,1,1,0,0,0,0,0,0,0,0,0,0,0,0,0,0,0,0,0,0,0,0,0,0,0,0,0,0,0,0,0,0,0,0,0,0,0,0,0,0,0,0,0,0,0,0,0,0,0,0,0,Milan Skriniar,£40.50m ,25,188,Defender - Centre-Back,right,Inter Milan,35,0,0,2998,40,4,0,3660,46,0,2,4157,42,0,2,3399,2,0,0,169,Serie A
19-06-17,18.3.4.28,Bostjan Cesar,652520,795,09-Jul-82,34,96,10,15,1,5465,7386,6400,141,126,669479,191,89,D C,1,2,3,1,2,1,3,3,3,1,2,5,8,7,5,10,5,15,9,10,15,12,7,15,10,15,14,13,13,15,6,14,16,6,15,5,14,14,13,9,8,15,15,20,13,10,9,13,14,14,15,13,11,11,14,12,13,13,16,15,13,8,20,1,1,1,1,12,20,D C,101,1,13,1,1,1,1,20,12,1,1,1,1,1,1,1,1.37439E+11,0,0,0,0,0,0,0,0,0,0,0,0,0,0,0,1,0,1,0,0,0,0,0,0,0,0,0,0,0,0,0,0,0,0,0,0,0,1,0,0,0,0,0,0,0,0,0,0,Bostjan Cesar,£180Th. ,38,191,Defender - Centre-Back,left,Retired,20,2,0,1707,10,0,0,544,15,1,0,1166,21,0,1,1890,nan,nan,nan,nan,Serie A
19-06-17,18.3.4.28,Patric,67100019,796,17-Apr-93,24,0,0,0,0,4500,6600,6500,140,130,10225423,184,74,D/WB RLC,1,1,1,1,3,2,3,3,1,2,2,12,12,10,7,11,10,12,10,8,12,12,11,13,10,18,13,16,10,11,10,11,16,7,11,15,12,17,18,13,12,13,10,9,15,13,20,14,13,16,13,12,8,16,14,14,12,8,16,16,16,2,20,16,14,9,20,17,17,D/WB RLC,116,1,1,1,1,1,9,17,17,20,9,7,14,14,16,16,0,0,0,0,0,0,0,0,0,0,0,0,0,0,0,0,0,0,0,0,0,0,0,0,0,0,0,0,0,0,0,0,0,0,0,0,0,0,0,0,0,0,0,0,0,0,0,0,0,Patric,£1.62m ,27,184,Defender - Centre-Back,right,SS Lazio,21,0,2,1187,21,0,1,1267,17,0,0,1224,24,1,0,1795,6,0,0,540,Serie A
19-06-17,18.3.4.28,Filip Helander,68014240,797,22-Apr-93,24,2,0,19,0,3750,6000,6000,132,120,4899821,192,84,D C,2,2,3,2,1,3,1,3,1,3,4,5,7,6,5,11,3,15,7,7,13,12,4,15,12,12,13,12,13,12,8,13,14,5,12,4,14,13,13,11,8,14,15,20,13,12,8,12,15,14,8,10,9,5,19,12,14,14,16,17,18,3,20,1,1,1,1,1,20,D C,101,1,1,1,1,1,1,20,1,1,1,1,1,1,1,1,0,0,0,0,0,0,0,0,0,0,0,0,0,0,0,0,0,0,0,0,0,0,0,0,0,0,0,0,0,0,0,0,0,0,0,0,0,0,0,0,0,0,0,0,0,0,0,0,0,Filip Helander,£2.25m ,27,192,Defender - Centre-Back,left,Rangers FC,13,1,0,1013,29,0,0,2499,23,0,0,1982,18,2,1,1614,11,1,0,914,Serie A
19-06-17,18.3.4.28,Dario Dainelli,704180,776,09-Jun-79,38,1,0,1,0,5500,6500,6450,146,129,232186002,191,78,D C,2,3,2,4,3,2,3,1,3,3,3,3,5,7,9,9,3,15,2,8,15,11,9,15,11,15,15,15,13,14,7,15,17,6,17,8,16,15,11,9,8,14,15,9,14,9,20,11,14,15,12,15,8,7,11,13,16,13,17,14,15,2,20,1,1,1,1,3,20,D C,101,1,1,1,1,1,1,20,3,1,1,1,1,1,1,1,8.79609E+12,0,0,0,0,0,0,0,0,0,0,0,0,0,0,0,0,0,0,0,0,0,0,0,0,0,0,0,0,0,0,0,0,0,0,0,0,0,0,0,0,0,0,0,1,0,0,0,0,Dario Dainelli,£270Th. ,41,191,Defender - Centre-Back,right,Retired,27,0,0,2280,23,0,0,1641,18,0,0,1424,nan,nan,nan,nan,nan,nan,nan,nan,Serie A
19-06-17,18.3.4.28,Raúl Albiol,7452450,796,04-Sep-85,31,51,0,8,0,6000,7000,7400,156,148,232186002,190,82,D C,3,2,1,3,1,4,2,1,2,4,3,7,10,8,9,12,8,14,11,12,15,12,9,15,12,13,15,16,13,13,12,13,13,6,14,9,15,17,16,11,12,16,15,10,14,14,20,16,15,15,13,16,8,13,16,14,14,13,14,12,7,6,20,1,1,1,10,1,20,D C,101,1,9,1,1,1,1,20,1,10,10,1,1,1,1,1,1.15292E+18,0,0,0,0,0,0,0,0,0,0,0,0,0,0,0,1,0,0,0,0,0,0,0,0,0,0,0,0,0,0,0,0,0,0,0,0,0,0,0,0,0,0,0,0,0,0,0,0,Raúl Albiol,£7.20m ,35,190,Defender - Centre-Back,right,Villarreal CF,35,0,1,3028,39,3,2,3462,26,1,0,2207,38,1,0,3448,8,0,0,702,Serie A
19-06-17,18.3.4.28,Stefan Radu,7545224,790,22-Oct-86,30,14,0,13,1,5400,7100,7100,149,142,31156399,183,79,D LC,1,1,2,3,1,4,2,3,1,1,3,3,12,9,8,11,3,15,11,3,15,12,10,16,13,18,17,15,14,13,12,13,17,8,16,11,14,16,14,13,12,15,12,20,16,13,9,13,14,13,10,14,14,13,19,14,17,12,19,9,8,6,20,11,8,1,1,20,19,D LC,104,1,1,1,1,1,1,19,20,1,1,1,8,1,11,1,2.19902E+12,0,0,0,0,0,0,0,0,0,0,0,0,0,0,0,0,0,0,0,0,0,0,0,0,0,0,0,0,0,0,0,0,0,0,0,0,0,0,0,0,0,1,0,0,0,0,0,0,Stefan Radu,£5.40m ,34,183,Defender - Centre-Back,left,SS Lazio,31,2,1,2560,41,0,2,3528,33,0,1,2698,31,1,0,2474,3,0,0,163,Serie A
19-06-17,18.3.4.28,Jherson Vergara,76016537,1653,26-May-94,23,0,0,18,3,2750,5350,5350,128,107,687468,190,83,D C,2,2,1,1,1,3,1,4,3,3,3,7,8,11,5,10,5,12,6,14,12,11,7,13,10,14,12,13,13,11,6,11,13,6,10,11,12,11,12,11,11,12,14,8,14,12,20,13,13,13,12,8,9,11,14,12,12,11,14,11,12,9,20,1,1,1,1,1,20,D C,101,1,1,1,1,1,1,20,1,1,1,1,1,1,1,1,0,0,0,0,0,0,0,0,0,0,0,0,0,0,0,0,0,0,0,0,0,0,0,0,0,0,0,0,0,0,0,0,0,0,0,0,0,0,0,0,0,0,0,0,0,0,0,0,0,Jherson Vergara,£360Th. ,26,190,Defender - Centre-Back,right,Without Club,18,0,0,1519,nan,nan,nan,nan,3,0,0,270,0,0,0,0,nan,nan,nan,nan,Serie A
19-06-17,18.3.4.28,Martín Cáceres,78010878,1657,07-Apr-87,30,69,3,11,0,5931,7958,6800,155,138,16734565,180,78,D/WB RC,3,3,3,3,3,2,3,1,1,1,3,3,10,10,7,11,2,14,9,12,13,10,5,15,11,16,14,18,13,14,9,12,15,10,11,11,15,14,15,11,13,16,13,12,6,11,20,15,15,14,12,14,17,16,17,12,12,13,10,13,12,5,20,17,8,1,20,13,18,D/WB RC,113,1,1,1,1,1,1,18,13,20,1,1,1,8,8,17,1.37439E+11,0,0,0,0,0,0,0,0,0,0,0,0,0,0,0,0,0,0,0,0,0,0,0,0,0,0,0,0,0,0,0,0,0,0,0,0,0,1,0,0,0,0,0,0,0,0,0,0,Martín Cáceres,£2.25m ,33,180,Defender - Centre-Back,right,ACF Fiorentina,4,0,0,360,25,4,1,2001,17,0,0,1278,30,2,0,2480,5,0,0,450,Serie A
19-06-17,18.3.4.28,Mauricio Lemos,78066681,1657,28-Dec-95,21,0,0,13,0,5750,6750,6750,152,132,7505191,186,80,D C,1,1,2,2,2,4,2,3,2,2,3,7,7,11,9,11,16,14,13,10,14,13,7,14,13,13,12,15,11,11,11,12,13,11,12,9,12,12,13,13,13,12,14,10,14,14,20,14,14,9,12,8,7,14,13,14,9,10,9,10,10,11,20,1,10,1,1,7,20,D C,101,1,1,1,1,1,1,20,7,1,14,10,1,1,1,1,2.10453E+11,0,0,0,0,0,0,0,0,0,0,0,0,0,0,0,0,0,0,0,0,0,0,0,0,0,0,0,0,0,0,0,0,1,0,0,0,1,1,0,0,0,0,0,0,0,0,0,0,Mauricio Lemos,£4.95m ,24,187,Defender - Centre-Back,right,Fenerbahce SK,26,5,0,1975,26,1,0,2142,5,0,0,360,27,1,0,2171,4,0,0,355,Serie A
19-06-17,18.3.4.28,Gustavo Gómez,79010306,1655,06-May-93,24,21,2,15,1,4833,5597,6500,144,133,4952575,185,85,D C,3,3,2,1,2,2,2,2,1,1,1,4,6,7,5,8,4,15,6,12,15,10,5,16,9,18,14,16,14,13,6,12,14,5,13,8,13,14,16,13,11,14,13,8,16,15,20,14,16,14,16,10,7,4,13,14,15,11,13,12,8,6,20,1,1,1,1,1,20,D C,101,1,12,1,1,1,1,20,1,1,7,1,1,1,1,1,1.37439E+11,0,0,0,0,0,0,0,0,0,0,0,0,0,0,0,0,0,0,0,0,0,0,0,0,0,0,0,0,0,0,0,0,0,0,0,0,0,1,0,0,0,0,0,0,0,0,0,0,Gustavo Gómez,£3.60m ,27,185,Defender - Centre-Back,right,Sociedade Esportiva Palmeiras,19,0,0,1170,18,3,0,1386,32,4,0,2854,27,2,1,2388,nan,nan,nan,nan,Serie A
19-06-17,18.3.4.28,Luca Rossettini,7980318,776,09-May-85,32,0,0,1,0,4000,6550,6550,137,131,232186002,187,82,D RC,3,1,1,2,3,2,4,2,2,3,1,7,11,6,5,10,7,13,8,13,14,12,7,13,10,13,13,12,13,13,11,13,10,9,11,11,13,12,13,14,12,13,14,10,16,15,20,13,14,13,12,12,8,13,10,9,14,11,11,12,12,6,20,15,1,1,16,1,20,D RC,103,1,10,1,1,1,1,20,1,16,1,1,1,1,1,15,0,0,0,0,0,0,0,0,0,0,0,0,0,0,0,0,0,0,0,0,0,0,0,0,0,0,0,0,0,0,0,0,0,0,0,0,0,0,0,0,0,0,0,0,0,0,0,0,0,Luca Rossettini,£1.26m ,35,187,Defender - Centre-Back,right,US Lecce,31,1,0,2774,25,0,0,2206,23,0,0,2002,27,0,2,2351,1,0,0,90,Serie A
19-06-17,18.3.4.28,Davide Astori,7983992,776,07-Jan-87,30,13,1,0,0,5400,7100,7100,148,142,232186002,188,80,D C,1,3,3,2,3,3,1,1,3,1,3,6,8,9,8,11,7,13,5,13,15,12,5,14,11,14,15,15,13,12,11,12,14,8,12,8,16,15,14,13,13,15,15,20,12,14,8,16,15,14,12,13,9,11,12,14,13,12,14,14,13,6,20,1,1,1,1,1,20,D C,101,1,1,1,1,1,1,20,1,1,1,1,1,1,1,1,8.81327E+12,0,0,0,0,0,0,0,0,0,0,0,0,0,0,0,1,0,0,0,0,0,0,0,0,0,0,0,0,0,0,0,0,0,0,1,0,0,0,0,0,0,0,0,1,0,0,0,0,Davide Astori,- ,nan,189,Defender - Centre-Back,left,---,40,2,2,3598,27,1,1,2408,nan,nan,nan,nan,nan,nan,nan,nan,nan,nan,nan,nan,Serie A
19-06-17,18.3.4.28,Andrea Masiello,7984549,776,05-Feb-86,31,0,0,0,0,4000,6550,6900,138,138,232186002,184,82,D RC,2,1,1,3,3,2,3,4,2,3,3,3,8,7,6,11,4,14,7,7,15,10,4,14,11,13,16,13,14,15,7,14,16,5,12,7,15,14,13,13,14,13,12,10,14,13,20,13,14,14,8,14,7,10,13,15,13,15,15,13,16,7,20,10,1,1,18,1,20,D RC,103,1,13,1,1,1,1,20,1,18,1,1,1,1,1,10,32768,0,0,0,0,0,0,0,0,0,0,0,0,0,0,0,1,0,0,0,0,0,0,0,0,0,0,0,0,0,0,0,0,0,0,0,0,0,0,0,0,0,0,0,0,0,0,0,0,Andrea Masiello,£2.70m ,34,184,Defender - Centre-Back,right,Genoa CFC,38,3,0,3137,41,5,0,3565,33,1,3,2593,27,0,1,2149,2,0,0,180,Serie A
19-06-17,18.3.4.28,Marco Andreolli,7984570,776,10-Jun-86,31,0,0,22,0,5000,6500,6550,140,131,232186002,187,81,D C,2,1,2,2,2,2,2,3,3,2,1,5,8,8,8,10,8,13,9,14,14,11,6,14,9,11,13,13,12,14,8,14,12,5,12,8,14,14,14,13,12,14,14,8,15,13,20,13,14,13,13,10,13,13,14,13,14,12,14,13,12,10,20,1,1,1,1,1,20,D C,101,1,1,1,1,1,1,20,1,1,1,1,1,1,1,1,0,0,0,0,0,0,0,0,0,0,0,0,0,0,0,0,0,0,0,0,0,0,0,0,0,0,0,0,0,0,0,0,0,0,0,0,0,0,0,0,0,0,0,0,0,0,0,0,0,Marco Andreolli,£1.08m ,34,187,Defender - Centre-Back,right,Without Club,9,1,0,559,24,0,0,1947,12,0,0,841,nan,nan,nan,nan,nan,nan,nan,nan,Serie A
19-06-17,18.3.4.28,Andrea Ranocchia,7988517,776,16-Feb-88,29,21,0,13,1,5500,6550,6750,150,135,14098292,195,81,D C,2,2,3,2,3,1,2,2,3,3,1,5,6,8,9,11,5,18,7,10,15,12,8,15,10,14,13,16,11,9,11,11,14,6,14,8,13,16,14,12,11,17,18,9,12,12,20,12,14,10,14,14,10,7,14,13,13,9,15,12,13,5,20,1,1,1,1,1,20,D C,101,1,1,1,1,1,1,20,1,1,1,1,1,1,1,1,0,0,0,0,0,0,0,0,0,0,0,0,0,0,0,0,0,0,0,0,0,0,0,0,0,0,0,0,0,0,0,0,0,0,0,0,0,0,0,0,0,0,0,0,0,0,0,0,0,Andrea Ranocchia,£4.50m ,32,195,Defender - Centre-Back,right,Inter Milan,25,2,2,2056,13,2,0,866,7,1,0,296,12,1,0,887,1,0,1,90,Serie A
19-06-17,18.3.4.28,Fabrizio Cacciatore,7988563,776,08-Oct-86,30,0,0,0,0,4000,6400,6650,133,133,232186002,182,85,D/WB RLC,3,1,1,1,3,3,3,3,3,2,2,7,12,10,8,8,7,13,8,14,13,12,9,14,8,16,13,14,8,14,8,13,14,11,13,8,15,14,16,13,12,13,12,11,13,14,20,15,13,15,10,15,7,14,16,12,11,15,12,12,17,7,20,19,1,1,20,16,15,D/WB RLC,116,1,1,1,1,1,1,15,16,20,1,1,1,1,15,19,131074,0,1,0,0,0,0,0,0,0,0,0,0,0,0,0,0,0,1,0,0,0,0,0,0,0,0,0,0,0,0,0,0,0,0,0,0,0,0,0,0,0,0,0,0,0,0,0,0,Fabrizio Cacciatore,£1.08m ,34,182,Defender - Right-Back,right,Without Club,31,1,1,2689,35,3,3,3080,16,0,2,1257,17,0,0,1245,nan,nan,nan,nan,Serie A
19-06-17,18.3.4.28,Andrea Costa,7989243,776,01-Feb-86,31,0,0,0,0,3500,5900,5900,130,118,1063442,182,73,D LC,2,3,3,1,3,1,2,3,2,3,2,5,10,7,6,11,4,15,5,12,14,9,6,14,9,14,12,12,11,11,10,12,12,6,10,9,13,14,13,12,12,12,12,20,13,14,8,14,13,15,15,9,8,11,9,14,15,14,15,12,12,4,20,1,1,1,1,15,20,D LC,104,1,1,1,1,1,1,20,15,1,1,1,1,1,1,1,8.93353E+12,0,0,0,0,0,0,0,0,0,0,0,0,0,0,0,0,0,0,0,0,0,0,0,0,0,0,0,0,0,0,0,0,0,0,0,0,0,1,0,0,0,0,0,1,0,0,0,0,Andrea Costa,£630Th. ,34,182,Defender - Centre-Back,left,AC Reggiana 1919,27,2,1,2205,16,0,0,1376,7,0,0,537,16,0,0,1251,nan,nan,nan,nan,Serie A
19-06-17,18.3.4.28,Fabio Pisacane,7990939,776,28-Jan-86,31,0,0,0,0,3250,6250,6250,134,125,232186002,178,77,D/WB RLC,3,1,3,2,1,2,1,1,2,3,3,5,9,7,6,10,6,12,7,11,14,11,6,14,9,12,14,13,12,13,10,13,12,7,11,11,14,12,14,13,13,12,10,9,14,12,20,13,11,12,8,11,7,13,12,16,10,11,14,14,12,5,20,16,1,1,20,15,19,D/WB RLC,116,1,1,1,1,1,1,19,15,20,1,1,1,1,13,16,2,0,1,0,0,0,0,0,0,0,0,0,0,0,0,0,0,0,0,0,0,0,0,0,0,0,0,0,0,0,0,0,0,0,0,0,0,0,0,0,0,0,0,0,0,0,0,0,0,Fabio Pisacane,£630Th. ,34,178,Defender - Centre-Back,right,Cagliari Calcio,29,1,1,2553,26,0,0,2140,28,2,1,2350,32,1,0,2541,1,0,0,44,Serie A
19-06-17,18.3.4.28,Giancarlo González,80000942,366,08-Feb-88,29,53,2,0,0,4850,6250,6250,143,125,6501099,186,78,D C,2,1,2,1,2,2,3,1,2,1,3,3,4,7,5,10,3,15,5,5,14,11,8,15,11,15,15,13,12,11,11,12,17,11,14,5,14,13,13,12,13,14,14,8,14,13,20,13,13,11,10,14,5,12,14,14,11,13,15,12,11,8,20,1,1,1,1,1,20,D C,101,1,1,1,1,1,1,20,1,1,10,1,1,1,1,1,0,0,0,0,0,0,0,0,0,0,0,0,0,0,0,0,0,0,0,0,0,0,0,0,0,0,0,0,0,0,0,0,0,0,0,0,0,0,0,0,0,0,0,0,0,0,0,0,0,Giancarlo González,£1.26m ,32,186,Defender - Centre-Back,right,Los Angeles Galaxy,21,1,0,1662,23,0,0,1948,38,1,1,2694,7,0,0,484,nan,nan,nan,nan,Serie A
19-06-17,18.3.4.28,Jean Claude Billong,83103184,769,28-Dec-93,23,0,0,0,0,2799,4581,5000,119,109,206387,192,90,D C,3,2,2,3,1,3,1,2,2,1,3,7,7,7,5,8,7,14,7,9,13,10,7,13,7,13,10,12,10,11,10,10,10,10,10,10,13,10,10,11,12,13,15,8,15,11,20,14,15,12,12,10,9,8,12,11,11,12,11,12,11,2,20,1,1,1,1,1,20,D C,101,1,1,1,1,1,1,20,1,1,1,1,1,1,1,1,0,0,0,0,0,0,0,0,0,0,0,0,0,0,0,0,0,0,0,0,0,0,0,0,0,0,0,0,0,0,0,0,0,0,0,0,0,0,0,0,0,0,0,0,0,0,0,0,0,Jean-Claude Billong,£810Th. ,26,192,Defender - Centre-Back,right,Hatayspor,24,2,1,1909,25,1,0,1981,29,0,0,2506,13,0,0,1119,1,0,0,0,Serie A
19-06-17,18.3.4.28,Giorgio Chiellini,831079,776,14-Aug-84,32,92,7,26,6,7000,8350,8350,167,167,232186002,187,85,D LC,4,1,1,1,3,4,3,1,2,1,3,2,10,8,8,9,2,16,11,20,17,12,4,19,8,16,16,20,16,15,10,14,19,8,14,13,18,17,20,11,11,17,14,20,15,15,7,16,18,17,13,13,15,14,12,19,17,11,17,16,18,3,20,11,1,1,1,16,20,D LC,104,1,1,1,1,1,1,20,16,1,1,1,1,1,11,1,1.12604E+15,0,0,1,0,0,1,0,0,0,0,0,0,0,0,0,0,0,0,0,0,0,0,0,0,0,0,0,0,0,1,0,0,0,0,0,0,0,1,0,0,0,0,0,0,0,0,0,0,Giorgio Chiellini,£9.00m ,36,187,Defender - Centre-Back,left,Juventus FC,33,4,1,2660,38,0,1,3172,34,1,2,2738,4,1,0,201,3,0,0,192,Serie A
19-06-17,18.3.4.28,Felipe,837211,1651,31-Jul-84,32,0,0,0,0,4000,6350,6350,136,127,232186002,188,75,D LC,1,2,2,1,2,2,3,3,3,2,3,10,11,11,7,10,10,15,6,14,14,10,9,13,10,14,13,14,13,13,11,13,12,6,12,9,14,13,15,10,11,14,14,20,7,11,9,13,13,12,15,12,13,11,9,12,12,7,11,10,10,11,20,1,1,1,1,15,20,D LC,104,1,12,1,1,1,1,20,15,1,1,1,1,1,1,1,0,0,0,0,0,0,0,0,0,0,0,0,0,0,0,0,0,0,0,0,0,0,0,0,0,0,0,0,0,0,0,0,0,0,0,0,0,0,0,0,0,0,0,0,0,0,0,0,0,Felipe,£450Th. ,36,188,Defender - Centre-Back,left,Without Club,33,1,1,2902,30,1,0,2577,31,3,1,2453,16,0,0,1086,nan,nan,nan,nan,Serie A
19-06-17,18.3.4.28,Bacary Sagna,8430030,769,14-Feb-83,34,65,0,12,0,5200,6650,6650,160,133,232186002,176,72,D/WB RC,1,1,3,1,3,3,1,1,1,1,1,11,13,11,5,13,7,15,8,8,14,12,5,15,14,12,14,14,15,13,13,14,15,10,8,13,14,15,16,10,11,13,12,10,16,12,20,14,15,15,8,14,9,10,16,16,16,14,14,14,17,9,20,18,1,1,20,14,15,D/WB RC,113,1,1,1,1,1,1,15,14,20,1,1,1,1,11,18,1081376,0,0,0,0,0,1,0,0,0,0,0,0,0,0,0,1,0,0,0,0,1,0,0,0,0,0,0,0,0,0,0,0,0,0,0,0,0,0,0,0,0,0,0,0,0,0,0,0,Bacary Sagna,£720Th. ,37,176,Defender - Right-Back,right,Without Club,25,0,2,1848,22,2,0,1764,31,1,4,2660,nan,nan,nan,nan,nan,nan,nan,nan,Serie A
19-06-17,18.3.4.28,Sčbastien De Maio,8442734,769,05-Mar-87,30,0,0,0,0,4250,6400,6400,138,128,232186002,190,90,D C,2,2,2,4,3,1,1,2,1,1,4,6,5,8,10,9,3,14,6,8,14,12,8,15,12,14,14,17,9,10,10,13,18,8,12,10,14,14,15,11,10,15,15,8,14,11,20,14,16,10,13,5,4,8,6,9,12,11,13,11,12,3,20,1,1,1,1,1,20,D C,101,1,1,1,1,1,1,20,1,1,1,1,1,1,1,1,0,0,0,0,0,0,0,0,0,0,0,0,0,0,0,0,0,0,0,0,0,0,0,0,0,0,0,0,0,0,0,0,0,0,0,0,0,0,0,0,0,0,0,0,0,0,0,0,0,Sebastien De Maio,£1.26m ,33,190,Defender - Centre-Back,right,Udinese Calcio,13,0,0,1170,27,2,0,2142,22,1,0,1673,23,1,0,1681,5,0,0,438,Serie A
19-06-17,18.3.4.28,Medhi Benatia,8443128,34,17-Apr-87,30,49,1,4,0,6250,7600,8000,159,154,232186002,189,94,D C,2,3,1,3,1,1,2,2,3,1,3,4,8,11,9,13,4,15,9,10,17,12,7,16,12,12,17,15,13,14,8,13,16,7,12,8,15,12,12,11,12,18,16,9,13,15,20,14,17,14,8,16,14,6,15,15,8,13,14,13,11,13,20,1,1,1,1,1,20,D C,101,1,13,1,1,1,1,20,1,1,1,1,1,1,1,1,2.74878E+11,0,0,0,0,0,0,0,0,0,0,0,0,0,0,0,1,0,0,0,0,0,0,0,0,0,0,0,0,0,0,0,0,0,0,0,0,0,0,1,0,0,0,0,0,0,0,0,0,Medhi Benatia,£20.70m ,33,190,Defender - Centre-Back,right,Al-Duhail SC,21,1,0,1456,32,4,0,2637,20,2,0,1604,24,0,0,2033,3,0,0,225,Serie A
19-06-17,18.3.4.28,Kalidou Koulibaly,85051083,41,20-Jun-91,26,16,0,0,0,6250,7750,7900,163,158,150936263,195,89,D C,3,1,1,3,3,1,1,3,1,1,2,6,7,10,6,12,6,16,8,8,16,12,6,16,12,14,16,15,14,13,11,11,16,8,12,9,16,14,16,12,14,18,15,10,14,16,20,17,19,14,13,14,8,10,12,15,11,14,12,14,14,7,20,1,1,1,13,1,20,D C,101,1,1,1,1,1,1,20,1,13,1,1,1,1,1,1,32,0,0,0,0,0,1,0,0,0,0,0,0,0,0,0,0,0,0,0,0,0,0,0,0,0,0,0,0,0,0,0,0,0,0,0,0,0,0,0,0,0,0,0,0,0,0,0,0,Kalidou Koulibaly,£54.00m ,29,187,Defender - Centre-Back,right,SSC Napoli,38,2,0,3372,45,5,0,3966,48,2,1,4305,34,0,0,2917,5,0,0,450,Serie A
19-06-17,18.3.4.28,Cristián Zapata,8825553,1653,30-Sep-86,30,44,1,4,0,5500,7250,6750,148,135,12251994,186,78,D C,3,2,3,1,1,1,3,2,2,1,1,1,5,8,5,9,2,15,3,12,16,10,4,15,9,15,13,15,12,9,7,11,13,4,12,8,15,16,13,13,13,18,15,9,14,14,20,16,16,13,15,13,15,8,18,13,16,11,14,16,15,4,20,1,1,1,10,1,20,D C,101,1,6,1,1,1,1,20,1,10,1,1,1,1,1,1,1.37439E+11,0,0,0,0,0,0,0,0,0,0,0,0,0,0,0,0,0,0,0,0,0,0,0,0,0,0,0,0,0,0,0,0,0,0,0,0,0,1,0,0,0,0,0,0,0,0,0,0,Cristián Zapata,£2.25m ,34,187,Defender - Centre-Back,right,Genoa CFC,16,1,0,1259,20,0,0,1713,20,1,0,1687,22,1,0,1860,3,0,0,270,Serie A
19-06-17,18.3.4.28,Miranda,8832812,1651,07-Sep-84,32,39,1,0,0,6500,7750,7600,161,152,232186002,186,78,D C,3,1,2,1,3,4,3,3,3,3,3,2,8,9,9,12,5,16,7,3,17,12,10,16,12,13,16,16,14,14,11,14,17,7,14,9,16,15,16,14,12,15,14,7,14,15,20,14,13,15,11,15,10,6,14,17,14,18,16,13,10,11,20,1,1,1,1,1,20,D C,101,1,1,1,1,1,1,20,1,1,1,1,1,1,1,1,1.37439E+11,0,0,0,0,0,0,0,0,0,0,0,0,0,0,0,0,0,0,0,0,0,0,0,0,0,0,0,0,0,0,0,0,0,0,0,0,0,1,0,0,0,0,0,0,0,0,0,0,Miranda,£7.20m ,36,186,Defender - Centre-Back,right,Jiangsu Suning,36,0,0,3205,31,0,0,2728,29,1,0,2293,15,1,1,1350,nan,nan,nan,nan,Serie A
19-06-17,18.3.4.28,Lucas Leiva,8833577,1651,09-Jan-87,30,24,0,9,4,6200,7100,7200,154,144,232186002,179,74,D/DM/M C,1,2,3,3,1,2,1,1,3,2,3,3,4,11,5,15,4,11,4,4,15,15,9,17,14,15,18,14,16,16,11,14,16,10,12,14,17,16,16,11,13,14,12,9,14,10,20,15,13,15,11,14,7,11,18,13,19,16,19,12,16,8,16,1,17,10,1,1,17,D/DM/M C,331,1,1,1,10,1,1,16,1,1,20,17,1,1,1,1,1.75922E+13,0,0,0,0,0,0,1,0,0,0,0,0,0,0,0,0,0,0,0,1,0,0,1,0,0,0,0,0,0,0,0,0,0,0,0,0,0,0,0,0,0,0,0,0,1,0,0,0,Lucas Leiva,£9.00m ,33,179,Midfielder - Defensive Midfield,right,SS Lazio,32,1,3,1778,50,4,5,4031,36,0,4,2711,30,0,1,2143,6,0,0,400,Serie A
19-06-17,18.3.4.28,Matías Silvestre,955977,1649,25-Sep-84,32,0,0,0,0,5000,6550,6650,139,133,232186002,185,84,D C,4,1,2,3,1,2,1,1,3,1,3,6,7,6,8,12,8,14,6,11,15,12,7,14,11,16,13,16,11,9,10,12,14,5,14,7,15,14,15,12,12,15,13,9,13,12,20,16,16,14,10,11,12,12,15,12,15,8,16,14,13,7,20,1,1,1,1,1,20,D C,101,1,1,1,1,1,1,20,1,1,1,1,1,1,1,1,4295000064,0,0,0,0,0,0,0,0,0,0,0,0,0,0,0,1,0,0,0,0,0,0,0,0,0,0,0,0,0,0,0,0,1,0,0,0,0,0,0,0,0,0,0,0,0,0,0,0,Matías Silvestre,£1.35m ,36,185,Defender - Centre-Back,right,Royal Excel Mouscron,38,0,2,3391,37,1,0,3321,35,2,1,3150,5,0,0,450,3,0,0,270,Serie A
19-06-17,18.3.4.28,Nicolás Spolli,956682,1649,20-Feb-83,34,0,0,0,0,4000,6250,6300,138,126,862595,192,90,D C,3,2,2,3,1,2,1,2,3,3,1,5,5,7,7,8,5,15,5,13,14,11,8,14,10,16,16,14,11,13,10,10,14,4,16,7,15,12,15,9,11,16,15,8,12,11,20,14,16,14,15,15,9,5,15,13,12,11,16,14,10,7,20,1,1,1,1,1,20,D C,101,1,1,1,1,1,1,20,1,1,1,1,1,1,1,1,8589934592,0,0,0,0,0,0,0,0,0,0,0,0,0,0,0,0,0,0,0,0,0,0,0,0,0,0,0,0,0,0,0,0,0,1,0,0,0,0,0,0,0,0,0,0,0,0,0,0,Nicolás Spolli,£360Th. ,37,193,Defender - Centre-Back,right,Retired,23,0,0,1767,22,0,0,1823,20,0,0,1627,8,0,0,616,0,0,0,0,Serie A
19-06-17,18.3.4.28,Santiago Gentiletti,961210,1649,09-Jan-85,32,0,0,0,0,5000,6300,6300,145,126,3686454,184,77,D C,1,3,1,2,2,4,2,2,3,1,1,3,7,7,5,11,11,13,7,5,15,13,12,13,12,15,16,14,12,10,13,13,14,6,13,8,15,18,18,11,11,14,12,20,15,11,6,14,13,13,14,14,12,11,14,14,13,12,18,18,18,4,20,1,1,1,1,10,20,D C,101,1,1,1,1,1,1,20,10,1,1,1,1,1,1,1,1.15292E+18,0,0,0,0,0,0,0,0,0,0,0,0,0,0,0,0,0,0,0,0,0,0,0,0,0,0,0,0,0,0,1,0,1,0,0,0,0,0,0,0,0,0,0,0,0,0,0,0,Santiago Gentiletti,£180Th. ,35,182,Defender - Centre-Back,left,Club Atlético Newell's Old Boys,17,0,1,1356,7,0,0,590,31,0,0,2617,23,0,0,2070,nan,nan,nan,nan,Serie A
19-06-17,18.3.4.28,Federico Fazio,964847,1649,17-Mar-87,30,4,1,13,1,5750,7000,7350,152,147,232186002,195,90,D C,1,1,3,3,1,3,3,3,2,3,3,3,4,10,7,13,4,18,6,5,15,14,6,17,13,13,16,15,14,13,12,14,15,13,14,8,15,14,13,8,9,15,18,12,9,11,20,13,17,12,14,10,13,15,13,12,13,12,14,14,13,11,20,1,1,1,1,1,20,D C,101,1,15,1,1,1,1,20,1,1,10,1,1,1,1,1,1.15292E+18,0,0,0,0,0,0,0,0,0,0,0,0,0,0,0,0,0,0,0,0,0,0,0,0,0,0,0,0,0,0,0,0,0,0,0,0,0,0,1,0,0,0,0,0,0,0,0,0,Federico Fazio,£11.70m ,33,195,Defender - Centre-Back,right,AS Roma,48,4,1,3946,45,2,2,3842,42,5,0,3524,23,2,0,1765,1,0,0,90,Serie A
19-06-17,18.3.4.28,Ricardo Rodríguez,98003635,798,25-Aug-92,24,45,1,4,0,5750,7700,7350,156,147,48283087,182,77,D/WB/M LC,3,2,3,1,4,1,2,1,1,3,3,15,17,9,10,11,14,8,12,16,11,13,15,14,12,11,16,14,17,14,12,16,13,10,8,11,12,17,14,12,11,15,9,20,18,12,9,17,12,15,6,15,3,12,15,14,12,18,16,17,19,4,20,19,17,10,1,20,15,D/WB/M LC,124,1,1,1,1,10,1,15,20,1,1,1,17,1,19,1,1.40742E+14,0,0,0,0,0,0,0,0,0,0,0,0,0,0,0,0,0,0,0,0,0,0,0,0,0,0,0,0,0,0,0,0,1,0,0,0,0,0,0,0,0,0,0,0,0,0,0,1,Ricardo Rodríguez,£13.50m ,28,180,Defender - Left-Back,left,Torino FC,27,2,3,2289,47,4,2,4149,41,0,3,3530,11,0,0,835,2,0,0,177,Serie A
19-06-17,18.3.4.28,Arlind Ajeti,98009096,752,25-Sep-93,23,13,1,12,1,4000,6500,6050,135,121,5112465,184,83,D C,3,3,1,3,1,3,3,2,3,1,2,3,4,6,6,10,4,14,7,10,14,9,8,14,9,12,10,14,14,13,6,13,10,4,12,8,13,13,13,10,11,16,12,10,12,12,20,15,16,16,14,15,7,6,14,10,13,8,11,9,9,11,20,1,1,1,1,1,20,D C,101,1,1,1,1,1,1,20,1,1,1,1,1,1,1,1,0,0,0,0,0,0,0,0,0,0,0,0,0,0,0,0,0,0,0,0,0,0,0,0,0,0,0,0,0,0,0,0,0,0,0,0,0,0,0,0,0,0,0,0,0,0,0,0,0,Arlind Ajeti,£900Th. ,27,184,Defender - Centre-Back,right,AC Reggiana 1919,5,1,0,369,23,0,1,1354,16,2,0,1310,8,0,0,316,3,0,0,158,Serie A
19-06-17,18.3.4.28,Berat Djimsiti,98015432,752,19-Feb-93,24,13,1,5,0,3500,5950,5900,131,118,360739,190,83,D RLC,3,2,3,1,3,1,1,2,3,3,3,5,7,7,6,11,4,14,8,10,14,10,4,14,11,9,13,15,9,11,8,10,12,6,10,8,14,13,11,11,10,17,14,12,12,12,20,13,14,9,5,10,5,8,12,13,14,7,13,12,14,5,20,13,1,1,16,15,20,D RLC,106,1,1,1,1,1,1,20,15,16,1,1,1,1,13,13,0,0,0,0,0,0,0,0,0,0,0,0,0,0,0,0,0,0,0,0,0,0,0,0,0,0,0,0,0,0,0,0,0,0,0,0,0,0,0,0,0,0,0,0,0,0,0,0,0,Berat Djimsiti,£900Th. ,27,190,Defender - Centre-Back,right,Atalanta BC,35,0,0,3124,30,0,1,2700,29,1,1,2283,41,2,1,3388,5,0,0,359,Serie A
19-06-17,18.3.4.28,Rafik Halliche,12004449,5,02-Sep-86,30,37,3,10,0,3342,6385,5750,115,115,232186002,186,84,D C,3,3,2,2,3,4,3,3,4,1,1,5,7,6,5,11,6,15,7,3,15,12,8,14,10,15,14,14,13,11,11,12,13,7,13,13,15,14,15,9,7,13,11,8,14,10,20,12,14,12,10,12,11,6,17,14,12,10,12,12,10,6,20,1,1,1,1,1,20,D C,101,1,17,1,1,1,1,20,1,1,1,1,1,1,1,1,0,0,0,0,0,0,0,0,0,0,0,0,0,0,0,0,0,0,0,0,0,0,0,0,0,0,0,0,0,0,0,0,0,0,0,0,0,0,0,0,0,0,0,0,0,0,0,0,0,Rafik Halliche,£405Th. ,34,187,Defender - Centre-Back,right,Without Club,1,0,0,90,24,2,0,2101,23,1,1,1916,11,0,1,806,nan,nan,nan,nan,Liga NOS
19-06-17,18.3.4.28,Hichem Belkeroui,12042674,5,24-Aug-90,26,10,0,0,0,2500,5500,5500,115,110,143313,193,89,D LC,2,3,1,2,2,2,3,2,4,2,1,7,8,7,5,10,10,13,9,11,14,8,7,13,10,16,15,16,14,11,9,13,13,10,12,10,11,12,15,10,10,14,13,20,14,11,3,13,12,14,9,12,8,11,12,12,12,11,13,12,10,8,20,14,1,1,1,18,20,D LC,104,1,1,1,1,1,1,20,18,1,1,1,1,1,14,1,0,0,0,0,0,0,0,0,0,0,0,0,0,0,0,0,0,0,0,0,0,0,0,0,0,0,0,0,0,0,0,0,0,0,0,0,0,0,0,0,0,0,0,0,0,0,0,0,0,Hicham Belkaroui,£360Th. ,30,195,Defender - Centre-Back,both,MC Oran,12,0,1,1037,19,0,1,1453,21,1,1,1740,5,0,0,292,nan,nan,nan,nan,Liga NOS
19-06-17,18.3.4.28,Mohamed Abarhoun,12053801,34,03-May-89,28,7,0,0,0,2000,5150,5650,130,114,190008,184,73,D C,1,2,4,2,2,3,3,3,1,3,4,7,7,9,7,11,5,14,7,10,13,12,3,14,12,11,13,12,12,11,8,11,12,6,11,8,12,13,12,12,13,12,13,9,14,12,20,13,11,13,8,10,5,11,13,12,13,12,15,14,13,8,20,1,1,1,1,1,20,D C,101,1,1,1,1,1,1,20,1,1,10,1,1,1,1,1,0,0,0,0,0,0,0,0,0,0,0,0,0,0,0,0,0,0,0,0,0,0,0,0,0,0,0,0,0,0,0,0,0,0,0,0,0,0,0,0,0,0,0,0,0,0,0,0,0,Mohamed Abarhoun,£720Th. ,31,187,Defender - Centre-Back,right,Without Club,20,0,0,1800,29,2,1,2542,33,1,0,2722,21,2,1,1828,nan,nan,nan,nan,Liga NOS
19-06-17,18.3.4.28,Zainadine Júnior,13104485,35,24-Jun-88,28,44,0,0,0,4000,6550,6550,132,131,3590529,178,75,D RC,2,2,3,4,1,1,2,3,1,3,3,6,9,10,8,11,5,15,7,15,13,11,8,15,12,14,15,14,11,13,8,13,17,11,12,9,14,14,15,14,14,14,12,6,16,13,20,14,13,14,11,12,8,14,16,14,12,13,16,16,12,7,20,1,1,1,19,1,20,D RC,103,1,1,1,1,1,1,20,1,19,1,1,1,1,1,1,1.15405E+18,0,0,0,0,0,0,0,0,0,0,0,0,0,0,0,0,0,0,0,0,0,0,0,0,0,0,0,0,0,0,0,0,0,0,0,0,0,0,0,0,0,0,0,0,0,0,0,0,Zainadine Júnior,£1.35m ,32,180,Defender - Centre-Back,right,CS Marítimo,15,1,0,1041,38,1,1,3437,33,1,3,2970,33,3,1,3000,5,1,0,444,Liga NOS
19-06-17,18.3.4.28,Nick Ansell,15019018,1435,02-Feb-94,23,0,0,2,0,2450,5000,5000,116,100,43372,186,81,D C,1,1,1,1,1,1,1,1,1,1,1,3,3,9,4,8,3,12,3,5,12,12,4,14,12,12,12,11,10,12,12,12,15,5,14,5,12,14,10,11,10,11,12,8,12,11,20,10,14,14,7,14,13,7,12,10,16,15,12,15,14,6,20,1,4,1,1,1,20,D C,101,1,1,1,1,1,1,20,1,1,1,4,1,1,1,1,8.79609E+12,0,0,0,0,0,0,0,0,0,0,0,0,0,0,0,0,0,0,0,0,0,0,0,0,0,0,0,0,0,0,0,0,0,0,0,0,0,0,0,0,0,0,0,1,0,0,0,0,Nick Ansell,£450Th. ,26,185,Defender - Centre-Back,right,Melbourne Victory,19,0,0,1350,10,0,0,850,23,0,0,1488,6,0,0,407,nan,nan,nan,nan,Liga NOS
19-06-17,18.3.4.28,Diego Reyes,168047,379,19-Sep-92,24,50,1,21,1,4750,6750,6750,145,135,7133484,189,68,D/DM C,2,2,3,2,4,3,2,2,3,1,1,6,7,8,6,14,7,13,8,10,16,12,11,16,12,10,13,13,12,13,11,11,14,7,11,10,15,14,13,12,13,11,16,11,14,14,20,12,10,12,8,10,3,14,13,14,14,9,17,15,16,7,20,10,5,1,14,1,20,D/DM C,111,1,1,1,1,1,1,20,1,14,17,5,1,1,1,10,0,0,0,0,0,0,0,0,0,0,0,0,0,0,0,0,0,0,0,0,0,0,0,0,0,0,0,0,0,0,0,0,0,0,0,0,0,0,0,0,0,0,0,0,0,0,0,0,0,Diego Reyes,£4.50m ,28,190,Defender - Centre-Back,right,Tigres UANL,35,1,0,3009,24,3,1,1488,21,1,0,1240,8,0,0,636,5,0,0,337,Liga NOS
19-06-17,18.3.4.28,Ícaro,19056162,1651,16-Apr-89,28,0,0,0,0,3396,4528,5500,120,112,121143,182,74,D C,3,3,1,3,1,3,1,1,1,1,1,6,8,7,6,7,4,16,6,9,13,5,6,13,5,16,14,14,13,13,6,12,12,5,11,8,13,12,13,10,11,12,15,6,12,11,20,13,14,13,8,15,7,8,15,12,10,14,12,14,10,10,20,1,1,1,1,1,20,D C,101,1,1,1,1,1,1,20,1,1,1,1,1,1,1,1,0,0,0,0,0,0,0,0,0,0,0,0,0,0,0,0,0,0,0,0,0,0,0,0,0,0,0,0,0,0,0,0,0,0,0,0,0,0,0,0,0,0,0,0,0,0,0,0,0,Ícaro,£270Th. ,31,181,Defender - Centre-Back,right,CD Feirense,26,2,0,2024,6,0,0,255,17,2,0,1354,27,1,0,2430,3,1,0,206,Liga NOS
19-06-17,18.3.4.28,Dráusio,19064405,1651,21-Aug-91,25,0,0,0,0,2012,5133,5750,121,117,518788,188,86,D/DM C,2,1,2,1,1,1,2,1,1,4,4,9,10,9,9,10,9,13,9,9,14,10,9,13,11,10,13,13,11,11,10,12,12,9,12,10,13,10,11,11,11,11,14,12,11,11,20,13,11,12,10,9,10,12,15,12,12,11,10,9,9,10,20,1,10,1,1,1,20,D/DM C,111,1,1,1,1,1,1,20,1,1,18,10,1,1,1,1,0,0,0,0,0,0,0,0,0,0,0,0,0,0,0,0,0,0,0,0,0,0,0,0,0,0,0,0,0,0,0,0,0,0,0,0,0,0,0,0,0,0,0,0,0,0,0,0,0,Dráusio,£540Th. ,29,188,Defender - Centre-Back,both,Without Club,34,1,0,2894,18,1,0,1581,nan,nan,nan,nan,nan,nan,nan,nan,nan,nan,nan,nan,Liga NOS
19-06-17,18.3.4.28,Bruno Nascimento,19073813,1651,30-May-91,26,0,0,0,0,3542,4808,5600,122,112,173347,188,72,D C,1,1,2,3,2,2,4,3,2,1,1,6,9,9,6,9,8,13,11,14,14,11,6,13,10,12,11,14,11,10,10,11,12,7,7,6,13,15,14,12,11,12,14,6,12,13,20,13,14,12,8,8,7,12,10,8,8,7,16,13,14,6,20,8,1,1,12,1,20,D C,101,1,10,1,1,1,1,20,1,12,1,1,1,1,1,8,0,0,0,0,0,0,0,0,0,0,0,0,0,0,0,0,0,0,0,0,0,0,0,0,0,0,0,0,0,0,0,0,0,0,0,0,0,0,0,0,0,0,0,0,0,0,0,0,0,Bruno Nascimento,£180Th. ,29,188,Defender - Centre-Back,right,Manama Club,10,0,0,677,8,0,0,495,22,0,0,1949,2,0,0,180,nan,nan,nan,nan,Liga NOS
19-06-17,18.3.4.28,Dankler,19074111,1651,24-Jan-92,25,0,0,0,0,3500,5500,5500,115,110,143313,185,80,D C,3,1,1,2,2,2,3,1,3,3,3,4,7,7,8,6,5,14,5,8,13,8,8,12,8,14,14,14,12,10,5,8,14,10,10,12,11,13,13,13,11,12,15,11,14,13,20,13,16,11,10,11,5,5,9,14,10,9,11,7,9,13,20,1,1,1,13,1,20,D C,101,1,1,1,1,1,1,20,1,13,1,1,1,1,1,1,0,0,0,0,0,0,0,0,0,0,0,0,0,0,0,0,0,0,0,0,0,0,0,0,0,0,0,0,0,0,0,0,0,0,0,0,0,0,0,0,0,0,0,0,0,0,0,0,0,Dankler,£720Th. ,28,185,Defender - Centre-Back,right,Vissel Kobe,31,1,0,2348,29,0,0,2550,56,0,0,5046,18,3,1,1620,nan,nan,nan,nan,Liga NOS
19-06-17,18.3.4.28,Marcelo,19080674,1651,27-Jul-89,27,0,0,0,0,4701,5224,6800,145,136,2994316,182,74,D C,1,2,1,1,3,2,1,2,2,1,3,7,7,8,8,11,6,13,5,6,15,15,8,15,13,13,14,15,13,14,11,14,15,7,12,8,14,14,14,12,14,14,13,8,14,13,20,14,13,13,10,13,13,8,15,14,13,12,15,13,12,6,20,1,1,1,1,1,20,D C,101,1,5,1,1,1,1,20,1,1,8,1,1,1,1,1,8589967424,0,0,0,0,0,0,1,0,0,0,0,0,0,0,0,1,0,0,0,0,0,0,0,0,0,0,0,0,0,0,0,0,0,1,0,0,0,0,0,0,0,0,0,0,0,0,0,0,Marcelo,£54.00m ,32,174,Defender - Left-Back,left,Real Madrid,47,3,13,3878,44,5,11,3671,34,3,6,2858,23,2,7,1884,3,0,1,270,LaLiga
19-06-17,18.3.4.28,Marcel,19088675,1651,16-Oct-92,24,0,0,0,0,2500,5500,5500,121,117,157544,196,73,DM C,1,3,4,3,4,1,2,2,1,2,3,4,6,10,7,11,8,14,11,7,13,12,7,15,11,14,11,12,12,12,10,11,12,8,10,9,14,11,10,13,12,10,18,10,10,12,20,12,10,12,12,10,6,14,12,11,11,12,11,11,12,7,15,1,15,7,1,1,15,DM C,301,1,1,1,7,1,1,15,1,1,20,15,1,1,1,1,0,0,0,0,0,0,0,0,0,0,0,0,0,0,0,0,0,0,0,0,0,0,0,0,0,0,0,0,0,0,0,0,0,0,0,0,0,0,0,0,0,0,0,0,0,0,0,0,0,Marcel,£270Th. ,28,189,Midfielder - Defensive Midfield,right,Londrina Esporte Clube (PR),15,1,0,1178,10,0,0,347,4,0,0,113,9,1,0,372,nan,nan,nan,nan,Liga NOS
19-06-17,18.3.4.28,Pedro Henrique,19116257,1651,18-Dec-92,24,0,0,0,0,4046,5766,6700,145,134,6987400,190,87,D C,3,1,1,2,1,1,1,2,4,3,2,4,7,8,7,9,6,13,7,8,15,12,7,13,11,9,11,14,12,13,11,14,13,6,14,8,14,13,14,12,10,15,16,20,17,13,8,14,17,12,4,11,5,8,16,12,14,13,18,18,17,8,20,1,1,1,1,13,20,D C,101,1,11,1,1,1,1,20,13,1,14,1,1,1,1,1,0,0,0,0,0,0,0,0,0,0,0,0,0,0,0,0,0,0,0,0,0,0,0,0,0,0,0,0,0,0,0,0,0,0,0,0,0,0,0,0,0,0,0,0,0,0,0,0,0,Pedro Henrique,£1.80m ,27,190,Defender - Centre-Back,left,Al-Wahda Mekka,40,0,4,3630,27,1,0,2310,39,2,0,3498,35,0,0,2952,2,0,0,180,Liga NOS
19-06-17,18.3.4.28,Raul Silva,19135096,1651,04-Nov-89,27,0,0,0,0,3709,4770,6250,140,130,1490785,191,84,D C,3,3,2,2,1,3,1,3,1,3,1,2,8,8,7,12,4,16,9,10,14,11,5,15,12,19,15,15,13,13,9,12,15,8,12,6,13,13,13,13,12,14,16,20,13,12,5,12,15,12,20,6,4,10,13,15,11,8,10,6,2,12,20,1,1,1,1,1,20,D C,101,1,11,1,1,1,1,20,1,1,1,1,1,1,1,1,0,0,0,0,0,0,0,0,0,0,0,0,0,0,0,0,0,0,0,0,0,0,0,0,0,0,0,0,0,0,0,0,0,0,0,0,0,0,0,0,0,0,0,0,0,0,0,0,0,Raúl Silva,£4.50m ,30,187,Defender - Centre-Back,left,SC Braga,32,7,0,2865,40,9,8,3490,23,1,1,1974,18,2,2,1239,1,0,0,45,Liga NOS
19-06-17,18.3.4.28,Felipe,19162578,1651,16-May-89,28,0,0,0,0,4750,6900,7350,150,147,34948859,191,87,D C,1,2,1,4,3,1,2,2,1,1,2,6,7,8,8,11,7,17,7,7,15,12,11,15,11,18,14,14,12,12,12,13,15,10,16,10,13,14,14,13,13,15,16,11,14,13,20,14,16,14,16,12,10,12,12,13,12,12,12,10,9,9,20,1,1,1,13,1,20,D C,101,1,1,1,1,1,1,20,1,13,12,1,1,1,1,1,32768,0,0,0,0,0,0,0,0,0,0,0,0,0,0,0,1,0,0,0,0,0,0,0,0,0,0,0,0,0,0,0,0,0,0,0,0,0,0,0,0,0,0,0,0,0,0,0,0,Felipe,£450Th. ,36,188,Defender - Centre-Back,left,Without Club,33,1,1,2902,30,1,0,2577,31,3,1,2453,16,0,0,1086,nan,nan,nan,nan,Serie A
19-06-17,18.3.4.28,Lucas Possignolo,19171602,1651,11-May-94,23,0,0,0,0,3000,5550,5550,132,116,162606,185,79,D C,2,1,2,1,2,3,1,3,2,3,1,6,5,8,8,11,15,15,7,8,13,11,8,15,11,11,14,14,13,13,8,10,13,6,13,10,14,13,13,12,13,14,12,5,13,10,20,12,13,14,5,11,8,8,10,8,11,13,16,15,13,6,20,1,1,1,1,1,20,D C,101,1,1,1,1,1,1,20,1,1,1,1,1,1,1,1,0,0,0,0,0,0,0,0,0,0,0,0,0,0,0,0,0,0,0,0,0,0,0,0,0,0,0,0,0,0,0,0,0,0,0,0,0,0,0,0,0,0,0,0,0,0,0,0,0,Lucas Possignolo,£900Th. ,26,188,Defender - Centre-Back,right,Portimonense SC,17,3,0,1423,29,1,0,2590,31,0,0,2587,27,2,0,2427,2,0,0,135,Liga NOS
19-06-17,18.3.4.28,Jubal,19172374,1651,29-Aug-93,23,0,0,0,0,4260,5614,6300,144,126,1792097,190,78,D C,1,4,1,1,1,1,3,2,2,3,2,3,5,8,9,8,4,13,6,3,14,12,2,14,11,12,15,13,13,13,9,14,14,8,11,10,13,13,13,12,13,13,15,9,14,13,20,11,13,13,11,13,11,2,14,13,7,11,7,13,12,13,20,1,1,1,1,1,20,D C,101,1,1,1,1,1,1,20,1,1,1,1,1,1,1,1,0,0,0,0,0,0,0,0,0,0,0,0,0,0,0,0,0,0,0,0,0,0,0,0,0,0,0,0,0,0,0,0,0,0,0,0,0,0,0,0,0,0,0,0,0,0,0,0,0,Jubal,£1.13m ,27,190,Defender - Centre-Back,right,AJ Auxerre,38,0,1,3350,35,1,0,3038,13,0,1,872,27,2,0,2087,6,0,0,540,Liga NOS
19-06-17,18.3.4.28,Pablo,19173885,1651,18-Mar-92,25,0,0,0,0,1759,5026,5000,119,114,72913,185,73,D LC,1,1,1,2,1,4,1,1,3,2,2,8,10,10,6,12,6,12,8,10,12,11,6,13,11,11,13,12,12,14,9,11,14,5,12,8,13,12,13,12,11,11,13,20,13,13,8,12,12,13,8,13,6,10,12,12,16,13,15,12,13,6,20,1,1,1,1,19,20,D LC,104,1,1,1,1,1,1,20,19,1,1,1,1,1,1,1,0,0,0,0,0,0,0,0,0,0,0,0,0,0,0,0,0,0,0,0,0,0,0,0,0,0,0,0,0,0,0,0,0,0,0,0,0,0,0,0,0,0,0,0,0,0,0,0,0,Pablo,£2.70m ,29,188,Defender - Centre-Back,right,FC Girondins Bordeaux,28,0,0,2381,15,0,3,1292,39,1,2,3203,28,4,0,2445,5,0,0,390,Ligue 1
19-06-17,18.3.4.28,Marcăo,19190440,1651,05-Jun-96,21,0,0,0,0,3000,6000,6200,135,124,924299,186,81,D C,3,4,1,3,2,2,3,2,2,1,2,12,10,10,7,11,10,14,10,10,13,12,10,14,12,15,13,13,12,12,11,13,12,12,11,11,14,12,14,11,12,11,13,20,12,13,8,13,12,11,14,11,12,13,13,12,10,13,14,14,12,8,20,1,1,1,1,1,20,D C,101,1,1,1,1,1,1,20,1,1,15,1,1,1,1,1,0,0,0,0,0,0,0,0,0,0,0,0,0,0,0,0,0,0,0,0,0,0,0,0,0,0,0,0,0,0,0,0,0,0,0,0,0,0,0,0,0,0,0,0,0,0,0,0,0,Marcão,£810Th. ,24,185,Defender - Centre-Back,left,Galatasaray SK,2,1,0,164,25,1,0,1851,45,3,1,3993,39,0,0,3463,9,1,1,810,Liga NOS
19-06-17,18.3.4.28,Róbson,19191674,1651,14-Feb-94,23,0,0,0,0,2750,5650,5650,130,113,344759,185,80,D C,1,3,1,3,2,4,2,1,3,2,3,6,7,8,8,10,6,13,8,7,13,10,8,13,9,14,12,16,12,10,6,12,14,8,8,12,13,14,14,12,11,10,13,9,12,12,20,14,13,13,11,12,4,5,13,11,12,14,13,14,12,6,20,1,1,1,1,1,20,D C,101,1,1,1,1,1,1,20,1,1,1,1,1,1,1,1,0,0,0,0,0,0,0,0,0,0,0,0,0,0,0,0,0,0,0,0,0,0,0,0,0,0,0,0,0,0,0,0,0,0,0,0,0,0,0,0,0,0,0,0,0,0,0,0,0,Robson,£450Th. ,26,185,Defender - Centre-Back,right,Botafogo Futebol Clube (SP),36,0,0,3300,13,0,0,1112,23,2,0,2062,32,1,0,2809,nan,nan,nan,nan,Liga NOS
19-06-17,18.3.4.28,Bruno Viana,19197239,1651,05-Feb-95,22,0,0,0,0,3850,5134,5800,136,126,2266481,187,77,D C,2,2,1,2,3,1,3,3,3,2,2,6,8,8,7,11,6,15,7,7,14,10,7,14,12,14,13,14,12,12,8,12,12,5,9,7,13,14,14,13,14,13,14,8,13,13,20,13,14,12,10,10,4,5,12,12,13,9,10,12,8,8,20,1,1,1,1,1,20,D C,101,1,1,1,1,1,1,20,1,1,1,1,1,1,1,1,0,0,0,0,0,0,0,0,0,0,0,0,0,0,0,0,0,0,0,0,0,0,0,0,0,0,0,0,0,0,0,0,0,0,0,0,0,0,0,0,0,0,0,0,0,0,0,0,0,Bruno Viana,£3.60m ,25,187,Defender - Centre-Back,right,SC Braga,23,1,0,1813,35,5,2,3180,44,0,1,3979,49,1,1,4345,6,1,0,540,Liga NOS
19-06-17,18.3.4.28,Flávio Ramos,19202456,1651,12-May-94,23,0,0,0,0,2846,4916,6200,136,124,557217,192,81,D C,3,2,1,1,1,2,1,1,1,3,1,6,7,7,5,7,5,15,6,11,15,8,6,14,8,14,12,14,13,13,8,12,13,5,8,9,14,13,14,12,12,12,15,8,14,13,20,13,14,14,8,12,7,10,13,12,11,13,16,15,13,8,20,1,1,1,1,1,20,D C,101,1,1,1,1,1,1,20,1,1,1,1,1,1,1,1,0,0,0,0,0,0,0,0,0,0,0,0,0,0,0,0,0,0,0,0,0,0,0,0,0,0,0,0,0,0,0,0,0,0,0,0,0,0,0,0,0,0,0,0,0,0,0,0,0,Cláudio Ramos,£1.35m ,28,183,Goalkeeper,right,FC Porto,34,51,6,3060,35,51,8,3150,37,57,5,3390,30,37,9,2700,0,0,0,0,Liga NOS
19-06-17,18.3.4.28,Felipe Macedo,19223427,1651,27-Mar-94,23,0,0,0,0,3250,5250,5250,123,115,96976,187,76,D C,2,3,3,3,3,1,3,3,2,3,4,10,5,6,5,13,5,14,8,8,13,11,10,13,10,16,13,14,10,13,3,13,13,3,10,10,10,9,15,11,11,11,15,5,13,13,20,13,16,12,13,14,11,10,7,10,12,13,12,9,10,9,20,1,1,1,1,1,20,D C,101,1,1,1,1,1,1,20,1,1,1,1,1,1,1,1,0,0,0,0,0,0,0,0,0,0,0,0,0,0,0,0,0,0,0,0,0,0,0,0,0,0,0,0,0,0,0,0,0,0,0,0,0,0,0,0,0,0,0,0,0,0,0,0,0,Felipe Macedo,£450Th. ,26,190,Defender - Centre-Back,right,SC Covilhã,1,0,0,44,19,1,0,1538,5,0,0,103,25,2,0,2129,0,0,0,0,Liga NOS
19-06-17,18.3.4.28,Lucăo,19223736,1651,23-Mar-96,21,0,0,0,0,2250,5900,5900,130,115,991683,187,78,D C,1,4,3,1,2,3,2,3,4,2,3,6,9,8,7,8,5,14,5,8,14,13,9,13,12,13,12,10,10,10,10,11,7,10,5,11,12,11,10,13,12,12,14,12,13,14,20,13,13,10,12,10,6,13,17,11,11,12,10,9,10,3,20,1,1,1,13,13,20,D C,101,1,1,1,1,1,1,20,13,13,1,1,1,1,1,1,0,0,0,0,0,0,0,0,0,0,0,0,0,0,0,0,0,0,0,0,0,0,0,0,0,0,0,0,0,0,0,0,0,0,0,0,0,0,0,0,0,0,0,0,0,0,0,0,0,Lucão,£900Th. ,24,185,Defender - Centre-Back,right,Goiás Esporte Clube,8,0,0,653,8,0,0,707,1,0,0,90,0,0,0,0,nan,nan,nan,nan,Liga NOS
19-06-17,18.3.4.28,Cleylton,19233140,1651,19-Mar-93,24,0,0,0,0,1505,4518,4500,112,102,16439,190,83,D C,3,3,2,3,4,3,1,2,3,3,2,7,7,8,8,11,7,12,8,10,11,11,12,11,11,13,11,14,10,10,10,9,12,7,11,7,12,13,12,11,10,9,15,8,13,12,20,13,15,10,9,10,10,10,12,12,13,13,13,12,10,6,20,1,1,1,1,1,20,D C,101,1,1,1,1,1,1,20,1,1,1,1,1,1,1,1,0,0,0,0,0,0,0,0,0,0,0,0,0,0,0,0,0,0,0,0,0,0,0,0,0,0,0,0,0,0,0,0,0,0,0,0,0,0,0,0,0,0,0,0,0,0,0,0,0,Cleylton,£180Th. ,27,190,Defender - Centre-Back,right,Without Club,nan,nan,nan,nan,6,0,0,301,16,1,1,1045,18,1,0,1620,nan,nan,nan,nan,Liga NOS
19-06-17,18.3.4.28,Jardel,2114077,1651,29-Mar-86,31,0,0,0,0,6152,5896,7200,153,144,232186002,192,88,D C,1,3,2,2,3,3,3,1,2,1,2,4,4,8,9,9,6,15,6,7,15,10,11,16,9,18,17,17,11,15,6,14,16,6,16,10,16,15,15,11,11,14,16,8,15,12,20,12,15,15,12,15,12,7,14,12,18,12,18,17,13,8,20,1,1,1,1,1,20,D C,101,1,1,1,1,1,1,20,1,1,1,1,1,1,1,1,0,0,0,0,0,0,0,0,0,0,0,0,0,0,0,0,0,0,0,0,0,0,0,0,0,0,0,0,0,0,0,0,0,0,0,0,0,0,0,0,0,0,0,0,0,0,0,0,0,Jardel,£3.15m ,34,192,Defender - Centre-Back,right,SL Benfica,8,0,0,720,34,2,4,3015,37,3,1,3175,19,0,0,1583,2,0,0,77,Liga NOS
19-06-17,18.3.4.28,Li Bowen,23229306,110,23-Jan-95,22,0,0,0,0,50,2300,2300,83,51,172,181,72,D C,3,1,3,4,3,2,1,2,1,1,3,1,1,2,1,6,1,7,1,1,8,6,1,11,5,3,9,8,6,8,1,13,8,1,13,5,13,5,6,12,11,6,7,7,8,10,20,5,4,8,4,7,8,8,18,13,12,12,14,12,16,1,20,1,1,1,1,1,20,D C,101,1,1,1,1,1,1,20,1,1,1,1,1,1,1,1,0,0,0,0,0,0,0,0,0,0,0,0,0,0,0,0,0,0,0,0,0,0,0,0,0,0,0,0,0,0,0,0,0,0,0,0,0,0,0,0,0,0,0,0,0,0,0,0,0,,,,,,,,,,,,,,,,,,,,,,,,,,,,
19-06-17,18.3.4.28,Andrej Lukic,24042685,761,02-Apr-94,23,0,0,0,0,500,5550,5650,127,113,505332,187,79,D/DM C,3,2,1,1,1,3,1,1,3,2,2,5,10,8,10,10,7,14,12,6,12,12,7,14,11,16,12,16,12,8,10,12,15,11,12,10,13,10,10,9,10,13,15,9,15,11,20,13,14,12,14,12,11,12,13,16,9,10,10,1,8,13,20,1,12,5,5,5,20,D/DM C,111,1,1,10,5,1,1,20,1,1,16,12,5,5,1,1,544,0,0,0,0,0,1,0,0,0,1,0,0,0,0,0,0,0,0,0,0,0,0,0,0,0,0,0,0,0,0,0,0,0,0,0,0,0,0,0,0,0,0,0,0,0,0,0,0,Andrej Lukic,£720Th. ,26,190,Defender - Centre-Back,right,Sheriff Tiraspol,33,2,1,2302,25,4,1,1419,37,3,0,2994,2,0,0,180,12,1,2,652,Liga NOS
19-06-17,18.3.4.28,Luisăo,304150,1651,13-Feb-81,36,44,3,10,0,6350,6600,7400,153,140,232186002,193,90,D C,1,1,2,1,3,1,2,2,3,3,4,2,3,5,10,10,2,15,3,4,16,9,11,15,8,15,12,17,10,17,7,16,15,5,20,8,16,15,14,8,7,15,18,9,13,9,20,13,18,19,14,15,8,2,9,18,16,16,19,11,10,11,20,1,1,1,1,1,20,D C,101,1,5,1,1,1,1,20,1,1,1,1,1,1,1,1,2.19902E+12,0,0,0,0,0,0,0,0,0,0,0,0,0,0,0,1,0,1,0,0,0,0,0,0,0,0,0,0,0,0,0,0,0,0,0,0,0,0,0,0,0,1,0,0,0,0,0,0,Luisão,£450Th. ,39,195,Defender - Centre-Back,right,Retired,39,1,3,3328,24,2,0,2190,nan,nan,nan,nan,nan,nan,nan,nan,nan,nan,nan,nan,Liga NOS
19-06-17,18.3.4.28,Vincent Sasso,34009250,769,16-Feb-91,26,0,0,2,0,3000,5250,5700,116,114,148368,190,82,D RC,1,1,2,1,4,1,3,3,3,1,1,4,9,8,5,10,6,14,8,7,12,10,6,13,10,14,14,14,12,12,10,13,16,6,8,8,12,14,13,10,9,16,15,8,13,10,20,14,15,12,10,14,5,15,13,13,15,9,13,15,15,8,20,1,1,1,15,5,20,D RC,103,1,1,1,1,1,1,20,5,15,1,1,1,1,1,1,2.74878E+11,0,0,0,0,0,0,0,0,0,0,0,0,0,0,0,0,0,0,0,0,0,0,0,0,0,0,0,0,0,0,0,0,0,0,0,0,0,0,1,0,0,0,0,0,0,0,0,0,Vincent Sasso,£900Th. ,29,190,Defender - Centre-Back,right,Servette FC,14,2,0,1110,19,1,1,1330,34,3,1,2980,33,1,0,2891,6,0,0,540,Liga NOS
19-06-17,18.3.4.28,Yohan Tavares,34012957,788,02-Mar-88,29,0,0,0,0,4750,6150,6150,128,120,404250,188,82,D C,2,1,3,2,1,4,3,2,1,3,2,5,5,7,6,11,7,13,10,9,13,11,12,14,11,14,14,14,12,14,7,12,13,5,15,7,14,14,13,12,8,14,14,8,13,13,20,15,13,13,7,10,8,7,14,13,13,13,14,13,13,6,20,1,1,1,10,7,20,D C,101,1,1,1,1,1,1,20,7,10,1,1,1,1,1,1,0,0,0,0,0,0,0,0,0,0,0,0,0,0,0,0,0,0,0,0,0,0,0,0,0,0,0,0,0,0,0,0,0,0,0,0,0,0,0,0,0,0,0,0,0,0,0,0,0,Yohan Tavares,£540Th. ,32,188,Defender - Centre-Back,right,CD Tondela,31,1,0,2548,15,1,1,1350,37,1,0,3360,30,3,0,2603,5,0,0,413,Liga NOS
19-06-17,18.3.4.28,Douglas,37007329,784,12-Jan-88,29,0,0,0,0,5750,6500,6250,145,125,887590,192,80,D C,3,3,1,3,1,2,2,2,1,1,1,6,7,8,8,11,10,16,7,12,15,10,8,14,12,15,14,15,13,11,12,13,12,9,10,12,12,13,12,9,9,14,16,11,17,10,20,12,14,12,13,16,5,4,16,10,14,11,13,11,13,10,20,1,1,1,12,1,20,D C,101,1,1,1,1,1,1,20,1,12,8,1,1,1,1,1,0,0,0,0,0,0,0,0,0,0,0,0,0,0,0,0,0,0,0,0,0,0,0,0,0,0,0,0,0,0,0,0,0,0,0,0,0,0,0,0,0,0,0,0,0,0,0,0,0,Douglas,£360Th. ,32,192,Defender - Centre-Back,right,Würzburger Kickers,8,0,0,674,nan,nan,nan,nan,nan,nan,nan,nan,0,0,0,0,4,0,0,275,Liga NOS
19-06-17,18.3.4.28,Antonio Briseńo,51015271,379,05-Feb-94,23,0,0,0,0,3000,5900,5900,135,118,269379,186,80,D LC,4,1,2,1,2,2,3,3,1,1,3,7,7,9,8,11,7,12,7,15,13,11,12,13,11,13,13,14,13,13,8,12,12,9,15,8,13,14,12,11,10,11,12,9,15,13,20,14,13,13,9,12,10,12,13,14,12,13,15,14,13,7,20,1,1,1,1,15,20,D LC,104,1,1,1,1,1,1,20,15,1,1,1,1,1,1,1,0,0,0,0,0,0,0,0,0,0,0,0,0,0,0,0,0,0,0,0,0,0,0,0,0,0,0,0,0,0,0,0,0,0,0,0,0,0,0,0,0,0,0,0,0,0,0,0,0,Antonio Briseño,£630Th. ,26,185,Defender - Centre-Back,right,Deportivo Guadalajara,35,2,0,3084,20,2,0,1474,40,3,0,3562,17,1,1,1376,5,0,0,216,Liga NOS
19-06-17,18.3.4.28,Henrique,55004803,788,19-Oct-86,30,0,0,0,0,4500,6250,6250,130,125,232186002,187,77,D C,1,3,3,1,1,2,1,2,2,2,1,6,6,8,7,9,7,14,11,8,14,12,8,15,11,12,14,12,12,13,8,12,12,8,12,8,14,13,13,11,12,13,14,11,11,11,20,13,12,13,11,10,15,8,10,14,11,11,15,10,11,10,20,1,1,1,13,7,20,D C,101,1,1,1,1,1,1,20,7,13,1,1,1,1,1,1,0,0,0,0,0,0,0,0,0,0,0,0,0,0,0,0,0,0,0,0,0,0,0,0,0,0,0,0,0,0,0,0,0,0,0,0,0,0,0,0,0,0,0,0,0,0,0,0,0,Nuno Henrique,£180Th. ,34,186,Defender - Centre-Back,right,LusitÃ¢nia FC Lourosa,14,2,0,1122,14,1,0,1119,2,1,0,180,2,0,0,240,nan,nan,nan,nan,Liga NOS
19-06-17,18.3.4.28,André Pinto,55009586,788,05-Oct-89,27,1,0,12,0,5000,6600,6600,138,132,3939997,192,86,D C,2,1,2,2,1,1,3,3,2,1,2,6,7,7,9,11,14,12,13,13,15,12,12,14,11,12,11,13,13,13,11,14,12,6,15,11,14,12,12,9,10,16,16,10,13,10,20,14,15,15,10,13,8,8,11,14,8,9,14,13,12,6,20,1,1,1,1,1,20,D C,101,1,1,1,1,1,1,20,1,1,1,1,1,1,1,1,3.51844E+13,0,0,0,0,0,0,0,0,0,1,0,0,0,0,0,0,0,0,0,0,0,0,0,0,0,0,0,0,0,0,0,0,0,0,0,0,0,0,0,0,0,0,0,0,0,1,0,0,André Pinto,£2.48m ,31,194,Defender - Centre-Back,right,Without Club,15,3,0,1307,17,0,1,1357,24,0,0,1645,14,0,0,1165,nan,nan,nan,nan,Liga NOS
19-06-17,18.3.4.28,Nuno Reis,55012973,788,31-Jan-91,26,0,0,2,0,2500,5250,5250,115,105,70031,182,75,D/DM C,2,3,1,4,3,3,1,2,3,3,1,6,9,10,6,11,10,11,6,7,13,10,6,12,12,14,12,12,13,10,9,11,14,8,13,9,13,14,13,10,10,13,12,8,11,11,20,12,13,10,10,3,7,9,9,13,12,13,12,9,12,6,19,10,14,1,14,1,19,D/DM C,321,1,10,1,1,1,1,19,1,14,20,14,1,1,1,10,0,0,0,0,0,0,0,0,0,0,0,0,0,0,0,0,0,0,0,0,0,0,0,0,0,0,0,0,0,0,0,0,0,0,0,0,0,0,0,0,0,0,0,0,0,0,0,0,0,Nuno Reis,£720Th. ,29,182,Defender - Centre-Back,right,Without Club,29,1,0,1336,20,0,0,1253,30,1,0,2538,23,0,0,1897,nan,nan,nan,nan,Liga NOS
19-06-17,18.3.4.28,Luís Rocha,55013957,788,13-Aug-86,30,0,0,0,0,3000,5400,5400,113,108,85879,186,85,D C,1,2,2,3,2,3,2,3,3,1,2,5,4,6,7,7,6,15,6,7,13,6,6,14,8,15,12,14,13,13,7,12,12,7,12,9,14,13,12,8,10,12,14,6,15,10,20,13,15,11,5,12,5,5,13,12,10,11,15,13,15,7,20,1,1,1,7,1,20,D C,101,1,10,1,1,1,1,20,1,7,1,1,1,1,1,1,5.6295E+14,0,0,0,0,0,0,0,0,0,0,0,0,0,0,0,0,1,0,0,0,0,0,0,0,0,0,0,0,0,0,0,0,0,0,0,0,0,0,0,0,0,0,0,0,0,0,0,0,Luís Rocha,£270Th. ,34,186,Defender - Centre-Back,right,GD Chaves,24,0,0,2019,33,6,0,2684,14,2,0,1262,24,3,1,2160,7,2,0,630,Liga NOS
19-06-17,18.3.4.28,Marco Baixinho,55021966,788,11-Jul-89,27,0,0,0,0,3500,6100,6100,136,122,428120,187,81,D C,3,2,3,4,4,1,1,2,1,1,2,4,5,6,5,10,3,13,4,7,14,11,11,14,12,11,13,14,12,16,8,13,14,4,15,7,14,14,14,12,12,14,14,5,15,12,20,13,13,13,4,12,11,6,17,13,15,13,16,16,14,5,20,1,1,1,1,1,20,D C,101,1,1,1,1,1,1,20,1,1,13,1,1,1,1,1,0,0,0,0,0,0,0,0,0,0,0,0,0,0,0,0,0,0,0,0,0,0,0,0,0,0,0,0,0,0,0,0,0,0,0,0,0,0,0,0,0,0,0,0,0,0,0,0,0,Marco Baixinho,£450Th. ,31,187,Defender - Centre-Back,right,FC Paços de Ferreira,25,1,2,2149,18,1,0,1529,38,5,2,3450,32,3,0,2598,5,0,0,450,Liga NOS
19-06-17,18.3.4.28,Diego Galo,55023835,1651,14-Jan-84,33,0,0,0,0,3562,4835,5750,120,115,72030,185,81,D C,1,2,2,1,1,3,3,1,1,3,2,2,3,7,2,10,2,13,2,10,13,11,8,13,11,10,11,14,11,14,9,13,12,5,12,4,14,13,12,12,11,14,14,9,13,12,20,11,13,14,8,11,8,10,13,14,8,13,13,12,10,7,20,1,1,1,5,1,20,D C,101,1,5,1,1,1,1,20,1,5,8,1,1,1,1,1,0,0,0,0,0,0,0,0,0,0,0,0,0,0,0,0,0,0,0,0,0,0,0,0,0,0,0,0,0,0,0,0,0,0,0,0,0,0,0,0,0,0,0,0,0,0,0,0,0,Diego Galo,£90Th. ,36,185,Defender - Centre-Back,right,União de Leiria,36,0,0,3209,37,0,1,3204,28,2,0,2473,24,2,1,2220,nan,nan,nan,nan,Liga NOS
19-06-17,18.3.4.28,Ricardo Ferreira,55024245,788,25-Nov-92,24,0,0,1,0,4500,6400,6000,142,128,916567,190,76,D C,1,2,3,1,2,3,1,2,1,1,3,5,8,10,8,12,5,14,8,10,15,13,5,14,13,13,12,12,12,13,10,12,11,5,11,8,14,13,13,12,12,13,14,10,14,12,20,12,14,14,10,13,14,5,14,15,13,7,16,13,13,6,20,1,1,1,1,1,20,D C,101,1,1,1,1,1,1,20,1,1,1,1,1,1,1,1,1.15292E+18,0,0,0,0,0,0,0,0,0,0,0,0,0,0,0,0,0,0,0,0,0,0,0,0,0,0,0,0,0,0,0,0,0,0,0,0,0,0,0,0,0,0,0,0,0,0,0,0,Ricardo Ferreira,£1.58m ,27,190,Defender - Centre-Back,right,SC Farense,14,1,0,1080,14,1,0,1190,1,0,0,37,5,0,0,352,nan,nan,nan,nan,Liga NOS
19-06-17,18.3.4.28,Tiago Duque,55024900,788,25-Jun-94,22,0,0,0,0,2250,5000,5000,120,107,73401,187,81,D LC,4,2,2,1,1,3,1,3,2,2,3,6,9,7,5,10,6,12,8,10,12,11,9,12,11,14,12,11,10,11,6,10,8,4,10,7,13,12,12,11,12,13,14,20,13,12,10,13,13,13,5,10,5,12,8,12,10,10,12,11,11,8,20,1,1,1,10,19,20,D LC,104,1,1,1,1,1,1,20,19,10,1,1,1,1,1,1,0,0,0,0,0,0,0,0,0,0,0,0,0,0,0,0,0,0,0,0,0,0,0,0,0,0,0,0,0,0,0,0,0,0,0,0,0,0,0,0,0,0,0,0,0,0,0,0,0,,,,,,,,,,,,,,,,,,,,,,,,,,,,
19-06-17,18.3.4.28,Gonçalo Silva,55029114,788,04-Jun-91,26,0,0,1,0,2250,6250,6250,126,125,622870,186,80,D C,3,2,3,2,3,3,4,2,3,2,2,6,7,10,6,12,6,13,5,6,14,12,2,13,12,11,16,15,8,14,7,10,12,6,14,8,12,13,14,14,13,13,13,12,12,14,20,14,12,12,8,11,8,8,14,14,11,12,12,10,14,5,20,1,1,1,10,1,20,D C,101,1,1,1,1,1,1,20,1,10,1,1,1,1,1,1,0,0,0,0,0,0,0,0,0,0,0,0,0,0,0,0,0,0,0,0,0,0,0,0,0,0,0,0,0,0,0,0,0,0,0,0,0,0,0,0,0,0,0,0,0,0,0,0,0,Gonçalo Silva,£1.13m ,29,186,Defender - Centre-Back,right,Belenenses SAD,25,2,0,2179,36,0,0,3240,37,0,3,3272,21,1,1,1793,nan,nan,nan,nan,Liga NOS
19-06-17,18.3.4.28,Talocha,55034680,788,30-Aug-89,27,0,0,0,0,2500,5750,5750,123,115,126188,179,75,D LC,1,3,1,3,3,2,3,1,3,3,1,10,12,10,7,11,8,13,7,11,13,11,10,13,12,12,11,13,11,13,8,12,12,7,10,12,13,13,13,11,12,14,13,20,14,11,7,14,13,14,2,11,2,10,13,13,14,12,13,12,11,3,20,10,10,5,1,20,18,D LC,104,1,1,1,1,5,1,18,20,1,1,1,10,1,10,1,0,0,0,0,0,0,0,0,0,0,0,0,0,0,0,0,0,0,0,0,0,0,0,0,0,0,0,0,0,0,0,0,0,0,0,0,0,0,0,0,0,0,0,0,0,0,0,0,0,,,,,,,,,,,,,,,,,,,,,,,,,,,,
19-06-17,18.3.4.28,Hugo Basto,55038670,788,14-May-93,24,0,0,0,0,3500,5900,5900,135,118,269379,188,83,D C,2,3,1,1,3,4,2,4,1,4,1,4,6,9,7,12,6,12,6,8,13,12,7,14,12,9,12,12,12,12,8,13,12,5,10,8,14,14,13,12,12,13,14,8,15,12,20,13,12,15,8,12,3,10,18,15,14,12,15,15,11,5,20,1,1,1,7,7,20,D C,101,1,1,1,1,1,1,20,7,7,1,1,1,1,1,1,1.15292E+18,0,0,0,0,0,0,0,0,0,0,0,0,0,0,0,1,0,0,0,0,0,0,0,0,0,0,0,0,0,0,0,0,0,0,0,0,0,0,0,0,0,0,0,0,0,0,0,0,Hugo Basto,£315Th. ,27,188,Defender - Centre-Back,right,GD Estoril Praia,25,0,0,1799,12,0,0,921,7,0,0,552,18,0,1,1548,7,2,0,630,Liga NOS
19-06-17,18.3.4.28,Domingos Duarte,55063355,788,10-Mar-95,22,0,0,1,0,3750,6000,6000,135,120,76087,190,84,D C,3,1,2,3,3,1,2,1,2,4,3,4,5,8,7,10,5,13,5,8,15,10,10,13,10,12,12,13,11,14,8,11,12,6,12,7,14,14,13,11,11,13,15,8,16,12,20,13,14,12,13,11,10,3,15,11,14,11,15,15,15,5,20,1,1,1,1,1,20,D C,101,1,1,1,1,1,1,20,1,1,1,1,1,1,1,1,0,0,0,0,0,0,0,0,0,0,0,0,0,0,0,0,0,0,0,0,0,0,0,0,0,0,0,0,0,0,0,0,0,0,0,0,0,0,0,0,0,0,0,0,0,0,0,0,0,Domingos Duarte,£1.80m ,25,192,Defender - Centre-Back,right,Granada CF,32,1,0,2787,32,0,0,2857,43,4,0,3838,39,3,1,3350,7,0,0,450,Liga NOS
19-06-17,18.3.4.28,Joăo Afonso,55063744,788,28-May-90,27,0,0,0,0,3450,6000,6000,125,120,591252,188,85,D C,2,3,2,2,3,3,2,3,1,1,3,6,7,7,7,10,8,15,8,8,14,11,8,14,9,12,13,12,9,15,8,10,12,5,12,7,15,13,14,9,9,14,15,10,11,13,20,13,14,11,11,10,4,11,17,13,14,12,15,15,14,6,20,1,1,1,7,7,20,D C,101,1,7,1,1,1,1,20,7,7,7,1,1,1,1,1,0,0,0,0,0,0,0,0,0,0,0,0,0,0,0,0,0,0,0,0,0,0,0,0,0,0,0,0,0,0,0,0,0,0,0,0,0,0,0,0,0,0,0,0,0,0,0,0,0,João Afonso,£900Th. ,30,188,Defender - Centre-Back,right,CD Santa Clara,36,0,1,3270,30,1,0,2407,6,1,1,540,38,4,3,3246,5,0,0,450,Liga NOS
19-06-17,18.3.4.28,Miguel Vieira,55066351,788,08-Oct-90,26,0,0,0,0,3000,6250,6250,128,125,622870,190,84,D C,3,2,1,2,1,3,3,1,1,3,3,4,6,11,6,11,8,14,6,8,14,12,7,15,13,12,12,12,13,12,10,13,13,10,12,11,12,12,12,11,12,14,14,11,12,11,20,13,14,13,8,10,13,10,10,12,11,14,14,13,14,6,20,1,1,1,1,1,20,D C,101,1,1,1,1,1,1,20,1,1,1,1,1,1,1,1,32,0,0,0,0,0,1,0,0,0,0,0,0,0,0,0,0,0,0,0,0,0,0,0,0,0,0,0,0,0,0,0,0,0,0,0,0,0,0,0,0,0,0,0,0,0,0,0,0,Miguel Vieira,£630Th. ,30,190,Defender - Centre-Back,left,Waasland-Beveren,17,1,0,1455,34,4,1,2994,37,1,0,3317,13,0,1,914,nan,nan,nan,nan,Liga NOS
19-06-17,18.3.4.28,Pedro Pinto,55067742,788,08-Nov-94,22,0,0,0,0,2000,5600,5600,133,112,411699,187,79,D C,2,1,1,2,1,2,2,3,1,2,2,8,6,7,8,11,8,13,8,9,13,10,8,13,9,10,13,12,13,13,7,9,13,8,13,8,13,10,13,12,12,13,13,12,12,12,20,12,13,8,8,8,8,8,14,15,14,15,13,14,10,6,20,1,1,1,1,1,20,D C,101,1,1,1,1,1,1,20,1,1,10,1,1,1,1,1,0,0,0,0,0,0,0,0,0,0,0,0,0,0,0,0,0,0,0,0,0,0,0,0,0,0,0,0,0,0,0,0,0,0,0,0,0,0,0,0,0,0,0,0,0,0,0,0,0,Pedro Pinto,£540Th. ,25,187,Defender - Centre-Back,both,Leixões SC,10,0,0,774,30,1,1,2285,20,0,1,1800,17,2,0,1483,2,0,0,146,Liga NOS
19-06-17,18.3.4.28,Rui Correia,55067761,788,23-Aug-90,26,0,0,0,0,3350,5650,5650,122,113,136958,188,78,D C,2,3,1,1,1,2,3,2,3,2,3,4,3,6,5,8,6,13,5,10,12,10,6,14,11,12,14,11,12,10,8,11,12,3,8,10,13,14,13,13,13,13,14,8,14,13,20,13,13,15,3,9,10,11,12,16,11,11,16,15,10,9,20,1,1,1,1,1,20,D C,101,1,1,1,1,1,1,20,1,1,15,1,1,1,1,1,32768,0,0,0,0,0,0,0,0,0,0,0,0,0,0,0,1,0,0,0,0,0,0,0,0,0,0,0,0,0,0,0,0,0,0,0,0,0,0,0,0,0,0,0,0,0,0,0,0,Rui Correia,£540Th. ,30,188,Defender - Centre-Back,left,CD Nacional,24,0,0,2131,17,0,1,1291,4,0,0,360,19,0,0,1650,0,0,0,0,Liga NOS
19-06-17,18.3.4.28,Rúben Dias,55070299,788,14-May-97,20,0,0,0,0,2200,6700,6700,155,134,11220153,187,83,D C,1,1,2,1,1,2,3,2,1,1,2,4,5,10,6,11,5,14,4,5,14,10,7,14,10,16,14,16,13,13,7,14,15,4,15,7,13,15,14,13,12,14,14,10,15,13,20,13,15,13,11,12,4,8,11,14,16,12,16,13,12,7,20,1,1,1,1,1,20,D C,101,1,1,1,1,1,1,20,1,1,1,1,1,1,1,1,1.15292E+18,0,0,0,0,0,0,0,0,0,0,0,0,0,0,0,0,0,0,0,0,0,0,0,0,0,0,0,0,0,0,0,0,0,0,0,0,0,0,0,0,0,0,0,0,0,0,0,0,Rúben Dias,£19.80m ,23,187,Defender - Centre-Back,right,Manchester City,35,0,2,3210,31,4,0,2781,55,4,3,4923,49,3,3,4410,7,1,0,630,Liga NOS
19-06-17,18.3.4.28,Jorge Fernandes,55070305,788,02-Apr-97,20,0,0,0,0,2000,4600,4600,123,92,56036,193,86,D C,2,2,1,3,3,1,1,3,1,1,1,3,6,6,5,8,3,12,6,8,13,8,10,12,8,11,9,11,8,13,6,10,12,6,10,6,13,12,12,9,8,12,14,6,13,11,20,11,14,12,11,10,5,11,9,10,16,9,16,14,13,7,20,1,1,1,10,1,20,D C,101,1,1,1,1,1,1,20,1,10,1,1,1,1,1,1,0,0,0,0,0,0,0,0,0,0,0,0,0,0,0,0,0,0,0,0,0,0,0,0,0,0,0,0,0,0,0,0,0,0,0,0,0,0,0,0,0,0,0,0,0,0,0,0,0,Jorge Fernandes,£900Th. ,23,195,Defender - Centre-Back,right,Vitória Guimarães SC,27,0,0,2382,30,1,1,2556,24,1,0,1971,22,0,0,1576,5,0,0,443,Liga NOS
19-06-17,18.3.4.28,Junior Pius,55072272,38,20-Dec-95,21,0,0,0,0,1328,3455,3250,116,95,8430,193,0,D C,3,1,2,1,3,3,1,2,2,4,3,3,4,5,3,6,5,13,6,5,13,7,8,13,9,15,11,12,12,11,7,11,12,8,6,10,11,11,12,11,10,11,14,9,13,10,20,12,13,12,10,12,9,10,12,11,11,10,12,16,13,14,20,1,1,1,1,1,20,D C,101,1,1,1,1,1,1,20,1,1,1,1,1,1,1,1,0,0,0,0,0,0,0,0,0,0,0,0,0,0,0,0,0,0,0,0,0,0,0,0,0,0,0,0,0,0,0,0,0,0,0,0,0,0,0,0,0,0,0,0,0,0,0,0,0,Júnior Pius,£135Th. ,24,193,Defender - Centre-Back,right,Royal Antwerp FC,nan,nan,nan,nan,3,0,0,171,33,3,3,3000,2,0,0,115,6,2,0,340,Liga NOS
19-06-17,18.3.4.28,Jefferson,55072306,1651,14-Apr-93,24,0,0,0,0,3250,5250,5600,115,112,50318,190,86,DM/M C,3,1,2,1,3,3,4,1,2,3,3,4,7,10,9,9,7,13,12,5,12,11,10,13,11,16,14,17,6,12,6,8,15,11,12,9,15,16,16,10,8,14,15,10,13,11,20,16,17,16,12,10,5,13,14,12,10,12,12,7,10,5,15,1,17,10,1,1,17,DM/M C,311,1,1,10,10,1,1,15,1,1,20,17,1,1,1,1,256,0,0,0,0,0,0,0,0,1,0,0,0,0,0,0,0,0,0,0,0,0,0,0,0,0,0,0,0,0,0,0,0,0,0,0,0,0,0,0,0,0,0,0,0,0,0,0,0,Jefferson,£3.15m ,32,176,Defender - Left-Back,left,Casa Pia AC,17,0,1,1170,39,0,12,3540,22,0,4,1394,8,1,1,317,0,0,0,0,Liga NOS
19-06-17,18.3.4.28,Ponck,55076417,12,13-Jan-95,22,2,0,0,0,3279,5601,6450,138,129,235651,183,84,D/DM C,3,2,3,1,1,3,4,3,1,3,3,6,7,8,6,11,5,13,9,8,13,10,4,15,11,17,13,15,8,12,7,10,12,6,10,9,14,14,12,14,13,15,14,11,15,14,20,15,16,12,14,11,3,10,13,11,8,13,13,9,15,8,20,1,12,1,1,1,20,D/DM C,111,1,1,1,1,1,1,20,1,1,20,12,1,1,1,1,8589934592,0,0,0,0,0,0,0,0,0,0,0,0,0,0,0,0,0,0,0,0,0,0,0,0,0,0,0,0,0,0,0,0,0,1,0,0,0,0,0,0,0,0,0,0,0,0,0,0,Ponck,£1.13m ,25,183,Defender - Centre-Back,right,Istanbul Basaksehir FK,38,1,0,3027,34,1,0,3120,36,2,1,3123,33,1,0,2435,3,0,0,196,Liga NOS
19-06-17,18.3.4.28,Iago,55078574,1651,22-May-92,25,0,0,0,0,2172,3585,5250,115,105,66345,188,85,D C,2,2,3,2,3,3,2,4,2,3,3,5,6,8,4,9,5,13,6,9,13,9,6,12,8,13,12,12,10,11,8,9,11,5,8,6,10,12,12,13,12,13,15,11,13,14,20,13,13,9,12,7,10,14,12,10,12,8,13,13,14,8,20,1,1,1,10,1,20,D C,101,1,1,1,1,1,1,20,1,10,10,1,1,1,1,1,0,0,0,0,0,0,0,0,0,0,0,0,0,0,0,0,0,0,0,0,0,0,0,0,0,0,0,0,0,0,0,0,0,0,0,0,0,0,0,0,0,0,0,0,0,0,0,0,0,,,,,,,,,,,,,,,,,,,,,,,,,,,,
19-06-17,18.3.4.28,Nélson Monte,55078869,788,20-Jul-95,21,0,0,0,0,2800,5950,5950,136,119,286015,187,82,D RC,2,3,2,3,1,3,1,3,1,1,2,4,10,10,5,10,3,11,6,10,13,12,3,13,12,14,13,12,13,13,12,12,12,4,10,8,14,14,14,13,13,12,13,10,13,13,20,13,11,12,12,10,5,10,17,11,13,14,14,13,16,5,20,1,1,1,16,1,20,D RC,103,1,1,1,1,1,1,20,1,16,1,1,1,1,1,1,32832,0,0,0,0,0,0,1,0,0,0,0,0,0,0,0,1,0,0,0,0,0,0,0,0,0,0,0,0,0,0,0,0,0,0,0,0,0,0,0,0,0,0,0,0,0,0,0,0,Nélson Monte,£1.80m ,25,187,Defender - Centre-Back,right,Rio Ave FC,12,0,0,1031,33,0,1,2806,18,0,1,1446,25,0,0,2009,6,0,0,539,Liga NOS
19-06-17,18.3.4.28,Nuno Tomás,55079051,788,15-Sep-95,21,0,0,0,0,2250,5850,5850,128,117,252925,184,84,D C,3,2,3,3,4,1,2,1,1,1,1,6,9,8,6,9,8,14,8,10,13,9,8,13,9,14,13,13,12,14,8,12,13,5,11,8,13,13,14,12,12,13,13,20,14,11,9,13,12,14,8,11,6,6,14,11,15,10,16,15,15,7,20,1,1,1,1,1,20,D C,101,1,1,1,1,1,1,20,1,1,1,1,1,1,1,1,0,0,0,0,0,0,0,0,0,0,0,0,0,0,0,0,0,0,0,0,0,0,0,0,0,0,0,0,0,0,0,0,0,0,0,0,0,0,0,0,0,0,0,0,0,0,0,0,0,Nuno Tomás,£1.35m ,25,184,Defender - Centre-Back,left,Kuopion Palloseura,1,0,0,90,31,3,1,2709,20,0,1,1473,27,0,0,2335,4,0,0,366,Liga NOS
19-06-17,18.3.4.28,Silvério,55082029,788,26-Dec-95,21,0,0,0,0,1750,5000,5000,126,100,94335,186,75,D C,3,3,1,3,2,1,3,2,2,1,3,4,6,4,5,10,3,14,5,4,13,12,4,12,11,12,14,12,11,9,6,11,14,5,8,9,12,13,13,11,11,12,13,7,14,11,20,11,12,14,5,7,6,5,18,14,11,12,14,11,9,11,20,1,1,1,1,1,20,D C,101,1,1,1,1,1,1,20,1,1,1,1,1,1,1,1,0,0,0,0,0,0,0,0,0,0,0,0,0,0,0,0,0,0,0,0,0,0,0,0,0,0,0,0,0,0,0,0,0,0,0,0,0,0,0,0,0,0,0,0,0,0,0,0,0,Silvério,£180Th. ,24,186,Defender - Centre-Back,both,Académica Coimbra,28,0,0,2372,0,0,0,0,27,2,0,2333,23,3,0,1872,7,0,1,620,Liga NOS
19-06-17,18.3.4.28,Pedro Monteiro,55082881,788,30-Jan-94,23,0,0,0,0,3250,5500,5500,115,105,149658,192,85,D C,2,1,3,3,2,3,1,2,3,3,1,6,6,5,5,10,4,13,6,10,13,11,10,12,8,11,12,12,10,13,7,10,13,4,10,8,12,12,12,10,10,14,15,10,13,10,20,14,13,14,4,6,10,7,14,13,11,10,16,15,14,6,20,1,1,1,1,1,20,D C,101,1,1,1,1,1,1,20,1,1,1,1,1,1,1,1,0,0,0,0,0,0,0,0,0,0,0,0,0,0,0,0,0,0,0,0,0,0,0,0,0,0,0,0,0,0,0,0,0,0,0,0,0,0,0,0,0,0,0,0,0,0,0,0,0,Pedro Monteiro,£270Th. ,26,192,Defender - Centre-Back,right,CD Feirense,12,0,0,1110,18,1,1,1543,25,1,0,2146,11,0,0,721,5,0,0,424,Liga NOS
19-06-17,18.3.4.28,Lazar Rosic,62070422,802,29-Jun-93,23,0,0,0,0,3290,5062,5400,132,118,342491,190,85,D C,3,4,1,1,1,3,3,1,3,1,2,7,7,6,5,9,6,14,7,7,13,9,7,13,9,14,13,13,12,12,11,12,13,8,13,11,13,12,14,11,12,12,14,10,12,11,20,13,14,12,10,10,9,8,13,13,11,13,9,8,8,14,20,1,1,1,1,1,20,D C,101,1,1,1,1,1,1,20,1,1,1,1,1,1,1,1,131072,0,0,0,0,0,0,0,0,0,0,0,0,0,0,0,0,0,1,0,0,0,0,0,0,0,0,0,0,0,0,0,0,0,0,0,0,0,0,0,0,0,0,0,0,0,0,0,0,Lazar Rosic,£900Th. ,27,190,Defender - Centre-Back,right,Moreirense FC,33,2,0,2649,15,0,0,1380,14,0,0,1102,18,2,0,1620,5,0,0,450,Liga NOS
19-06-17,18.3.4.28,Nikola Maras,62127145,802,19-Dec-95,21,2,0,5,2,3250,5600,6200,143,124,557217,186,78,D C,4,3,2,2,1,1,1,2,2,2,2,7,7,8,8,11,8,14,7,7,13,11,10,13,12,12,13,12,13,14,11,14,12,10,16,10,14,13,13,10,12,12,13,10,9,10,20,13,13,15,11,9,9,9,12,12,13,12,11,12,12,7,20,1,1,1,1,1,20,D C,101,1,1,1,1,1,1,20,1,1,12,1,1,1,1,1,0,0,0,0,0,0,0,0,0,0,0,0,0,0,0,0,0,0,0,0,0,0,0,0,0,0,0,0,0,0,0,0,0,0,0,0,0,0,0,0,0,0,0,0,0,0,0,0,0,Nikola Maras,£1.80m ,24,189,Defender - Centre-Back,right,UD Almería,36,2,0,3270,38,1,0,3375,31,4,1,2697,39,3,0,3407,5,0,0,450,Liga NOS
19-06-17,18.3.4.28,Iván Marcano,67009719,796,23-Jun-87,29,0,0,1,0,5000,7250,7300,148,146,27455699,189,83,D C,3,1,2,4,3,1,2,4,1,3,3,8,11,9,10,11,6,15,7,14,15,12,7,16,13,12,15,13,14,15,11,13,14,6,16,9,15,16,15,11,11,14,15,20,16,12,11,16,14,16,13,12,6,12,12,15,15,12,18,13,12,4,20,1,1,1,1,14,20,D C,101,1,9,1,1,1,1,20,14,1,10,1,1,1,1,1,4294967296,0,0,0,0,0,0,0,0,0,0,0,0,0,0,0,0,0,0,0,0,0,0,0,0,0,0,0,0,0,0,0,0,1,0,0,0,0,0,0,0,0,0,0,0,0,0,0,0,Iván Marcano,£7.20m ,33,189,Defender - Centre-Back,left,FC Porto,46,5,2,4170,46,7,1,4033,13,1,0,1056,37,6,1,3330,nan,nan,nan,nan,Liga NOS
19-06-17,18.3.4.28,Vasco Fernandes,727458,788,12-Nov-86,30,0,0,11,0,4400,5900,5900,123,118,232186002,182,79,D RC,4,2,2,2,2,1,2,1,3,1,2,7,9,9,6,10,8,10,9,8,13,11,10,14,11,12,15,14,11,10,8,12,15,12,15,10,12,14,13,13,13,13,12,8,16,14,20,14,12,12,14,12,6,12,13,14,10,12,15,14,15,6,20,1,1,1,18,1,20,D RC,103,1,1,1,1,1,1,20,1,18,14,1,1,1,1,1,34,0,1,0,0,0,1,0,0,0,0,0,0,0,0,0,0,0,0,0,0,0,0,0,0,0,0,0,0,0,0,0,0,0,0,0,0,0,0,0,0,0,0,0,0,0,0,0,0,Vasco Fernandes,£720Th. ,33,182,Defender - Centre-Back,right,Ümraniyespor,34,2,0,2901,27,2,2,2366,37,1,1,3360,20,1,1,1770,5,1,0,377,Liga NOS
19-06-17,18.3.4.28,Ricardo Costa,728186,788,16-May-81,36,22,1,23,0,4500,6250,6250,140,125,232186002,183,80,D C,3,3,3,1,2,1,3,1,2,3,3,4,5,6,7,8,10,17,9,11,15,9,12,14,8,18,14,17,12,12,8,13,15,5,14,8,15,16,12,8,10,12,13,11,13,10,20,10,14,13,16,15,9,15,12,16,12,13,18,9,10,5,20,1,1,1,13,10,20,D C,101,1,10,1,1,1,1,20,10,13,10,1,1,1,1,1,2.3365E+12,0,0,0,0,0,0,0,0,0,0,0,0,0,0,0,1,1,0,0,0,0,0,0,0,0,1,0,0,0,0,0,0,0,0,0,0,0,1,0,0,0,1,0,0,0,0,0,0,Ricardo Costa,£225Th. ,39,184,Defender - Centre-Back,right,Retired,39,1,1,3275,34,2,0,3023,31,1,1,2764,32,1,0,2748,nan,nan,nan,nan,Liga NOS
19-06-17,18.3.4.28,Ricardo,735107,12,19-Aug-80,36,17,1,0,0,4750,6000,6000,128,120,25430,185,80,D RC,2,1,1,2,2,3,1,1,2,3,3,7,7,6,5,9,9,14,9,11,14,9,8,14,9,14,12,14,10,14,7,12,15,7,17,6,14,13,15,10,12,14,15,7,16,10,20,12,13,12,11,8,8,12,12,12,14,11,15,12,14,6,20,1,1,1,15,1,20,D RC,103,1,5,1,1,1,1,20,1,15,13,1,1,1,1,1,64,0,0,0,0,0,0,1,0,0,0,0,0,0,0,0,0,0,0,0,0,0,0,0,0,0,0,0,0,0,0,0,0,0,0,0,0,0,0,0,0,0,0,0,0,0,0,0,0,Ricardo,£90Th. ,40,186,Defender - Centre-Back,right,Retired,16,2,0,1440,20,0,0,1568,33,0,0,2969,16,0,0,1165,nan,nan,nan,nan,Liga NOS
19-06-17,18.3.4.28,André Micael,744129,788,04-Feb-89,28,0,0,0,0,2750,5450,5450,116,109,110575,188,83,D C,3,1,3,1,2,3,1,2,1,1,2,6,6,7,6,10,9,12,8,9,14,7,10,11,10,12,13,11,13,12,7,11,12,7,12,8,13,12,12,11,10,12,14,7,13,12,20,13,14,11,10,12,7,7,10,10,14,12,14,14,14,6,20,1,1,1,1,1,20,D C,101,1,1,1,1,1,1,20,1,1,1,1,1,1,1,1,0,0,0,0,0,0,0,0,0,0,0,0,0,0,0,0,0,0,0,0,0,0,0,0,0,0,0,0,0,0,0,0,0,0,0,0,0,0,0,0,0,0,0,0,0,0,0,0,0,André Micael,£540Th. ,31,188,Defender - Centre-Back,right,Varzim SC,23,1,0,2070,16,1,1,1305,12,0,0,907,11,1,0,927,7,0,0,630,Liga NOS
19-06-17,18.3.4.28,José Semedo,744525,788,11-Jan-85,32,0,0,13,1,3250,5400,5400,116,108,232186002,183,80,D/DM/M C,3,1,1,2,1,2,2,1,3,1,1,5,7,8,3,10,4,8,2,10,13,8,4,14,10,14,12,15,10,13,6,13,16,4,15,6,12,16,16,9,8,16,10,7,13,11,20,17,16,12,12,14,4,13,12,6,18,13,16,12,8,6,18,6,16,1,14,1,18,D/DM/M C,331,1,5,1,1,1,1,18,1,14,20,16,1,1,1,6,8606711872,0,0,0,0,0,0,1,0,0,0,0,0,0,0,0,0,0,0,0,0,0,0,0,0,1,0,0,0,0,0,0,0,0,1,0,0,0,0,0,0,0,0,0,0,0,0,0,0,José Semedo,£225Th. ,35,183,Midfielder - Defensive Midfield,right,Vitória Setúbal FC,11,0,0,379,20,0,0,1623,34,2,0,2767,34,1,0,3040,nan,nan,nan,nan,Liga NOS
19-06-17,18.3.4.28,Gonçalo Brandăo,744606,788,09-Oct-86,30,2,0,8,0,5000,5750,5750,115,115,161066,182,78,D C,2,1,3,2,1,2,1,2,4,3,1,12,11,11,5,11,10,12,8,10,14,11,10,13,12,11,14,12,13,14,8,11,13,6,15,9,14,15,12,10,10,13,14,20,12,12,4,14,12,14,6,12,11,11,12,14,14,13,15,14,15,5,20,1,1,1,1,14,20,D C,101,1,1,1,1,1,1,20,14,1,1,1,1,1,1,1,17179871232,0,0,0,0,0,0,0,0,0,0,0,1,0,0,0,0,0,0,0,0,0,0,0,0,0,0,0,0,0,0,0,0,0,0,1,0,0,0,0,0,0,0,0,0,0,0,0,0,Gonçalo Brandão,£135Th. ,34,187,Defender - Centre-Back,left,FC Porto B,21,0,0,1699,5,0,0,450,26,2,2,2195,12,0,0,890,1,0,0,90,Liga NOS
19-06-17,18.3.4.28,Gonçalo Santos,745678,788,15-Nov-86,30,0,0,0,0,2500,5400,5400,114,108,115120,185,79,D/DM C,1,1,2,2,2,2,4,3,2,3,3,9,8,7,7,11,9,13,11,10,12,12,10,12,12,12,11,12,12,12,10,11,14,6,11,8,13,13,13,10,10,13,13,10,13,11,20,12,12,14,6,12,7,10,10,13,15,14,16,9,13,6,20,1,1,1,1,1,20,D/DM C,111,1,10,1,1,1,1,20,1,1,20,1,1,1,1,1,8589934592,0,0,0,0,0,0,0,0,0,0,0,0,0,0,0,0,0,0,0,0,0,0,0,0,0,0,0,0,0,0,0,0,0,1,0,0,0,0,0,0,0,0,0,0,0,0,0,0,Pablo Santos,£1.35m ,28,188,Defender - Centre-Back,left,Hatayspor,1,0,0,90,25,1,0,2236,27,4,0,2133,29,1,0,2424,4,0,0,360,Liga NOS
19-06-17,18.3.4.28,Sebastián Coates,78016342,1657,07-Oct-90,26,29,1,11,0,4600,7200,7200,149,144,28748725,196,92,D C,2,3,2,1,2,1,2,1,1,2,1,6,10,12,11,12,7,16,6,5,15,12,10,15,12,13,14,15,14,16,10,13,9,13,13,12,13,14,14,11,11,16,16,9,15,12,20,14,16,15,10,14,7,5,13,12,13,11,12,13,12,6,20,1,1,1,1,1,20,D C,101,1,1,1,1,1,1,20,1,1,1,1,1,1,1,1,1.41734E+11,0,0,0,0,0,0,0,0,0,0,0,0,0,0,0,0,0,0,0,0,0,0,0,0,0,0,0,0,0,0,0,0,1,0,0,0,0,1,0,0,0,0,0,0,0,0,0,0,Sebastián Coates,£9.00m ,30,196,Defender - Centre-Back,right,Sporting CP,43,3,1,3870,54,5,5,4890,49,2,3,4440,40,6,1,3559,6,1,0,513,Liga NOS
19-06-17,18.3.4.28,Jacob Adebanjo,84100406,38,05-Sep-93,23,0,0,0,0,1264,4300,4250,110,100,3840,184,78,D/DM RC,1,3,1,1,1,3,2,4,2,2,1,7,7,10,8,12,7,12,8,10,11,12,11,12,12,16,12,14,10,11,11,10,12,10,9,10,12,13,12,12,12,10,13,4,14,13,20,13,13,10,9,4,10,16,13,11,13,12,13,12,10,5,17,1,10,1,15,1,17,D/DM RC,323,1,1,1,1,1,1,17,1,15,20,10,1,1,1,1,0,0,0,0,0,0,0,0,0,0,0,0,0,0,0,0,0,0,0,0,0,0,0,0,0,0,0,0,0,0,0,0,0,0,0,0,0,0,0,0,0,0,0,0,0,0,0,0,0,Jacob Adebanjo,£90Th. ,27,184,Midfielder - Defensive Midfield,right,Without Club,1,0,0,90,1,0,0,10,2,0,0,180,3,1,0,77,nan,nan,nan,nan,Liga NOS
19-06-17,18.3.4.28,Jadson,84125475,1651,05-Nov-91,25,0,0,0,0,3500,6200,6200,130,124,557217,186,80,D C,2,2,3,1,3,2,3,1,1,1,1,7,6,9,7,11,9,16,9,9,14,12,6,15,13,13,14,12,14,12,8,13,14,5,16,8,13,12,13,13,14,14,12,5,13,12,20,11,11,12,3,11,14,5,12,15,10,8,18,15,13,3,20,1,1,1,1,1,20,D C,101,1,1,1,1,1,1,20,1,1,1,1,1,1,1,1,0,0,0,0,0,0,0,0,0,0,0,0,0,0,0,0,0,0,0,0,0,0,0,0,0,0,0,0,0,0,0,0,0,0,0,0,0,0,0,0,0,0,0,0,0,0,0,0,0,Jadson,£270Th. ,28,189,Defender - Centre-Back,right,Portimonense SC,23,2,2,1969,5,1,0,287,21,2,1,1772,33,3,0,2722,nan,nan,nan,nan,Liga NOS
19-06-17,18.3.4.28,Stéphane Sparagna,85087278,769,17-Feb-95,22,0,0,0,0,3750,5750,6000,134,120,304351,186,82,D C,2,3,4,3,2,3,2,1,3,3,2,5,6,9,6,11,6,12,6,5,14,11,7,15,12,15,12,14,12,13,8,13,13,8,10,7,13,13,14,12,12,14,12,7,13,13,20,14,14,13,12,12,8,9,13,13,9,11,13,10,7,8,20,7,10,1,10,1,20,D C,101,1,1,1,1,1,1,20,1,10,13,10,1,1,1,7,0,0,0,0,0,0,0,0,0,0,0,0,0,0,0,0,0,0,0,0,0,0,0,0,0,0,0,0,0,0,0,0,0,0,0,0,0,0,0,0,0,0,0,0,0,0,0,0,0,Stéphane Sparagna,£1.13m ,25,186,Defender - Centre-Back,right,UD Vilafranquense,33,0,1,2713,24,0,0,1956,4,0,0,227,2,1,0,180,7,0,0,531,Liga NOS
19-06-17,18.3.4.28,Yordan Osorio,86043118,1658,10-May-94,23,0,0,0,0,3803,5325,6250,137,125,2039900,189,80,D C,3,2,2,3,3,1,2,4,1,1,3,2,7,8,4,12,6,14,4,10,14,12,4,14,12,12,14,12,13,15,7,13,13,8,11,7,13,14,13,11,11,13,14,12,14,12,20,14,12,14,7,10,10,9,13,12,10,15,13,12,13,6,20,1,13,1,1,1,20,D C,101,1,1,1,1,1,1,20,1,1,14,13,1,1,1,1,2.74878E+11,0,0,0,0,0,0,0,0,0,0,0,0,0,0,0,0,0,0,0,0,0,0,0,0,0,0,0,0,0,0,0,0,0,0,0,0,0,0,1,0,0,0,0,0,0,0,0,0,Yordan Osorio,£900Th. ,26,186,Defender - Centre-Back,right,Parma Calcio 1913,15,3,0,1206,12,0,0,1039,30,2,0,2700,16,0,0,972,nan,nan,nan,nan,Liga NOS
19-06-17,18.3.4.28,Jorge Fellipe,8827074,1651,27-Oct-88,28,0,0,0,0,1750,5500,5500,121,116,148389,195,83,D C,3,2,1,2,3,2,3,3,3,2,1,4,6,5,6,2,3,14,4,5,13,9,5,13,7,12,12,13,11,12,11,11,13,10,13,10,13,13,12,13,12,12,14,20,13,13,15,14,14,12,10,11,10,4,12,12,10,11,12,10,11,11,20,12,1,1,1,13,20,D C,101,1,1,1,1,1,1,20,13,1,1,1,1,1,12,1,0,0,0,0,0,0,0,0,0,0,0,0,0,0,0,0,0,0,0,0,0,0,0,0,0,0,0,0,0,0,0,0,0,0,0,0,0,0,0,0,0,0,0,0,0,0,0,0,0,Jorge Fellipe,£180Th. ,32,192,Defender - Centre-Back,left,SC Farense,nan,nan,nan,nan,7,1,1,514,23,2,0,2001,19,2,1,1653,nan,nan,nan,nan,Liga NOS
19-06-17,18.3.4.28,Rodrigo Defendi,8834927,1651,17-Jun-86,31,0,0,0,0,3250,5550,5550,118,111,128184,190,80,D C,2,2,3,3,2,1,1,3,3,3,3,9,8,9,9,10,12,14,13,11,13,9,10,13,11,14,13,13,11,9,9,9,11,13,11,12,14,14,12,12,10,12,15,20,12,12,6,11,14,10,10,13,8,13,10,5,10,9,16,13,15,5,20,1,1,1,1,1,20,D C,101,1,12,1,1,1,1,20,1,1,1,1,1,1,1,1,3.51844E+13,0,0,0,0,0,0,0,0,0,1,0,0,0,0,0,0,0,0,0,0,0,0,0,0,0,0,0,0,0,0,0,0,0,0,0,0,0,0,0,0,0,0,0,0,0,1,0,0,Rodrigo Defendi,£90Th. ,34,190,Defender - Centre-Back,right,Without Club,34,0,0,2972,13,3,2,1022,17,2,2,1402,2,0,0,132,nan,nan,nan,nan,Liga NOS
19-06-17,18.3.4.28,Rúben Fernandes,8871609,788,06-May-86,31,0,0,0,0,3250,5550,5550,119,118,232186002,185,78,D LC,4,3,2,3,3,1,2,3,3,3,3,8,8,10,9,10,10,13,11,11,13,10,10,12,10,12,13,13,12,14,8,13,12,8,14,11,14,13,11,12,12,12,13,20,13,12,5,14,12,12,7,10,7,11,13,15,18,13,15,15,15,5,20,1,1,1,6,16,20,D LC,104,1,1,1,1,1,1,20,16,6,8,1,1,1,1,1,0,0,0,0,0,0,0,0,0,0,0,0,0,0,0,0,0,0,0,0,0,0,0,0,0,0,0,0,0,0,0,0,0,0,0,0,0,0,0,0,0,0,0,0,0,0,0,0,0,Rúben Fernandes,£630Th. ,34,187,Defender - Centre-Back,right,Gil Vicente FC,40,3,2,3576,38,4,3,3450,35,0,1,2925,35,1,1,3097,4,0,0,360,Liga NOS
19-06-17,18.3.4.28,Nuno André Coelho,8874548,788,07-Jan-86,31,0,0,14,2,4500,6000,6000,135,120,220133,190,82,D C,1,2,3,2,2,1,2,3,2,2,3,7,7,7,8,10,8,13,10,10,13,11,9,14,10,13,14,12,11,13,8,12,13,6,12,10,14,13,12,12,12,13,15,6,12,11,20,11,14,12,9,10,12,12,12,10,13,12,15,16,16,6,20,1,1,1,10,7,20,D C,101,1,5,1,1,1,1,20,7,10,13,1,1,1,1,1,0,0,0,0,0,0,0,0,0,0,0,0,0,0,0,0,0,0,0,0,0,0,0,0,0,0,0,0,0,0,0,0,0,0,0,0,0,0,0,0,0,0,0,0,0,0,0,0,0,Nuno André Coelho,£270Th. ,34,190,Defender - Centre-Back,right,Without Club,17,1,0,1384,11,0,1,765,6,0,0,426,nan,nan,nan,nan,nan,nan,nan,nan,Liga NOS
19-06-17,18.3.4.28,Raphael Rossi,89024840,1651,25-Jul-90,26,0,0,0,0,2750,5950,6100,126,122,428120,189,80,D C,3,1,2,1,3,1,2,1,3,2,2,5,6,11,6,11,6,15,6,8,15,11,6,14,11,17,10,15,13,12,10,11,13,13,11,8,13,13,14,11,10,13,14,11,14,13,20,14,14,13,18,10,9,6,12,11,12,9,10,11,10,7,20,1,1,1,14,1,20,D C,101,1,13,1,1,1,1,20,1,14,1,1,1,1,1,1,1.37439E+11,0,0,1,0,0,0,0,0,0,0,0,0,0,0,0,0,1,1,0,0,0,0,0,0,0,0,0,0,0,0,0,0,0,0,0,0,0,1,0,0,0,0,0,0,0,0,0,0,Raphael Rossi,£1.58m ,30,190,Defender - Centre-Back,right,FC Sion,39,3,1,3510,32,3,0,2880,12,1,0,936,nan,nan,nan,nan,nan,nan,nan,nan,Liga NOS
19-06-17,18.3.4.28,Jérémy Mathieu,915419,769,29-Oct-83,33,4,0,13,2,6500,6800,7350,155,147,232186002,189,84,D/WB LC,2,2,2,1,2,3,1,1,3,1,2,11,11,10,8,10,14,15,14,14,16,12,14,15,15,12,14,14,13,14,10,14,13,8,14,11,15,15,16,12,10,10,16,20,13,13,5,15,15,14,11,14,13,17,13,15,13,14,14,14,16,5,20,16,13,1,1,17,20,D/WB LC,114,1,11,1,1,1,1,20,17,1,9,1,13,1,16,1,3.51844E+13,0,0,0,0,0,0,0,0,0,1,0,0,0,0,0,0,0,0,0,0,0,0,0,0,0,0,0,0,0,0,0,0,0,0,0,0,0,0,0,0,0,0,0,0,0,1,0,0,Jérémy Mathieu,£1.80m ,36,189,Defender - Centre-Back,left,Retired,16,1,0,1145,48,3,2,4162,33,3,0,2891,25,3,1,2161,nan,nan,nan,nan,Liga NOS
19-06-17,18.3.4.28,Ezequiel Muńoz,14000741,1649,08-Oct-90,26,0,0,1,0,4250,6450,6450,138,129,5303862,185,82,D C,2,3,3,3,1,2,3,3,1,2,1,5,6,8,7,12,5,16,7,9,13,12,5,15,11,17,14,16,12,11,8,13,15,7,12,8,14,14,15,12,10,14,14,8,16,11,20,14,16,15,13,15,12,9,14,14,10,13,16,16,12,6,20,1,1,1,12,1,20,D C,101,1,1,1,1,1,1,20,1,12,1,1,1,1,1,1,32832,0,0,0,0,0,0,1,0,0,0,0,0,0,0,0,1,0,0,0,0,0,0,0,0,0,0,0,0,0,0,0,0,0,0,0,0,0,0,0,0,0,0,0,0,0,0,0,0,Ezequiel Muñoz,£1.35m ,30,186,Defender - Centre-Back,right,Club Atlético Independiente,32,0,0,2463,20,0,1,1497,7,0,0,569,25,1,1,2250,nan,nan,nan,nan,LaLiga
19-06-17,18.3.4.28,Gabriel Mercado,14000758,1649,18-Mar-87,30,14,3,20,1,5250,7200,7200,144,142,232186002,180,83,D RC,2,1,3,1,1,2,3,2,1,3,4,6,12,11,9,13,6,15,7,14,14,12,10,15,11,16,15,15,13,14,12,14,16,5,14,15,15,15,16,12,12,15,13,9,15,13,20,15,14,16,14,18,13,17,12,13,17,12,17,8,7,2,20,15,1,1,20,9,16,D RC,103,1,1,1,1,1,1,16,9,20,1,1,1,1,1,15,2147614752,0,0,0,0,0,1,0,0,0,0,0,0,0,0,0,0,0,1,0,0,0,0,0,0,0,0,0,0,0,0,0,1,0,0,0,0,0,0,0,0,0,0,0,0,0,0,0,0,Gabriel Mercado,£4.50m ,33,181,Defender - Centre-Back,right,Al-Rayyan SC,40,3,1,3103,43,0,2,3626,34,3,2,2753,21,3,0,1890,4,0,0,360,LaLiga
19-06-17,18.3.4.28,Facundo Roncaglia,14001537,1649,10-Feb-87,30,14,0,0,0,6000,6850,6850,150,137,10192786,179,76,D RC,3,3,3,3,1,1,2,4,2,2,3,6,10,10,11,12,6,15,12,13,15,13,9,14,12,15,14,13,13,10,11,12,16,6,10,10,14,15,15,13,12,14,13,9,14,12,20,15,16,12,13,13,7,13,14,13,12,10,11,9,12,12,20,1,1,1,19,14,20,D RC,103,1,1,1,1,1,1,20,14,19,1,1,1,1,1,1,1.37439E+11,0,0,0,0,0,1,0,0,1,0,0,0,0,0,0,0,0,0,0,0,0,0,0,0,0,0,0,0,0,0,0,0,0,0,0,0,0,1,0,0,0,0,0,0,0,0,0,0,Facundo Roncaglia,£2.70m ,33,179,Defender - Centre-Back,right,CA Osasuna,48,3,1,3942,22,0,0,1500,24,0,0,2092,19,1,0,1580,4,1,1,334,LaLiga
19-06-17,18.3.4.28,Mauro Dos Santos,14005488,1649,07-Jul-89,27,0,0,0,0,4500,6250,6250,134,125,3657479,180,76,D C,2,1,2,2,3,3,1,1,1,3,2,4,7,4,3,10,6,16,11,10,15,9,8,14,8,12,14,13,12,13,9,11,13,5,11,6,14,15,15,13,11,11,13,9,15,14,20,13,14,14,11,11,11,9,13,12,15,13,11,13,10,7,20,1,1,1,7,1,20,D C,101,1,1,1,1,1,1,20,1,7,1,1,1,1,1,1,0,0,0,0,0,0,0,0,0,0,0,0,0,0,0,0,0,0,0,0,0,0,0,0,0,0,0,0,0,0,0,0,0,0,0,0,0,0,0,0,0,0,0,0,0,0,0,0,0,Mauro dos Santos,£1.08m ,31,182,Defender - Centre-Back,right,Albirex Niigata,16,0,0,1211,14,0,0,981,7,0,0,592,30,3,1,2603,nan,nan,nan,nan,LaLiga
19-06-17,18.3.4.28,Sergio Sánchez,1507596,796,03-Apr-86,31,0,0,4,0,4900,6250,6250,140,123,232186002,185,78,D RC,1,2,4,3,3,3,1,1,2,3,3,6,12,8,8,12,6,14,7,10,15,13,8,13,12,16,14,14,12,14,8,13,16,7,13,10,13,12,13,11,11,12,12,10,12,11,20,12,11,15,16,10,9,13,8,13,14,12,11,8,9,12,20,7,1,1,15,1,20,D RC,103,1,1,1,1,1,1,20,1,15,10,1,1,1,1,7,131072,0,0,0,0,0,0,0,0,0,0,0,0,0,0,0,0,0,1,0,0,0,0,0,0,0,0,0,0,0,0,0,0,0,0,0,0,0,0,0,0,0,0,0,0,0,0,0,0,Sergio Sánchez,£900Th. ,34,185,Defender - Centre-Back,right,Without Club,20,0,0,1736,4,0,0,236,22,1,1,1918,2,0,0,180,nan,nan,nan,nan,LaLiga
19-06-17,18.3.4.28,Gabriel Paulista,19127830,1651,26-Nov-90,26,0,0,0,0,6250,6750,7100,152,142,28324060,185,72,D C,3,3,1,3,2,1,1,3,1,1,3,5,9,8,8,12,8,15,10,10,15,11,6,16,11,17,14,18,11,13,10,11,17,6,11,10,14,15,16,15,13,14,14,10,15,15,20,15,15,13,14,12,7,14,14,15,10,14,15,9,7,10,20,8,1,1,14,12,20,D C,101,1,10,1,1,1,1,20,12,14,1,1,1,1,8,8,98304,0,0,0,0,0,0,0,0,0,0,0,0,0,0,0,1,1,0,0,0,0,0,0,0,0,0,0,0,0,0,0,0,0,0,0,0,0,0,0,0,0,0,0,0,0,0,0,0,Gabriel Paulista,£18.00m ,29,187,Defender - Centre-Back,right,Valencia CF,27,0,0,2216,37,0,0,3147,46,0,1,4019,42,1,1,3642,4,1,0,360,LaLiga
19-06-17,18.3.4.28,Naldo,19141395,1651,25-Aug-88,28,0,0,0,0,5600,6000,6400,133,128,4467004,188,83,D C,4,1,2,3,1,2,2,4,3,3,2,3,7,8,9,9,10,11,8,7,13,11,10,13,11,13,15,12,9,15,7,14,14,10,10,9,14,14,15,12,12,11,14,10,14,13,20,15,13,10,12,12,6,7,13,12,5,10,11,6,7,11,20,1,1,1,10,1,20,D C,101,1,1,1,1,1,1,20,1,10,1,1,1,1,1,1,0,0,0,0,0,0,0,0,0,0,0,0,0,0,0,0,0,0,0,0,0,0,0,0,0,0,0,0,0,0,0,0,0,0,0,0,0,0,0,0,0,0,0,0,0,0,0,0,0,Naldo,£900Th. ,32,188,Defender - Centre-Back,right,Antalyaspor,24,2,0,2220,17,0,0,1461,18,1,1,1516,26,0,1,2048,2,0,0,180,LaLiga
19-06-17,18.3.4.28,Djene Dakonam,211232,50,31-Dec-91,25,30,0,0,0,5200,6450,6450,135,130,3847149,176,71,D/DM RC,3,2,3,2,4,3,2,3,3,2,1,9,11,9,5,11,7,7,8,11,14,9,8,13,10,11,12,13,12,14,11,12,10,8,9,11,12,12,15,15,14,11,7,11,15,14,20,14,12,12,10,6,11,15,6,14,11,12,11,11,16,3,20,15,12,1,19,14,20,D/DM RC,113,1,1,1,1,1,1,20,14,19,18,12,1,1,14,15,0,0,0,0,0,0,0,0,0,0,0,0,0,0,0,0,0,0,0,0,0,0,0,0,0,0,0,0,0,0,0,0,0,0,0,0,0,0,0,0,0,0,0,0,0,0,0,0,0,,,,,,,,,,,,,,,,,,,,,,,,,,,,
19-06-17,18.3.4.28,Ignasi Miquel,28027172,796,28-Oct-92,24,0,0,1,0,3550,6250,6250,139,125,4522690,189,80,D LC,2,3,2,1,2,3,2,1,2,3,1,7,8,12,6,11,7,15,9,9,12,12,3,12,13,11,13,12,12,13,11,13,14,5,10,10,14,12,13,11,12,12,17,20,13,12,10,12,11,12,13,8,11,11,13,14,12,12,12,9,14,4,20,12,1,1,1,15,20,D LC,104,1,1,1,1,1,1,20,15,1,1,1,1,1,12,1,4,0,0,1,0,0,0,0,0,0,0,0,0,0,0,0,0,0,0,0,0,0,0,0,0,0,0,0,0,0,0,0,0,0,0,0,0,0,0,0,0,0,0,0,0,0,0,0,0,Ignasi Miquel,£1.35m ,28,189,Defender - Centre-Back,left,CD Leganés,33,2,1,2853,37,1,1,3335,10,0,0,584,24,1,0,2103,3,0,0,198,LaLiga
19-06-17,18.3.4.28,Rafael Zuchi,29117667,1651,11-Jun-94,23,0,0,0,0,1500,4750,4750,114,95,233298,188,77,D C,2,1,1,4,1,1,3,3,2,2,3,8,10,10,11,12,11,12,11,10,12,11,10,12,11,12,12,11,12,12,12,11,4,12,10,11,11,12,12,13,12,12,12,5,12,12,20,11,11,12,12,11,11,12,13,9,10,11,13,12,10,12,20,1,1,1,1,1,20,D C,101,1,1,1,1,1,1,20,1,1,1,1,1,1,1,1,0,0,0,0,0,0,0,0,0,0,0,0,0,0,0,0,0,0,0,0,0,0,0,0,0,0,0,0,0,0,0,0,0,0,0,0,0,0,0,0,0,0,0,0,0,0,0,0,0,,,,,,,,,,,,,,,,,,,,,,,,,,,,
19-06-17,18.3.4.28,Dimitris Siovas,36002122,772,16-Sep-88,28,12,0,14,1,4000,5750,6250,130,125,3657479,191,87,D/DM C,2,1,3,2,2,1,2,1,2,1,2,9,13,12,7,13,8,13,12,11,13,14,12,13,14,11,14,12,13,13,13,13,13,12,13,10,13,14,12,10,9,15,15,20,10,11,7,12,15,12,8,12,12,14,19,12,13,12,14,13,14,9,20,1,7,1,1,1,20,D/DM C,111,1,1,1,1,1,1,20,1,1,16,7,1,1,1,1,8.8004E+12,0,0,0,0,0,0,0,0,1,0,0,0,0,0,0,0,0,0,0,0,0,0,0,1,0,0,0,0,0,0,0,0,1,0,0,0,0,0,0,0,0,0,0,1,0,0,0,0,Dimitrios Siovas,£2.70m ,32,191,Defender - Centre-Back,left,SD Huesca,18,1,1,1522,30,2,1,2569,37,1,1,3233,25,0,0,2012,6,1,0,540,LaLiga
19-06-17,18.3.4.28,Daniele Bonera,3801706,776,31-May-81,36,16,0,34,0,5500,6500,6250,142,127,289222,183,74,D RC,1,2,1,1,1,1,1,3,2,3,3,2,9,8,4,10,2,14,8,13,16,11,5,14,11,13,14,13,15,14,9,13,14,5,15,10,16,15,14,10,9,10,11,9,9,11,20,13,13,13,15,8,15,12,13,13,17,13,16,15,16,8,20,2,1,1,18,10,20,D RC,103,1,1,1,1,1,1,20,10,18,1,1,1,1,1,2,0,0,0,0,0,0,0,0,0,0,0,0,0,0,0,0,0,0,0,0,0,0,0,0,0,0,0,0,0,0,0,0,0,0,0,0,0,0,0,0,0,0,0,0,0,0,0,0,0,Daniele Bonera,£180Th. ,39,183,Defender - Centre-Back,right,Retired,10,0,0,900,21,0,2,1730,11,0,0,726,nan,nan,nan,nan,nan,nan,nan,nan,LaLiga
19-06-17,18.3.4.28,Rodrigo Ely,43080624,1651,03-Nov-93,23,0,0,2,0,3500,6000,6500,146,133,7560214,188,83,D C,3,1,1,1,3,3,3,3,1,2,2,4,5,6,4,12,8,13,7,10,14,13,6,14,12,12,14,13,13,14,11,13,14,4,11,8,14,14,13,12,12,14,15,9,14,13,20,13,13,14,13,6,7,5,16,15,15,12,13,14,14,4,20,1,1,1,1,1,20,D C,101,1,1,1,1,1,1,20,1,1,1,1,1,1,1,1,8.79609E+12,0,0,0,0,0,0,0,0,0,0,0,0,0,0,0,0,0,0,0,0,0,0,0,0,0,0,0,0,0,0,0,0,0,0,0,0,0,0,0,0,0,0,0,1,0,0,0,0,Rodrigo Ely,£5.40m ,26,188,Defender - Centre-Back,right,Deportivo Alavés,11,1,0,878,36,1,1,3138,5,0,0,431,25,2,0,2126,5,1,0,248,LaLiga
19-06-17,18.3.4.28,Héctor Moreno,51000042,379,17-Jan-88,29,80,3,3,1,6250,7200,6800,148,136,10392346,182,80,D C,2,1,1,3,1,4,1,3,2,3,3,8,7,9,5,13,10,15,9,11,15,13,6,14,13,15,13,14,14,14,13,14,13,14,13,7,15,16,15,12,10,14,11,20,14,12,10,15,13,15,12,16,6,10,14,14,15,12,15,8,11,7,20,9,7,1,9,13,20,D C,101,1,1,1,1,1,1,20,13,9,10,7,1,1,9,6,8.80039E+12,0,0,0,0,0,0,0,0,0,0,0,0,0,0,0,0,0,0,0,0,0,0,0,0,0,0,0,0,0,0,0,0,1,0,0,0,0,0,0,0,0,0,0,1,0,0,0,0,Héctor Moreno,£3.60m ,32,184,Defender - Centre-Back,left,Al-Gharafa SC,39,7,1,3461,15,1,0,1113,29,1,1,2205,21,1,2,1791,4,0,0,360,Serie A
19-06-17,18.3.4.28,Gerard Piqué,5124470,796,02-Feb-87,30,80,5,12,1,8200,8450,8450,170,169,232186002,194,85,D C,3,1,3,3,1,3,3,3,1,2,2,8,10,13,10,15,7,16,8,8,16,16,13,15,16,14,16,15,18,15,15,17,14,11,16,9,18,15,15,11,10,9,16,12,15,13,20,15,15,16,12,18,8,9,16,15,16,17,14,10,10,16,20,1,1,1,1,1,20,D C,101,1,15,1,1,1,1,20,1,1,10,1,1,1,1,1,1.15292E+18,0,0,0,0,0,1,0,0,0,0,0,0,0,0,0,1,0,0,0,0,0,0,0,0,0,0,0,0,0,0,0,0,1,0,0,0,0,0,1,0,0,0,0,0,0,0,0,0,Gerard Piqué,£45.00m ,33,192,Defender - Centre-Back,right,FC Barcelona,41,3,0,3563,49,5,0,4145,52,7,4,4680,45,1,0,3986,6,0,0,518,LaLiga
19-06-17,18.3.4.28,Daniel Carriço,55000931,788,04-Aug-88,28,1,0,16,0,5500,7400,7400,153,144,20432869,182,74,D C,3,2,2,3,2,1,3,4,3,3,1,7,7,8,8,10,11,15,11,10,15,12,12,16,13,18,17,17,12,15,9,13,14,7,19,11,15,15,15,12,13,12,13,8,12,11,20,11,14,14,15,14,18,12,12,14,15,14,17,16,17,8,20,1,10,1,1,1,20,D C,101,1,5,1,1,1,1,20,1,1,15,10,1,1,1,1,32768,0,0,0,0,0,0,0,0,0,0,0,0,0,0,0,1,0,0,0,0,0,0,0,0,0,0,0,0,0,0,0,0,0,0,0,0,0,0,0,0,0,0,0,0,0,0,0,0,Daniel Carriço,£900Th. ,32,183,Defender - Centre-Back,right,Wuhan Zall,10,0,0,627,6,0,0,459,38,1,1,3303,19,0,0,1432,nan,nan,nan,nan,LaLiga
19-06-17,18.3.4.28,Paulo Oliveira,55024825,788,08-Jan-92,25,1,0,23,1,4500,6900,6900,149,138,13719938,187,82,D C,1,1,1,2,3,3,1,3,2,1,2,6,6,8,7,11,10,12,7,8,14,9,11,15,9,10,15,12,10,15,8,14,16,5,13,8,15,14,14,13,14,14,15,9,14,14,20,14,13,14,6,12,6,11,13,14,12,12,17,10,14,10,20,1,1,1,1,1,20,D C,101,1,1,1,1,1,1,20,1,1,1,1,1,1,1,1,0,0,0,0,0,0,0,0,0,0,0,0,0,0,0,0,0,0,0,0,0,0,0,0,0,0,0,0,0,0,0,0,0,0,0,0,0,0,0,0,0,0,0,0,0,0,0,0,0,Paulo Oliveira,£2.70m ,28,187,Defender - Centre-Back,right,SD Eibar,19,1,0,1425,27,0,0,2305,29,0,0,2297,28,1,0,2269,6,0,0,540,LaLiga
19-06-17,18.3.4.28,Rúben Semedo,55063358,788,04-Apr-94,23,0,0,8,3,3600,6800,6800,149,136,19778982,189,84,D/DM C,1,3,3,3,1,4,1,2,3,3,1,8,8,12,9,13,8,14,9,10,13,13,12,16,14,18,17,17,13,9,13,8,15,9,10,10,14,14,13,15,15,13,15,10,18,16,20,15,13,10,15,11,6,9,13,15,11,12,12,15,9,14,20,1,7,1,5,5,20,D/DM C,111,1,1,1,1,1,1,20,5,5,17,7,1,1,1,1,32,0,0,0,0,0,1,0,0,0,0,0,0,0,0,0,0,0,0,0,0,0,0,0,0,0,0,0,0,0,0,0,0,0,0,0,0,0,0,0,0,0,0,0,0,0,0,0,0,Rúben Semedo,£900Th. ,26,189,Defender - Centre-Back,right,Olympiacos Piraeus,31,0,0,2720,5,0,0,321,26,2,0,2141,45,5,0,3883,7,0,0,630,LaLiga
19-06-17,18.3.4.28,Rúben Vezo,55067158,788,25-Apr-94,23,0,0,5,2,4768,6024,6750,148,136,9498924,182,80,D RC,2,2,3,3,1,2,1,3,1,3,3,6,10,11,6,12,7,13,7,12,13,12,10,13,13,9,13,14,14,10,12,13,13,6,11,11,14,15,15,15,15,12,14,11,15,14,20,16,11,11,8,10,7,12,11,12,14,10,17,13,14,5,20,1,1,1,16,7,20,D RC,103,1,1,1,1,1,1,20,7,16,10,1,1,1,1,1,0,0,0,0,0,0,0,0,0,0,0,0,0,0,0,0,0,0,0,0,0,0,0,0,0,0,0,0,0,0,0,0,0,0,0,0,0,0,0,0,0,0,0,0,0,0,0,0,0,Rúben Vezo,£5.40m ,26,182,Defender - Centre-Back,right,Levante UD,20,0,1,1624,26,1,0,2142,27,2,1,2082,30,0,1,2700,4,0,0,360,LaLiga
19-06-17,18.3.4.28,Stefan Savic,62012567,62002127,08-Jan-91,26,43,3,7,0,6800,7650,7650,158,153,47875242,187,80,D C,3,3,1,3,2,2,2,4,2,3,1,7,9,9,9,11,6,14,8,10,16,12,9,14,11,13,17,14,15,15,12,14,15,8,12,8,15,15,15,13,14,11,13,12,13,14,20,15,15,14,9,13,8,13,14,14,14,15,14,12,11,7,20,1,1,1,13,7,20,D C,101,1,1,1,1,1,1,20,7,13,1,1,1,1,1,1,0,0,0,0,0,0,0,0,0,0,0,0,0,0,0,0,0,0,0,0,0,0,0,0,0,0,0,0,0,0,0,0,0,0,0,0,0,0,0,0,0,0,0,0,0,0,0,0,0,Stefan Savic,£36.00m ,29,187,Defender - Centre-Back,right,Atlético Madrid,49,1,1,4186,37,0,0,3032,22,0,2,1781,28,1,0,2482,5,0,0,450,LaLiga
19-06-17,18.3.4.28,Vukasin Jovanovic,62137154,802,17-May-96,21,0,0,13,0,4000,6200,6200,155,124,10420890,188,79,D C,2,1,2,4,1,3,3,1,1,3,1,4,4,11,6,12,8,13,8,9,13,13,9,13,11,14,13,15,14,13,10,12,14,9,12,10,13,13,14,12,12,12,13,10,12,13,20,14,13,13,14,13,10,11,11,15,12,14,14,15,10,10,20,1,1,1,11,11,20,D C,101,1,1,1,1,1,1,20,11,11,14,1,1,1,1,1,64,0,0,0,0,0,0,1,0,0,0,0,0,0,0,0,0,0,0,0,0,0,0,0,0,0,0,0,0,0,0,0,0,0,0,0,0,0,0,0,0,0,0,0,0,0,0,0,0,Vukasin Jovanovic,£2.70m ,24,188,Defender - Centre-Back,right,FC Girondins Bordeaux,22,0,0,1900,16,0,0,1440,19,0,0,1647,11,0,1,779,0,0,0,0,LaLiga
19-06-17,18.3.4.28,Xabi Etxeita,67008295,796,31-Oct-87,29,1,0,0,0,4550,6650,6650,138,133,7161643,185,79,D C,3,4,1,2,2,2,2,2,3,3,1,6,6,9,7,10,5,15,6,7,16,10,2,15,10,14,13,15,13,15,8,13,14,8,13,5,15,15,16,11,10,11,14,10,11,11,20,15,15,15,13,12,6,13,9,12,14,13,14,13,10,7,20,1,9,1,10,1,20,D C,101,1,1,1,1,1,1,20,1,10,14,9,1,1,1,1,4.5036E+15,0,0,0,0,0,0,0,0,0,0,0,0,0,0,0,1,0,0,0,0,0,0,0,0,0,0,0,0,0,0,0,0,0,0,0,0,0,0,0,0,0,0,0,0,0,0,0,0,Xabi Etxeita,£1.80m ,32,186,Defender - Centre-Back,right,Getafe CF,16,1,0,1171,19,2,0,1603,32,4,0,2768,22,0,0,1896,4,0,0,360,LaLiga
19-06-17,18.3.4.28,Bernardo,67010361,1653,11-Jul-89,27,0,0,0,0,5650,6150,6250,134,125,2949580,192,85,D C,1,3,2,2,1,2,3,2,3,3,2,3,3,3,5,10,4,16,5,6,13,10,5,15,12,14,14,14,12,12,11,12,12,9,11,8,13,13,14,9,11,10,16,10,15,11,20,16,17,14,10,11,7,8,7,11,12,12,14,12,13,9,20,1,1,1,1,1,20,D C,101,1,1,1,1,1,1,20,1,1,1,1,1,1,1,1,0,0,0,0,0,0,0,0,0,0,0,0,0,0,0,0,0,0,0,0,0,0,0,0,0,0,0,0,0,0,0,0,0,0,0,0,0,0,0,0,0,0,0,0,0,0,0,0,0,Bernardo,£5.40m ,25,186,Defender - Left-Back,left,Brighton & Hove Albion,32,3,1,2820,27,1,1,1846,27,0,1,2260,16,0,0,784,3,1,2,270,Bundesliga
19-06-17,18.3.4.28,Diego Llorente,67011217,796,16-Aug-93,23,1,0,6,0,5150,7100,7100,153,145,25807228,186,75,D RC,2,2,3,1,1,3,1,2,2,3,3,8,10,9,6,14,6,14,6,13,15,13,9,16,14,15,14,18,12,15,9,15,8,6,11,7,16,15,16,12,11,8,13,10,12,13,20,14,13,13,12,10,8,15,9,9,13,12,9,12,18,6,20,10,1,1,17,12,20,D RC,103,1,1,1,1,1,1,20,12,17,12,1,1,1,1,10,32,0,0,0,0,0,1,0,0,0,0,0,0,0,0,0,0,0,0,0,0,0,0,0,0,0,0,0,0,0,0,0,0,0,0,0,0,0,0,0,0,0,0,0,0,0,0,0,0,Diego Llorente,£15.75m ,27,186,Defender - Centre-Back,right,Leeds United,27,2,0,2209,34,7,0,2912,23,0,0,1931,30,1,2,2418,1,0,0,90,LaLiga
19-06-17,18.3.4.28,Miguel Torres,67011252,796,28-Jan-86,31,0,0,12,0,4250,6700,6300,134,126,232186002,185,81,D RLC,2,1,2,3,1,1,1,2,1,1,2,12,14,11,3,14,11,13,9,16,14,12,7,15,14,14,14,16,13,16,10,12,10,5,11,7,13,17,16,11,11,8,12,10,11,12,20,11,11,10,13,14,12,19,9,10,18,14,16,13,17,3,20,14,8,1,20,19,17,D RLC,106,1,1,1,1,1,1,17,19,20,8,3,8,8,10,14,4294967296,0,0,0,0,0,0,0,0,0,0,0,0,0,0,0,0,0,0,0,0,0,0,0,0,0,0,0,0,0,0,0,0,1,0,0,0,0,0,0,0,0,0,0,0,0,0,0,0,Miguel Torres,£720Th. ,34,184,Defender - Right-Back,right,Retired,23,0,0,1654,8,0,0,676,1,0,0,22,nan,nan,nan,nan,nan,nan,nan,nan,LaLiga
19-06-17,18.3.4.28,Eneko Bóveda,67018261,796,14-Dec-88,28,0,0,0,0,4400,6500,6500,134,132,4818967,180,78,D/WB RLC,3,2,2,3,2,2,1,3,2,3,2,4,11,11,3,10,6,12,8,14,12,12,4,14,12,11,14,14,13,14,10,13,15,9,11,13,14,14,15,13,12,13,11,10,11,14,20,15,13,13,10,11,13,14,11,11,14,11,15,10,16,6,20,18,14,9,20,15,18,D/WB RLC,116,1,1,1,1,1,9,18,15,20,1,1,1,14,11,18,0,0,0,0,0,0,0,0,0,0,0,0,0,0,0,0,0,0,0,0,0,0,0,0,0,0,0,0,0,0,0,0,0,0,0,0,0,0,0,0,0,0,0,0,0,0,0,0,0,Eneko Bóveda,£1.35m ,31,182,Defender - Right-Back,right,Deportivo de La Coruña,23,0,0,1839,16,0,1,1326,24,0,1,1907,32,1,4,2725,2,1,0,149,LaLiga
19-06-17,18.3.4.28,Nacho,67030696,796,18-Jan-90,27,8,0,6,0,6500,7750,7750,158,154,61125395,180,77,D RLC,1,2,2,4,3,3,3,3,3,3,4,7,12,10,10,13,8,14,8,12,14,13,7,16,10,15,15,13,13,17,11,14,14,9,13,12,15,17,16,16,12,14,11,13,15,15,20,15,14,19,8,15,3,20,19,10,20,13,18,16,16,1,20,12,1,1,18,18,20,D RLC,106,1,13,1,1,1,1,20,18,18,1,1,1,1,12,12,0,0,0,0,0,0,0,0,0,0,0,0,0,0,0,0,0,0,0,0,0,0,0,0,0,0,0,0,0,0,0,0,0,0,0,0,0,0,0,0,0,0,0,0,0,0,0,0,0,,,,,,,,,,,,,,,,,,,,,,,,,,,,
19-06-17,18.3.4.28,Luis Hernández,67030712,796,14-Apr-89,28,0,0,0,0,5000,6900,6900,144,138,13719938,183,75,D RC,3,1,2,2,3,2,1,2,2,3,1,11,13,11,6,11,7,13,10,20,14,13,10,16,14,13,15,14,13,11,10,11,12,9,12,10,16,14,13,14,13,10,12,10,14,14,20,16,12,12,8,16,5,14,15,13,11,9,14,12,12,2,20,10,1,1,19,1,20,D RC,103,1,1,1,1,1,1,20,1,19,1,1,1,1,1,10,1.1259E+15,0,0,0,0,0,0,0,0,0,0,0,0,0,0,0,0,0,0,0,0,0,0,0,0,0,0,0,0,0,0,0,0,0,0,0,0,0,0,0,0,0,0,0,0,0,0,0,0,Luis Hernández,£2.25m ,31,182,Defender - Centre-Back,right,Maccabi Tel Aviv,29,1,1,2512,38,0,1,3420,26,1,1,2250,29,0,1,2399,2,0,0,96,LaLiga
19-06-17,18.3.4.28,Pedro Alcalá,67031045,796,19-Mar-89,28,0,0,0,0,3550,6250,6250,128,125,2949580,196,85,D C,3,4,1,2,2,1,1,3,3,2,3,10,7,8,7,8,14,15,12,8,12,10,10,13,12,12,13,12,13,13,9,13,15,13,12,6,14,13,12,12,11,7,14,11,12,12,20,14,14,14,4,11,8,7,11,14,13,12,12,12,12,7,20,1,1,1,1,1,20,D C,101,1,10,1,1,1,1,20,1,1,1,1,1,1,1,1,2.30584E+18,0,0,0,0,0,0,1,0,0,0,0,0,0,0,0,0,0,0,0,0,0,0,0,0,0,0,0,0,0,0,0,0,0,1,0,0,0,0,0,0,0,0,0,0,0,0,0,0,Pedro Alcalá,£720Th. ,31,196,Defender - Centre-Back,right,Cádiz CF,40,4,2,3599,8,1,0,690,29,2,1,2180,31,0,2,2567,0,0,0,0,LaLiga
19-06-17,18.3.4.28,Mikel San José,67037571,796,30-May-89,28,1,0,3,0,6500,7450,7450,152,150,36223113,186,77,D/DM/M C,3,2,4,2,2,1,2,2,2,1,3,5,8,10,13,12,9,18,8,8,16,14,14,15,13,12,13,15,14,13,12,14,12,8,13,13,16,16,14,11,8,10,15,12,12,12,20,15,16,14,11,13,8,5,14,12,11,12,17,10,10,5,18,1,16,1,1,1,18,D/DM/M C,331,1,1,1,1,1,1,18,1,1,20,16,1,1,1,1,33554432,0,0,0,0,0,0,0,0,0,0,0,0,0,0,0,0,0,0,0,0,0,0,0,0,0,1,0,0,0,0,0,0,0,0,0,0,0,0,0,0,0,0,0,0,0,0,0,0,Mikel San José,£8.10m ,31,187,Midfielder - Defensive Midfield,right,Birmingham City,44,4,2,3349,38,1,1,2892,37,1,1,1992,12,0,0,463,2,0,0,90,LaLiga
19-06-17,18.3.4.28,Andreu Fontŕs,67038644,796,14-Nov-89,27,0,0,14,0,5500,6850,6850,145,137,11325317,186,72,D/DM C,3,3,3,1,2,4,2,1,2,3,2,7,11,9,8,14,8,12,11,10,13,17,11,16,14,13,14,13,15,15,13,14,12,9,12,7,14,14,13,11,10,8,13,20,11,13,7,14,17,14,8,11,8,13,9,13,14,12,13,12,12,4,20,7,9,1,1,10,20,D/DM C,111,1,13,1,1,1,1,20,10,1,18,9,1,1,7,1,1.41017E+14,0,0,0,0,0,0,0,0,0,0,0,0,0,0,0,0,0,0,0,0,0,0,0,0,0,0,0,0,0,0,0,0,1,0,0,0,0,0,1,0,0,0,0,0,0,0,0,1,Andreu Fontàs,£2.70m ,30,186,Defender - Centre-Back,left,Sporting Kansas City,27,2,1,2220,18,0,1,1335,18,0,0,1381,2,1,0,180,nan,nan,nan,nan,LaLiga
19-06-17,18.3.4.28,Carles Planas,67038646,796,04-Mar-91,26,0,0,44,0,4300,6300,6300,138,126,4144694,173,73,D/WB LC,3,3,2,1,3,3,3,3,1,4,2,9,11,10,7,12,9,12,8,13,12,13,8,13,12,13,13,12,12,12,11,13,11,8,12,13,12,13,15,14,12,14,7,20,13,12,6,16,13,13,10,11,7,11,9,10,12,10,12,10,12,4,20,18,9,1,1,20,15,D/WB LC,114,1,1,1,1,1,1,15,20,1,1,1,9,1,18,1,0,0,0,0,0,0,0,0,0,0,0,0,0,0,0,0,0,0,0,0,0,0,0,0,0,0,0,0,0,0,0,0,0,0,0,0,0,0,0,0,0,0,0,0,0,0,0,0,0,Carles Planas,£720Th. ,29,175,Defender - Left-Back,left,AEK Larnaca,14,0,0,1158,7,0,1,306,7,0,1,419,13,1,1,1075,0,0,0,0,LaLiga
19-06-17,18.3.4.28,Marc Muniesa,67046414,796,27-Mar-92,25,0,0,3,0,5300,6500,6350,148,132,19115882,179,72,D LC,2,2,3,1,3,3,2,3,3,3,2,4,11,10,8,13,6,12,6,9,13,14,7,14,15,12,15,14,13,14,13,14,13,12,10,11,14,15,15,14,14,14,10,20,10,14,6,14,12,13,10,11,13,9,12,11,15,11,13,13,14,7,20,15,1,1,1,19,20,D LC,104,1,10,1,1,1,1,20,19,1,1,1,1,1,15,1,4294967328,0,0,0,0,0,1,0,0,0,0,0,0,0,0,0,0,0,0,0,0,0,0,0,0,0,0,0,0,0,0,0,0,1,0,0,0,0,0,0,0,0,0,0,0,0,0,0,0,Marc Muniesa,£2.25m ,28,180,Defender - Centre-Back,left,Al-Arabi SC,15,1,0,1127,14,0,1,1219,24,0,0,1808,21,1,3,1890,6,0,0,535,LaLiga
19-06-17,18.3.4.28,Víctor Ruiz,67046591,796,25-Jan-89,28,0,0,5,0,6000,7200,7200,153,145,20698920,184,80,D C,3,3,4,3,3,3,2,2,3,1,2,7,9,10,7,12,8,15,10,13,16,14,9,15,12,12,14,16,14,14,11,14,12,8,12,8,16,14,15,11,10,9,13,20,11,14,9,13,16,15,11,12,12,11,8,10,9,11,10,10,11,7,20,8,1,1,1,10,20,D C,101,1,9,1,1,1,1,20,10,1,11,1,1,1,8,1,33554432,0,0,0,0,0,0,0,0,0,0,0,0,0,0,0,0,0,0,0,0,0,0,0,0,0,1,0,0,0,0,0,0,0,0,0,0,0,0,0,0,0,0,0,0,0,0,0,0,Víctor Ruiz,£10.80m ,31,184,Defender - Centre-Back,left,Real Betis Balompié,36,1,1,3077,34,2,1,3047,33,0,0,2966,26,0,1,2302,1,0,0,10,LaLiga
19-06-17,18.3.4.28,Martín Mantovani,67047093,1649,07-Jul-84,32,0,0,0,0,5116,5116,6200,128,124,1197915,185,78,D C,2,1,3,3,3,1,2,3,3,2,1,8,9,11,8,10,9,13,9,9,14,9,8,14,7,13,14,15,11,13,8,13,11,1,16,11,14,15,15,10,10,9,14,10,13,12,20,12,14,14,4,13,5,11,12,9,11,13,12,10,12,2,20,1,1,1,1,1,20,D C,101,1,10,1,1,1,1,20,1,1,10,1,1,1,1,1,4295000064,0,0,0,0,0,0,0,0,0,0,0,0,0,0,0,1,0,0,0,0,0,0,0,0,0,0,0,0,0,0,0,0,1,0,0,0,0,0,0,0,0,0,0,0,0,0,0,0,Martín Mantovani,£450Th. ,36,185,Defender - Centre-Back,right,FC Andorra,32,1,0,2788,20,1,0,1253,22,2,1,1821,25,0,1,2091,1,0,0,16,LaLiga
19-06-17,18.3.4.28,Jonás Ramalho,67054790,796,10-Jun-93,24,0,0,0,0,4000,6200,6200,137,125,4220774,181,70,D RC,1,2,3,4,2,1,2,1,2,2,2,3,8,9,4,10,5,13,7,11,13,11,5,13,11,14,13,13,12,12,10,12,11,10,13,9,15,14,15,12,12,11,11,12,14,14,20,14,14,12,9,13,11,12,11,14,12,13,12,10,13,6,20,13,8,1,18,8,20,D RC,103,1,1,1,1,1,1,20,8,18,13,1,1,8,6,13,0,0,0,0,0,0,0,0,0,0,0,0,0,0,0,0,0,0,0,0,0,0,0,0,0,0,0,0,0,0,0,0,0,0,0,0,0,0,0,0,0,0,0,0,0,0,0,0,0,Jonás Ramalho,£3.60m ,27,185,Defender - Centre-Back,right,Girona FC,32,2,1,2836,28,0,0,2477,27,1,0,2070,23,0,0,1735,5,0,0,358,LaLiga
19-06-17,18.3.4.28,Víctor Laguardia,67059116,796,05-Nov-89,27,0,0,2,0,3700,6200,6200,127,125,2852020,185,80,D C,4,1,4,3,3,3,3,3,1,3,1,4,8,8,6,9,6,12,8,13,15,10,7,14,9,16,13,19,13,15,10,14,16,4,12,8,12,16,17,11,10,10,14,8,12,12,20,13,13,16,12,13,13,12,12,12,17,12,15,13,15,5,20,1,1,1,13,9,20,D C,101,1,8,1,1,1,1,20,9,13,1,1,1,1,1,1,1.37439E+11,0,0,0,0,0,0,0,0,0,0,0,0,0,0,0,1,0,0,0,0,0,0,0,0,0,0,0,0,0,0,0,0,0,0,0,0,0,1,0,0,0,0,0,0,0,0,0,0,Víctor Laguardia,£1.62m ,30,185,Defender - Centre-Back,right,Deportivo Alavés,31,2,1,2517,19,2,0,1740,36,1,2,3240,32,1,2,2706,7,0,0,552,LaLiga
19-06-17,18.3.4.28,Marc Bartra,67063004,796,15-Jan-91,26,12,0,16,2,6400,7400,7400,152,148,29918771,184,73,D C,3,1,1,2,3,1,1,3,1,2,2,7,10,12,9,14,7,15,8,12,16,13,9,17,14,15,18,14,18,15,12,13,14,10,11,10,12,10,14,14,14,11,13,10,13,12,20,14,11,15,8,13,7,8,10,12,16,13,17,14,12,7,20,10,1,1,14,8,20,D C,101,1,14,1,1,1,1,20,8,14,1,1,1,1,5,10,1.15306E+18,0,0,0,0,0,0,0,0,0,0,0,0,0,0,0,0,0,0,0,0,0,0,0,0,0,0,0,0,0,0,0,0,1,0,0,0,0,0,0,0,0,0,0,0,0,0,0,1,Marc Bartra,£15.75m ,29,184,Defender - Centre-Back,right,Real Betis Balompié,31,1,4,2606,36,5,1,2912,46,1,0,3960,33,3,1,2780,7,0,0,630,LaLiga
19-06-17,18.3.4.28,Jordi Amat,67064765,796,21-Mar-92,25,0,0,15,0,5250,6250,6400,135,128,18027023,184,83,D C,3,3,3,1,2,3,1,1,3,1,3,7,8,10,6,12,6,12,9,8,13,11,6,14,11,18,14,17,13,12,10,11,15,9,12,9,15,14,17,12,11,13,12,14,15,12,20,14,14,13,15,14,13,6,18,13,16,15,18,11,7,3,20,1,1,1,7,6,20,D C,101,1,1,1,1,1,1,20,6,7,5,1,1,1,1,1,32768,0,0,0,0,0,0,0,0,0,0,0,0,0,0,0,1,0,0,0,0,0,0,0,0,0,0,0,0,0,0,0,0,0,0,0,0,0,0,0,0,0,0,0,0,0,0,0,0,Jordi Amat,£4.50m ,28,184,Defender - Centre-Back,right,KAS Eupen,19,0,0,1542,26,0,0,2142,31,0,0,2764,25,2,0,2046,9,0,0,810,LaLiga
19-06-17,18.3.4.28,Sergi Gómez,67071183,796,28-Jul-92,24,0,0,39,1,4250,6750,6750,152,135,11709950,183,75,D C,3,1,4,1,2,2,1,3,2,2,1,6,9,10,8,12,7,14,9,12,14,16,9,15,14,10,13,13,12,12,14,13,4,7,14,8,16,15,14,12,9,9,13,8,13,15,20,13,14,14,9,12,10,6,15,10,11,12,13,8,16,2,20,8,1,1,13,1,20,D C,101,1,10,1,1,1,1,20,1,13,9,1,1,1,1,8,4294967296,0,0,0,0,0,0,0,0,0,0,0,0,0,0,0,0,0,0,0,0,0,0,0,0,0,0,0,0,0,0,0,0,1,0,0,0,0,0,0,0,0,0,0,0,0,0,0,0,Sergi Gómez,£7.20m ,28,185,Defender - Centre-Back,right,Sevilla FC,36,1,0,2501,35,1,0,2862,48,0,1,4131,21,0,0,1413,4,0,0,223,LaLiga
19-06-17,18.3.4.28,Juanpe,67072242,796,30-Apr-91,26,0,0,0,0,3750,6100,6100,128,122,2874551,190,80,D C,1,2,2,3,3,3,1,3,1,2,1,6,6,8,4,12,6,14,7,8,14,13,5,14,12,11,13,13,13,14,11,13,11,9,11,8,14,14,14,11,8,7,15,10,14,12,20,13,14,13,7,11,7,10,12,10,12,8,12,15,15,9,20,1,1,1,4,1,20,D C,101,1,1,1,1,1,1,20,1,4,15,1,1,1,1,1,8.80039E+12,0,0,0,0,0,0,0,0,0,0,0,0,0,0,0,0,0,0,0,0,0,0,0,0,0,0,0,0,0,0,0,0,1,0,0,0,0,0,0,0,0,0,0,1,0,0,0,0,Juanpe,£4.50m ,29,190,Defender - Centre-Back,right,Girona FC,34,2,1,2997,35,5,2,3064,36,0,0,2991,37,0,1,3240,1,0,0,90,LaLiga
19-06-17,18.3.4.28,Sergio Postigo,67072387,796,04-Nov-88,28,0,0,0,0,4250,6500,6500,135,130,5043590,185,75,D RC,1,2,3,3,2,3,2,2,1,3,2,5,5,5,5,10,5,14,8,8,15,10,5,14,9,14,14,15,12,15,9,14,15,6,14,7,14,15,15,11,9,11,13,10,14,13,20,14,15,15,13,13,9,10,14,12,12,13,15,14,12,8,20,1,1,1,15,1,20,D RC,103,1,10,1,1,1,1,20,1,15,1,1,1,1,1,1,32768,0,0,0,0,0,0,0,0,0,0,0,0,0,0,0,1,0,0,0,0,0,0,0,0,0,0,0,0,0,0,0,0,0,0,0,0,0,0,0,0,0,0,0,0,0,0,0,0,Sergio Postigo,£1.80m ,31,185,Defender - Centre-Back,right,Levante UD,36,2,1,3169,32,1,0,2603,23,1,1,1611,28,1,1,2375,5,0,0,288,LaLiga
19-06-17,18.3.4.28,Hugo Mallo,67086276,796,22-Jun-91,25,0,0,12,0,5200,7300,7300,157,146,24823866,174,75,D/WB RC,3,1,1,3,2,1,1,2,3,3,1,4,13,11,9,12,7,10,6,14,13,12,9,15,12,16,14,16,14,16,10,13,15,7,12,13,15,15,16,15,13,13,9,12,13,14,20,15,14,15,9,13,7,8,16,13,15,11,11,8,6,3,20,17,8,1,20,9,18,D/WB RC,113,1,1,1,1,1,1,18,9,20,1,1,1,8,6,17,0,0,0,0,0,0,0,0,0,0,0,0,0,0,0,0,0,0,0,0,0,0,0,0,0,0,0,0,0,0,0,0,0,0,0,0,0,0,0,0,0,0,0,0,0,0,0,0,0,Hugo Mallo,£10.80m ,29,174,Defender - Right-Back,right,Celta de Vigo,41,3,4,3638,38,0,7,3364,35,1,4,3094,29,0,1,2117,5,0,0,450,LaLiga
19-06-17,18.3.4.28,Raúl Navas,67086925,796,11-May-88,29,0,0,0,0,4250,7000,7000,140,138,14069616,185,83,D C,3,1,2,3,4,2,1,3,3,3,1,5,6,7,6,8,8,15,8,6,16,13,10,14,14,15,13,13,14,15,11,12,8,8,13,8,14,16,16,12,12,12,13,12,13,12,20,15,14,14,14,12,7,12,7,10,10,10,12,13,11,3,20,1,1,1,7,1,20,D C,101,1,10,1,1,1,1,20,1,7,5,1,1,1,1,1,4294967296,0,0,0,0,0,0,0,0,0,0,0,0,0,0,0,0,0,0,0,0,0,0,0,0,0,0,0,0,0,0,0,0,1,0,0,0,0,0,0,0,0,0,0,0,0,0,0,0,Raúl Navas,£2.70m ,32,187,Defender - Centre-Back,right,CA Osasuna,35,1,1,3068,25,1,1,2223,16,0,0,1311,10,0,0,800,1,0,0,79,LaLiga
19-06-17,18.3.4.28,Zouhair Feddal,67087626,34,01-Jan-89,28,11,0,8,0,5600,6500,6500,140,132,5102436,190,78,D C,1,1,3,3,1,2,1,3,1,3,1,8,8,9,7,10,9,13,8,8,14,11,5,14,11,13,16,14,13,14,11,13,13,10,11,12,14,13,15,12,11,10,16,20,14,13,7,14,14,12,9,11,5,9,12,12,10,12,12,13,14,8,20,12,1,1,1,14,20,D C,101,1,5,1,1,1,1,20,14,1,1,1,1,1,12,1,0,0,0,0,0,0,0,0,0,0,0,0,0,0,0,0,0,0,0,0,0,0,0,0,0,0,0,0,0,0,0,0,0,0,0,0,0,0,0,0,0,0,0,0,0,0,0,0,0,Zouhair Feddal,£2.70m ,30,192,Defender - Centre-Back,left,Sporting CP,33,2,2,2785,15,3,0,1257,29,1,2,2200,18,1,3,1553,6,0,2,512,LaLiga
19-06-17,18.3.4.28,Raúl Albentosa,67088655,796,07-Sep-88,28,0,0,0,0,5200,6500,6500,140,130,5043590,192,86,D C,2,1,3,1,3,2,1,1,1,1,1,8,8,6,7,10,7,13,10,10,15,11,8,13,10,15,15,16,14,14,7,14,14,11,13,11,17,15,15,7,9,9,16,8,13,10,20,12,16,12,10,12,11,8,14,13,15,12,14,11,12,9,20,1,1,1,1,1,20,D C,101,1,1,1,1,1,1,20,1,1,14,1,1,1,1,1,4294967296,0,0,0,0,0,0,0,0,0,0,0,0,0,0,0,0,0,0,0,0,0,0,0,0,0,0,0,0,0,0,0,0,1,0,0,0,0,0,0,0,0,0,0,0,0,0,0,0,Raúl Albentosa,£1.35m ,32,192,Defender - Centre-Back,right,Without Club,29,1,1,2516,20,1,0,1748,11,2,0,990,18,2,1,1650,nan,nan,nan,nan,LaLiga
19-06-17,18.3.4.28,Álvaro,67093060,796,08-Jan-90,27,0,0,0,0,4500,7000,7000,145,141,23553068,183,76,D RC,1,4,2,1,3,3,3,1,1,2,3,5,7,10,6,12,6,14,9,13,16,12,8,14,11,14,14,15,14,15,11,14,14,7,14,7,14,12,14,13,11,13,13,12,12,13,20,14,13,13,12,13,6,12,10,16,11,13,13,10,7,9,20,1,1,1,15,1,20,D RC,103,1,1,1,1,1,1,20,1,15,9,1,1,1,1,1,32768,0,0,0,0,0,0,0,0,0,0,0,0,0,0,0,1,0,0,0,0,0,0,0,0,0,0,0,0,0,0,0,0,0,0,0,0,0,0,0,0,0,0,0,0,0,0,0,0,,,,,,,,,,,,,,,,,,,,,,,,,,,,
19-06-17,18.3.4.28,Ximo Navarro,67100203,796,23-Jan-90,27,0,0,0,0,4250,6350,6350,135,127,3961155,178,71,D/WB RC,1,3,3,3,3,2,1,2,3,2,2,9,12,11,9,10,8,12,8,6,13,11,7,14,11,13,12,13,11,13,10,12,11,9,13,12,12,12,13,15,12,13,11,9,13,15,20,13,11,14,11,8,2,14,19,11,14,11,9,13,10,2,20,18,7,1,20,14,19,D/WB RC,113,1,1,1,1,1,1,19,14,20,1,1,1,7,1,18,32,0,0,0,0,0,1,0,0,0,0,0,0,0,0,0,0,0,0,0,0,0,0,0,0,0,0,0,0,0,0,0,0,0,0,0,0,0,0,0,0,0,0,0,0,0,0,0,0,Ximo Navarro,£1.80m ,30,176,Defender - Right-Back,right,Deportivo Alavés,37,2,1,3324,33,0,0,2713,31,2,2,2532,23,0,0,1906,6,0,0,494,LaLiga
19-06-17,18.3.4.28,Ińigo Martínez,67104772,796,17-May-91,26,2,0,4,0,5500,7400,7400,159,148,44015115,181,77,D C,3,2,1,3,1,1,4,1,3,2,2,5,6,9,8,12,14,14,16,5,15,15,3,16,15,17,17,16,14,14,13,13,16,13,15,7,16,15,15,14,12,13,12,20,12,13,9,13,15,14,14,13,6,5,14,14,16,13,14,14,11,10,20,1,1,1,1,10,20,D C,101,1,1,1,1,1,1,20,10,1,1,1,1,1,1,1,4.40492E+13,0,0,0,0,0,0,0,0,1,0,0,0,0,0,0,0,0,0,0,0,0,0,0,0,0,0,0,0,0,0,0,0,0,0,0,0,1,0,0,0,0,0,0,1,0,1,0,0,Iñigo Martínez,£28.80m ,29,182,Defender - Centre-Back,left,Athletic Bilbao,40,4,4,3539,32,1,1,2856,35,0,2,3084,40,1,3,3660,6,0,0,540,LaLiga
19-06-17,18.3.4.28,Bruno,67107164,796,24-May-90,27,0,0,0,0,4250,6350,6350,135,127,4194165,184,82,D C,1,2,1,3,1,3,3,1,1,3,3,4,9,6,6,10,5,14,8,10,14,9,6,14,8,14,14,15,12,13,6,13,15,6,12,9,14,12,15,13,12,11,13,7,14,13,20,14,15,13,11,12,5,11,12,14,11,12,15,13,12,6,20,1,1,1,12,1,20,D C,101,1,1,1,1,1,1,20,1,12,10,1,1,1,1,1,1.37439E+11,0,0,0,0,0,0,0,0,0,0,0,0,0,0,0,1,0,0,0,0,0,0,0,0,0,0,0,0,0,0,0,0,0,0,0,0,0,1,0,0,0,0,0,0,0,0,0,0,Bruno,£675Th. ,40,180,Defender - Right-Back,right,Retired,42,0,5,3719,26,0,1,2107,18,0,1,1537,nan,nan,nan,nan,nan,nan,nan,nan,Premier League
19-06-17,18.3.4.28,Pedro Bigas,67122014,796,15-May-90,27,0,0,0,0,4650,6750,6750,148,136,10651468,181,78,D/DM LC,2,3,2,3,1,4,2,2,3,3,2,6,7,9,9,10,8,14,8,5,14,10,8,14,11,12,13,14,13,14,10,13,14,10,14,11,14,14,15,12,12,12,12,20,14,13,10,14,14,14,10,10,14,17,9,13,8,13,15,12,11,5,20,12,14,7,9,17,20,D/DM LC,114,1,1,1,1,7,1,20,17,9,18,14,9,1,12,8,0,0,0,0,0,0,0,0,0,0,0,0,0,0,0,0,0,0,0,0,0,0,0,0,0,0,0,0,0,0,0,0,0,0,0,0,0,0,0,0,0,0,0,0,0,0,0,0,0,Pedro Bigas,£1.35m ,30,181,Defender - Centre-Back,left,SD Eibar,33,4,1,2695,14,0,0,1076,12,0,1,764,24,3,0,1824,4,0,0,315,LaLiga
19-06-17,18.3.4.28,Álex Gálvez,67131398,796,06-Jun-89,28,0,0,0,0,4800,6500,6500,139,130,5043590,190,79,D C,1,3,3,1,3,3,1,3,2,3,2,6,8,9,7,11,12,14,10,11,16,12,8,16,11,14,15,17,14,10,9,13,13,7,10,8,13,13,12,10,10,10,15,8,13,12,20,14,14,13,14,13,8,12,8,14,11,9,16,12,12,6,20,1,12,1,1,1,20,D C,101,1,1,1,1,1,1,20,1,1,15,12,1,1,1,1,3.52531E+13,0,0,0,0,0,0,0,0,0,0,0,0,0,0,0,0,0,0,0,0,0,0,0,0,0,0,0,0,0,0,0,0,0,0,0,0,1,0,0,0,0,0,0,0,0,1,0,0,,,,,,,,,,,,,,,,,,,,,,,,,,,,
19-06-17,18.3.4.28,Unai Bustinza,67132476,796,02-Feb-92,25,0,0,0,0,3250,6200,6200,130,124,950256,175,76,D RC,3,3,1,3,3,3,2,2,1,2,2,9,7,5,3,10,6,13,5,11,15,12,11,14,9,13,15,13,12,11,7,10,12,6,15,9,13,12,15,13,10,12,10,10,16,14,20,16,15,12,13,5,11,14,7,8,9,14,14,15,13,12,20,1,1,1,20,12,17,D RC,103,1,1,1,1,1,1,17,12,20,1,1,1,1,1,1,0,0,0,0,0,0,0,0,0,0,0,0,0,0,0,0,0,0,0,0,0,0,0,0,0,0,0,0,0,0,0,0,0,0,0,0,0,0,0,0,0,0,0,0,0,0,0,0,0,Unai Bustinza,£1.62m ,28,175,Defender - Centre-Back,right,CD Leganés,22,0,1,1790,26,2,1,2176,28,0,1,2278,35,0,2,2870,4,0,0,33,LaLiga
19-06-17,18.3.4.28,Jonny,67144651,796,03-Mar-94,23,0,0,20,0,4750,7250,7250,157,145,23135854,170,70,D/WB RLC,3,3,3,2,2,3,3,2,1,2,1,6,12,13,10,10,7,10,7,13,14,12,8,14,11,14,14,16,13,16,9,13,17,8,12,11,14,15,16,15,14,12,10,8,15,15,20,15,12,17,14,14,6,14,13,19,9,12,10,9,10,6,20,17,1,1,20,19,18,D/WB RLC,116,1,1,1,1,1,1,18,19,20,1,1,1,1,17,17,0,0,0,0,0,0,0,0,0,0,0,0,0,0,0,0,0,0,0,0,0,0,0,0,0,0,0,0,0,0,0,0,0,0,0,0,0,0,0,0,0,0,0,0,0,0,0,0,0,Jony,£1.80m ,29,179,Forward - Left Winger,left,CA Osasuna,26,2,1,1372,30,6,5,2163,37,4,11,2993,32,0,4,1659,4,0,0,187,LaLiga
19-06-17,18.3.4.28,Chema,67154282,796,03-Mar-92,25,0,0,0,0,3750,6550,6550,142,131,5881900,189,80,D C,1,1,1,3,2,3,2,2,3,2,1,7,9,9,9,12,7,14,7,7,14,12,7,14,11,14,15,15,12,13,10,13,14,10,14,7,14,14,15,11,12,9,15,20,13,13,8,13,14,13,13,12,8,7,13,14,14,14,14,14,13,6,20,1,1,1,1,5,20,D C,101,1,10,1,1,1,1,20,5,1,1,1,1,1,1,1,4294967296,0,0,0,0,0,0,0,0,0,0,0,0,0,0,0,0,0,0,0,0,0,0,0,0,0,0,0,0,0,0,0,0,1,0,0,0,0,0,0,0,0,0,0,0,0,0,0,0,Chema,£1.80m ,28,189,Defender - Centre-Back,left,Getafe CF,32,3,0,2470,28,1,1,2204,21,2,0,1410,14,0,0,1025,0,0,0,0,LaLiga
19-06-17,18.3.4.28,David López,67155094,796,09-Oct-89,27,0,0,0,0,6200,7250,7250,152,145,25857720,183,83,D/DM C,1,1,2,3,1,2,2,1,3,3,2,7,8,9,8,13,9,14,10,9,14,12,9,15,12,13,14,15,14,15,12,15,9,7,15,10,15,18,15,13,12,12,12,10,13,13,20,15,14,15,11,13,6,14,12,13,12,12,13,10,10,5,19,1,15,1,12,1,19,D/DM C,321,1,1,1,1,1,1,19,1,12,20,15,1,1,1,1,0,0,0,0,0,0,0,0,0,0,0,0,0,0,0,0,0,0,0,0,0,0,0,0,0,0,0,0,0,0,0,0,0,0,0,0,0,0,0,0,0,0,0,0,0,0,0,0,0,David López,£7.20m ,31,185,Midfielder - Defensive Midfield,right,RCD Espanyol Barcelona,37,3,2,3360,43,1,1,3870,24,0,0,2079,36,4,3,2695,8,0,1,671,LaLiga
19-06-17,18.3.4.28,Rubén Duarte,67158096,796,18-Oct-95,21,0,0,2,0,4000,6500,6500,146,129,9217069,180,75,D/WB LC,2,4,3,3,2,4,3,3,2,1,2,10,10,9,7,13,12,9,9,11,13,13,4,14,12,11,14,13,13,13,12,13,11,8,13,11,15,14,13,13,13,13,8,20,14,14,7,14,11,13,9,11,8,11,13,11,10,12,12,10,17,8,20,18,1,1,1,20,18,D/WB LC,114,1,1,1,1,1,1,18,20,1,9,1,1,1,18,1,0,0,0,0,0,0,0,0,0,0,0,0,0,0,0,0,0,0,0,0,0,0,0,0,0,0,0,0,0,0,0,0,0,0,0,0,0,0,0,0,0,0,0,0,0,0,0,0,0,Rubén Duarte,£1.80m ,25,180,Defender - Left-Back,left,Deportivo Alavés,5,0,0,257,26,0,2,2351,33,0,0,2774,31,0,2,2664,6,0,0,476,LaLiga
19-06-17,18.3.4.28,Diego González,67184689,796,28-Jan-95,22,0,0,0,0,3350,6700,6700,154,134,13817838,185,78,D/DM LC,3,2,2,2,3,1,2,3,1,3,3,3,14,11,4,11,5,13,6,4,14,13,7,15,11,15,13,14,13,13,6,13,13,7,14,7,13,13,13,13,11,7,14,20,13,13,12,13,15,13,11,12,6,14,12,13,11,10,11,12,19,1,20,10,12,1,12,20,20,D/DM LC,114,1,14,1,1,1,1,20,20,12,18,12,12,1,10,4,0,0,0,0,0,0,0,0,0,0,0,0,0,0,0,0,0,0,0,0,0,0,0,0,0,0,0,0,0,0,0,0,0,0,0,0,0,0,0,0,0,0,0,0,0,0,0,0,0,Diego González,£1.80m ,25,185,Defender - Centre-Back,left,Elche CF,40,0,0,3186,18,1,0,1432,24,0,0,1861,33,0,0,2470,1,0,0,6,LaLiga
19-06-17,18.3.4.28,Carlos Vigaray,67186783,796,07-Sep-94,22,0,0,0,0,3500,6100,6100,134,122,4641526,183,70,D RLC,1,2,3,3,2,2,3,2,1,2,2,8,11,12,7,12,8,11,8,8,13,9,7,13,10,12,13,12,12,13,9,12,11,1,8,13,12,14,14,13,12,10,13,12,9,14,20,14,13,12,4,2,11,14,9,12,10,10,12,10,14,4,20,14,1,1,20,16,18,D RLC,106,1,1,1,1,1,1,18,16,20,1,1,1,1,14,14,0,0,0,0,0,0,0,0,0,0,0,0,0,0,0,0,0,0,0,0,0,0,0,0,0,0,0,0,0,0,0,0,0,0,0,0,0,0,0,0,0,0,0,0,0,0,0,0,0,Carlos Vigaray,£720Th. ,26,182,Defender - Right-Back,right,Real Zaragoza,26,0,3,1408,13,0,0,983,10,0,0,826,26,1,0,2149,2,0,0,143,LaLiga
19-06-17,18.3.4.28,Aritz Elustondo,67190072,796,28-Mar-94,23,0,0,0,0,4350,6500,6500,145,134,5609093,182,72,D RC,3,2,2,2,1,2,3,1,3,3,2,4,12,9,5,12,7,15,12,12,14,12,6,14,13,13,12,16,13,14,14,13,12,4,7,9,13,17,14,12,12,12,13,10,8,14,20,13,12,11,11,8,10,12,10,13,10,10,10,13,17,3,20,1,1,1,20,1,17,D RC,103,1,1,1,1,1,1,17,1,20,1,1,1,1,1,1,0,0,0,0,0,0,0,0,0,0,0,0,0,0,0,0,0,0,0,0,0,0,0,0,0,0,0,0,0,0,0,0,0,0,0,0,0,0,0,0,0,0,0,0,0,0,0,0,0,Aritz Elustondo,£4.50m ,26,182,Defender - Centre-Back,right,Real Sociedad,12,0,1,714,24,3,2,1972,29,1,1,2362,26,0,1,1762,8,0,0,720,LaLiga
19-06-17,18.3.4.28,Yeray,67192475,796,24-Jan-95,22,0,0,0,0,4250,6950,6950,147,139,31137695,182,77,D RC,3,3,1,2,2,2,1,1,2,1,1,7,12,9,7,11,8,15,9,6,15,13,8,14,10,13,14,16,15,14,11,13,13,8,13,5,14,15,16,13,12,12,13,9,12,13,20,14,14,13,13,12,8,12,18,12,15,12,15,14,10,7,20,13,1,1,17,1,20,D RC,103,1,1,1,1,1,1,20,1,17,1,1,1,1,1,13,8.79609E+12,0,0,0,0,0,0,0,0,0,0,0,0,0,0,0,0,0,0,0,0,0,0,0,0,0,0,0,0,0,0,0,0,0,0,0,0,0,0,0,0,0,0,0,1,0,0,0,0,,,,,,,,,,,,,,,,,,,,,,,,,,,,
19-06-17,18.3.4.28,Jesús Vallejo,67192921,796,05-Jan-97,20,0,0,4,0,6200,6700,6700,154,134,15366786,184,79,D C,1,1,1,2,3,1,1,3,3,2,3,5,8,9,7,12,6,12,8,9,14,13,8,15,13,14,17,12,17,13,12,16,14,7,14,7,14,17,10,10,12,10,13,9,15,12,20,12,11,16,6,15,12,10,12,17,12,15,14,16,18,4,20,8,11,1,13,1,20,D C,101,1,12,1,1,1,1,20,1,13,11,11,1,1,1,8,2.74878E+11,0,0,0,0,0,0,0,0,0,0,0,0,0,0,0,0,0,0,0,0,0,0,0,0,0,0,0,0,0,0,0,0,0,0,0,0,0,0,1,0,0,0,0,0,0,0,0,0,Jesús Vallejo,£10.80m ,23,184,Defender - Centre-Back,right,Granada CF,27,1,1,2295,12,0,0,1004,7,1,0,491,21,0,0,1493,8,0,0,630,LaLiga
19-06-17,18.3.4.28,Róber,67194879,796,16-Feb-95,22,0,0,0,0,3850,6200,6200,135,125,4734607,182,74,D/DM RC,1,2,3,3,2,2,1,1,3,2,2,6,7,8,7,10,7,13,7,10,14,11,8,13,10,13,12,14,13,14,8,13,12,9,10,8,13,14,14,12,12,11,12,10,13,13,20,14,14,14,11,12,7,12,14,13,14,13,14,14,8,7,20,12,5,1,16,12,20,D/DM RC,113,1,1,1,1,1,1,20,12,16,17,5,1,1,5,12,0,0,0,0,0,0,0,0,0,0,0,0,0,0,0,0,0,0,0,0,0,0,0,0,0,0,0,0,0,0,0,0,0,0,0,0,0,0,0,0,0,0,0,0,0,0,0,0,0,,,,,,,,,,,,,,,,,,,,,,,,,,,,
19-06-17,18.3.4.28,Mario Hermoso,67196188,796,18-Jun-95,22,0,0,5,2,4000,6500,6500,140,130,8622911,181,72,D LC,3,1,3,1,2,3,1,1,3,3,2,10,9,9,5,9,8,11,9,13,13,11,5,14,11,12,12,13,13,14,10,12,12,8,10,9,14,13,14,14,14,13,11,20,13,15,10,14,14,13,5,10,8,15,11,10,11,11,9,12,11,5,20,14,8,1,1,18,20,D LC,104,1,1,1,1,1,1,20,18,1,1,1,8,1,14,1,0,0,0,0,0,0,0,0,0,0,0,0,0,0,0,0,0,0,0,0,0,0,0,0,0,0,0,0,0,0,0,0,0,0,0,0,0,0,0,0,0,0,0,0,0,0,0,0,0,Mario Hermoso,£4.50m ,25,184,Defender - Centre-Back,left,Atlético Madrid,33,1,2,2951,24,1,0,2109,35,3,0,3106,23,0,0,1691,3,0,1,257,LaLiga
19-06-17,18.3.4.28,Lucas,67197145,769,14-Feb-96,21,0,0,5,0,5500,6900,6900,165,138,19128760,184,76,D LC,1,1,1,3,2,2,1,1,2,2,1,7,8,9,8,11,6,14,6,10,15,12,5,15,12,15,14,15,13,12,10,13,5,10,13,9,13,13,13,14,13,12,12,20,15,14,10,15,14,12,14,4,12,12,9,15,10,12,10,7,9,6,20,15,1,1,1,16,20,D LC,104,1,1,1,1,1,1,20,16,1,1,1,1,1,15,1,1.37439E+11,0,0,0,0,0,0,0,0,0,0,0,0,0,0,0,0,0,0,0,0,0,0,0,0,0,0,0,0,0,0,0,0,0,0,0,0,0,1,0,0,0,0,0,0,0,0,0,0,,,,,,,,,,,,,,,,,,,,,,,,,,,,
19-06-17,18.3.4.28,José León,67199304,796,03-Feb-95,22,0,0,0,0,2250,4900,4900,120,98,430342,183,80,D C,3,3,1,3,2,3,1,1,3,1,3,2,4,6,3,11,1,12,8,4,13,11,5,15,10,10,7,10,11,11,9,15,10,1,10,9,14,9,11,13,13,10,7,20,11,15,10,9,9,10,6,10,5,10,15,12,12,12,9,11,16,4,20,1,9,1,1,8,20,D C,101,1,13,1,1,1,1,20,8,1,14,9,1,1,1,1,0,0,0,0,0,0,0,0,0,0,0,0,0,0,0,0,0,0,0,0,0,0,0,0,0,0,0,0,0,0,0,0,0,0,0,0,0,0,0,0,0,0,0,0,0,0,0,0,0,,,,,,,,,,,,,,,,,,,,,,,,,,,,
19-06-17,18.3.4.28,Unai Núńez,67214595,796,30-Jan-97,20,0,0,0,0,4250,6850,6850,155,137,32027508,186,80,D RC,1,4,2,3,3,1,4,2,3,2,2,6,6,7,8,11,8,14,9,10,15,11,10,15,11,13,15,15,13,14,10,14,17,7,10,8,14,14,15,12,13,11,13,8,14,13,20,13,14,14,8,11,8,11,13,10,13,12,10,11,20,1,20,14,1,1,16,1,20,D RC,103,1,1,1,1,1,1,20,1,16,1,1,1,1,1,14,0,0,0,0,0,0,0,0,0,0,0,0,0,0,0,0,0,0,0,0,0,0,0,0,0,0,0,0,0,0,0,0,0,0,0,0,0,0,0,0,0,0,0,0,0,0,0,0,0,Unai Núñez,£13.50m ,23,186,Defender - Centre-Back,right,Athletic Bilbao,33,3,0,2806,36,1,0,3167,15,0,0,1276,26,0,0,2053,3,0,0,270,LaLiga
19-06-17,18.3.4.28,Iván Ramis,7444112,796,25-Oct-84,32,0,0,3,0,4200,6550,6550,144,131,2653119,188,82,D C,3,3,1,2,2,1,1,2,2,2,2,6,5,6,7,10,12,16,9,10,15,14,8,14,10,16,13,17,14,15,8,15,15,4,12,6,14,15,14,8,9,10,15,12,11,9,20,13,14,14,13,12,11,10,13,12,17,12,15,10,12,4,20,1,1,1,7,1,20,D C,101,1,8,1,1,1,1,20,1,7,6,1,1,1,1,1,3.51844E+13,0,0,0,0,0,0,0,0,0,0,0,0,0,0,0,1,0,0,0,0,0,0,0,0,0,0,0,0,0,0,0,0,0,0,0,0,0,0,0,0,0,0,0,0,0,1,0,0,Iván Ramis,£450Th. ,36,189,Defender - Centre-Back,right,Retired,22,3,0,1721,16,3,0,1303,22,0,1,1718,7,1,0,458,nan,nan,nan,nan,LaLiga
19-06-17,18.3.4.28,Alexis,7444671,796,04-Aug-85,31,0,0,3,0,5750,6750,6750,140,135,232186002,183,75,D C,1,1,4,3,1,2,2,2,1,2,3,7,7,8,6,12,6,16,8,9,14,11,9,16,12,15,15,15,13,12,10,12,10,7,9,10,14,15,14,13,12,14,14,13,11,13,20,12,12,12,15,14,12,14,8,10,10,9,9,9,7,12,20,3,1,1,12,13,20,D C,101,1,12,1,1,1,1,20,13,12,8,1,1,1,3,2,1.37439E+11,0,0,0,0,0,0,0,0,0,0,0,0,0,0,0,0,0,0,0,0,0,0,0,0,0,0,0,0,0,0,0,0,0,0,0,0,0,1,0,0,0,0,0,0,0,0,0,0,,,,,,,,,,,,,,,,,,,,,,,,,,,,
19-06-17,18.3.4.28,Sergio Ramos,7458272,796,30-Mar-86,31,143,10,6,0,8600,8850,8850,174,174,232186002,184,83,D C,1,1,2,1,4,2,2,4,4,3,2,9,11,13,13,14,14,20,14,12,16,16,14,18,14,18,18,17,13,10,13,11,20,15,19,12,14,14,16,13,15,15,16,14,15,15,20,17,16,11,18,20,7,14,10,18,15,16,17,6,7,15,20,13,10,1,14,1,20,D C,101,1,9,1,1,1,1,20,1,14,12,10,1,1,1,13,1.84722E+14,0,0,0,0,0,1,0,0,0,0,0,0,0,0,0,0,0,0,0,0,0,0,0,0,0,0,0,0,0,0,0,0,1,0,0,0,0,0,0,0,0,0,0,1,0,1,0,1,Sergio Ramos,£40.50m ,34,184,Defender - Centre-Back,right,Real Madrid,44,10,2,3988,42,5,1,3731,42,11,2,3662,44,13,1,3828,6,2,0,495,LaLiga
19-06-17,18.3.4.28,David Lombán,7458361,796,05-Jun-87,30,0,0,0,0,4350,6550,6550,138,131,232186002,188,84,D C,1,1,2,3,1,2,2,2,1,3,3,5,5,10,8,11,13,14,8,10,15,12,16,14,13,12,13,13,13,14,11,13,16,10,14,11,13,15,13,10,11,9,15,8,13,13,20,14,15,16,9,13,5,10,8,11,13,10,13,11,16,1,20,1,1,1,1,1,20,D C,101,1,13,1,1,1,1,20,1,1,1,1,1,1,1,1,3.51887E+13,0,0,0,0,0,0,0,0,0,0,0,0,0,0,0,1,0,0,0,0,0,0,0,0,0,0,0,0,0,0,0,0,1,0,0,0,0,0,0,0,0,0,0,0,0,1,0,0,David Lombán,£1.08m ,33,185,Defender - Centre-Back,right,Málaga CF,23,1,0,2020,15,1,0,1175,10,0,0,472,27,3,0,2124,2,0,0,5,LaLiga
19-06-17,18.3.4.28,Guillermo Maripán,75030680,1652,06-May-94,23,3,0,0,0,3750,6250,6250,148,125,4601345,193,83,D C,3,3,1,2,3,4,2,3,1,1,3,6,5,6,5,10,6,12,8,6,13,9,4,15,7,14,13,15,11,13,8,13,14,3,8,7,14,13,15,12,12,14,16,9,16,11,20,15,15,11,12,10,4,9,8,11,13,11,13,9,9,5,20,1,1,1,1,1,20,D C,101,1,1,1,1,1,1,20,1,1,7,1,1,1,1,1,0,0,0,0,0,0,0,0,0,0,0,0,0,0,0,0,0,0,0,0,0,0,0,0,0,0,0,0,0,0,0,0,0,0,0,0,0,0,0,0,0,0,0,0,0,0,0,0,0,Guillermo Maripán,£1.35m ,26,193,Defender - Centre-Back,right,AS Monaco,31,1,1,2789,22,0,0,1827,25,2,2,2188,25,2,0,2206,2,0,0,15,LaLiga
19-06-17,18.3.4.28,Jeison Murillo,76016518,1653,27-May-92,25,25,1,4,0,5750,7250,7100,153,147,44338605,182,78,D C,2,2,1,3,2,4,3,2,4,3,1,4,6,8,8,12,5,14,5,7,16,12,8,16,12,13,17,15,14,11,11,12,13,6,11,8,16,13,16,15,14,14,13,9,16,16,20,14,14,10,11,12,7,9,14,14,12,12,16,16,15,3,20,1,1,1,1,1,20,D C,101,1,1,1,1,1,1,20,1,1,1,1,1,1,1,1,1.41734E+11,0,0,0,0,0,0,0,0,0,0,0,0,0,0,0,0,0,0,0,0,0,0,0,0,0,0,0,0,0,0,0,0,1,0,0,0,0,1,0,0,0,0,0,0,0,0,0,0,Jeison Murillo,£13.50m ,28,182,Defender - Centre-Back,right,Celta de Vigo,34,1,1,2735,17,0,0,1374,7,0,0,562,30,1,0,2373,5,0,0,439,LaLiga
19-06-17,18.3.4.28,Carlos Sánchez,78011012,1653,06-Feb-86,31,74,0,0,0,5250,7250,6800,143,136,232186002,182,82,DM/M C,2,1,2,1,3,3,1,2,3,2,1,7,9,11,9,13,9,13,12,8,14,13,10,14,13,14,15,16,16,14,12,11,12,8,13,11,14,14,16,12,11,15,11,10,15,13,20,15,15,12,12,16,6,11,12,14,10,13,14,14,12,10,15,1,20,1,1,8,20,DM/M C,421,1,1,1,1,1,1,15,8,1,19,20,1,1,1,1,33554688,0,0,0,0,0,0,0,0,1,0,0,0,0,0,0,0,0,0,0,0,0,0,0,0,0,1,0,0,0,0,0,0,0,0,0,0,0,0,0,0,0,0,0,0,0,0,0,0,Carlos Sánchez,£1.80m ,34,182,Midfielder - Defensive Midfield,left,Without Club,41,1,1,2714,25,1,0,1664,9,0,0,313,10,0,1,428,nan,nan,nan,nan,Serie A
19-06-17,18.3.4.28,Leandro Cabrera,78027200,1657,17-Jun-91,26,0,0,13,2,3500,5900,5700,119,114,2208967,188,82,D/WB LC,3,1,1,4,3,1,3,3,3,3,2,4,8,6,4,7,6,13,8,18,14,8,5,14,8,16,10,18,9,16,7,11,18,6,14,8,13,18,18,7,7,8,16,20,9,14,8,11,16,17,14,8,7,15,16,14,7,13,17,7,6,4,20,16,1,1,1,17,20,D/WB LC,114,1,8,1,1,1,1,20,17,1,1,1,1,1,16,1,1.12604E+15,0,0,0,0,0,0,0,0,0,0,0,0,0,0,0,1,0,0,0,0,0,0,0,0,0,0,0,0,0,0,0,0,0,0,0,0,0,1,0,0,0,0,0,0,0,0,0,0,Leandro Cabrera,£540Th. ,29,190,Defender - Centre-Back,left,RCD Espanyol Barcelona,38,2,2,3413,16,0,0,1265,36,2,1,3127,38,3,1,3316,8,0,0,720,Serie A
19-06-17,18.3.4.28,José Giménez,78060464,1657,20-Jan-95,22,33,4,7,0,6750,7500,7650,168,152,67271492,185,77,D C,2,1,3,1,4,3,2,3,2,1,2,7,10,11,7,11,6,16,8,13,15,12,8,15,12,15,15,16,14,14,11,14,15,10,13,10,15,16,16,14,12,12,13,12,12,13,20,15,15,12,13,13,11,12,10,14,11,14,14,7,9,6,20,1,1,1,13,1,20,D C,101,1,1,1,1,1,1,20,1,13,12,1,1,1,1,1,1.37439E+11,0,0,0,0,0,0,0,0,0,0,0,0,0,0,0,0,0,0,0,0,0,0,0,0,0,0,0,0,0,0,0,0,0,0,0,0,0,1,0,0,0,0,0,0,0,0,0,0,José Giménez,£40.50m ,25,185,Defender - Centre-Back,right,Atlético Madrid,29,1,1,1993,38,2,2,2920,29,2,0,2323,27,0,1,2150,0,0,0,0,LaLiga
19-06-17,18.3.4.28,Erick Cabaco,78065103,1657,19-Apr-95,22,0,0,16,1,3500,6200,6200,142,124,3338902,186,75,D C,1,1,2,3,2,2,1,3,3,2,2,6,7,7,7,9,7,14,8,9,14,10,8,14,9,15,14,15,12,15,7,12,15,6,13,10,13,13,16,11,11,12,13,8,13,12,20,14,15,13,13,14,8,4,13,14,10,12,12,10,13,8,20,1,1,1,1,1,20,D C,101,1,1,1,1,1,1,20,1,1,1,1,1,1,1,1,0,0,0,0,0,0,0,0,0,0,0,0,0,0,0,0,0,0,0,0,0,0,0,0,0,0,0,0,0,0,0,0,0,0,0,0,0,0,0,0,0,0,0,0,0,0,0,0,0,Erick Cabaco,£1.35m ,25,185,Defender - Centre-Back,right,Getafe CF,22,0,1,1791,18,0,1,1400,24,3,0,1909,16,0,0,1188,4,0,0,197,LaLiga
19-06-17,18.3.4.28,Oscar Duarte,80011933,366,03-Jun-89,28,25,2,0,0,5400,6700,6550,142,134,5985140,185,83,D C,3,2,2,2,3,3,3,3,3,2,1,8,8,10,9,10,10,15,10,13,15,9,7,14,11,14,14,14,12,13,6,13,15,11,12,10,14,15,15,9,12,14,14,10,12,12,20,14,14,14,12,15,12,12,14,11,10,14,14,4,12,10,20,1,1,1,1,1,20,D C,101,1,14,1,1,1,1,20,1,1,1,1,1,1,1,1,0,0,0,0,0,0,0,0,0,0,0,0,0,0,0,0,0,0,0,0,0,0,0,0,0,0,0,0,0,0,0,0,0,0,0,0,0,0,0,0,0,0,0,0,0,0,0,0,0,Óscar Duarte,£900Th. ,31,186,Defender - Centre-Back,right,Levante UD,17,0,0,1333,13,0,0,1157,13,0,0,837,9,1,0,604,2,0,0,175,LaLiga
19-06-17,18.3.4.28,Fernando Navarro,813115,796,25-Jun-82,34,2,0,3,0,4700,6350,6350,142,125,221624,177,68,D LC,2,2,1,1,1,1,1,1,3,3,2,7,9,9,4,10,7,11,6,13,16,9,9,13,12,16,14,16,15,12,8,15,13,6,12,11,14,14,13,11,11,12,11,20,14,10,8,12,12,14,16,13,8,11,11,16,16,11,13,8,8,15,20,5,1,1,5,20,18,D LC,104,1,1,1,1,1,1,18,20,5,1,1,1,1,5,1,1.37439E+11,0,0,0,0,0,0,0,0,0,0,0,0,0,0,0,1,0,0,0,0,0,0,0,0,0,0,0,0,0,0,0,0,0,0,0,0,0,1,0,0,0,0,0,0,0,0,0,0,Fernando Navarro,£90Th. ,38,176,Defender - Left-Back,left,Retired,26,0,0,2140,16,0,0,1131,nan,nan,nan,nan,nan,nan,nan,nan,nan,nan,nan,nan,LaLiga
19-06-17,18.3.4.28,Thomas Vermaelen,8154103,757,14-Nov-85,31,59,1,12,1,6900,7500,7500,160,149,19512353,183,80,D C,3,1,1,4,2,2,2,3,3,1,2,7,8,10,8,14,10,15,12,13,15,13,11,15,14,15,16,14,16,15,12,14,18,7,14,13,15,15,16,11,11,13,14,20,9,13,10,13,14,15,11,14,16,13,18,13,13,13,16,13,11,3,20,1,1,1,5,14,20,D C,101,1,1,1,1,1,1,20,14,5,1,1,1,1,1,1,4.39805E+13,0,0,0,0,0,1,0,0,0,1,0,0,0,0,0,0,0,0,0,0,0,0,0,0,0,0,0,0,0,0,0,0,0,0,0,0,0,0,0,0,0,0,0,1,0,1,0,0,Thomas Vermaelen,£4.50m ,34,183,Defender - Centre-Back,left,Vissel Kobe,12,0,0,609,20,0,1,1512,24,0,1,1829,16,0,0,1333,nan,nan,nan,nan,LaLiga
19-06-17,18.3.4.28,David García,824480,796,25-Feb-82,35,0,0,0,0,3850,6200,6200,132,124,283554,182,79,D RC,2,1,2,1,2,2,2,2,1,3,2,5,7,9,6,9,5,14,11,12,14,10,7,15,9,15,12,18,13,15,8,14,15,7,18,7,14,18,18,10,10,12,11,8,15,10,20,13,13,15,11,13,14,15,12,12,20,14,19,12,12,5,20,8,1,1,17,1,20,D RC,103,1,5,1,1,1,1,20,1,17,1,1,1,1,1,8,8.80039E+12,0,0,0,0,0,0,0,0,0,0,0,0,0,0,0,1,0,0,0,0,0,0,0,0,0,0,0,0,0,0,0,0,1,0,0,0,0,0,0,0,0,0,0,1,0,0,0,0,David García,£90Th. ,38,183,Defender - Centre-Back,right,UD Tamaraceite,25,1,1,1915,12,1,0,948,22,1,0,1851,4,1,0,390,2,0,0,180,LaLiga
19-06-17,18.3.4.28,Samuel Umtiti,85059774,769,14-Nov-93,23,8,1,7,1,7500,8050,8050,169,161,62096763,182,75,D C,1,1,2,1,3,2,2,1,3,1,3,4,11,10,6,14,7,14,10,9,16,14,8,16,14,14,18,15,17,16,11,14,15,8,11,10,17,16,15,14,14,14,11,20,15,15,10,15,15,16,12,15,8,11,11,14,16,15,14,14,14,5,20,1,1,1,1,12,20,D C,101,1,1,1,1,1,1,20,12,1,11,1,1,1,1,1,4294967296,0,0,0,0,0,0,0,0,0,0,0,0,0,0,0,0,0,0,0,0,0,0,0,0,0,0,0,0,0,0,0,0,1,0,0,0,0,0,0,0,0,0,0,0,0,0,0,0,Samuel Umtiti,£54.00m ,26,182,Defender - Centre-Back,left,FC Barcelona,43,1,0,3729,40,1,0,3539,15,0,1,1268,18,0,0,1316,nan,nan,nan,nan,LaLiga
19-06-17,18.3.4.28,Raphaël Varane,85075627,769,25-Apr-93,24,37,2,15,3,8000,8250,8250,172,164,111638837,191,82,D C,1,1,2,1,2,1,1,2,3,2,3,5,9,11,6,13,8,15,9,10,17,14,10,17,14,11,15,13,14,17,11,14,12,11,9,8,17,14,14,15,13,11,17,8,16,16,20,14,15,15,6,15,14,14,12,16,13,17,14,17,16,8,20,1,1,1,10,1,20,D C,101,1,9,1,1,1,1,20,1,10,6,1,1,1,1,1,2.74878E+11,0,0,0,0,0,0,0,0,0,0,0,0,0,0,0,0,0,0,0,0,0,0,0,0,0,0,0,0,0,0,0,0,0,0,0,0,0,0,1,0,0,0,0,0,0,0,0,0,Raphaël Varane,£63.00m ,27,191,Defender - Centre-Back,right,Real Madrid,39,4,2,3381,44,0,2,3801,43,2,0,3775,43,3,1,3843,7,0,0,630,LaLiga
19-06-17,18.3.4.28,Clément Lenglet,85078880,769,17-Jun-95,22,0,0,3,0,5500,6250,6250,152,138,5216147,186,81,D LC,3,2,1,3,3,3,1,1,2,2,1,9,10,11,8,12,10,15,8,10,14,13,8,14,11,10,15,14,11,14,12,12,14,10,14,10,14,13,15,12,13,14,14,20,12,14,8,13,15,13,9,13,10,12,12,15,12,12,14,15,9,10,20,13,10,1,1,18,20,D LC,104,1,1,1,1,1,1,20,18,1,1,1,10,1,13,1,0,0,0,0,0,0,0,0,0,0,0,0,0,0,0,0,0,0,0,0,0,0,0,0,0,0,0,0,0,0,0,0,0,0,0,0,0,0,0,0,0,0,0,0,0,0,0,0,0,Clément Lenglet,£22.50m ,25,186,Defender - Centre-Back,left,FC Barcelona,39,0,0,3302,54,4,1,4693,45,2,1,3654,40,4,1,3418,5,0,0,402,LaLiga
19-06-17,18.3.4.28,Aďssa Mandi,85079680,5,22-Oct-91,25,24,1,0,0,6000,6500,6500,142,132,5102436,184,78,D RLC,3,3,3,2,1,1,4,3,1,3,2,6,13,9,5,10,6,14,5,12,13,12,6,15,12,14,15,16,12,12,11,13,16,7,12,12,12,14,14,14,13,14,13,9,15,14,20,13,14,13,13,14,8,15,8,13,16,13,15,14,14,7,20,10,1,1,19,15,20,D RLC,106,1,1,1,1,1,1,20,15,19,1,1,1,1,10,10,1.37439E+11,0,0,0,1,0,0,0,0,0,0,0,0,0,0,0,0,0,0,0,0,0,0,0,0,0,0,0,0,0,0,0,0,0,0,0,0,0,1,0,0,0,0,0,0,0,0,0,0,Aïssa Mandi,£8.10m ,29,184,Defender - Centre-Back,right,Real Betis Balompié,28,2,1,2373,35,1,0,3115,48,2,1,4260,30,0,0,2698,5,1,0,442,LaLiga
19-06-17,18.3.4.28,Diego Godín,8826848,1657,16-Feb-86,31,108,8,9,0,7850,8900,8300,169,166,232186002,187,79,D C,1,3,2,1,2,1,3,1,1,1,3,4,5,8,10,11,5,18,7,9,17,11,11,16,11,14,16,18,16,16,8,17,16,6,15,7,16,16,16,11,12,11,16,11,15,14,20,15,14,16,14,15,6,5,16,13,12,13,14,11,10,6,20,1,1,1,1,1,20,D C,101,1,9,1,1,1,1,20,1,1,1,1,1,1,1,1,1.37473E+11,0,0,0,0,0,0,0,0,0,0,0,0,0,0,0,0,0,0,0,0,0,0,0,0,0,1,0,0,0,0,0,0,0,0,0,0,0,1,0,0,0,0,0,0,0,0,0,0,Diego Godín,£31.50m ,34,187,Defender - Centre-Back,right,Cagliari Calcio,47,3,2,4028,45,1,0,3903,39,4,3,3347,36,2,1,2800,3,1,0,265,LaLiga
19-06-17,18.3.4.28,Sídnei,8832967,1651,23-Aug-89,27,0,0,5,0,5750,7200,7200,150,144,22729274,185,83,D C,1,2,2,3,1,3,1,3,1,3,3,5,7,10,8,12,10,16,9,9,15,11,9,15,11,15,15,14,14,14,9,13,10,10,12,12,15,15,13,11,10,12,14,10,13,16,20,15,16,13,11,13,8,10,13,16,15,13,7,14,12,10,20,1,1,1,5,5,20,D C,101,1,10,1,1,1,1,20,5,5,8,1,1,1,1,1,4,0,0,1,0,0,0,0,0,0,0,0,0,0,0,0,0,0,0,0,0,0,0,0,0,0,0,0,0,0,0,0,0,0,0,0,0,0,0,0,0,0,0,0,0,0,0,0,0,Sidnei,£3.60m ,31,185,Defender - Centre-Back,right,Real Betis Balompié,32,1,0,2761,22,1,1,1869,34,2,1,2666,15,1,0,1222,3,0,0,270,LaLiga
19-06-17,18.3.4.28,Simon Kjćr,947424,764,26-Mar-89,28,68,3,2,0,6500,7500,7250,155,150,21095489,189,90,D C,2,2,4,1,4,3,2,1,1,1,1,3,7,6,7,8,14,13,10,12,18,10,17,16,8,17,15,20,8,16,7,14,18,5,16,7,16,14,13,11,9,15,16,8,15,13,20,13,17,17,13,15,8,12,14,18,7,15,16,14,14,10,20,1,1,1,10,1,20,D C,101,1,1,1,1,1,1,20,1,10,8,1,1,1,1,1,9.07097E+12,0,0,0,0,0,0,0,0,0,0,0,0,0,0,0,0,0,0,0,0,0,0,0,0,0,0,0,0,0,0,0,0,0,0,0,0,0,0,1,0,0,0,0,1,0,0,0,0,Simon Kjaer,£9.00m ,31,191,Defender - Centre-Back,right,AC Milan,43,3,1,3665,27,3,1,2201,37,0,0,3035,25,0,0,2006,9,0,0,822,LaLiga
19-06-17,18.3.4.28,Ezequiel Garay,956658,1649,10-Oct-86,30,32,0,46,9,7000,7400,7400,160,147,232186002,189,90,D C,3,2,3,2,1,2,3,2,1,2,4,8,10,8,10,11,14,14,13,9,14,13,13,14,11,12,15,11,16,15,11,15,8,5,11,8,17,13,13,12,11,13,13,11,14,13,20,15,13,15,10,14,13,6,13,15,8,10,13,16,16,7,20,1,1,1,1,1,20,D C,101,1,10,1,1,1,1,20,1,1,1,1,1,1,1,1,2.74878E+11,0,0,0,0,0,0,0,0,0,0,0,0,0,0,0,0,0,0,0,0,0,0,0,0,0,0,0,0,0,0,0,0,0,0,0,0,0,0,1,0,0,0,0,0,0,0,0,0,Ezequiel Garay,£10.80m ,34,188,Defender - Centre-Back,right,Without Club,33,3,0,2880,28,0,0,2378,35,2,0,3009,23,0,0,1891,nan,nan,nan,nan,LaLiga
19-06-17,18.3.4.28,Gustavo Cabral,958132,1649,14-Oct-85,31,0,0,6,0,6000,7250,7250,149,145,232186002,183,81,D C,3,2,1,4,1,2,2,4,3,1,1,5,7,7,5,9,7,15,6,9,17,11,8,16,8,17,15,16,12,13,9,13,15,6,16,6,17,16,16,12,11,9,13,8,15,14,20,13,16,14,16,15,6,12,14,15,13,14,13,7,9,11,20,1,1,1,1,1,20,D C,101,1,10,1,1,1,1,20,1,1,11,1,1,1,1,1,32768,0,0,0,0,0,0,0,0,0,0,0,0,0,0,0,1,0,0,0,0,0,0,0,0,0,0,0,0,0,0,0,0,0,0,0,0,0,0,0,0,0,0,0,0,0,0,0,0,Gustavo Cabral,£2.25m ,35,182,Defender - Centre-Back,right,CF Pachuca,45,3,2,3992,29,2,1,2082,25,0,1,1986,28,2,0,2334,14,0,0,1260,LaLiga
19-06-17,18.3.4.28,Nicolás Pareja,961346,1649,19-Jan-84,33,1,0,5,0,6250,7500,7500,155,145,232186002,183,75,D C,1,1,1,1,3,1,3,3,3,1,3,2,7,9,7,11,14,13,10,7,15,14,11,16,13,12,16,16,15,16,13,15,18,9,18,9,16,15,16,11,10,14,13,11,9,9,20,12,13,13,11,18,16,10,16,18,14,13,13,14,9,12,20,1,1,1,5,1,20,D C,101,1,10,1,1,1,1,20,1,5,1,1,1,1,1,1,33280,0,0,0,0,0,0,0,0,0,1,0,0,0,0,0,1,0,0,0,0,0,0,0,0,0,0,0,0,0,0,0,0,0,0,0,0,0,0,0,0,0,0,0,0,0,0,0,0,Nicolás Pareja,£720Th. ,36,181,Defender - Centre-Back,right,Without Club,34,2,1,2825,9,0,0,765,6,0,0,422,nan,nan,nan,nan,nan,nan,nan,nan,LaLiga
19-06-17,18.3.4.28,Fabian Schär,98007212,798,20-Dec-91,25,29,7,5,1,5050,6600,6600,143,133,6803038,186,85,D C,3,1,2,1,1,3,2,2,2,3,1,6,9,11,8,12,10,16,11,8,14,14,16,13,12,12,15,13,17,10,14,14,12,9,11,9,13,16,12,9,10,13,14,12,12,11,20,13,15,12,10,14,10,4,10,13,12,14,15,14,16,6,20,8,1,1,10,1,20,D C,101,1,14,1,1,1,1,20,1,10,1,1,1,1,1,8,1.40806E+14,0,0,0,0,0,0,0,0,0,0,0,0,0,0,0,0,0,0,0,0,0,0,0,0,0,1,0,0,0,0,0,0,0,0,0,0,1,0,0,0,0,0,0,0,0,0,0,1,Fabian Schär,£2.70m ,28,186,Defender - Centre-Back,right,Newcastle United,7,0,1,402,27,2,2,2401,28,4,1,2311,27,2,0,2151,4,0,0,204,LaLiga
