GameDate,FMRTEVersion,Name,UID,NationID,Born,Age,IntCaps,IntGoals,U21Caps,U21Goals,WorldReputation,HomeReputation,CurrentReputation,PA,CA,Price,Height,Weight,PositionsString,GK.AerialAbility,GK.CommandOfArea,GK.Communication,GK.Eccentricity,GK.Handling,GK.Kicking,GK.OneOnOnes,GK.Reflexes,GK.RushingOut,GK.TendencyToPunch,GK.Throwing,Tech.Corners,Tech.Crossing,Tech.Dribbling,Tech.Finishing,Tech.FirstTouch,Tech.Freekicks,Tech.Heading,Tech.LongShots,Tech.Longthrows,Tech.Marking,Tech.Passing,Tech.PenaltyTaking,Tech.Tackling,Tech.Technique,Mental.Aggression,Mental.Anticipation,Mental.Bravery,Mental.Composure,Mental.Concentration,Mental.Vision,Mental.Decisions,Mental.Determination,Mental.Flair,Mental.Leadership,Mental.OffTheBall,Mental.Positioning,Mental.Teamwork,Mental.Workrate,Phy.Acceleration,Phy.Agility,Phy.Balance,Phy.Jumping,Phy.LeftFoot,Phy.NaturalFitness,Phy.Pace,Phy.RightFoot,Phy.Stamina,Phy.Strength,Hidden.Consistency,Hidden.Dirtiness,Hidden.ImportantMatches,Hidden.InjuryProness,Hidden.Versatility,Personality.Adaptability,Personality.Ambition,Personality.Loyalty,Personality.Pressure,Personality.Professional,Personality.Sportsmanship,Personality.Temperament,Personality.Controversy,Positions.Defender,Positions.WingBack,Positions.Midfielder,Positions.AttackingMidfielder,Positions.Right,Positions.Left,Positions.Centre,Positions.PositionsDesc,Positions.PositionsDescVal,Positions.Goalkeeper,Positions.Sweeper,Positions.Striker,Positions.AttackingMidCentral,Positions.AttackingMidLeft,Positions.AttackingMidRight,Positions.DefenderCentral,Positions.DefenderLeft,Positions.DefenderRight,Positions.DefensiveMidfielder,Positions.MidfielderCentral,Positions.MidfielderLeft,Positions.MidfielderRight,Positions.WingBackLeft,Positions.WingBackRight,PPMVal,PPM0,PPM1,PPM2,PPM3,PPM4,PPM5,PPM6,PPM7,PPM8,PPM9,PPM10,PPM11,PPM12,PPM13,PPM14,PPM15,PPM16,PPM17,PPM18,PPM19,PPM20,PPM21,PPM22,PPM23,PPM24,PPM25,PPM26,PPM27,PPM28,PPM29,PPM30,PPM31,PPM32,PPM33,PPM34,PPM35,PPM36,PPM37,PPM38,PPM39,PPM40,PPM41,PPM42,PPM43,PPM44,PPM45,PPM46,PPM47,name,Market Value,age,height,position,foot,current club,16/17 games,16/17 goals/conceded,16/17 assists/clean,16/17 minutes,17/18 games,17/18 goals/conceded,17/18 assists/clean,17/18 minutes,18/19 games,18/19 goals/conceded,18/19 assists/clean,18/19 minutes,19/20 games,19/20 goals/conceded,19/20 assists/clean,19/20 minutes,20/21 games,20/21 goals/conceded,20/21 assists/clean,20/21 minutes,current league
19-06-17,18.3.4.28,Jesús Gámez,1501035,796,10-Apr-85,32,0,0,4,2,5509,6800,6500,150,120,6074673,182,77,D/WB RL,4,2,3,1,4,2,2,2,3,1,3,5,11,11,5,12,5,11,7,12,12,12,7,13,14,12,13,13,14,13,10,13,12,6,12,13,13,14,12,11,12,13,12,12,12,12,20,12,12,13,8,12,16,10,6,16,15,11,12,12,8,5,20,18,1,1,20,16,1,D/WB RL,115,1,1,1,1,1,1,1,16,20,1,1,1,1,15,18,1.54619E+11,0,0,0,0,0,1,0,0,0,0,0,0,0,0,0,0,0,0,0,0,0,0,0,0,0,0,0,0,0,0,0,0,0,0,1,0,0,1,0,0,0,0,0,0,0,0,0,0,Jesús Gámez,£1.80m ,35,177,Defender - Right-Back,right,Retired,7,0,0,381,3,0,0,217,nan,nan,nan,nan,nan,nan,nan,nan,nan,nan,nan,nan,Premier League
19-06-17,18.3.4.28,Matt Lowton,152936,765,09-Jun-89,28,0,0,0,0,4750,6650,6650,135,133,26534260,181,78,D/WB R,3,3,3,1,1,3,1,3,1,1,1,6,13,12,8,13,6,14,12,7,14,13,6,14,13,13,14,13,16,14,11,12,17,10,8,12,14,16,16,14,15,12,11,6,14,13,20,14,13,14,9,13,8,11,10,13,14,8,9,11,11,7,20,18,10,1,20,1,13,D/WB R,112,1,1,1,1,1,1,13,1,20,1,7,1,10,1,18,34,0,1,0,0,0,1,0,0,0,0,0,0,0,0,0,0,0,0,0,0,0,0,0,0,0,0,0,0,0,0,0,0,0,0,0,0,0,0,0,0,0,0,0,0,0,0,0,0,Matthew Lowton,£4.50m ,31,180,Defender - Right-Back,right,Burnley FC,36,0,2,3240,27,0,3,2384,24,0,0,2078,20,0,2,1722,3,0,1,259,Premier League
19-06-17,18.3.4.28,Kyle Naughton,152937,765,17-Nov-88,28,0,0,9,0,5500,6350,6700,135,127,26931133,180,73,D/WB/M RL,3,1,3,3,3,3,3,2,3,2,1,6,11,10,5,13,7,10,12,10,11,11,5,12,12,8,12,11,15,11,10,11,14,11,8,11,12,14,13,14,14,13,10,12,18,14,20,15,11,12,9,12,5,14,12,15,18,14,16,16,13,4,20,18,16,1,20,15,5,D/WB/M RL,125,1,1,1,1,1,1,1,15,20,1,5,5,16,13,18,1.1259E+15,0,0,0,0,0,0,1,0,0,1,0,0,0,0,0,0,0,0,0,0,0,0,0,0,0,0,0,0,0,0,0,0,0,0,0,0,0,0,0,0,0,0,0,0,0,0,0,0,Kyle Naughton,£4.50m ,31,181,Defender - Right-Back,right,Swansea City,34,1,0,2959,39,1,2,3399,38,1,2,3025,35,3,0,2720,2,0,0,171,Premier League
19-06-17,18.3.4.28,Chancel Mbemba,18057323,53,08-Aug-94,22,25,1,0,0,5250,6750,6800,145,132,49225584,182,80,D RLC,3,1,2,2,1,2,1,2,2,2,1,4,10,12,8,12,4,14,10,4,13,12,7,15,13,10,13,14,14,12,8,11,13,10,10,11,15,15,15,15,11,14,13,8,14,15,20,14,14,12,8,13,6,14,14,12,12,14,14,14,16,5,20,1,1,1,17,15,20,D RLC,106,1,1,1,1,1,1,20,15,17,13,1,1,1,1,1,4294967296,0,0,0,0,0,0,0,0,0,0,0,0,0,0,0,0,0,0,0,0,0,0,0,0,0,0,0,0,0,0,0,0,1,0,0,0,0,0,0,0,0,0,0,0,0,0,0,0,Chancel Mbemba,£5.40m ,26,182,Defender - Centre-Back,right,FC Porto,13,1,0,1195,11,0,0,883,8,0,0,485,42,6,1,3301,6,0,0,531,Premier League
19-06-17,18.3.4.28,Danilo,19099575,1651,15-Jul-91,25,15,0,15,2,7000,7500,7250,152,150,44013283,184,78,D/WB RL,2,2,2,3,2,2,3,4,1,2,2,11,13,12,11,12,10,10,13,13,12,12,12,15,13,14,12,14,11,13,10,10,15,14,10,14,11,13,16,13,12,13,12,16,15,17,20,17,14,12,14,12,9,14,12,15,13,12,16,12,12,8,20,18,9,1,20,16,9,D/WB RL,115,1,1,1,1,1,1,1,16,20,11,9,1,9,15,18,2.8823E+17,0,0,0,0,0,1,0,0,0,0,0,0,0,0,0,0,0,0,0,0,0,0,0,0,0,0,0,1,0,0,0,0,0,0,0,0,0,0,0,0,0,0,0,0,0,0,0,0,Danilo,£18.00m ,29,184,Defender - Right-Back,right,Juventus FC,25,1,3,2117,38,3,2,2476,22,1,1,1479,32,2,0,2152,5,0,1,450,Premier League
19-06-17,18.3.4.28,Emerson,19158043,776,13-Mar-94,23,0,0,0,0,5000,6750,7250,158,145,64378562,176,77,D RL,3,4,3,2,4,2,2,4,1,2,2,12,15,16,7,16,10,9,14,10,12,13,4,14,15,11,13,12,12,12,12,13,14,14,5,15,12,13,14,16,15,15,9,20,13,16,10,14,13,13,11,9,5,13,8,12,13,10,14,13,12,9,20,15,14,1,15,20,10,D RL,105,1,1,1,1,1,1,1,20,15,1,10,14,10,15,12,1.10018E+12,1,0,0,0,0,0,0,0,1,0,0,0,0,0,0,0,0,0,0,0,0,0,0,0,0,0,0,1,0,1,0,0,0,0,0,0,0,0,0,0,1,0,0,0,0,0,0,0,Emerson,£18.00m ,26,181,Defender - Left-Back,left,Chelsea FC,36,1,1,2595,10,0,2,655,27,1,2,2250,21,0,1,1523,2,0,0,114,Premier League
19-06-17,18.3.4.28,Craig Cathcart,28000905,785,06-Feb-89,28,33,2,15,0,5750,6550,6600,138,135,26976197,188,73,D RC,2,1,1,1,2,1,1,3,2,2,1,3,4,8,10,12,4,15,4,7,14,12,4,16,12,11,14,13,14,14,8,15,16,5,11,11,14,13,14,11,9,13,15,13,15,12,20,15,13,15,6,13,13,8,9,12,15,13,18,17,17,3,20,1,1,1,15,9,20,D RC,103,1,1,1,1,1,1,20,9,15,1,1,1,1,1,1,2.74878E+11,0,0,0,0,0,0,0,0,0,0,0,0,0,0,0,1,0,0,0,0,0,0,0,0,0,0,0,0,0,0,0,0,0,0,0,0,0,0,1,0,0,0,0,0,0,0,0,0,Craig Cathcart,£3.15m ,31,189,Defender - Centre-Back,right,Watford FC,16,0,1,1177,7,0,0,495,41,3,1,3578,30,0,0,2579,7,1,0,559,Premier League
19-06-17,18.3.4.28,Joel Ward,28004100,765,29-Oct-89,27,0,0,0,0,5400,6650,6600,136,129,20559807,188,83,D RL,2,2,1,4,1,1,2,2,2,1,3,5,16,10,5,10,5,13,8,5,13,12,5,15,11,16,14,16,12,13,9,13,18,5,10,13,13,17,15,13,13,12,13,10,17,12,20,15,13,15,1,10,6,15,14,12,12,9,13,10,13,1,20,10,10,10,20,15,10,D RL,105,1,1,1,1,1,10,10,15,20,1,10,1,10,1,10,0,0,0,0,0,0,0,0,0,0,0,0,0,0,0,0,0,0,0,0,0,0,0,0,0,0,0,0,0,0,0,0,0,0,0,0,0,0,0,0,0,0,0,0,0,0,0,0,0,Joel Ward,£4.50m ,30,186,Defender - Right-Back,right,Crystal Palace,42,0,1,3778,20,0,1,1706,12,1,0,939,29,0,0,2383,5,0,0,450,Premier League
19-06-17,18.3.4.28,Kyle Walker,28009441,765,28-May-90,27,27,0,7,0,7000,7750,7750,157,154,72250405,182,80,D/WB R,1,2,1,3,2,1,2,3,1,2,3,11,13,13,7,12,12,14,7,13,12,13,6,13,13,12,13,15,13,13,11,9,13,10,12,13,12,15,16,18,15,15,12,10,13,18,20,15,15,14,5,12,6,14,19,15,14,7,8,12,11,7,20,18,5,5,20,10,12,D/WB R,112,1,1,1,1,1,5,12,10,20,1,1,1,5,1,18,134217760,0,0,0,0,0,1,0,0,0,0,0,0,0,0,0,0,0,0,0,0,0,0,0,0,0,0,0,1,0,0,0,0,0,0,0,0,0,0,0,0,0,0,0,0,0,0,0,0,Kyle Walker,£45.00m ,30,183,Defender - Right-Back,right,Manchester City,39,0,5,3176,48,0,7,3842,52,2,1,4301,42,1,6,3454,8,0,0,684,Premier League
19-06-17,18.3.4.28,Martin Kelly,28010835,765,27-Apr-90,27,1,0,8,3,4900,6500,6250,130,125,13042350,191,78,D RC,2,2,1,3,2,1,1,2,3,2,2,4,8,8,10,12,5,12,2,6,11,12,5,14,12,13,12,16,12,14,13,13,14,5,10,10,14,11,16,12,13,13,13,11,10,13,20,15,14,7,17,11,14,13,16,12,14,12,14,14,12,5,20,14,1,1,20,10,16,D RC,103,1,1,1,1,1,1,16,10,20,1,1,1,1,1,14,0,0,0,0,0,0,0,0,0,0,0,0,0,0,0,0,0,0,0,0,0,0,0,0,0,0,0,0,0,0,0,0,0,0,0,0,0,0,0,0,0,0,0,0,0,0,0,0,0,Martin Kelly,£2.70m ,30,191,Defender - Right-Back,right,Crystal Palace,34,0,2,2559,19,0,0,1554,20,0,0,1712,21,0,1,1685,2,0,0,151,Premier League
19-06-17,18.3.4.28,Adam Smith,28011401,765,29-Apr-91,26,0,0,11,0,4900,6450,6650,139,133,26534260,180,79,D R,2,1,2,1,1,3,2,2,1,3,3,6,13,15,7,13,6,8,11,3,12,14,2,15,13,10,14,13,13,12,13,13,14,9,10,13,14,14,16,14,14,12,7,8,17,16,20,15,13,15,10,14,5,12,12,14,8,11,15,13,11,2,20,13,10,7,20,13,1,D R,102,1,1,1,1,1,7,1,13,20,1,1,1,10,1,13,2.2518E+15,0,0,1,0,0,0,0,0,1,0,0,0,0,0,0,0,0,0,0,0,0,0,0,0,0,0,0,0,0,0,0,0,0,0,0,0,0,0,0,0,0,0,0,0,0,0,0,0,Adam Smith,£4.50m ,29,174,Defender - Right-Back,right,AFC Bournemouth,36,1,5,3099,32,1,4,2438,26,1,1,2163,25,0,1,2151,7,0,1,630,Premier League
19-06-17,18.3.4.28,Steve Cook,28014634,765,19-Apr-91,26,0,0,0,0,5100,6800,6800,148,140,33727050,186,82,D RC,2,4,1,2,1,3,2,3,3,4,1,6,9,8,8,12,6,14,6,14,14,14,1,16,14,9,14,13,14,13,12,14,14,6,14,7,14,13,16,14,13,13,14,11,16,14,20,15,14,14,6,13,2,12,12,14,13,12,13,16,11,8,20,1,1,1,17,1,20,D RC,103,1,1,1,1,1,1,20,1,17,1,1,1,1,1,1,4294967296,0,0,0,0,0,0,0,0,0,0,0,0,0,0,0,0,0,0,0,0,0,0,0,0,0,0,0,0,0,0,0,0,1,0,0,0,0,0,0,0,0,0,0,0,0,0,0,0,Steve Cook,£6.30m ,29,185,Defender - Centre-Back,right,AFC Bournemouth,38,2,1,3420,40,3,1,3336,35,2,1,3078,31,1,0,2532,8,0,0,656,Premier League
19-06-17,18.3.4.28,Kieran Trippier,28018613,765,19-Sep-90,26,1,0,2,0,5750,7050,7050,146,142,22121658,178,72,D/WB R,2,3,1,3,1,3,3,3,3,1,3,11,16,11,8,15,13,9,10,10,11,13,5,14,14,12,13,13,13,12,13,14,14,8,11,14,13,16,16,13,13,14,9,6,14,14,20,18,13,14,8,10,7,13,11,12,12,13,14,14,14,4,20,17,13,1,20,1,1,D/WB R,112,1,1,1,1,1,1,1,1,20,1,1,1,13,1,17,34,0,1,0,0,0,1,0,0,0,0,0,0,0,0,0,0,0,0,0,0,0,0,0,0,0,0,0,0,0,0,0,0,0,0,0,0,0,0,0,0,0,0,0,0,0,0,0,0,Kieran Trippier,£18.00m ,30,173,Defender - Right-Back,right,Atlético Madrid,22,0,7,1464,35,0,9,2904,38,1,5,3174,33,0,5,2730,6,0,0,540,Premier League
19-06-17,18.3.4.28,Nathaniel Clyne,28019851,765,05-Apr-91,26,14,0,8,0,6250,7400,7550,154,151,58295551,176,67,D/WB R,2,3,1,2,3,4,3,1,3,3,3,3,10,13,6,14,3,9,8,9,14,14,5,16,13,13,13,14,13,13,11,14,14,10,9,15,14,17,16,16,15,14,8,8,18,16,20,17,13,17,8,15,8,12,14,15,15,15,15,12,14,7,20,19,1,1,20,14,1,D/WB R,112,1,1,1,1,1,1,1,14,20,1,1,1,1,13,19,2.2529E+15,0,1,0,0,0,1,0,0,0,0,0,0,0,0,0,0,0,0,0,0,0,0,0,0,0,0,0,1,0,0,0,0,0,0,0,0,0,0,0,0,1,0,0,0,0,0,0,0,Nathaniel Clyne,£18.00m ,29,175,Defender - Right-Back,right,Crystal Palace,41,0,3,3616,5,0,0,183,21,0,1,1523,nan,nan,nan,nan,2,0,0,117,Premier League
19-06-17,18.3.4.28,Tommy Smith,28047506,765,14-Apr-92,25,0,0,0,0,4750,6500,6500,140,130,22147819,186,75,D RC,1,3,3,2,2,3,3,3,3,1,3,4,13,13,7,12,5,13,7,11,12,12,4,13,12,11,13,13,12,12,13,12,13,11,18,12,14,16,15,13,12,11,13,10,17,13,20,16,14,14,6,14,1,15,8,12,13,5,16,15,18,5,20,1,1,1,20,13,16,D RC,103,1,1,1,1,1,1,16,13,20,1,1,1,1,1,1,1048608,0,0,0,0,0,1,0,0,0,0,0,0,0,0,0,0,0,0,0,0,1,0,0,0,0,0,0,0,0,0,0,0,0,0,0,0,0,0,0,0,0,0,0,0,0,0,0,0,Tommy Smith,£2.70m ,28,185,Defender - Right-Back,right,Stoke City,47,4,8,3972,27,0,1,2062,16,0,0,1231,33,0,4,2780,11,1,0,920,Premier League
19-06-17,18.3.4.28,Michael Keane,28047558,765,11-Jan-93,24,2,0,16,3,5900,7350,7250,155,140,52569320,186,83,D RC,1,1,1,1,1,3,2,1,1,2,2,5,8,8,8,12,5,14,5,12,14,12,5,14,13,13,14,14,14,13,10,13,17,8,12,10,14,15,13,14,14,12,14,13,14,13,20,13,15,12,8,12,11,10,10,15,14,14,16,16,14,5,20,1,13,1,17,1,20,D RC,103,1,1,1,1,1,1,20,1,17,1,13,1,10,1,1,2.79173E+11,0,0,0,0,0,0,0,0,0,0,0,0,0,0,0,0,0,0,0,0,0,0,0,0,0,0,0,0,0,0,0,0,1,0,0,0,0,0,1,0,0,0,0,0,0,0,0,0,Michael Keane,£18.00m ,27,188,Defender - Centre-Back,right,Everton FC,39,2,1,3510,38,1,1,3295,35,1,2,3150,34,2,0,2785,9,3,1,810,Premier League
19-06-17,18.3.4.28,Sam Byram,28059134,765,16-Sep-93,23,0,0,0,0,4250,6250,6250,145,124,16313227,181,73,D/M R,3,2,4,3,3,2,2,2,3,2,2,5,14,12,11,14,3,13,8,13,12,13,5,12,13,11,13,11,15,12,12,10,11,12,9,13,14,14,15,13,12,13,11,10,14,13,20,14,10,14,8,10,15,13,13,11,12,12,11,12,12,2,20,14,18,15,20,1,1,D/M R,112,1,1,1,1,1,15,1,1,20,1,1,1,18,1,14,8,0,0,0,1,0,0,0,0,0,0,0,0,0,0,0,0,0,0,0,0,0,0,0,0,0,0,0,0,0,0,0,0,0,0,0,0,0,0,0,0,0,0,0,0,0,0,0,0,Sam Byram,£3.60m ,27,183,Defender - Right-Back,right,Norwich City,23,0,2,1664,13,0,0,924,8,0,1,654,20,0,0,1559,nan,nan,nan,nan,Premier League
19-06-17,18.3.4.28,John Stones,28060397,765,28-May-94,23,18,0,12,0,6750,7850,7850,172,155,138755427,188,70,D RC,2,2,1,4,2,4,3,3,4,1,3,5,11,13,8,13,5,15,5,8,15,15,12,15,14,10,14,16,17,15,14,13,13,12,13,15,14,13,15,14,13,16,14,12,19,15,20,13,15,15,8,12,5,10,12,20,15,16,14,13,16,5,20,1,1,1,16,1,20,D RC,103,1,1,1,1,1,1,20,1,16,1,1,1,1,1,1,1.15292E+18,0,0,0,0,0,0,0,0,0,0,0,0,0,0,0,0,0,0,0,0,0,0,0,0,0,0,0,0,0,0,0,0,1,0,0,0,0,0,0,0,0,0,0,0,0,0,0,0,John Stones,£45.00m ,26,188,Defender - Centre-Back,right,Manchester City,41,2,0,3170,29,3,0,2234,39,0,1,2820,24,0,1,1584,2,0,0,90,Premier League
19-06-17,18.3.4.28,Héctor Bellerín,28066082,796,19-Mar-95,22,3,0,12,0,6750,7250,7500,162,151,108585970,177,72,D/WB R,3,1,3,3,3,1,3,3,3,1,2,8,12,13,9,12,5,10,10,12,12,11,8,14,14,12,12,15,13,13,10,12,15,12,4,14,12,14,16,20,15,12,9,8,16,19,20,15,9,14,8,15,5,14,15,15,14,15,15,15,15,5,20,20,10,8,20,1,1,D/WB R,112,1,1,1,1,1,8,1,1,20,1,1,1,10,1,20,134217760,0,0,0,0,0,1,0,0,0,0,0,0,0,0,0,0,0,0,0,0,0,0,0,0,0,0,0,1,0,0,0,0,0,0,0,0,0,0,0,0,0,0,0,0,0,0,0,0,Héctor Bellerín,£36.00m ,25,178,Defender - Right-Back,right,Arsenal FC,42,1,5,3233,47,3,5,4161,19,0,5,1533,25,1,2,1949,9,0,3,630,Premier League
19-06-17,18.3.4.28,Jonjoe Kenny,28090682,765,15-Mar-97,20,0,0,0,0,4250,5650,6100,132,122,17098216,176,64,D R,3,3,2,3,2,2,1,1,3,3,3,6,11,11,5,11,6,11,8,5,13,10,11,14,12,14,11,14,13,12,11,12,15,6,14,10,13,13,16,14,14,12,9,11,14,12,20,14,11,14,9,12,6,13,11,10,15,13,14,13,14,1,20,10,14,1,20,10,14,D R,102,1,1,1,1,1,1,14,10,20,14,14,1,7,1,10,0,0,0,0,0,0,0,0,0,0,0,0,0,0,0,0,0,0,0,0,0,0,0,0,0,0,0,0,0,0,0,0,0,0,0,0,0,0,0,0,0,0,0,0,0,0,0,0,0,Jonjoe Kenny,£4.50m ,23,176,Defender - Right-Back,right,Everton FC,22,0,4,1902,28,0,3,2377,15,0,1,1240,34,2,3,2994,3,0,0,222,Premier League
19-06-17,18.3.4.28,Ainsley Maitland-Niles,28095584,765,29-Aug-97,19,0,0,0,0,5250,6750,6750,149,130,58356008,177,0,D/WB/DM/M RLC,2,2,4,3,1,2,1,1,2,3,2,10,10,13,7,13,8,6,11,8,10,12,7,11,14,10,12,9,13,11,12,11,11,14,7,12,11,13,11,16,14,13,8,8,13,14,20,13,11,12,9,13,7,17,14,14,13,13,11,12,13,12,17,17,20,14,17,17,20,D/WB/DM/M RLC,446,1,1,1,8,10,14,8,17,17,16,20,12,14,17,17,0,0,0,0,0,0,0,0,0,0,0,0,0,0,0,0,0,0,0,0,0,0,0,0,0,0,0,0,0,0,0,0,0,0,0,0,0,0,0,0,0,0,0,0,0,0,0,0,0,Ainsley Maitland-Niles,£6.30m ,23,180,Midfielder - Right Midfield,right,Arsenal FC,20,0,2,1555,32,0,1,2310,31,2,3,2188,33,1,2,2106,6,0,0,367,Premier League
19-06-17,18.3.4.28,Trent Alexander-Arnold,28104124,765,07-Oct-98,18,0,0,0,0,5000,6600,6600,177,141,68321749,180,70,D/WB/DM/M RC,1,3,2,2,3,1,1,2,1,1,2,12,16,14,12,13,13,9,13,7,11,14,13,13,14,13,13,13,13,12,11,12,16,13,12,13,12,14,15,15,14,12,9,8,14,15,20,13,10,13,9,13,7,14,12,16,18,13,17,12,13,8,19,20,16,12,20,12,16,D/WB/DM/M RC,243,1,1,1,1,1,12,8,10,19,16,16,1,16,12,20,2.8823E+17,0,1,0,0,0,1,0,0,0,1,0,0,0,0,0,0,0,0,0,0,0,0,0,0,0,0,0,0,0,0,0,0,0,0,0,0,0,0,0,0,0,0,0,0,0,0,0,0,Trent Alexander-Arnold,£22.50m ,22,180,Defender - Right-Back,right,Liverpool FC,24,4,5,1663,34,3,3,2744,40,1,16,3388,49,4,15,3991,7,0,1,629,Premier League
19-06-17,18.3.4.28,Dujon Sterling,28108034,765,24-Oct-99,17,0,0,0,0,2506,4511,3750,144,105,342279,179,73,D/WB/M/AM RC,3,2,1,2,4,1,1,1,3,2,2,4,7,6,9,6,9,6,9,9,6,5,6,7,7,14,9,11,9,7,7,8,2,12,4,7,7,9,11,17,11,9,9,10,9,16,20,15,11,10,9,4,8,10,20,13,10,10,10,9,20,8,20,18,16,18,20,11,16,D/WB/M/AM RC,133,1,1,12,1,1,18,16,11,20,1,1,1,16,1,18,134217728,0,0,0,0,0,0,0,0,0,0,0,0,0,0,0,0,0,0,0,0,0,0,0,0,0,0,0,1,0,0,0,0,0,0,0,0,0,0,0,0,0,0,0,0,0,0,0,0,Dujon Sterling, ,21,186,Defender - Right-Back,right,Chelsea FC U23,32,5,6,2619,34,6,2,2764,40,0,5,3457,10,0,1,749,nan,nan,nan,nan,Premier League
19-06-17,18.3.4.28,Marc Albrighton,29010506,765,18-Nov-89,27,0,0,8,1,5100,6900,6900,142,137,27458989,174,68,WB/M/AM RL,2,1,1,3,3,3,2,2,3,2,4,15,15,12,11,13,12,5,10,7,8,13,10,12,12,14,12,14,12,16,14,10,13,12,7,13,14,17,18,14,13,11,6,8,15,13,20,15,9,10,10,13,5,11,11,12,15,10,16,16,17,3,11,17,20,17,19,20,4,WB/M/AM RL,435,1,1,5,4,17,17,1,10,11,1,1,20,19,15,17,1.50633E+14,0,1,0,0,0,0,0,1,0,0,0,0,0,0,0,0,0,0,0,0,0,0,0,0,0,0,0,0,0,0,0,0,0,0,0,0,0,0,0,0,1,0,0,1,0,0,0,1,Marc Albrighton,£9.00m ,30,175,Midfielder - Right Midfield,right,Leicester City,47,4,9,3522,42,2,7,2968,32,3,4,1936,28,0,5,1439,4,0,0,125,Premier League
19-06-17,18.3.4.28,Molla Wagué,29023789,31,21-Feb-91,26,19,3,0,0,4494,6742,6100,135,122,4949284,191,87,D RC,3,2,3,3,1,3,3,2,3,1,4,3,6,6,8,8,6,16,6,5,14,7,6,15,9,13,12,15,13,13,6,12,13,6,8,8,13,14,14,13,10,14,16,5,13,14,20,14,15,13,13,13,10,8,15,14,13,13,15,12,13,6,20,1,1,1,15,1,20,D RC,103,1,1,5,1,1,1,20,1,15,1,1,1,1,1,1,32,0,0,0,0,0,1,0,0,0,0,0,0,0,0,0,0,0,0,0,0,0,0,0,0,0,0,0,0,0,0,0,0,0,0,0,0,0,0,0,0,0,0,0,0,0,0,0,0,Molla Wagué,£1.35m ,29,191,Defender - Centre-Back,right,Amiens SC,8,0,0,700,9,1,0,677,14,3,0,1044,11,0,0,862,2,0,0,180,Premier League
19-06-17,18.3.4.28,Calum Chambers,29076103,765,20-Jan-95,22,3,0,22,0,5800,6700,6700,150,134,37977717,183,73,D RC,3,1,1,3,2,2,3,2,3,3,2,6,11,10,9,13,7,14,8,12,15,12,8,15,13,13,13,13,14,12,11,11,14,9,10,10,13,15,14,12,12,15,15,10,14,13,20,15,14,14,7,11,10,16,14,12,14,12,13,13,13,8,20,14,10,1,18,8,20,D RC,103,1,1,1,1,1,1,20,8,18,14,10,1,10,1,14,0,0,0,0,0,0,0,0,0,0,0,0,0,0,0,0,0,0,0,0,0,0,0,0,0,0,0,0,0,0,0,0,0,0,0,0,0,0,0,0,0,0,0,0,0,0,0,0,0,Calum Chambers,£12.60m ,25,182,Defender - Centre-Back,right,Arsenal FC,27,2,1,2430,25,0,0,1832,33,2,0,2766,18,1,4,1384,nan,nan,nan,nan,Premier League
19-06-17,18.3.4.28,Joe Gomez,29115800,765,23-May-97,20,0,0,3,0,4600,6500,6500,163,142,42787941,188,87,D RLC,3,3,1,3,3,1,1,2,1,2,1,8,11,14,8,15,6,15,8,12,14,12,5,14,14,13,13,14,15,14,9,14,18,8,12,8,14,13,14,14,13,13,14,8,14,14,20,15,14,13,4,14,11,14,14,14,12,14,16,10,16,6,20,1,1,1,18,15,20,D RLC,106,1,1,1,1,1,1,20,15,18,1,1,1,1,1,1,4294967296,0,0,0,0,0,0,0,0,0,0,0,0,0,0,0,0,0,0,0,0,0,0,0,0,0,0,0,0,0,0,0,0,1,0,0,0,0,0,0,0,0,0,0,0,0,0,0,0,Joe Gomez,£19.80m ,23,188,Defender - Centre-Back,right,Liverpool FC,11,1,0,945,31,0,2,2463,26,0,0,1644,43,0,0,3319,8,0,0,619,Premier League
19-06-17,18.3.4.28,Kyle Walker-Peters,29126231,765,13-Apr-97,20,0,0,0,0,4300,6000,6000,129,120,12110110,174,64,D/WB RL,1,2,2,2,3,1,2,3,3,1,1,10,12,13,10,13,6,9,8,5,10,11,8,13,12,12,12,11,12,9,10,10,13,11,8,10,12,12,13,14,14,14,6,14,15,14,20,15,10,13,5,5,9,14,10,12,14,14,13,12,13,5,20,16,10,5,20,16,1,D/WB RL,115,1,1,11,1,5,1,1,16,20,1,1,10,1,11,16,0,0,0,0,0,0,0,0,0,0,0,0,0,0,0,0,0,0,0,0,0,0,0,0,0,0,0,0,0,0,0,0,0,0,0,0,0,0,0,0,0,0,0,0,0,0,0,0,0,Kyle Walker-Peters,£2.70m ,23,173,Defender - Right-Back,right,Southampton FC,21,2,0,1890,9,1,2,445,10,0,3,705,15,0,0,1123,7,0,1,630,Premier League
19-06-17,18.3.4.28,Mason Holgate,29128167,765,22-Oct-96,20,0,0,6,0,4750,6600,6600,142,130,43591214,181,64,D RC,3,2,2,3,2,1,3,1,3,3,1,5,9,9,5,11,6,13,5,7,13,12,8,14,15,13,11,13,14,10,11,13,13,9,8,9,14,13,13,14,15,13,13,9,15,16,20,15,13,13,8,11,2,12,9,16,8,15,12,13,12,5,20,1,10,1,19,1,20,D RC,103,1,1,1,1,1,1,20,1,19,14,10,1,1,1,1,4294967296,0,0,0,0,0,0,0,0,0,0,0,0,0,0,0,0,0,0,0,0,0,0,0,0,0,0,0,0,0,0,0,0,1,0,0,0,0,0,0,0,0,0,0,0,0,0,0,0,Mason Holgate,£6.30m ,24,187,Defender - Centre-Back,right,Everton FC,28,0,1,2195,21,0,0,1722,30,1,4,2536,32,1,3,2503,nan,nan,nan,nan,Premier League
19-06-17,18.3.4.28,Allan Nyom,34009070,11,10-May-88,29,16,0,0,0,5300,6000,6550,145,132,21189050,188,78,D R,3,2,3,1,1,2,1,2,4,1,2,5,10,12,6,10,5,12,6,12,14,12,7,15,12,13,13,17,13,10,9,12,16,10,9,14,11,15,15,14,12,12,14,5,16,16,20,18,17,11,13,15,5,10,14,14,15,14,16,12,13,12,20,14,1,1,20,14,14,D R,102,1,1,1,1,1,1,14,14,20,1,1,1,1,11,14,134217760,0,0,0,0,0,1,0,0,0,0,0,0,0,0,0,0,0,0,0,0,0,0,0,0,0,0,0,1,0,0,0,0,0,0,0,0,0,0,0,0,0,0,0,0,0,0,0,0,Allan Nyom,£4.05m ,32,189,Defender - Right-Back,right,Getafe CF,34,0,2,2802,34,0,1,2758,27,1,2,1986,44,2,1,3245,6,0,1,510,Premier League
19-06-17,18.3.4.28,Cuco Martina,37013420,380,25-Sep-89,27,25,0,0,0,4750,5550,6300,124,123,14107580,183,78,D/WB RLC,3,1,2,3,3,3,1,1,1,1,1,10,13,9,6,11,9,12,9,12,10,10,6,13,13,9,11,13,11,10,11,11,11,9,10,12,10,12,12,13,15,12,13,10,12,11,20,14,13,12,7,9,7,13,13,9,8,11,13,12,17,7,20,18,12,1,20,16,16,D/WB RLC,116,1,1,1,1,1,1,16,16,20,14,10,1,12,12,18,17179869184,0,0,0,0,0,0,0,0,0,0,0,0,0,0,0,0,0,0,0,0,0,0,0,0,0,0,0,0,0,0,0,0,0,0,1,0,0,0,0,0,0,0,0,0,0,0,0,0,Cuco Martina,£2.25m ,31,185,Defender - Right-Back,right,Without Club,20,0,1,1581,28,0,2,2413,31,0,1,2652,1,0,0,90,nan,nan,nan,nan,Premier League
19-06-17,18.3.4.28,Timothy Fosu-Mensah,37051102,784,02-Jan-98,19,0,0,1,0,5350,6500,6700,153,130,21792868,190,0,D/DM/M RC,3,2,3,1,1,1,2,1,3,4,3,8,7,9,6,12,7,11,8,8,11,11,8,14,13,14,12,14,10,11,7,11,16,7,6,10,12,12,14,16,13,13,15,10,14,15,20,14,15,12,6,12,4,8,8,16,12,11,8,16,18,6,19,1,20,5,18,14,20,D/DM/M RC,433,1,1,1,5,1,1,19,14,18,19,20,1,1,1,1,0,0,0,0,0,0,0,0,0,0,0,0,0,0,0,0,0,0,0,0,0,0,0,0,0,0,0,0,0,0,0,0,0,0,0,0,0,0,0,0,0,0,0,0,0,0,0,0,0,Timothy Fosu-Mensah,£6.30m ,22,190,Defender - Right-Back,right,Manchester United,11,0,0,323,24,0,0,1818,13,0,0,884,8,0,0,441,1,0,0,81,Premier League
19-06-17,18.3.4.28,Ezequiel Schelotto,43048983,1649,23-May-89,28,0,0,0,0,5000,6350,6250,146,134,15366551,187,79,D/WB/M/AM R,1,3,3,3,1,1,1,3,3,3,1,7,12,11,8,8,7,11,8,13,10,11,5,11,11,17,10,14,11,11,9,13,19,13,10,13,11,14,16,15,14,14,14,8,17,16,20,15,14,13,11,14,5,16,17,18,11,6,15,13,10,6,20,18,17,19,20,13,1,D/WB/M/AM R,132,1,1,1,1,13,19,1,1,20,1,1,13,17,11,18,1.09951E+12,0,1,0,0,0,0,1,0,0,0,0,0,0,0,0,0,0,0,0,0,0,0,0,0,0,0,0,0,0,0,0,0,0,0,0,0,0,0,0,0,1,0,0,0,0,0,0,0,Ezequiel Schelotto,£4.05m ,31,187,Defender - Right-Back,right,Without Club,26,0,5,2148,24,0,1,1690,4,0,0,143,9,0,0,451,nan,nan,nan,nan,Premier League
19-06-17,18.3.4.28,Davide Zappacosta,43061433,776,11-Jun-92,25,4,0,17,0,4750,7000,7000,149,140,31417335,182,72,D/WB/M R,4,1,2,1,2,3,2,1,1,3,1,10,14,14,9,12,9,10,9,10,13,13,7,14,13,11,13,14,13,13,11,13,14,10,9,15,14,14,14,15,13,14,12,7,14,15,20,15,13,16,6,13,6,14,13,15,14,14,13,14,13,4,20,19,18,9,20,9,1,D/WB/M R,122,1,1,1,1,1,9,1,9,20,1,1,1,18,8,19,34,0,1,0,0,0,1,0,0,0,0,0,0,0,0,0,0,0,0,0,0,0,0,0,0,0,0,0,0,0,0,0,0,0,0,0,0,0,0,0,0,0,0,0,0,0,0,0,0,Davide Zappacosta,£18.00m ,28,182,Defender - Right-Back,right,Genoa CFC,29,1,4,2333,38,2,2,2305,17,0,2,1020,9,0,1,446,2,1,0,166,Premier League
19-06-17,18.3.4.28,Victor Moses,5007466,38,12-Dec-90,26,27,9,0,0,6500,6950,7250,146,146,48063215,177,77,WB/M R,2,3,4,2,2,2,2,3,4,3,3,8,10,14,11,12,9,10,11,16,4,13,9,12,12,11,10,9,12,8,9,15,8,13,6,11,14,13,18,16,13,14,8,13,10,15,20,16,18,8,10,12,13,14,11,12,12,11,11,8,12,7,1,20,17,15,20,14,14,WB/M R,212,1,1,13,14,14,15,1,1,1,1,1,14,17,1,20,2.25235E+15,0,0,0,0,1,0,0,0,0,1,0,0,0,0,0,0,0,0,0,0,0,0,0,0,0,0,0,1,0,0,0,0,0,0,0,0,0,0,0,1,0,0,0,0,0,0,0,0,Victor Moses,£18.00m ,29,177,Midfielder - Right Midfield,right,Spartak Moscow,40,4,4,3045,38,4,4,3038,22,4,1,1250,27,1,6,1243,2,1,0,102,Premier League
19-06-17,18.3.4.28,Phil Bardsley,5107572,793,28-Jun-85,31,13,0,0,0,4600,6500,6500,132,132,13836614,180,74,D RL,3,2,1,2,1,4,3,3,1,4,3,13,12,11,9,12,8,13,14,13,15,11,6,16,11,18,14,17,10,16,6,14,8,8,15,12,15,15,14,12,12,13,10,5,8,11,20,16,13,10,13,10,12,7,7,10,14,8,8,6,7,15,20,7,3,1,20,17,5,D RL,105,1,1,1,1,1,1,5,17,20,3,1,1,3,1,7,17179869952,0,0,0,0,0,0,0,0,1,1,0,0,0,0,0,0,0,0,0,0,0,0,0,0,0,0,0,0,0,0,0,0,0,0,1,0,0,0,0,0,0,0,0,0,0,0,0,0,Phil Bardsley,£1.35m ,35,180,Defender - Right-Back,right,Burnley FC,17,1,0,1350,15,0,0,1335,23,0,0,2092,22,0,1,1968,4,0,0,281,Premier League
19-06-17,18.3.4.28,Glen Johnson,5112082,765,23-Aug-84,32,54,1,14,0,5300,6150,6150,156,123,1390128,182,70,D/WB R,3,3,1,3,2,3,1,2,2,1,1,3,13,13,10,13,8,13,12,6,13,10,12,14,15,11,13,13,14,12,13,11,13,12,7,13,11,14,14,12,15,16,13,15,15,11,20,7,12,12,7,13,13,15,15,15,15,12,15,16,14,5,20,17,14,13,20,14,12,D/WB R,112,1,1,1,1,1,13,12,14,20,1,1,1,14,14,17,5.49756E+11,0,1,0,0,0,0,0,0,0,0,0,0,0,0,0,0,0,0,0,0,0,0,0,0,0,0,0,0,0,0,0,0,0,0,0,0,0,0,0,1,0,0,0,0,0,0,0,0,Glen Johnson,£2.25m ,36,182,Defender - Right-Back,both,Retired,25,0,0,2135,10,0,0,639,nan,nan,nan,nan,nan,nan,nan,nan,nan,nan,nan,nan,Premier League
19-06-17,18.3.4.28,Liam Rosenior,5112276,765,09-Jul-84,32,0,0,7,0,4500,6250,6250,136,125,3672795,178,73,D/WB/M RL,2,3,1,1,3,3,3,1,3,2,3,9,10,10,6,11,6,8,6,12,14,12,7,13,11,11,13,13,11,13,11,12,15,11,15,11,13,16,17,13,11,10,10,12,17,12,20,15,12,16,10,15,13,14,15,18,8,14,18,16,13,14,20,18,17,1,20,15,6,D/WB/M RL,125,1,1,1,1,1,1,6,15,20,1,1,1,17,13,18,1.09965E+12,0,0,0,0,0,1,0,0,0,0,0,0,0,0,0,0,0,0,0,0,0,0,0,0,0,0,0,1,0,0,0,0,0,0,0,0,0,0,0,0,1,0,0,0,0,0,0,0,Liam Rosenior,£900Th. ,36,178,Defender - Right-Back,right,Retired,12,0,1,926,8,0,0,632,nan,nan,nan,nan,nan,nan,nan,nan,nan,nan,nan,nan,Premier League
19-06-17,18.3.4.28,Simon Francis,5112466,765,16-Feb-85,32,0,0,0,0,4750,6700,6950,145,132,232186002,188,90,D RC,2,1,3,2,1,3,3,2,3,2,2,10,15,11,6,13,5,14,9,10,14,13,6,15,13,9,14,12,13,12,10,12,13,4,15,11,14,13,15,14,10,14,12,9,15,11,20,15,15,14,3,13,2,14,12,14,13,11,15,15,14,2,20,13,1,1,20,1,20,D RC,103,1,1,1,1,1,1,20,1,20,1,1,1,1,1,13,9.8956E+12,0,0,0,0,0,1,0,0,0,0,0,1,0,0,0,0,0,0,0,0,0,0,0,0,0,0,0,0,0,0,0,0,0,0,0,0,0,0,0,0,1,0,0,1,0,0,0,0,Simon Francis,£2.25m ,35,191,Defender - Right-Back,right,Without Club,35,0,2,3030,34,0,1,2916,20,0,3,1492,18,0,1,1130,nan,nan,nan,nan,Premier League
19-06-17,18.3.4.28,Ashley Young,5113149,765,09-Jul-85,31,30,7,10,0,6100,6750,6750,155,143,232186002,175,65,D/M RL,2,3,2,1,2,2,1,3,1,2,2,14,15,12,10,14,14,5,13,3,9,12,12,11,13,7,11,6,10,14,9,13,12,14,10,13,12,15,16,14,15,12,7,9,15,15,20,15,10,12,8,15,5,13,18,12,8,12,13,4,14,4,20,15,18,15,18,20,14,D/M RL,115,1,1,12,14,15,13,1,20,18,1,1,18,14,15,15,7.09185E+13,1,0,0,0,0,0,0,0,0,0,1,1,0,0,0,0,0,0,0,0,0,0,0,0,0,0,0,0,0,0,0,0,0,0,0,0,0,0,0,1,0,0,0,0,0,0,1,0,Ashley Young,£6.30m ,35,175,Midfielder - Left Midfield,both,Inter Milan,23,0,1,1469,39,2,7,3156,41,2,3,3509,43,5,6,3005,3,0,1,152,Premier League
19-06-17,18.3.4.28,Danny Simpson,5116936,765,04-Jan-87,30,0,0,0,0,5300,6800,6800,139,134,232186002,176,77,D R,1,1,1,1,1,1,1,1,1,1,1,8,9,12,6,12,1,15,6,8,12,10,6,15,10,15,15,15,12,15,9,14,13,7,4,10,15,15,14,14,12,13,7,14,15,14,20,15,14,13,14,13,5,7,15,11,12,11,14,13,13,6,20,12,5,1,20,13,10,D R,102,1,1,1,1,1,1,10,13,20,1,1,1,5,1,12,8589934592,0,0,0,0,0,0,0,0,0,0,0,0,0,0,0,0,0,0,0,0,0,0,0,0,0,0,0,0,0,0,0,0,0,1,0,0,0,0,0,0,0,0,0,0,0,0,0,0,Danny Simpson,£4.50m ,33,176,Defender - Right-Back,right,Without Club,45,0,2,3893,31,0,0,2597,13,0,0,907,25,0,0,2083,nan,nan,nan,nan,Premier League
19-06-17,18.3.4.28,James Tomkins,5129541,765,29-Mar-89,28,0,0,10,0,5500,6700,6700,138,134,29696861,191,79,D RC,3,2,1,2,1,3,2,1,1,4,1,6,4,11,4,9,4,16,4,6,14,10,2,15,10,12,13,16,15,11,6,13,13,4,14,8,14,18,16,13,11,14,16,10,15,13,20,13,14,13,7,15,11,14,10,15,13,11,14,18,17,5,20,1,1,1,15,1,20,D RC,103,1,1,1,1,1,1,20,1,15,12,1,1,1,1,1,0,0,0,0,0,0,0,0,0,0,0,0,0,0,0,0,0,0,0,0,0,0,0,0,0,0,0,0,0,0,0,0,0,0,0,0,0,0,0,0,0,0,0,0,0,0,0,0,0,James Tomkins,£7.20m ,31,192,Defender - Centre-Back,right,Crystal Palace,27,3,0,2184,30,3,0,2568,30,1,1,2653,19,1,1,1603,nan,nan,nan,nan,Premier League
19-06-17,18.3.4.28,Mame Diouf,53016763,41,01-Dec-87,29,37,10,18,7,6400,6500,6750,151,133,34394597,185,77,D/WB/M/AM RLC,1,2,3,1,2,3,3,2,1,3,3,6,8,10,10,11,6,12,9,5,6,8,10,7,12,16,14,17,11,12,8,10,15,12,6,16,6,13,15,14,15,12,14,14,18,14,20,15,13,13,15,13,10,10,14,17,7,13,14,7,10,12,16,17,17,20,20,15,17,D/WB/M/AM RLC,546,1,1,14,17,15,20,1,1,16,1,1,14,17,1,17,8392704,0,0,0,0,0,0,0,0,0,0,0,0,1,0,0,0,0,0,0,0,0,0,0,1,0,0,0,0,0,0,0,0,0,0,0,0,0,0,0,0,0,0,0,0,0,0,0,0,Mame Diouf,£6.30m ,32,185,Forward - Centre-Forward,right,Hatayspor,29,1,2,1493,37,6,3,2701,18,2,2,878,11,2,0,292,4,1,1,283,Premier League
19-06-17,18.3.4.28,Cédric,55012984,788,31-Aug-91,25,17,0,10,0,5600,7000,6850,148,140,29741989,172,66,D/WB R,2,4,3,3,1,1,4,3,2,3,2,9,13,12,7,13,8,6,10,10,11,12,12,14,13,14,14,14,11,14,13,14,14,13,11,13,14,13,13,17,13,14,6,9,14,17,20,15,7,13,8,11,8,10,16,12,14,13,17,15,15,5,20,17,12,10,20,1,1,D/WB R,112,1,1,1,1,1,10,1,1,20,1,1,1,12,1,17,2,0,1,0,0,0,0,0,0,0,0,0,0,0,0,0,0,0,0,0,0,0,0,0,0,0,0,0,0,0,0,0,0,0,0,0,0,0,0,0,0,0,0,0,0,0,0,0,0,,,,,,,,,,,,,,,,,,,,,,,,,,,,
19-06-17,18.3.4.28,Seamus Coleman,56001681,789,11-Oct-88,28,43,1,13,1,6200,7450,7650,153,145,83420492,178,67,D/WB/M R,1,3,2,3,2,4,3,2,1,2,4,5,13,14,12,12,8,14,13,12,12,12,7,14,12,16,12,15,13,13,9,13,18,11,15,13,13,16,17,15,12,14,10,9,14,14,20,17,14,14,11,12,7,10,10,13,18,12,15,15,14,7,20,20,17,5,20,10,1,D/WB/M R,122,1,1,1,1,1,5,1,10,20,1,1,1,17,1,20,2.19902E+12,0,1,0,0,0,1,0,0,0,1,0,0,0,0,0,0,0,0,0,0,1,0,0,0,0,0,0,0,0,0,0,0,0,0,0,0,0,0,0,0,0,1,0,0,0,0,0,0,Seamus Coleman,£10.80m ,32,177,Defender - Right-Back,right,Everton FC,28,4,4,2497,12,0,1,1035,30,2,2,2650,30,0,1,2082,6,0,1,407,Premier League
19-06-17,18.3.4.28,César Azpilicueta,67033300,796,28-Aug-89,27,19,0,22,1,6750,7750,8000,165,161,162130533,178,76,D/WB RLC,1,4,3,1,3,3,1,2,1,3,1,8,13,9,6,11,7,9,10,11,14,10,8,16,13,12,15,16,14,15,11,15,16,8,15,12,15,17,20,14,14,12,9,15,17,14,20,18,10,19,12,15,5,16,12,14,18,16,18,15,12,6,20,16,1,1,20,19,18,D/WB RLC,116,1,1,1,1,1,1,18,19,20,1,1,1,1,16,15,1.15292E+18,0,0,0,0,0,0,0,0,0,0,0,0,0,0,0,0,0,0,0,0,0,0,0,0,0,0,0,0,0,0,0,0,0,0,0,0,0,0,0,0,0,0,0,0,0,0,0,0,César Azpilicueta,£36.00m ,31,178,Defender - Right-Back,right,Chelsea FC,47,2,7,4098,52,3,7,4755,57,1,9,4867,49,4,7,4312,7,0,1,499,Premier League
19-06-17,18.3.4.28,Kiko Femenía,67063051,796,02-Feb-91,26,0,0,1,0,5508,6260,7000,141,140,20698920,173,71,D/WB/M/AM RL,2,4,1,2,1,3,2,1,3,3,3,10,11,12,9,11,9,7,9,14,8,12,11,11,13,9,12,14,10,12,10,10,9,13,9,12,10,12,13,17,12,10,7,10,14,17,20,13,9,13,6,11,6,16,12,12,13,8,14,16,7,11,20,19,18,18,20,16,1,D/WB/M/AM RL,135,1,1,1,1,16,18,1,6,20,1,1,12,18,9,19,2,0,1,0,0,0,0,0,0,0,0,0,0,0,0,0,0,0,0,0,0,0,0,0,0,0,0,0,0,0,0,0,0,0,0,0,0,0,0,0,0,0,0,0,0,0,0,0,0,Kiko Femenía,£4.50m ,29,171,Defender - Right-Back,right,Watford FC,37,0,2,2986,23,1,0,1716,34,1,2,2491,29,0,1,2331,4,0,1,305,Premier League
19-06-17,18.3.4.28,Javi Manquillo,67141802,796,05-May-94,23,0,0,4,0,5250,6500,6550,135,126,25745477,180,63,D/WB R,3,4,2,1,1,3,1,3,3,1,2,5,12,12,5,12,7,8,8,12,13,11,7,13,12,13,13,13,14,14,9,13,16,11,9,13,14,14,15,13,14,9,11,8,12,14,20,15,11,12,7,12,8,13,8,14,15,11,15,11,13,2,20,19,13,10,20,9,1,D/WB R,112,1,1,1,1,1,10,1,9,20,1,1,1,13,7,19,32800,0,0,0,0,0,1,0,0,0,0,0,0,0,0,0,1,0,0,0,0,0,0,0,0,0,0,0,0,0,0,0,0,0,0,0,0,0,0,0,0,0,0,0,0,0,0,0,0,Javier Manquillo,£4.50m ,26,178,Defender - Right-Back,right,Newcastle United,22,1,0,1607,23,0,1,1926,21,0,3,1396,24,0,1,1819,6,0,0,485,Premier League
19-06-17,18.3.4.28,Geoff Cameron,72006682,390,11-Jul-85,31,55,4,0,0,4700,6750,6500,137,129,232186002,191,84,D/DM/M RC,3,1,1,3,3,3,3,1,1,3,1,9,10,12,10,11,9,12,9,15,13,11,13,13,9,11,13,11,12,14,10,13,15,12,10,13,12,12,14,12,12,12,13,11,15,11,20,13,13,13,1,12,11,19,16,14,7,12,14,14,15,3,18,5,20,1,18,8,20,D/DM/M RC,433,1,1,1,1,1,1,18,8,18,18,20,1,15,1,5,2.74878E+11,0,0,0,1,0,1,0,0,0,0,0,0,0,0,1,0,0,0,0,0,0,0,0,0,0,0,0,0,0,0,0,0,0,0,0,0,0,0,1,0,0,0,0,0,0,0,0,0,Geoff Cameron,£2.25m ,35,190,Midfielder - Defensive Midfield,right,Queens Park Rangers,21,0,2,1808,21,0,0,1576,19,1,1,1391,37,1,1,3147,7,0,0,630,Premier League
19-06-17,18.3.4.28,DeAndre Yedlin,72038776,390,09-Jul-93,23,46,0,4,0,5250,6500,6700,144,134,35265023,173,73,D/WB R,2,3,3,1,3,2,3,1,1,3,2,8,11,12,6,11,6,10,4,8,10,10,4,13,10,11,10,12,10,11,10,11,12,10,6,11,9,15,15,19,15,11,12,8,14,19,20,14,11,13,7,11,5,10,13,15,11,10,12,12,13,4,20,20,7,7,20,1,1,D/WB R,112,1,1,1,1,1,7,1,1,20,1,1,1,7,1,20,1048610,0,1,0,0,0,1,0,0,0,0,0,0,0,0,0,0,0,0,0,0,1,0,0,0,0,0,0,0,0,0,0,0,0,0,0,0,0,0,0,0,0,0,0,0,0,0,0,0,DeAndre Yedlin,£7.20m ,27,173,Defender - Right-Back,right,Newcastle United,32,1,6,2277,34,0,2,2842,29,1,2,2475,20,1,0,1250,2,0,1,180,Premier League
19-06-17,18.3.4.28,Ángel Rangel,7448186,796,28-Oct-82,34,0,0,0,0,5100,6000,6250,133,120,1058613,180,81,D/WB R,2,2,3,2,1,1,3,2,1,3,1,8,12,14,11,13,7,11,11,11,13,12,6,15,12,15,12,14,14,13,13,12,14,11,14,15,13,17,16,10,10,13,11,11,13,10,20,11,14,15,11,15,8,12,20,15,18,14,14,12,12,2,20,19,1,1,20,10,1,D/WB R,112,1,1,1,1,1,1,1,10,20,1,1,1,1,1,19,1048608,0,0,0,0,0,1,0,0,0,0,0,0,0,0,0,0,0,0,0,0,1,0,0,0,0,0,0,0,0,0,0,0,0,0,0,0,0,0,0,0,0,0,0,0,0,0,0,0,Ángel Rangel,£900Th. ,37,188,Defender - Right-Back,right,Without Club,21,1,0,1026,7,0,1,425,20,2,2,1736,21,0,0,1663,nan,nan,nan,nan,Premier League
19-06-17,18.3.4.28,Matteo Darmian,7990060,776,02-Dec-89,27,30,1,1,0,6300,7400,7250,150,140,27211362,183,70,D/WB RL,2,3,2,2,3,3,1,1,2,3,1,4,9,7,7,13,4,14,4,10,15,12,4,17,13,12,13,14,13,13,6,13,13,5,10,9,13,14,15,13,14,14,11,11,17,14,20,15,14,15,13,13,7,18,10,14,15,15,15,18,18,8,20,19,13,1,20,18,14,D/WB RL,115,1,1,1,1,1,1,14,18,20,1,1,10,13,17,19,1.37439E+11,0,1,0,0,0,0,0,0,0,0,0,0,0,0,0,0,0,0,0,0,0,0,0,0,0,0,0,0,0,0,0,0,0,0,0,0,0,1,0,0,0,0,0,0,0,0,0,0,Matteo Darmian,£9.00m ,30,183,Defender - Right-Back,right,Inter Milan,29,0,1,2322,17,0,2,1105,7,0,0,533,34,1,1,2685,5,0,0,377,Premier League
19-06-17,18.3.4.28,Bruno,814310,796,01-Oct-80,36,0,0,0,0,4250,6550,6750,139,131,232186002,181,76,D/WB R,1,3,2,2,1,1,1,2,1,3,1,8,11,11,7,15,8,11,9,16,11,13,9,12,15,15,14,13,14,13,9,14,14,14,16,11,14,14,15,12,10,10,10,10,20,13,20,15,13,17,14,14,5,15,18,12,15,14,20,11,12,9,20,17,14,1,20,11,14,D/WB R,112,1,1,1,1,1,1,14,11,20,12,14,1,13,8,17,2.92058E+11,0,0,0,0,0,1,1,0,0,0,0,0,0,0,0,0,0,0,0,0,0,0,0,0,0,0,0,0,0,0,0,0,0,0,1,0,0,0,1,0,0,0,0,0,0,0,0,0,Bruno,£675Th. ,40,180,Defender - Right-Back,right,Retired,42,0,5,3719,26,0,1,2107,18,0,1,1537,nan,nan,nan,nan,nan,nan,nan,nan,Premier League
19-06-17,18.3.4.28,Toby Alderweireld,8169242,757,02-Mar-89,28,67,3,5,0,7250,8500,8200,170,164,29023250,187,91,D RC,1,1,3,3,3,1,3,1,1,1,2,7,10,12,9,14,11,16,11,12,14,15,8,17,13,13,17,14,14,14,13,15,14,10,12,10,17,15,15,13,13,14,14,14,15,12,20,14,15,16,5,13,9,13,11,13,15,15,18,15,13,9,20,11,1,1,15,6,20,D RC,103,1,1,1,1,1,1,20,6,15,10,1,1,1,3,11,1.49534E+14,0,0,0,0,0,0,0,0,0,1,0,0,0,0,0,0,0,0,0,0,0,0,0,0,0,0,0,0,0,0,0,0,0,0,0,0,0,0,0,0,0,0,0,1,0,0,0,1,Toby Alderweireld,£36.00m ,31,186,Defender - Centre-Back,right,Tottenham Hotspur,39,2,0,3325,21,0,1,1741,50,0,0,4363,42,2,2,3798,5,0,0,450,Premier League
19-06-17,18.3.4.28,Yohan Benalouane,8434244,51,28-Mar-87,30,0,0,0,0,5096,5606,6250,138,134,13094595,187,85,D RC,2,2,4,2,1,1,1,2,2,2,3,5,9,11,6,12,6,15,8,6,14,10,8,15,13,17,15,16,13,8,9,13,13,9,12,7,14,13,14,12,11,15,15,9,15,13,20,15,16,12,16,14,7,8,12,13,11,11,16,12,6,14,20,1,1,1,16,10,20,D RC,103,1,1,1,1,1,1,20,10,16,1,1,1,1,1,1,1.15292E+18,0,0,0,0,0,1,0,0,0,0,0,0,0,0,0,0,0,0,0,0,0,0,0,0,0,0,0,0,0,0,0,0,0,0,0,0,0,0,0,0,0,0,0,0,0,0,0,0,Yohan Benalouane,£900Th. ,33,185,Defender - Centre-Back,right,Aris Thessaloniki,25,1,0,2061,10,2,0,819,19,1,1,1636,2,0,0,49,nan,nan,nan,nan,Premier League
19-06-17,18.3.4.28,Jérémy Pied,8440220,769,23-Feb-89,28,0,0,5,0,4750,6450,6550,136,131,20708517,173,69,WB/AM R,3,1,2,3,2,1,2,1,2,1,1,13,13,13,7,14,11,8,10,6,10,13,9,11,13,12,13,11,13,12,13,12,15,12,7,12,9,11,14,15,14,11,7,10,13,13,20,14,8,13,13,14,10,8,20,13,14,14,15,15,15,5,15,18,15,20,20,13,10,WB/AM R,522,1,1,1,1,12,20,1,10,15,1,10,13,15,10,18,2.25235E+15,0,0,0,0,0,0,0,0,0,0,0,0,0,0,0,0,0,0,0,0,0,0,0,0,0,0,0,0,0,0,0,0,0,0,0,0,0,0,0,1,0,0,0,0,0,0,0,0,Jérémy Pied,£2.25m ,31,173,Defender - Right-Back,right,LOSC Lille,6,0,0,277,6,0,1,500,13,0,2,616,9,0,0,731,3,0,0,176,Premier League
19-06-17,18.3.4.28,Serge Aurier,85057643,24,24-Dec-92,24,41,1,0,0,6250,7250,7250,148,143,52949109,174,74,D/WB R,1,1,1,3,2,3,1,2,3,2,2,7,12,12,8,14,7,14,9,12,12,13,6,15,12,14,13,15,12,11,10,13,15,11,10,16,13,14,16,15,13,14,9,8,18,14,20,18,14,12,13,14,7,12,14,15,12,12,11,11,12,14,20,17,10,1,20,12,12,D/WB R,112,1,1,1,1,1,1,12,12,20,7,1,1,10,8,17,134348840,0,0,0,1,0,1,0,0,0,0,0,0,0,0,0,0,0,1,0,0,0,0,0,0,0,0,0,1,0,0,0,0,0,0,0,0,0,0,0,0,0,0,0,0,0,0,0,0,Serge Aurier,£18.00m ,27,176,Defender - Right-Back,right,Tottenham Hotspur,32,0,5,2561,24,2,3,2025,17,2,3,1358,42,2,8,3546,4,1,1,360,Premier League
19-06-17,18.3.4.28,Kurt Zouma,85075595,769,27-Oct-94,22,2,0,7,1,5850,6750,7850,162,146,95115359,190,96,D RC,1,2,3,1,3,1,2,1,3,3,1,4,10,9,8,11,6,16,7,8,13,10,7,16,10,14,12,14,13,11,8,13,15,7,13,8,12,12,15,19,11,18,18,5,14,15,20,14,18,13,13,15,9,8,10,17,13,14,14,15,13,5,20,10,1,1,15,1,20,D RC,103,1,1,1,1,1,1,20,1,15,14,1,1,1,1,10,1.37439E+11,0,0,0,0,0,1,0,0,0,0,0,0,0,0,0,0,0,0,0,0,0,0,0,0,0,0,0,0,0,0,0,0,0,0,0,0,0,1,0,0,0,0,0,0,0,0,0,0,Kurt Zouma,£13.50m ,25,190,Defender - Centre-Back,right,Chelsea FC,17,0,1,802,37,1,0,3127,36,2,2,2924,43,1,3,3704,8,2,0,659,Premier League
19-06-17,18.3.4.28,Daryl Janmaat,860896,784,22-Jul-89,27,28,0,11,0,5750,6800,6800,147,137,34986677,185,80,D/WB R,1,3,3,3,1,2,1,2,3,2,2,5,14,14,7,13,7,12,14,10,14,13,7,15,13,15,13,13,13,12,12,13,13,12,14,14,10,15,15,13,13,13,12,12,14,13,20,15,12,12,11,13,9,14,13,15,11,14,13,13,12,5,18,20,11,1,20,14,14,D/WB R,222,1,1,1,1,1,1,14,10,18,8,1,1,11,14,20,288,0,0,0,0,0,1,0,0,1,0,0,0,0,0,0,0,0,0,0,0,0,0,0,0,0,0,0,0,0,0,0,0,0,0,0,0,0,0,0,0,0,0,0,0,0,0,0,0,Daryl Janmaat,£5.40m ,31,185,Defender - Right-Back,right,Without Club,30,2,1,1809,25,3,0,1986,22,0,2,1803,10,1,1,788,nan,nan,nan,nan,Premier League
19-06-17,18.3.4.28,Antonio Valencia,8830032,1654,04-Aug-85,31,88,10,0,0,6500,8000,7500,158,149,232186002,181,78,D/WB R,3,1,4,2,1,2,3,1,2,3,1,10,12,12,9,12,5,7,8,8,12,12,8,14,13,11,14,14,8,15,7,12,17,10,12,12,14,16,17,16,13,18,8,7,17,16,20,18,18,14,7,14,6,8,18,15,12,12,18,16,16,4,20,17,15,12,20,8,12,D/WB R,112,1,1,1,10,8,12,1,1,20,1,12,8,15,1,17,17314103298,0,1,0,0,0,0,0,0,0,0,0,0,0,0,1,0,0,0,0,0,0,0,0,0,0,0,0,1,0,0,0,0,0,0,1,0,0,0,0,0,0,0,0,0,0,0,0,0,Antonio D'Alena,£90Th. ,22,175,Midfielder - Defensive Midfield,left,Imolese Calcio 1919,35,10,11,2869,39,3,2,3282,3,0,0,48,5,0,1,183,3,0,0,83,Serie A
19-06-17,18.3.4.28,Craig Dawson,90000708,765,06-May-90,27,0,0,15,7,5200,6750,6800,140,136,31122834,188,83,D RC,2,2,3,1,3,1,3,2,1,2,2,2,12,9,9,12,2,17,6,4,14,11,10,14,11,15,13,17,11,12,10,11,17,7,12,6,15,15,13,12,10,11,17,12,18,13,20,15,15,14,4,14,2,8,6,18,7,10,9,9,8,3,20,1,1,1,20,10,20,D RC,103,1,1,1,1,1,1,20,10,20,1,1,1,1,1,1,33792,0,0,0,0,0,0,0,0,0,0,1,0,0,0,0,1,0,0,0,0,0,0,0,0,0,0,0,0,0,0,0,0,0,0,0,0,0,0,0,0,0,0,0,0,0,0,0,0,Craig Dawson,£7.20m ,30,188,Defender - Centre-Back,right,West Ham United,39,4,1,3488,32,2,1,2869,45,3,3,3831,30,2,0,2449,1,0,0,90,Premier League
19-06-17,18.3.4.28,Christopher Schindler,91012809,771,29-Apr-90,27,0,0,4,0,5250,6300,6900,140,138,36282268,188,77,D RLC,2,1,1,1,3,4,2,1,1,3,2,5,6,9,7,12,5,15,7,12,13,12,14,14,11,12,14,13,13,13,8,12,15,5,15,9,14,13,14,12,11,15,15,15,12,12,20,15,14,15,4,15,4,16,11,11,13,13,16,13,15,4,20,14,12,1,18,18,20,D RLC,106,1,1,1,1,1,1,20,18,18,12,12,1,1,14,14,0,0,0,0,0,0,0,0,0,0,0,0,0,0,0,0,0,0,0,0,0,0,0,0,0,0,0,0,0,0,0,0,0,0,0,0,0,0,0,0,0,0,0,0,0,0,0,0,0,Christopher Schindler,£5.40m ,30,188,Defender - Centre-Back,right,Huddersfield Town,48,2,3,4287,39,0,2,3401,38,1,0,3352,46,2,1,4140,6,0,0,378,Premier League
19-06-17,18.3.4.28,Antonio Rüdiger,92023410,771,03-Mar-93,24,17,0,10,1,6450,7450,7450,163,149,69451085,190,85,D RC,1,3,1,3,2,2,3,3,2,1,2,5,10,10,7,10,9,14,8,14,14,12,7,16,11,15,15,17,13,12,10,12,17,9,15,8,14,13,15,13,12,17,15,10,10,16,20,16,18,12,14,12,14,13,15,17,12,13,15,9,11,13,20,1,1,1,16,10,20,D RC,103,1,1,1,1,1,1,20,10,16,1,1,1,1,1,1,1.37439E+11,0,0,0,0,0,0,0,0,0,0,0,0,0,0,0,0,0,0,0,0,0,0,0,0,0,0,0,0,0,0,0,0,0,0,0,0,0,1,0,0,0,0,0,0,0,0,0,0,Antonio Rüdiger,£36.00m ,27,190,Defender - Centre-Back,right,Chelsea FC,36,1,4,3025,45,3,2,3785,44,1,0,3894,28,2,0,2417,0,0,0,0,Premier League
19-06-17,18.3.4.28,Victor Lindelöf,93023425,797,17-Jul-94,22,12,1,13,0,6000,7000,7250,168,149,81481802,187,0,D/DM RC,1,1,2,2,2,3,3,3,1,1,1,3,10,12,7,13,3,11,6,11,15,14,10,14,14,12,15,12,14,12,13,13,14,14,13,14,15,14,15,16,15,14,13,12,16,15,20,14,13,15,8,15,3,16,14,13,18,16,17,15,12,6,20,13,3,1,16,5,20,D/DM RC,113,1,1,1,1,1,1,20,5,16,16,3,1,1,1,13,0,0,0,0,0,0,0,0,0,0,0,0,0,0,0,0,0,0,0,0,0,0,0,0,0,0,0,0,0,0,0,0,0,0,0,0,0,0,0,0,0,0,0,0,0,0,0,0,0,Victor Lindelöf,£22.50m ,26,187,Defender - Centre-Back,right,Manchester United,47,1,0,4090,29,0,0,2361,40,1,1,3502,47,1,1,4108,6,0,0,540,Premier League
19-06-17,18.3.4.28,Daniel Amartey,93034815,21,21-Dec-94,22,19,0,0,0,5300,6500,6500,150,128,29260020,183,76,D/WB/DM/M RC,2,1,1,2,2,1,3,2,3,1,3,6,7,7,6,12,8,14,10,8,15,12,9,14,11,16,13,15,13,13,8,11,16,5,8,11,13,13,16,12,12,13,13,9,15,12,20,15,14,8,10,14,7,15,7,15,15,15,15,14,11,5,20,17,16,1,20,1,16,D/WB/DM/M RC,133,1,1,1,1,1,1,15,1,20,17,16,1,14,1,17,1.37439E+11,0,0,0,0,0,0,0,0,0,1,0,0,0,0,0,0,0,0,0,0,0,0,0,0,0,0,0,0,0,0,0,0,0,0,0,0,0,1,0,0,0,0,0,0,0,0,0,0,Daniel Amartey,£4.50m ,25,186,Midfielder - Defensive Midfield,right,Leicester City,35,1,1,2196,15,0,0,1150,10,0,0,730,1,0,0,90,3,0,0,235,Premier League
19-06-17,18.3.4.28,Pablo Zabaleta,951034,1649,16-Jan-85,32,58,0,43,5,6650,7250,7150,163,135,232186002,176,74,D/WB R,3,3,1,3,1,2,2,2,2,2,2,8,12,10,10,13,6,11,9,9,15,12,10,18,12,17,14,19,13,14,10,12,17,4,16,16,15,19,19,9,10,13,9,9,15,9,20,16,13,19,8,14,13,20,18,16,18,18,20,15,14,6,20,18,14,13,20,13,14,D/WB R,112,1,1,1,1,1,13,10,13,20,13,14,1,14,12,18,2.19902E+12,0,0,0,0,0,0,0,0,0,0,0,0,0,0,0,0,0,0,0,0,0,0,0,0,0,0,0,0,0,0,0,0,0,0,0,0,0,0,0,0,0,1,0,0,0,0,0,0,Pablo Zabaleta,£4.50m ,35,176,Defender - Right-Back,right,Retired,32,2,2,2055,39,0,1,3366,27,0,1,2181,13,0,0,859,nan,nan,nan,nan,Premier League
19-06-17,18.3.4.28,Moritz Bauer,98009418,755,25-Jan-92,25,0,0,0,0,4250,5900,6000,135,129,7105337,181,73,D/WB R,1,2,1,3,1,1,1,2,2,1,2,11,12,13,6,12,10,12,8,14,13,11,5,13,12,13,13,12,12,14,9,13,7,9,9,12,10,16,17,13,13,12,10,12,12,14,20,16,9,16,10,10,5,9,16,8,13,7,15,12,11,8,20,17,10,1,20,13,1,D/WB R,112,1,1,1,1,1,1,1,13,20,1,1,1,10,1,17,32,0,0,0,0,0,1,0,0,0,0,0,0,0,0,0,0,0,0,0,0,0,0,0,0,0,0,0,0,0,0,0,0,0,0,0,0,0,0,0,0,0,0,0,0,0,0,0,0,Moritz Bauer,£4.50m ,28,181,Defender - Right-Back,right,Stoke City,23,0,4,1824,33,0,1,2805,16,0,1,1234,13,0,3,870,nan,nan,nan,nan,Premier League
19-06-17,18.3.4.28,Florent Hadergjonaj,98031298,798,31-Jul-94,22,1,0,11,0,4750,6300,6400,140,128,7834442,182,73,D/WB R,3,2,2,1,2,1,3,2,2,4,1,9,14,12,7,12,8,10,7,14,10,13,8,13,12,16,12,13,10,10,11,11,13,13,8,13,11,14,16,15,13,10,10,12,17,14,20,15,9,12,9,11,8,13,11,14,9,14,15,12,16,8,20,20,13,12,20,1,13,D/WB R,112,1,1,1,1,1,12,10,1,20,13,13,1,12,1,20,1.09951E+12,0,0,0,0,0,0,0,0,0,0,0,0,0,0,0,0,0,0,0,0,0,0,0,0,0,0,0,0,0,0,0,0,0,0,0,0,0,0,0,0,1,0,0,0,0,0,0,0,Florent Hadergjonaj,£4.50m ,26,182,Defender - Right-Back,right,Kasimpasa,29,1,3,2444,29,0,2,2109,24,0,0,1841,35,0,2,2626,4,0,0,340,Premier League
19-06-17,18.3.4.28,Jean-Eudes Aholou,13112746,50,20-Mar-94,23,0,0,0,0,3800,6250,6250,131,124,7052613,186,79,D/DM/M RC,2,2,1,1,4,1,2,3,1,1,3,7,10,11,7,11,7,12,10,8,10,12,10,13,11,12,12,14,13,12,10,12,14,8,8,12,12,14,12,14,12,14,14,20,15,13,8,15,14,13,11,14,6,16,13,14,12,11,13,11,19,5,17,12,18,1,17,1,18,D/DM/M RC,333,1,1,1,1,1,1,1,1,17,20,18,1,15,1,12,0,0,0,0,0,0,0,0,0,0,0,0,0,0,0,0,0,0,0,0,0,0,0,0,0,0,0,0,0,0,0,0,0,0,0,0,0,0,0,0,0,0,0,0,0,0,0,0,0,Jean-Eudes Aholou,£2.70m ,26,187,Midfielder - Defensive Midfield,left,RC Strasbourg Alsace,39,3,2,3403,40,5,0,3275,21,0,1,1339,17,1,1,1012,5,1,0,295,Ligue 1
19-06-17,18.3.4.28,Yves Bissouma,13174979,31,30-Aug-96,20,10,3,0,0,4250,6150,6450,136,123,17462375,180,78,WB/M RC,2,3,2,1,1,2,2,3,2,3,2,11,11,14,12,13,13,10,15,2,8,12,6,8,13,8,10,10,12,11,9,10,10,13,8,14,9,11,14,15,14,12,10,8,14,14,20,15,12,13,11,8,7,11,20,13,12,12,10,11,14,1,1,16,20,1,16,1,20,WB/M RC,423,1,1,1,1,1,1,1,1,1,1,20,1,1,1,16,2.2518E+15,0,0,0,0,0,0,0,0,0,0,0,0,0,0,0,0,0,0,0,0,0,0,0,0,0,0,0,0,0,0,0,0,0,0,0,0,0,0,0,0,0,0,0,0,0,0,0,0,Yves Bissouma,£7.20m ,24,182,Midfielder - Central Midfield,right,Brighton & Hove Albion,27,1,1,1032,28,3,1,1858,34,1,1,2295,23,1,0,1325,5,1,0,449,Ligue 1
19-06-17,18.3.4.28,Djibril Sidibé,167575,769,29-Jul-92,24,10,1,1,0,6550,7350,7300,154,146,65371496,182,71,D RL,2,2,1,1,3,3,2,4,2,2,2,10,13,14,9,14,13,12,10,13,14,14,12,15,13,13,14,13,11,12,13,13,15,14,12,15,13,14,15,14,13,14,12,10,14,15,20,15,15,12,10,14,9,13,10,15,13,16,15,15,16,7,20,14,13,1,20,17,1,D RL,105,1,1,1,1,1,1,1,17,20,1,1,10,13,12,14,135266338,0,1,0,0,0,1,0,0,0,0,0,0,0,0,0,0,0,0,0,0,1,0,0,0,0,0,0,1,0,0,0,0,0,0,0,0,0,0,0,0,0,0,0,0,0,0,0,0,Djibril Sidibé,£20.70m ,28,182,Defender - Right-Back,right,AS Monaco,47,3,8,3847,35,3,9,2847,32,0,4,2543,28,0,5,2090,4,0,0,284,Ligue 1
19-06-17,18.3.4.28,Thomas Meunier,18043393,757,12-Sep-91,25,15,1,7,1,6250,7500,7250,147,145,29604326,190,82,D/WB RC,1,2,1,3,2,1,1,4,2,3,1,8,14,13,10,13,10,12,12,11,12,14,7,13,14,10,14,14,14,15,12,14,16,11,8,13,13,16,16,12,11,14,14,8,14,14,20,15,14,15,8,14,8,14,14,16,15,14,17,14,15,6,20,18,15,13,20,12,15,D/WB RC,113,1,1,10,12,10,13,10,1,20,14,15,12,15,1,18,0,0,0,0,0,0,0,0,0,0,0,0,0,0,0,0,0,0,0,0,0,0,0,0,0,0,0,0,0,0,0,0,0,0,0,0,0,0,0,0,0,0,0,0,0,0,0,0,0,Thomas Meunier,£13.50m ,29,190,Defender - Right-Back,right,Borussia Dortmund,36,2,7,2789,34,5,5,2308,31,5,7,2368,27,1,2,2135,8,0,0,612,Ligue 1
19-06-17,18.3.4.28,Somália,19081040,1651,28-Sep-88,28,0,0,0,0,3800,5750,6400,135,127,9411773,180,73,M/AM RC,1,1,1,1,2,2,2,1,3,2,3,6,10,12,10,7,5,11,5,10,11,10,12,9,11,10,12,14,11,10,9,10,14,10,5,10,9,13,13,16,14,13,11,5,13,18,20,13,12,12,8,7,7,12,14,13,11,14,14,12,16,7,15,15,20,18,18,13,20,M/AM RC,413,1,1,10,15,13,18,1,7,15,15,20,13,15,1,15,0,0,0,0,0,0,0,0,0,0,0,0,0,0,0,0,0,0,0,0,0,0,0,0,0,0,0,0,0,0,0,0,0,0,0,0,0,0,0,0,0,0,0,0,0,0,0,0,0,Somália,£1.80m ,32,181,Midfielder - Central Midfield,both,Ferencvárosi TC,31,0,1,2111,31,2,0,2352,17,1,1,1016,12,0,0,789,10,1,2,646,Ligue 1
19-06-17,18.3.4.28,Marquinhos,19163495,1651,14-May-94,23,19,0,0,0,7000,8000,7800,175,156,172709061,183,72,D RC,1,3,3,1,1,2,2,2,1,3,1,4,11,10,8,14,4,15,10,7,15,13,8,16,14,14,15,15,15,16,12,15,18,10,12,8,16,17,15,14,13,16,13,10,14,15,20,15,13,16,8,15,8,15,15,15,12,14,17,15,16,7,20,1,1,1,15,1,20,D RC,103,1,1,1,1,1,1,20,1,15,10,1,1,1,1,1,8589967360,0,0,0,0,0,0,0,0,0,0,0,0,0,0,0,1,0,0,0,0,0,0,0,0,0,0,0,0,0,0,0,0,0,1,0,0,0,0,0,0,0,0,0,0,0,0,0,0,Marquinhos,£49.50m ,26,183,Defender - Centre-Back,right,Paris Saint-Germain,44,4,0,3849,41,2,3,3613,44,4,2,3861,37,6,1,3043,5,1,0,433,Ligue 1
19-06-17,18.3.4.28,Rafael,2107500,1651,09-Jul-90,26,2,0,6,1,5750,6500,6950,148,139,29243991,172,74,D/WB R,1,1,1,3,1,3,1,3,3,1,3,6,14,13,7,13,6,10,7,11,11,13,6,12,14,16,14,15,10,10,11,12,17,13,11,14,10,15,15,16,16,13,8,10,13,16,20,13,11,12,14,14,12,12,15,17,15,14,16,10,12,5,20,20,12,1,20,13,1,D/WB R,112,1,1,1,1,1,1,1,13,20,1,1,1,12,13,20,1.37439E+11,0,1,0,0,0,1,0,0,0,0,0,0,0,0,0,0,0,0,0,0,0,0,0,0,0,0,0,0,0,0,0,0,0,0,0,0,0,1,0,0,0,0,0,0,0,0,0,0,Rafael,£720Th. ,30,186,Goalkeeper,right,Reading FC,2,2,0,180,0,0,0,0,4,3,2,390,46,56,13,4170,7,1,6,630,Serie A
19-06-17,18.3.4.28,Mehdi Zeffane,29114944,5,19-May-92,25,11,0,0,0,3000,5450,5450,119,109,25215,176,71,D R,1,2,2,3,3,3,2,2,2,1,1,5,12,10,6,11,5,6,9,11,8,9,6,11,12,12,11,11,9,10,8,10,12,9,8,12,10,12,13,16,13,12,8,10,16,14,20,15,10,13,12,8,5,15,19,13,12,10,10,14,14,10,20,15,7,10,20,12,1,D R,102,1,1,1,1,10,10,1,12,20,1,1,7,7,12,15,2,0,1,0,0,0,0,0,0,0,0,0,0,0,0,0,0,0,0,0,0,0,0,0,0,0,0,0,0,0,0,0,0,0,0,0,0,0,0,0,0,0,0,0,0,0,0,0,0,Mehdi Zeffane,£900Th. ,28,176,Defender - Right-Back,right,Krylya Sovetov Samara,2,0,0,165,15,0,1,988,31,1,3,2110,6,0,0,489,13,0,1,891,Ligue 1
19-06-17,18.3.4.28,Hamari Traoré,30035411,31,27-Jan-92,25,10,0,0,0,3800,6300,6300,129,126,6301369,174,59,D R,1,2,2,3,2,2,3,3,3,1,1,10,13,12,8,11,8,12,8,15,13,12,10,13,12,15,13,13,11,12,10,12,12,12,7,13,11,13,14,15,13,12,8,10,16,15,20,15,8,12,13,12,5,13,14,10,10,13,14,13,19,8,20,15,10,10,20,1,1,D R,102,1,1,1,1,1,10,1,1,20,1,1,1,10,1,15,2.2518E+15,0,0,0,1,0,0,0,0,0,0,0,0,0,0,0,0,0,0,0,0,0,0,0,0,0,0,0,0,0,0,0,0,0,0,0,0,0,0,0,0,0,0,0,0,0,0,0,0,Hamari Traoré,£5.40m ,28,175,Defender - Right-Back,right,Stade Rennais FC,32,2,2,2779,33,0,2,2910,49,0,2,4294,37,1,5,3327,7,0,1,619,Ligue 1
19-06-17,18.3.4.28,Daniel Alves,315542,1651,06-May-83,34,99,7,0,0,7750,8300,8050,174,161,232186002,172,70,D/WB/M R,3,1,4,2,2,2,1,1,2,2,2,14,17,14,12,16,14,9,14,12,13,16,14,15,16,17,14,17,15,13,15,14,20,15,15,17,13,15,17,15,14,14,7,10,18,14,20,15,10,16,14,18,9,14,18,20,11,20,15,8,8,17,20,19,17,10,20,8,6,D/WB/M R,122,1,1,1,1,1,10,6,7,20,1,1,5,17,8,19,1.23695E+12,0,1,0,0,0,1,0,0,0,1,0,0,0,0,0,0,0,0,0,0,0,0,0,0,0,0,0,0,0,0,0,0,0,0,0,0,0,1,0,0,1,0,0,0,0,0,0,0,Dani Alves,£3.60m ,37,172,Defender - Right-Back,right,São Paulo Futebol Clube,33,6,7,2543,41,5,10,3263,52,5,11,4003,27,5,1,2425,nan,nan,nan,nan,Ligue 1
19-06-17,18.3.4.28,Oualid El Hajjam,34002344,769,19-Feb-91,26,0,0,0,0,3500,6250,6250,128,125,6346937,181,76,D/DM/M RC,1,2,2,4,2,3,2,2,2,3,1,6,14,13,6,11,6,11,10,10,13,13,6,13,12,12,13,13,11,12,10,12,16,11,8,13,14,12,15,15,11,14,12,6,14,12,20,14,12,15,8,8,6,14,10,13,15,14,14,15,15,6,20,15,17,1,20,13,15,D/DM/M RC,123,1,1,1,1,1,1,10,13,20,17,15,1,17,13,15,32,0,0,0,0,0,1,0,0,0,0,0,0,0,0,0,0,0,0,0,0,0,0,0,0,0,0,0,0,0,0,0,0,0,0,0,0,0,0,0,0,0,0,0,0,0,0,0,0,Oualid El Hajjam,£900Th. ,29,181,Defender - Right-Back,right,ES Troyes AC,28,1,2,2435,29,1,1,2385,15,0,0,904,23,1,1,1907,7,0,0,513,Ligue 1
19-06-17,18.3.4.28,Vincent Manceau,34011263,769,24-Jul-89,27,0,0,0,0,3800,6250,6250,125,125,5675627,175,69,D/DM RC,1,2,2,2,2,2,4,1,1,2,2,6,12,10,5,11,6,10,10,10,13,12,9,13,12,13,13,14,12,13,12,11,15,11,13,10,13,14,14,15,13,12,7,9,13,13,20,14,11,13,12,12,10,15,8,13,18,12,8,8,14,3,20,15,15,1,20,12,15,D/DM RC,113,1,1,1,1,1,1,1,12,20,17,15,1,12,1,15,0,0,0,0,0,0,0,0,0,0,0,0,0,0,0,0,0,0,0,0,0,0,0,0,0,0,0,0,0,0,0,0,0,0,0,0,0,0,0,0,0,0,0,0,0,0,0,0,0,Vincent Manceau,£1.80m ,31,176,Defender - Right-Back,right,SCO Angers,38,1,0,3315,35,0,0,3150,33,1,1,3000,24,0,0,2165,3,0,0,147,Ligue 1
19-06-17,18.3.4.28,Junior Sambia,36515152,769,07-Sep-96,20,0,0,0,0,3600,5600,5600,114,112,2785844,181,68,D/DM RL,2,2,3,1,1,3,4,3,3,3,3,8,12,14,9,11,14,9,11,6,10,12,9,12,12,12,11,7,10,11,12,9,4,13,7,11,12,13,14,13,13,14,10,12,15,14,20,14,11,10,12,8,11,14,12,12,10,12,9,11,20,1,20,1,1,1,20,17,1,D/DM RL,115,1,1,1,1,1,1,1,17,20,20,1,1,1,1,1,0,0,0,0,0,0,0,0,0,0,0,0,0,0,0,0,0,0,0,0,0,0,0,0,0,0,0,0,0,0,0,0,0,0,0,0,0,0,0,0,0,0,0,0,0,0,0,0,0,Junior Sambia,£2.25m ,24,185,Midfielder - Defensive Midfield,right,Montpellier HSC,41,4,3,3610,38,3,7,2411,32,0,1,1079,22,1,1,912,7,0,1,170,Ligue 1
19-06-17,18.3.4.28,Kenny Tete,37039829,784,09-Oct-95,21,6,0,0,0,5250,6500,6850,155,137,41362585,180,73,D/WB R,3,2,2,3,2,1,3,2,1,2,1,7,11,10,5,12,5,12,7,11,15,12,6,18,12,15,11,15,12,11,10,13,14,9,7,12,14,14,14,14,13,15,12,10,14,14,20,15,14,14,10,15,5,14,13,12,12,11,12,4,8,10,20,20,1,1,20,12,14,D/WB R,112,1,1,1,1,1,1,14,12,20,1,1,1,1,12,20,1.37439E+11,0,0,0,0,0,0,0,0,0,0,0,0,0,0,0,0,0,0,0,0,0,0,0,0,0,0,0,0,0,0,0,0,0,0,0,0,0,1,0,0,0,0,0,0,0,0,0,0,Kenny Tete,£7.20m ,25,180,Defender - Right-Back,right,Fulham FC,23,3,2,1907,31,1,5,2406,22,0,3,1725,28,0,1,1654,4,0,2,229,Ligue 1
19-06-17,18.3.4.28,Benjamin Angoua,38001740,24,28-Nov-86,30,17,1,4,0,3950,5550,5900,121,118,1883934,183,73,D RC,1,1,1,1,1,1,1,1,1,1,1,4,8,6,6,8,5,14,7,10,15,7,6,14,8,14,12,16,10,12,10,11,13,9,8,8,12,15,14,11,12,14,11,10,13,14,20,15,14,14,13,13,8,12,14,12,13,13,14,11,11,7,20,14,7,1,15,13,20,D RC,103,1,1,1,1,1,1,20,13,15,14,7,1,1,12,14,32832,0,0,0,0,0,0,1,0,0,0,0,0,0,0,0,1,0,0,0,0,0,0,0,0,0,0,0,0,0,0,0,0,0,0,0,0,0,0,0,0,0,0,0,0,0,0,0,0,Benjamin Angoua,£900Th. ,33,183,Defender - Centre-Back,right,Stade Briochin,39,1,2,3434,nan,nan,nan,nan,7,0,0,532,17,1,0,1487,9,1,0,810,Ligue 1
19-06-17,18.3.4.28,Abdoulaye Bamba,43013866,24,25-Apr-90,27,0,0,0,0,3250,5500,5600,115,112,451423,182,68,D/WB R,2,1,2,2,2,4,4,2,2,1,1,7,12,9,5,10,6,12,7,15,12,9,6,12,10,11,13,12,11,10,9,9,13,7,6,10,10,14,15,16,13,13,11,5,15,15,20,14,10,12,10,13,7,12,12,13,12,15,12,14,14,7,20,18,10,1,20,14,1,D/WB R,112,1,1,1,1,1,1,1,14,20,1,1,1,10,1,18,8,0,0,0,1,0,0,0,0,0,0,0,0,0,0,0,0,0,0,0,0,0,0,0,0,0,0,0,0,0,0,0,0,0,0,0,0,0,0,0,0,0,0,0,0,0,0,0,0,Abdoulaye Bamba,£900Th. ,30,182,Defender - Right-Back,right,SCO Angers,12,0,2,791,21,0,0,1803,30,0,4,2574,11,0,1,943,7,0,0,572,Ligue 1
19-06-17,18.3.4.28,Hiroki Sakai,45015208,116,12-Apr-90,27,36,0,0,0,5250,6600,6600,134,132,10376373,183,70,D/WB R,1,3,2,3,3,3,2,3,1,3,2,9,12,12,8,12,8,10,13,14,10,12,7,14,11,14,11,15,11,14,9,12,16,10,9,12,10,13,16,14,12,12,12,10,16,15,20,16,13,16,10,14,6,15,12,15,15,10,17,13,14,4,20,19,13,12,20,10,13,D/WB R,112,1,1,1,1,1,12,13,10,20,1,1,1,13,10,19,134217728,0,0,0,0,0,0,0,0,0,0,0,0,0,0,0,0,0,0,0,0,0,0,0,0,0,0,0,1,0,0,0,0,0,0,0,0,0,0,0,0,0,0,0,0,0,0,0,0,Hiroki Sakai,£5.40m ,30,183,Defender - Right-Back,right,Olympique Marseille,40,0,3,3422,50,1,4,3950,32,1,5,2808,25,0,0,1959,9,0,1,799,Ligue 1
19-06-17,18.3.4.28,Kelvin Amian,48031443,769,08-Feb-98,19,0,0,2,0,2001,5004,5000,144,112,899166,180,78,D RC,4,1,3,2,3,3,1,4,1,1,3,8,11,9,7,13,3,11,10,13,13,11,5,13,11,12,13,11,13,12,12,13,11,1,7,11,12,12,12,13,13,13,9,6,16,13,20,13,12,13,4,12,5,10,12,8,10,11,12,13,15,3,20,1,1,1,20,14,18,D RC,103,1,1,1,1,1,1,18,14,20,11,1,1,1,1,1,0,0,0,0,0,0,0,0,0,0,0,0,0,0,0,0,0,0,0,0,0,0,0,0,0,0,0,0,0,0,0,0,0,0,0,0,0,0,0,0,0,0,0,0,0,0,0,0,0,Kelvin Amian,£4.50m ,22,180,Defender - Right-Back,right,FC Toulouse,24,0,0,2015,40,1,1,3514,34,0,1,3002,22,0,2,1810,8,1,0,720,Ligue 1
19-06-17,18.3.4.28,Nordi Mukiele,48034615,769,01-Nov-97,19,0,0,0,0,3600,6200,6200,136,124,11802666,185,74,D RC,2,4,2,1,4,1,3,3,3,2,1,8,10,8,6,11,6,13,5,11,15,12,9,14,10,12,13,14,11,13,10,11,12,8,8,10,13,14,15,13,14,15,12,6,14,14,20,14,13,13,7,13,5,12,19,13,12,12,13,13,15,7,20,1,1,1,19,1,20,D RC,103,1,1,1,1,1,1,20,1,19,13,1,1,1,1,1,0,0,0,0,0,0,0,0,0,0,0,0,0,0,0,0,0,0,0,0,0,0,0,0,0,0,0,0,0,0,0,0,0,0,0,0,0,0,0,0,0,0,0,0,0,0,0,0,0,Nordi Mukiele,£12.60m ,22,187,Defender - Right-Back,right,RB Leipzig,37,0,1,3273,39,0,1,3321,31,1,1,1901,37,3,3,2659,6,0,0,429,Ligue 1
19-06-17,18.3.4.28,Alexander Djiku,48036760,769,09-Dec-94,22,0,0,0,0,3800,6250,6250,131,125,4846362,182,74,D RC,1,1,1,3,1,3,2,3,1,2,3,7,11,10,7,11,7,13,7,11,14,12,8,13,12,15,12,15,13,14,8,12,13,10,9,10,13,13,14,13,12,15,11,10,14,12,20,14,14,12,12,11,7,11,10,14,14,12,13,12,14,7,20,1,1,1,15,1,20,D RC,103,1,1,1,1,1,1,20,1,15,13,1,1,1,1,1,0,0,0,0,0,0,0,0,0,0,0,0,0,0,0,0,0,0,0,0,0,0,0,0,0,0,0,0,0,0,0,0,0,0,0,0,0,0,0,0,0,0,0,0,0,0,0,0,0,Alexander Djiku,£7.20m ,26,182,Defender - Centre-Back,right,RC Strasbourg Alsace,24,1,0,1939,33,0,0,3000,35,1,0,3137,33,2,1,2737,7,0,0,506,Ligue 1
19-06-17,18.3.4.28,Patrick Burner,48036808,769,11-Apr-96,21,0,0,0,0,2250,5000,5000,129,100,613692,170,65,D R,3,2,1,1,2,1,1,3,2,2,2,6,10,10,6,11,3,11,10,10,9,10,6,11,12,10,9,9,10,12,10,9,4,8,6,12,9,13,14,14,14,12,7,8,12,13,20,13,8,10,9,10,10,10,13,10,11,9,10,12,16,1,20,13,12,10,20,1,1,D R,102,1,1,1,1,1,10,1,1,20,1,1,1,12,1,13,0,0,0,0,0,0,0,0,0,0,0,0,0,0,0,0,0,0,0,0,0,0,0,0,0,0,0,0,0,0,0,0,0,0,0,0,0,0,0,0,0,0,0,0,0,0,0,0,0,Patrick Burner,£1.80m ,24,170,Defender - Right-Back,right,Nîmes Olympique,7,0,0,447,23,0,0,1527,21,0,0,1702,22,1,1,1612,5,0,0,293,Ligue 1
19-06-17,18.3.4.28,Aloďs Confais,48037139,769,07-Sep-96,20,0,0,0,0,3250,5800,5800,131,116,5070967,174,61,D/DM/M RC,3,1,3,3,1,2,2,1,1,2,1,10,11,12,9,12,8,9,10,8,11,13,9,10,12,10,12,13,12,13,13,12,12,11,9,12,13,14,13,12,13,10,10,11,13,12,20,12,11,12,9,12,8,14,10,11,10,10,12,11,12,4,17,10,20,1,17,1,20,D/DM/M RC,433,1,1,1,1,1,1,1,1,17,18,20,1,1,1,10,0,0,0,0,0,0,0,0,0,0,0,0,0,0,0,0,0,0,0,0,0,0,0,0,0,0,0,0,0,0,0,0,0,0,0,0,0,0,0,0,0,0,0,0,0,0,0,0,0,Aloïs Confais,£810Th. ,24,174,Midfielder - Defensive Midfield,right,Nea Salamina Famagusta,34,1,0,2299,19,0,0,834,29,1,0,2238,26,1,0,1892,4,0,0,305,Ligue 1
19-06-17,18.3.4.28,Ronaël Pierre-Gabriel,48038032,769,03-Jun-98,19,0,0,0,0,2250,5000,5000,126,100,838712,177,0,D R,1,4,4,2,1,3,2,3,4,4,1,7,10,12,7,11,7,10,8,10,10,10,6,12,11,7,11,11,10,9,10,10,12,9,6,12,9,13,14,15,13,12,8,5,10,13,20,12,10,10,10,10,10,10,13,12,12,11,13,10,16,8,20,1,1,1,20,12,1,D R,102,1,1,1,1,1,1,1,12,20,1,1,1,1,1,1,2,0,1,0,0,0,0,0,0,0,0,0,0,0,0,0,0,0,0,0,0,0,0,0,0,0,0,0,0,0,0,0,0,0,0,0,0,0,0,0,0,0,0,0,0,0,0,0,0,Ronaël Pierre-Gabriel,£3.60m ,22,177,Defender - Right-Back,right,Stade Brest 29,14,0,0,963,17,0,0,1260,5,0,0,416,8,0,1,578,5,0,0,381,Ligue 1
19-06-17,18.3.4.28,Clément Michelin,48042718,769,11-May-97,20,0,0,0,0,3000,5150,5150,117,103,1066063,178,63,D/WB RL,3,3,2,1,3,2,1,2,1,1,2,10,14,10,6,14,7,10,6,17,8,11,3,12,11,10,12,12,8,11,10,11,6,8,6,13,10,12,11,12,15,10,7,5,11,15,20,12,7,10,10,10,8,10,16,13,15,11,10,12,14,7,20,17,13,1,20,15,10,D/WB RL,115,1,1,1,1,1,1,10,15,20,1,1,1,13,1,17,0,0,0,0,0,0,0,0,0,0,0,0,0,0,0,0,0,0,0,0,0,0,0,0,0,0,0,0,0,0,0,0,0,0,0,0,0,0,0,0,0,0,0,0,0,0,0,0,0,Clément Michelin,£1.13m ,23,178,Defender - Right-Back,right,RC Lens,10,0,0,721,10,0,0,346,15,0,0,901,26,1,3,2238,4,0,0,217,Ligue 1
19-06-17,18.3.4.28,Valentin Rosier,50047466,769,19-Aug-96,20,0,0,0,0,3500,6000,6000,129,120,5261792,175,70,D R,1,1,1,3,3,3,2,1,2,1,2,8,12,14,10,13,5,9,10,10,14,14,4,13,12,8,12,10,10,12,14,14,11,13,7,14,12,15,14,14,13,12,7,8,14,13,20,12,11,13,10,16,5,14,9,12,12,9,13,12,14,7,20,10,1,1,20,12,1,D R,102,1,1,1,1,1,1,1,12,20,1,1,1,1,1,10,0,0,0,0,0,0,0,0,0,0,0,0,0,0,0,0,0,0,0,0,0,0,0,0,0,0,0,0,0,0,0,0,0,0,0,0,0,0,0,0,0,0,0,0,0,0,0,0,0,Valentin Rosier,£4.05m ,24,175,Defender - Right-Back,right,Besiktas JK,4,0,0,360,37,0,3,2914,19,0,4,1537,17,0,0,1419,1,0,1,90,Ligue 1
19-06-17,18.3.4.28,Edgar Ié,55060508,788,01-May-94,23,0,0,3,1,3700,5750,6200,129,124,7887635,180,80,D RC,2,2,1,3,1,1,3,2,1,2,2,7,9,10,6,11,8,13,8,10,12,10,9,14,12,13,12,11,11,12,8,11,11,9,9,9,12,13,12,14,15,10,10,10,12,13,20,14,13,13,12,10,10,16,14,15,10,12,12,11,11,6,20,10,1,1,16,13,20,D RC,103,1,11,1,1,1,1,20,13,16,9,1,1,1,8,10,4294967296,0,0,0,0,0,0,0,0,0,0,0,0,0,0,0,0,0,0,0,0,0,0,0,0,0,0,0,0,0,0,0,0,1,0,0,0,0,0,0,0,0,0,0,0,0,0,0,0,Edgar Ié,£2.70m ,26,182,Defender - Centre-Back,right,Trabzonspor,26,0,0,2111,37,1,1,3342,21,0,0,1380,21,0,0,1661,6,0,0,399,Ligue 1
19-06-17,18.3.4.28,Milan Gajic,62124118,802,28-Jan-96,21,0,0,18,1,3950,5950,5950,140,119,4078901,178,74,D R,2,2,1,2,2,3,3,1,3,3,2,11,12,11,9,12,11,10,13,9,13,11,9,13,13,12,10,12,13,14,10,11,14,12,11,11,11,15,14,13,13,13,12,8,12,12,20,14,11,14,10,14,9,16,12,13,13,14,13,12,13,9,20,15,8,8,20,13,5,D R,102,1,1,1,1,1,8,1,13,20,8,5,1,8,10,15,800,0,0,0,0,0,1,0,0,1,1,0,0,0,0,0,0,0,0,0,0,0,0,0,0,0,0,0,0,0,0,0,0,0,0,0,0,0,0,0,0,0,0,0,0,0,0,0,0,Milan Gajic,£1.58m ,24,178,Defender - Right-Back,both,Red Star Belgrade,21,0,0,1764,5,0,1,450,14,1,4,1149,16,1,4,1237,15,0,2,923,Ligue 1
19-06-17,18.3.4.28,Iván Balliu,67053461,752,01-Jan-92,25,0,0,0,0,4000,6200,6200,130,123,5027669,175,68,D/WB R,1,1,3,4,2,1,3,3,2,3,1,8,12,11,7,13,8,9,11,13,10,13,7,12,14,12,11,14,12,11,12,12,14,6,8,13,12,14,14,14,13,10,6,12,14,13,20,15,10,12,6,12,5,15,15,13,10,13,14,15,13,4,20,17,7,1,20,10,1,D/WB R,112,1,1,1,1,1,1,1,10,20,1,1,1,7,7,17,1048584,0,0,0,1,0,0,0,0,0,0,0,0,0,0,0,0,0,0,0,0,1,0,0,0,0,0,0,0,0,0,0,0,0,0,0,0,0,0,0,0,0,0,0,0,0,0,0,0,Iván Balliu,£900Th. ,28,172,Defender - Right-Back,right,UD Almería,30,0,5,2644,28,0,1,2278,32,1,1,2496,32,1,4,2444,6,0,0,540,Ligue 1
19-06-17,18.3.4.28,Vincent Rüfli,69004837,798,22-Jan-88,29,1,0,0,0,3250,5500,5700,120,114,1017416,183,76,D RL,1,3,2,2,1,3,2,2,2,2,3,12,13,10,6,12,7,9,11,12,10,11,4,13,11,16,11,13,11,12,10,11,5,6,11,10,12,14,14,12,10,12,9,16,11,13,20,14,12,12,10,12,6,10,12,10,10,11,12,7,8,14,20,14,14,9,20,15,13,D RL,105,1,1,1,1,1,9,13,15,20,1,1,1,14,1,14,0,0,0,0,0,0,0,0,0,0,0,0,0,0,0,0,0,0,0,0,0,0,0,0,0,0,0,0,0,0,0,0,0,0,0,0,0,0,0,0,0,0,0,0,0,0,0,0,0,Vincent Rüfli,£810Th. ,32,183,Defender - Right-Back,right,FC St. Gallen 1879,20,0,3,1538,3,0,0,22,17,1,1,1345,18,1,0,697,4,0,0,87,Ligue 1
19-06-17,18.3.4.28,Andrea Raggi,837002,776,24-Jun-84,32,0,0,3,0,5750,6500,6600,136,132,4268860,187,82,D RLC,2,3,3,3,1,1,3,3,2,1,3,5,11,8,7,10,6,15,9,14,15,10,8,16,9,16,14,17,12,15,8,12,17,9,17,11,13,15,13,11,11,16,14,6,13,12,20,13,15,13,14,15,8,14,14,14,16,16,16,12,11,7,20,10,1,1,17,16,20,D RLC,106,1,1,1,1,1,1,20,16,17,1,1,1,1,9,10,5.62967E+14,0,0,0,0,0,0,1,0,0,0,0,0,0,0,0,1,0,1,0,0,0,0,0,0,0,0,0,0,0,0,0,0,0,0,1,0,0,0,0,0,0,0,0,0,0,0,0,0,Andrea Raggi,£450Th. ,36,187,Defender - Centre-Back,right,Without Club,37,0,2,2611,28,1,0,2300,11,0,0,945,nan,nan,nan,nan,nan,nan,nan,nan,Ligue 1
19-06-17,18.3.4.28,Christophe Jallet,8427430,769,31-Oct-83,33,14,1,0,0,3900,6350,6350,141,127,232186002,176,70,D/WB RL,3,1,4,3,3,3,1,3,1,3,2,8,12,10,7,11,8,12,10,12,11,12,12,14,12,10,14,15,14,14,10,13,17,8,10,12,12,15,14,12,12,15,10,9,14,13,20,14,12,15,9,13,8,14,11,15,15,16,17,17,16,5,20,19,1,1,20,16,1,D/WB RL,115,1,1,1,1,1,1,1,16,20,1,1,1,1,15,19,1.37439E+11,0,1,0,0,0,0,0,0,0,0,0,0,0,0,0,0,0,0,0,0,0,0,0,0,0,0,0,0,0,0,0,0,0,0,0,0,0,1,0,0,0,0,0,0,0,0,0,0,Christophe Jallet,£450Th. ,36,178,Defender - Right-Back,right,Retired,22,1,5,1778,22,0,0,1801,17,1,0,1185,13,1,2,945,nan,nan,nan,nan,Ligue 1
19-06-17,18.3.4.28,Romain Danzé,8428673,769,03-Jul-86,30,0,0,4,0,3800,6350,6350,133,127,232186002,184,72,D/WB R,1,1,3,3,1,1,3,3,1,2,1,8,13,10,6,11,7,12,8,10,12,11,9,13,11,9,14,14,11,15,10,12,16,9,14,12,14,15,16,12,12,14,12,8,13,13,20,16,12,14,9,16,8,15,7,14,18,14,16,16,16,5,20,17,13,10,20,12,1,D/WB R,112,1,1,1,1,1,10,1,12,20,12,1,8,13,10,17,32,0,0,0,0,0,1,0,0,0,0,0,0,0,0,0,0,0,0,0,0,0,0,0,0,0,0,0,0,0,0,0,0,0,0,0,0,0,0,0,0,0,0,0,0,0,0,0,0,Romain Danzé,£675Th. ,34,184,Defender - Right-Back,right,Retired,36,0,2,3181,16,0,0,1042,0,0,0,0,nan,nan,nan,nan,nan,nan,nan,nan,Ligue 1
19-06-17,18.3.4.28,Issa Cissokho,8431681,41,23-Feb-85,32,5,0,0,0,3000,5900,5900,125,118,232186002,173,73,D/WB RL,2,1,3,1,4,3,1,1,1,3,1,7,13,9,6,11,10,6,8,11,12,13,8,13,11,11,12,13,10,12,8,8,16,11,6,12,8,12,14,14,13,12,7,8,15,14,20,14,14,12,11,13,8,16,10,13,14,12,14,16,16,6,20,17,15,14,20,15,1,D/WB RL,115,1,1,8,1,14,14,1,15,20,1,1,14,15,15,17,2.2518E+15,0,0,0,1,0,0,0,0,0,0,0,0,0,0,0,0,0,0,0,0,0,0,0,0,0,0,0,0,0,0,0,0,0,0,0,0,0,0,0,0,0,0,0,0,0,0,0,0,Issa Cissokho,£450Th. ,35,173,Defender - Right-Back,right,Without Club,15,0,2,1339,22,0,0,1792,26,1,1,2128,5,0,0,428,nan,nan,nan,nan,Ligue 1
19-06-17,18.3.4.28,Jonathan Martins Pereira,8434189,769,30-Jan-86,31,0,0,0,0,3700,6050,6050,121,121,1993637,182,78,D R,1,3,3,3,3,1,3,1,4,2,2,5,12,12,7,13,7,13,7,12,12,11,6,13,13,14,13,15,11,12,9,11,14,11,9,10,11,13,15,14,13,14,11,8,12,13,20,14,14,13,14,14,13,8,12,13,13,12,14,11,11,7,20,12,1,1,20,7,1,D R,102,1,1,1,1,1,1,1,7,20,1,1,1,1,1,12,10,0,1,0,1,0,0,0,0,0,0,0,0,0,0,0,0,0,0,0,0,0,0,0,0,0,0,0,0,0,0,0,0,0,0,0,0,0,0,0,0,0,0,0,0,0,0,0,0,Jonathan Martins Pereira,£1.35m ,34,182,Defender - Right-Back,right,Retired,17,0,0,1268,14,0,0,1137,1,0,0,12,nan,nan,nan,nan,nan,nan,nan,nan,Ligue 1
19-06-17,18.3.4.28,Romain Genevois,8443040,375,28-Oct-87,29,10,0,1,0,3850,6250,6250,127,125,4846362,182,79,D RC,4,1,3,4,3,1,4,1,1,2,2,5,9,9,9,11,6,13,8,12,14,9,8,14,11,14,14,15,11,13,7,12,16,8,8,9,13,13,14,15,12,13,11,6,14,14,20,15,15,12,14,13,7,15,11,13,10,11,8,13,16,5,20,15,12,1,15,1,20,D RC,103,1,1,8,1,1,1,20,1,15,10,1,1,12,1,15,32,0,0,0,0,0,1,0,0,0,0,0,0,0,0,0,0,0,0,0,0,0,0,0,0,0,0,0,0,0,0,0,0,0,0,0,0,0,0,0,0,0,0,0,0,0,0,0,0,Romain Genevois,£1.80m ,32,182,Defender - Centre-Back,right,Without Club,16,0,0,1129,26,1,1,2024,6,0,0,358,nan,nan,nan,nan,nan,nan,nan,nan,Ligue 1
19-06-17,18.3.4.28,Paul Baysse,8448625,769,18-May-88,29,0,0,6,1,4500,6550,6550,144,131,10187001,185,82,D RC,1,2,2,2,3,1,2,3,4,3,2,4,12,7,7,11,6,15,9,13,14,13,6,14,11,15,14,17,13,14,11,13,13,7,12,8,14,16,15,12,12,8,13,8,12,11,20,14,15,13,6,15,10,8,12,15,12,12,13,14,14,5,20,10,1,1,16,8,20,D RC,103,1,1,1,1,1,1,20,8,16,1,1,1,1,8,10,0,0,0,0,0,0,0,0,0,0,0,0,0,0,0,0,0,0,0,0,0,0,0,0,0,0,0,0,0,0,0,0,0,0,0,0,0,0,0,0,0,0,0,0,0,0,0,0,0,Paul Baysse,£2.25m ,32,185,Defender - Centre-Back,right,FC Girondins Bordeaux,25,2,1,2126,24,1,0,1896,26,0,0,2273,0,0,0,0,7,0,0,512,LaLiga
19-06-17,18.3.4.28,Kévin Théophile-Catherine,8449438,769,28-Oct-89,27,0,0,1,0,3950,6300,6300,135,126,5265144,180,77,D RC,2,2,1,3,3,3,3,1,2,1,1,7,12,12,6,11,7,13,11,11,13,10,7,12,11,12,13,14,12,11,10,11,15,9,8,8,13,13,14,16,12,14,12,8,14,14,20,15,14,12,12,13,5,14,11,8,14,9,12,13,14,6,20,15,1,1,20,13,16,D RC,103,1,1,1,1,1,1,16,13,20,8,1,1,1,10,15,1.09951E+12,0,1,0,0,0,1,0,0,0,0,0,0,0,0,0,0,0,0,0,0,0,0,0,0,0,0,0,0,0,0,0,0,0,0,0,0,0,0,0,0,1,0,0,0,0,0,0,0,Kévin Théophile-Catherine,£3.60m ,30,183,Defender - Centre-Back,right,GNK Dinamo Zagreb,42,0,2,3719,27,0,1,2374,32,1,0,2898,26,1,2,2307,9,0,0,689,Ligue 1
19-06-17,18.3.4.28,Arnaud Souquet,85014379,769,12-Feb-92,25,0,0,2,0,4000,6400,6400,131,128,7574176,179,72,D/WB RC,2,1,2,3,3,1,3,3,2,3,4,12,13,12,7,13,12,6,10,6,9,14,10,10,13,9,12,12,13,14,12,13,17,10,9,14,10,15,14,14,14,12,7,8,14,13,20,14,11,14,12,13,7,15,14,14,13,13,15,14,15,7,20,19,15,12,20,1,15,D/WB RC,113,1,1,1,10,1,12,1,1,20,13,15,1,15,1,19,8.79609E+12,0,0,0,0,0,0,0,0,0,0,0,0,0,0,0,0,0,0,0,0,0,0,0,0,0,0,0,0,0,0,0,0,0,0,0,0,0,0,0,0,0,0,0,1,0,0,0,0,Arnaud Souquet,£4.05m ,28,179,Defender - Right-Back,right,Montpellier HSC,31,1,5,2768,39,1,4,3299,36,0,3,3090,28,2,2,2315,7,1,0,570,Ligue 1
19-06-17,18.3.4.28,Yoann Andreu,85016145,769,03-May-89,28,0,0,0,0,3800,6250,6250,125,125,5675627,175,64,D RL,1,1,3,4,1,1,2,2,1,2,1,7,13,9,6,12,6,12,10,10,14,13,6,13,12,14,13,13,12,12,10,12,14,7,9,11,12,13,15,14,13,15,11,10,12,12,20,14,12,12,12,13,10,10,20,12,14,13,14,15,15,6,20,15,1,1,20,16,1,D RL,105,1,1,1,1,1,1,1,16,20,10,1,1,1,15,15,0,0,0,0,0,0,0,0,0,0,0,0,0,0,0,0,0,0,0,0,0,0,0,0,0,0,0,0,0,0,0,0,0,0,0,0,0,0,0,0,0,0,0,0,0,0,0,0,0,Yoann Andreu,£1.58m ,31,178,Defender - Left-Back,right,Retired,17,0,1,1458,23,1,2,2070,2,0,0,123,nan,nan,nan,nan,nan,nan,nan,nan,Ligue 1
19-06-17,18.3.4.28,Dimitri Foulquier,85045661,769,23-Mar-93,24,0,0,8,0,3950,6150,6150,138,123,5061599,183,77,D RL,3,1,2,1,3,1,1,2,4,4,1,7,13,12,7,12,6,8,9,11,12,9,7,12,12,10,12,14,13,12,11,10,14,11,7,13,12,12,13,16,13,14,11,8,15,15,20,13,13,11,10,13,7,8,11,13,14,10,14,15,15,5,20,15,12,10,20,18,1,D RL,105,1,1,1,1,9,10,1,18,20,1,1,10,12,14,15,2.2518E+15,0,0,0,1,0,0,0,0,0,0,0,0,0,0,0,0,0,0,0,0,0,0,0,0,0,0,0,0,0,0,0,0,0,0,0,0,0,0,0,0,0,0,0,0,0,0,0,0,Dimitri Foulquier,£1.80m ,27,183,Defender - Right-Back,right,Granada CF,22,0,2,1868,19,0,2,1563,29,3,3,2093,27,1,0,1857,8,0,1,631,Ligue 1
19-06-17,18.3.4.28,Ruben Aguilar,85046582,769,26-Apr-93,24,0,0,0,0,3800,6350,6350,131,127,8574545,172,70,D/WB R,3,2,1,3,3,1,2,2,3,1,3,5,15,11,7,12,6,9,7,11,15,13,8,14,13,14,13,15,12,14,12,13,16,10,8,12,10,14,16,13,13,15,6,7,14,14,20,15,12,14,12,12,10,11,12,14,14,12,15,12,10,6,20,17,1,1,20,13,1,D/WB R,112,1,1,1,1,1,1,1,13,20,1,1,1,1,10,17,32,0,0,0,0,0,1,0,0,0,0,0,0,0,0,0,0,0,0,0,0,0,0,0,0,0,0,0,0,0,0,0,0,0,0,0,0,0,0,0,0,0,0,0,0,0,0,0,0,Ruben Aguilar,£5.40m ,27,172,Defender - Right-Back,right,AS Monaco,34,0,0,3073,38,0,2,3030,30,1,5,2622,23,1,4,1415,8,1,1,720,Ligue 1
19-06-17,18.3.4.28,Kenny Lala,85051366,769,03-Oct-91,25,0,0,0,0,3800,6400,6400,129,128,8470046,178,77,D/WB RC,2,2,2,1,3,3,3,1,3,3,3,5,13,11,7,12,6,12,8,12,10,11,13,12,12,12,12,14,13,12,11,12,15,10,10,13,11,14,15,14,12,15,10,7,16,15,20,16,14,14,11,13,5,8,18,15,12,13,13,12,14,6,20,16,1,1,20,13,15,D/WB RC,113,1,1,1,1,1,1,15,13,20,1,1,1,1,13,16,134217728,0,0,0,0,0,0,0,0,0,0,0,0,0,0,0,0,0,0,0,0,0,0,0,0,0,0,0,1,0,0,0,0,0,0,0,0,0,0,0,0,0,0,0,0,0,0,0,0,Kenny Lala,£4.50m ,29,178,Defender - Right-Back,right,RC Strasbourg Alsace,40,1,3,3600,37,3,6,3166,40,5,10,3460,33,2,1,2540,8,1,0,694,Ligue 1
19-06-17,18.3.4.28,Jonathan Rivierez,85055657,769,18-May-89,28,0,0,0,0,3600,5500,5500,116,109,847791,181,79,D/WB RC,2,2,3,1,3,3,1,3,1,4,3,5,12,10,5,10,6,11,7,8,12,9,7,12,11,13,13,14,13,12,9,9,13,9,7,8,13,13,13,15,12,13,10,5,13,13,20,15,14,14,13,5,6,10,10,13,13,13,14,14,14,5,20,16,1,1,20,10,17,D/WB RC,113,1,1,1,1,1,1,17,10,20,1,1,1,1,10,16,0,0,0,0,0,0,0,0,0,0,0,0,0,0,0,0,0,0,0,0,0,0,0,0,0,0,0,0,0,0,0,0,0,0,0,0,0,0,0,0,0,0,0,0,0,0,0,0,0,Jonathan Rivierez,£720Th. ,31,182,Defender - Centre-Back,right,SM Caen,18,0,1,1418,28,0,2,2271,20,0,0,1129,33,2,0,2924,8,0,0,720,Ligue 1
19-06-17,18.3.4.28,Youssouf Sabaly,85057304,41,05-Mar-93,24,0,0,0,0,4250,6500,6550,135,131,11897004,174,70,D/WB R,3,3,3,1,1,3,1,1,4,2,1,8,12,12,8,11,7,10,9,12,12,10,10,14,12,13,13,12,12,13,10,13,13,12,10,14,11,14,15,15,14,15,10,8,16,14,20,15,13,14,12,12,8,13,14,14,15,12,13,11,10,6,20,17,1,1,20,14,1,D/WB R,112,1,1,1,1,1,1,1,14,20,1,1,1,1,12,17,134217760,0,0,0,0,0,1,0,0,0,0,0,0,0,0,0,0,0,0,0,0,0,0,0,0,0,0,0,1,0,0,0,0,0,0,0,0,0,0,0,0,0,0,0,0,0,0,0,0,Youssouf Sabaly,£6.30m ,27,174,Defender - Right-Back,right,FC Girondins Bordeaux,33,0,5,2739,39,0,6,3406,31,0,3,2630,14,0,1,1067,8,0,0,711,Ligue 1
19-06-17,18.3.4.28,Jérémy Cordoval,85058781,769,12-Jan-90,27,0,0,0,0,2750,5500,5500,111,110,852722,167,67,D RL,1,3,1,2,2,3,1,3,3,1,3,7,11,11,5,12,6,6,7,10,12,12,6,12,13,11,11,10,12,12,9,11,13,7,5,8,11,13,13,15,14,10,6,7,15,15,20,14,8,12,8,13,7,10,10,13,13,14,14,16,16,6,20,15,12,1,20,15,1,D RL,105,1,1,1,1,1,1,1,15,20,10,1,1,12,15,15,0,0,0,0,0,0,0,0,0,0,0,0,0,0,0,0,0,0,0,0,0,0,0,0,0,0,0,0,0,0,0,0,0,0,0,0,0,0,0,0,0,0,0,0,0,0,0,0,0,Jérémy Cordoval,£900Th. ,30,169,Defender - Right-Back,right,LB Châteauroux,32,0,1,2456,13,0,1,1098,30,1,0,2329,16,0,1,1237,5,0,0,349,Ligue 1
19-06-17,18.3.4.28,Kévin Malcuit,85067228,769,31-Jul-91,25,0,0,0,0,4100,6550,6550,134,132,9677020,181,73,D/WB/M R,4,3,1,2,3,1,2,2,3,2,2,6,13,13,9,12,6,9,9,5,11,12,9,12,12,13,13,14,12,12,8,12,14,13,6,14,10,13,15,15,13,14,12,6,14,16,20,15,14,14,9,13,12,12,13,15,12,12,13,15,15,8,20,18,16,15,20,1,1,D/WB/M R,122,1,1,1,1,1,15,1,1,20,1,1,1,16,1,18,2.2518E+15,0,0,0,1,0,0,0,0,0,0,0,0,0,0,0,0,0,0,0,0,0,0,0,0,0,0,0,0,0,0,0,0,0,0,0,0,0,0,0,0,0,0,0,0,0,0,0,0,Kévin Malcuit,£6.75m ,29,178,Defender - Right-Back,right,SSC Napoli,34,0,4,2935,25,0,5,1932,27,0,3,1992,6,0,1,403,1,0,0,15,Ligue 1
19-06-17,18.3.4.28,Jordan Ikoko,85072032,53,03-Feb-94,23,4,0,0,0,3900,6150,6150,131,123,6548254,177,60,D R,1,3,1,1,3,1,3,1,2,2,4,6,12,12,8,13,7,8,10,10,11,11,8,13,12,11,12,12,11,12,10,12,13,6,7,13,9,13,15,16,14,14,9,8,14,14,20,15,12,12,8,13,6,14,12,13,14,13,15,14,15,6,20,15,1,1,20,10,1,D R,102,1,1,1,1,1,1,1,10,20,1,1,1,1,7,15,1048578,0,1,0,0,0,0,0,0,0,0,0,0,0,0,0,0,0,0,0,0,1,0,0,0,0,0,0,0,0,0,0,0,0,0,0,0,0,0,0,0,0,0,0,0,0,0,0,0,Jordan Ikoko,£1.35m ,26,178,Defender - Right-Back,right,PFK Ludogorets Razgrad,32,0,1,2672,30,0,3,2598,21,0,0,1737,23,2,1,1660,2,0,0,6,Ligue 1
19-06-17,18.3.4.28,Bouna Sarr,85072773,22,31-Jan-92,25,0,0,0,0,3800,6300,6300,127,126,7413376,177,65,D/AM RL,4,1,3,2,2,3,4,2,2,1,2,8,11,13,10,13,8,10,11,7,5,12,13,8,13,8,11,9,10,9,9,10,12,12,5,13,8,7,10,16,15,12,8,10,15,15,20,14,11,12,8,13,7,12,10,14,13,13,9,9,11,10,16,1,10,20,20,15,12,D/AM RL,525,1,1,1,12,15,20,1,1,16,8,10,10,10,1,1,2.25183E+15,0,0,0,0,0,0,0,0,0,0,0,0,0,0,0,0,0,0,0,0,0,0,0,0,0,0,0,0,0,0,0,0,0,0,0,1,0,0,0,0,0,0,0,0,0,0,0,0,Bouna Sarr,£5.40m ,28,177,Defender - Right-Back,right,Bayern Munich,29,1,2,1270,48,1,4,3109,37,1,1,2654,32,2,3,2535,5,0,3,271,Ligue 1
19-06-17,18.3.4.28,Christophe Hérelle,85076637,769,22-Aug-92,24,0,0,0,0,3500,6250,6250,129,125,6720288,188,75,D/DM RC,2,2,4,1,3,2,3,3,1,3,1,4,10,7,5,10,7,13,10,5,14,11,6,14,13,14,14,15,12,12,8,13,12,5,6,10,14,13,14,13,13,15,14,5,15,12,20,14,14,12,10,12,7,12,9,13,10,7,12,10,10,8,20,13,1,1,16,1,20,D/DM RC,113,1,1,1,1,1,1,20,1,16,16,1,1,1,1,13,0,0,0,0,0,0,0,0,0,0,0,0,0,0,0,0,0,0,0,0,0,0,0,0,0,0,0,0,0,0,0,0,0,0,0,0,0,0,0,0,0,0,0,0,0,0,0,0,0,Christophe Hérelle,£5.40m ,28,188,Defender - Centre-Back,right,Stade Brest 29,36,0,0,2829,35,0,0,3049,34,0,0,3028,18,3,0,1363,5,0,0,433,Ligue 1
19-06-17,18.3.4.28,Mathieu Deplagne,85077401,769,01-Oct-91,25,0,0,0,0,3750,6050,6050,127,121,3242331,183,78,D R,3,1,1,3,2,3,4,1,3,3,2,5,10,9,5,12,11,12,11,11,13,13,11,15,10,15,14,14,13,15,10,14,14,6,6,9,14,13,14,12,12,14,11,5,15,11,20,14,14,13,13,12,7,10,7,13,16,13,15,15,15,5,20,15,1,1,20,10,1,D R,102,1,1,5,1,1,1,1,10,20,1,1,1,1,10,15,32,0,0,0,0,0,1,0,0,0,0,0,0,0,0,0,0,0,0,0,0,0,0,0,0,0,0,0,0,0,0,0,0,0,0,0,0,0,0,0,0,0,0,0,0,0,0,0,0,Mathieu Deplagne,£1.13m ,29,183,Defender - Right-Back,right,FC Cincinnati,21,0,0,1288,31,0,2,2622,39,1,1,3448,16,0,0,1264,nan,nan,nan,nan,Ligue 1
19-06-17,18.3.4.28,Léo Dubois,85085148,769,14-Sep-94,22,0,0,0,0,3900,6550,6550,141,131,8989770,178,65,D/WB R,1,2,3,2,1,3,2,3,2,2,2,14,14,11,7,13,12,9,10,11,13,12,7,14,13,8,12,13,13,14,13,13,13,9,13,13,13,14,15,12,14,13,11,10,15,12,20,14,11,15,8,11,7,10,10,14,13,12,12,15,16,6,20,16,1,1,20,14,1,D/WB R,112,1,1,1,1,1,1,1,14,20,10,1,1,1,13,16,72,0,0,0,1,0,0,1,0,0,0,0,0,0,0,0,0,0,0,0,0,0,0,0,0,0,0,0,0,0,0,0,0,0,0,0,0,0,0,0,0,0,0,0,0,0,0,0,0,Léo Dubois,£9.00m ,26,178,Defender - Right-Back,right,Olympique Lyon,41,0,8,3478,35,4,5,3114,34,3,6,2642,28,0,2,2312,8,1,0,641,Ligue 1
19-06-17,18.3.4.28,Jordan Leborgne,85093003,769,29-Sep-95,21,0,0,0,0,2500,5200,5200,107,105,939361,173,64,WB/M RC,3,2,1,1,2,2,3,1,3,1,1,12,11,13,9,12,11,10,10,7,12,14,11,11,11,10,8,12,10,10,10,11,10,11,1,12,11,12,16,13,13,15,7,7,14,12,20,11,8,6,11,5,10,10,20,11,11,10,11,8,17,2,15,17,20,5,17,1,20,WB/M RC,423,1,1,1,1,1,5,1,1,15,15,20,1,13,1,17,0,0,0,0,0,0,0,0,0,0,0,0,0,0,0,0,0,0,0,0,0,0,0,0,0,0,0,0,0,0,0,0,0,0,0,0,0,0,0,0,0,0,0,0,0,0,0,0,0,Jordan Leborgne,£360Th. ,25,173,Midfielder - Central Midfield,right,Rodez AF,8,0,0,347,0,0,0,0,nan,nan,nan,nan,2,0,0,180,4,0,0,189,Ligue 1
19-06-17,18.3.4.28,Frédéric Guilbert,85096693,769,24-Dec-94,22,0,0,1,0,4000,6200,6200,136,124,9154263,177,68,D RC,2,1,2,1,1,2,3,3,3,2,1,5,12,9,7,12,8,13,10,16,11,12,8,14,12,12,13,12,12,12,10,13,14,11,13,11,12,13,14,13,14,13,11,10,14,12,20,12,14,12,11,12,8,14,13,12,14,12,14,12,12,5,20,12,1,1,18,1,20,D RC,103,1,13,1,1,1,1,20,1,18,11,1,1,1,1,12,0,0,0,0,0,0,0,0,0,0,0,0,0,0,0,0,0,0,0,0,0,0,0,0,0,0,0,0,0,0,0,0,0,0,0,0,0,0,0,0,0,0,0,0,0,0,0,0,0,Frédéric Guilbert,£5.40m ,25,178,Defender - Right-Back,right,Aston Villa,29,0,1,2458,42,1,3,3840,38,1,2,3291,29,2,2,2352,2,0,0,180,Ligue 1
19-06-17,18.3.4.28,Baďssama Sankoh,85097012,22,20-Mar-92,25,14,0,0,0,3250,5800,5800,121,116,2200882,180,73,D RC,2,2,3,1,1,2,3,2,2,1,3,5,10,8,5,11,6,13,9,6,14,12,5,13,11,10,12,13,11,13,9,11,14,8,7,8,11,13,14,15,12,14,10,6,15,14,20,13,14,12,7,7,8,11,10,12,15,9,13,10,13,6,20,10,1,1,19,1,20,D RC,103,1,1,1,1,1,1,20,1,19,14,1,1,1,1,10,0,0,0,0,0,0,0,0,0,0,0,0,0,0,0,0,0,0,0,0,0,0,0,0,0,0,0,0,0,0,0,0,0,0,0,0,0,0,0,0,0,0,0,0,0,0,0,0,0,Baissama Sankoh,£720Th. ,28,180,Midfielder - Defensive Midfield,right,Nea Salamina Famagusta,21,0,0,1462,30,0,0,1922,19,0,0,927,10,4,0,805,3,0,0,158,Ligue 1
19-06-17,18.3.4.28,Steeve Yago,85100394,9,16-Dec-92,24,36,0,0,0,3750,6100,6000,129,119,3287468,180,77,D RC,3,2,3,3,3,3,3,3,2,3,1,6,11,11,6,13,7,11,5,8,14,10,9,12,9,15,14,17,10,12,8,13,14,7,8,7,10,13,15,15,13,13,10,5,14,14,20,15,14,10,15,11,7,11,12,12,14,15,13,12,14,2,20,15,1,1,20,10,19,D RC,103,1,1,1,1,1,1,19,10,20,1,1,1,1,10,15,0,0,0,0,0,0,0,0,0,0,0,0,0,0,0,0,0,0,0,0,0,0,0,0,0,0,0,0,0,0,0,0,0,0,0,0,0,0,0,0,0,0,0,0,0,0,0,0,0,Steeve Yago,£1.80m ,27,178,Defender - Centre-Back,right,SM Caen,24,0,1,2072,27,0,0,2076,14,0,1,1206,18,0,0,1492,6,0,0,405,Ligue 1
19-06-17,18.3.4.28,Fouad Chafik,85116902,34,16-Oct-86,30,9,0,0,0,3750,6150,6150,127,123,232186002,183,72,D R,2,3,1,3,2,1,3,3,1,3,2,2,13,11,7,14,8,8,10,10,13,13,8,14,11,14,13,10,12,13,10,12,11,12,4,14,12,13,15,14,13,13,11,8,14,15,20,14,12,13,2,13,7,8,19,14,12,12,12,9,11,1,20,15,15,12,20,10,1,D R,102,1,1,1,1,1,12,1,10,20,1,1,1,15,8,15,2.2518E+15,0,0,0,0,0,0,0,0,0,0,0,0,0,0,0,0,0,0,0,0,0,0,0,0,0,0,0,0,0,0,0,0,0,0,0,0,0,0,0,0,0,0,0,0,0,0,0,0,Fouad Chafik,£1.35m ,34,183,Defender - Right-Back,right,Dijon FCO,28,0,1,2519,23,0,2,1695,26,0,2,2206,23,0,3,1830,7,0,0,551,Ligue 1
19-06-17,18.3.4.28,Almamy Touré,85122415,31,28-Apr-96,21,0,0,0,0,5550,6000,6550,156,131,15000571,184,80,D RC,1,2,2,3,2,1,1,3,1,1,4,8,15,13,8,13,8,16,9,12,13,13,10,13,13,12,13,12,12,13,12,12,14,12,9,14,13,14,13,14,13,14,12,7,13,14,20,14,14,13,7,15,11,13,15,15,16,14,16,17,17,5,20,14,1,1,20,12,16,D RC,103,1,1,1,1,1,1,16,12,20,10,1,1,1,10,14,2.79174E+11,0,1,0,0,0,1,0,0,0,0,0,0,0,0,0,0,0,0,0,0,1,0,0,0,0,0,0,0,0,0,0,0,1,0,0,0,0,0,1,0,0,0,0,0,0,0,0,0,Almamy Touré,£7.20m ,24,183,Defender - Right-Back,right,Eintracht Frankfurt,27,0,5,1981,27,1,6,1872,12,0,0,880,29,1,4,2370,4,0,0,317,Ligue 1
19-06-17,18.3.4.28,Angelo Fulgini,85133890,769,20-Aug-96,20,0,0,0,0,3750,5900,5900,130,118,5203514,183,71,D/DM/M RC,3,4,2,1,2,3,3,2,1,4,1,14,12,13,10,12,13,12,11,6,9,13,9,10,13,12,12,11,13,11,13,12,11,13,8,13,8,12,14,13,14,12,11,6,15,14,20,14,12,13,10,10,8,15,11,14,12,11,12,9,12,5,17,13,20,13,17,12,20,D/DM/M RC,433,1,1,1,13,1,1,12,1,17,19,20,12,12,1,13,0,0,0,0,0,0,0,0,0,0,0,0,0,0,0,0,0,0,0,0,0,0,0,0,0,0,0,0,0,0,0,0,0,0,0,0,0,0,0,0,0,0,0,0,0,0,0,0,0,Angelo Fulgini,£3.15m ,24,183,Midfielder - Central Midfield,right,SCO Angers,36,6,2,2797,32,4,5,1695,33,4,2,1842,23,1,2,1837,8,2,1,720,Ligue 1
19-06-17,18.3.4.28,Matthieu Udol,85138174,769,20-Mar-96,21,0,0,0,0,2750,5300,5300,116,106,1331997,175,66,D RL,3,3,1,3,2,2,3,1,1,2,3,11,11,11,4,12,7,12,5,5,12,13,6,13,12,15,12,13,11,13,7,10,5,5,6,11,12,15,12,13,14,11,9,20,14,14,6,12,17,10,10,10,4,10,7,10,13,10,11,12,20,3,20,13,10,7,15,20,1,D RL,105,1,1,1,1,7,1,1,20,15,1,1,10,1,13,13,0,0,0,0,0,0,0,0,0,0,0,0,0,0,0,0,0,0,0,0,0,0,0,0,0,0,0,0,0,0,0,0,0,0,0,0,0,0,0,0,0,0,0,0,0,0,0,0,0,Matthieu Udol,£360Th. ,24,178,Defender - Left-Back,left,FC Metz,3,0,0,270,6,0,0,353,5,0,1,343,14,0,1,1192,7,0,1,630,Ligue 1
19-06-17,18.3.4.28,Bryan Passi,85140255,769,05-Aug-97,19,0,0,0,0,1750,4700,4700,111,94,597723,189,78,D RC,1,2,3,3,3,2,1,1,3,2,1,5,7,10,8,9,10,11,6,2,11,11,5,10,11,10,10,11,5,11,10,11,10,2,7,11,13,11,12,12,11,13,14,5,14,12,20,10,11,10,10,6,7,10,15,12,11,12,10,11,19,6,20,1,1,1,17,1,20,D RC,103,1,1,1,1,1,1,20,1,17,15,1,1,1,1,1,0,0,0,0,0,0,0,0,0,0,0,0,0,0,0,0,0,0,0,0,0,0,0,0,0,0,0,0,0,0,0,0,0,0,0,0,0,0,0,0,0,0,0,0,0,0,0,0,0,Bryan Passi, ,23,189,Defender - Centre-Back,right,Chamois Niortais FC,3,0,0,143,1,0,0,90,0,0,0,0,17,0,1,1501,3,0,0,260,Ligue 1
19-06-17,18.3.4.28,Mathieu Debuchy,915351,769,28-Jul-85,31,27,2,2,0,6000,6500,6500,150,131,232186002,178,78,D/WB R,1,3,3,3,2,3,1,4,1,3,1,8,12,12,8,12,7,13,9,12,14,11,8,15,11,14,14,16,12,14,12,13,15,11,12,13,15,14,14,13,13,13,12,9,12,13,20,13,11,14,14,14,14,16,14,13,13,14,16,13,12,8,20,18,10,8,20,11,14,D/WB R,112,1,1,1,1,1,8,14,11,20,10,1,1,10,10,18,2.2518E+15,0,0,0,0,0,0,0,0,0,0,0,0,0,0,0,0,0,0,0,0,0,0,0,0,0,0,0,0,0,0,0,0,0,0,0,0,0,0,0,0,0,0,0,0,0,0,0,0,Mathieu Debuchy,£4.05m ,35,177,Defender - Right-Back,right,AS Saint-Étienne,4,2,0,266,23,5,1,2012,24,4,3,1947,32,2,3,2693,3,0,0,189,Premier League
19-06-17,18.3.4.28,Mouhamadou Dabo,919771,769,28-Nov-86,30,0,0,8,0,3700,6000,6000,138,120,2406623,176,67,D/WB RL,1,2,2,4,1,2,2,3,3,1,2,8,11,10,5,9,8,9,7,11,10,11,8,12,10,12,11,13,12,10,9,10,15,11,8,10,12,13,14,14,13,14,8,10,12,14,20,15,11,12,12,15,8,16,8,15,10,14,10,14,14,9,20,18,13,10,18,20,1,D/WB RL,115,1,1,1,1,10,10,1,20,18,10,1,12,13,18,18,2.2518E+15,0,0,0,1,0,0,1,0,0,0,0,0,0,0,0,0,0,0,0,0,0,0,0,0,0,0,0,0,0,0,0,0,0,0,0,0,0,0,0,0,0,0,0,0,0,0,0,0,Mouhamadou Dabo,£450Th. ,33,176,Defender - Right-Back,right,Retired,3,0,0,192,0,0,0,0,0,0,0,0,nan,nan,nan,nan,nan,nan,nan,nan,Ligue 1
19-06-17,18.3.4.28,Saidy Janko,98030722,798,22-Oct-95,21,0,0,4,0,2500,5700,5700,128,112,2884839,180,80,D/WB/M R,1,1,3,2,2,2,1,2,1,2,1,5,10,13,7,12,5,9,9,6,10,11,4,11,13,11,13,10,11,10,11,10,8,11,4,13,11,13,12,15,12,12,10,7,10,15,20,13,12,12,4,5,17,13,7,12,11,13,9,13,14,5,20,16,16,15,20,1,1,D/WB/M R,122,1,1,1,1,1,15,1,1,20,1,1,1,16,1,16,2,0,1,0,0,0,0,0,0,0,0,0,0,0,0,0,0,0,0,0,0,0,0,0,0,0,0,0,0,0,0,0,0,0,0,0,0,0,0,0,0,0,0,0,0,0,0,0,0,Saidy Janko,£2.70m ,25,181,Defender - Right-Back,right,Real Valladolid CF,21,1,1,1163,22,0,0,1499,17,0,1,1365,46,1,6,3414,1,0,0,80,Ligue 1
19-06-17,18.3.4.28,Alessandro Schöpf,16047316,755,07-Feb-94,23,12,2,19,8,4750,6750,6750,147,140,21987316,178,75,WB/M/AM RC,1,2,3,3,2,1,3,2,3,1,2,11,11,14,12,13,10,8,14,10,7,13,12,11,13,16,13,10,10,12,12,10,13,13,8,15,9,12,18,14,15,10,8,15,18,12,20,17,7,13,6,11,5,18,12,16,10,10,15,12,17,4,10,19,17,20,19,12,20,WB/M/AM RC,533,1,1,1,20,12,17,1,1,10,8,12,12,17,1,19,5.49756E+11,0,0,0,0,0,0,0,0,0,0,1,0,0,0,0,0,0,0,0,0,0,0,0,0,0,0,0,0,0,0,0,0,0,0,0,0,0,0,0,1,0,0,0,0,0,0,0,0,Alessandro Schöpf,£4.50m ,26,178,Midfielder - Right Midfield,right,FC Schalke 04,42,8,4,2761,20,1,0,1157,21,2,1,1399,27,1,1,1843,3,0,0,158,Bundesliga
19-06-17,18.3.4.28,Stefan Posch,16147386,755,14-May-97,20,0,0,4,0,2750,6000,6250,131,120,9819982,188,76,D RC,1,3,3,3,2,3,3,2,1,2,2,3,7,7,6,9,4,13,6,10,13,11,9,12,10,10,12,14,16,13,8,12,12,5,10,6,13,15,10,12,11,11,16,10,13,15,20,12,13,15,7,16,6,10,12,15,10,16,13,15,18,5,20,11,10,1,15,1,20,D RC,103,1,1,1,1,1,1,20,1,15,10,10,1,1,1,11,0,0,0,0,0,0,0,0,0,0,0,0,0,0,0,0,0,0,0,0,0,0,0,0,0,0,0,0,0,0,0,0,0,0,0,0,0,0,0,0,0,0,0,0,0,0,0,0,0,Stefan Posch,£2.25m ,23,188,Defender - Centre-Back,right,TSG 1899 Hoffenheim,30,1,0,2681,17,0,0,1423,24,2,0,2034,30,0,1,2526,6,0,0,509,Bundesliga
19-06-17,18.3.4.28,Konrad Laimer,16147659,755,27-May-97,20,0,0,6,0,4050,6300,6550,151,131,17744343,180,72,D/DM/M RC,2,1,2,2,2,1,1,3,3,1,2,8,10,12,10,11,8,6,9,7,13,12,9,15,11,18,15,17,10,14,12,11,17,9,10,15,13,16,18,13,12,10,9,12,17,12,20,17,9,12,10,14,4,15,13,16,12,12,14,16,9,8,16,10,20,12,16,1,20,D/DM/M RC,433,1,1,1,10,1,12,1,1,16,18,20,1,12,1,10,0,0,0,0,0,0,0,0,0,0,0,0,0,0,0,0,0,0,0,0,0,0,0,0,0,0,0,0,0,0,0,0,0,0,0,0,0,0,0,0,0,0,0,0,0,0,0,0,0,Konrad Laimer,£7.20m ,23,180,Midfielder - Central Midfield,right,RB Leipzig,43,4,4,3263,29,0,2,1701,43,2,3,2956,42,4,7,3060,nan,nan,nan,nan,Bundesliga
19-06-17,18.3.4.28,William,19225946,1651,03-Apr-95,22,0,0,1,0,4650,6650,6650,148,133,19437392,176,71,D/WB R,3,2,4,1,3,3,1,1,2,1,4,14,14,11,8,13,11,8,10,12,13,12,10,15,13,17,11,14,10,12,12,11,14,13,11,13,12,10,16,16,14,12,8,10,16,14,20,13,9,14,10,10,7,10,8,12,12,13,11,6,10,10,20,20,14,14,20,12,1,D/WB R,112,1,1,1,1,1,14,1,12,20,1,1,1,14,12,20,2.19916E+12,0,0,0,0,0,0,0,0,0,0,0,0,0,0,0,0,0,0,0,0,0,0,0,0,0,0,0,1,0,0,0,0,0,0,0,0,0,0,0,0,0,1,0,0,0,0,0,0,William,£3.60m ,25,176,Defender - Right-Back,right,VfL Wolfsburg,2,0,0,180,26,0,2,1941,33,2,3,2857,22,3,2,1862,nan,nan,nan,nan,Bundesliga
19-06-17,18.3.4.28,Bernardo,19270959,1651,14-May-95,22,0,0,0,0,4100,6100,6600,146,132,7350320,186,76,D/DM/M RLC,3,1,2,3,2,1,3,2,2,1,3,5,10,9,7,11,7,10,11,14,14,12,8,16,12,16,15,17,9,12,8,9,15,7,10,9,13,15,16,12,11,14,14,20,17,16,10,15,13,13,10,11,3,17,14,17,7,12,14,10,12,8,20,14,17,10,20,18,17,D/DM/M RLC,126,1,1,1,10,1,1,12,18,20,17,17,1,1,12,14,0,0,0,0,0,0,0,0,0,0,0,0,0,0,0,0,0,0,0,0,0,0,0,0,0,0,0,0,0,0,0,0,0,0,0,0,0,0,0,0,0,0,0,0,0,0,0,0,0,Bernardo,£5.40m ,25,186,Defender - Left-Back,left,Brighton & Hove Albion,32,3,1,2820,27,1,1,1846,27,0,1,2260,16,0,0,784,3,1,2,270,Bundesliga
19-06-17,18.3.4.28,Tin Jedvaj,24026928,761,28-Nov-95,21,9,0,5,1,5350,6600,6350,155,132,11105628,184,81,D RLC,1,3,2,4,2,4,1,1,1,2,2,5,11,9,10,12,5,11,9,17,15,13,8,16,12,16,15,17,15,9,10,12,16,9,10,13,11,12,14,12,11,15,12,10,16,14,20,13,13,12,14,12,10,17,14,17,8,12,12,8,10,13,20,15,10,1,17,15,20,D RLC,106,1,1,1,1,1,1,20,15,17,10,10,1,1,13,15,4294967296,0,0,0,0,0,0,0,0,0,0,0,0,0,0,0,0,0,0,0,0,0,0,0,0,0,0,0,0,0,0,0,0,1,0,0,0,0,0,0,0,0,0,0,0,0,0,0,0,Tin Jedvaj,£4.50m ,24,188,Defender - Centre-Back,right,Bayer 04 Leverkusen,23,1,0,1828,10,0,0,597,21,2,0,1470,31,2,0,2642,0,0,0,0,Bundesliga
19-06-17,18.3.4.28,Theodor Gebre Selassie,25006446,763,24-Dec-86,30,43,3,6,0,5100,6600,6600,132,132,232186002,181,71,D/WB R,2,1,4,4,1,3,2,1,1,2,1,7,11,12,8,12,6,14,10,13,9,10,7,10,11,10,10,14,12,14,8,12,12,9,10,14,9,14,16,16,14,12,11,9,18,15,20,17,9,15,5,13,10,13,14,11,15,12,16,18,16,2,20,20,14,14,20,10,1,D/WB R,112,1,1,1,1,1,14,1,10,20,1,1,1,14,10,20,2.74878E+11,0,0,0,0,0,0,0,0,0,0,0,0,0,0,0,0,0,0,0,0,0,0,0,0,0,0,0,0,0,0,0,0,0,0,0,0,0,0,1,0,0,0,0,0,0,0,0,0,Theodor Gebre Selassie,£2.25m ,33,181,Defender - Right-Back,right,SV Werder Bremen,31,5,2,2428,36,3,0,3218,36,3,5,3199,32,2,4,2789,6,0,1,540,Bundesliga
19-06-17,18.3.4.28,Pavel Kaderabek,25019787,763,25-Apr-92,25,28,2,7,1,4700,6700,6700,136,134,12564813,182,81,D/WB R,1,2,3,3,2,1,1,1,2,2,1,8,12,9,10,10,8,13,12,15,11,10,11,13,11,17,10,15,8,13,9,9,15,10,11,13,11,14,17,14,11,16,11,10,18,16,20,17,14,14,12,14,6,10,12,15,13,12,16,14,17,3,20,20,15,15,20,12,1,D/WB R,112,1,1,1,1,1,15,1,12,20,1,1,1,15,10,20,134217728,0,0,0,0,0,0,0,0,0,0,0,0,0,0,0,0,0,0,0,0,0,0,0,0,0,0,0,1,0,0,0,0,0,0,0,0,0,0,0,0,0,0,0,0,0,0,0,0,Pavel Kaderabek,£9.90m ,28,182,Defender - Right-Back,right,TSG 1899 Hoffenheim,26,1,3,2197,34,3,4,2631,36,5,5,3140,33,3,7,2776,4,0,0,291,Bundesliga
19-06-17,18.3.4.28,Frederik Sřrensen,27020708,764,14-Apr-92,25,1,0,17,0,5500,6250,6500,138,130,7489782,194,88,D RC,1,3,2,2,3,2,1,2,3,1,2,5,8,6,6,8,6,12,9,17,13,10,5,13,8,10,16,13,15,15,9,12,12,6,10,7,15,17,10,11,7,14,18,9,13,15,20,13,16,14,7,14,10,13,16,15,10,17,14,14,18,5,20,12,1,1,18,7,20,D RC,103,1,10,1,1,1,1,20,7,18,1,1,1,1,1,12,2.79173E+11,0,0,0,0,0,0,0,0,0,0,0,0,0,0,0,0,0,0,0,0,0,0,0,0,0,0,0,0,0,0,0,0,1,0,0,0,0,0,1,0,0,0,0,0,0,0,0,0,Frederik Sörensen,£4.05m ,28,194,Defender - Centre-Back,right,1. FC Köln,33,0,3,2890,35,3,2,2632,6,0,0,136,25,1,1,1976,3,0,0,97,Bundesliga
19-06-17,18.3.4.28,Tony Jantschke,29022529,771,07-Apr-90,27,0,0,18,0,4750,6500,6750,139,135,12324205,177,72,D/WB RC,2,3,2,4,4,3,2,1,2,2,2,5,9,7,5,11,5,12,5,10,14,12,6,15,11,10,17,12,14,17,9,13,12,4,11,7,16,18,12,11,13,11,11,12,14,12,20,14,10,16,5,14,8,16,6,11,17,12,16,16,18,3,20,16,11,1,20,1,18,D/WB RC,113,1,1,1,1,1,1,18,1,20,11,11,1,1,1,16,2.79173E+11,0,0,0,0,0,0,0,0,0,0,0,0,0,0,0,0,0,0,0,0,0,0,0,0,0,0,0,0,0,0,0,0,1,0,0,0,0,0,1,0,0,0,0,0,0,0,0,0,Tony Jantschke,£3.15m ,30,177,Defender - Centre-Back,right,Borussia Mönchengladbach,35,0,0,2533,14,0,1,804,15,0,2,1020,19,0,0,1128,3,0,0,112,Bundesliga
19-06-17,18.3.4.28,Daniel Opare,29022535,21,18-Oct-90,26,17,0,2,0,4600,6100,6100,127,127,3877763,175,74,D/WB R,3,3,1,2,2,2,1,2,2,2,1,8,14,12,7,12,6,8,10,15,10,11,7,13,13,16,8,14,9,11,10,9,14,14,8,12,9,10,16,16,14,14,10,9,16,17,20,15,11,11,14,12,11,11,15,18,7,12,10,8,7,16,20,20,10,10,20,13,8,D/WB R,112,1,1,1,1,1,10,8,13,20,1,1,1,10,11,20,134217728,0,0,0,0,0,0,0,0,0,0,0,0,0,0,0,0,0,0,0,0,0,0,0,0,0,0,0,1,0,0,0,0,0,0,0,0,0,0,0,0,0,0,0,0,0,0,0,0,Daniel Opare,£900Th. ,30,174,Defender - Right-Back,right,SV Zulte Waregem,8,0,0,586,17,0,0,1418,24,0,0,1847,nan,nan,nan,nan,8,0,2,627,Bundesliga
19-06-17,18.3.4.28,Sebastian Rudy,29022542,771,28-Feb-90,27,20,0,23,5,6500,7500,7500,150,150,49787611,180,74,D/WB/DM/M RC,2,3,3,1,3,3,2,3,3,3,2,12,12,10,9,15,10,7,13,8,11,16,11,13,15,11,16,10,17,13,14,16,9,8,10,9,15,18,12,12,14,10,9,12,13,12,20,16,9,13,4,10,7,14,7,13,13,11,15,17,19,3,16,16,20,12,16,10,20,D/WB/DM/M RC,343,1,1,1,12,10,11,1,1,16,20,20,10,11,1,16,17200840704,0,0,0,0,0,0,0,0,0,0,0,0,0,0,0,0,0,0,0,0,0,0,1,0,1,0,0,0,0,0,0,0,0,0,1,0,0,0,0,0,0,0,0,0,0,0,0,0,Sebastian Rudy,£13.50m ,30,180,Midfielder - Defensive Midfield,right,TSG 1899 Hoffenheim,34,3,10,2998,35,1,5,2133,28,0,0,1853,35,1,4,2993,5,0,2,450,Bundesliga
19-06-17,18.3.4.28,Jonas Strifler,29022546,771,30-Jan-90,27,0,0,0,0,1363,4653,4950,68,63,88209,173,71,D/WB/DM/M RC,2,3,3,1,2,1,1,2,3,1,1,6,10,7,6,8,6,6,7,11,10,8,7,11,9,11,9,9,7,9,6,9,13,8,8,7,11,10,11,10,10,8,5,8,11,10,20,10,7,12,5,12,9,7,6,14,13,9,12,14,16,7,17,17,18,1,17,1,18,D/WB/DM/M RC,343,1,1,1,1,1,1,14,1,17,20,18,1,10,1,17,32,0,0,0,0,0,1,0,0,0,0,0,0,0,0,0,0,0,0,0,0,0,0,0,0,0,0,0,0,0,0,0,0,0,0,0,0,0,0,0,0,0,0,0,0,0,0,0,0,,,,,,,,,,,,,,,,,,,,,,,,,,,,
19-06-17,18.3.4.28,Jean-Philippe Gbamin,29114927,24,25-Sep-95,21,2,0,0,0,6250,6250,6750,140,130,23163918,186,83,D/DM/M RC,3,1,3,2,1,4,2,3,1,3,1,6,10,11,8,10,6,12,7,14,14,12,7,15,11,16,12,17,9,13,10,10,14,8,11,8,12,14,16,13,12,15,14,9,17,16,20,16,15,13,10,13,8,17,11,13,13,10,10,15,15,11,17,11,20,1,15,10,20,D/DM/M RC,333,1,1,1,1,1,1,17,10,15,20,20,1,1,6,11,0,0,0,0,0,0,0,0,0,0,0,0,0,0,0,0,0,0,0,0,0,0,0,0,0,0,0,0,0,0,0,0,0,0,0,0,0,0,0,0,0,0,0,0,0,0,0,0,0,Jean-Philippe Gbamin,£13.50m ,25,186,Midfielder - Defensive Midfield,right,Everton FC,31,0,0,2365,31,1,3,2710,33,2,1,2869,2,0,0,135,nan,nan,nan,nan,Bundesliga
19-06-17,18.3.4.28,Lars Bender,35007385,771,27-Apr-89,28,19,4,1,0,6800,7050,7300,154,146,44042058,185,81,D/DM/M RC,3,1,3,3,1,1,4,1,2,2,2,7,10,8,9,12,7,12,11,13,15,13,8,17,11,15,16,18,12,17,10,14,17,5,14,12,14,19,17,11,11,14,12,10,18,12,20,17,13,18,6,18,13,15,9,14,14,16,19,15,18,2,16,12,20,10,16,1,20,D/DM/M RC,333,1,1,1,8,1,10,10,1,16,20,20,1,10,1,12,2.74928E+11,0,0,0,0,0,0,0,0,0,0,0,0,0,0,0,0,0,0,0,0,0,0,0,0,1,1,0,0,0,0,0,0,0,0,0,0,0,0,1,0,0,0,0,0,0,0,0,0,Lars Bender,£11.70m ,31,185,Defender - Right-Back,right,Bayer 04 Leverkusen,12,0,1,823,24,3,7,1792,27,1,5,1814,28,2,1,2043,6,1,1,461,Bundesliga
19-06-17,18.3.4.28,Daniel Brosinski,35008235,771,17-Jul-88,28,0,0,4,1,4150,6400,6650,136,133,11369040,178,70,D/WB R,1,2,2,2,3,3,1,4,2,2,4,12,14,11,9,11,14,7,13,17,9,13,11,12,11,14,9,12,13,12,12,11,15,12,8,13,8,10,17,15,14,10,9,15,16,14,20,16,8,13,6,13,5,16,7,12,11,13,13,12,10,8,20,20,14,14,20,13,10,D/WB R,112,1,1,1,1,11,14,1,13,20,10,10,11,14,13,20,134217728,0,0,0,0,0,0,0,0,0,0,0,0,0,0,0,0,0,0,0,0,0,0,0,0,0,0,0,1,0,0,0,0,0,0,0,0,0,0,0,0,0,0,0,0,0,0,0,0,Daniel Brosinski,£2.70m ,32,178,Defender - Right-Back,right,1.FSV Mainz 05,35,1,3,2965,33,3,9,2892,28,3,6,2414,27,2,4,1791,6,0,1,532,Bundesliga
19-06-17,18.3.4.28,Ermin Bicakcic,35013742,759,24-Jan-90,27,19,3,0,0,4928,7219,6450,130,129,7046965,185,81,D RC,3,1,3,3,3,3,1,2,3,2,1,3,6,5,8,8,4,13,4,14,16,9,5,15,8,14,11,18,10,14,7,11,16,5,12,8,13,15,12,11,8,14,14,15,14,16,20,13,17,15,13,13,7,10,11,15,9,13,17,9,14,7,20,11,1,1,15,1,20,D RC,103,1,1,1,1,1,1,20,1,15,1,1,1,1,1,11,32768,0,0,0,0,0,0,0,0,0,0,0,0,0,0,0,1,0,0,0,0,0,0,0,0,0,0,0,0,0,0,0,0,0,0,0,0,0,0,0,0,0,0,0,0,0,0,0,0,Ermin Bicakcic,£1.80m ,30,185,Defender - Centre-Back,right,TSG 1899 Hoffenheim,19,1,1,1171,13,0,1,825,30,1,3,2198,22,2,0,1289,3,1,0,249,Bundesliga
19-06-17,18.3.4.28,Dennis Diekmeier,35016422,771,20-Oct-89,27,0,0,1,0,4100,6600,6600,133,132,9518279,188,80,D/WB R,2,1,1,3,1,3,1,2,3,1,2,10,16,12,7,10,6,8,9,17,11,11,6,13,10,16,9,16,8,12,9,10,14,10,9,12,8,10,18,15,11,17,13,7,13,18,20,16,14,13,13,13,10,8,7,18,10,12,9,10,8,15,20,20,15,15,20,1,1,D/WB R,112,1,1,1,1,1,15,1,1,20,1,1,1,15,1,20,134217728,0,0,0,0,0,0,0,0,0,0,0,0,0,0,0,0,0,0,0,0,0,0,0,0,0,0,0,1,0,0,0,0,0,0,0,0,0,0,0,0,0,0,0,0,0,0,0,0,Dennis Diekmeier,£1.35m ,31,188,Defender - Right-Back,right,SV Sandhausen,26,0,1,1883,22,0,3,1869,16,0,6,1440,34,2,4,2974,6,0,1,540,Bundesliga
19-06-17,18.3.4.28,Sebastian Jung,35017378,771,22-Jun-90,26,1,0,19,0,4550,6550,6550,139,131,8068394,179,72,D/WB R,3,2,1,2,1,1,1,2,3,3,3,8,14,11,7,11,6,8,10,16,13,12,7,13,12,16,14,14,13,13,11,12,16,9,9,11,12,15,16,13,13,12,8,10,14,16,20,15,10,15,8,15,10,10,7,12,14,10,17,15,18,4,20,18,10,10,20,1,14,D/WB R,112,1,1,1,1,1,10,14,1,20,8,8,1,10,1,18,0,0,0,0,0,0,0,0,0,0,0,0,0,0,0,0,0,0,0,0,0,0,0,0,0,0,0,0,0,0,0,0,0,0,0,0,0,0,0,0,0,0,0,0,0,0,0,0,0,Sebastian Jung,£450Th. ,30,179,Defender - Right-Back,right,Karlsruher SC,7,0,1,535,7,0,0,411,2,0,0,147,10,0,1,766,0,0,0,0,Bundesliga
19-06-17,18.3.4.28,Julian Korb,35017439,771,21-Mar-92,25,0,0,10,0,4500,6500,6500,139,130,8840985,177,69,D/WB RC,1,1,1,3,2,3,2,1,3,2,1,6,10,11,6,12,6,8,7,10,11,13,6,12,13,10,15,9,15,13,10,14,10,8,7,10,12,17,12,16,16,8,8,9,12,13,20,14,7,14,6,12,10,17,7,10,16,9,14,15,17,3,20,20,15,12,20,10,15,D/WB RC,113,1,1,1,8,1,12,13,10,20,15,15,1,12,10,20,0,0,0,0,0,0,0,0,0,0,0,0,0,0,0,0,0,0,0,0,0,0,0,0,0,0,0,0,0,0,0,0,0,0,0,0,0,0,0,0,0,0,0,0,0,0,0,0,0,Julian Korb,£2.70m ,28,177,Defender - Right-Back,right,Without Club,21,1,1,1322,29,1,2,2431,12,0,0,1007,27,1,4,2111,nan,nan,nan,nan,Bundesliga
19-06-17,18.3.4.28,Matthias Zimmermann,35017462,771,16-Jun-92,25,0,0,0,0,2800,5800,5800,120,116,1494444,177,77,D/WB/DM/M RC,3,1,2,2,3,1,4,2,1,2,3,8,10,9,7,11,6,8,9,10,11,13,7,13,12,11,14,9,12,13,10,14,10,7,10,8,13,16,12,12,13,9,8,9,14,12,20,14,10,12,7,10,6,17,7,13,12,8,15,15,17,5,20,16,17,10,20,12,17,D/WB/DM/M RC,133,1,1,1,1,1,10,1,12,20,18,17,1,10,10,16,0,0,0,0,0,0,0,0,0,0,0,0,0,0,0,0,0,0,0,0,0,0,0,0,0,0,0,0,0,0,0,0,0,0,0,0,0,0,0,0,0,0,0,0,0,0,0,0,0,Matthias Zimmermann,£900Th. ,28,177,Defender - Right-Back,right,Fortuna Düsseldorf,30,1,0,1726,7,0,0,427,36,1,3,3230,38,2,4,3250,5,1,0,288,Bundesliga
19-06-17,18.3.4.28,Panagiotis Retsos,36105386,772,09-Aug-98,18,0,0,0,0,5650,6400,6650,155,128,25538249,185,76,D RLC,2,2,2,1,3,2,1,3,2,1,3,3,9,9,6,11,6,14,7,12,14,13,7,15,13,14,14,16,15,11,10,11,15,8,12,7,11,15,12,12,13,15,14,10,13,16,20,15,11,13,9,16,6,17,13,17,12,16,14,9,14,5,20,12,10,1,16,16,20,D RLC,106,1,1,1,1,1,1,20,16,16,14,10,1,1,12,12,1.15292E+18,0,0,0,0,0,0,0,0,0,0,0,0,0,0,0,0,0,0,0,0,0,0,0,0,0,0,0,0,0,0,0,0,0,0,0,0,0,0,0,0,0,0,0,0,0,0,0,0,Panagiotis Retsos,£16.20m ,22,186,Defender - Centre-Back,right,AS Saint-Étienne,34,0,0,2712,34,1,3,2437,1,0,0,31,7,0,0,285,2,0,0,138,Bundesliga
19-06-17,18.3.4.28,Giulio Donati,43036529,776,05-Feb-90,27,0,0,25,0,5000,6500,6500,132,130,7905881,179,82,D/WB R,2,1,2,3,2,3,1,2,1,3,3,7,12,9,6,10,5,9,7,15,14,11,6,16,10,16,15,13,10,12,8,11,17,6,12,10,14,16,13,13,12,14,9,9,16,15,20,17,12,13,14,13,7,12,12,15,13,13,15,8,8,10,20,20,12,12,20,10,14,D/WB R,112,1,1,1,1,1,12,14,10,20,1,1,1,12,10,20,2.74878E+11,0,0,0,0,0,0,0,0,0,0,0,0,0,0,0,0,0,0,0,0,0,0,0,0,0,0,0,0,0,0,0,0,0,0,0,0,0,0,1,0,0,0,0,0,0,0,0,0,Giulio Donati,£3.15m ,30,178,Defender - Right-Back,right,AC Monza,37,0,2,3267,31,0,3,2495,9,0,0,624,20,1,0,1762,4,0,0,360,Bundesliga
19-06-17,18.3.4.28,Gôtoku Sakai,45015318,116,14-Mar-91,26,34,0,7,2,4700,6700,6700,139,139,12085826,175,72,D/WB/DM RL,2,2,2,3,1,3,1,1,1,3,1,12,15,11,7,11,10,8,8,14,12,13,7,14,12,16,13,15,10,10,12,12,15,13,13,11,12,14,16,12,14,11,9,18,14,12,20,15,9,11,10,11,4,16,10,14,14,9,17,11,13,4,20,20,14,10,20,18,14,D/WB/DM RL,125,1,1,1,1,10,10,1,18,20,16,14,10,10,18,20,1.40875E+14,0,0,0,0,0,0,0,0,0,0,0,0,0,0,0,0,0,0,0,0,0,0,0,0,0,0,0,0,0,0,0,0,0,0,0,0,0,1,0,0,0,0,0,0,0,0,0,1,Gotoku Sakai,£1.35m ,29,176,Defender - Left-Back,right,Vissel Kobe,37,1,3,3052,29,0,0,2379,51,0,4,4297,30,1,7,2406,nan,nan,nan,nan,Bundesliga
19-06-17,18.3.4.28,Aleksandar Ignjovski,62013411,802,27-Jan-91,26,12,0,10,1,4200,6200,6200,128,124,4762059,175,71,D/WB/DM/M RC,1,3,1,1,2,4,1,4,3,2,2,8,10,12,6,9,6,8,7,12,14,11,10,15,10,18,10,16,8,12,9,8,18,6,11,10,12,13,17,14,15,12,8,14,16,13,20,16,8,13,14,11,4,19,14,16,12,14,17,12,10,5,20,16,18,12,20,14,18,D/WB/DM/M RC,133,1,1,1,10,12,12,1,14,20,18,18,12,12,10,16,0,0,0,0,0,0,0,0,0,0,0,0,0,0,0,0,0,0,0,0,0,0,0,0,0,0,0,0,0,0,0,0,0,0,0,0,0,0,0,0,0,0,0,0,0,0,0,0,0,Aleksandar Ignjovski,£450Th. ,29,175,Midfielder - Defensive Midfield,right,Holstein Kiel,21,0,0,1243,1,0,0,55,17,0,0,1059,22,0,0,1261,5,0,0,224,Bundesliga
19-06-17,18.3.4.28,Lukasz Piszczek,719130,787,03-Jun-85,32,55,3,8,2,5250,7250,7250,161,145,232186002,184,79,D/WB R,2,3,3,1,2,2,2,1,1,2,2,9,14,11,10,12,8,10,12,17,11,13,9,13,12,16,12,14,12,15,11,13,14,10,10,14,11,17,14,13,11,14,11,12,18,15,20,16,13,17,8,16,10,18,15,10,16,13,18,16,18,4,20,20,14,14,20,14,1,D/WB R,112,1,1,8,1,12,14,1,14,20,1,1,12,14,14,20,2.8823E+17,0,0,0,0,0,0,0,0,0,0,0,0,0,0,0,0,0,0,0,0,1,0,0,0,0,0,0,0,0,0,0,0,0,0,0,0,0,0,0,0,0,0,0,0,0,0,0,0,Lukasz Piszczek,£3.60m ,35,184,Defender - Right-Back,right,Borussia Dortmund,39,5,4,3134,31,0,5,2800,26,1,6,2329,38,1,4,2731,4,0,0,132,Bundesliga
19-06-17,18.3.4.28,Carlos Salcedo,72039283,379,29-Sep-93,23,13,0,0,0,4500,6750,6500,137,130,7524540,188,77,D RC,3,4,1,2,2,1,4,1,3,2,3,5,8,9,6,12,5,12,8,14,15,10,9,16,10,15,13,18,10,13,9,10,17,5,11,7,14,12,14,14,12,16,14,11,13,12,20,13,14,12,14,13,5,12,12,14,7,14,10,8,10,12,20,11,1,1,15,10,20,D RC,103,1,1,1,1,1,1,20,10,15,1,1,1,1,6,11,0,0,0,0,0,0,0,0,0,0,0,0,0,0,0,0,0,0,0,0,0,0,0,0,0,0,0,0,0,0,0,0,0,0,0,0,0,0,0,0,0,0,0,0,0,0,0,0,0,Carlos Salcedo,£6.30m ,27,184,Defender - Centre-Back,right,Tigres UANL,23,0,1,1749,24,0,0,1996,32,2,0,2595,23,1,0,1822,10,0,0,708,Bundesliga
19-06-17,18.3.4.28,Peter Pekarik,7563749,794,30-Oct-86,30,75,2,7,0,4500,6750,6500,130,130,6263601,176,72,D/WB R,1,2,1,2,3,2,2,1,3,3,3,8,14,10,5,11,5,10,6,13,12,12,6,14,11,12,16,10,13,16,9,13,12,6,12,10,14,18,13,14,15,10,8,10,15,13,20,16,8,18,8,17,5,10,14,14,16,13,15,17,18,3,20,18,8,8,20,14,10,D/WB R,112,1,1,1,1,1,8,10,14,20,1,1,1,8,12,18,0,0,0,0,0,0,0,0,0,0,0,0,0,0,0,0,0,0,0,0,0,0,0,0,0,0,0,0,0,0,0,0,0,0,0,0,0,0,0,0,0,0,0,0,0,0,0,0,0,Peter Pekarik,£1.58m ,33,177,Defender - Right-Back,right,Hertha BSC,36,1,2,3215,23,1,2,1887,4,0,1,288,12,0,2,1040,6,2,0,371,Bundesliga
19-06-17,18.3.4.28,Miiko Albornoz,8109538,1652,30-Nov-90,26,8,1,0,0,3700,5950,6200,135,129,6126951,180,80,D/WB RL,2,3,3,2,2,3,4,4,2,3,2,11,14,12,8,14,9,8,11,15,10,13,10,11,15,14,11,10,15,12,12,14,12,14,7,11,10,14,12,12,13,13,10,20,16,14,9,14,12,13,8,13,5,14,10,13,15,11,14,12,13,11,20,20,12,12,16,20,1,D/WB RL,115,1,1,1,1,12,10,1,20,16,1,1,12,10,20,16,1.40759E+14,0,0,0,0,0,0,0,0,0,0,0,0,0,0,1,0,0,0,0,0,0,0,0,0,0,0,0,0,0,0,0,0,1,0,1,0,0,0,0,0,0,0,0,0,0,0,0,1,Miiko Albornoz,£1.35m ,29,180,Defender - Left-Back,left,Without Club,27,0,2,2174,11,0,2,790,23,1,3,1705,19,0,1,1343,nan,nan,nan,nan,Bundesliga
19-06-17,18.3.4.28,Marcel Tisserand,85095880,53,10-Jan-93,24,10,0,4,0,5000,6500,6500,138,130,9261558,190,80,D RLC,1,3,2,1,2,1,2,3,1,1,3,6,11,13,7,13,6,11,8,10,15,12,5,15,12,14,14,16,9,11,10,10,16,12,12,9,12,10,14,14,12,15,17,8,15,16,20,13,14,13,8,13,6,14,12,14,7,13,16,14,12,11,20,12,8,8,16,15,20,D RLC,106,1,1,5,1,1,8,20,15,16,1,1,1,8,11,12,34359738368,0,0,0,0,0,0,0,0,0,0,0,0,0,0,0,0,0,0,0,0,0,0,0,0,0,0,0,0,0,0,0,0,0,0,0,1,0,0,0,0,0,0,0,0,0,0,0,0,Marcel Tisserand,£6.75m ,27,190,Defender - Centre-Back,right,Fenerbahce SK,29,0,2,2479,19,0,1,1519,12,1,0,1068,23,1,2,1905,4,0,0,360,Bundesliga
19-06-17,18.3.4.28,Benjamin Pavard,85120944,769,28-Mar-96,21,0,0,11,0,4950,6200,6450,165,129,7880477,186,76,D RC,2,3,2,3,1,2,2,2,4,1,1,5,9,10,7,12,5,13,9,10,14,14,10,13,14,14,16,14,17,11,13,14,13,9,11,7,15,16,9,9,11,13,14,10,12,11,20,13,12,12,8,15,6,15,12,14,12,10,14,15,17,6,20,11,12,1,16,12,20,D RC,103,1,1,1,1,1,1,20,12,16,14,12,1,1,7,11,1.15306E+18,0,0,0,0,0,0,0,0,0,0,0,0,0,0,0,0,0,0,0,0,0,0,0,0,0,0,0,0,0,0,0,0,1,0,0,0,0,0,0,0,0,0,0,0,0,0,0,1,Benjamin Pavard,£27.00m ,24,186,Defender - Right-Back,right,Bayern Munich,21,1,2,1699,36,1,0,3270,31,0,0,2786,47,4,7,3978,7,0,0,531,Bundesliga
19-06-17,18.3.4.28,Paul Verhaegh,857021,784,01-Sep-83,33,3,0,15,0,4750,6500,6750,141,135,232186002,178,74,D/WB R,2,1,3,2,2,4,3,2,3,3,1,9,13,9,6,12,6,10,7,12,14,12,18,14,13,11,16,12,17,18,10,16,12,8,15,10,14,18,12,11,13,10,8,12,15,11,20,13,9,18,8,18,3,8,15,11,15,13,18,16,18,5,20,18,8,8,20,1,1,D/WB R,112,1,1,1,1,1,8,1,1,20,1,1,1,8,1,18,5.76461E+17,0,0,0,0,0,0,0,0,0,0,0,0,0,0,0,0,0,0,0,0,0,0,0,0,0,0,0,0,0,0,0,0,0,0,0,0,0,0,1,0,0,0,0,0,0,0,0,0,Paul Verhaegh,£900Th. ,37,178,Defender - Right-Back,right,Retired,31,3,2,2764,33,2,2,2797,3,0,0,270,8,0,0,452,nan,nan,nan,nan,Bundesliga
19-06-17,18.3.4.28,Christoph Janker,8713751,771,14-Feb-85,32,0,0,13,0,3050,6050,6050,125,121,1769370,185,78,D RC,2,3,4,1,3,2,3,1,1,2,1,10,9,7,7,10,7,11,8,12,14,11,10,14,10,10,12,13,10,15,8,12,13,7,11,8,14,18,12,10,10,13,12,15,14,11,20,14,13,16,8,15,10,16,6,10,15,12,17,14,16,4,20,14,12,1,16,10,20,D RC,103,1,1,1,1,1,1,20,10,16,12,12,1,1,8,14,0,0,0,0,0,0,0,0,0,0,0,0,0,0,0,0,0,0,0,0,0,0,0,0,0,0,0,0,0,0,0,0,0,0,0,0,0,0,0,0,0,0,0,0,0,0,0,0,0,Christoph Janker,£135Th. ,35,185,Defender - Centre-Back,right,Retired,17,0,0,1265,5,0,0,73,4,0,0,69,nan,nan,nan,nan,nan,nan,nan,nan,Bundesliga
19-06-17,18.3.4.28,Andreas Beck,8723862,771,13-Mar-87,30,9,0,27,2,4500,6500,6500,142,130,232186002,180,74,D/WB RL,1,1,2,2,1,4,4,2,4,2,2,6,11,9,5,11,5,8,8,13,13,12,7,14,12,11,15,10,12,15,10,14,11,6,13,10,13,17,14,13,14,10,9,12,17,13,20,16,9,16,8,11,6,15,14,12,15,10,17,15,17,5,20,18,9,1,20,15,9,D/WB RL,115,1,1,1,1,1,1,8,15,20,1,9,1,1,13,18,2.74878E+11,0,0,0,0,0,0,0,0,0,0,0,0,0,0,0,0,0,0,0,0,0,0,0,0,0,0,0,0,0,0,0,0,0,0,0,0,0,0,1,0,0,0,0,0,0,0,0,0,Andreas Beck,£2.70m ,33,nan,Defender - Right-Back,nan,KAS Eupen,30,1,3,1926,29,1,2,2363,24,0,2,1777,28,1,1,2490,3,0,0,89,Bundesliga
19-06-17,18.3.4.28,Fabian Johnson,8726381,390,11-Dec-87,29,56,2,0,0,5400,6900,6900,149,143,18946115,183,70,D/WB/M/AM RL,3,3,1,3,3,2,1,1,2,3,3,10,13,12,11,12,10,8,11,16,9,10,9,10,11,16,9,13,10,12,10,9,13,11,8,14,8,13,16,14,13,11,11,20,17,17,15,14,9,12,9,13,5,18,10,15,12,12,15,16,18,5,17,18,20,20,16,20,10,D/WB/M/AM RL,445,1,1,1,1,20,12,1,17,16,10,10,20,12,18,16,135266304,0,0,0,0,0,0,0,0,0,0,0,0,0,0,0,0,0,0,0,0,1,0,0,0,0,0,0,1,0,0,0,0,0,0,0,0,0,0,0,0,0,0,0,0,0,0,0,0,Fabian Johnson,£4.05m ,32,183,Forward - Left Winger,right,Without Club,35,4,4,2038,12,1,0,479,18,1,1,1008,7,0,0,298,nan,nan,nan,nan,Bundesliga
19-06-17,18.3.4.28,Rafinha,8833533,1651,07-Sep-85,31,4,0,15,3,6500,7250,7500,151,145,26527483,172,68,D/WB RL,4,2,1,3,3,2,2,1,1,1,2,10,15,13,10,14,8,7,11,10,12,13,17,16,14,16,13,10,14,11,12,14,15,13,7,13,12,10,16,15,16,8,6,14,14,13,20,16,7,13,16,13,3,12,14,10,12,12,10,6,8,17,20,20,12,12,20,16,10,D/WB RL,115,1,1,1,1,1,12,1,16,20,10,10,1,12,16,20,196608,0,0,0,0,0,0,0,0,0,0,0,0,0,0,0,0,1,1,0,0,0,0,0,0,0,0,0,0,0,0,0,0,0,0,0,0,0,0,0,0,0,0,0,0,0,0,0,0,Rafinha,£25.20m ,27,174,Midfielder - Attacking Midfield,left,Paris Saint-Germain,28,7,5,1567,18,2,3,1062,8,1,0,348,33,4,2,2344,3,0,1,154,Serie A
19-06-17,18.3.4.28,Markus Feulner,883735,771,12-Feb-82,35,0,0,13,1,2900,5900,4900,135,118,11629,183,82,DM/M RLC,3,1,3,2,1,3,1,1,2,1,1,12,11,9,10,12,11,7,14,12,10,14,10,12,13,11,15,13,15,14,13,14,13,10,15,8,12,17,10,8,9,14,10,12,13,8,20,10,12,16,8,16,15,18,18,16,8,12,17,14,12,10,15,11,20,10,15,15,20,DM/M RLC,316,1,1,1,10,8,8,1,15,15,20,20,8,8,11,11,2048,0,0,0,0,0,0,0,0,0,0,0,1,0,0,0,0,0,0,0,0,0,0,0,0,0,0,0,0,0,0,0,0,0,0,0,0,0,0,0,0,0,0,0,0,0,0,0,0,Markus Suttner,£2.25m ,33,179,Defender - Left-Back,left,Austria Vienna,33,4,5,2856,17,0,1,1447,9,1,1,761,22,0,1,1489,6,0,1,508,Premier League
19-06-17,18.3.4.28,Sascha Riether,890204,771,23-Mar-83,34,2,0,20,0,4750,6250,6250,136,125,702591,174,71,D/WB R,4,1,1,2,3,3,3,2,1,3,1,8,11,10,6,13,7,10,6,14,13,12,9,14,12,11,16,12,14,15,9,14,16,7,13,10,12,18,12,12,13,12,8,10,17,14,20,13,9,17,6,17,9,17,11,11,15,13,18,15,13,4,20,16,14,10,20,8,14,D/WB R,112,1,1,1,1,1,10,13,8,20,14,14,1,10,8,16,2.74895E+11,0,0,0,0,0,0,0,0,0,0,0,0,0,0,0,0,0,0,0,0,0,0,0,0,1,0,0,0,0,0,0,0,0,0,0,0,0,0,1,0,0,0,0,0,0,0,0,0,Sascha Riether,£450Th. ,37,174,Defender - Right-Back,right,Retired,9,0,0,582,0,0,0,0,1,0,0,1,nan,nan,nan,nan,nan,nan,nan,nan,Bundesliga
19-06-17,18.3.4.28,Timothy Chandler,91001071,390,29-Mar-90,27,29,1,0,0,4550,6050,6550,133,131,9017617,186,80,D/WB RL,2,2,3,3,4,3,2,2,4,3,1,8,13,10,7,11,7,10,9,17,12,10,6,12,11,14,10,14,8,13,9,10,15,9,10,12,11,12,16,14,11,15,13,8,13,16,20,16,14,13,8,13,9,15,10,12,10,11,14,13,11,6,20,20,14,14,20,16,10,D/WB RL,115,1,1,1,1,1,14,10,16,20,8,8,1,14,16,20,0,0,0,0,0,0,0,0,0,0,0,0,0,0,0,0,0,0,0,0,0,0,0,0,0,0,0,0,0,0,0,0,0,0,0,0,0,0,0,0,0,0,0,0,0,0,0,0,0,Timothy Chandler,£4.50m ,30,186,Defender - Right-Back,right,Eintracht Frankfurt,38,0,6,3237,25,3,4,1983,1,0,0,16,33,5,1,1575,4,0,0,66,Bundesliga
19-06-17,18.3.4.28,Daniel Caligiuri,91003264,771,15-Jan-89,28,0,0,0,0,5050,6550,7050,141,141,23132297,182,79,WB/M/AM RL,4,4,1,2,2,1,3,2,3,2,2,10,12,13,11,12,10,8,12,12,9,11,14,14,12,16,11,13,11,12,12,10,12,14,7,12,10,14,16,13,12,15,9,10,14,16,20,16,12,13,8,13,8,16,9,14,12,11,15,13,10,8,12,20,18,18,20,16,10,WB/M/AM RL,225,1,1,10,10,16,18,1,1,12,1,1,16,18,1,20,1.44115E+17,0,0,0,0,0,0,0,0,0,0,1,0,0,0,0,0,0,0,0,0,0,0,0,0,0,0,0,0,0,0,0,0,0,0,0,0,0,0,0,0,0,0,0,0,0,0,0,0,Daniel Caligiuri,£6.75m ,32,182,Midfielder - Right Midfield,right,FC Augsburg,41,6,6,2969,37,6,11,3187,40,7,5,3516,30,4,5,2466,6,3,1,511,Bundesliga
19-06-17,18.3.4.28,Oliver Sorg,91004882,771,29-May-90,27,1,0,5,0,4600,6600,6600,133,132,10192445,175,69,D/WB RL,4,1,2,2,2,1,3,1,3,2,3,6,10,10,8,12,8,9,14,15,13,11,5,15,11,11,16,14,10,14,8,12,13,7,11,10,13,16,12,12,15,13,8,15,14,12,20,15,9,13,10,13,6,14,7,12,15,12,15,13,11,3,20,18,12,8,20,17,12,D/WB RL,115,1,1,1,1,1,8,10,17,20,12,12,1,8,15,18,0,0,0,0,0,0,0,0,0,0,0,0,0,0,0,0,0,0,0,0,0,0,0,0,0,0,0,0,0,0,0,0,0,0,0,0,0,0,0,0,0,0,0,0,0,0,0,0,0,Oliver Sorg,£2.25m ,30,175,Defender - Right-Back,right,1.FC Nuremberg,28,0,0,2443,23,0,1,1780,20,0,0,1670,28,0,1,2061,1,0,0,0,Bundesliga
19-06-17,18.3.4.28,Matthias Ginter,91107789,771,19-Jan-94,23,14,0,18,1,6950,7450,7450,160,144,51026341,190,88,D/DM/M RC,2,3,2,3,3,2,1,1,2,2,3,6,12,7,10,13,7,15,10,14,14,13,11,14,12,11,15,12,16,15,12,16,12,6,10,9,14,17,12,10,9,13,14,12,16,12,20,14,15,13,8,13,7,16,8,15,13,13,16,16,18,3,20,11,17,10,15,1,20,D/DM/M RC,123,1,1,8,10,1,1,20,1,15,17,17,1,1,1,11,1.15292E+18,0,0,0,0,0,0,0,0,0,0,0,0,0,0,0,0,0,0,0,0,0,0,0,0,0,0,0,0,0,0,0,0,1,0,0,0,0,0,1,0,0,0,0,0,0,0,0,0,Matthias Ginter,£22.50m ,26,191,Defender - Centre-Back,right,Borussia Mönchengladbach,42,0,1,3382,37,5,2,3330,29,2,0,2560,36,1,2,3231,7,1,0,630,Bundesliga
19-06-17,18.3.4.28,Kevin Akpoguma,91109389,771,19-Apr-95,22,0,0,7,0,3750,6250,6250,142,125,7537873,192,83,D RLC,3,1,1,2,3,3,2,2,1,1,1,5,9,9,10,11,8,13,11,15,13,10,10,14,11,14,11,15,11,10,9,10,14,11,9,12,11,15,13,13,12,15,17,10,16,16,20,13,14,12,12,12,4,18,9,15,7,11,13,10,11,8,20,14,11,1,16,15,20,D RLC,106,1,1,8,1,1,1,20,15,16,11,11,1,1,13,14,1.15292E+18,0,0,0,0,0,0,0,0,0,0,0,0,0,0,0,0,0,0,0,0,0,0,0,0,0,0,0,0,0,0,0,0,0,0,0,0,0,0,0,0,0,0,0,0,0,0,0,0,Kevin Akpoguma,£7.20m ,25,192,Defender - Centre-Back,right,TSG 1899 Hoffenheim,30,1,0,2611,27,0,1,2126,14,0,0,992,20,0,0,1346,7,0,0,660,Bundesliga
19-06-17,18.3.4.28,Jonathan Tah,91119700,771,11-Feb-96,21,3,0,4,0,5600,7100,7100,171,142,48509716,192,90,D RC,4,1,1,1,2,3,1,1,3,3,1,6,10,9,5,12,5,12,5,13,15,12,7,14,13,10,14,13,16,10,11,12,10,8,10,5,13,15,9,13,11,16,17,12,14,17,20,13,17,14,6,14,4,10,8,13,7,14,14,16,16,11,20,11,10,1,15,1,20,D RC,103,1,1,1,1,1,1,20,1,15,10,10,1,1,1,11,4294967296,0,0,0,0,0,0,0,0,0,0,0,0,0,0,0,0,0,0,0,0,0,0,0,0,0,0,0,0,0,0,0,0,1,0,0,0,0,0,0,0,0,0,0,0,0,0,0,0,Jonathan Tah,£27.00m ,24,195,Defender - Centre-Back,right,Bayer 04 Leverkusen,26,1,1,2296,33,0,2,2936,38,3,1,3389,39,0,1,3136,2,0,0,41,Bundesliga
19-06-17,18.3.4.28,Raphael Framberger,91122823,771,06-Sep-95,21,0,0,0,0,4200,5950,6200,129,119,8950512,179,0,D/WB R,3,3,1,1,1,4,3,1,1,3,3,10,12,11,7,9,4,7,10,15,13,10,6,13,10,14,12,10,9,13,8,9,12,7,8,11,13,13,16,14,12,11,8,9,13,17,20,15,10,12,9,14,14,10,7,10,14,10,16,14,16,4,20,20,12,12,20,1,10,D/WB R,112,1,1,1,1,1,12,1,1,20,10,10,1,12,1,20,0,0,0,0,0,0,0,0,0,0,0,0,0,0,0,0,0,0,0,0,0,0,0,0,0,0,0,0,0,0,0,0,0,0,0,0,0,0,0,0,0,0,0,0,0,0,0,0,0,Raphael Framberger,£675Th. ,25,179,Defender - Right-Back,right,FC Augsburg,5,0,1,233,12,0,0,893,8,0,0,667,18,0,2,1171,6,0,1,513,Bundesliga
19-06-17,18.3.4.28,Marius Wolf,91124151,771,27-May-95,22,0,0,0,0,4250,6500,6750,141,135,23549289,187,73,WB/M/AM RL,3,3,3,3,1,2,1,1,1,3,3,12,10,13,11,11,9,10,13,12,9,10,13,11,12,15,10,14,8,12,11,8,17,13,9,14,10,12,16,15,11,13,13,10,16,17,20,15,9,12,4,11,6,17,7,16,9,10,11,11,13,9,10,20,19,19,20,15,1,WB/M/AM RL,225,1,1,11,1,15,19,1,1,10,1,1,15,19,1,20,0,0,0,0,0,0,0,0,0,0,0,0,0,0,0,0,0,0,0,0,0,0,0,0,0,0,0,0,0,0,0,0,0,0,0,0,0,0,0,0,0,0,0,0,0,0,0,0,0,Marius Wolf,£9.00m ,25,187,Forward - Right Winger,right,1. FC Köln,13,1,1,803,34,6,11,2790,22,1,0,1258,24,1,5,1615,3,0,0,224,Bundesliga
19-06-17,18.3.4.28,Benno Schmitz,91126210,771,17-Nov-94,22,0,0,0,0,2400,6150,5900,130,123,3938463,182,75,D/WB RC,2,2,3,3,1,2,2,3,2,1,2,12,11,8,7,11,10,8,10,14,12,13,9,13,11,12,14,12,13,14,9,13,12,6,8,10,12,16,14,12,10,13,10,10,16,12,20,15,11,15,7,14,4,17,9,15,12,13,16,14,16,7,20,18,15,1,20,14,15,D/WB RC,113,1,1,1,1,1,1,10,14,20,15,15,1,1,12,18,0,0,0,0,0,0,0,0,0,0,0,0,0,0,0,0,0,0,0,0,0,0,0,0,0,0,0,0,0,0,0,0,0,0,0,0,0,0,0,0,0,0,0,0,0,0,0,0,0,Benno Schmitz,£900Th. ,25,182,Defender - Right-Back,right,1. FC Köln,17,0,2,1108,2,0,0,82,16,0,1,1322,20,0,0,1348,2,0,1,37,Bundesliga
19-06-17,18.3.4.28,Benjamin Henrichs,91132680,771,23-Feb-97,20,3,0,2,0,5050,7300,7050,167,141,45178016,183,77,D/WB/M RLC,2,4,2,1,3,3,1,1,2,4,3,9,11,12,9,15,10,8,11,13,10,14,11,13,15,12,14,15,15,10,12,13,14,9,13,10,10,16,12,12,14,14,12,14,15,12,20,15,11,13,8,16,4,18,11,16,12,15,14,14,12,8,20,16,17,14,20,18,17,D/WB/M RLC,126,1,1,1,14,10,10,1,18,20,13,17,10,10,14,16,4299161600,0,0,0,0,0,0,0,0,0,0,0,0,0,0,0,0,0,0,0,0,0,0,1,0,0,0,0,0,0,0,0,0,1,0,0,0,0,0,0,0,0,0,0,0,0,0,0,0,Benjamin Henrichs,£10.80m ,23,183,Defender - Right-Back,right,RB Leipzig,37,0,3,3069,28,0,1,1531,30,1,3,2517,15,0,0,1069,7,0,0,242,Bundesliga
19-06-17,18.3.4.28,Lukas Klostermann,91134708,771,03-Jun-96,21,0,0,5,0,4700,6700,6700,151,129,12212575,189,83,D/WB RLC,3,2,3,3,1,1,1,3,3,3,1,7,11,8,8,9,6,12,6,15,13,10,5,14,10,12,14,16,9,12,9,10,14,7,11,10,11,13,14,14,10,15,15,12,16,18,20,14,14,13,8,13,8,16,12,16,7,13,13,15,17,6,20,16,10,10,20,15,18,D/WB RLC,116,1,1,1,1,8,10,18,15,20,8,8,8,10,11,16,0,0,0,0,0,0,0,0,0,0,0,0,0,0,0,0,0,0,0,0,0,0,0,0,0,0,0,0,0,0,0,0,0,0,0,0,0,0,0,0,0,0,0,0,0,0,0,0,0,Lukas Klostermann,£10.80m ,24,189,Defender - Centre-Back,right,RB Leipzig,1,0,0,90,39,1,0,3205,40,5,3,2965,43,4,2,3634,5,0,0,334,Bundesliga
19-06-17,18.3.4.28,Patrick Kammerbauer,91138634,771,11-Feb-97,20,0,0,0,0,2500,5750,6000,127,115,6374607,174,73,D/DM/M RC,2,1,2,3,3,2,2,2,1,1,2,6,9,10,7,11,6,8,9,12,14,12,7,14,11,15,12,16,10,12,9,11,14,7,9,9,11,14,15,12,14,14,9,12,17,12,20,13,9,14,10,13,3,16,8,13,12,11,13,15,15,6,20,14,18,1,20,1,18,D/DM/M RC,123,1,1,1,1,1,1,12,1,20,18,18,1,1,1,14,0,0,0,0,0,0,0,0,0,0,0,0,0,0,0,0,0,0,0,0,0,0,0,0,0,0,0,0,0,0,0,0,0,0,0,0,0,0,0,0,0,0,0,0,0,0,0,0,0,Patrick Kammerbauer,£630Th. ,23,174,Midfielder - Defensive Midfield,right,Eintracht Braunschweig,24,1,0,1358,19,2,1,1251,8,0,0,364,23,0,1,1642,1,0,0,14,Bundesliga
19-06-17,18.3.4.28,Yanni Regäsel,91138642,771,13-Jan-96,21,0,0,0,0,2250,5750,5750,124,115,2496359,180,72,D/WB R,1,1,2,4,3,2,2,2,3,3,3,8,12,9,6,10,7,10,6,13,14,10,7,14,11,14,11,16,10,13,8,11,15,7,10,9,12,14,13,14,12,14,10,8,16,13,20,15,10,16,10,15,6,9,6,16,9,14,13,8,8,14,20,18,1,1,20,1,14,D/WB R,112,1,1,1,1,1,1,14,1,20,12,1,1,1,1,18,17179869184,0,0,0,0,0,0,0,0,0,0,0,0,0,0,0,0,0,0,0,0,0,0,0,0,0,0,0,0,0,0,0,0,0,0,1,0,0,0,0,0,0,0,0,0,0,0,0,0,,,,,,,,,,,,,,,,,,,,,,,,,,,,
19-06-17,18.3.4.28,Lukas Klünter,91143017,771,26-May-96,21,0,0,0,0,3750,6250,6250,139,125,11163974,184,73,D/WB R,1,1,1,1,4,1,3,1,1,1,1,8,11,10,9,10,7,12,9,14,13,10,9,14,11,13,10,13,9,12,9,9,12,7,8,10,12,15,13,15,11,13,12,10,16,17,20,15,10,14,8,13,7,15,8,13,13,12,14,16,14,5,20,20,13,13,20,10,14,D/WB R,112,1,7,8,1,1,13,14,10,20,8,1,1,13,8,20,0,0,0,0,0,0,0,0,0,0,0,0,0,0,0,0,0,0,0,0,0,0,0,0,0,0,0,0,0,0,0,0,0,0,0,0,0,0,0,0,0,0,0,0,0,0,0,0,0,Lukas Klünter,£2.70m ,24,184,Defender - Right-Back,right,Hertha BSC,25,2,6,2236,28,1,0,2047,12,0,0,720,24,0,2,1905,0,0,0,0,Bundesliga
19-06-17,18.3.4.28,Florian Baak,91151070,771,18-Mar-99,18,0,0,0,0,2050,4800,5050,113,96,673305,185,75,D RC,2,2,2,1,1,1,3,3,1,2,3,4,6,6,7,8,5,15,6,10,13,9,5,13,8,14,10,16,8,10,7,8,15,5,11,7,10,12,13,11,10,14,14,10,13,13,20,10,13,14,10,12,6,4,10,12,13,14,13,15,12,8,20,11,1,1,15,1,20,D RC,103,1,1,1,1,1,1,20,1,15,1,1,1,1,1,11,0,0,0,0,0,0,0,0,0,0,0,0,0,0,0,0,0,0,0,0,0,0,0,0,0,0,0,0,0,0,0,0,0,0,0,0,0,0,0,0,0,0,0,0,0,0,0,0,0,Florian Baak,£360Th. ,21,191,Defender - Centre-Back,right,FC Winterthur,23,3,0,1857,23,1,1,2023,27,5,2,2325,18,0,0,1567,9,0,0,810,Bundesliga
19-06-17,18.3.4.28,Leon Balogun,92002651,38,28-Jun-88,28,10,0,0,0,4200,6450,6200,126,124,4213024,190,81,D/WB RC,1,3,2,3,1,1,3,3,1,2,2,5,11,9,6,10,5,14,7,18,12,9,6,13,9,14,10,15,9,14,7,10,14,7,11,9,12,13,14,12,10,17,16,13,12,16,20,14,15,16,12,12,12,12,8,14,8,13,12,13,13,7,20,16,9,1,18,1,20,D/WB RC,113,1,1,1,1,1,1,20,1,18,10,9,1,1,1,16,0,0,0,0,0,0,0,0,0,0,0,0,0,0,0,0,0,0,0,0,0,0,0,0,0,0,0,0,0,0,0,0,0,0,0,0,0,0,0,0,0,0,0,0,0,0,0,0,0,Leon Balogun,£1.80m ,32,190,Defender - Centre-Back,right,Rangers FC,21,0,0,1317,15,0,0,1198,10,1,0,801,13,0,0,944,6,0,0,435,Bundesliga
19-06-17,18.3.4.28,Mitchell Weiser,92016244,771,21-Apr-94,23,0,0,12,1,6100,7100,7100,159,147,30287200,176,67,D/WB R,1,3,1,2,3,2,1,1,2,1,2,10,14,15,11,14,12,6,11,12,11,12,12,12,13,14,11,10,13,10,13,12,12,14,8,12,10,11,14,16,15,10,8,14,13,16,20,14,8,12,8,13,11,18,7,11,12,14,10,8,8,15,20,20,15,15,20,14,1,D/WB R,112,1,1,1,1,13,15,1,14,20,1,1,13,15,12,20,65536,0,0,0,0,0,0,0,0,0,0,0,0,0,0,0,0,1,0,0,0,0,0,0,0,0,0,0,0,0,0,0,0,0,0,0,0,0,0,0,0,0,0,0,0,0,0,0,0,Mitchell Weiser,£10.80m ,26,177,Defender - Right-Back,right,Bayer 04 Leverkusen,21,4,6,1450,31,2,2,2531,41,2,4,3056,28,1,0,1895,0,0,0,0,Bundesliga
19-06-17,18.3.4.28,Erik Durm,92021444,771,12-May-92,25,7,0,5,0,4350,6850,6850,139,137,15186418,183,72,D/WB RL,2,2,1,3,2,1,3,2,4,3,2,7,11,12,10,11,7,9,9,13,10,12,10,11,13,16,11,8,12,12,10,11,13,11,7,12,10,14,16,16,15,9,11,10,13,15,20,16,8,13,8,12,14,18,8,15,8,12,13,9,14,5,20,20,14,14,20,17,1,D/WB RL,115,1,1,10,1,13,14,1,17,20,1,1,13,14,17,20,0,0,0,0,0,0,0,0,0,0,0,0,0,0,0,0,0,0,0,0,0,0,0,0,0,0,0,0,0,0,0,0,0,0,0,0,0,0,0,0,0,0,0,0,0,0,0,0,0,Erik Durm,£900Th. ,28,183,Defender - Left-Back,right,Eintracht Frankfurt,20,0,3,1387,0,0,0,0,30,0,1,2217,15,0,0,821,nan,nan,nan,nan,Bundesliga
19-06-17,18.3.4.28,Danny da Costa,92028423,771,13-Jul-93,23,0,0,5,1,3200,6200,6200,131,124,6695799,187,85,D/WB R,1,2,2,3,1,2,1,3,2,3,1,6,11,12,6,11,7,10,6,15,13,10,8,13,11,15,10,15,9,11,8,9,15,8,7,11,10,12,15,14,13,15,13,10,16,18,20,14,13,13,8,11,10,14,10,13,11,12,15,14,14,4,20,20,12,12,20,1,14,D/WB R,112,1,1,1,1,1,12,14,1,20,1,1,1,12,1,20,0,0,0,0,0,0,0,0,0,0,0,0,0,0,0,0,0,0,0,0,0,0,0,0,0,0,0,0,0,0,0,0,0,0,0,0,0,0,0,0,0,0,0,0,0,0,0,0,0,Danny da Costa,£3.15m ,27,187,Defender - Right-Back,right,Eintracht Frankfurt,4,0,1,198,21,1,5,1417,50,4,5,4472,37,4,10,2496,4,0,0,178,Bundesliga
19-06-17,18.3.4.28,Jeremy Toljan,92029806,771,08-Aug-94,22,0,0,18,1,4550,7050,7050,149,141,38056360,182,76,D/WB RL,1,1,3,2,2,1,1,4,1,4,2,6,10,11,8,11,6,10,9,14,12,10,8,12,13,15,14,12,10,12,8,10,11,9,6,14,11,13,15,15,13,12,13,12,16,18,20,16,10,11,6,12,5,17,9,12,11,10,13,15,18,5,20,20,12,12,20,18,13,D/WB RL,115,1,1,1,1,11,12,13,18,20,1,1,11,12,18,20,134217728,0,0,0,0,0,0,0,0,0,0,0,0,0,0,0,0,0,0,0,0,0,0,0,0,0,0,0,1,0,0,0,0,0,0,0,0,0,0,0,0,0,0,0,0,0,0,0,0,Jeremy Toljan,£4.50m ,26,182,Defender - Right-Back,right,US Sassuolo,21,1,1,1368,27,1,2,1998,15,0,1,1031,30,1,2,2275,3,0,0,255,Bundesliga
19-06-17,18.3.4.28,Joshua Kimmich,92039023,771,08-Feb-95,22,20,2,14,2,6900,7900,7900,169,153,79337526,176,70,D/WB/DM/M RC,3,3,2,1,1,2,3,1,3,3,2,10,12,11,12,13,8,10,11,10,12,14,12,13,14,17,16,12,15,12,13,15,16,9,10,14,12,18,17,13,16,10,10,14,14,11,20,17,8,13,8,15,5,18,12,18,10,14,13,15,12,8,20,16,18,12,20,11,18,D/WB/DM/M RC,133,1,1,1,12,11,11,14,1,20,18,18,11,11,1,16,4718592,0,0,0,0,0,0,0,0,0,0,0,0,0,0,0,0,0,0,0,1,0,0,1,0,0,0,0,0,0,0,0,0,0,0,0,0,0,0,0,0,0,0,0,0,0,0,0,0,Joshua Kimmich,£49.50m ,25,176,Midfielder - Defensive Midfield,right,Bayern Munich,40,9,2,2092,47,6,17,3918,48,2,19,4281,51,7,17,4354,7,2,4,635,Bundesliga
19-06-17,18.3.4.28,Pascal Stenzel,92065838,771,20-Mar-96,21,0,0,0,0,4300,6300,6300,138,126,10717610,183,72,D/WB/DM/M RC,3,3,1,3,1,1,2,1,2,2,2,6,10,8,9,12,8,10,11,12,11,14,11,11,14,12,14,16,15,13,11,15,15,6,12,10,13,18,13,10,11,11,10,10,16,12,20,15,9,14,8,13,10,15,10,14,10,12,15,13,13,5,20,16,18,1,20,1,18,D/WB/DM/M RC,133,1,1,1,1,1,1,1,1,20,18,18,1,1,1,16,0,0,0,0,0,0,0,0,0,0,0,0,0,0,0,0,0,0,0,0,0,0,0,0,0,0,0,0,0,0,0,0,0,0,0,0,0,0,0,0,0,0,0,0,0,0,0,0,0,Pascal Stenzel,£4.50m ,24,183,Defender - Right-Back,right,VfB Stuttgart,21,1,1,1482,30,1,0,2374,24,0,3,1737,37,0,2,3142,3,0,0,270,Bundesliga
19-06-17,18.3.4.28,Felix Passlack,92071494,771,29-May-98,19,0,0,0,0,4400,6400,6400,161,128,14689581,170,74,D/WB/M/AM R,1,3,2,4,1,2,2,4,2,2,3,12,13,11,13,9,12,8,11,14,10,10,14,11,12,15,11,17,10,10,9,9,17,12,14,14,10,13,17,14,14,17,7,12,17,13,20,13,11,11,7,17,4,17,9,16,13,13,14,15,12,8,20,20,16,16,20,14,10,D/WB/M/AM R,132,1,1,1,10,13,16,1,14,20,8,10,13,16,14,20,1.44115E+17,0,0,0,0,0,0,0,0,0,0,1,0,0,0,0,0,0,0,0,0,0,0,0,0,0,0,0,1,0,0,0,0,0,0,0,0,0,0,0,0,0,0,0,0,0,0,0,0,Felix Passlack,£1.35m ,22,170,Defender - Right-Back,right,Borussia Dortmund,23,1,3,1708,19,2,1,1281,8,0,0,628,28,3,4,2477,5,1,0,276,Bundesliga
19-06-17,18.3.4.28,Robert Bauer,92071550,771,09-Apr-95,22,0,0,0,0,4550,6300,6550,136,126,11714518,183,76,D/WB/DM/M RLC,2,2,3,2,3,3,1,1,2,1,3,6,9,7,7,10,6,10,11,16,14,12,8,15,10,15,13,16,10,11,8,10,15,7,11,8,12,13,15,11,10,15,12,12,17,14,20,16,13,14,10,14,7,18,12,17,9,13,15,10,8,8,20,16,18,1,20,16,18,D/WB/DM/M RLC,136,1,1,1,1,1,1,15,16,20,18,18,1,1,12,16,0,0,0,0,0,0,0,0,0,0,0,0,0,0,0,0,0,0,0,0,0,0,0,0,0,0,0,0,0,0,0,0,0,0,0,0,0,0,0,0,0,0,0,0,0,0,0,0,0,Robert Bauer,£2.25m ,25,183,Defender - Right-Back,right,Arsenal Tula,27,1,3,2124,19,0,0,1162,24,0,0,1888,16,1,2,1226,12,0,0,1080,Bundesliga
19-06-17,18.3.4.28,Pawel Olkowski,96017865,787,13-Feb-90,27,13,0,8,0,3800,6050,6300,131,126,6154702,184,75,D/WB R,2,4,3,1,2,4,3,2,1,1,1,7,12,10,8,11,6,9,13,16,10,12,9,11,12,13,12,14,10,11,11,11,13,10,8,11,10,14,16,13,11,14,10,10,17,16,20,16,12,8,8,12,10,12,12,14,6,14,15,11,11,8,20,20,15,10,20,10,1,D/WB R,112,1,1,1,1,1,10,1,10,20,1,1,7,15,10,20,134217728,0,0,0,0,0,0,0,0,0,0,0,0,0,0,0,0,0,0,0,0,0,0,0,0,0,0,0,1,0,0,0,0,0,0,0,0,0,0,0,0,0,0,0,0,0,0,0,0,Pawel Olkowski,£900Th. ,30,184,Defender - Right-Back,right,Gaziantep FK,16,0,3,1315,14,0,0,1031,39,2,3,3279,13,0,0,861,3,0,0,219,Bundesliga
19-06-17,18.3.4.28,Nico Elvedi,98033057,798,30-Sep-96,20,4,0,1,0,4650,6650,6650,150,133,21193900,188,83,D RC,3,1,4,3,1,1,2,3,1,2,2,5,9,8,6,13,5,12,6,14,14,12,8,15,11,12,15,13,16,12,10,13,12,7,10,9,12,17,12,12,10,14,15,12,14,17,20,13,13,13,8,13,5,17,12,14,10,16,13,15,17,6,20,14,10,1,18,14,20,D RC,103,1,10,1,1,1,1,20,14,18,10,10,1,1,12,14,0,0,0,0,0,0,0,0,0,0,0,0,0,0,0,0,0,0,0,0,0,0,0,0,0,0,0,0,0,0,0,0,0,0,0,0,0,0,0,0,0,0,0,0,0,0,0,0,0,Nico Elvedi,£15.30m ,24,189,Defender - Centre-Back,right,Borussia Mönchengladbach,36,0,0,3116,36,2,3,3184,31,2,1,2715,39,1,0,3249,7,1,0,585,Bundesliga
19-06-17,18.3.4.28,Daniele Dessena,1400695,776,10-May-87,30,0,0,25,6,4250,6300,6300,134,126,6678568,183,80,DM/M RC,1,1,1,4,2,3,2,3,1,3,4,9,11,11,9,12,9,11,11,10,12,12,8,13,11,14,13,14,8,14,11,13,16,10,13,11,13,14,14,14,12,12,10,10,13,13,20,15,13,13,13,12,9,13,10,12,11,10,11,10,10,6,15,12,20,1,15,1,20,DM/M RC,423,1,1,1,1,1,1,1,1,15,18,20,1,10,1,12,1.37439E+11,0,0,0,0,0,0,0,0,1,0,0,0,0,0,0,0,0,0,0,0,0,0,0,0,0,0,0,0,0,0,0,0,0,0,0,0,0,1,0,0,0,0,0,0,0,0,0,0,Daniele Dessena,£630Th. ,33,182,Midfielder - Central Midfield,right,Brescia Calcio,21,2,0,1463,18,1,0,686,23,1,2,1104,24,2,2,1875,4,0,0,329,Serie A
19-06-17,18.3.4.28,Lorenzo De Silvestri,1401054,776,23-May-88,29,6,0,18,0,4750,6550,6550,143,131,9768428,186,84,D/WB/M R,1,1,1,1,1,1,1,1,1,1,1,8,12,10,8,12,4,15,8,14,12,12,4,13,10,14,11,16,12,12,7,12,15,4,10,14,12,15,16,14,11,13,13,8,16,15,20,17,14,14,10,13,11,12,13,13,11,12,15,14,14,13,20,18,17,1,20,9,10,D/WB/M R,122,1,1,1,1,1,1,10,9,20,1,1,8,17,8,18,2.75012E+11,0,1,0,0,0,1,0,0,0,0,0,0,0,0,0,0,0,0,0,0,0,0,0,0,0,0,0,1,0,0,0,0,0,0,0,0,0,0,1,0,0,0,0,0,0,0,0,0,Lorenzo De Silvestri,£3.60m ,32,186,Defender - Right-Back,right,Bologna FC 1909,19,1,3,1557,39,7,2,3253,34,2,4,2606,37,3,1,2984,5,1,0,411,Serie A
19-06-17,18.3.4.28,Danilo D'Ambrosio,1414241,776,09-Sep-88,28,1,0,3,0,5250,7100,7050,144,141,20945745,180,75,D/WB/M RL,2,3,2,2,3,1,3,2,2,2,2,7,13,12,11,13,7,12,9,12,12,12,6,13,12,17,12,15,12,13,10,13,12,7,6,13,12,14,15,14,13,12,10,10,14,15,20,14,12,12,12,10,10,16,13,14,11,12,15,15,14,8,20,19,18,1,20,19,13,D/WB/M RL,125,1,1,1,1,1,1,13,19,20,1,1,17,18,18,19,1.09951E+12,0,0,0,0,0,1,0,0,0,0,0,0,0,0,0,0,0,0,0,0,0,0,0,0,0,0,0,0,0,0,0,0,0,0,0,0,0,0,0,0,1,0,0,0,0,0,0,0,Danilo D'Ambrosio,£10.80m ,32,180,Defender - Right-Back,right,Inter Milan,39,3,3,3366,34,2,4,2986,38,2,6,3250,32,5,0,2095,5,2,0,371,Serie A
19-06-17,18.3.4.28,Timothy Castagne,18074558,757,05-Dec-95,21,0,0,7,1,4950,6100,6500,145,128,16784002,185,80,D/WB RC,2,1,2,2,1,1,3,3,1,1,4,8,14,10,10,12,9,8,9,12,12,12,7,12,11,14,12,12,14,14,8,13,18,12,12,11,14,15,14,14,11,10,9,8,14,14,20,14,13,13,14,14,11,12,14,12,13,10,14,11,12,1,20,19,12,1,20,13,15,D/WB RC,113,1,1,1,1,1,1,15,13,20,10,1,10,12,12,19,0,0,0,0,0,0,0,0,0,0,0,0,0,0,0,0,0,0,0,0,0,0,0,0,0,0,0,0,0,0,0,0,0,0,0,0,0,0,0,0,0,0,0,0,0,0,0,0,0,Timothy Castagne,£4.50m ,24,180,Defender - Right-Back,right,Leicester City,49,2,1,4289,26,1,3,1995,37,5,4,2671,33,2,3,2157,7,1,2,622,Serie A
19-06-17,18.3.4.28,Thiago Cionek,19050795,787,21-Apr-86,31,12,0,0,0,3000,6050,6050,124,121,232186002,183,82,D RC,1,2,2,2,2,3,2,1,3,3,1,4,9,9,9,10,6,13,4,9,14,11,9,14,11,14,13,13,13,14,6,13,15,5,12,4,14,11,14,12,11,13,12,8,14,12,20,14,13,14,10,12,5,11,14,15,15,11,17,14,11,2,20,1,1,1,16,1,20,D RC,103,1,1,1,1,1,1,20,1,16,10,1,1,1,1,1,0,0,0,0,0,0,0,0,0,0,0,0,0,0,0,0,0,0,0,0,0,0,0,0,0,0,0,0,0,0,0,0,0,0,0,0,0,0,0,0,0,0,0,0,0,0,0,0,0,Thiago Cionek,£720Th. ,34,183,Defender - Centre-Back,right,Reggina 1914,30,0,0,2387,33,2,0,2862,33,0,2,2727,30,1,2,2345,5,0,0,344,Serie A
19-06-17,18.3.4.28,Bruno Peres,19138183,1651,01-Mar-90,27,0,0,0,0,5250,6500,7000,144,139,18757606,178,72,D/WB/M RL,3,1,1,3,1,2,2,1,1,2,2,12,12,16,9,15,10,9,12,12,7,13,8,11,16,13,8,9,8,11,11,9,12,17,8,14,6,10,11,17,16,12,8,10,13,17,20,14,11,12,12,9,4,12,10,12,9,8,10,12,11,8,20,19,17,1,20,15,1,D/WB/M RL,125,1,1,1,1,1,1,1,15,20,1,1,12,17,15,19,2.39309E+15,0,1,0,0,0,0,0,0,0,0,0,0,0,0,0,0,0,0,0,0,0,0,0,0,0,0,0,1,0,0,0,0,0,0,0,0,0,0,0,1,0,0,0,0,0,0,0,1,Bruno Peres,£7.20m ,30,178,Defender - Right-Back,right,AS Roma,45,3,4,3458,43,1,1,3102,3,0,0,167,19,2,3,1173,4,1,0,153,Serie A
19-06-17,18.3.4.28,Jens Stryger Larsen,27013107,764,21-Feb-91,26,4,1,7,0,3750,6500,5950,123,119,2334898,180,81,D RL,3,1,2,2,1,2,4,3,1,1,2,10,12,11,8,10,9,6,10,7,13,11,7,9,10,17,13,14,11,7,12,11,14,11,9,11,8,12,12,14,9,11,9,10,10,15,20,14,11,8,13,11,6,17,9,18,9,8,10,10,14,14,20,15,15,15,20,15,14,D RL,105,1,1,1,13,14,15,13,15,20,14,14,13,15,12,15,268435496,0,0,0,1,0,1,0,0,0,0,0,0,0,0,0,0,0,0,0,0,0,0,0,0,0,0,0,0,1,0,0,0,0,0,0,0,0,0,0,0,0,0,0,0,0,0,0,0,Jens Stryger Larsen,£1.80m ,29,180,Defender - Right-Back,both,Udinese Calcio,43,0,3,3856,40,1,1,3430,37,1,4,3332,36,1,3,2930,nan,nan,nan,nan,Serie A
19-06-17,18.3.4.28,Loďck Landre,29022617,769,05-May-92,25,0,0,5,2,3750,5300,5300,132,106,17842,182,78,D RC,1,3,3,1,1,2,4,3,2,1,3,5,10,8,7,10,6,13,11,8,13,8,7,12,9,14,13,17,11,10,6,9,14,8,10,8,11,13,14,13,12,14,11,6,14,14,20,14,15,12,14,14,8,8,11,14,13,11,13,12,13,6,20,10,1,1,18,8,20,D RC,103,1,1,1,1,1,1,20,8,18,12,1,1,1,8,10,8.79609E+12,0,0,0,1,0,0,0,0,0,0,0,0,0,0,0,1,0,0,0,0,0,0,0,0,0,0,0,0,0,0,0,0,0,0,0,0,0,0,0,0,0,0,0,1,0,0,0,0,Loïck Landre,£180Th. ,28,182,Defender - Centre-Back,right,Nîmes Olympique,6,0,0,437,1,0,0,90,24,3,0,1726,14,1,0,1229,7,0,0,552,Serie A
19-06-17,18.3.4.28,Jacopo Sala,29024855,776,05-Dec-91,25,0,0,5,1,4400,6250,6500,141,130,8724442,181,75,D/WB/M RC,1,2,4,4,2,1,2,2,1,1,2,11,13,12,10,12,10,6,13,8,10,13,9,11,14,16,12,12,13,11,15,13,11,13,8,12,9,15,16,13,14,10,10,10,13,13,20,12,11,15,6,13,5,14,13,17,10,12,12,13,15,5,20,19,19,13,20,1,18,D/WB/M RC,123,1,1,1,1,1,13,1,1,20,1,18,1,19,1,19,4.64489E+15,0,0,0,0,0,0,0,0,0,0,1,0,0,0,0,0,0,0,0,0,0,0,0,0,0,0,0,0,0,0,0,0,0,0,0,0,0,0,0,1,0,0,0,0,0,0,0,1,Jacopo Sala,£1.35m ,28,181,Defender - Right-Back,right,Spezia Calcio,21,0,0,1658,16,0,1,1263,24,0,1,1816,16,0,0,851,4,0,0,288,Serie A
19-06-17,18.3.4.28,Benedikt Höwedes,35015879,771,29-Feb-88,29,44,2,22,3,7000,7500,7500,154,150,47167208,188,77,D RC,1,2,1,1,1,1,1,1,4,1,2,4,8,6,8,10,4,16,5,12,18,10,8,18,9,16,14,17,10,18,8,12,17,3,14,8,15,18,12,11,10,15,15,12,16,13,20,16,14,17,10,17,12,14,10,13,17,15,18,16,13,3,20,10,8,1,16,13,20,D RC,103,1,1,1,1,1,1,20,13,16,8,8,1,1,10,10,1.37439E+11,0,0,0,0,0,0,0,0,0,0,0,0,0,0,0,1,0,0,0,0,0,0,0,0,0,0,0,0,0,0,0,0,0,0,0,0,0,1,0,0,0,0,0,0,0,0,0,0,Benedikt Höwedes,£8.10m ,32,188,Defender - Centre-Back,right,Retired,46,2,4,4170,3,1,0,248,26,4,0,2000,24,0,0,2104,nan,nan,nan,nan,Serie A
19-06-17,18.3.4.28,Rick Karsdorp,37039938,784,11-Feb-95,22,3,0,0,0,5400,6750,6750,156,138,23827135,182,80,D/WB R,2,1,1,1,2,3,2,1,1,3,1,9,14,11,6,12,8,9,7,11,13,13,9,12,13,13,13,15,13,11,13,11,15,8,8,16,11,17,18,13,13,14,11,10,13,15,20,17,13,14,6,11,13,14,11,13,13,14,13,12,10,11,20,17,12,1,20,8,10,D/WB R,112,1,1,1,1,1,1,10,8,20,14,10,6,12,7,17,1048586,0,1,0,1,0,0,0,0,0,0,0,0,0,0,0,0,0,0,0,0,1,0,0,0,0,0,0,0,0,0,0,0,0,0,0,0,0,0,0,0,0,0,0,0,0,0,0,0,Rick Karsdorp,£8.10m ,25,184,Defender - Right-Back,right,AS Roma,42,1,7,3580,1,0,0,82,14,0,0,761,24,2,5,1818,3,0,0,183,Serie A
19-06-17,18.3.4.28,Hans Hateboer,37046941,784,09-Jan-94,23,0,0,8,2,4250,5750,6200,134,124,7102905,187,74,D/WB RC,2,1,2,3,2,1,1,2,3,2,3,8,12,9,4,12,7,12,5,8,12,11,7,14,11,16,13,13,13,13,9,13,16,10,10,13,12,14,15,12,13,15,11,7,13,14,20,14,15,12,7,11,5,11,15,14,13,12,13,10,12,7,20,19,13,5,20,1,15,D/WB RC,113,1,1,1,1,1,5,15,1,20,10,1,1,13,1,19,8.79609E+12,0,1,0,0,0,1,0,0,0,0,0,0,0,0,0,0,0,0,0,0,0,0,0,0,0,0,0,0,0,0,0,0,0,0,0,0,0,0,0,0,0,0,0,1,0,0,0,0,Hans Hateboer,£6.30m ,26,185,Defender - Right-Back,right,Atalanta BC,27,2,5,2178,43,0,2,3275,43,6,6,3723,42,2,6,3033,5,2,0,390,Serie A
19-06-17,18.3.4.28,Davide Faraoni,43008971,776,25-Oct-91,25,0,0,7,0,3500,6000,6000,128,120,4182600,180,80,D/WB/M R,1,1,1,1,1,1,1,1,1,1,1,13,13,13,6,11,8,10,12,11,12,12,8,13,11,10,11,11,11,10,10,10,14,9,8,13,13,14,14,13,12,12,10,13,14,14,20,13,12,14,13,13,8,7,11,15,11,13,14,12,10,8,19,19,20,9,20,8,3,D/WB/M R,432,1,1,1,1,1,9,3,8,19,1,1,8,20,7,19,0,0,0,0,0,0,0,0,0,0,0,0,0,0,0,0,0,0,0,0,0,0,0,0,0,0,0,0,0,0,0,0,0,0,0,0,0,0,0,0,0,0,0,0,0,0,0,0,0,Davide Faraoni,£900Th. ,29,180,Defender - Right-Back,right,Hellas Verona,7,1,0,464,30,2,3,1918,39,4,4,3104,37,5,3,3317,5,0,1,450,Serie A
19-06-17,18.3.4.28,Davide Santon,43016424,776,02-Jan-91,26,8,0,17,0,5300,6500,6750,144,135,11125467,186,83,D/WB RL,2,3,1,2,1,3,3,1,3,2,1,11,13,12,8,12,8,11,10,11,12,11,10,13,13,13,14,12,12,10,11,11,14,10,9,13,12,13,15,15,13,14,12,12,13,14,20,14,13,10,11,13,10,14,13,13,12,11,14,14,17,5,20,17,7,1,19,20,12,D/WB RL,115,1,1,1,1,1,1,12,20,19,1,1,7,7,17,15,5.49756E+11,0,0,0,0,0,1,0,0,0,0,0,0,0,0,0,0,0,0,0,0,0,0,0,0,0,0,0,0,0,0,0,0,0,0,0,0,0,0,0,1,0,0,0,0,0,0,0,0,Davide Santon,£2.70m ,29,187,Defender - Right-Back,right,AS Roma,15,0,1,1108,15,0,1,834,21,0,2,1293,21,0,0,973,4,0,0,249,Serie A
19-06-17,18.3.4.28,Antonio Caracciolo,43020293,776,30-Jun-90,26,0,0,0,0,1750,5800,5800,130,116,2775466,185,73,D/WB RC,2,1,3,1,3,2,2,2,3,3,3,6,12,10,7,10,7,12,8,11,12,11,7,13,12,12,12,10,13,11,9,13,8,11,7,12,12,10,11,12,12,12,13,10,13,14,20,14,13,16,10,13,14,13,10,10,10,5,8,7,5,4,20,17,1,1,17,1,20,D/WB RC,113,1,1,1,1,1,1,20,1,17,1,1,1,1,1,17,2,0,1,0,0,0,0,0,0,0,0,0,0,0,0,0,0,0,0,0,0,0,0,0,0,0,0,0,0,0,0,0,0,0,0,0,0,0,0,0,0,0,0,0,0,0,0,0,0,Antonio Caracciolo,£720Th. ,30,185,Defender - Centre-Back,right,AC Pisa 1909,35,0,0,2870,33,2,0,2855,29,3,0,2472,33,0,0,2911,5,1,0,450,Serie A
19-06-17,18.3.4.28,Leonardo Spinazzola,43036586,776,25-Mar-93,24,3,0,0,0,4500,7350,7150,154,143,33856104,186,75,D/WB/M RL,1,3,2,1,1,3,2,3,3,3,1,6,13,13,7,13,6,10,8,8,11,11,8,12,13,9,13,11,9,9,11,11,12,14,7,13,11,12,13,16,13,12,12,12,16,17,20,15,12,12,7,12,5,18,15,15,10,12,12,12,7,5,20,20,19,13,15,20,10,D/WB/M RL,125,1,1,1,1,13,12,1,20,13,1,10,19,15,20,15,134234112,0,0,0,0,0,0,0,0,0,0,0,0,0,0,1,0,0,0,0,0,0,0,0,0,0,0,0,1,0,0,0,0,0,0,0,0,0,0,0,0,0,0,0,0,0,0,0,0,Leonardo Spinazzola,£10.80m ,27,186,Defender - Left-Back,right,AS Roma,32,0,4,2680,25,0,4,2137,14,1,1,912,32,2,3,2160,6,0,0,494,Serie A
19-06-17,18.3.4.28,Mattia De Sciglio,43037008,776,20-Oct-92,24,31,0,5,0,5750,7050,7150,151,142,22877426,182,78,D/WB RL,4,3,1,2,1,1,2,3,3,3,1,6,13,12,2,13,5,12,6,12,14,13,8,14,13,12,13,12,13,14,11,12,13,5,10,12,14,15,13,15,14,13,12,12,12,15,20,13,11,12,11,10,14,15,9,14,14,11,12,19,17,9,20,18,13,1,20,20,8,D/WB RL,115,1,1,1,1,1,1,8,20,20,1,1,13,13,17,18,1.09951E+12,0,0,0,0,0,0,0,0,0,0,0,0,0,0,0,0,0,0,0,0,0,0,0,0,0,0,0,0,0,0,0,0,0,0,0,0,0,0,0,0,1,0,0,0,0,0,0,0,Mattia De Sciglio,£12.60m ,28,183,Defender - Right-Back,right,Olympique Lyon,27,0,1,2301,20,1,0,1484,28,0,1,2231,13,0,0,774,3,0,0,49,Serie A
19-06-17,18.3.4.28,Alessandro Florenzi,43041177,776,11-Mar-91,26,24,2,18,5,6100,7700,7700,162,154,119548505,173,67,D/WB/M/AM RC,3,3,3,1,1,3,1,2,3,1,2,14,14,12,13,14,12,10,16,6,8,13,12,9,14,14,13,14,13,13,12,12,18,16,12,15,9,15,16,16,15,11,8,10,16,15,20,15,9,15,8,16,14,20,5,16,19,16,18,20,18,3,18,16,20,17,20,14,18,D/WB/M/AM RC,443,1,1,1,12,14,17,1,10,18,5,18,10,20,10,16,4.39818E+12,0,1,0,0,0,0,0,0,1,0,0,1,0,0,1,0,0,0,0,0,0,0,0,0,0,0,0,1,0,0,0,0,0,0,0,0,0,0,0,0,0,0,1,0,0,0,0,0,Alessandro Florenzi,£27.00m ,29,173,Defender - Right-Back,right,Paris Saint-Germain,13,1,3,955,42,1,4,3095,38,3,3,2891,32,0,1,2014,6,2,0,499,Serie A
19-06-17,18.3.4.28,Gaetano Letizia,43049523,776,29-Jun-90,26,0,0,0,0,2250,6200,6200,136,124,2428344,173,63,D/WB RL,3,3,1,3,2,2,2,2,4,1,1,6,14,12,6,11,8,7,8,9,11,11,6,12,11,13,13,12,12,10,15,11,12,8,12,13,11,13,12,15,15,12,7,8,10,13,20,14,11,13,6,12,5,17,11,16,12,11,13,7,12,11,20,18,13,1,20,17,11,D/WB RL,115,1,1,1,1,1,1,11,17,20,1,1,11,13,13,18,7.03687E+13,0,0,0,0,0,1,0,0,0,0,0,0,0,0,0,0,0,0,0,0,0,0,0,0,0,0,0,0,0,0,0,0,0,0,0,0,0,0,0,0,0,0,0,0,0,0,1,0,Gaetano Letizia,£1.35m ,30,173,Defender - Right-Back,both,Benevento Calcio,46,2,3,4031,30,1,0,2233,32,1,1,2567,32,1,5,2789,5,1,0,413,Serie A
19-06-17,18.3.4.28,Matteo Bianchetti,43055102,776,17-Mar-93,24,0,0,21,0,4000,5950,5950,135,119,4512829,189,82,D RC,3,3,1,1,1,3,3,1,2,3,3,7,8,4,6,9,7,14,7,12,14,12,5,14,8,13,14,15,12,15,8,12,15,3,14,5,14,12,13,12,10,11,13,7,12,10,20,12,14,15,13,13,12,10,12,13,14,12,15,12,12,5,20,15,1,1,17,1,20,D RC,103,1,1,1,1,1,1,20,1,17,1,1,1,1,1,15,8.79609E+12,0,0,0,0,0,0,0,0,0,0,0,0,0,0,0,0,0,0,0,0,0,0,0,0,0,0,0,0,0,0,0,0,0,0,0,0,0,0,0,0,0,0,0,1,0,0,0,0,Matteo Bianchetti,£720Th. ,27,189,Defender - Centre-Back,right,US Cremonese,37,0,2,3326,4,0,0,293,21,1,0,1747,36,1,2,3123,4,0,0,360,Serie A
19-06-17,18.3.4.28,Mario Sampirisi,43061338,776,31-Oct-92,24,0,0,1,0,3750,5900,5900,130,118,3918038,188,75,D/WB RC,2,2,3,1,3,2,2,3,3,2,1,6,14,10,8,10,6,13,6,10,14,12,6,13,12,11,11,11,14,12,7,10,14,7,8,6,12,14,14,13,13,13,15,8,15,13,20,14,13,12,8,8,6,14,11,13,12,13,12,11,10,5,20,16,1,1,20,10,18,D/WB RC,113,1,1,1,1,1,1,18,10,20,1,1,1,1,9,16,0,0,0,0,0,0,0,0,0,0,0,0,0,0,0,0,0,0,0,0,0,0,0,0,0,0,0,0,0,0,0,0,0,0,0,0,0,0,0,0,0,0,0,0,0,0,0,0,0,Mario Sampirisi,£810Th. ,27,188,Defender - Right-Back,right,AC Monza,23,1,1,1193,31,0,0,2192,36,0,1,3066,19,1,1,1292,3,0,0,240,Serie A
19-06-17,18.3.4.28,Francesco Zampano,43072156,776,30-Sep-93,23,0,0,0,0,3500,5950,5950,132,119,5077477,177,68,D/WB/M RL,3,1,3,2,3,3,2,3,2,3,4,9,12,11,6,12,7,6,11,13,10,10,7,12,13,10,9,13,12,9,10,10,15,10,12,12,10,12,14,15,12,14,8,7,14,14,20,14,12,16,6,14,5,15,12,16,15,12,16,16,12,2,20,18,17,1,20,15,1,D/WB/M RL,125,1,1,1,1,1,1,1,15,20,1,1,13,17,14,18,0,0,0,0,0,0,0,0,0,0,0,0,0,0,0,0,0,0,0,0,0,0,0,0,0,0,0,0,0,0,0,0,0,0,0,0,0,0,0,0,0,0,0,0,0,0,0,0,0,Francesco Zampano,£1.62m ,27,177,Defender - Right-Back,right,Frosinone Calcio,36,0,6,3060,19,0,8,1579,28,0,2,2225,25,1,0,1393,5,0,0,320,Serie A
19-06-17,18.3.4.28,Vincent Laurini,43073457,769,10-Jun-89,28,0,0,0,0,3500,6150,6150,131,123,4824646,173,72,D/WB R,2,1,3,2,2,3,3,1,2,1,2,5,13,11,5,12,5,10,7,11,11,9,7,13,10,12,13,13,13,12,11,13,13,9,10,12,11,15,15,14,14,12,9,10,13,15,20,14,12,15,10,11,13,11,15,12,14,13,15,14,12,7,20,17,10,1,20,9,5,D/WB R,112,1,1,1,1,1,1,5,9,20,1,1,1,10,1,17,0,0,0,0,0,0,0,0,0,0,0,0,0,0,0,0,0,0,0,0,0,0,0,0,0,0,0,0,0,0,0,0,0,0,0,0,0,0,0,0,0,0,0,0,0,0,0,0,0,Vincent Laurini,£1.80m ,31,173,Defender - Right-Back,right,Parma Calcio 1913,25,0,0,2009,23,0,1,1707,17,0,0,998,18,0,3,1129,3,0,0,243,Serie A
19-06-17,18.3.4.28,Ibrahima Mbaye,43078377,41,19-Nov-94,22,1,0,6,0,3500,6100,6100,140,122,6986355,188,70,D/WB/M RL,1,2,1,1,3,2,1,1,3,1,3,7,11,11,8,11,4,11,7,12,12,11,8,16,11,14,12,11,10,11,9,10,13,6,7,10,12,10,12,14,11,13,14,10,13,13,20,14,14,13,14,11,9,16,13,13,11,15,14,12,12,9,20,19,17,1,20,17,10,D/WB/M RL,125,1,1,1,1,1,1,10,17,20,1,1,15,17,16,19,0,0,0,0,0,0,0,0,0,0,0,0,0,0,0,0,0,0,0,0,0,0,0,0,0,0,0,0,0,0,0,0,0,0,0,0,0,0,0,0,0,0,0,0,0,0,0,0,0,Ibrahima Mbaye,£2.97m ,25,188,Defender - Right-Back,right,Bologna FC 1909,17,0,1,1186,25,1,0,1748,25,2,0,2102,21,0,4,1596,1,0,0,26,Serie A
19-06-17,18.3.4.28,Edoardo Goldaniga,43080121,776,02-Nov-93,23,0,0,2,0,4000,6400,6400,150,128,11940900,188,80,D RC,1,3,1,3,1,1,1,1,1,2,1,4,6,11,6,12,4,15,5,10,13,12,8,14,12,15,16,13,12,10,11,13,15,7,15,6,14,12,12,13,12,15,12,10,13,13,20,12,13,12,10,18,6,10,13,14,15,15,17,14,10,7,20,14,1,1,15,12,20,D RC,103,1,1,1,1,1,1,20,12,15,1,1,1,1,1,14,1.75922E+13,0,0,0,0,0,0,0,0,0,0,0,0,0,0,0,1,0,0,0,0,0,0,0,0,0,0,0,0,0,0,0,0,0,0,0,0,0,0,0,0,0,0,0,0,1,0,0,0,Edoardo Goldaniga,£2.70m ,26,193,Defender - Centre-Back,both,Genoa CFC,30,2,0,2568,14,1,0,1246,30,1,1,2700,14,1,0,900,4,0,1,291,Serie A
19-06-17,18.3.4.28,Andrea Conti,43081379,776,02-Mar-94,23,0,0,17,1,5000,7150,7150,158,143,38156654,184,76,D/WB/M R,2,3,2,1,3,3,1,1,1,4,2,6,13,11,12,13,5,14,9,13,12,13,7,14,14,10,15,14,13,13,12,12,15,12,10,15,14,14,13,14,13,15,13,12,15,15,20,15,12,15,13,15,5,13,12,17,9,12,13,12,8,8,20,19,18,5,20,5,1,D/WB/M R,122,1,1,1,1,1,5,1,5,20,1,1,5,18,5,19,34,0,1,0,0,0,1,0,0,0,0,0,0,0,0,0,0,0,0,0,0,0,0,0,0,0,0,0,0,0,0,0,0,0,0,0,0,0,0,0,0,0,0,0,0,0,0,0,0,Andrea Conti,£13.50m ,26,184,Defender - Right-Back,right,AC Milan,35,8,5,2767,5,0,0,333,16,0,3,635,26,0,2,2025,0,0,0,0,Serie A
19-06-17,18.3.4.28,Elseid Hysaj,43083951,752,02-Feb-94,23,29,0,4,0,5000,7300,7300,154,146,72732763,182,70,D RL,1,1,2,4,3,1,3,1,2,1,2,8,13,10,5,13,5,11,9,11,14,13,7,15,12,15,12,15,13,13,12,13,12,8,10,14,14,15,15,15,15,14,11,10,16,15,20,17,14,15,6,13,6,13,15,14,13,14,14,13,13,7,20,15,9,1,20,16,1,D RL,105,1,1,1,1,1,1,1,16,20,1,1,5,9,10,15,0,0,0,0,0,0,0,0,0,0,0,0,0,0,0,0,0,0,0,0,0,0,0,0,0,0,0,0,0,0,0,0,0,0,0,0,0,0,0,0,0,0,0,0,0,0,0,0,0,Elseid Hysaj,£22.50m ,26,182,Defender - Right-Back,right,SSC Napoli,45,0,0,3854,47,0,1,4087,35,0,2,2707,24,1,2,1692,4,0,1,329,Serie A
19-06-17,18.3.4.28,Federico Mattiello,43085786,776,14-Jul-95,21,0,0,0,0,2750,5750,6000,143,120,4627607,182,77,D/WB/M RL,1,1,2,1,2,1,2,1,1,2,3,7,12,12,6,11,6,10,9,13,12,12,5,12,12,13,12,13,13,13,5,11,16,11,6,12,12,14,14,14,13,12,10,20,9,14,7,13,10,15,6,8,15,16,9,13,11,12,14,13,13,5,20,19,18,8,20,17,1,D/WB/M RL,125,1,1,1,1,7,8,1,17,20,1,1,15,18,16,19,0,0,0,0,0,0,0,0,0,0,0,0,0,0,0,0,0,0,0,0,0,0,0,0,0,0,0,0,0,0,0,0,0,0,0,0,0,0,0,0,0,0,0,0,0,0,0,0,0,Federico Mattiello,£2.25m ,25,184,Defender - Right-Back,right,Spezia Calcio,7,2,4,630,31,0,0,2259,19,1,2,1495,18,0,1,925,nan,nan,nan,nan,Serie A
19-06-17,18.3.4.28,Mattia Bani,43091093,776,10-Dec-93,23,0,0,0,0,1250,5600,5750,132,115,2865546,188,81,D RC,2,1,1,2,4,2,3,3,1,1,1,8,10,9,8,11,7,12,8,10,13,11,8,14,12,10,13,12,12,12,11,12,12,8,10,11,13,14,12,12,12,11,12,8,12,12,20,14,12,12,10,13,8,12,10,13,14,12,14,15,12,8,20,15,1,1,16,1,20,D RC,103,1,1,1,1,1,1,20,1,16,1,1,1,1,1,15,0,0,0,0,0,0,0,0,0,0,0,0,0,0,0,0,0,0,0,0,0,0,0,0,0,0,0,0,0,0,0,0,0,0,0,0,0,0,0,0,0,0,0,0,0,0,0,0,0,Mattia Bani,£2.25m ,26,188,Defender - Centre-Back,right,Genoa CFC,38,0,1,3336,18,0,0,1526,31,0,0,2627,27,4,0,2211,2,0,0,159,Serie A
19-06-17,18.3.4.28,Alex Ferrari,43093049,776,01-Jul-94,22,0,0,7,0,1350,6550,6000,136,120,5496321,191,80,D/WB RC,1,3,3,2,3,2,2,3,3,1,2,10,10,13,9,11,11,14,9,9,14,12,8,13,12,11,14,12,13,11,10,12,13,12,9,10,13,11,11,13,11,12,13,6,12,13,20,13,13,11,10,10,7,11,11,12,11,12,8,8,10,8,20,16,1,1,18,1,20,D/WB RC,113,1,1,1,1,1,1,20,1,18,1,1,1,1,1,16,0,0,0,0,0,0,0,0,0,0,0,0,0,0,0,0,0,0,0,0,0,0,0,0,0,0,0,0,0,0,0,0,0,0,0,0,0,0,0,0,0,0,0,0,0,0,0,0,0,Alex Ferrari,£1.35m ,26,191,Defender - Centre-Back,right,UC Sampdoria,14,0,1,1219,27,1,0,2295,7,0,0,660,13,0,0,1050,0,0,0,0,Serie A
19-06-17,18.3.4.28,Lorenzo Venuti,43093519,776,12-Apr-95,22,0,0,1,0,1750,6000,6000,140,120,402400,176,66,D/WB RL,4,3,4,3,2,1,4,1,3,1,2,8,14,9,6,10,7,10,10,12,13,11,9,13,12,11,10,13,12,10,10,11,14,7,10,10,10,14,12,14,14,12,10,14,11,13,20,14,12,13,8,11,12,12,10,14,12,10,13,14,10,2,20,16,10,1,20,15,13,D/WB RL,115,1,1,1,1,1,1,13,15,20,1,1,10,10,13,16,0,0,0,0,0,0,0,0,0,0,0,0,0,0,0,0,0,0,0,0,0,0,0,0,0,0,0,0,0,0,0,0,0,0,0,0,0,0,0,0,0,0,0,0,0,0,0,0,0,Lorenzo Venuti,£1.35m ,25,179,Defender - Right-Back,right,ACF Fiorentina,41,0,2,3396,32,0,1,2405,32,3,3,2369,18,0,2,895,2,0,0,12,Serie A
19-06-17,18.3.4.28,Paolo Faragň,43094009,776,12-Feb-93,24,0,0,0,0,2250,5900,5900,130,118,4378982,187,84,M RC,3,3,1,3,3,2,3,1,1,1,1,4,12,12,11,14,7,13,10,5,7,12,6,10,11,8,13,14,13,13,12,13,13,12,7,13,10,13,13,13,11,12,16,9,12,13,20,13,13,15,5,12,7,14,14,15,13,12,13,15,13,5,14,15,20,14,18,10,20,M RC,403,1,1,1,14,8,13,1,1,14,12,20,10,18,1,15,7.20579E+16,0,0,0,1,0,0,1,0,0,0,0,0,0,0,0,0,0,0,0,0,1,0,0,0,0,0,0,0,0,0,0,0,0,0,0,0,0,0,1,0,0,0,0,0,0,0,0,0,Paolo Faragò,£5.40m ,27,187,Midfielder - Right Midfield,right,Cagliari Calcio,32,5,1,2439,36,2,6,2568,29,1,3,1967,22,1,1,1428,4,0,0,176,Serie A
19-06-17,18.3.4.28,Kevin Bonifazi,43094128,776,19-May-96,21,0,0,0,0,2600,6300,6300,149,126,11414416,187,84,D RC,3,2,2,1,3,3,2,1,1,2,2,5,5,10,10,6,8,12,7,13,13,11,4,13,12,12,14,10,13,13,10,14,12,9,9,12,14,10,11,14,13,12,15,8,14,13,20,12,14,13,13,12,6,6,12,11,14,13,12,13,11,7,20,1,1,1,17,1,20,D RC,103,1,1,1,1,1,1,20,1,17,1,1,1,1,1,1,0,0,0,0,0,0,0,0,0,0,0,0,0,0,0,0,0,0,0,0,0,0,0,0,0,0,0,0,0,0,0,0,0,0,0,0,0,0,0,0,0,0,0,0,0,0,0,0,0,Kevin Bonifazi,£1.35m ,24,187,Defender - Centre-Back,right,Udinese Calcio,20,3,0,1648,7,0,0,497,28,2,0,2393,21,3,0,1753,1,0,0,8,Serie A
19-06-17,18.3.4.28,Davide Biraschi,43094277,776,02-Jul-94,22,0,0,3,0,3250,5900,5900,135,118,4653547,182,73,D RC,4,2,2,1,1,2,1,3,1,1,4,5,7,5,5,7,7,15,4,8,14,10,7,14,9,14,14,13,12,11,9,11,12,1,10,11,13,14,14,13,12,12,11,6,11,12,20,13,17,11,14,11,8,8,8,11,11,10,13,9,13,7,20,11,1,1,15,8,20,D RC,103,1,1,1,1,1,1,20,8,15,12,1,1,1,1,11,32768,0,0,0,0,0,0,0,0,0,0,0,0,0,0,0,1,0,0,0,0,0,0,0,0,0,0,0,0,0,0,0,0,0,0,0,0,0,0,0,0,0,0,0,0,0,0,0,0,Davide Biraschi,£1.08m ,26,182,Defender - Centre-Back,right,Genoa CFC,10,0,0,646,26,0,1,2046,36,0,2,3053,26,0,1,2181,2,0,0,180,Serie A
19-06-17,18.3.4.28,Manuel Lazzari,43096538,776,29-Nov-93,23,0,0,0,0,3500,6300,6400,145,128,3680082,174,65,WB/M R,2,1,1,1,3,1,4,2,2,1,1,10,13,14,6,12,6,4,8,5,9,13,7,12,11,11,14,16,12,10,13,14,15,13,8,11,11,13,14,18,14,9,7,8,15,12,20,15,9,17,5,13,6,15,13,15,16,12,13,10,13,8,10,19,20,13,20,1,1,WB/M R,422,1,1,1,1,1,13,1,1,10,1,1,1,20,1,19,2,0,1,0,0,0,0,0,0,0,0,0,0,0,0,0,0,0,0,0,0,0,0,0,0,0,0,0,0,0,0,0,0,0,0,0,0,0,0,0,0,0,0,0,0,0,0,0,0,Manuel Lazzari,£5.40m ,26,174,Midfielder - Right Midfield,right,SS Lazio,41,0,7,3490,38,2,1,3178,34,0,9,2932,40,1,4,3275,4,1,0,299,Serie A
19-06-17,18.3.4.28,Cristian Barillari,43122938,776,27-Aug-95,21,0,0,0,0,500,3750,3750,90,75,111171,168,66,D/WB R,2,2,1,1,1,1,1,2,3,3,1,4,9,9,7,9,8,9,7,11,9,8,4,9,8,10,10,9,9,8,7,9,11,7,4,9,10,11,12,11,12,11,9,20,15,12,6,11,10,12,8,5,9,12,9,8,8,9,10,11,8,9,20,18,15,1,20,1,1,D/WB R,112,1,1,1,1,1,1,1,1,20,1,1,1,15,1,18,0,0,0,0,0,0,0,0,0,0,0,0,0,0,0,0,0,0,0,0,0,0,0,0,0,0,0,0,0,0,0,0,0,0,0,0,0,0,0,0,0,0,0,0,0,0,0,0,0,,,,,,,,,,,,,,,,,,,,,,,,,,,,
19-06-17,18.3.4.28,Davide Calabria,43123020,776,06-Dec-96,20,0,0,1,0,3250,6600,6550,153,130,17439714,177,70,D/WB RL,3,3,2,3,1,1,2,2,2,3,3,6,13,12,4,12,2,7,8,7,13,12,6,13,12,13,14,14,12,13,11,11,15,5,9,13,12,16,13,15,16,12,9,12,16,14,20,12,10,13,8,7,10,14,19,14,17,12,14,17,14,4,20,18,14,1,20,16,1,D/WB RL,115,1,1,1,1,1,1,1,16,20,1,1,10,14,12,18,1.09951E+12,0,0,0,0,0,0,0,0,0,0,0,0,0,0,0,0,0,0,0,0,0,0,0,0,0,0,0,0,0,0,0,0,0,0,0,0,0,0,0,0,1,0,0,0,0,0,0,0,Davide Calabria,£11.70m ,23,176,Defender - Right-Back,right,AC Milan,13,0,1,999,30,1,3,2368,33,1,1,2535,27,1,1,1827,8,0,0,750,Serie A
19-06-17,18.3.4.28,Claud Adjapong,43202413,776,06-May-98,19,0,0,0,0,2750,5650,5950,142,119,8077310,180,74,D/WB R,3,1,1,3,3,2,1,3,1,1,2,11,13,11,7,8,10,11,7,11,12,12,5,11,10,11,11,11,11,12,10,12,14,11,8,9,11,9,10,14,12,11,11,9,13,15,20,14,14,11,12,9,5,10,13,14,13,13,13,12,14,3,20,20,15,15,20,12,8,D/WB R,112,1,1,1,3,1,15,1,12,20,8,8,10,15,11,20,0,0,0,0,0,0,0,0,0,0,0,0,0,0,0,0,0,0,0,0,0,0,0,0,0,0,0,0,0,0,0,0,0,0,0,0,0,0,0,0,0,0,0,0,0,0,0,0,0,Claud Adjapong,£3.60m ,22,180,Defender - Right-Back,right,US Lecce,21,3,1,1532,17,0,1,1311,6,1,0,315,5,0,0,228,5,0,0,365,Serie A
19-06-17,18.3.4.28,Bright Gyamfi,43207789,21,20-Jan-96,21,0,0,0,0,1600,5650,5650,138,113,2293757,178,0,D/WB RC,3,3,1,3,1,1,2,3,2,2,2,7,13,11,9,11,9,9,9,13,12,12,9,12,10,13,12,11,12,13,10,11,11,12,9,13,11,11,11,14,12,11,9,10,12,13,20,11,13,12,10,11,10,11,12,10,10,9,11,10,10,10,20,18,7,1,20,10,15,D/WB RC,113,1,1,1,1,1,1,15,10,20,7,7,1,1,1,18,0,0,0,0,0,0,0,0,0,0,0,0,0,0,0,0,0,0,0,0,0,0,0,0,0,0,0,0,0,0,0,0,0,0,0,0,0,0,0,0,0,0,0,0,0,0,0,0,0,Bright Gyamfi,£360Th. ,24,178,Defender - Right-Back,right,AC Reggiana 1919,23,0,1,1258,9,0,0,318,10,0,0,836,4,0,0,326,5,0,0,375,Serie A
19-06-17,18.3.4.28,Bruno Gaspar,55027972,788,21-Apr-93,24,0,0,1,0,4500,6100,6100,134,122,3970662,180,70,D/WB RL,3,3,2,1,1,1,2,1,3,1,2,8,14,10,8,11,6,10,7,11,11,11,8,13,13,14,12,13,11,11,10,12,14,11,12,13,12,12,14,14,13,11,8,12,12,14,20,13,10,13,14,10,12,14,7,12,12,12,15,12,14,6,20,18,10,7,20,18,1,D/WB RL,115,1,1,1,1,1,7,1,18,20,1,1,1,10,13,18,0,0,0,0,0,0,0,0,0,0,0,0,0,0,0,0,0,0,0,0,0,0,0,0,0,0,0,0,0,0,0,0,0,0,0,0,0,0,0,0,0,0,0,0,0,0,0,0,0,Bruno Gaspar,£2.70m ,27,180,Defender - Right-Back,right,Sporting CP,36,0,6,2989,17,0,2,935,30,1,0,2062,21,0,1,1258,nan,nan,nan,nan,Serie A
19-06-17,18.3.4.28,Joăo Cancelo,55041623,788,27-May-94,23,0,0,8,1,6000,7100,7300,164,146,47022132,182,72,D/WB/M/AM R,3,1,3,3,3,1,1,3,3,3,2,10,14,14,12,14,11,8,14,10,8,14,12,11,14,12,12,11,9,7,13,9,7,15,6,13,8,10,11,18,15,12,12,12,15,15,20,13,12,5,12,10,7,14,10,12,12,10,12,12,10,11,20,18,17,17,20,10,1,D/WB/M/AM R,132,1,1,1,1,1,17,1,10,20,1,1,5,17,9,18,8.86495E+12,0,1,0,0,0,1,0,0,0,0,0,0,0,0,0,0,0,0,0,0,0,0,0,0,0,0,0,1,0,0,0,0,0,0,0,0,1,0,0,0,0,0,0,1,0,0,0,0,João Cancelo,£31.50m ,26,182,Defender - Right-Back,right,Manchester City,38,1,4,2695,29,1,4,2178,34,1,5,2599,33,1,1,2356,3,0,1,270,Serie A
19-06-17,18.3.4.28,Pedro Pereira,55082273,788,22-Jan-98,19,0,0,0,0,2500,5650,5650,122,113,731499,182,69,D/WB R,1,3,3,3,1,2,1,3,1,2,3,8,13,12,8,12,8,12,10,14,10,10,8,11,10,12,12,14,10,12,10,12,14,8,6,8,11,12,14,14,12,10,11,7,15,14,20,15,11,15,12,10,8,16,10,16,12,8,16,12,16,5,20,17,9,1,20,13,1,D/WB R,112,1,1,1,1,1,1,1,13,20,1,1,5,9,10,17,0,0,0,0,0,0,0,0,0,0,0,0,0,0,0,0,0,0,0,0,0,0,0,0,0,0,0,0,0,0,0,0,0,0,0,0,0,0,0,0,0,0,0,0,0,0,0,0,0,Pedro Pereira,£1.80m ,22,185,Midfielder - Right Midfield,right,FC Crotone,13,0,0,876,7,0,0,471,27,0,0,1436,22,2,1,1342,4,0,0,307,Serie A
19-06-17,18.3.4.28,Stephan Lichtsteiner,5723486,798,16-Jan-84,33,90,6,30,1,6000,7750,7250,159,145,8168538,182,76,D/WB/M R,3,4,1,2,3,3,1,4,2,2,1,4,12,12,10,11,2,12,10,10,15,14,5,14,12,19,14,20,16,16,11,14,20,8,13,15,16,16,17,13,13,14,11,9,15,14,20,14,14,16,16,14,7,11,15,13,15,15,14,6,7,12,20,19,18,6,20,1,7,D/WB/M R,122,1,1,1,1,1,6,7,1,20,1,1,1,18,1,19,229410,0,1,0,0,0,1,0,0,0,0,0,0,0,0,0,1,1,1,0,0,0,0,0,0,0,0,0,0,0,0,0,0,0,0,0,0,0,0,0,0,0,0,0,0,0,0,0,0,Stephan Lichtsteiner,£1.35m ,36,182,Defender - Right-Back,right,Retired,30,1,3,2196,32,0,3,2018,23,1,1,1732,20,0,1,1346,nan,nan,nan,nan,Serie A
19-06-17,18.3.4.28,Darko Lazovic,5747078,802,15-Sep-90,26,6,0,10,5,4500,6350,6350,137,127,5694068,181,66,WB/M/AM RL,2,1,3,2,1,4,1,3,2,3,3,13,12,13,10,13,12,9,13,5,5,13,11,9,13,10,12,8,11,11,13,11,10,15,11,13,8,11,12,14,13,12,10,10,12,14,20,13,10,13,7,11,8,14,12,13,12,8,10,11,10,12,1,17,18,20,20,16,14,WB/M/AM RL,535,1,1,5,14,16,20,1,1,1,1,1,8,18,1,17,5.49756E+11,0,0,0,0,0,0,0,0,0,0,1,1,0,0,0,0,0,0,0,0,0,0,0,0,0,0,0,0,0,0,0,0,0,0,0,0,0,0,0,1,0,0,0,0,0,0,0,0,Darko Lazovic,£1.62m ,30,181,Midfielder - Left Midfield,right,Hellas Verona,36,2,5,2624,24,0,0,1457,34,3,4,2667,39,3,7,3314,3,0,0,225,Serie A
19-06-17,18.3.4.28,Dusan Basta,5754424,802,18-Aug-84,32,19,2,28,1,5250,6500,6750,147,138,9226984,183,76,D/WB/M R,3,1,3,3,2,1,2,3,3,2,1,8,13,12,9,12,10,12,12,15,14,12,11,14,13,15,15,13,12,12,11,13,13,12,9,14,14,17,17,13,12,14,10,9,16,13,20,15,13,13,10,12,14,16,17,13,14,15,17,16,17,2,20,19,17,7,20,8,14,D/WB/M R,122,1,1,1,1,1,7,14,8,20,1,1,4,17,6,19,150994994,0,1,0,0,1,1,0,0,0,0,0,0,0,0,0,0,0,0,0,0,0,0,0,0,1,0,0,1,0,0,0,0,0,0,0,0,0,0,0,0,0,0,0,0,0,0,0,0,Dusan Basta,£900Th. ,36,183,Defender - Right-Back,right,Retired,30,1,2,2393,22,0,3,1707,2,0,0,135,nan,nan,nan,nan,nan,nan,nan,nan,Serie A
19-06-17,18.3.4.28,Nenad Tomovic,5768029,802,30-Aug-87,29,22,0,9,1,5100,6350,6700,145,134,15509107,184,79,D/WB RC,3,2,3,2,1,3,2,3,1,1,2,6,11,10,8,12,7,13,8,12,14,12,8,13,11,16,12,15,13,10,11,13,14,10,11,10,15,15,14,14,13,13,11,9,15,14,20,14,15,14,14,13,7,13,13,13,14,12,13,12,15,6,20,17,5,1,19,10,20,D/WB RC,113,1,1,1,1,1,1,20,10,19,1,1,1,5,1,17,0,0,0,0,0,0,0,0,0,0,0,0,0,0,0,0,0,0,0,0,0,0,0,0,0,0,0,0,0,0,0,0,0,0,0,0,0,0,0,0,0,0,0,0,0,0,0,0,0,Nenad Tomović,£1.35m ,33,184,Defender - Centre-Back,right,SPAL,35,0,1,2559,29,0,0,2437,11,1,0,831,25,0,1,1911,6,0,1,524,Serie A
19-06-17,18.3.4.28,Christian Maggio,6100081,776,11-Feb-82,35,34,0,2,0,5500,6450,6450,154,129,638769,184,79,D/WB/M R,3,3,3,1,1,3,3,2,2,3,3,8,12,12,10,12,4,13,8,13,12,12,2,15,13,13,14,15,11,13,12,12,11,7,10,14,14,13,15,12,13,15,13,9,15,14,20,12,14,12,9,15,12,14,10,12,15,14,15,18,10,7,20,19,19,10,20,1,1,D/WB/M R,122,1,1,1,1,1,10,1,1,20,1,1,1,19,1,19,134217762,0,1,0,0,0,1,0,0,0,0,0,0,0,0,0,0,0,0,0,0,0,0,0,0,0,0,0,1,0,0,0,0,0,0,0,0,0,0,0,0,0,0,0,0,0,0,0,0,Christian Maggio,£450Th. ,38,184,Defender - Right-Back,right,Benevento Calcio,11,0,0,691,20,0,0,1133,20,2,0,1687,35,3,7,2995,3,0,0,75,Serie A
19-06-17,18.3.4.28,Andrea Barzagli,6100324,776,08-May-81,36,68,0,15,0,6900,8300,7900,167,158,232186002,187,87,D RC,3,2,2,3,2,1,2,3,1,1,1,2,2,8,3,11,2,14,3,3,20,12,10,16,11,8,18,14,16,19,11,18,18,3,12,5,19,17,14,8,8,18,14,9,10,9,20,11,15,20,3,12,14,5,9,19,15,17,18,18,20,7,20,1,1,1,15,1,20,D RC,103,1,11,1,1,1,1,20,1,15,1,1,1,1,1,1,8589934656,0,0,0,0,0,0,1,0,0,0,0,0,0,0,0,0,0,0,0,0,0,0,0,0,0,0,0,0,0,0,0,0,0,1,0,0,0,0,0,0,0,0,0,0,0,0,0,0,Andrea Barzagli,£900Th. ,39,187,Defender - Centre-Back,right,Retired,39,0,0,2618,38,0,1,2372,10,0,0,367,nan,nan,nan,nan,nan,nan,nan,nan,Serie A
19-06-17,18.3.4.28,Adam Marusic,62095383,62002127,17-Oct-92,24,15,0,0,0,6000,6500,6900,146,133,32383021,185,81,D/WB/M R,2,3,3,3,2,2,1,1,2,2,2,5,12,12,11,12,6,7,12,4,10,13,12,11,12,13,11,13,12,12,9,13,15,13,9,16,12,14,16,15,12,15,13,8,14,16,20,14,14,14,10,11,7,14,15,13,14,13,16,13,11,9,20,19,17,14,20,8,5,D/WB/M R,122,1,1,1,1,4,14,5,8,20,1,1,6,17,8,19,134217776,0,0,0,0,1,1,0,0,0,0,0,0,0,0,0,0,0,0,0,0,0,0,0,0,0,0,0,1,0,0,0,0,0,0,0,0,0,0,0,0,0,0,0,0,0,0,0,0,Adam Marusic,£9.00m ,28,185,Defender - Right-Back,right,SS Lazio,40,5,6,3477,39,3,5,2942,34,2,1,2693,15,2,1,939,6,0,2,391,Serie A
19-06-17,18.3.4.28,Patric,67100019,796,17-Apr-93,24,0,0,0,0,4500,6600,6500,140,130,10225423,184,74,D/WB RLC,1,1,1,1,3,2,3,3,1,2,2,12,12,10,7,11,10,12,10,8,12,12,11,13,10,18,13,16,10,11,10,11,16,7,11,15,12,17,18,13,12,13,10,9,15,13,20,14,13,16,13,12,8,16,14,14,12,8,16,16,16,2,20,16,14,9,20,17,17,D/WB RLC,116,1,1,1,1,1,9,17,17,20,9,7,14,14,16,16,0,0,0,0,0,0,0,0,0,0,0,0,0,0,0,0,0,0,0,0,0,0,0,0,0,0,0,0,0,0,0,0,0,0,0,0,0,0,0,0,0,0,0,0,0,0,0,0,0,Patric,£1.62m ,27,184,Defender - Centre-Back,right,SS Lazio,21,0,2,1187,21,0,1,1267,17,0,0,1224,24,1,0,1795,6,0,0,540,Serie A
19-06-17,18.3.4.28,Pol Lirola,67211095,796,13-Aug-97,19,0,0,0,0,3258,5715,6500,158,130,21107523,183,78,D/WB/M R,3,3,1,3,2,3,2,3,3,1,3,10,13,12,7,11,10,11,9,11,11,11,8,12,11,12,12,11,13,12,12,11,13,11,8,11,10,11,11,16,13,13,10,12,13,15,20,14,13,12,8,9,7,10,15,13,11,12,13,13,12,8,20,19,16,8,20,1,1,D/WB/M R,122,1,1,1,1,1,8,1,1,20,1,1,1,16,1,19,402653186,0,1,0,0,0,0,0,0,0,0,0,0,0,0,0,0,0,0,0,0,0,0,0,0,0,0,0,1,1,0,0,0,0,0,0,0,0,0,0,0,0,0,0,0,0,0,0,0,Pol Lirola,£6.75m ,23,183,Defender - Right-Back,right,ACF Fiorentina,29,1,3,2175,26,0,1,2203,38,2,7,3180,39,1,2,2933,4,0,1,198,Serie A
19-06-17,18.3.4.28,Vasilis Torosidis,688241,772,10-Jun-85,32,91,9,16,0,5250,7000,6400,144,128,3887048,186,82,D/WB RL,3,2,3,2,3,2,3,3,3,2,4,10,12,12,11,11,9,14,11,14,8,12,7,13,11,14,13,15,12,12,11,11,14,12,9,14,9,14,15,14,11,15,13,10,12,14,20,13,14,13,12,14,11,15,14,13,15,14,14,8,7,8,20,18,14,1,20,17,14,D/WB RL,115,1,1,1,1,1,1,14,17,20,8,6,1,14,10,18,5.49756E+11,0,0,0,0,0,1,0,0,0,0,0,0,0,0,0,0,0,0,0,0,0,0,0,0,0,0,0,0,0,0,0,0,0,0,0,0,0,0,0,1,0,0,0,0,0,0,0,0,Vasilios Torosidis,£630Th. ,35,186,Defender - Right-Back,right,Retired,28,1,1,1939,17,0,0,907,25,3,4,1206,10,0,1,560,nan,nan,nan,nan,Serie A
19-06-17,18.3.4.28,Juan Cuadrado,76010707,1653,26-May-88,29,64,7,0,0,6400,8000,7950,165,159,178467284,179,72,M/AM R,3,4,1,1,3,1,1,1,2,2,1,11,13,16,12,16,10,11,13,8,8,14,9,13,16,16,14,10,12,10,12,10,15,14,8,16,7,8,14,17,17,10,8,10,15,17,20,16,9,12,15,12,10,18,15,16,13,16,15,13,14,6,13,15,19,20,20,11,10,M/AM R,522,1,1,13,10,11,20,1,1,13,1,5,8,19,1,15,8.8545E+13,0,0,0,0,1,0,0,0,0,0,0,0,0,0,0,0,0,0,0,0,0,0,0,0,0,0,0,0,0,0,0,0,0,0,0,1,0,0,0,1,0,0,0,0,1,0,1,0,Juan Cuadrado,£25.20m ,32,176,Defender - Right-Back,right,Juventus FC,45,3,10,2907,29,5,9,1915,23,1,3,1552,45,3,7,3441,5,0,1,382,Serie A
19-06-17,18.3.4.28,Martín Cáceres,78010878,1657,07-Apr-87,30,69,3,11,0,5931,7958,6800,155,138,16734565,180,78,D/WB RC,3,3,3,3,3,2,3,1,1,1,3,3,10,10,7,11,2,14,9,12,13,10,5,15,11,16,14,18,13,14,9,12,15,10,11,11,15,14,15,11,13,16,13,12,6,11,20,15,15,14,12,14,17,16,17,12,12,13,10,13,12,5,20,17,8,1,20,13,18,D/WB RC,113,1,1,1,1,1,1,18,13,20,1,1,1,8,8,17,1.37439E+11,0,0,0,0,0,0,0,0,0,0,0,0,0,0,0,0,0,0,0,0,0,0,0,0,0,0,0,0,0,0,0,0,0,0,0,0,0,1,0,0,0,0,0,0,0,0,0,0,Martín Cáceres,£2.25m ,33,180,Defender - Centre-Back,right,ACF Fiorentina,4,0,0,360,25,4,1,2001,17,0,0,1278,30,2,0,2480,5,0,0,450,Serie A
19-06-17,18.3.4.28,Luca Rossettini,7980318,776,09-May-85,32,0,0,1,0,4000,6550,6550,137,131,232186002,187,82,D RC,3,1,1,2,3,2,4,2,2,3,1,7,11,6,5,10,7,13,8,13,14,12,7,13,10,13,13,12,13,13,11,13,10,9,11,11,13,12,13,14,12,13,14,10,16,15,20,13,14,13,12,12,8,13,10,9,14,11,11,12,12,6,20,15,1,1,16,1,20,D RC,103,1,10,1,1,1,1,20,1,16,1,1,1,1,1,15,0,0,0,0,0,0,0,0,0,0,0,0,0,0,0,0,0,0,0,0,0,0,0,0,0,0,0,0,0,0,0,0,0,0,0,0,0,0,0,0,0,0,0,0,0,0,0,0,0,Luca Rossettini,£1.26m ,35,187,Defender - Centre-Back,right,US Lecce,31,1,0,2774,25,0,0,2206,23,0,0,2002,27,0,2,2351,1,0,0,90,Serie A
19-06-17,18.3.4.28,Ignazio Abate,7983987,776,12-Nov-86,30,22,1,18,2,5750,6600,6950,152,139,15783837,180,73,D/WB R,1,2,1,3,2,2,1,2,2,1,4,5,12,13,4,11,2,10,6,14,13,12,4,13,11,15,14,14,10,11,9,12,15,6,15,13,13,15,14,17,16,13,10,7,12,17,20,15,12,13,13,12,13,8,18,13,18,13,16,15,12,7,20,18,12,7,20,1,1,D/WB R,112,1,1,1,1,1,7,1,1,20,1,1,1,12,1,18,1.09951E+12,0,1,0,0,0,1,0,0,0,0,0,0,0,0,0,0,0,0,0,0,0,0,0,0,0,0,0,0,0,0,0,0,0,0,0,0,0,0,0,0,1,0,0,0,0,0,0,0,Ignazio Abate,£2.70m ,33,180,Defender - Right-Back,right,Without Club,26,0,2,2170,27,1,1,1713,24,0,0,1688,nan,nan,nan,nan,nan,nan,nan,nan,Serie A
19-06-17,18.3.4.28,Aleandro Rosi,7984127,776,17-May-87,30,0,0,0,0,4000,6050,6050,132,121,2137870,184,80,D/WB/M R,3,3,2,3,1,1,2,1,3,1,1,3,12,12,10,9,4,11,8,12,10,12,5,12,11,15,12,13,11,11,8,12,11,12,8,13,12,12,16,14,13,11,12,10,14,15,20,13,12,10,15,14,5,18,16,11,12,12,15,13,11,5,20,19,18,8,20,13,1,D/WB/M R,122,1,1,1,1,1,8,1,13,20,1,1,12,18,12,19,1.09951E+12,0,0,0,0,0,0,0,0,0,0,0,0,0,0,0,1,0,0,0,0,1,0,0,0,0,0,0,0,0,0,0,0,0,0,0,0,0,0,0,0,1,0,0,0,0,0,0,0,Aleandro Rosi,£810Th. ,33,180,Defender - Right-Back,right,AC Perugia Calcio,31,1,1,2565,25,0,1,1826,14,0,0,1109,38,0,3,3150,7,1,2,397,Serie A
19-06-17,18.3.4.28,Andrea Masiello,7984549,776,05-Feb-86,31,0,0,0,0,4000,6550,6900,138,138,232186002,184,82,D RC,2,1,1,3,3,2,3,4,2,3,3,3,8,7,6,11,4,14,7,7,15,10,4,14,11,13,16,13,14,15,7,14,16,5,12,7,15,14,13,13,14,13,12,10,14,13,20,13,14,14,8,14,7,10,13,15,13,15,15,13,16,7,20,10,1,1,18,1,20,D RC,103,1,13,1,1,1,1,20,1,18,1,1,1,1,1,10,32768,0,0,0,0,0,0,0,0,0,0,0,0,0,0,0,1,0,0,0,0,0,0,0,0,0,0,0,0,0,0,0,0,0,0,0,0,0,0,0,0,0,0,0,0,0,0,0,0,Andrea Masiello,£2.70m ,34,184,Defender - Centre-Back,right,Genoa CFC,38,3,0,3137,41,5,0,3565,33,1,3,2593,27,0,1,2149,2,0,0,180,Serie A
19-06-17,18.3.4.28,Fabrizio Cacciatore,7988563,776,08-Oct-86,30,0,0,0,0,4000,6400,6650,133,133,232186002,182,85,D/WB RLC,3,1,1,1,3,3,3,3,3,2,2,7,12,10,8,8,7,13,8,14,13,12,9,14,8,16,13,14,8,14,8,13,14,11,13,8,15,14,16,13,12,13,12,11,13,14,20,15,13,15,10,15,7,14,16,12,11,15,12,12,17,7,20,19,1,1,20,16,15,D/WB RLC,116,1,1,1,1,1,1,15,16,20,1,1,1,1,15,19,131074,0,1,0,0,0,0,0,0,0,0,0,0,0,0,0,0,0,1,0,0,0,0,0,0,0,0,0,0,0,0,0,0,0,0,0,0,0,0,0,0,0,0,0,0,0,0,0,0,Fabrizio Cacciatore,£1.08m ,34,182,Defender - Right-Back,right,Without Club,31,1,1,2689,35,3,3,3080,16,0,2,1257,17,0,0,1245,nan,nan,nan,nan,Serie A
19-06-17,18.3.4.28,Fabio Pisacane,7990939,776,28-Jan-86,31,0,0,0,0,3250,6250,6250,134,125,232186002,178,77,D/WB RLC,3,1,3,2,1,2,1,1,2,3,3,5,9,7,6,10,6,12,7,11,14,11,6,14,9,12,14,13,12,13,10,13,12,7,11,11,14,12,14,13,13,12,10,9,14,12,20,13,11,12,8,11,7,13,12,16,10,11,14,14,12,5,20,16,1,1,20,15,19,D/WB RLC,116,1,1,1,1,1,1,19,15,20,1,1,1,1,13,16,2,0,1,0,0,0,0,0,0,0,0,0,0,0,0,0,0,0,0,0,0,0,0,0,0,0,0,0,0,0,0,0,0,0,0,0,0,0,0,0,0,0,0,0,0,0,0,0,0,Fabio Pisacane,£630Th. ,34,178,Defender - Centre-Back,right,Cagliari Calcio,29,1,1,2553,26,0,0,2140,28,2,1,2350,32,1,0,2541,1,0,0,44,Serie A
19-06-17,18.3.4.28,Simone Padoin,836918,776,18-Mar-84,33,0,0,6,0,5250,6550,6550,145,131,232186002,177,74,M RLC,3,3,1,3,2,2,1,3,2,1,1,8,11,9,8,11,8,9,11,14,12,14,8,13,12,15,13,15,10,14,11,14,17,6,7,11,15,18,18,12,12,12,9,10,14,13,20,17,11,15,10,13,6,20,6,12,17,14,18,16,18,5,14,15,20,8,20,16,19,M RLC,406,1,1,1,5,8,8,1,13,14,11,19,16,20,14,15,1.40737E+14,0,0,0,0,0,0,0,0,0,0,0,0,0,0,0,1,0,0,0,0,0,0,0,0,0,0,0,0,0,0,0,0,0,0,0,0,0,0,0,0,0,0,0,0,0,0,0,1,Simone Padoin,£450Th. ,36,177,Midfielder - Left Midfield,right,Retired,32,1,2,2262,37,1,0,3117,32,0,1,2016,31,0,3,2436,1,0,0,9,Serie A
19-06-17,18.3.4.28,Bacary Sagna,8430030,769,14-Feb-83,34,65,0,12,0,5200,6650,6650,160,133,232186002,176,72,D/WB RC,1,1,3,1,3,3,1,1,1,1,1,11,13,11,5,13,7,15,8,8,14,12,5,15,14,12,14,14,15,13,13,14,15,10,8,13,14,15,16,10,11,13,12,10,16,12,20,14,15,15,8,14,9,10,16,16,16,14,14,14,17,9,20,18,1,1,20,14,15,D/WB RC,113,1,1,1,1,1,1,15,14,20,1,1,1,1,11,18,1081376,0,0,0,0,0,1,0,0,0,0,0,0,0,0,0,1,0,0,0,0,1,0,0,0,0,0,0,0,0,0,0,0,0,0,0,0,0,0,0,0,0,0,0,0,0,0,0,0,Bacary Sagna,£720Th. ,37,176,Defender - Right-Back,right,Without Club,25,0,2,1848,22,2,0,1764,31,1,4,2660,nan,nan,nan,nan,nan,nan,nan,nan,Serie A
19-06-17,18.3.4.28,Bryan Dabo,85059761,769,18-Feb-92,25,0,0,1,0,4250,6350,6350,130,127,7470075,187,79,D/DM/M RC,3,2,1,3,3,1,3,2,2,1,1,5,13,12,8,12,10,12,8,6,13,12,10,14,12,13,13,14,11,9,10,11,13,12,8,9,11,13,15,15,14,14,11,5,16,14,20,15,14,10,13,11,7,13,6,15,10,10,12,11,10,8,19,15,20,1,20,1,15,D/DM/M RC,433,1,1,1,1,1,1,12,1,19,18,15,1,20,1,15,0,0,0,0,0,0,0,0,0,0,0,0,0,0,0,0,0,0,0,0,0,0,0,0,0,0,0,0,0,0,0,0,0,0,0,0,0,0,0,0,0,0,0,0,0,0,0,0,0,Bryan Dabo,£4.05m ,28,187,Midfielder - Central Midfield,right,Benevento Calcio,22,0,1,1099,27,3,1,1965,26,1,2,918,17,1,4,1209,5,0,0,296,Serie A
19-06-17,18.3.4.28,Rômulo,8833765,1651,22-May-87,30,0,0,0,0,5250,6450,6550,140,131,232186002,178,72,WB/M RC,3,4,1,1,3,3,3,2,2,1,1,8,13,13,11,13,7,12,15,6,10,13,12,14,13,16,12,13,12,15,12,14,12,14,13,14,10,13,14,12,13,12,10,9,9,13,20,15,12,15,12,15,16,17,14,15,11,10,13,8,9,11,15,16,20,13,17,12,20,WB/M RC,423,1,1,1,1,1,13,1,12,15,1,20,5,17,8,16,0,0,0,0,0,0,0,0,0,0,0,0,0,0,0,0,0,0,0,0,0,0,0,0,0,0,0,0,0,0,0,0,0,0,0,0,0,0,0,0,0,0,0,0,0,0,0,0,0,Rômulo,£2.70m ,33,178,Midfielder - Central Midfield,right,Without Club,41,4,10,3565,41,3,6,3562,32,1,3,2560,24,1,3,1755,nan,nan,nan,nan,Serie A
19-06-17,18.3.4.28,Emil Krafth,93031462,797,02-Aug-94,22,9,0,16,1,3500,6250,6150,141,123,8817457,185,79,D/WB R,1,1,4,2,1,3,2,3,2,1,2,10,14,10,4,12,9,10,10,9,13,12,8,13,12,11,13,11,12,13,12,13,13,8,6,14,13,13,13,13,13,12,12,8,12,14,20,14,12,13,6,11,10,9,10,12,12,13,13,14,15,2,20,16,10,5,20,12,2,D/WB R,112,1,1,1,1,1,5,2,12,20,1,1,1,10,10,16,1.09951E+12,0,0,0,0,0,0,0,0,0,0,0,0,0,0,0,0,0,0,0,0,0,0,0,0,0,0,0,0,0,0,0,0,0,0,0,0,0,0,0,0,1,0,0,0,0,0,0,0,Emil Krafth,£1.35m ,26,184,Defender - Right-Back,right,Newcastle United,29,1,1,1951,12,0,0,946,36,1,1,3062,20,0,1,1248,5,0,0,432,Serie A
19-06-17,18.3.4.28,Bartosz Bereszynski,96011201,787,12-Jul-92,24,3,0,4,0,4000,5950,6200,126,124,6981488,183,77,D/WB R,2,3,3,1,2,1,3,3,4,3,3,8,12,13,8,12,8,12,7,12,12,13,12,13,12,12,10,14,11,12,10,10,13,11,5,14,12,13,14,14,12,11,10,9,10,15,20,15,11,13,7,12,10,12,14,16,5,14,15,12,9,10,20,18,15,1,20,1,1,D/WB R,112,1,1,1,1,1,1,1,1,20,1,1,1,15,1,18,2,0,1,0,0,0,0,0,0,0,0,0,0,0,0,0,0,0,0,0,0,0,0,0,0,0,0,0,0,0,0,0,0,0,0,0,0,0,0,0,0,0,0,0,0,0,0,0,0,Bartosz Bereszynski,£10.80m ,28,183,Defender - Right-Back,right,UC Sampdoria,35,0,4,2855,31,0,1,2483,28,0,2,2270,29,0,1,2495,5,0,0,450,Serie A
19-06-17,18.3.4.28,Cristian Ansaldi,964420,1649,20-Sep-86,30,5,1,0,0,5300,6600,6850,146,137,232186002,181,76,D/WB RL,3,2,1,2,3,1,4,3,1,3,2,13,12,13,6,13,12,10,10,13,13,12,10,15,13,15,12,12,12,13,11,12,18,11,9,11,12,12,14,13,14,16,11,20,14,13,15,14,13,13,12,10,11,14,17,13,13,12,16,13,12,8,20,17,14,1,16,20,12,D/WB RL,115,1,1,1,1,1,1,12,20,16,1,1,14,8,17,10,1.41837E+14,0,0,0,0,0,0,0,0,0,0,0,0,0,0,0,0,0,0,0,0,0,0,0,0,0,0,0,0,0,0,0,0,0,0,0,0,0,0,0,0,1,0,0,0,0,0,0,1,Cristian Ansaldi,£4.50m ,34,181,Defender - Left-Back,both,Torino FC,26,0,2,1814,25,1,3,1869,25,3,2,1906,32,5,7,2176,3,0,0,93,Serie A
19-06-17,18.3.4.28,Silvan Widmer,98010781,798,05-Mar-93,24,9,0,17,1,4500,6850,6850,147,137,18498494,183,81,D/WB/M R,2,3,2,3,3,4,3,3,1,1,2,7,13,13,8,13,6,12,11,13,12,12,7,13,14,13,13,12,11,11,11,11,14,11,10,11,12,14,13,16,14,14,11,8,14,16,20,15,12,14,12,12,5,13,14,13,15,11,15,12,12,8,20,19,18,1,20,9,7,D/WB/M R,122,1,1,1,1,1,1,7,9,20,1,1,8,18,9,19,134217728,0,0,0,0,0,0,0,0,0,0,0,0,0,0,0,0,0,0,0,0,0,0,0,0,0,0,0,1,0,0,0,0,0,0,0,0,0,0,0,0,0,0,0,0,0,0,0,0,Silvan Widmer,£7.65m ,27,182,Defender - Right-Back,right,FC Basel 1893,29,0,4,2581,26,3,2,1732,41,2,7,3588,50,6,8,4485,6,1,0,540,Serie A
19-06-17,18.3.4.28,Berat Djimsiti,98015432,752,19-Feb-93,24,13,1,5,0,3500,5950,5900,131,118,360739,190,83,D RLC,3,2,3,1,3,1,1,2,3,3,3,5,7,7,6,11,4,14,8,10,14,10,4,14,11,9,13,15,9,11,8,10,12,6,10,8,14,13,11,11,10,17,14,12,12,12,20,13,14,9,5,10,5,8,12,13,14,7,13,12,14,5,20,13,1,1,16,15,20,D RLC,106,1,1,1,1,1,1,20,15,16,1,1,1,1,13,13,0,0,0,0,0,0,0,0,0,0,0,0,0,0,0,0,0,0,0,0,0,0,0,0,0,0,0,0,0,0,0,0,0,0,0,0,0,0,0,0,0,0,0,0,0,0,0,0,0,Berat Djimsiti,£900Th. ,27,190,Defender - Centre-Back,right,Atalanta BC,35,0,0,3124,30,0,1,2700,29,1,1,2283,41,2,1,3388,5,0,0,359,Serie A
19-06-17,18.3.4.28,Zainadine Júnior,13104485,35,24-Jun-88,28,44,0,0,0,4000,6550,6550,132,131,3590529,178,75,D RC,2,2,3,4,1,1,2,3,1,3,3,6,9,10,8,11,5,15,7,15,13,11,8,15,12,14,15,14,11,13,8,13,17,11,12,9,14,14,15,14,14,14,12,6,16,13,20,14,13,14,11,12,8,14,16,14,12,13,16,16,12,7,20,1,1,1,19,1,20,D RC,103,1,1,1,1,1,1,20,1,19,1,1,1,1,1,1,1.15405E+18,0,0,0,0,0,0,0,0,0,0,0,0,0,0,0,0,0,0,0,0,0,0,0,0,0,0,0,0,0,0,0,0,0,0,0,0,0,0,0,0,0,0,0,0,0,0,0,0,Zainadine Júnior,£1.35m ,32,180,Defender - Centre-Back,right,CS Marítimo,15,1,0,1041,38,1,1,3437,33,1,3,2970,33,3,1,3000,5,1,0,444,Liga NOS
19-06-17,18.3.4.28,Douglas,19068564,1651,06-Aug-90,26,0,0,8,0,5250,6000,6350,136,127,2713429,171,67,D/WB R,1,2,3,2,1,1,1,3,4,3,2,12,12,15,9,14,12,7,11,10,9,12,12,11,15,13,11,13,12,9,13,11,15,13,8,12,8,13,13,14,15,12,6,14,14,14,20,14,10,11,10,9,10,15,11,17,6,12,14,13,12,12,19,20,11,11,20,12,5,D/WB R,222,1,1,1,5,5,11,1,12,19,1,5,5,11,12,20,2.8823E+17,0,1,0,0,0,1,0,0,0,0,0,0,0,0,0,0,0,0,0,0,0,0,0,0,0,0,0,0,0,0,0,0,0,0,0,0,0,0,0,0,0,0,0,0,0,0,0,0,Douglas,£360Th. ,32,192,Defender - Centre-Back,right,Würzburger Kickers,8,0,0,674,nan,nan,nan,nan,nan,nan,nan,nan,0,0,0,0,4,0,0,275,Liga NOS
19-06-17,18.3.4.28,Luís Felipe,19084261,1651,08-Apr-91,26,0,0,0,0,2500,5300,5300,112,106,95904,178,73,D/WB R,1,3,2,3,2,4,1,3,2,3,1,11,13,12,7,12,12,7,12,13,9,12,13,9,12,13,12,12,11,11,11,11,11,13,6,13,10,12,13,14,13,10,8,5,12,14,20,11,9,13,11,12,6,16,12,11,8,14,10,9,13,13,20,19,12,10,20,12,11,D/WB R,112,1,1,1,8,3,10,1,12,20,7,11,6,12,11,19,2.28698E+15,0,0,0,0,0,1,0,0,0,1,0,0,0,0,0,0,0,0,0,0,0,0,0,0,0,0,0,0,0,0,0,0,0,0,0,0,0,0,0,0,0,0,0,0,0,1,0,0,Luís Felipe,£180Th. ,29,178,Defender - Right-Back,right,Associação Atlética Portuguesa (SP),2,0,0,81,3,0,1,69,nan,nan,nan,nan,nan,nan,nan,nan,nan,nan,nan,nan,Liga NOS
19-06-17,18.3.4.28,Bebeto,19088884,1651,01-Jan-90,27,0,0,0,0,2014,5035,5750,120,115,541295,174,70,D/WB R,1,3,2,2,1,2,2,1,2,2,2,10,11,13,8,11,13,9,8,10,10,10,11,12,12,12,12,12,10,12,8,9,13,10,9,13,11,13,13,14,14,12,7,10,13,14,20,14,9,10,8,11,5,9,12,12,9,10,14,12,13,4,19,20,11,7,20,1,1,D/WB R,222,1,1,1,1,1,7,1,1,19,1,1,1,11,1,20,34,0,1,0,0,0,1,0,0,0,0,0,0,0,0,0,0,0,0,0,0,0,0,0,0,0,0,0,0,0,0,0,0,0,0,0,0,0,0,0,0,0,0,0,0,0,0,0,0,Bebeto,£1.80m ,30,174,Defender - Right-Back,right,CD Tondela,nan,nan,nan,nan,41,2,3,3681,26,0,1,2192,19,0,1,1574,4,0,0,264,Liga NOS
19-06-17,18.3.4.28,Patrick,19117305,1651,22-Jan-91,26,0,0,0,0,3300,5500,5750,118,115,208308,178,73,D/WB RL,2,2,1,3,1,1,3,1,3,3,3,10,12,9,8,10,8,8,10,12,13,11,10,14,11,10,12,14,9,14,8,10,15,7,8,10,11,14,15,12,11,12,7,12,13,12,20,15,10,12,9,12,9,15,13,12,13,10,14,7,11,9,20,19,13,1,20,20,1,D/WB RL,115,1,1,1,1,1,1,1,20,20,1,1,1,13,11,19,0,0,0,0,0,0,0,0,0,0,0,0,0,0,0,0,0,0,0,0,0,0,0,0,0,0,0,0,0,0,0,0,0,0,0,0,0,0,0,0,0,0,0,0,0,0,0,0,0,Patrick,£900Th. ,29,173,Defender - Right-Back,right,Coritiba Foot Ball Club,35,0,8,3006,19,2,3,1323,34,0,4,2815,20,0,1,1737,nan,nan,nan,nan,Liga NOS
19-06-17,18.3.4.28,Lionn,2108018,1651,29-Jan-89,28,0,0,0,0,3042,5071,5950,126,119,225705,184,77,D R,2,2,3,3,2,1,2,3,3,2,3,11,12,10,8,12,11,10,12,14,10,10,12,12,13,14,12,14,11,11,9,11,16,12,9,13,11,14,14,13,13,13,12,8,11,14,20,15,12,12,10,10,8,7,14,14,12,11,13,10,5,10,20,12,1,1,20,1,1,D R,102,1,1,1,1,1,1,1,1,20,1,1,1,1,1,12,32802,0,1,0,0,0,1,0,0,0,0,0,0,0,0,0,1,0,0,0,0,0,0,0,0,0,0,0,0,0,0,0,0,0,0,0,0,0,0,0,0,0,0,0,0,0,0,0,0,Lionn,£1.35m ,31,184,Defender - Right-Back,right,Without Club,15,0,1,961,33,1,2,2773,14,0,2,1156,13,0,0,1138,nan,nan,nan,nan,Liga NOS
19-06-17,18.3.4.28,Vincent Sasso,34009250,769,16-Feb-91,26,0,0,2,0,3000,5250,5700,116,114,148368,190,82,D RC,1,1,2,1,4,1,3,3,3,1,1,4,9,8,5,10,6,14,8,7,12,10,6,13,10,14,14,14,12,12,10,13,16,6,8,8,12,14,13,10,9,16,15,8,13,10,20,14,15,12,10,14,5,15,13,13,15,9,13,15,15,8,20,1,1,1,15,5,20,D RC,103,1,1,1,1,1,1,20,5,15,1,1,1,1,1,1,2.74878E+11,0,0,0,0,0,0,0,0,0,0,0,0,0,0,0,0,0,0,0,0,0,0,0,0,0,0,0,0,0,0,0,0,0,0,0,0,0,0,1,0,0,0,0,0,0,0,0,0,Vincent Sasso,£900Th. ,29,190,Defender - Centre-Back,right,Servette FC,14,2,0,1110,19,1,1,1330,34,3,1,2980,33,1,0,2891,6,0,0,540,Liga NOS
19-06-17,18.3.4.28,Cristiano Piccini,43052618,776,26-Sep-92,24,0,0,1,0,4250,6250,6800,140,136,14807331,189,79,D/WB R,2,3,2,3,2,2,2,3,3,4,1,8,12,12,9,13,6,12,10,12,11,13,10,12,12,10,14,13,13,10,11,12,14,12,9,12,12,15,15,15,15,14,13,12,13,14,20,14,13,14,8,11,15,13,13,13,9,9,10,10,11,14,20,19,14,7,20,1,1,D/WB R,112,1,1,1,1,1,7,1,1,20,1,1,1,14,1,19,34359738368,0,0,0,0,0,0,0,0,0,0,0,0,0,0,0,0,0,0,0,0,0,0,0,0,0,0,0,0,0,0,0,0,0,0,0,1,0,0,0,0,0,0,0,0,0,0,0,0,Cristiano Piccini,£6.75m ,28,189,Defender - Right-Back,right,Atalanta BC,25,3,3,1922,40,0,3,3462,38,1,0,2891,2,0,0,75,nan,nan,nan,nan,Liga NOS
19-06-17,18.3.4.28,Bruno Pereirinha,55001512,788,02-Mar-88,29,0,0,19,0,4750,5800,5800,133,116,51356,174,68,D/WB/M RL,3,2,1,3,3,2,1,3,1,1,2,12,12,12,9,13,8,7,10,10,10,12,10,12,13,10,12,13,13,11,11,12,13,13,9,13,11,13,12,12,13,10,8,9,12,12,20,11,8,12,8,12,14,17,14,13,15,13,18,17,17,4,20,19,18,10,20,18,1,D/WB/M RL,125,1,1,1,1,7,10,1,18,20,1,1,16,18,17,19,18,0,1,0,0,1,0,0,0,0,0,0,0,0,0,0,0,0,0,0,0,0,0,0,0,0,0,0,0,0,0,0,0,0,0,0,0,0,0,0,0,0,0,0,0,0,0,0,0,Bruno Pereirinha,£360Th. ,32,174,Forward - Right Winger,right,Without Club,nan,nan,nan,nan,18,0,0,960,18,0,0,1167,nan,nan,nan,nan,nan,nan,nan,nan,Liga NOS
19-06-17,18.3.4.28,Mano,55003642,788,09-Apr-87,30,0,0,2,0,3250,5750,5500,115,115,232186002,170,64,D/WB R,1,3,3,3,2,1,1,3,3,1,1,11,12,11,9,11,8,13,8,11,12,11,10,12,12,14,13,13,8,10,11,11,13,7,10,13,9,13,13,14,14,11,6,10,14,15,20,14,7,10,12,10,13,14,8,12,15,12,14,12,13,8,20,17,1,1,20,10,1,D/WB R,112,1,1,1,1,1,1,1,10,20,1,1,1,1,1,17,0,0,0,0,0,0,0,0,0,0,0,0,0,0,0,0,0,0,0,0,0,0,0,0,0,0,0,0,0,0,0,0,0,0,0,0,0,0,0,0,0,0,0,0,0,0,0,0,0,Mano,£180Th. ,33,170,Defender - Right-Back,right,Vitória Setúbal FC,23,0,2,1845,16,0,0,1349,34,0,1,2828,12,0,1,991,nan,nan,nan,nan,Liga NOS
19-06-17,18.3.4.28,Pedro Queirós,55011074,788,08-Aug-84,32,0,0,0,0,4000,5400,5400,115,108,30701,182,75,D R,2,3,3,3,3,4,1,4,1,2,1,10,11,12,7,10,9,9,10,15,12,11,10,13,10,11,13,13,12,14,11,14,13,8,13,11,14,12,13,11,11,12,10,5,12,11,20,11,12,13,10,11,8,11,13,10,13,11,12,13,13,6,20,10,1,1,20,10,1,D R,102,1,1,1,1,1,1,1,10,20,1,1,1,1,1,10,0,0,0,0,0,0,0,0,0,0,0,0,0,0,0,0,0,0,0,0,0,0,0,0,0,0,0,0,0,0,0,0,0,0,0,0,0,0,0,0,0,0,0,0,0,0,0,0,0,Pedro Queirós,£90Th. ,36,180,Defender - Right-Back,right,FC Tirsense,17,0,0,1483,3,0,0,114,21,1,0,1348,nan,nan,nan,nan,1,0,0,90,Liga NOS
19-06-17,18.3.4.28,André Almeida,55011100,788,10-Sep-90,26,8,0,17,0,4500,6800,6800,137,135,7318787,186,80,D/DM/M RLC,3,2,4,2,2,4,3,1,1,3,2,8,11,11,8,11,8,10,11,12,13,12,7,15,11,15,14,15,12,15,11,12,14,6,12,12,14,15,15,13,12,13,13,8,15,13,20,16,12,15,12,13,8,17,12,14,14,12,16,14,16,6,20,12,16,5,20,17,16,D/DM/M RLC,126,1,1,1,5,1,1,1,17,20,18,16,1,10,1,12,0,0,0,0,0,0,0,0,0,0,0,0,0,0,0,0,0,0,0,0,0,0,0,0,0,0,0,0,0,0,0,0,0,0,0,0,0,0,0,0,0,0,0,0,0,0,0,0,0,André Almeida,£6.75m ,30,186,Defender - Right-Back,right,SL Benfica,25,2,3,1851,40,2,8,3354,53,2,12,4727,27,4,5,2366,5,0,2,374,Liga NOS
19-06-17,18.3.4.28,Joăo Aurélio,55011464,788,17-Aug-88,28,0,0,11,1,4400,6100,6100,132,122,633459,182,74,D/WB/M RC,2,1,1,3,3,2,2,3,3,1,2,11,11,12,9,12,9,8,8,12,9,12,11,14,13,12,12,13,8,13,10,10,14,13,14,15,11,13,14,14,12,13,11,7,14,14,20,14,12,13,7,12,9,12,12,11,13,13,14,12,12,6,20,16,18,15,20,5,15,D/WB/M RC,123,1,1,1,12,5,15,1,1,20,1,15,1,18,1,16,32,0,0,0,0,0,1,0,0,0,0,0,0,0,0,0,0,0,0,0,0,0,0,0,0,0,0,0,0,0,0,0,0,0,0,0,0,0,0,0,0,0,0,0,0,0,0,0,0,João Aurélio,£1.13m ,32,182,Defender - Right-Back,right,Pafos FC,31,0,5,1923,32,0,3,2429,21,2,5,1860,30,2,3,2515,7,0,0,491,Liga NOS
19-06-17,18.3.4.28,Sílvio,55011718,788,28-Sep-87,29,8,0,0,0,5500,5750,5750,135,115,404674,178,70,D/WB RL,2,3,3,3,3,3,1,2,2,1,1,9,13,12,8,13,9,9,11,12,12,11,11,13,13,12,14,12,13,13,12,12,14,12,9,12,12,13,12,11,12,11,9,12,9,11,20,10,10,13,11,12,18,15,13,11,10,14,12,14,15,8,20,19,1,1,20,19,1,D/WB RL,115,1,1,1,1,1,1,1,19,20,1,1,1,1,16,19,32,0,0,0,0,0,1,0,0,0,0,0,0,0,0,0,0,0,0,0,0,0,0,0,0,0,0,0,0,0,0,0,0,0,0,0,0,0,0,0,0,0,0,0,0,0,0,0,0,,,,,,,,,,,,,,,,,,,,,,,,,,,,
19-06-17,18.3.4.28,Paulinho,55013000,788,13-Jul-91,25,0,0,0,0,3500,6100,6100,138,122,404336,176,69,D R,1,2,1,2,2,1,1,1,2,4,3,9,12,12,6,10,8,10,8,12,12,11,8,13,13,12,12,13,12,12,11,12,15,10,10,14,12,15,15,14,13,13,8,8,14,15,20,15,10,15,9,13,2,11,13,14,11,14,14,10,12,6,20,15,1,1,20,1,1,D R,102,1,1,1,1,1,1,1,1,20,1,1,1,1,1,15,34,0,1,0,0,0,1,0,0,0,0,0,0,0,0,0,0,0,0,0,0,0,0,0,0,0,0,0,0,0,0,0,0,0,0,0,0,0,0,0,0,0,0,0,0,0,0,0,0,Paulinho,£36.00m ,32,183,Midfielder - Central Midfield,right,Guangzhou Evergrande Taobao,29,12,5,2610,68,22,10,4263,42,22,8,3632,16,10,4,1406,nan,nan,nan,nan,LaLiga
19-06-17,18.3.4.28,Diogo Figueiras,55013024,788,01-Jul-91,25,0,0,0,0,3000,6250,6250,135,130,1407963,171,62,D/WB/M R,2,2,3,3,4,2,2,3,3,1,3,9,13,12,8,13,8,5,8,11,11,12,9,12,12,15,13,14,9,9,11,10,14,9,6,13,10,13,15,16,14,12,6,10,14,15,20,16,9,11,13,10,5,13,12,13,9,10,12,9,6,12,20,19,16,7,20,14,1,D/WB/M R,122,1,1,1,1,1,7,1,14,20,1,1,1,16,10,19,131106,0,1,0,0,0,1,0,0,0,0,0,0,0,0,0,0,0,1,0,0,0,0,0,0,0,0,0,0,0,0,0,0,0,0,0,0,0,0,0,0,0,0,0,0,0,0,0,0,Diogo Figueiras,£1.58m ,29,169,Defender - Right-Back,right,SC Braga,43,3,8,3751,28,1,4,2219,4,0,1,270,23,0,2,1778,nan,nan,nan,nan,Liga NOS
19-06-17,18.3.4.28,Jean-Sony,55017618,375,23-Jan-86,31,61,8,0,0,3750,5700,5700,122,114,232186002,175,67,D/WB R,3,1,1,2,3,3,1,4,1,1,1,8,13,11,7,9,11,9,7,14,12,10,9,12,12,13,13,11,12,13,10,12,15,12,8,13,12,13,13,14,13,11,10,6,14,14,20,12,13,12,8,11,10,14,17,14,11,13,15,14,10,6,20,17,10,10,20,1,1,D/WB R,112,1,1,1,1,1,10,1,1,20,1,1,1,10,1,17,2.2518E+15,0,0,0,0,0,1,0,0,0,0,0,1,0,0,0,0,0,0,0,0,0,0,0,0,0,0,0,0,0,0,0,0,0,0,0,0,0,0,0,0,0,0,0,0,0,0,0,0,,,,,,,,,,,,,,,,,,,,,,,,,,,,
19-06-17,18.3.4.28,Edu Machado,55022047,788,26-Apr-90,27,0,0,5,0,3250,5850,5850,122,117,54888,175,70,D/AM R,2,3,1,2,2,1,1,2,1,1,4,7,12,12,8,11,5,5,8,12,10,12,6,11,12,10,11,11,10,10,9,11,13,12,8,13,11,12,13,15,13,11,8,8,10,15,20,13,10,12,11,10,4,14,9,10,14,14,11,12,11,5,20,12,13,17,20,14,1,D/AM R,112,1,1,1,1,14,17,1,1,20,1,1,5,13,1,12,0,0,0,0,0,0,0,0,0,0,0,0,0,0,0,0,0,0,0,0,0,0,0,0,0,0,0,0,0,0,0,0,0,0,0,0,0,0,0,0,0,0,0,0,0,0,0,0,0,Edu Machado,£630Th. ,30,175,Defender - Right-Back,right,Leixões SC,26,0,1,2226,6,0,0,513,21,0,3,1808,5,0,0,370,6,0,0,461,Liga NOS
19-06-17,18.3.4.28,Ricardo Esgaio,55022375,788,16-May-93,24,0,0,18,3,4250,6700,6700,142,134,6599210,173,65,D/WB/M/AM RL,2,3,3,1,3,3,3,3,1,2,2,12,16,12,11,12,10,7,11,11,10,13,14,12,13,13,11,12,13,12,12,13,16,12,7,15,12,13,14,13,13,12,9,6,13,13,20,14,8,14,7,12,6,18,13,16,13,12,17,12,12,9,20,17,18,19,20,15,13,D/WB/M/AM RL,135,1,1,1,13,13,19,1,15,20,13,13,14,18,12,17,1048672,0,0,0,0,0,1,1,0,0,0,0,0,0,0,0,0,0,0,0,0,1,0,0,0,0,0,0,0,0,0,0,0,0,0,0,0,0,0,0,0,0,0,0,0,0,0,0,0,Ricardo Esgaio,£3.60m ,27,173,Defender - Right-Back,right,SC Braga,25,1,3,1963,48,4,13,4161,34,0,5,2759,49,1,7,4234,6,1,1,540,Liga NOS
19-06-17,18.3.4.28,David Bruno,55022402,788,14-Feb-92,25,0,0,4,0,3000,5700,5700,118,114,216015,176,72,D/WB RL,2,2,2,3,1,1,1,3,2,1,3,7,10,11,7,12,7,9,7,14,12,13,6,12,12,12,12,13,10,13,9,11,15,8,10,13,13,11,13,13,12,12,11,8,14,13,20,14,10,14,9,11,6,13,15,14,16,13,15,10,13,6,20,20,1,1,20,16,1,D/WB RL,115,1,1,1,1,1,1,1,16,20,1,1,1,1,1,20,2.2518E+15,0,1,0,0,0,0,0,0,0,0,0,0,0,0,0,0,0,0,0,0,0,0,0,0,0,0,0,0,0,0,0,0,0,0,0,0,0,0,0,0,0,0,0,0,0,0,0,0,David Bruno,£675Th. ,28,175,Defender - Right-Back,right,Astra Giurgiu,22,0,1,1948,33,0,4,2752,27,1,3,2286,22,0,0,1490,6,0,1,494,Liga NOS
19-06-17,18.3.4.28,André Geraldes,55027820,788,02-May-91,26,0,0,0,0,4750,6000,6000,126,120,71860,181,74,D RL,2,2,1,2,2,4,1,3,1,1,2,9,12,12,7,12,9,11,9,12,10,11,10,13,13,11,11,12,11,12,8,12,14,11,11,13,12,13,13,14,13,12,12,9,14,14,20,14,11,13,11,11,7,14,13,13,11,9,13,12,13,6,20,14,10,5,20,15,1,D RL,105,1,1,1,1,1,5,1,15,20,1,1,1,10,10,14,32,0,0,0,0,0,1,0,0,0,0,0,0,0,0,0,0,0,0,0,0,0,0,0,0,0,0,0,0,0,0,0,0,0,0,0,0,0,0,0,0,0,0,0,0,0,0,0,0,André Geraldes,£540Th. ,29,181,Defender - Right-Back,right,APOEL Nicosia,33,0,2,2970,25,0,0,1807,35,0,1,2885,35,0,3,2982,6,0,1,494,Liga NOS
19-06-17,18.3.4.28,Joăo Góis,55029619,788,05-May-90,27,0,0,0,0,3250,5650,5650,125,113,108079,174,68,D RL,3,2,3,3,1,3,2,2,3,3,3,9,11,12,6,10,4,9,10,18,11,11,7,14,12,12,13,14,11,13,9,11,14,12,7,13,12,13,14,13,12,13,7,9,13,13,20,12,11,12,2,11,11,6,11,14,9,12,13,12,11,5,20,15,12,1,20,15,1,D RL,105,1,1,1,1,1,1,1,15,20,1,1,1,12,10,15,1.1259E+15,0,0,0,0,0,0,0,0,0,0,0,0,0,0,0,0,0,0,0,0,0,0,0,0,0,0,0,0,0,0,0,0,0,0,0,0,0,0,0,0,0,0,0,0,0,0,0,0,João Góis,£360Th. ,30,174,Defender - Right-Back,right,Without Club,11,0,0,852,18,1,0,1490,26,0,2,2206,10,0,1,872,nan,nan,nan,nan,Liga NOS
19-06-17,18.3.4.28,Eliseu Nadjack,55033299,788,06-Feb-94,23,0,0,0,0,2750,5300,5300,120,106,103098,179,70,D R,2,1,3,3,3,1,2,2,3,4,1,5,10,12,8,10,6,5,7,11,8,10,8,11,12,12,12,13,8,7,9,8,12,15,5,14,9,13,14,16,15,10,8,11,13,16,20,15,8,10,12,8,5,8,13,7,8,7,14,14,10,6,20,13,7,10,20,1,1,D R,102,1,1,1,1,1,10,1,1,20,1,1,1,7,1,13,0,0,0,0,0,0,0,0,0,0,0,0,0,0,0,0,0,0,0,0,0,0,0,0,0,0,0,0,0,0,0,0,0,0,0,0,0,0,0,0,0,0,0,0,0,0,0,0,0,,,,,,,,,,,,,,,,,,,,,,,,,,,,
19-06-17,18.3.4.28,Joel Ferreira,55045964,788,10-Jan-92,25,0,0,0,0,2250,5500,5500,118,110,135352,180,74,D RL,3,3,1,2,3,3,2,2,2,3,2,8,11,10,6,9,9,10,7,10,12,11,4,13,11,10,12,12,11,14,10,11,14,7,11,10,13,14,13,11,12,11,10,20,13,11,14,14,11,11,10,11,12,13,13,12,13,12,16,16,15,7,20,13,1,1,15,20,7,D RL,105,1,1,1,1,1,1,7,20,15,1,1,1,1,13,1,0,0,0,0,0,0,0,0,0,0,0,0,0,0,0,0,0,0,0,0,0,0,0,0,0,0,0,0,0,0,0,0,0,0,0,0,0,0,0,0,0,0,0,0,0,0,0,0,0,Joel Pereira,£900Th. ,24,189,Goalkeeper,right,Huddersfield Town,16,17,7,1360,3,5,0,192,15,20,4,1329,25,43,5,2280,0,0,0,0,Premier League
19-06-17,18.3.4.28,Wilson Manafá,55061773,788,23-Jul-94,22,0,0,0,0,2750,5000,5000,115,109,102501,173,70,D/M/AM RL,2,3,2,4,3,3,2,2,2,3,3,6,10,9,8,8,8,11,9,10,8,10,8,12,12,13,10,12,11,10,9,7,11,10,7,13,11,12,10,16,12,10,11,6,14,16,20,12,10,8,8,9,6,14,14,9,9,7,13,11,11,3,20,12,16,19,20,17,10,D/M/AM RL,125,1,1,1,10,17,19,1,1,20,1,1,1,16,1,12,0,0,0,0,0,0,0,0,0,0,0,0,0,0,0,0,0,0,0,0,0,0,0,0,0,0,0,0,0,0,0,0,0,0,0,0,0,0,0,0,0,0,0,0,0,0,0,0,0,Wilson Manafá,£270Th. ,26,177,Defender - Right-Back,right,FC Porto,39,3,3,1958,22,0,3,685,34,3,5,2522,45,1,1,3190,6,0,1,467,Liga NOS
19-06-17,18.3.4.28,Ricardo Pereira,55062009,788,06-Oct-93,23,2,0,18,7,5000,6650,7250,160,147,32577088,175,70,D/WB/AM R,2,2,1,1,2,1,2,1,3,3,3,9,14,14,10,13,8,6,12,7,12,12,12,14,15,11,14,13,12,12,12,13,15,15,7,14,10,13,14,16,15,10,9,10,15,15,20,14,9,14,9,12,10,16,12,14,13,14,15,15,12,6,20,16,13,20,20,14,1,D/WB/AM R,122,1,1,7,1,14,20,1,13,20,1,1,1,13,1,16,5.49756E+11,0,1,0,0,0,0,0,0,0,0,0,0,0,0,0,0,0,0,0,0,0,0,0,0,0,0,0,0,0,0,0,0,0,0,0,0,0,0,0,1,0,0,0,0,0,0,0,0,Ricardo Pereira,£18.00m ,27,175,Defender - Right-Back,right,Leicester City,30,2,4,2574,43,2,7,3563,37,2,7,3224,33,4,3,2970,nan,nan,nan,nan,Liga NOS
19-06-17,18.3.4.28,Marcelo Goiano,55062043,1651,13-Oct-87,29,0,0,0,0,3612,5161,6450,137,129,1638418,176,69,D/WB RL,3,3,2,3,2,2,2,2,1,3,1,8,13,12,6,12,11,7,12,11,11,12,12,13,13,11,13,12,12,14,10,13,14,11,14,15,12,12,14,14,14,10,7,12,14,14,20,14,8,15,8,15,6,14,14,10,13,14,15,12,15,6,20,17,1,1,20,20,1,D/WB RL,115,1,1,1,1,1,1,1,20,20,1,1,1,1,15,17,1.44115E+17,0,0,0,0,0,0,0,0,1,0,0,0,0,0,0,0,0,0,0,0,0,0,0,0,0,0,0,0,0,0,0,0,0,0,0,0,0,0,0,0,0,0,0,0,0,0,0,0,Marcelo Goiano,£1.80m ,33,176,Defender - Right-Back,right,Sivasspor,36,0,3,2853,38,1,2,3249,38,1,1,3283,30,0,2,2617,2,0,0,155,Liga NOS
19-06-17,18.3.4.28,Arnold Issoko,55062785,53,06-Apr-92,25,1,0,0,0,3500,5600,5750,116,115,148456,185,76,D/AM RL,4,2,2,2,2,1,3,3,3,2,3,3,10,8,11,7,3,9,11,4,3,9,9,4,7,13,12,14,6,11,7,8,15,14,7,16,9,11,14,18,11,11,14,5,18,17,20,16,14,12,4,10,8,9,13,10,12,10,17,15,14,7,19,13,15,20,20,16,12,D/AM RL,525,1,1,12,12,16,20,1,1,19,1,1,12,15,1,13,2.2518E+15,0,0,0,0,0,0,0,0,0,0,0,0,0,1,0,0,0,0,0,0,0,0,0,0,0,0,0,1,0,0,0,1,0,0,0,0,0,0,0,0,0,0,0,0,0,0,0,0,Arnold Issoko,£720Th. ,28,185,Forward - Right Winger,right,CD Cova Piedade,30,0,1,1348,37,1,1,2603,18,3,8,1599,7,1,0,310,6,2,0,397,Liga NOS
19-06-17,18.3.4.28,Mama Baldé,55070279,23,06-Nov-95,21,0,0,0,0,2250,5650,5650,135,113,334527,181,75,D R,2,1,2,1,3,2,3,2,3,3,2,8,11,11,8,11,5,8,7,13,10,10,5,13,12,12,12,12,9,11,11,9,13,13,10,14,9,11,13,16,14,13,10,8,16,16,20,12,11,13,8,10,4,13,9,12,15,13,14,12,13,6,20,15,7,10,20,1,1,D R,102,1,1,1,1,1,10,1,1,20,1,1,1,7,1,15,134217762,0,1,0,0,0,1,0,0,0,0,0,0,0,0,0,0,0,0,0,0,0,0,0,0,0,0,0,1,0,0,0,0,0,0,0,0,0,0,0,0,0,0,0,0,0,0,0,0,Mama Baldé,£450Th. ,24,181,Forward - Right Winger,right,Dijon FCO,17,0,3,1392,17,3,2,1095,35,10,3,2783,28,6,2,1918,4,1,0,316,Liga NOS
19-06-17,18.3.4.28,Bruno Santos,55074152,1651,07-Feb-93,24,0,0,0,0,3196,4262,6300,126,118,621461,183,79,D R,3,1,2,3,1,2,2,1,2,4,1,7,11,11,7,12,8,7,5,11,10,11,8,13,13,13,12,12,11,12,10,11,12,8,8,13,11,11,13,15,14,13,12,11,12,15,20,12,12,11,9,10,14,11,12,8,11,12,13,10,13,5,20,12,12,1,20,1,12,D R,102,1,1,1,1,1,1,1,1,20,1,12,1,1,1,12,0,0,0,0,0,0,0,0,0,0,0,0,0,0,0,0,0,0,0,0,0,0,0,0,0,0,0,0,0,0,0,0,0,0,0,0,0,0,0,0,0,0,0,0,0,0,0,0,0,Bruno Santos,£540Th. ,27,183,Defender - Right-Back,right,AEL Limassol,32,0,1,2624,27,0,0,2269,32,1,7,2843,25,3,1,2112,4,0,0,327,Liga NOS
19-06-17,18.3.4.28,Nélson Monte,55078869,788,20-Jul-95,21,0,0,0,0,2800,5950,5950,136,119,286015,187,82,D RC,2,3,2,3,1,3,1,3,1,1,2,4,10,10,5,10,3,11,6,10,13,12,3,13,12,14,13,12,13,13,12,12,12,4,10,8,14,14,14,13,13,12,13,10,13,13,20,13,11,12,12,10,5,10,17,11,13,14,14,13,16,5,20,1,1,1,16,1,20,D RC,103,1,1,1,1,1,1,20,1,16,1,1,1,1,1,1,32832,0,0,0,0,0,0,1,0,0,0,0,0,0,0,0,1,0,0,0,0,0,0,0,0,0,0,0,0,0,0,0,0,0,0,0,0,0,0,0,0,0,0,0,0,0,0,0,0,Nélson Monte,£1.80m ,25,187,Defender - Centre-Back,right,Rio Ave FC,12,0,0,1031,33,0,1,2806,18,0,1,1446,25,0,0,2009,6,0,0,539,Liga NOS
19-06-17,18.3.4.28,Fernando Fonseca,55082104,788,14-Mar-97,20,0,0,8,0,2500,5500,5500,135,110,368833,182,66,D R,3,3,3,1,1,2,3,1,2,3,4,10,14,12,9,12,8,9,8,12,10,11,11,12,13,13,13,13,10,11,9,10,15,7,7,13,11,13,13,14,14,12,9,7,14,14,20,14,7,13,8,10,8,12,15,13,15,13,13,9,9,12,20,10,10,1,20,1,1,D R,102,1,1,1,1,1,1,1,1,20,7,1,1,10,1,10,32,0,0,0,0,0,1,0,0,0,0,0,0,0,0,0,0,0,0,0,0,0,0,0,0,0,0,0,0,0,0,0,0,0,0,0,0,0,0,0,0,0,0,0,0,0,0,0,0,Fernando Fonseca,£630Th. ,23,183,Defender - Right-Back,right,FC Paços de Ferreira,30,0,0,2527,19,0,2,1555,3,0,1,270,23,0,2,1943,5,0,0,294,Liga NOS
19-06-17,18.3.4.28,Maxi Pereira,5512991,1657,08-Jun-84,33,121,3,3,0,6000,6900,6900,144,138,232186002,173,70,D R,3,2,2,2,2,1,3,1,2,1,4,11,12,11,10,13,11,8,12,17,12,12,12,15,12,18,15,18,14,15,12,15,19,8,15,16,11,15,18,12,12,14,7,11,14,12,20,13,12,18,18,15,3,16,16,16,6,16,16,6,8,9,20,15,10,1,20,1,1,D R,102,1,1,1,1,1,1,1,1,20,5,1,1,10,1,15,1.1259E+15,0,0,0,0,0,1,0,0,0,0,0,0,0,0,0,0,0,1,0,0,0,0,0,0,0,0,0,0,0,0,0,1,0,0,0,0,0,0,0,0,0,0,0,0,0,0,0,0,Maxi Pereira,£900Th. ,36,173,Defender - Right-Back,right,Retired,35,2,4,2984,23,1,4,1635,30,1,2,2157,nan,nan,nan,nan,nan,nan,nan,nan,Liga NOS
19-06-17,18.3.4.28,Stefan Ristovski,62092056,781,12-Feb-92,25,35,1,12,0,4750,6500,6450,135,129,1834363,180,73,D/WB R,3,1,3,2,3,3,1,1,3,2,3,8,15,12,8,12,6,12,11,10,12,13,7,13,12,12,14,12,10,13,11,12,16,9,9,14,13,15,17,14,13,12,11,8,13,14,20,15,13,15,10,14,8,10,13,16,11,10,15,14,11,4,20,16,14,1,20,10,1,D/WB R,112,1,1,1,1,1,1,1,10,20,1,1,1,14,1,16,1048610,0,1,0,0,0,1,0,0,0,0,0,0,0,0,0,0,0,0,0,0,1,0,0,0,0,0,0,0,0,0,0,0,0,0,0,0,0,0,0,0,0,0,0,0,0,0,0,0,Stefan Ristovski,£2.25m ,28,180,Defender - Right-Back,right,Sporting CP,41,1,9,3530,30,1,4,2409,33,0,4,2639,26,0,4,2008,nan,nan,nan,nan,Liga NOS
19-06-17,18.3.4.28,Tiago Mesquita,67092626,788,23-Nov-90,26,0,0,0,0,3500,5650,5650,116,113,149075,180,75,D R,3,1,2,3,3,2,1,1,2,1,1,8,12,11,7,11,4,7,6,12,12,11,8,13,12,14,13,13,10,13,10,12,12,9,8,13,12,12,14,14,12,13,10,8,13,13,20,13,12,13,11,11,6,10,18,11,11,11,14,12,12,7,20,13,1,1,20,1,10,D R,102,1,1,1,1,1,1,10,1,20,1,1,1,1,1,13,2,0,1,0,0,0,0,0,0,0,0,0,0,0,0,0,0,0,0,0,0,0,0,0,0,0,0,0,0,0,0,0,0,0,0,0,0,0,0,0,0,0,0,0,0,0,0,0,0,Tiago Mesquita,£270Th. ,29,180,Defender - Right-Back,right,Académico Viseu FC,16,0,2,1149,6,0,1,459,12,0,1,981,16,0,2,1311,5,0,0,358,Liga NOS
19-06-17,18.3.4.28,Vasco Fernandes,727458,788,12-Nov-86,30,0,0,11,0,4400,5900,5900,123,118,232186002,182,79,D RC,4,2,2,2,2,1,2,1,3,1,2,7,9,9,6,10,8,10,9,8,13,11,10,14,11,12,15,14,11,10,8,12,15,12,15,10,12,14,13,13,13,13,12,8,16,14,20,14,12,12,14,12,6,12,13,14,10,12,15,14,15,6,20,1,1,1,18,1,20,D RC,103,1,1,1,1,1,1,20,1,18,14,1,1,1,1,1,34,0,1,0,0,0,1,0,0,0,0,0,0,0,0,0,0,0,0,0,0,0,0,0,0,0,0,0,0,0,0,0,0,0,0,0,0,0,0,0,0,0,0,0,0,0,0,0,0,Vasco Fernandes,£720Th. ,33,182,Defender - Centre-Back,right,Ümraniyespor,34,2,0,2901,27,2,2,2366,37,1,1,3360,20,1,1,1770,5,1,0,377,Liga NOS
19-06-17,18.3.4.28,Ricardo Pessoa,729932,788,05-Feb-82,35,0,0,1,0,3000,5200,5200,110,108,7886,173,69,D/WB R,1,3,1,1,1,2,2,1,3,3,3,10,14,10,7,8,18,9,11,12,11,12,15,13,11,10,12,12,12,11,11,13,15,7,17,12,13,15,12,11,11,13,10,5,11,12,20,13,11,13,8,13,6,13,9,12,18,12,15,13,13,4,20,18,12,8,20,10,1,D/WB R,112,1,1,1,1,1,8,1,10,20,1,1,1,12,1,18,2,0,1,0,0,0,0,0,0,0,0,0,0,0,0,0,0,0,0,0,0,0,0,0,0,0,0,0,0,0,0,0,0,0,0,0,0,0,0,0,0,0,0,0,0,0,0,0,0,Ricardo Pessoa,£68Th. ,38,177,Defender - Right-Back,right,Retired,30,4,5,2664,11,1,0,895,nan,nan,nan,nan,nan,nan,nan,nan,nan,nan,nan,nan,Liga NOS
19-06-17,18.3.4.28,Ricardo,735107,12,19-Aug-80,36,17,1,0,0,4750,6000,6000,128,120,25430,185,80,D RC,2,1,1,2,2,3,1,1,2,3,3,7,7,6,5,9,9,14,9,11,14,9,8,14,9,14,12,14,10,14,7,12,15,7,17,6,14,13,15,10,12,14,15,7,16,10,20,12,13,12,11,8,8,12,12,12,14,11,15,12,14,6,20,1,1,1,15,1,20,D RC,103,1,5,1,1,1,1,20,1,15,13,1,1,1,1,1,64,0,0,0,0,0,0,1,0,0,0,0,0,0,0,0,0,0,0,0,0,0,0,0,0,0,0,0,0,0,0,0,0,0,0,0,0,0,0,0,0,0,0,0,0,0,0,0,0,Ricardo,£90Th. ,40,186,Defender - Centre-Back,right,Retired,16,2,0,1440,20,0,0,1568,33,0,0,2969,16,0,0,1165,nan,nan,nan,nan,Liga NOS
19-06-17,18.3.4.28,Pedrinho,743337,788,06-Mar-85,32,0,0,0,0,4250,5300,5300,120,107,53543,177,71,D R,3,1,1,1,1,1,1,2,3,3,3,9,11,11,6,11,8,9,10,11,10,10,8,12,11,11,13,13,12,12,11,12,14,12,13,13,11,12,13,13,13,11,8,8,12,13,20,12,11,12,9,13,8,11,9,13,13,11,15,15,15,6,20,15,12,12,20,13,5,D R,102,1,1,1,5,1,12,1,13,20,1,1,1,12,10,15,2.2518E+15,0,0,0,0,1,0,0,0,0,0,0,0,0,0,0,0,0,0,0,0,0,0,0,0,0,0,0,0,0,0,0,0,0,0,0,0,0,0,0,0,0,0,0,0,0,0,0,0,Pedrinho,£720Th. ,27,170,Midfielder - Attacking Midfield,right,Riga FC,34,5,3,2827,35,4,3,3112,36,1,5,2457,49,4,5,3916,1,1,0,85,Liga NOS
19-06-17,18.3.4.28,Barge,748235,788,04-Jan-84,33,0,0,0,0,3500,5500,5500,119,110,36315,174,69,D/M/AM R,3,2,1,2,1,3,2,3,3,3,3,13,12,9,8,9,10,8,9,10,11,11,6,12,11,13,12,12,13,12,8,13,14,9,13,12,13,13,13,12,11,11,9,8,13,12,20,12,11,13,8,15,10,14,12,10,12,12,14,12,10,7,20,15,18,17,20,12,13,D/M/AM R,122,1,1,1,7,12,17,1,10,20,1,13,12,18,1,15,1048640,0,0,0,0,0,0,1,0,0,0,0,0,0,0,0,0,0,0,0,0,1,0,0,0,0,0,0,0,0,0,0,0,0,0,0,0,0,0,0,0,0,0,0,0,0,0,0,0,Barge,£90Th. ,36,174,Defender - Right-Back,right,Retired,28,0,2,2279,3,0,0,219,nan,nan,nan,nan,nan,nan,nan,nan,nan,nan,nan,nan,Liga NOS
19-06-17,18.3.4.28,Koffi Kouao,83177137,24,20-May-98,19,0,0,0,0,1750,4750,5250,120,105,177378,171,66,D R,2,4,2,3,1,4,2,3,1,3,2,8,10,11,5,11,11,6,8,12,10,11,7,12,12,11,11,13,7,10,7,9,13,11,8,13,10,13,15,15,14,10,7,10,14,15,20,14,8,14,11,11,5,11,12,11,8,10,11,10,12,7,20,13,1,1,20,1,1,D R,102,1,1,1,1,1,1,1,1,20,1,1,1,1,1,13,2.28698E+15,0,0,0,0,0,0,0,0,0,1,0,0,0,0,0,0,0,0,0,0,0,0,0,0,0,0,0,0,0,0,0,0,0,0,0,0,0,0,0,0,0,0,0,0,0,1,0,0,Koffi Kouao,£270Th. ,22,173,Defender - Right-Back,right,FC Vizela,8,0,2,720,15,0,0,833,9,0,1,685,1,0,1,90,7,1,0,630,Liga NOS
19-06-17,18.3.4.28,Jacob Adebanjo,84100406,38,05-Sep-93,23,0,0,0,0,1264,4300,4250,110,100,3840,184,78,D/DM RC,1,3,1,1,1,3,2,4,2,2,1,7,7,10,8,12,7,12,8,10,11,12,11,12,12,16,12,14,10,11,11,10,12,10,9,10,12,13,12,12,12,10,13,4,14,13,20,13,13,10,9,4,10,16,13,11,13,12,13,12,10,5,17,1,10,1,15,1,17,D/DM RC,323,1,1,1,1,1,1,17,1,15,20,10,1,1,1,1,0,0,0,0,0,0,0,0,0,0,0,0,0,0,0,0,0,0,0,0,0,0,0,0,0,0,0,0,0,0,0,0,0,0,0,0,0,0,0,0,0,0,0,0,0,0,0,0,0,Jacob Adebanjo,£90Th. ,27,184,Midfielder - Defensive Midfield,right,Without Club,1,0,0,90,1,0,0,10,2,0,0,180,3,1,0,77,nan,nan,nan,nan,Liga NOS
19-06-17,18.3.4.28,Emmanuel Hackman,84102962,21,14-May-95,22,0,0,0,0,2783,4554,5250,128,106,86929,180,72,D RL,1,3,3,3,1,1,3,1,2,2,1,5,9,8,6,8,6,13,6,14,12,9,8,14,7,15,14,15,9,12,6,6,14,7,8,13,12,13,15,14,14,14,11,8,14,14,20,15,11,11,8,9,4,15,15,13,11,15,16,14,14,11,20,1,1,1,20,18,10,D RL,105,1,1,1,1,1,1,10,18,20,14,1,1,1,1,1,0,0,0,0,0,0,0,0,0,0,0,0,0,0,0,0,0,0,0,0,0,0,0,0,0,0,0,0,0,0,0,0,0,0,0,0,0,0,0,0,0,0,0,0,0,0,0,0,0,Emmanuel Hackman,£720Th. ,25,187,Defender - Right-Back,right,Portimonense SC,24,2,0,2012,31,0,2,2657,16,0,1,1004,22,2,2,1683,nan,nan,nan,nan,Liga NOS
19-06-17,18.3.4.28,Rodrigo Soares,84125466,1651,26-Dec-92,24,0,0,0,0,2306,4100,5000,122,100,53140,176,71,D/WB RL,3,1,1,3,3,4,2,2,2,3,4,6,10,10,6,10,8,7,7,11,10,11,4,11,13,8,11,9,8,13,8,10,15,8,7,13,9,11,11,15,13,10,8,5,12,15,20,12,8,14,10,9,4,6,8,11,8,10,14,12,13,6,20,18,1,1,20,16,1,D/WB RL,115,1,1,1,1,1,1,1,16,20,1,1,1,1,10,18,0,0,0,0,0,0,0,0,0,0,0,0,0,0,0,0,0,0,0,0,0,0,0,0,0,0,0,0,0,0,0,0,0,0,0,0,0,0,0,0,0,0,0,0,0,0,0,0,0,,,,,,,,,,,,,,,,,,,,,,,,,,,,
19-06-17,18.3.4.28,Pierre Sagna,85042904,769,21-Aug-90,26,0,0,0,0,3647,4689,6050,128,121,287769,183,76,D R,1,3,1,2,3,3,3,1,2,3,2,5,12,11,6,10,5,9,7,11,9,9,8,14,12,11,13,12,8,14,8,13,12,8,10,12,13,13,14,15,14,14,12,7,15,15,20,14,12,12,12,13,7,12,13,14,14,12,13,13,10,8,20,15,5,1,20,10,1,D R,102,1,1,1,1,1,1,1,10,20,1,1,1,5,1,15,32,0,0,0,0,0,1,0,0,0,0,0,0,0,0,0,0,0,0,0,0,0,0,0,0,0,0,0,0,0,0,0,0,0,0,0,0,0,0,0,0,0,0,0,0,0,0,0,0,Pierre Sagna,£720Th. ,30,183,Defender - Right-Back,right,CD Santa Clara,32,0,1,2704,33,0,3,2811,16,0,0,803,29,1,0,2426,3,0,1,118,Liga NOS
19-06-17,18.3.4.28,Fahd Moufi,85137119,34,05-May-96,21,0,0,1,0,2000,4750,4750,119,95,59141,176,71,D R,1,2,2,2,3,1,1,3,2,1,2,7,12,9,5,9,5,8,5,11,10,12,5,12,11,14,11,10,9,10,9,9,7,2,7,12,11,13,13,13,13,11,9,8,12,13,20,13,12,10,12,4,8,8,12,10,12,10,12,7,13,6,20,15,13,10,20,1,1,D R,102,1,1,1,1,1,10,1,1,20,1,1,1,13,1,15,0,0,0,0,0,0,0,0,0,0,0,0,0,0,0,0,0,0,0,0,0,0,0,0,0,0,0,0,0,0,0,0,0,0,0,0,0,0,0,0,0,0,0,0,0,0,0,0,0,Fahd Moufi,£180Th. ,24,177,Defender - Right-Back,right,Portimonense SC,19,0,0,1557,3,0,0,200,16,1,0,1262,28,0,1,2403,0,0,0,0,Liga NOS
19-06-17,18.3.4.28,Víctor García,86017958,1658,11-Jun-94,23,7,0,6,1,4500,6100,6200,146,124,1368277,178,71,D/WB/M R,1,2,1,2,3,3,1,1,4,1,2,11,12,12,8,12,9,9,6,12,11,12,12,12,13,12,12,13,10,11,8,11,16,11,7,16,11,13,13,17,14,12,7,6,14,16,20,15,8,14,9,10,7,10,14,12,15,14,15,11,11,11,20,16,18,10,20,1,10,D/WB/M R,122,1,1,1,1,1,10,1,1,20,5,10,1,18,1,16,32,0,0,0,0,0,1,0,0,0,0,0,0,0,0,0,0,0,0,0,0,0,0,0,0,0,0,0,0,0,0,0,0,0,0,0,0,0,0,0,0,0,0,0,0,0,0,0,0,Víctor García,£1.13m ,26,178,Defender - Right-Back,right,AD Alcorcón,22,0,3,1967,21,0,1,1681,9,0,1,810,17,0,1,1459,3,0,0,52,Liga NOS
19-06-17,18.3.4.28,Gabriel Mercado,14000758,1649,18-Mar-87,30,14,3,20,1,5250,7200,7200,144,142,232186002,180,83,D RC,2,1,3,1,1,2,3,2,1,3,4,6,12,11,9,13,6,15,7,14,14,12,10,15,11,16,15,15,13,14,12,14,16,5,14,15,15,15,16,12,12,15,13,9,15,13,20,15,14,16,14,18,13,17,12,13,17,12,17,8,7,2,20,15,1,1,20,9,16,D RC,103,1,1,1,1,1,1,16,9,20,1,1,1,1,1,15,2147614752,0,0,0,0,0,1,0,0,0,0,0,0,0,0,0,0,0,1,0,0,0,0,0,0,0,0,0,0,0,0,0,1,0,0,0,0,0,0,0,0,0,0,0,0,0,0,0,0,Gabriel Mercado,£4.50m ,33,181,Defender - Centre-Back,right,Al-Rayyan SC,40,3,1,3103,43,0,2,3626,34,3,2,2753,21,3,0,1890,4,0,0,360,LaLiga
19-06-17,18.3.4.28,Facundo Roncaglia,14001537,1649,10-Feb-87,30,14,0,0,0,6000,6850,6850,150,137,10192786,179,76,D RC,3,3,3,3,1,1,2,4,2,2,3,6,10,10,11,12,6,15,12,13,15,13,9,14,12,15,14,13,13,10,11,12,16,6,10,10,14,15,15,13,12,14,13,9,14,12,20,15,16,12,13,13,7,13,14,13,12,10,11,9,12,12,20,1,1,1,19,14,20,D RC,103,1,1,1,1,1,1,20,14,19,1,1,1,1,1,1,1.37439E+11,0,0,0,0,0,1,0,0,1,0,0,0,0,0,0,0,0,0,0,0,0,0,0,0,0,0,0,0,0,0,0,0,0,0,0,0,0,1,0,0,0,0,0,0,0,0,0,0,Facundo Roncaglia,£2.70m ,33,179,Defender - Centre-Back,right,CA Osasuna,48,3,1,3942,22,0,0,1500,24,0,0,2092,19,1,0,1580,4,1,1,334,LaLiga
19-06-17,18.3.4.28,Antonio Barragán,1504803,796,12-Jun-87,30,0,0,1,0,5250,6750,6750,144,126,232186002,186,83,D/WB R,4,2,1,4,3,4,3,3,3,1,4,6,10,9,6,13,6,12,8,12,13,11,8,14,12,11,12,13,11,12,12,12,12,9,10,14,13,15,14,13,13,13,13,10,13,14,20,14,13,13,7,13,10,13,12,12,9,12,14,13,12,8,20,18,12,1,20,9,10,D/WB R,112,1,1,1,1,1,1,10,9,20,1,1,1,12,8,18,1.1259E+15,0,0,0,0,0,0,0,0,0,0,0,0,0,0,0,0,0,0,0,0,0,0,0,0,0,0,0,0,0,0,0,0,0,0,0,0,0,0,0,0,0,0,0,0,0,0,0,0,Antonio Barragán,£2.25m ,33,186,Defender - Right-Back,right,Elche CF,27,0,0,2286,31,0,6,2426,24,0,1,1699,14,0,2,847,2,0,0,180,LaLiga
19-06-17,18.3.4.28,Sergio Sánchez,1507596,796,03-Apr-86,31,0,0,4,0,4900,6250,6250,140,123,232186002,185,78,D RC,1,2,4,3,3,3,1,1,2,3,3,6,12,8,8,12,6,14,7,10,15,13,8,13,12,16,14,14,12,14,8,13,16,7,13,10,13,12,13,11,11,12,12,10,12,11,20,12,11,15,16,10,9,13,8,13,14,12,11,8,9,12,20,7,1,1,15,1,20,D RC,103,1,1,1,1,1,1,20,1,15,10,1,1,1,1,7,131072,0,0,0,0,0,0,0,0,0,0,0,0,0,0,0,0,0,1,0,0,0,0,0,0,0,0,0,0,0,0,0,0,0,0,0,0,0,0,0,0,0,0,0,0,0,0,0,0,Sergio Sánchez,£900Th. ,34,185,Defender - Centre-Back,right,Without Club,20,0,0,1736,4,0,0,236,22,1,1,1918,2,0,0,180,nan,nan,nan,nan,LaLiga
19-06-17,18.3.4.28,Anaitz Arbilla,1509367,796,15-May-87,30,0,0,0,0,4250,6450,6450,132,130,232186002,177,75,D/WB RLC,3,1,2,3,2,1,4,2,3,2,3,10,11,12,9,10,14,10,15,12,11,10,9,13,10,12,11,14,9,14,9,12,10,9,7,12,13,15,14,13,13,10,9,15,12,12,20,14,10,14,7,4,8,17,12,11,8,8,10,11,10,7,20,20,15,15,20,19,15,D/WB RLC,116,1,1,1,15,1,1,10,19,20,1,10,9,15,15,20,4.67293E+12,0,0,0,0,0,0,0,0,1,1,0,0,0,0,0,0,0,0,0,0,1,0,0,0,0,0,0,0,0,0,0,0,0,0,0,0,0,0,1,0,0,0,1,0,0,0,0,0,Anaitz Arbilla,£1.80m ,33,178,Defender - Centre-Back,right,SD Eibar,23,0,2,1662,31,2,1,2452,27,1,3,2123,24,1,0,2007,5,0,1,278,LaLiga
19-06-17,18.3.4.28,Carlos Martínez,1511410,796,09-Apr-86,31,0,0,0,0,4000,6400,6400,138,128,2727346,189,79,D R,2,2,3,2,1,3,3,1,1,1,2,5,10,10,6,12,2,10,3,10,12,10,4,14,12,16,14,18,15,14,12,11,12,13,10,13,15,16,17,11,9,11,15,13,11,14,20,17,14,14,10,11,15,13,13,10,15,11,14,14,10,8,20,15,1,1,20,1,10,D R,102,1,1,1,1,1,1,10,1,20,1,1,1,1,1,15,1.09951E+12,0,0,0,0,0,1,0,0,0,0,0,0,0,0,0,0,0,0,0,0,0,0,0,0,0,0,0,0,0,0,0,0,0,0,0,0,0,0,0,0,1,0,0,0,0,0,0,0,Carlos Martínez,£450Th. ,34,189,Defender - Right-Back,right,Retired,11,0,3,959,2,0,0,92,15,0,1,1085,17,0,0,1027,nan,nan,nan,nan,LaLiga
19-06-17,18.3.4.28,Coke,1511783,796,26-Apr-87,30,0,0,0,0,5200,6700,6700,139,134,232186002,177,74,D/WB R,1,2,2,3,2,2,1,3,1,3,2,8,14,10,11,13,8,15,12,14,10,12,12,13,12,17,14,16,15,16,11,12,18,11,18,15,10,13,17,11,13,15,11,12,14,12,20,14,10,16,9,18,8,15,8,15,15,16,18,14,10,5,20,20,15,15,20,1,10,D/WB R,112,1,1,1,1,1,15,10,1,20,10,10,1,15,1,20,1024,0,0,0,0,0,0,0,0,0,0,1,0,0,0,0,0,0,0,0,0,0,0,0,0,0,0,0,0,0,0,0,0,0,0,0,0,0,0,0,0,0,0,0,0,0,0,0,0,Coke,£1.80m ,33,176,Defender - Right-Back,right,Levante UD,8,1,0,629,20,3,0,1566,30,5,1,2084,20,3,0,1288,1,0,0,5,LaLiga
19-06-17,18.3.4.28,Roberto Rosales,18011736,1658,20-Nov-88,28,68,0,4,0,5900,7300,6900,146,138,12957719,175,71,D/WB R,1,3,2,2,2,2,3,3,2,4,2,13,15,15,7,14,10,11,12,12,12,13,8,15,14,12,12,16,14,10,9,10,12,9,8,13,14,11,14,15,15,12,9,8,15,15,20,16,12,12,12,15,10,12,14,12,13,11,14,12,13,4,20,19,12,8,20,5,1,D/WB R,112,1,1,1,1,1,8,1,5,20,1,1,1,12,1,19,32,0,0,0,0,0,1,0,0,0,0,0,0,0,0,0,0,0,0,0,0,0,0,0,0,0,0,0,0,0,0,0,0,0,0,0,0,0,0,0,0,0,0,0,0,0,0,0,0,Roberto Rosales,£2.25m ,31,174,Defender - Right-Back,right,CD Leganés,34,1,2,3041,36,1,0,3130,26,3,2,2230,28,0,1,2173,3,1,0,252,LaLiga
19-06-17,18.3.4.28,Michel,19019226,1651,15-Feb-90,27,0,0,3,0,5250,6300,6450,141,129,3742775,174,67,D/WB R,1,3,1,1,2,2,1,2,3,2,3,12,14,13,12,12,10,7,10,11,12,12,11,12,12,11,13,12,12,11,11,12,14,12,7,15,12,11,12,15,15,11,7,11,14,14,20,15,8,12,8,8,12,13,19,14,10,12,11,12,14,10,20,19,11,1,20,1,1,D/WB R,112,1,1,1,1,1,1,1,1,20,1,1,1,11,1,19,32,0,0,0,0,0,1,0,0,0,0,0,0,0,0,0,0,0,0,0,0,0,0,0,0,0,0,0,0,0,0,0,0,0,0,0,0,0,0,0,0,0,0,0,0,0,0,0,0,Míchel,£1.62m ,30,177,Defender - Right-Back,right,Sport Club Corinthians Paulista,26,0,4,2149,28,0,2,2136,11,1,0,718,7,0,0,426,nan,nan,nan,nan,LaLiga
19-06-17,18.3.4.28,Djene Dakonam,211232,50,31-Dec-91,25,30,0,0,0,5200,6450,6450,135,130,3847149,176,71,D/DM RC,3,2,3,2,4,3,2,3,3,2,1,9,11,9,5,11,7,7,8,11,14,9,8,13,10,11,12,13,12,14,11,12,10,8,9,11,12,12,15,15,14,11,7,11,15,14,20,14,12,12,10,6,11,15,6,14,11,12,11,11,16,3,20,15,12,1,19,14,20,D/DM RC,113,1,1,1,1,1,1,20,14,19,18,12,1,1,14,15,0,0,0,0,0,0,0,0,0,0,0,0,0,0,0,0,0,0,0,0,0,0,0,0,0,0,0,0,0,0,0,0,0,0,0,0,0,0,0,0,0,0,0,0,0,0,0,0,0,,,,,,,,,,,,,,,,,,,,,,,,,,,,
19-06-17,18.3.4.28,Sime Vrsaljko,24004437,761,10-Jan-92,25,26,0,12,0,5950,7300,7300,156,146,20766118,181,76,D/WB/M R,3,1,2,3,1,1,4,2,1,3,2,9,14,10,4,11,3,13,7,12,15,11,8,15,12,15,14,15,9,10,10,13,17,8,10,12,13,12,15,14,14,14,13,9,18,16,20,19,13,10,10,10,8,18,18,18,12,15,14,4,7,8,20,19,18,1,20,14,1,D/WB/M R,122,1,1,1,1,1,1,1,14,20,1,1,12,18,13,19,134217826,0,1,0,0,0,1,1,0,0,0,0,0,0,0,0,0,0,0,0,0,0,0,0,0,0,0,0,1,0,0,0,0,0,0,0,0,0,0,0,0,0,0,0,0,0,0,0,0,Sime Vrsaljko,£22.50m ,28,181,Defender - Right-Back,right,Atlético Madrid,25,1,2,1794,29,0,5,2134,13,0,2,912,7,0,1,482,nan,nan,nan,nan,LaLiga
19-06-17,18.3.4.28,Pablo Maffeo,28095341,796,12-Jul-97,19,0,0,0,0,4500,6250,6250,131,125,15426436,173,0,D/WB R,3,1,2,2,2,3,1,3,1,2,3,6,11,13,7,10,7,13,9,10,12,12,4,13,13,13,12,14,10,12,9,13,14,13,10,13,12,14,14,14,13,13,12,12,18,13,20,13,13,14,12,11,11,8,16,11,12,12,12,8,11,8,20,17,10,1,20,1,1,D/WB R,112,1,1,1,1,1,1,1,1,20,1,1,1,10,1,17,0,0,0,0,0,0,0,0,0,0,0,0,0,0,0,0,0,0,0,0,0,0,0,0,0,0,0,0,0,0,0,0,0,0,0,0,0,0,0,0,0,0,0,0,0,0,0,0,0,Pablo Maffeo,£9.00m ,23,172,Defender - Right-Back,right,SD Huesca,20,1,2,1624,34,0,2,2713,9,0,0,691,35,0,2,2762,4,1,0,340,LaLiga
19-06-17,18.3.4.28,Sébastien Corchia,34002343,769,01-Nov-90,26,1,0,26,3,5500,6750,6750,139,135,8366675,176,64,D/WB R,2,1,2,1,2,3,1,1,2,3,1,12,13,12,7,13,13,11,11,11,14,13,11,14,13,13,13,14,13,13,11,13,17,12,11,10,12,14,14,14,14,12,8,8,17,14,20,15,12,14,12,13,5,12,16,15,15,14,17,15,14,7,20,16,15,14,20,12,1,D/WB R,112,1,1,1,1,1,14,1,12,20,1,1,1,15,12,16,2.2518E+15,0,0,0,0,0,0,0,0,0,0,0,0,0,0,0,0,0,0,0,0,0,0,0,0,0,0,0,0,0,0,0,0,0,0,0,0,0,0,0,0,0,0,0,0,0,0,0,0,Sébastien Corchia,£3.60m ,29,176,Defender - Right-Back,right,FC Nantes,42,2,4,3778,20,0,3,1377,12,0,0,906,7,0,1,630,1,0,0,90,LaLiga
19-06-17,18.3.4.28,Daniele Bonera,3801706,776,31-May-81,36,16,0,34,0,5500,6500,6250,142,127,289222,183,74,D RC,1,2,1,1,1,1,1,3,2,3,3,2,9,8,4,10,2,14,8,13,16,11,5,14,11,13,14,13,15,14,9,13,14,5,15,10,16,15,14,10,9,10,11,9,9,11,20,13,13,13,15,8,15,12,13,13,17,13,16,15,16,8,20,2,1,1,18,10,20,D RC,103,1,1,1,1,1,1,20,10,18,1,1,1,1,1,2,0,0,0,0,0,0,0,0,0,0,0,0,0,0,0,0,0,0,0,0,0,0,0,0,0,0,0,0,0,0,0,0,0,0,0,0,0,0,0,0,0,0,0,0,0,0,0,0,0,Daniele Bonera,£180Th. ,39,183,Defender - Centre-Back,right,Retired,10,0,0,900,21,0,2,1730,11,0,0,726,nan,nan,nan,nan,nan,nan,nan,nan,LaLiga
19-06-17,18.3.4.28,Miguel Layún,51000344,379,25-Jun-88,28,55,4,0,0,4750,6550,6950,149,139,10202024,179,73,D/WB RL,1,1,2,2,3,2,4,3,2,1,1,16,16,12,11,13,14,8,13,10,11,14,15,12,14,14,11,13,14,12,13,13,17,12,14,13,12,13,13,14,13,12,8,10,14,14,20,14,9,15,9,12,4,18,16,16,13,15,17,15,16,8,20,18,12,12,20,20,12,D/WB RL,115,1,1,1,1,12,9,10,20,20,1,12,8,12,18,15,2.2518E+15,0,0,0,0,0,1,0,0,0,0,0,0,0,0,0,0,0,0,0,0,0,0,0,0,0,0,0,0,0,0,0,0,0,0,0,0,0,0,0,0,0,0,0,0,0,0,0,0,Miguel Layún,£4.50m ,32,178,Midfielder - Right Midfield,right,CF Monterrey,25,3,4,1607,32,4,0,1786,34,1,3,2607,36,5,2,2567,15,0,2,772,LaLiga
19-06-17,18.3.4.28,Nélson Semedo,55061470,788,16-Nov-93,23,6,0,0,0,5500,7050,7500,164,150,34090851,177,67,D R,1,3,2,2,3,1,1,2,2,2,2,8,12,15,11,15,8,7,12,11,11,12,8,14,16,13,14,14,14,13,11,13,15,14,6,16,13,14,15,17,16,13,8,12,15,16,20,15,11,14,11,15,7,15,16,13,14,15,17,13,10,10,20,15,14,11,20,1,14,D R,102,1,1,1,1,1,11,1,1,20,13,14,1,14,1,15,34,0,1,0,0,0,1,0,0,0,0,0,0,0,0,0,0,0,0,0,0,0,0,0,0,0,0,0,0,0,0,0,0,0,0,0,0,0,0,0,0,0,0,0,0,0,0,0,0,Nélson Semedo,£27.00m ,26,177,Defender - Right-Back,right,Wolverhampton Wanderers,47,2,12,4217,36,0,2,2494,46,1,3,2886,42,1,6,2993,4,0,0,331,LaLiga
19-06-17,18.3.4.28,Rúben Vezo,55067158,788,25-Apr-94,23,0,0,5,2,4768,6024,6750,148,136,9498924,182,80,D RC,2,2,3,3,1,2,1,3,1,3,3,6,10,11,6,12,7,13,7,12,13,12,10,13,13,9,13,14,14,10,12,13,13,6,11,11,14,15,15,15,15,12,14,11,15,14,20,16,11,11,8,10,7,12,11,12,14,10,17,13,14,5,20,1,1,1,16,7,20,D RC,103,1,1,1,1,1,1,20,7,16,10,1,1,1,1,1,0,0,0,0,0,0,0,0,0,0,0,0,0,0,0,0,0,0,0,0,0,0,0,0,0,0,0,0,0,0,0,0,0,0,0,0,0,0,0,0,0,0,0,0,0,0,0,0,0,Rúben Vezo,£5.40m ,26,182,Defender - Centre-Back,right,Levante UD,20,0,1,1624,26,1,0,2142,27,2,1,2082,30,0,1,2700,4,0,0,360,LaLiga
19-06-17,18.3.4.28,Antonio Rukavina,5754526,802,26-Jan-84,33,39,0,8,0,5300,6850,6450,135,129,1166463,177,73,D/WB R,1,2,3,1,1,2,1,3,3,3,2,11,12,12,8,12,8,6,11,12,13,12,14,13,11,13,13,16,11,15,8,13,12,8,11,15,14,16,17,14,10,11,9,8,13,15,20,14,12,13,9,13,6,12,14,12,13,11,14,13,15,5,20,18,13,1,20,12,1,D/WB R,112,1,1,1,1,1,1,1,12,20,1,1,1,13,10,18,2.74878E+11,0,0,0,0,0,0,0,0,0,0,0,0,0,0,0,0,0,0,0,0,0,0,0,0,0,0,0,0,0,0,0,0,0,0,0,0,0,0,1,0,0,0,0,0,0,0,0,0,Antonio Rukavina,£900Th. ,36,177,Defender - Right-Back,right,FC Astana,12,0,1,991,27,0,0,2169,43,0,2,3900,19,0,4,1603,nan,nan,nan,nan,LaLiga
19-06-17,18.3.4.28,Javi López,67006184,796,21-Jan-86,31,0,0,0,0,4000,6250,6250,141,125,1429170,179,74,D/WB/M RC,2,2,3,2,3,3,1,3,1,2,1,9,12,11,8,11,8,7,10,11,12,13,6,13,11,13,12,14,11,13,11,11,9,8,13,14,14,15,16,12,12,13,8,12,13,12,20,13,11,15,9,10,11,17,13,11,11,12,12,12,17,2,20,18,19,14,20,10,15,D/WB/M RC,123,1,1,1,1,8,14,1,5,20,14,15,10,19,8,18,0,0,0,0,0,0,0,0,0,0,0,0,0,0,0,0,0,0,0,0,0,0,0,0,0,0,0,0,0,0,0,0,0,0,0,0,0,0,0,0,0,0,0,0,0,0,0,0,0,Javi López,£900Th. ,34,180,Defender - Right-Back,right,Without Club,20,0,1,1614,15,0,0,1039,25,0,0,2159,28,1,1,2375,nan,nan,nan,nan,LaLiga
19-06-17,18.3.4.28,Diego Llorente,67011217,796,16-Aug-93,23,1,0,6,0,5150,7100,7100,153,145,25807228,186,75,D RC,2,2,3,1,1,3,1,2,2,3,3,8,10,9,6,14,6,14,6,13,15,13,9,16,14,15,14,18,12,15,9,15,8,6,11,7,16,15,16,12,11,8,13,10,12,13,20,14,13,13,12,10,8,15,9,9,13,12,9,12,18,6,20,10,1,1,17,12,20,D RC,103,1,1,1,1,1,1,20,12,17,12,1,1,1,1,10,32,0,0,0,0,0,1,0,0,0,0,0,0,0,0,0,0,0,0,0,0,0,0,0,0,0,0,0,0,0,0,0,0,0,0,0,0,0,0,0,0,0,0,0,0,0,0,0,0,Diego Llorente,£15.75m ,27,186,Defender - Centre-Back,right,Leeds United,27,2,0,2209,34,7,0,2912,23,0,0,1931,30,1,2,2418,1,0,0,90,LaLiga
19-06-17,18.3.4.28,Miguel Torres,67011252,796,28-Jan-86,31,0,0,12,0,4250,6700,6300,134,126,232186002,185,81,D RLC,2,1,2,3,1,1,1,2,1,1,2,12,14,11,3,14,11,13,9,16,14,12,7,15,14,14,14,16,13,16,10,12,10,5,11,7,13,17,16,11,11,8,12,10,11,12,20,11,11,10,13,14,12,19,9,10,18,14,16,13,17,3,20,14,8,1,20,19,17,D RLC,106,1,1,1,1,1,1,17,19,20,8,3,8,8,10,14,4294967296,0,0,0,0,0,0,0,0,0,0,0,0,0,0,0,0,0,0,0,0,0,0,0,0,0,0,0,0,0,0,0,0,1,0,0,0,0,0,0,0,0,0,0,0,0,0,0,0,Miguel Torres,£720Th. ,34,184,Defender - Right-Back,right,Retired,23,0,0,1654,8,0,0,676,1,0,0,22,nan,nan,nan,nan,nan,nan,nan,nan,LaLiga
19-06-17,18.3.4.28,Eneko Bóveda,67018261,796,14-Dec-88,28,0,0,0,0,4400,6500,6500,134,132,4818967,180,78,D/WB RLC,3,2,2,3,2,2,1,3,2,3,2,4,11,11,3,10,6,12,8,14,12,12,4,14,12,11,14,14,13,14,10,13,15,9,11,13,14,14,15,13,12,13,11,10,11,14,20,15,13,13,10,11,13,14,11,11,14,11,15,10,16,6,20,18,14,9,20,15,18,D/WB RLC,116,1,1,1,1,1,9,18,15,20,1,1,1,14,11,18,0,0,0,0,0,0,0,0,0,0,0,0,0,0,0,0,0,0,0,0,0,0,0,0,0,0,0,0,0,0,0,0,0,0,0,0,0,0,0,0,0,0,0,0,0,0,0,0,0,Eneko Bóveda,£1.35m ,31,182,Defender - Right-Back,right,Deportivo de La Coruña,23,0,0,1839,16,0,1,1326,24,0,1,1907,32,1,4,2725,2,1,0,149,LaLiga
19-06-17,18.3.4.28,Aday,67029382,796,16-Dec-87,29,0,0,0,0,3400,6250,6250,127,126,3131555,179,78,D/WB/M/AM RL,1,2,1,3,4,2,1,2,3,2,1,11,13,13,8,13,8,7,9,11,7,12,7,7,14,11,11,12,11,11,12,12,12,13,10,14,9,11,11,13,13,12,7,12,11,13,20,12,9,14,12,7,11,18,17,12,13,11,12,9,8,7,19,18,20,18,20,19,1,D/WB/M/AM RL,445,1,1,1,1,10,18,1,19,15,1,1,15,20,16,18,2,0,1,0,0,0,0,0,0,0,0,0,0,0,0,0,0,0,0,0,0,0,0,0,0,0,0,0,0,0,0,0,0,0,0,0,0,0,0,0,0,0,0,0,0,0,0,0,0,Aday,£1.80m ,32,178,Defender - Left-Back,right,Girona FC,35,0,9,2598,32,2,0,1840,10,0,2,647,33,2,2,2337,2,0,0,135,LaLiga
19-06-17,18.3.4.28,Nacho,67030696,796,18-Jan-90,27,8,0,6,0,6500,7750,7750,158,154,61125395,180,77,D RLC,1,2,2,4,3,3,3,3,3,3,4,7,12,10,10,13,8,14,8,12,14,13,7,16,10,15,15,13,13,17,11,14,14,9,13,12,15,17,16,16,12,14,11,13,15,15,20,15,14,19,8,15,3,20,19,10,20,13,18,16,16,1,20,12,1,1,18,18,20,D RLC,106,1,13,1,1,1,1,20,18,18,1,1,1,1,12,12,0,0,0,0,0,0,0,0,0,0,0,0,0,0,0,0,0,0,0,0,0,0,0,0,0,0,0,0,0,0,0,0,0,0,0,0,0,0,0,0,0,0,0,0,0,0,0,0,0,,,,,,,,,,,,,,,,,,,,,,,,,,,,
19-06-17,18.3.4.28,Luis Hernández,67030712,796,14-Apr-89,28,0,0,0,0,5000,6900,6900,144,138,13719938,183,75,D RC,3,1,2,2,3,2,1,2,2,3,1,11,13,11,6,11,7,13,10,20,14,13,10,16,14,13,15,14,13,11,10,11,12,9,12,10,16,14,13,14,13,10,12,10,14,14,20,16,12,12,8,16,5,14,15,13,11,9,14,12,12,2,20,10,1,1,19,1,20,D RC,103,1,1,1,1,1,1,20,1,19,1,1,1,1,1,10,1.1259E+15,0,0,0,0,0,0,0,0,0,0,0,0,0,0,0,0,0,0,0,0,0,0,0,0,0,0,0,0,0,0,0,0,0,0,0,0,0,0,0,0,0,0,0,0,0,0,0,0,Luis Hernández,£2.25m ,31,182,Defender - Centre-Back,right,Maccabi Tel Aviv,29,1,1,2512,38,0,1,3420,26,1,1,2250,29,0,1,2399,2,0,0,96,LaLiga
19-06-17,18.3.4.28,Víctor Sánchez,67046419,796,08-Aug-87,29,0,0,0,0,4750,7000,7000,148,142,16997670,174,73,D/DM/M RC,3,3,3,2,3,3,2,2,3,1,1,7,11,10,8,13,6,10,8,11,12,14,8,12,13,15,12,15,13,16,13,15,18,8,14,14,16,18,18,14,12,10,8,12,14,12,20,15,11,14,11,10,5,18,14,10,15,10,17,13,12,3,16,15,19,11,16,13,19,D/DM/M RC,333,1,1,1,10,1,11,9,13,16,20,19,1,12,10,15,64,0,0,0,0,0,0,1,0,0,0,0,0,0,0,0,0,0,0,0,0,0,0,0,0,0,0,0,0,0,0,0,0,0,0,0,0,0,0,0,0,0,0,0,0,0,0,0,0,Víctor Sánchez,£3.15m ,33,174,Midfielder - Central Midfield,right,Without Club,27,1,1,2288,33,0,2,2728,28,0,3,1467,34,0,3,2241,nan,nan,nan,nan,LaLiga
19-06-17,18.3.4.28,Martín Montoya,67053464,796,14-Apr-91,26,0,0,22,1,5750,6750,6750,153,137,8464294,175,73,D/WB RL,3,1,1,3,3,3,1,4,3,3,3,8,13,13,9,12,5,11,11,13,12,13,8,14,12,13,12,15,12,12,11,12,12,10,11,14,13,15,15,15,12,13,9,10,14,15,20,16,12,12,10,13,4,10,12,11,12,11,13,13,13,10,20,17,11,1,20,16,1,D/WB RL,115,1,1,1,1,1,1,1,16,20,1,1,1,11,11,17,32,0,0,0,0,0,1,0,0,0,0,0,0,0,0,0,0,0,0,0,0,0,0,0,0,0,0,0,0,0,0,0,0,0,0,0,0,0,0,0,0,0,0,0,0,0,0,0,0,Martín Montoya,£7.20m ,29,175,Defender - Right-Back,right,Real Betis Balompié,31,2,3,2400,31,0,4,2722,29,0,1,2470,27,0,1,1901,2,0,0,96,LaLiga
19-06-17,18.3.4.28,Jonás Ramalho,67054790,796,10-Jun-93,24,0,0,0,0,4000,6200,6200,137,125,4220774,181,70,D RC,1,2,3,4,2,1,2,1,2,2,2,3,8,9,4,10,5,13,7,11,13,11,5,13,11,14,13,13,12,12,10,12,11,10,13,9,15,14,15,12,12,11,11,12,14,14,20,14,14,12,9,13,11,12,11,14,12,13,12,10,13,6,20,13,8,1,18,8,20,D RC,103,1,1,1,1,1,1,20,8,18,13,1,1,8,6,13,0,0,0,0,0,0,0,0,0,0,0,0,0,0,0,0,0,0,0,0,0,0,0,0,0,0,0,0,0,0,0,0,0,0,0,0,0,0,0,0,0,0,0,0,0,0,0,0,0,Jonás Ramalho,£3.60m ,27,185,Defender - Centre-Back,right,Girona FC,32,2,1,2836,28,0,0,2477,27,1,0,2070,23,0,0,1735,5,0,0,358,LaLiga
19-06-17,18.3.4.28,Juanfran,67055268,796,11-Sep-88,28,0,0,0,0,5500,7150,7150,145,143,19815755,179,69,D/WB/M/AM R,3,3,2,2,3,2,4,1,1,2,3,12,16,14,10,13,11,6,13,14,9,13,8,5,14,7,13,14,11,13,13,12,12,14,13,14,12,14,10,15,14,13,12,11,12,16,20,13,9,12,8,11,6,17,12,14,13,10,15,15,8,7,20,18,18,16,20,10,1,D/WB/M/AM R,132,1,1,1,1,10,16,1,1,20,1,1,5,18,1,18,18,0,1,0,0,1,0,0,0,0,0,0,0,0,0,0,0,0,0,0,0,0,0,0,0,0,0,0,0,0,0,0,0,0,0,0,0,0,0,0,0,0,0,0,0,0,0,0,0,Juanfran,£4.50m ,35,181,Defender - Right-Back,right,São Paulo Futebol Clube,36,2,3,3009,30,0,4,2387,47,0,4,3498,18,0,0,1382,nan,nan,nan,nan,LaLiga
19-06-17,18.3.4.28,Sergi Roberto,67063007,796,07-Feb-92,25,1,0,13,1,6900,7900,7900,167,160,88071917,178,68,D/WB/DM/M RC,2,3,1,1,1,2,2,1,2,3,2,10,14,13,10,16,8,10,11,10,12,15,12,12,15,11,13,13,15,16,15,14,12,13,9,16,13,17,17,15,12,12,9,12,14,15,20,17,11,15,9,14,8,19,17,13,18,12,17,16,16,4,18,17,20,12,18,1,20,D/WB/DM/M RC,443,1,1,1,12,1,10,1,1,18,17,20,1,15,1,17,2147483748,0,0,1,0,0,1,1,0,0,0,0,0,0,0,0,0,0,0,0,0,0,0,0,0,0,0,0,0,0,0,0,1,0,0,0,0,0,0,0,0,0,0,0,0,0,0,0,0,Sergi Roberto,£49.50m ,28,178,Defender - Right-Back,right,FC Barcelona,47,1,6,3567,48,1,8,3439,44,1,7,3215,39,1,2,3020,5,1,0,419,LaLiga
19-06-17,18.3.4.28,Aleix Vidal,67064771,796,21-Aug-89,27,1,0,0,0,6500,7400,7400,153,149,27970874,177,70,D/WB/M/AM RL,3,1,3,1,2,1,2,1,3,1,3,11,12,15,11,14,8,7,10,13,11,13,12,13,15,12,12,14,11,13,12,13,15,16,9,15,11,13,16,15,13,12,8,12,15,14,20,13,9,14,10,12,7,16,11,16,8,14,13,11,9,10,18,18,18,20,20,16,1,D/WB/M/AM RL,545,1,1,1,1,16,20,1,1,18,1,1,15,18,1,18,2,0,1,0,0,0,0,0,0,0,0,0,0,0,0,0,0,0,0,0,0,0,0,0,0,0,0,0,0,0,0,0,0,0,0,0,0,0,0,0,0,0,0,0,0,0,0,0,0,Aleix Vidal,£6.75m ,31,177,Defender - Right-Back,right,Sevilla FC,12,2,5,886,25,2,3,1031,21,0,3,1298,29,2,5,2175,0,0,0,0,LaLiga
19-06-17,18.3.4.28,Óscar De Marcos,67065930,796,14-Apr-89,28,0,0,4,0,5750,7250,7250,152,147,40510026,180,76,D/WB/M/AM RC,1,1,2,3,2,3,1,1,2,1,1,10,12,11,11,10,10,11,12,4,11,12,7,12,12,12,12,15,12,13,11,11,13,12,9,15,13,14,16,13,12,11,10,12,14,14,20,18,13,15,5,11,6,20,11,15,12,12,14,11,8,7,20,19,16,20,20,14,20,D/WB/M/AM RC,133,1,1,10,20,12,14,1,12,20,1,16,14,15,13,19,2147483680,0,0,0,0,0,1,0,0,0,0,0,0,0,0,0,0,0,0,0,0,0,0,0,0,0,0,0,0,0,0,0,1,0,0,0,0,0,0,0,0,0,0,0,0,0,0,0,0,Óscar de Marcos,£5.40m ,31,182,Defender - Right-Back,right,Athletic Bilbao,32,1,4,2588,28,2,5,2293,34,1,3,2650,13,0,2,538,1,0,0,90,LaLiga
19-06-17,18.3.4.28,Mario,67066949,796,24-Nov-90,26,2,2,2,0,6000,7350,7350,153,147,33511406,178,71,D/WB R,3,1,2,2,3,3,1,2,2,3,2,8,13,12,9,12,6,7,9,13,15,12,8,16,12,13,15,17,13,16,11,14,15,9,14,15,14,16,17,14,14,13,9,12,13,14,20,15,12,17,10,13,8,7,17,12,17,13,16,11,12,4,20,17,10,1,20,1,1,D/WB R,112,1,1,1,1,1,1,1,1,20,1,1,1,10,1,17,64,0,0,0,0,0,0,1,0,0,0,0,0,0,0,0,0,0,0,0,0,0,0,0,0,0,0,0,0,0,0,0,0,0,0,0,0,0,0,0,0,0,0,0,0,0,0,0,0,Mauro,£900Th. ,29,178,Midfielder - Defensive Midfield,right,Retired,14,0,0,1163,nan,nan,nan,nan,nan,nan,nan,nan,nan,nan,nan,nan,nan,nan,nan,nan,Liga NOS
19-06-17,18.3.4.28,Sergio Postigo,67072387,796,04-Nov-88,28,0,0,0,0,4250,6500,6500,135,130,5043590,185,75,D RC,1,2,3,3,2,3,2,2,1,3,2,5,5,5,5,10,5,14,8,8,15,10,5,14,9,14,14,15,12,15,9,14,15,6,14,7,14,15,15,11,9,11,13,10,14,13,20,14,15,15,13,13,9,10,14,12,12,13,15,14,12,8,20,1,1,1,15,1,20,D RC,103,1,10,1,1,1,1,20,1,15,1,1,1,1,1,1,32768,0,0,0,0,0,0,0,0,0,0,0,0,0,0,0,1,0,0,0,0,0,0,0,0,0,0,0,0,0,0,0,0,0,0,0,0,0,0,0,0,0,0,0,0,0,0,0,0,Sergio Postigo,£1.80m ,31,185,Defender - Centre-Back,right,Levante UD,36,2,1,3169,32,1,0,2603,23,1,1,1611,28,1,1,2375,5,0,0,288,LaLiga
19-06-17,18.3.4.28,Hugo Mallo,67086276,796,22-Jun-91,25,0,0,12,0,5200,7300,7300,157,146,24823866,174,75,D/WB RC,3,1,1,3,2,1,1,2,3,3,1,4,13,11,9,12,7,10,6,14,13,12,9,15,12,16,14,16,14,16,10,13,15,7,12,13,15,15,16,15,13,13,9,12,13,14,20,15,14,15,9,13,7,8,16,13,15,11,11,8,6,3,20,17,8,1,20,9,18,D/WB RC,113,1,1,1,1,1,1,18,9,20,1,1,1,8,6,17,0,0,0,0,0,0,0,0,0,0,0,0,0,0,0,0,0,0,0,0,0,0,0,0,0,0,0,0,0,0,0,0,0,0,0,0,0,0,0,0,0,0,0,0,0,0,0,0,0,Hugo Mallo,£10.80m ,29,174,Defender - Right-Back,right,Celta de Vigo,41,3,4,3638,38,0,7,3364,35,1,4,3094,29,0,1,2117,5,0,0,450,LaLiga
19-06-17,18.3.4.28,Álvaro,67093060,796,08-Jan-90,27,0,0,0,0,4500,7000,7000,145,141,23553068,183,76,D RC,1,4,2,1,3,3,3,1,1,2,3,5,7,10,6,12,6,14,9,13,16,12,8,14,11,14,14,15,14,15,11,14,14,7,14,7,14,12,14,13,11,13,13,12,12,13,20,14,13,13,12,13,6,12,10,16,11,13,13,10,7,9,20,1,1,1,15,1,20,D RC,103,1,1,1,1,1,1,20,1,15,9,1,1,1,1,1,32768,0,0,0,0,0,0,0,0,0,0,0,0,0,0,0,1,0,0,0,0,0,0,0,0,0,0,0,0,0,0,0,0,0,0,0,0,0,0,0,0,0,0,0,0,0,0,0,0,,,,,,,,,,,,,,,,,,,,,,,,,,,,
19-06-17,18.3.4.28,Ximo Navarro,67100203,796,23-Jan-90,27,0,0,0,0,4250,6350,6350,135,127,3961155,178,71,D/WB RC,1,3,3,3,3,2,1,2,3,2,2,9,12,11,9,10,8,12,8,6,13,11,7,14,11,13,12,13,11,13,10,12,11,9,13,12,12,12,13,15,12,13,11,9,13,15,20,13,11,14,11,8,2,14,19,11,14,11,9,13,10,2,20,18,7,1,20,14,19,D/WB RC,113,1,1,1,1,1,1,19,14,20,1,1,1,7,1,18,32,0,0,0,0,0,1,0,0,0,0,0,0,0,0,0,0,0,0,0,0,0,0,0,0,0,0,0,0,0,0,0,0,0,0,0,0,0,0,0,0,0,0,0,0,0,0,0,0,Ximo Navarro,£1.80m ,30,176,Defender - Right-Back,right,Deportivo Alavés,37,2,1,3324,33,0,0,2713,31,2,2,2532,23,0,0,1906,6,0,0,494,LaLiga
19-06-17,18.3.4.28,David Simón,67127964,796,16-Dec-88,28,0,0,0,0,4000,6050,6050,126,120,1666141,179,73,D/WB R,3,3,2,2,1,1,2,2,4,3,2,6,9,10,7,9,6,5,8,13,12,9,10,12,9,14,13,16,12,12,9,12,15,8,13,15,10,16,16,14,13,12,9,8,15,14,20,16,12,14,5,10,6,12,12,13,15,10,16,12,12,6,20,19,12,9,20,1,1,D/WB R,112,1,1,1,1,1,9,1,1,20,1,1,1,12,1,19,32800,0,0,0,0,0,1,0,0,0,0,0,0,0,0,0,1,0,0,0,0,0,0,0,0,0,0,0,0,0,0,0,0,0,0,0,0,0,0,0,0,0,0,0,0,0,0,0,0,David Simón,£720Th. ,31,179,Defender - Right-Back,right,FC Cartagena,19,0,1,1591,15,0,0,1077,30,0,1,2469,10,1,0,696,6,0,0,413,LaLiga
19-06-17,18.3.4.28,Joseba Zaldua,67131394,796,24-Jun-92,24,0,0,0,0,4250,6600,6600,139,132,5082872,176,71,D R,3,3,4,4,1,2,2,2,3,2,3,6,12,12,6,11,10,14,9,13,14,13,3,14,13,13,14,15,14,14,12,13,13,9,11,13,14,13,14,13,13,14,6,10,12,13,20,14,14,13,11,12,12,12,14,12,10,12,14,16,13,13,20,10,1,1,20,1,1,D R,102,1,1,1,1,1,1,1,1,20,1,1,1,1,1,10,0,0,0,0,0,0,0,0,0,0,0,0,0,0,0,0,0,0,0,0,0,0,0,0,0,0,0,0,0,0,0,0,0,0,0,0,0,0,0,0,0,0,0,0,0,0,0,0,0,Joseba Zaldua,£3.60m ,28,176,Defender - Right-Back,right,Real Sociedad,17,0,2,1376,30,1,1,2559,29,1,2,2411,33,0,2,2822,0,0,0,0,LaLiga
19-06-17,18.3.4.28,Unai Bustinza,67132476,796,02-Feb-92,25,0,0,0,0,3250,6200,6200,130,124,950256,175,76,D RC,3,3,1,3,3,3,2,2,1,2,2,9,7,5,3,10,6,13,5,11,15,12,11,14,9,13,15,13,12,11,7,10,12,6,15,9,13,12,15,13,10,12,10,10,16,14,20,16,15,12,13,5,11,14,7,8,9,14,14,15,13,12,20,1,1,1,20,12,17,D RC,103,1,1,1,1,1,1,17,12,20,1,1,1,1,1,1,0,0,0,0,0,0,0,0,0,0,0,0,0,0,0,0,0,0,0,0,0,0,0,0,0,0,0,0,0,0,0,0,0,0,0,0,0,0,0,0,0,0,0,0,0,0,0,0,0,Unai Bustinza,£1.62m ,28,175,Defender - Centre-Back,right,CD Leganés,22,0,1,1790,26,2,1,2176,28,0,1,2278,35,0,2,2870,4,0,0,33,LaLiga
19-06-17,18.3.4.28,Iván,67134757,796,23-Aug-93,23,0,0,0,0,3950,6200,6200,136,124,2653643,178,72,D/WB R,1,2,2,3,2,2,2,2,3,2,3,7,11,11,7,11,7,9,10,14,13,12,8,14,11,11,13,13,13,15,9,13,14,9,12,10,13,14,14,14,12,13,9,8,15,14,20,14,12,14,11,14,11,10,14,12,14,15,14,14,12,8,20,18,10,5,20,5,1,D/WB R,112,1,1,1,1,1,5,1,5,20,1,1,1,10,1,18,288,0,0,0,0,0,1,0,0,1,0,0,0,0,0,0,0,0,0,0,0,0,0,0,0,0,0,0,0,0,0,0,0,0,0,0,0,0,0,0,0,0,0,0,0,0,0,0,0,,,,,,,,,,,,,,,,,,,,,,,,,,,,
19-06-17,18.3.4.28,Dani Carvajal,67139735,796,11-Jan-92,25,12,0,9,1,7450,8050,8050,162,159,93314620,173,74,D/WB RL,2,2,2,3,3,3,2,1,1,2,3,11,14,12,8,13,8,10,9,13,14,13,9,15,12,17,14,18,13,15,12,12,16,12,13,17,12,17,19,16,14,17,8,10,16,14,20,18,12,15,12,11,5,13,15,15,17,14,19,8,9,5,20,18,11,1,20,15,1,D/WB RL,115,1,1,1,1,1,1,1,15,20,1,1,1,11,10,18,1048576,0,0,0,0,0,0,0,0,0,0,0,0,0,0,0,0,0,0,0,0,1,0,0,0,0,0,0,0,0,0,0,0,0,0,0,0,0,0,0,0,0,0,0,0,0,0,0,0,Daniel Carvajal,£54.00m ,28,173,Defender - Right-Back,right,Real Madrid,41,1,12,3549,41,0,7,3473,37,1,6,3140,42,1,8,3752,3,0,1,213,LaLiga
19-06-17,18.3.4.28,Jonny,67144651,796,03-Mar-94,23,0,0,20,0,4750,7250,7250,157,145,23135854,170,70,D/WB RLC,3,3,3,2,2,3,3,2,1,2,1,6,12,13,10,10,7,10,7,13,14,12,8,14,11,14,14,16,13,16,9,13,17,8,12,11,14,15,16,15,14,12,10,8,15,15,20,15,12,17,14,14,6,14,13,19,9,12,10,9,10,6,20,17,1,1,20,19,18,D/WB RLC,116,1,1,1,1,1,1,18,19,20,1,1,1,1,17,17,0,0,0,0,0,0,0,0,0,0,0,0,0,0,0,0,0,0,0,0,0,0,0,0,0,0,0,0,0,0,0,0,0,0,0,0,0,0,0,0,0,0,0,0,0,0,0,0,0,Jony,£1.80m ,29,179,Forward - Left Winger,left,CA Osasuna,26,2,1,1372,30,6,5,2163,37,4,11,2993,32,0,4,1659,4,0,0,187,LaLiga
19-06-17,18.3.4.28,Rubén Peńa,67177699,796,18-Jul-91,25,0,0,0,0,3900,6250,6250,129,126,2768954,170,67,WB/M/AM RL,2,3,1,1,1,2,2,3,1,2,3,8,13,13,9,10,8,8,10,10,9,10,10,10,11,10,10,11,10,10,12,10,9,10,7,13,8,11,11,14,13,13,8,9,11,13,20,12,9,12,10,10,7,14,9,13,12,12,11,9,19,6,15,16,17,20,20,17,14,WB/M/AM RL,535,1,1,15,14,17,20,1,1,15,1,1,14,17,1,16,0,0,0,0,0,0,0,0,0,0,0,0,0,0,0,0,0,0,0,0,0,0,0,0,0,0,0,0,0,0,0,0,0,0,0,0,0,0,0,0,0,0,0,0,0,0,0,0,0,Rubén Pérez,£6.75m ,31,178,Midfielder - Defensive Midfield,right,CD Leganés,32,0,1,2495,36,0,0,2895,32,0,0,2561,28,1,1,2376,8,0,0,720,LaLiga
19-06-17,18.3.4.28,Ińigo Lekue,67184347,796,04-May-93,24,0,0,0,0,4550,6600,6600,152,133,7530484,179,71,D/WB RL,4,1,3,2,1,3,2,1,3,1,1,9,12,13,6,11,5,10,6,8,12,11,3,13,12,10,12,13,10,11,11,11,15,12,8,14,12,13,14,14,12,13,10,10,13,15,20,16,13,14,12,3,11,15,11,14,14,9,14,10,11,7,20,19,15,13,20,16,1,D/WB RL,115,1,1,1,1,1,13,1,16,20,1,1,10,15,15,19,32,0,0,0,0,0,1,0,0,0,0,0,0,0,0,0,0,0,0,0,0,0,0,0,0,0,0,0,0,0,0,0,0,0,0,0,0,0,0,0,0,0,0,0,0,0,0,0,0,Iñigo Lekue,£6.75m ,27,180,Defender - Right-Back,right,Athletic Bilbao,31,3,1,1977,46,0,1,3194,4,0,1,209,18,0,2,935,1,0,0,4,LaLiga
19-06-17,18.3.4.28,Nacho Vidal,67184889,796,24-Jan-95,22,0,0,0,0,1000,5500,5500,142,120,1484265,180,0,D/WB R,3,3,3,1,3,1,4,1,1,2,1,5,8,8,4,13,1,12,11,11,15,10,9,14,12,11,14,13,12,13,10,13,15,7,4,13,12,12,14,14,13,12,11,7,13,14,20,13,10,11,11,8,8,11,13,12,11,11,11,10,18,1,20,18,1,1,20,1,12,D/WB R,112,1,1,1,1,1,1,12,1,20,1,1,1,1,1,18,0,0,0,0,0,0,0,0,0,0,0,0,0,0,0,0,0,0,0,0,0,0,0,0,0,0,0,0,0,0,0,0,0,0,0,0,0,0,0,0,0,0,0,0,0,0,0,0,0,Nacho Vidal,£900Th. ,25,180,Defender - Right-Back,right,CA Osasuna,42,4,2,3770,9,1,0,626,38,0,5,2858,33,1,0,2567,6,0,0,324,LaLiga
19-06-17,18.3.4.28,Carlos Vigaray,67186783,796,07-Sep-94,22,0,0,0,0,3500,6100,6100,134,122,4641526,183,70,D RLC,1,2,3,3,2,2,3,2,1,2,2,8,11,12,7,12,8,11,8,8,13,9,7,13,10,12,13,12,12,13,9,12,11,1,8,13,12,14,14,13,12,10,13,12,9,14,20,14,13,12,4,2,11,14,9,12,10,10,12,10,14,4,20,14,1,1,20,16,18,D RLC,106,1,1,1,1,1,1,18,16,20,1,1,1,1,14,14,0,0,0,0,0,0,0,0,0,0,0,0,0,0,0,0,0,0,0,0,0,0,0,0,0,0,0,0,0,0,0,0,0,0,0,0,0,0,0,0,0,0,0,0,0,0,0,0,0,Carlos Vigaray,£720Th. ,26,182,Defender - Right-Back,right,Real Zaragoza,26,0,3,1408,13,0,0,983,10,0,0,826,26,1,0,2149,2,0,0,143,LaLiga
19-06-17,18.3.4.28,Ander Capa,67187680,796,08-Feb-92,25,0,0,0,0,4250,6750,6750,144,134,9943702,176,68,D/WB/M R,1,3,2,1,1,3,2,2,3,3,4,10,13,13,10,11,8,8,9,11,11,12,11,11,12,11,14,12,13,13,9,13,17,13,11,14,12,15,12,15,13,10,8,10,13,14,20,14,13,13,8,15,7,14,14,12,10,12,12,11,19,3,20,19,16,15,20,12,1,D/WB/M R,122,1,1,1,1,12,15,1,1,20,1,1,10,16,1,19,0,0,0,0,0,0,0,0,0,0,0,0,0,0,0,0,0,0,0,0,0,0,0,0,0,0,0,0,0,0,0,0,0,0,0,0,0,0,0,0,0,0,0,0,0,0,0,0,0,Ander Capa,£2.70m ,28,175,Defender - Right-Back,right,Athletic Bilbao,37,0,3,3013,34,0,1,2321,28,0,0,1796,41,3,5,3339,6,0,1,502,LaLiga
19-06-17,18.3.4.28,Aritz Elustondo,67190072,796,28-Mar-94,23,0,0,0,0,4350,6500,6500,145,134,5609093,182,72,D RC,3,2,2,2,1,2,3,1,3,3,2,4,12,9,5,12,7,15,12,12,14,12,6,14,13,13,12,16,13,14,14,13,12,4,7,9,13,17,14,12,12,12,13,10,8,14,20,13,12,11,11,8,10,12,10,13,10,10,10,13,17,3,20,1,1,1,20,1,17,D RC,103,1,1,1,1,1,1,17,1,20,1,1,1,1,1,1,0,0,0,0,0,0,0,0,0,0,0,0,0,0,0,0,0,0,0,0,0,0,0,0,0,0,0,0,0,0,0,0,0,0,0,0,0,0,0,0,0,0,0,0,0,0,0,0,0,Aritz Elustondo,£4.50m ,26,182,Defender - Centre-Back,right,Real Sociedad,12,0,1,714,24,3,2,1972,29,1,1,2362,26,0,1,1762,8,0,0,720,LaLiga
19-06-17,18.3.4.28,Yeray,67192475,796,24-Jan-95,22,0,0,0,0,4250,6950,6950,147,139,31137695,182,77,D RC,3,3,1,2,2,2,1,1,2,1,1,7,12,9,7,11,8,15,9,6,15,13,8,14,10,13,14,16,15,14,11,13,13,8,13,5,14,15,16,13,12,12,13,9,12,13,20,14,14,13,13,12,8,12,18,12,15,12,15,14,10,7,20,13,1,1,17,1,20,D RC,103,1,1,1,1,1,1,20,1,17,1,1,1,1,1,13,8.79609E+12,0,0,0,0,0,0,0,0,0,0,0,0,0,0,0,0,0,0,0,0,0,0,0,0,0,0,0,0,0,0,0,0,0,0,0,0,0,0,0,0,0,0,0,1,0,0,0,0,,,,,,,,,,,,,,,,,,,,,,,,,,,,
19-06-17,18.3.4.28,Róber,67194879,796,16-Feb-95,22,0,0,0,0,3850,6200,6200,135,125,4734607,182,74,D/DM RC,1,2,3,3,2,2,1,1,3,2,2,6,7,8,7,10,7,13,7,10,14,11,8,13,10,13,12,14,13,14,8,13,12,9,10,8,13,14,14,12,12,11,12,10,13,13,20,14,14,14,11,12,7,12,14,13,14,13,14,14,8,7,20,12,5,1,16,12,20,D/DM RC,113,1,1,1,1,1,1,20,12,16,17,5,1,1,5,12,0,0,0,0,0,0,0,0,0,0,0,0,0,0,0,0,0,0,0,0,0,0,0,0,0,0,0,0,0,0,0,0,0,0,0,0,0,0,0,0,0,0,0,0,0,0,0,0,0,,,,,,,,,,,,,,,,,,,,,,,,,,,,
19-06-17,18.3.4.28,Álvaro Odriozola,67199408,796,14-Dec-95,21,0,0,0,0,4700,7200,7200,163,144,37360032,175,66,D R,3,2,2,3,1,1,2,3,4,3,1,12,15,15,8,13,10,9,11,10,13,14,7,13,16,11,12,14,12,14,13,13,13,11,10,11,12,13,12,16,13,14,10,8,14,17,20,15,12,14,12,12,12,12,19,11,11,10,11,10,17,3,20,14,1,1,20,1,1,D R,102,1,1,1,1,1,1,1,1,20,1,1,1,1,1,14,1.09951E+12,0,0,0,0,0,1,0,0,0,0,0,0,0,0,0,0,0,0,0,0,0,0,0,0,0,0,0,0,0,0,0,0,0,0,0,0,0,0,0,0,1,0,0,0,0,0,0,0,Álvaro Odriozola,£22.50m ,24,176,Defender - Right-Back,right,Real Madrid,34,0,8,2852,41,1,4,3435,22,1,9,1856,10,0,2,613,1,0,0,57,LaLiga
19-06-17,18.3.4.28,Rafa Navarro,67208294,796,24-Feb-94,23,0,0,0,0,3250,5850,5850,130,117,1527332,173,61,D R,3,1,2,3,2,2,3,1,1,3,3,10,12,12,7,11,9,10,12,12,12,11,10,12,12,11,13,12,10,10,12,11,8,10,10,12,12,12,13,14,13,13,10,10,12,13,20,14,11,13,8,10,7,12,15,10,14,13,11,12,18,2,20,12,10,1,20,1,1,D R,102,1,1,1,1,1,1,1,1,20,1,1,1,10,1,12,0,0,0,0,0,0,0,0,0,0,0,0,0,0,0,0,0,0,0,0,0,0,0,0,0,0,0,0,0,0,0,0,0,0,0,0,0,0,0,0,0,0,0,0,0,0,0,0,0,Rafa Navarro,£450Th. ,26,173,Defender - Right-Back,right,NK Istra 1961,18,2,2,1288,5,0,0,263,26,1,1,2321,0,0,0,0,nan,nan,nan,nan,LaLiga
19-06-17,18.3.4.28,Unai Núńez,67214595,796,30-Jan-97,20,0,0,0,0,4250,6850,6850,155,137,32027508,186,80,D RC,1,4,2,3,3,1,4,2,3,2,2,6,6,7,8,11,8,14,9,10,15,11,10,15,11,13,15,15,13,14,10,14,17,7,10,8,14,14,15,12,13,11,13,8,14,13,20,13,14,14,8,11,8,11,13,10,13,12,10,11,20,1,20,14,1,1,16,1,20,D RC,103,1,1,1,1,1,1,20,1,16,1,1,1,1,1,14,0,0,0,0,0,0,0,0,0,0,0,0,0,0,0,0,0,0,0,0,0,0,0,0,0,0,0,0,0,0,0,0,0,0,0,0,0,0,0,0,0,0,0,0,0,0,0,0,0,Unai Núñez,£13.50m ,23,186,Defender - Centre-Back,right,Athletic Bilbao,33,3,0,2806,36,1,0,3167,15,0,0,1276,26,0,0,2053,3,0,0,270,LaLiga
19-06-17,18.3.4.28,Marc Navarro,67222733,796,02-Jul-95,21,0,0,0,0,2500,5750,5750,133,115,2350403,183,0,D/WB/AM R,3,4,3,1,2,2,3,1,1,2,1,11,13,12,9,11,8,9,9,12,12,10,6,13,13,9,9,11,10,12,11,9,20,9,8,13,12,13,11,14,13,11,10,8,13,12,20,13,10,12,9,3,7,14,12,11,11,11,10,11,19,2,19,20,15,18,20,1,1,D/WB/AM R,232,1,1,1,1,1,18,1,1,19,1,1,1,15,1,20,0,0,0,0,0,0,0,0,0,0,0,0,0,0,0,0,0,0,0,0,0,0,0,0,0,0,0,0,0,0,0,0,0,0,0,0,0,0,0,0,0,0,0,0,0,0,0,0,0,Marc Navarro,£1.80m ,25,188,Defender - Right-Back,right,Watford FC,26,5,2,1678,24,1,2,1469,5,0,0,261,6,0,0,243,2,0,0,90,LaLiga
19-06-17,18.3.4.28,Tito,7451317,796,11-Jul-85,31,0,0,0,0,4350,6350,6350,138,127,232186002,174,62,D/WB R,2,1,3,3,3,3,2,2,3,3,1,8,11,9,6,12,11,9,8,14,13,12,7,14,12,15,14,17,14,15,10,15,15,9,13,13,15,17,17,13,11,11,7,9,14,12,20,14,8,17,6,14,10,12,15,10,15,12,19,14,12,4,20,18,10,1,20,13,1,D/WB R,112,1,1,1,1,1,1,1,13,20,1,1,1,10,11,18,1.11669E+12,0,0,0,0,0,0,0,0,0,0,0,0,0,0,0,0,0,0,0,0,0,0,0,0,0,0,0,0,0,0,0,0,0,0,1,0,0,0,0,0,1,0,0,0,0,0,0,0,Tito,£720Th. ,35,174,Defender - Right-Back,right,Without Club,23,0,3,1876,17,1,0,1322,16,0,0,1182,28,0,0,2177,nan,nan,nan,nan,LaLiga
19-06-17,18.3.4.28,Francisco Molinero,7451371,796,26-Jul-85,31,0,0,2,0,4500,6100,6100,133,122,1435626,175,72,D/WB R,2,2,3,1,3,1,3,3,3,1,3,9,14,11,7,11,6,7,8,15,14,11,5,14,14,14,12,16,10,13,7,9,13,10,11,12,12,13,15,16,12,12,8,9,14,14,20,14,12,15,13,13,7,14,11,10,12,10,10,11,20,7,20,16,8,1,20,13,1,D/WB R,112,1,1,1,1,1,1,1,13,20,1,1,1,8,9,16,0,0,0,0,0,0,0,0,0,0,0,0,0,0,0,0,0,0,0,0,0,0,0,0,0,0,0,0,0,0,0,0,0,0,0,0,0,0,0,0,0,0,0,0,0,0,0,0,0,Francisco Molinero,£540Th. ,35,177,Defender - Right-Back,right,Without Club,38,0,2,3280,12,0,0,754,31,0,0,2711,32,0,1,2645,nan,nan,nan,nan,LaLiga
19-06-17,18.3.4.28,Juanfran,7451701,796,09-Jan-85,32,13,1,9,0,6500,7500,7500,153,149,232186002,180,71,D/WB R,3,3,1,3,1,3,1,1,4,3,3,15,15,14,11,14,8,7,12,11,13,13,12,13,14,13,13,14,14,14,13,13,16,11,12,15,15,15,16,14,14,13,11,12,12,15,20,14,11,15,10,13,9,14,15,17,15,14,15,14,10,8,20,18,13,1,20,1,1,D/WB R,112,1,1,1,1,1,1,1,1,20,1,1,1,13,1,18,7.09185E+13,0,0,0,0,0,1,0,0,0,0,0,0,0,0,0,0,0,0,0,0,0,0,0,0,0,0,0,0,0,0,0,0,0,0,0,0,0,0,0,1,0,0,0,0,0,0,1,0,Juanfran,£4.50m ,35,181,Defender - Right-Back,right,São Paulo Futebol Clube,36,2,3,3009,30,0,4,2387,47,0,4,3498,18,0,0,1382,nan,nan,nan,nan,LaLiga
19-06-17,18.3.4.28,Pedro López,7452446,796,01-Nov-83,33,0,0,0,0,4400,6350,6350,135,127,946684,174,75,D/WB R,2,3,3,3,1,2,4,3,3,3,1,11,13,11,9,14,9,10,12,15,12,12,12,13,14,13,13,15,14,15,10,14,17,14,15,13,14,14,14,13,12,12,9,7,14,13,20,13,9,15,9,12,9,12,10,14,15,14,18,16,15,6,20,19,13,1,20,5,5,D/WB R,112,1,1,1,1,1,1,1,5,20,10,5,1,13,1,19,802,0,1,0,0,0,1,0,0,1,1,0,0,0,0,0,0,0,0,0,0,0,0,0,0,0,0,0,0,0,0,0,0,0,0,0,0,0,0,0,0,0,0,0,0,0,0,0,0,Pedro López,£225Th. ,25,189,Goalkeeper,right,CF Villanovense,10,15,3,900,34,48,11,3021,13,19,3,1170,11,12,6,990,2,0,2,180,LaLiga
19-06-17,18.3.4.28,Damián Suárez,78001192,1657,27-Apr-88,29,0,0,26,0,4250,6400,6400,134,129,3545580,173,74,D/WB R,4,2,1,2,1,2,1,3,1,1,2,15,13,12,7,12,12,7,12,14,12,12,7,13,12,17,12,18,10,13,9,11,12,9,12,14,12,16,17,14,14,15,9,8,15,11,20,16,10,13,16,13,4,15,14,12,7,8,12,7,9,5,20,18,10,1,20,14,1,D/WB R,112,1,1,1,1,1,1,1,14,20,8,1,1,10,12,18,196896,0,0,0,0,0,1,0,0,1,0,0,0,0,0,0,0,1,1,0,0,0,0,0,0,0,0,0,0,0,0,0,0,0,0,0,0,0,0,0,0,0,0,0,0,0,0,0,0,Damián Suárez,£2.25m ,32,173,Defender - Right-Back,right,Getafe CF,42,0,6,3780,33,1,4,2878,42,0,3,3709,34,1,4,2958,6,0,0,523,LaLiga
19-06-17,18.3.4.28,Matías Aguirregaray,78020879,1657,01-Apr-89,28,6,0,20,2,2750,6000,6050,135,122,2242105,183,78,D/WB/M R,2,3,1,1,3,2,1,3,2,2,2,11,11,13,9,11,8,11,9,14,13,11,10,14,12,14,12,18,8,9,9,9,16,12,11,15,8,12,15,12,13,13,10,10,14,14,20,15,14,10,14,14,5,18,15,12,10,9,10,9,12,5,18,20,19,10,20,13,1,D/WB/M R,232,1,1,1,1,1,10,1,10,18,1,1,13,19,12,20,2.3222E+15,0,0,0,1,0,1,0,0,0,0,0,0,0,0,0,0,0,0,0,0,0,0,0,0,0,0,0,0,0,0,0,0,0,0,0,1,0,0,0,0,0,0,0,0,0,0,1,0,MatÃ­as Aguirregaray,£1.80m ,31,174,Defender - Right-Back,right,Without Club,28,6,0,2124,30,0,0,2373,26,1,3,2300,25,2,0,1893,nan,nan,nan,nan,LaLiga
19-06-17,18.3.4.28,David García,824480,796,25-Feb-82,35,0,0,0,0,3850,6200,6200,132,124,283554,182,79,D RC,2,1,2,1,2,2,2,2,1,3,2,5,7,9,6,9,5,14,11,12,14,10,7,15,9,15,12,18,13,15,8,14,15,7,18,7,14,18,18,10,10,12,11,8,15,10,20,13,13,15,11,13,14,15,12,12,20,14,19,12,12,5,20,8,1,1,17,1,20,D RC,103,1,5,1,1,1,1,20,1,17,1,1,1,1,1,8,8.80039E+12,0,0,0,0,0,0,0,0,0,0,0,0,0,0,0,1,0,0,0,0,0,0,0,0,0,0,0,0,0,0,0,0,1,0,0,0,0,0,0,0,0,0,0,1,0,0,0,0,David García,£90Th. ,38,183,Defender - Centre-Back,right,UD Tamaraceite,25,1,1,1915,12,1,0,948,22,1,0,1851,4,1,0,390,2,0,0,180,LaLiga
19-06-17,18.3.4.28,Aďssa Mandi,85079680,5,22-Oct-91,25,24,1,0,0,6000,6500,6500,142,132,5102436,184,78,D RLC,3,3,3,2,1,1,4,3,1,3,2,6,13,9,5,10,6,14,5,12,13,12,6,15,12,14,15,16,12,12,11,13,16,7,12,12,12,14,14,14,13,14,13,9,15,14,20,13,14,13,13,14,8,15,8,13,16,13,15,14,14,7,20,10,1,1,19,15,20,D RLC,106,1,1,1,1,1,1,20,15,19,1,1,1,1,10,10,1.37439E+11,0,0,0,1,0,0,0,0,0,0,0,0,0,0,0,0,0,0,0,0,0,0,0,0,0,0,0,0,0,0,0,0,0,0,0,0,0,1,0,0,0,0,0,0,0,0,0,0,Aïssa Mandi,£8.10m ,29,184,Defender - Centre-Back,right,Real Betis Balompié,28,2,1,2373,35,1,0,3115,48,2,1,4260,30,0,0,2698,5,1,0,442,LaLiga
19-06-17,18.3.4.28,Daniel Wass,936891,764,31-May-89,28,16,0,14,0,6250,7500,7500,160,150,25873652,178,70,D/WB/DM/M/AM RC,3,1,1,2,2,2,2,2,2,1,2,13,13,13,11,15,16,11,11,14,11,15,9,13,14,12,14,12,11,14,13,14,13,11,8,11,10,12,13,14,13,12,13,9,13,13,20,13,11,15,10,14,7,19,17,16,13,17,15,13,10,7,19,19,20,19,19,14,20,D/WB/DM/M/AM RC,453,1,1,8,15,12,19,10,14,19,17,20,12,18,14,19,1.37439E+11,0,0,0,1,0,0,0,0,0,0,0,0,0,0,0,0,0,0,0,0,0,0,0,0,0,0,0,0,0,0,0,0,0,0,0,0,0,1,0,0,0,0,0,0,0,0,0,0,Daniel Wass,£13.50m ,31,178,Defender - Right-Back,right,Valencia CF,54,7,5,3722,39,4,9,3081,50,2,7,3742,45,2,6,3632,7,1,1,619,LaLiga
