GameDate,Name,UID,NationID,Born,Age,IntCaps,IntGoals,U21Caps,U21Goals,WorldReputation,HomeReputation,CurrentReputation,PA,CA,Price,Height,Weight,PositionsString,GK.AerialAbility,GK.CommandOfArea,GK.Communication,GK.Eccentricity,GK.Handling,GK.Kicking,GK.OneOnOnes,GK.Reflexes,GK.RushingOut,GK.TendencyToPunch,GK.Throwing,Tech.Corners,Tech.Crossing,Tech.Dribbling,Tech.Finishing,Tech.FirstTouch, Tech.Freekicks,Tech.Heading,Tech.LongShots,Tech.Longthrows,Tech.Marking,Tech.Passing,Tech.PenaltyTaking, Tech.Tackling,Tech.Technique,Mental.Aggression,Mental.Anticipation,Mental.Bravery,Mental.Composure,Mental.Concentration,Mental.Vision,Mental.Decisions,Mental.Determination,Mental.Flair,Mental.Leadership, Mental.OffTheBall,Mental.Positioning,Mental.Teamwork,Mental.Workrate,Phy.Acceleration,Phy.Agility,Phy.Balance,Phy.Jumping,Phy.LeftFoot,Phy.NaturalFitness,Phy.Pace,Phy.RightFoot,Phy.Stamina,Phy.Strength, Hidden.Consistency,Hidden.Dirtiness,Hidden.ImportantMatches,Hidden.InjuryProness,Hidden.Versatility,Personality.Adaptability,Personality.Ambition,Personality.Loyalty,Personality.Pressure,Personality.Professional,Personality.Sportsmanship,Personality.Temperament,Personality.Controversy,Positions.Defender,Positions.WingBack,Positions.Midfielder,Positions.AttackingMidfielder,Positions.Right,Positions.Left,Positions.Centre,Positions.PositionsDesc,Positions.PositionsDescVal,Positions.Goalkeeper,Positions.Sweeper,Positions.Striker,Positions.AttackingMidCentral,Positions.AttackingMidLeft,Positions.AttackingMidRight,Positions.DefenderCentral,Positions.DefenderLeft, Positions.DefenderRight,Positions.DefensiveMidfielder,Positions.MidfielderCentral,Positions.MidfielderLeft,Positions.MidfielderRight,Positions.WingBackLeft,Positions.WingBackRight,PPMVal,PPM0,PPM1,PPM2,PPM3,PPM4,PPM5,PPM6,PPM7,PPM8,PPM9,PPM10,PPM11,PPM12,PPM13,PPM14,PPM15,PPM16,PPM17,PPM18,PPM19,PPM20,PPM21,PPM22,PPM23,PPM24,PPM25,PPM26,PPM27,PPM28,PPM29,PPM30,PPM31,PPM32,PPM33,PPM34,PPM35,PPM36,PPM37,PPM38,PPM39,PPM40,PPM41,PPM42,PPM43,PPM44,PPM45,PPM46,PPM47,name,Market Value,age,height,position,foot,current club,10/11 games,10/11 goals/conceded,10/11 assists/clean,10/11 minutes,11/12 games,11/12 goals/conceded,11/12 assists/clean,11/12 minutes,12/13 games,12/13 goals/conceded,12/13 assists/clean,12/13 minutes,13/14 games,13/14 goals/conceded,13/14 assists/clean,13/14 minutes,14/15 games,14/15 goals/conceded,14/15 assists/clean,14/15 minutes,15/16 games,15/16 goals/conceded,15/16 assists/clean,15/16 minutes,16/17 games,16/17 goals/conceded,16/17 assists/clean,16/17 minutes,17/18 games,17/18 goals/conceded,17/18 assists/clean,17/18 minutes,18/19 games,18/19 goals/conceded,18/19 assists/clean,18/19 minutes,current league,19/20 games,19/20 goals/conceded,19/20 assists/clean,19/20 minutes,20/21 games,20/21 goals/conceded,20/21 assists/clean,20/21 minutes
13/6/2011,Mbaye Niang,85051236,769,12/19/1994,16,0,0,0,0,3950,4950,4950,166,110,14319902,184,74,S ,1,3,3,1,2,2,1,8,2,2,2,7,7,13,12,13,11,8,10,5,3,9,15,2,14,8,8,11,14,9,7,9,16,12,5,11,5,8,9,15,12,13,11,10,15,14,20,11,13,13,8,15,7,7,10,16,14,13,14,14,14,7,1,1,1,13,10,13,12,S ,600,1,1,20,12,13,10,1,1,1,1,1,1,1,1,1,512,0,0,0,0,0,0,0,0,0,1,0,0,0,0,0,0,0,0,0,0,0,0,0,0,0,0,0,0,0,0,0,0,0,0,0,0,0,0,0,0,0,0,0,0,0,0,0,0,M'Baye Niang,£1.58m ,25,188,Forward - Centre-Forward,right,Stade Rennais FC,7,3,0,339,23,2,3,1043,25,1,1,1092,31,5,3,1780,19,5,3,1051,21,8,4,1411,34,5,5,2377,31,4,3,1925,44,14,7,2802,Ligue 1,36,15,2,2882,1,0,0,64
13/6/2011,Roberto Esposito,43093045,776,3/27/1994,17,0,0,0,0,550,2750,2350,78,47,11272,178,74,S ,1,1,2,2,1,3,3,1,2,1,2,7,5,11,12,9,4,11,4,3,1,8,8,7,9,12,4,9,10,2,3,4,10,9,1,12,2,6,11,11,8,4,5,7,12,11,20,6,6,7,8,10,6,6,14,3,13,8,11,10,12,6,1,1,1,1,1,1,1,S ,600,1,1,20,1,1,1,1,1,1,1,1,1,1,1,1,0,0,0,0,0,0,0,0,0,0,0,0,0,0,0,0,0,0,0,0,0,0,0,0,0,0,0,0,0,0,0,0,0,0,0,0,0,0,0,0,0,0,0,0,0,0,0,0,0,,,,,,,,,,,,,,,,,,,,,,,,,,,,,,,,,,,,,,,,,,,,,,,,,,,,
13/6/2011,Reuben Noble-Lazarus,28036609,765,8/16/1993,17,0,0,0,0,2000,4000,4000,154,80,5805354,181,86,AM/S RL,1,3,3,3,2,3,2,1,2,2,3,8,13,7,10,12,9,4,8,3,2,8,9,8,7,4,12,8,8,3,13,4,10,8,5,10,2,9,9,12,12,13,8,14,9,11,20,9,4,7,14,6,10,9,3,10,17,8,12,12,12,19,1,1,9,20,20,18,1,AM/S RL,515,1,1,17,1,18,20,1,1,1,1,1,1,9,1,1,0,0,0,0,0,0,0,0,0,0,0,0,0,0,0,0,0,0,0,0,0,0,0,0,0,0,0,0,0,0,0,0,0,0,0,0,0,0,0,0,0,0,0,0,0,0,0,0,0,,,,,,,,,,,,,,,,,,,,,,,,,,,,,,,,,,,,,,,,,,,,,,,,,,,,
13/6/2011,Lenny Nangis,85043913,769,3/24/1994,17,0,0,0,0,1100,2250,2250,160,91,9083026,174,71,S R,3,1,2,1,1,3,2,1,1,2,3,6,10,12,10,10,7,5,9,5,1,8,10,2,12,8,8,9,11,8,8,7,14,13,5,13,4,7,11,16,14,11,7,5,15,14,20,11,9,13,8,14,5,7,5,14,13,14,14,15,15,5,1,1,15,15,15,10,1,S R,602,1,1,20,1,10,15,1,1,1,1,1,10,15,1,1,18,0,1,0,0,1,0,0,0,0,0,0,0,0,0,0,0,0,0,0,0,0,0,0,0,0,0,0,0,0,0,0,0,0,0,0,0,0,0,0,0,0,0,0,0,0,0,0,0,Lenny Nangis,£720Th. ,26,172,Forward - Left Winger,right,RWD Molenbeek,nan,nan,nan,nan,14,1,0,766,8,1,0,386,24,2,1,1242,37,4,4,2414,17,0,3,736,32,0,2,1525,22,0,4,1099,29,1,3,1790,Ligue 1,nan,nan,nan,nan,5,0,0,431
13/6/2011,Jordan Obita,28052366,765,12/8/1993,17,0,0,0,0,1650,4650,4650,151,85,6898207,181,63,AM LC,2,1,3,2,3,1,3,1,2,1,3,5,9,12,7,10,9,8,5,3,4,13,9,4,8,12,12,3,11,6,8,11,8,13,10,7,6,16,14,14,11,13,6,20,15,13,8,9,5,10,6,10,3,10,11,11,10,6,15,9,5,5,1,1,9,20,10,20,15,AM LC,504,1,1,15,15,20,10,1,1,1,1,1,9,1,1,1,0,0,0,0,0,0,0,0,0,0,0,0,0,0,0,0,0,0,0,0,0,0,0,0,0,0,0,0,0,0,0,0,0,0,0,0,0,0,0,0,0,0,0,0,0,0,0,0,0,,,,,,,,,,,,,,,,,,,,,,,,,,,,,,,,,,,,,,,,,,,,,,,,,,,,
13/6/2011,Giorgio Verga,43092915,776,2/8/1994,17,0,0,0,0,500,2700,2300,69,46,61427,183,77,S ,3,1,1,1,2,1,3,1,1,3,2,6,4,7,8,9,3,10,5,2,1,3,8,1,5,7,3,3,10,4,7,2,8,4,4,10,3,10,10,10,10,11,8,8,16,12,20,6,3,7,12,10,10,5,14,14,5,6,10,7,8,9,1,1,1,1,1,1,1,S ,600,1,1,20,1,1,1,1,1,1,1,1,1,1,1,1,0,0,0,0,0,0,0,0,0,0,0,0,0,0,0,0,0,0,0,0,0,0,0,0,0,0,0,0,0,0,0,0,0,0,0,0,0,0,0,0,0,0,0,0,0,0,0,0,0,,,,,,,,,,,,,,,,,,,,,,,,,,,,,,,,,,,,,,,,,,,,,,,,,,,,
13/6/2011,Wilfried Zaha,28051378,765,11/10/1992,18,0,0,0,0,3000,5350,5350,147,107,6840482,181,67,AM/S R,1,1,2,2,2,3,3,4,3,3,3,1,8,14,10,13,1,7,6,2,5,9,9,10,13,8,9,10,9,8,13,7,12,15,1,11,8,11,11,15,12,11,10,11,10,14,20,11,11,14,9,9,3,10,15,13,10,13,10,11,12,4,1,1,1,18,18,10,1,AM/S R,622,1,1,20,1,10,18,1,1,1,1,1,1,1,1,1,8.8545E+13,0,0,0,0,0,0,0,0,0,0,0,0,0,0,0,0,0,0,0,0,0,0,0,0,0,0,0,0,0,0,0,0,0,0,0,1,0,0,0,1,0,0,0,0,1,0,1,0,Wilfried Zahibo, ,27,191,Midfielder - Central Midfield,right,Houston Dynamo,nan,nan,nan,nan,0,0,0,0,1,1,0,120,30,0,1,2198,33,2,0,2794,31,2,0,2128,17,0,0,1070,39,4,2,2482,27,1,3,1747,Ligue 1,7,0,0,314,nan,nan,nan,nan
13/6/2011,Wellington Silva,19086339,1651,1/6/1993,18,0,0,0,0,2750,5600,5600,154,108,9989488,171,68,AM/S LC,1,3,2,3,1,3,2,3,1,3,2,8,11,15,11,14,9,7,9,2,4,11,9,4,15,11,9,9,10,11,12,10,12,16,4,12,5,9,14,14,16,5,5,10,13,13,20,10,5,10,6,9,10,13,8,18,6,12,5,7,8,13,1,1,1,18,13,18,15,AM/S LC,624,1,1,20,15,18,13,1,1,1,1,1,1,1,1,1,34360262672,0,0,0,0,1,0,0,0,0,0,0,0,0,0,0,0,0,0,0,1,0,0,0,0,0,0,0,0,0,0,0,0,0,0,0,1,0,0,0,0,0,0,0,0,0,0,0,0,Wellington Silva,£450Th. ,27,170,Forward - Right Winger,right,Fluminense Football Club,2,0,0,37,16,3,0,858,23,4,0,624,39,3,5,1808,35,0,7,2235,45,4,5,3002,23,2,2,1322,10,1,2,262,25,1,1,989,LaLiga,16,2,1,792,nan,nan,nan,nan
13/6/2011,Villyan Bijev,28067659,390,4/15/1993,18,0,0,0,0,1500,3500,2600,126,73,1261639,184,75,S ,2,3,3,1,1,1,1,6,1,1,1,9,7,8,13,12,10,8,8,6,4,9,10,6,12,8,10,10,14,12,6,9,10,14,1,13,5,5,8,7,8,9,10,6,11,12,20,10,8,10,10,10,6,10,13,15,14,11,13,15,15,10,1,1,1,1,1,1,1,S ,600,1,1,20,1,1,1,1,1,1,1,1,1,1,1,1,0,0,0,0,0,0,0,0,0,0,0,0,0,0,0,0,0,0,0,0,0,0,0,0,0,0,0,0,0,0,0,0,0,0,0,0,0,0,0,0,0,0,0,0,0,0,0,0,0,,,,,,,,,,,,,,,,,,,,,,,,,,,,,,,,,,,,,,,,,,,,,,,,,,,,
13/6/2011,Terence Makengo,85028834,769,6/22/1992,18,0,0,0,0,1250,2500,2500,134,100,3722136,180,70,S ,1,1,1,1,1,2,3,1,1,1,1,5,7,11,11,11,7,11,10,5,2,8,10,2,13,6,10,7,12,9,6,9,14,13,5,12,4,6,7,16,14,13,10,8,12,14,20,10,8,12,6,14,13,6,9,14,14,9,14,14,14,7,1,1,1,10,10,10,1,S ,600,1,1,20,1,10,10,1,1,1,1,1,1,1,1,1,4.39805E+12,0,0,0,0,1,0,0,0,0,1,0,0,0,0,0,0,0,0,0,0,0,0,0,0,0,0,0,0,0,0,0,0,0,0,0,0,0,0,0,0,0,0,1,0,0,0,0,0,,,,,,,,,,,,,,,,,,,,,,,,,,,,,,,,,,,,,,,,,,,,,,,,,,,,
13/6/2011,Steven Skrzybski,92037586,771,11/18/1992,18,0,0,0,0,2500,4200,4200,95,84,892390,173,64,S RLC,2,3,2,3,3,2,3,6,3,1,1,8,11,9,10,10,8,10,8,3,4,9,8,5,11,13,8,4,8,5,5,6,10,10,9,10,3,15,12,12,12,9,4,16,12,11,20,8,4,10,12,10,5,10,3,10,11,12,13,8,13,12,1,1,1,15,15,15,15,S RLC,606,1,1,20,15,15,15,1,1,1,1,1,1,1,1,1,0,0,0,0,0,0,0,0,0,0,0,0,0,0,0,0,0,0,0,0,0,0,0,0,0,0,0,0,0,0,0,0,0,0,0,0,0,0,0,0,0,0,0,0,0,0,0,0,0,,,,,,,,,,,,,,,,,,,,,,,,,,,,,,,,,,,,,,,,,,,,,,,,,,,,
13/6/2011,Rok Baskera,62078827,795,5/26/1993,18,0,0,0,0,1000,4250,3500,124,80,8884,185,87,S ,3,2,3,1,3,1,1,2,1,3,1,5,5,10,14,14,8,14,9,8,3,10,8,6,11,8,7,9,9,9,9,8,9,11,10,12,7,8,8,8,8,8,16,10,9,8,20,8,8,8,7,10,7,9,8,8,11,9,11,10,10,9,1,1,1,1,1,1,1,S ,600,1,1,20,1,1,1,1,1,1,1,1,1,1,1,1,0,0,0,0,0,0,0,0,0,0,0,0,0,0,0,0,0,0,0,0,0,0,0,0,0,0,0,0,0,0,0,0,0,0,0,0,0,0,0,0,0,0,0,0,0,0,0,0,0,,,,,,,,,,,,,,,,,,,,,,,,,,,,,,,,,,,,,,,,,,,,,,,,,,,,
13/6/2011,Richard van den Bosch,92022263,771,7/25/1992,18,0,0,0,0,250,3250,3250,110,72,51649,169,64,AM/S RL,1,3,1,1,3,1,2,1,1,3,1,8,10,12,9,9,3,12,7,2,2,12,5,5,8,15,8,1,8,5,9,9,6,7,6,9,4,9,10,12,9,8,3,20,15,10,16,6,5,10,10,10,5,7,7,2,16,14,15,11,11,13,1,1,14,20,19,20,12,AM/S RL,515,1,1,17,12,20,19,1,1,1,1,1,14,13,1,1,0,0,0,0,0,0,0,0,0,0,0,0,0,0,0,0,0,0,0,0,0,0,0,0,0,0,0,0,0,0,0,0,0,0,0,0,0,0,0,0,0,0,0,0,0,0,0,0,0,,,,,,,,,,,,,,,,,,,,,,,,,,,,,,,,,,,,,,,,,,,,,,,,,,,,
13/6/2011,Miguel Medina,79011885,1655,6/1/1993,18,0,0,0,0,1200,4814,3700,170,107,26602253,184,74,S ,3,3,3,1,3,2,2,6,3,3,1,9,12,14,14,10,10,11,13,9,7,8,10,9,12,12,7,12,9,8,7,9,8,12,6,12,7,8,12,14,13,13,10,9,12,14,20,7,10,8,10,8,8,10,10,15,10,10,7,8,10,8,1,1,1,10,10,8,7,S ,600,1,1,20,7,8,10,1,1,1,1,1,1,1,1,1,0,0,0,0,0,0,0,0,0,0,0,0,0,0,0,0,0,0,0,0,0,0,0,0,0,0,0,0,0,0,0,0,0,0,0,0,0,0,0,0,0,0,0,0,0,0,0,0,0,,,,,,,,,,,,,,,,,,,,,,,,,,,,,,,,,,,,,,,,,,,,,,,,,,,,
13/6/2011,Luke Williams,28048007,765,6/11/1993,18,0,0,0,0,2200,4500,4750,134,90,2873850,174,70,AM/S RLC,1,1,3,2,3,3,1,6,3,1,3,9,8,13,8,7,6,6,10,5,4,11,8,6,10,11,9,14,11,7,11,8,15,12,6,10,8,14,15,14,18,5,5,12,12,10,20,7,5,8,6,10,5,10,6,12,18,12,15,16,12,3,1,1,12,16,16,15,15,AM/S RLC,626,1,1,20,15,15,16,1,1,1,1,1,1,12,1,1,0,0,0,0,0,0,0,0,0,0,0,0,0,0,0,0,0,0,0,0,0,0,0,0,0,0,0,0,0,0,0,0,0,0,0,0,0,0,0,0,0,0,0,0,0,0,0,0,0,Mike Williamson,£3.15m ,36,194,Defender - Centre-Back,right,Gateshead FC,32,0,3,2771,26,0,1,2165,28,0,0,2472,35,0,0,3121,33,1,1,2596,7,1,1,630,9,0,0,715,17,0,0,1449,32,0,0,2830,Premier League,nan,nan,nan,nan,nan,nan,nan,nan
13/6/2011,Luca Munarini,43082009,776,3/9/1993,18,0,0,0,0,50,1350,1350,87,40,1303,180,78,S ,2,3,1,1,3,1,2,3,1,2,2,6,3,10,10,9,8,7,7,1,6,8,8,3,5,10,4,1,11,8,5,3,7,12,11,7,5,6,9,11,8,6,9,1,12,12,20,4,4,9,8,10,6,7,12,17,8,5,14,15,5,8,1,1,1,1,1,1,1,S ,600,1,1,20,1,1,1,1,1,1,1,1,1,1,1,1,0,0,0,0,0,0,0,0,0,0,0,0,0,0,0,0,0,0,0,0,0,0,0,0,0,0,0,0,0,0,0,0,0,0,0,0,0,0,0,0,0,0,0,0,0,0,0,0,0,Luca Cigarini,£4.95m ,34,175,Midfielder - Defensive Midfield,right,FC Crotone,18,3,2,893,32,1,2,2547,30,2,5,2491,36,2,8,2618,34,1,3,2774,26,2,2,1902,7,0,0,471,27,2,3,2153,28,0,1,1933,Serie A,22,0,4,1604,5,0,1,391
13/6/2011,Luc Castaignos,37005404,784,9/27/1992,18,0,0,0,0,5000,6100,5750,165,115,18274490,188,78,AM/S R,1,3,1,3,1,1,3,1,1,1,1,10,7,9,13,13,11,12,11,6,4,9,10,3,14,3,13,16,12,13,11,9,11,14,4,16,4,11,13,12,13,14,12,12,13,12,20,12,13,10,8,12,14,10,13,11,10,10,12,13,6,5,1,1,1,16,16,13,13,AM/S R,622,1,1,20,13,13,16,1,1,1,1,1,1,1,1,1,0,0,0,0,0,0,0,0,0,0,0,0,0,0,0,0,0,0,0,0,0,0,0,0,0,0,0,0,0,0,0,0,0,0,0,0,0,0,0,0,0,0,0,0,0,0,0,0,0,Luc Castaignos,£4.05m ,28,188,Forward - Centre-Forward,right,Gyeongnam FC,37,15,2,2646,11,3,0,426,51,16,6,3715,31,14,5,2639,35,14,0,2794,21,5,3,1028,14,0,0,430,36,3,1,1288,30,4,4,1824,Serie A,8,2,0,498,nan,nan,nan,nan
13/6/2011,Khouma Babacar,43043943,41,3/17/1993,18,0,0,0,0,3250,6490,5600,142,118,31618300,191,85,S ,1,3,1,1,3,2,1,4,3,1,1,7,7,11,12,12,6,15,11,8,5,12,10,5,13,12,13,15,14,12,11,10,15,9,10,15,8,12,13,14,10,13,14,5,12,12,20,12,13,13,8,12,7,6,18,18,4,17,15,15,11,3,1,1,1,10,1,10,1,S ,600,1,1,20,1,10,1,1,1,1,1,1,1,1,1,1,2.74878E+11,0,0,0,0,0,0,0,0,0,0,1,0,0,0,0,0,0,0,0,0,0,0,0,0,0,0,0,0,0,0,0,0,0,0,0,0,0,0,1,0,0,0,0,0,0,0,0,0,Khouma Babacar,£1.62m ,27,185,Forward - Centre-Forward,right,Alanyaspor,21,2,1,715,21,5,0,1349,17,2,0,850,42,20,8,3348,28,9,2,1365,24,7,1,1199,31,14,3,1764,31,7,4,1335,31,7,2,1523,Serie A,25,3,3,1426,6,2,1,218
13/6/2011,Kevin Volland,91014650,771,7/30/1992,18,0,0,0,0,4500,6050,6050,145,121,2475485,179,75,AM/S RL,1,3,3,1,3,1,3,3,2,1,3,6,11,12,13,14,5,13,6,3,4,11,9,5,15,10,10,11,12,10,9,11,16,12,6,14,6,11,8,15,14,12,10,20,11,14,8,13,11,13,8,6,3,15,4,15,12,17,14,5,11,3,1,1,14,18,15,18,11,AM/S RL,625,1,1,20,11,18,15,1,1,1,1,1,14,12,1,1,0,0,0,0,0,0,0,0,0,0,0,0,0,0,0,0,0,0,0,0,0,0,0,0,0,0,0,0,0,0,0,0,0,0,0,0,0,0,0,0,0,0,0,0,0,0,0,0,0,,,,,,,,,,,,,,,,,,,,,,,,,,,,,,,,,,,,,,,,,,,,,,,,,,,,
13/6/2011,Kelvin,19144895,1651,6/1/1993,18,0,0,0,0,1500,5500,5500,146,108,3999999,175,71,AM/S LC,3,2,2,3,2,3,1,7,1,1,3,12,14,16,12,16,11,4,12,4,4,13,13,5,15,6,13,10,13,11,11,9,11,16,6,13,5,6,11,15,14,5,5,20,13,14,3,7,5,10,6,10,9,12,12,12,9,13,9,5,11,7,1,1,1,18,10,17,18,AM/S LC,624,1,1,20,18,17,10,1,1,1,1,1,1,1,1,1,2.25183E+15,0,0,0,0,1,0,0,0,0,0,0,0,0,0,0,0,0,0,0,0,0,0,0,0,0,0,0,0,0,0,0,0,0,0,0,1,0,0,0,0,0,0,0,0,0,0,0,0,Kelvin,£1.80m ,27,175,Forward - Right Winger,left,Botafogo de Futebol e Regatas,4,1,0,324,27,2,2,1449,24,5,1,1382,23,1,2,1196,24,2,8,1464,35,2,3,2415,6,0,1,302,22,1,4,902,10,1,0,401,Liga NOS,6,0,0,346,nan,nan,nan,nan
13/6/2011,Julian Wießmeier,91100203,771,11/4/1992,18,0,0,0,0,4250,5500,5500,137,110,10383099,171,71,AM/S RC,1,1,2,2,3,1,1,1,3,2,2,10,13,14,14,14,8,13,9,5,6,13,10,10,14,6,10,7,11,9,11,12,6,12,12,8,9,13,10,14,13,14,6,16,15,9,20,9,6,10,10,10,6,10,11,9,8,15,15,14,11,11,1,1,14,18,18,1,16,AM/S RC,623,1,1,20,16,1,18,1,1,1,1,1,1,14,1,1,0,0,0,0,0,0,0,0,0,0,0,0,0,0,0,0,0,0,0,0,0,0,0,0,0,0,0,0,0,0,0,0,0,0,0,0,0,0,0,0,0,0,0,0,0,0,0,0,0,Julian Wießmeier,£720Th. ,27,171,Midfielder - Attacking Midfield,both,SV Ried,30,20,0,2421,24,7,5,1553,21,1,3,1367,21,4,2,1622,31,11,1,1973,29,15,3,2526,22,12,6,1843,38,8,9,2972,30,10,6,2146,Bundesliga,31,10,3,2318,5,2,0,154
13/6/2011,Joel Campbell,80010074,366,6/26/1992,18,19,4,0,0,5500,5250,5250,125,107,7540707,178,70,AM/S RL,3,1,2,2,3,1,1,1,3,3,3,10,13,8,10,13,9,9,11,6,4,6,9,7,13,17,8,7,13,9,8,9,12,11,12,12,5,7,10,13,13,13,7,20,12,13,10,6,3,9,6,9,11,9,11,12,11,10,13,13,10,10,1,1,9,20,20,20,1,AM/S RL,515,1,1,20,1,20,20,1,1,1,1,1,9,1,1,1,0,0,0,0,0,0,0,0,0,0,0,0,0,0,0,0,0,0,0,0,0,0,0,0,0,0,0,0,0,0,0,0,0,0,0,0,0,0,0,0,0,0,0,0,0,0,0,0,0,Joel Campbell,£1.35m ,28,178,Forward - Right Winger,left,Club León FC,8,0,0,416,27,4,3,1252,33,2,3,1889,43,11,11,3185,33,1,1,1832,31,4,6,1696,29,3,4,1246,9,2,1,232,38,4,4,2399,Ligue 1,23,1,3,1210,14,0,0,525
13/6/2011,Jeffrey Schlupp,29045055,771,12/23/1992,18,0,0,0,0,1600,2000,4800,131,96,2232442,173,70,AM/S L,2,1,1,3,2,1,1,1,2,2,3,4,8,10,10,8,4,6,7,3,3,7,9,6,8,7,7,5,8,7,7,8,10,9,5,10,6,8,12,14,11,7,5,20,10,16,10,8,9,10,5,10,6,7,14,10,10,10,10,10,10,3,7,7,14,17,1,17,1,AM/S L,623,1,1,20,1,17,1,1,7,1,1,1,14,1,7,1,0,0,0,0,0,0,0,0,0,0,0,0,0,0,0,0,0,0,0,0,0,0,0,0,0,0,0,0,0,0,0,0,0,0,0,0,0,0,0,0,0,0,0,0,0,0,0,0,0,,,,,,,,,,,,,,,,,,,,,,,,,,,,,,,,,,,,,,,,,,,,,,,,,,,,
13/6/2011,Iker Muniain,67037570,796,12/19/1992,18,0,0,0,0,4650,6750,6750,164,139,24000000,169,63,AM/S LC,1,3,2,2,1,3,2,5,3,2,3,6,12,16,14,13,7,8,10,3,3,12,10,6,17,13,14,14,12,13,13,14,14,17,11,14,3,10,13,17,15,14,5,9,12,14,20,11,11,12,7,11,6,11,13,17,13,12,11,7,9,13,1,1,11,18,11,18,15,AM/S LC,624,1,1,20,15,18,11,1,1,1,1,1,11,1,1,1,7.04031E+13,0,0,1,0,0,0,0,0,0,0,0,0,0,0,0,0,0,0,0,0,0,0,0,0,0,0,0,0,0,0,0,0,0,0,0,1,0,0,0,0,0,0,0,0,0,0,1,0,Iker Muniain,£18.00m ,27,169,Forward - Left Winger,right,Athletic Bilbao,38,5,3,2629,58,9,8,4717,43,2,3,2868,39,9,4,3021,41,2,4,3245,28,2,1,1364,46,7,5,3150,20,5,4,1298,37,7,5,2543,LaLiga,37,6,2,2868,6,0,0,409
13/6/2011,Heung-Min Son,92020288,135,7/8/1992,18,5,1,0,0,5250,6150,6650,162,132,229999992,183,76,AM/S RC,2,1,1,1,1,1,3,4,1,3,1,6,7,13,16,13,12,10,14,5,4,8,12,5,14,9,15,10,13,8,7,9,12,14,5,14,5,8,10,16,15,9,8,17,10,14,20,11,10,9,5,10,13,13,14,16,14,11,18,15,17,2,1,1,1,17,15,14,17,AM/S RC,623,1,1,20,17,14,15,1,1,1,1,1,1,1,1,1,1.81419E+13,0,0,0,0,1,0,0,0,0,1,0,0,0,1,0,0,0,0,0,0,0,0,0,0,0,0,0,0,0,0,0,0,0,0,0,0,0,0,0,1,0,0,0,0,1,0,0,0,Heung-min Son,£4.05m ,28,184,Forward - Left Winger,both,Tottenham Hotspur,14,3,0,748,30,5,1,1431,34,12,2,2786,43,12,7,3225,42,17,4,3181,42,8,5,2001,47,21,9,2972,53,18,11,3379,48,20,10,3292,Bundesliga,41,18,12,3174,8,9,4,586
13/6/2011,Guille,67142546,796,10/13/1992,18,0,0,0,0,1650,3150,3150,112,63,381296,178,75,S ,2,2,1,3,3,3,3,1,1,1,1,9,7,13,11,13,9,13,9,1,3,9,8,3,9,6,3,9,4,5,8,9,7,7,4,6,7,11,10,11,10,7,7,8,15,11,20,8,7,9,12,10,13,7,9,11,13,7,10,7,6,9,1,1,1,1,1,1,1,S ,600,1,1,20,1,1,1,1,1,1,1,1,1,1,1,1,0,0,0,0,0,0,0,0,0,0,0,0,0,0,0,0,0,0,0,0,0,0,0,0,0,0,0,0,0,0,0,0,0,0,0,0,0,0,0,0,0,0,0,0,0,0,0,0,0,,,,,,,,,,,,,,,,,,,,,,,,,,,,,,,,,,,,,,,,,,,,,,,,,,,,
13/6/2011,Francesco Grandolfo,43062178,776,7/26/1992,18,0,0,0,0,1500,5000,5000,145,105,1183609,185,82,S ,1,2,2,1,3,3,1,6,2,3,2,7,8,13,14,9,7,13,11,4,5,11,12,6,14,7,8,7,7,12,9,13,12,9,10,13,12,14,9,12,15,11,12,8,14,12,20,15,13,12,6,9,5,13,11,18,17,10,15,12,10,4,1,1,1,1,1,1,1,S ,600,1,1,20,1,1,1,1,1,1,1,1,1,1,1,1,0,0,0,0,0,0,0,0,0,0,0,0,0,0,0,0,0,0,0,0,0,0,0,0,0,0,0,0,0,0,0,0,0,0,0,0,0,0,0,0,0,0,0,0,0,0,0,0,0,Francesco Grandolfo,£450Th. ,28,180,Forward - Centre-Forward,left,FC Legnago Salus,26,19,0,2114,12,5,0,869,19,1,0,838,16,1,0,630,28,18,0,1826,31,10,0,2236,32,11,3,2234,15,1,1,523,37,5,0,2072,Serie A,28,3,2,1536,6,1,0,472
13/6/2011,Diego Rubio,75017533,1652,5/15/1993,18,1,0,0,0,3000,6250,6000,152,126,30000001,178,77,S ,3,3,2,1,1,2,2,6,1,1,3,10,11,11,14,12,12,11,12,6,6,10,13,6,12,13,12,13,13,11,9,10,14,14,8,15,6,10,12,14,14,10,11,11,13,14,20,10,10,11,6,12,8,12,13,13,13,15,15,16,15,6,1,1,1,12,7,7,12,S ,600,1,1,20,12,7,7,1,1,1,1,1,1,1,1,1,0,0,0,0,0,0,0,0,0,0,0,0,0,0,0,0,0,0,0,0,0,0,0,0,0,0,0,0,0,0,0,0,0,0,0,0,0,0,0,0,0,0,0,0,0,0,0,0,0,Diego Rubio,£1.35m ,27,179,Forward - Centre-Forward,right,Colorado Rapids,10,6,1,445,17,1,1,521,28,8,4,2056,32,8,2,1994,22,14,3,1857,38,3,5,1422,25,9,2,1782,28,11,6,1310,27,12,6,2157,Liga NOS,12,2,1,744,nan,nan,nan,nan
13/6/2011,Connor Wickham,28030306,765,3/31/1993,18,0,0,3,0,3900,6215,6500,153,113,114999996,191,90,S RL,1,2,3,2,1,3,3,2,2,1,3,4,8,13,12,14,2,11,5,18,3,13,12,8,12,10,8,12,10,10,11,12,15,10,9,12,10,12,12,13,10,10,15,8,12,14,20,7,17,10,3,12,9,10,10,15,14,10,12,10,12,6,1,1,1,15,15,15,1,S RL,605,1,1,20,1,15,15,1,1,1,1,1,1,1,1,1,1.1259E+15,0,0,1,0,0,0,0,0,0,1,0,0,0,0,0,0,0,0,0,0,0,0,0,0,0,0,0,0,0,0,0,0,0,0,0,0,0,0,0,0,0,0,0,0,0,0,0,0,Connor Wickham,£5.40m ,27,189,Forward - Centre-Forward,right,Crystal Palace,41,9,2,2727,19,1,1,670,25,7,0,1282,36,15,7,2531,40,6,1,2974,24,6,3,1586,10,3,0,545,nan,nan,nan,nan,8,1,1,159,Premier League,21,3,1,1135,nan,nan,nan,nan
13/6/2011,Brian Montenegro,79012289,1655,6/10/1993,18,0,0,0,0,1350,4859,3350,153,108,488737,179,79,S ,1,2,2,3,2,3,1,1,3,3,3,8,8,10,11,9,10,13,9,9,9,10,10,11,11,9,11,12,9,10,9,11,10,8,8,15,9,11,14,13,12,9,11,11,15,12,20,12,12,9,7,10,5,13,12,6,6,6,11,7,11,13,1,1,1,10,1,1,10,S ,600,1,1,20,10,1,1,1,1,1,1,1,1,1,1,1,0,0,0,0,0,0,0,0,0,0,0,0,0,0,0,0,0,0,0,0,0,0,0,0,0,0,0,0,0,0,0,0,0,0,0,0,0,0,0,0,0,0,0,0,0,0,0,0,0,,,,,,,,,,,,,,,,,,,,,,,,,,,,,,,,,,,,,,,,,,,,,,,,,,,,
13/6/2011,Bobby Shou Wood,92022817,390,11/15/1992,18,0,0,0,0,2250,4250,5000,135,90,784539,182,76,AM/S RC,2,1,1,1,3,1,3,3,3,1,3,10,12,12,12,12,8,10,6,2,6,12,5,3,11,12,6,6,8,9,7,5,10,12,5,12,5,15,12,13,12,12,9,8,14,12,20,10,4,10,14,10,8,16,6,10,12,6,6,6,12,20,1,1,12,18,15,10,18,AM/S RC,623,1,1,20,18,10,15,1,1,1,1,1,1,12,1,1,0,0,0,0,0,0,0,0,0,0,0,0,0,0,0,0,0,0,0,0,0,0,0,0,0,0,0,0,0,0,0,0,0,0,0,0,0,0,0,0,0,0,0,0,0,0,0,0,0,,,,,,,,,,,,,,,,,,,,,,,,,,,,,,,,,,,,,,,,,,,,,,,,,,,,
13/6/2011,Yero,85024504,41,8/19/1991,19,0,0,0,0,1500,4679,4500,139,104,3953403,195,89,S ,1,1,3,1,1,3,1,1,3,1,1,6,6,9,9,9,6,14,12,6,6,6,6,6,9,11,13,11,11,11,6,12,9,11,6,13,6,6,9,8,8,16,18,7,10,13,20,9,16,10,11,9,9,10,13,15,16,5,12,12,9,4,1,1,1,1,1,1,1,S ,600,1,1,20,1,1,1,1,1,1,1,1,1,1,1,1,0,0,0,0,0,0,0,0,0,0,0,0,0,0,0,0,0,0,0,0,0,0,0,0,0,0,0,0,0,0,0,0,0,0,0,0,0,0,0,0,0,0,0,0,0,0,0,0,0,,,,,,,,,,,,,,,,,,,,,,,,,,,,,,,,,,,,,,,,,,,,,,,,,,,,
13/6/2011,Vincent Aboubakar,12028932,11,1/22/1992,19,10,1,14,4,4850,6000,5400,141,120,22282814,184,82,S ,1,1,1,1,3,3,1,2,2,3,2,6,7,13,12,12,7,11,9,3,3,8,12,3,12,12,12,13,14,11,10,11,15,13,5,13,5,16,14,14,13,15,12,5,15,16,20,13,15,12,12,15,7,7,9,14,13,14,15,13,13,14,1,1,12,12,12,1,1,S ,600,1,1,20,1,1,12,1,1,1,1,1,1,12,1,1,512,0,0,0,0,0,0,0,0,0,1,0,0,0,0,0,0,0,0,0,0,0,0,0,0,0,0,0,0,0,0,0,0,0,0,0,0,0,0,0,0,0,0,0,0,0,0,0,0,Vincent Aboubakar,£2.25m ,28,184,Forward - Centre-Forward,right,Besiktas JK,20,4,1,787,31,8,6,2460,30,3,2,1340,36,16,8,2952,22,9,4,1202,42,18,3,3066,38,19,4,2423,43,26,7,2971,11,4,2,589,Ligue 1,10,2,0,294,2,0,0,108
13/6/2011,Valonis Kadrijaj,92037897,802,3/23/1992,19,0,0,0,0,2250,2500,3250,107,75,61405,192,91,S ,1,1,2,3,3,3,3,1,2,2,3,8,6,8,12,9,8,12,9,4,3,9,7,3,9,8,7,9,10,4,8,10,10,15,6,9,7,7,11,12,12,12,14,8,13,12,20,8,5,9,7,10,13,8,14,13,14,8,9,18,10,12,1,1,1,1,1,1,1,S ,600,1,1,20,1,1,1,1,1,1,1,1,1,1,1,1,0,0,0,0,0,0,0,0,0,0,0,0,0,0,0,0,0,0,0,0,0,0,0,0,0,0,0,0,0,0,0,0,0,0,0,0,0,0,0,0,0,0,0,0,0,0,0,0,0,,,,,,,,,,,,,,,,,,,,,,,,,,,,,,,,,,,,,,,,,,,,,,,,,,,,
13/6/2011,Uros Djeric,62072128,802,5/28/1992,19,0,0,0,0,750,3650,3000,124,77,4119452,196,87,S ,2,3,1,3,3,1,2,1,2,1,3,3,5,10,11,8,8,14,9,8,4,7,11,2,11,10,11,12,11,9,7,11,7,11,5,12,6,11,9,10,7,17,15,5,12,9,20,10,17,14,10,10,9,11,12,11,8,14,6,13,6,5,1,1,1,12,12,1,12,S ,600,1,1,20,12,1,12,1,1,1,1,1,1,1,1,1,0,0,0,0,0,0,0,0,0,0,0,0,0,0,0,0,0,0,0,0,0,0,0,0,0,0,0,0,0,0,0,0,0,0,0,0,0,0,0,0,0,0,0,0,0,0,0,0,0,,,,,,,,,,,,,,,,,,,,,,,,,,,,,,,,,,,,,,,,,,,,,,,,,,,,
13/6/2011,Simon Zoller,91007707,771,6/26/1991,19,0,0,0,0,1100,4650,4650,111,93,894805,179,70,S ,2,1,1,3,1,1,2,3,3,3,1,6,6,12,12,13,9,8,12,2,3,8,12,3,13,6,10,8,11,11,11,8,10,12,9,13,5,9,9,13,13,11,10,6,12,13,20,11,9,10,4,8,6,5,11,14,10,13,12,13,12,7,1,1,1,10,1,1,10,S ,600,1,1,20,10,1,1,1,1,1,1,1,1,1,1,1,4.39805E+12,0,0,0,0,0,0,0,0,0,1,0,0,0,0,0,0,0,0,0,0,0,0,0,0,0,0,0,0,0,0,0,0,0,0,0,0,0,0,0,0,0,0,1,0,0,0,0,0,Simon Rolfes,£3.60m ,38,191,Midfielder - Defensive Midfield,left,Retired,37,6,3,2414,40,3,6,2591,40,4,2,3031,43,7,5,3231,33,1,1,1856,nan,nan,nan,nan,nan,nan,nan,nan,nan,nan,nan,nan,nan,nan,nan,nan,Bundesliga,nan,nan,nan,nan,nan,nan,nan,nan
13/6/2011,Sega Keita,85033207,769,3/3/1992,19,0,0,0,0,1650,3350,3350,148,101,2098834,177,70,AM/S R,2,2,3,2,2,1,3,1,1,1,1,6,7,12,9,12,8,7,11,5,2,9,10,2,12,7,10,11,11,11,8,9,13,12,5,11,4,10,12,16,13,13,7,5,13,15,20,9,11,12,7,14,10,6,14,13,13,15,14,16,16,6,1,1,10,20,20,10,1,AM/S R,512,1,1,18,1,10,20,1,1,1,1,1,10,10,1,1,4.39805E+12,0,0,0,0,1,0,0,0,0,0,0,0,0,0,0,0,0,0,0,0,0,0,0,0,0,0,0,0,0,0,0,0,0,0,0,0,0,0,0,0,0,0,1,0,0,0,0,0,,,,,,,,,,,,,,,,,,,,,,,,,,,,,,,,,,,,,,,,,,,,,,,,,,,,
13/6/2011,Rafael Lopes,55028339,788,7/28/1991,19,0,0,0,0,1500,4700,4750,121,94,3821216,187,75,S ,2,1,3,2,2,2,2,2,1,2,1,10,8,12,14,14,10,14,14,6,6,10,8,4,13,5,9,3,14,10,10,8,8,10,12,13,9,5,9,11,10,14,13,5,14,11,20,5,14,10,7,10,7,9,10,12,13,14,13,14,15,11,1,1,1,10,10,7,7,S ,600,1,1,20,7,7,10,1,1,1,1,1,1,1,1,1,0,0,0,0,0,0,0,0,0,0,0,0,0,0,0,0,0,0,0,0,0,0,0,0,0,0,0,0,0,0,0,0,0,0,0,0,0,0,0,0,0,0,0,0,0,0,0,0,0,Rafael Copetti,£90Th. ,29,193,Goalkeeper,left,Esporte Clube Pelotas (RS),nan,nan,nan,nan,1,1,0,0,0,0,0,0,0,0,0,0,3,4,1,188,nan,nan,nan,nan,nan,nan,nan,nan,nan,nan,nan,nan,nan,nan,nan,nan,Liga NOS,nan,nan,nan,nan,nan,nan,nan,nan
13/6/2011,Pierre-Michel Lasogga,91014711,771,12/15/1991,19,0,0,3,1,3750,6100,6100,140,120,13007663,189,88,S ,2,3,1,3,3,1,1,6,3,3,2,4,5,7,13,7,6,12,10,3,4,7,12,6,8,14,16,18,15,11,7,13,18,5,9,14,9,12,18,10,7,12,15,14,8,15,20,13,18,17,12,10,13,6,15,14,14,5,4,16,17,12,1,1,8,10,10,1,1,S ,600,1,1,20,1,1,10,1,1,1,1,1,1,8,1,1,4.39805E+12,0,0,0,0,0,0,0,0,0,1,0,0,0,0,0,0,0,0,0,1,0,0,0,0,0,0,0,0,0,0,0,0,0,0,0,0,0,0,0,0,0,0,1,0,0,0,0,0,Pierre-Michel Lasogga,£4.50m ,28,189,Forward - Centre-Forward,right,Al-Arabi SC,31,16,5,2149,36,10,4,2218,8,1,2,287,24,15,1,1839,30,5,0,2235,31,8,3,1828,22,2,0,632,33,10,4,1991,31,19,2,2056,Bundesliga,20,7,5,1510,1,0,0,12
13/6/2011,Nicky Ajose,28010492,765,10/7/1991,19,0,0,0,0,1950,4500,4500,140,87,3030139,178,73,AM/S RL,3,2,3,1,2,2,3,5,2,3,1,11,8,11,11,10,5,5,4,4,2,7,4,3,10,3,9,5,9,8,7,10,15,13,2,12,5,11,11,14,11,9,7,10,13,14,20,9,7,10,3,5,3,15,12,11,6,9,16,10,14,2,6,1,8,18,17,18,10,AM/S RL,625,1,1,20,10,18,17,1,6,1,1,1,8,6,1,1,34359738368,0,0,0,0,0,0,0,0,0,0,0,0,0,0,0,0,0,0,0,0,0,0,0,0,0,0,0,0,0,0,0,0,0,0,0,1,0,0,0,0,0,0,0,0,0,0,0,0,,,,,,,,,,,,,,,,,,,,,,,,,,,,,,,,,,,,,,,,,,,,,,,,,,,,
13/6/2011,Nélson Oliveira,55011049,788,8/8/1991,19,0,0,0,0,4250,5500,5500,176,110,9660040,186,82,S ,3,3,1,2,2,3,1,7,2,1,3,9,10,12,12,12,11,10,13,5,5,9,13,5,12,10,12,9,13,11,9,9,10,14,8,13,6,8,10,11,11,14,12,12,16,11,20,12,15,10,6,12,7,12,11,15,14,16,12,14,15,5,1,1,1,7,7,7,7,S ,600,1,1,20,7,7,7,1,1,1,1,1,1,1,1,1,0,0,0,0,0,0,0,0,0,0,0,0,0,0,0,0,0,0,0,0,0,0,0,0,0,0,0,0,0,0,0,0,0,0,0,0,0,0,0,0,0,0,0,0,0,0,0,0,0,Nélson Oliveira,£3.60m ,29,185,Forward - Centre-Forward,right,AEK Athens,31,5,0,1404,22,3,2,909,31,4,0,939,36,8,2,2122,13,1,1,425,29,9,1,2078,32,15,5,1738,40,8,3,2696,13,5,0,916,Liga NOS,34,16,9,2407,6,1,0,411
13/6/2011,Marcos Álvarez,35017420,771,9/30/1991,19,0,0,0,0,750,5000,5000,123,100,4963922,179,69,S ,2,1,3,1,3,3,1,1,3,3,3,7,11,11,12,11,7,9,8,6,6,10,7,9,11,9,11,8,11,11,11,10,10,8,5,13,11,10,12,14,11,11,9,6,11,14,20,11,10,8,9,8,4,8,12,11,10,9,17,16,12,11,1,1,1,14,14,1,1,S ,600,1,1,20,1,1,14,1,1,1,1,1,1,1,1,1,0,0,0,0,0,0,0,0,0,0,0,0,0,0,0,0,0,0,0,0,0,0,0,0,0,0,0,0,0,0,0,0,0,0,0,0,0,0,0,0,0,0,0,0,0,0,0,0,0,Marcos Pérez,- ,31,174,Defender - Right-Back,right,Ciudad Lucena,26,0,0,2268,17,0,0,1073,24,0,0,2112,31,1,0,2571,36,0,0,3085,nan,nan,nan,nan,1,0,0,120,33,0,0,2469,10,0,0,898,LaLiga,15,0,0,1246,nan,nan,nan,nan
13/6/2011,Marco Prießner,92032203,771,3/8/1992,19,0,0,0,0,50,3000,3000,81,60,281874,181,0,S ,1,2,3,1,3,1,1,1,3,3,3,7,4,13,12,10,4,9,12,1,1,9,5,2,8,11,6,9,11,4,7,4,10,6,11,8,6,12,13,8,12,13,8,8,15,13,20,8,5,10,16,10,5,9,5,12,14,14,14,12,18,11,1,1,1,1,1,1,1,S ,600,1,1,20,1,1,1,1,1,1,1,1,1,1,1,1,0,0,0,0,0,0,0,0,0,0,0,0,0,0,0,0,0,0,0,0,0,0,0,0,0,0,0,0,0,0,0,0,0,0,0,0,0,0,0,0,0,0,0,0,0,0,0,0,0,,,,,,,,,,,,,,,,,,,,,,,,,,,,,,,,,,,,,,,,,,,,,,,,,,,,
13/6/2011,Lennart Thy,92018031,771,2/25/1992,19,0,0,0,0,3250,5350,5750,142,107,4590467,184,78,S ,3,3,1,1,2,1,2,1,2,3,2,5,8,11,13,12,8,12,10,5,6,10,12,5,12,12,15,13,10,11,9,12,10,10,7,15,8,13,14,12,11,10,12,12,13,11,20,12,11,12,5,14,7,5,12,7,13,13,6,16,14,10,1,1,10,14,14,14,13,S ,600,1,1,20,13,14,14,1,1,1,1,8,10,10,1,1,0,0,0,0,0,0,0,0,0,0,0,0,0,0,0,0,0,0,0,0,0,0,0,0,0,0,0,0,0,0,0,0,0,0,0,0,0,0,0,0,0,0,0,0,0,0,0,0,0,Lennart Thy,£540Th. ,28,184,Forward - Centre-Forward,right,Sparta Rotterdam,44,9,2,2850,26,2,6,2103,24,3,1,1590,28,4,2,1838,34,5,3,2209,31,8,4,2548,22,3,0,764,34,8,6,2976,31,10,2,1878,Bundesliga,26,8,2,1851,6,2,0,438
13/6/2011,Joshua King,53020695,786,1/15/1992,19,0,0,0,0,3100,5500,5500,144,109,8243630,186,78,S ,3,2,1,2,3,2,2,7,2,2,2,4,6,8,11,12,4,7,6,4,4,8,8,3,12,7,9,7,9,9,5,8,10,15,2,12,4,8,10,17,13,12,14,9,10,17,20,8,12,9,4,10,12,8,14,6,11,6,15,13,15,4,1,1,1,12,12,12,1,S ,600,1,1,20,1,12,12,1,1,1,1,1,1,1,1,1,34359738384,0,0,0,0,1,0,0,0,0,0,0,0,0,0,0,0,0,0,0,0,0,0,0,0,0,0,0,0,0,0,0,0,0,0,0,1,0,0,0,0,0,0,0,0,0,0,0,0,Joshua King,- ,28,189,Forward - Second Striker,right,AFC Bournemouth,22,5,2,1585,26,3,3,1267,27,2,6,1742,35,2,7,2090,19,5,1,890,35,7,4,2241,36,16,2,2720,34,9,3,2497,38,12,4,3037,Bundesliga,27,6,4,2050,2,0,0,113
13/6/2011,Jordan Faucher,85070955,769,11/6/1991,19,0,0,0,0,1000,2000,2000,119,80,79107,174,68,S ,3,2,1,1,1,3,1,3,1,1,3,7,7,12,12,12,7,6,9,5,1,8,14,2,12,6,10,7,15,12,8,11,10,12,5,12,4,6,9,13,14,10,7,5,15,11,20,12,7,14,6,16,5,6,7,18,12,11,10,14,14,6,1,1,1,1,1,1,1,S ,600,1,1,20,1,1,1,1,1,1,1,1,1,1,1,1,0,0,0,0,0,0,0,0,0,0,0,0,0,0,0,0,0,0,0,0,0,0,0,0,0,0,0,0,0,0,0,0,0,0,0,0,0,0,0,0,0,0,0,0,0,0,0,0,0,Jordan Ferri, ,28,172,Midfielder - Central Midfield,right,Montpellier HSC,nan,nan,nan,nan,0,0,0,0,10,0,0,328,42,4,0,2868,42,2,6,3134,44,3,5,3014,36,3,4,1572,34,0,4,1324,32,2,1,2268,Ligue 1,19,0,0,1349,8,0,0,484
13/6/2011,Jordan Ayew,34010721,21,9/11/1991,19,2,0,1,1,5100,6350,5700,164,127,8490220,182,81,S ,2,2,2,2,2,3,1,1,2,1,3,5,12,13,11,13,7,14,11,5,4,11,12,2,14,7,13,14,11,12,11,12,15,14,5,13,5,10,13,16,13,15,12,5,16,15,20,14,14,12,12,16,5,7,13,15,14,16,12,10,8,7,1,1,10,14,14,12,1,S ,600,1,1,20,1,12,14,1,1,1,1,1,10,10,1,1,2.2518E+15,0,0,0,0,0,0,0,0,0,0,0,1,0,0,0,0,0,0,0,0,0,0,0,0,0,0,0,0,0,0,0,0,0,0,0,0,0,0,0,0,0,0,0,0,0,0,0,0,Jordan Ayew,£3.60m ,29,182,Forward - Centre-Forward,right,Crystal Palace,29,2,4,955,45,7,7,2310,47,10,5,2696,40,7,3,2269,33,13,7,2716,36,7,1,2695,36,4,7,2482,44,11,3,3278,25,2,2,1340,Ligue 1,39,9,2,3269,5,0,0,373
13/6/2011,Jérémy Manzorro,85014239,769,11/11/1991,19,0,0,0,0,1000,2000,2000,115,81,593184,173,70,S ,3,3,1,3,2,2,1,1,3,2,3,5,7,11,10,11,7,6,8,5,1,7,10,3,11,12,11,10,7,7,7,9,10,12,5,12,5,8,11,15,13,11,6,5,11,14,20,12,9,13,12,10,12,12,12,15,15,2,11,10,8,7,1,1,14,14,14,1,10,S ,600,1,1,20,10,1,14,1,1,1,8,10,1,14,1,1,2,0,1,0,0,0,0,0,0,0,0,0,0,0,0,0,0,0,0,0,0,0,0,0,0,0,0,0,0,0,0,0,0,0,0,0,0,0,0,0,0,0,0,0,0,0,0,0,0,,,,,,,,,,,,,,,,,,,,,,,,,,,,,,,,,,,,,,,,,,,,,,,,,,,,
13/6/2011,Jannis Schliesing,92038157,771,1/5/1992,19,0,0,0,0,250,4200,4200,115,83,776948,187,71,S ,2,2,3,1,2,1,3,3,1,1,3,8,4,9,11,12,8,12,4,1,3,7,8,8,11,8,8,4,10,3,6,6,9,16,9,12,8,10,11,12,12,12,10,16,14,12,20,7,4,10,5,10,9,10,5,15,12,16,12,18,17,13,1,1,1,1,1,1,1,S ,600,1,1,20,1,1,1,1,1,1,1,1,1,1,1,1,0,0,0,0,0,0,0,0,0,0,0,0,0,0,0,0,0,0,0,0,0,0,0,0,0,0,0,0,0,0,0,0,0,0,0,0,0,0,0,0,0,0,0,0,0,0,0,0,0,,,,,,,,,,,,,,,,,,,,,,,,,,,,,,,,,,,,,,,,,,,,,,,,,,,,
13/6/2011,Jake Taylor,28029361,801,12/1/1991,19,0,0,4,0,1550,4000,4000,131,85,806432,172,71,AM C,1,1,1,3,2,3,1,4,2,1,2,9,8,7,8,12,9,3,7,7,7,11,11,8,11,4,5,10,9,7,5,8,9,6,13,7,6,7,13,14,7,11,6,15,17,11,20,14,5,16,4,7,3,18,13,10,16,10,7,14,6,13,7,7,10,20,13,13,20,AM C,501,1,1,15,20,13,13,1,1,7,1,7,7,10,1,7,0,0,0,0,0,0,0,0,0,0,0,0,0,0,0,0,0,0,0,0,0,0,0,0,0,0,0,0,0,0,0,0,0,0,0,0,0,0,0,0,0,0,0,0,0,0,0,0,0,,,,,,,,,,,,,,,,,,,,,,,,,,,,,,,,,,,,,,,,,,,,,,,,,,,,
13/6/2011,Ishak Belfodil,85029184,769,1/12/1992,19,0,0,0,0,1550,5219,5200,140,116,4301352,191,86,S ,3,1,2,3,3,3,2,5,3,3,2,5,6,12,12,14,7,13,10,6,2,8,11,2,14,8,12,12,12,12,11,11,14,13,5,13,6,9,11,14,11,16,15,5,15,12,20,14,16,13,8,15,6,5,14,16,11,14,14,14,14,8,1,1,1,1,1,1,1,S ,600,1,1,20,1,1,1,1,1,1,1,1,1,1,1,1,0,0,0,0,0,0,0,0,0,0,0,0,0,0,0,0,0,0,0,0,0,0,0,0,0,0,0,0,0,0,0,0,0,0,0,0,0,0,0,0,0,0,0,0,0,0,0,0,0,Ishak Belfodil,£2.25m ,28,192,Forward - Centre-Forward,right,TSG 1899 Hoffenheim,0,0,0,0,17,0,0,348,34,8,5,2050,27,1,1,1129,23,1,3,1362,23,11,5,1957,37,17,6,3277,32,6,1,1605,35,17,6,2322,Serie A,5,0,0,269,5,0,0,215
13/6/2011,Gilmar,55025006,1651,9/23/1991,19,0,0,0,0,250,500,500,121,73,393962,193,80,S ,3,3,3,3,1,2,2,1,3,2,2,7,5,11,7,9,7,11,8,2,3,9,7,1,4,3,8,8,9,4,9,7,8,13,12,11,6,9,5,11,9,9,13,8,11,11,20,2,10,10,17,10,3,8,11,12,11,8,10,5,13,4,1,1,1,1,1,1,1,S ,600,1,1,20,1,1,1,1,1,1,1,1,1,1,1,1,0,0,0,0,0,0,0,0,0,0,0,0,0,0,0,0,0,0,0,0,0,0,0,0,0,0,0,0,0,0,0,0,0,0,0,0,0,0,0,0,0,0,0,0,0,0,0,0,0,Gilmar,£180Th. ,29,193,Forward - Centre-Forward,right,Aliados FC Lordelo,2,1,0,113,8,1,0,313,nan,nan,nan,nan,nan,nan,nan,nan,1,0,0,44,nan,nan,nan,nan,nan,nan,nan,nan,nan,nan,nan,nan,nan,nan,nan,nan,Liga NOS,nan,nan,nan,nan,nan,nan,nan,nan
13/6/2011,Gerard Moreno,67115823,796,4/7/1992,19,0,0,0,0,2650,4150,4150,125,83,2024540,177,75,S ,1,1,3,1,1,2,3,5,3,3,1,9,6,10,12,11,9,12,10,3,4,9,6,6,13,10,11,5,12,7,7,10,9,13,14,13,7,8,10,12,10,11,6,20,11,11,10,6,7,10,6,10,13,9,15,17,14,12,7,5,8,5,1,1,1,1,1,1,1,S ,600,1,1,20,1,1,1,1,1,1,1,1,1,1,1,1,0,0,0,0,0,0,0,0,0,0,0,0,0,0,0,0,0,0,0,0,0,0,0,0,0,0,0,0,0,0,0,0,0,0,0,0,0,0,0,0,0,0,0,0,0,0,0,0,0,,,,,,,,,,,,,,,,,,,,,,,,,,,,,,,,,,,,,,,,,,,,,,,,,,,,
13/6/2011,Flamur Kastrati,53024848,786,11/14/1991,19,0,0,1,0,3000,5219,5800,139,116,5682536,185,75,AM/S RLC,2,2,2,2,2,1,2,2,3,2,2,6,8,14,10,13,8,11,8,4,5,10,10,5,13,12,11,12,11,8,9,10,8,11,5,14,7,11,13,16,15,11,12,8,11,12,20,11,12,11,6,10,8,12,18,13,10,6,6,11,8,12,1,1,14,18,15,18,15,AM/S RLC,626,1,1,20,15,18,15,1,1,1,1,10,14,14,1,1,0,0,0,0,0,0,0,0,0,0,0,0,0,0,0,0,0,0,0,0,0,0,0,0,0,0,0,0,0,0,0,0,0,0,0,0,0,0,0,0,0,0,0,0,0,0,0,0,0,,,,,,,,,,,,,,,,,,,,,,,,,,,,,,,,,,,,,,,,,,,,,,,,,,,,
13/6/2011,Dudu,19090225,1651,9/20/1991,19,0,0,0,0,750,4250,4750,136,105,12589681,184,76,S ,1,1,2,3,1,2,1,8,3,2,1,2,8,12,12,11,7,11,14,6,6,9,11,6,12,6,11,9,12,11,9,12,6,13,5,13,4,11,11,13,12,12,13,8,9,12,20,13,12,12,6,10,6,7,7,13,8,13,6,5,13,9,1,1,1,1,1,1,1,S ,600,1,1,20,1,1,1,1,1,1,1,1,1,1,1,1,0,0,0,0,0,0,0,0,0,0,0,0,0,0,0,0,0,0,0,0,0,0,0,0,0,0,0,0,0,0,0,0,0,0,0,0,0,0,0,0,0,0,0,0,0,0,0,0,0,Dudu,£450Th. ,29,184,Forward - Centre-Forward,right,São Gonçalo Esporte Clube (RJ),nan,nan,nan,nan,13,1,0,257,0,0,0,0,nan,nan,nan,nan,0,0,0,0,0,0,0,0,nan,nan,nan,nan,3,0,0,74,nan,nan,nan,nan,Liga NOS,nan,nan,nan,nan,nan,nan,nan,nan
13/6/2011,Dennis Mast,91105976,771,2/15/1992,19,0,0,0,0,250,3600,3600,107,72,21392,184,0,M/AM/S RC,3,2,2,2,1,2,3,3,1,2,1,7,9,13,11,10,4,5,8,9,9,8,6,6,10,8,6,4,9,10,8,8,9,8,7,8,5,10,12,13,11,9,12,20,14,12,4,8,4,8,12,3,8,8,11,6,12,12,17,13,16,12,1,1,16,20,20,9,15,M/AM/S RC,533,1,1,17,15,9,20,1,1,1,1,11,8,16,1,1,0,0,0,0,0,0,0,0,0,0,0,0,0,0,0,0,0,0,0,0,0,0,0,0,0,0,0,0,0,0,0,0,0,0,0,0,0,0,0,0,0,0,0,0,0,0,0,0,0,,,,,,,,,,,,,,,,,,,,,,,,,,,,,,,,,,,,,,,,,,,,,,,,,,,,
13/6/2011,David Steppé,85081065,769,7/13/1991,19,0,0,0,0,1100,2250,2250,112,91,2002989,178,67,S ,3,1,2,2,2,3,3,1,3,2,3,6,8,12,7,12,9,6,12,5,1,8,11,3,13,7,10,8,11,11,11,9,8,14,5,11,5,7,12,16,15,12,7,5,12,15,20,12,8,10,7,8,14,6,14,10,10,6,16,9,13,9,1,1,1,10,10,10,10,S ,600,1,1,20,10,10,10,1,1,1,1,1,1,1,1,1,4.39805E+12,0,0,0,0,1,0,0,0,0,0,0,0,0,0,0,0,0,0,0,0,0,0,0,0,0,0,0,0,0,0,0,0,0,0,0,0,0,0,0,0,0,0,1,0,0,0,0,0,,,,,,,,,,,,,,,,,,,,,,,,,,,,,,,,,,,,,,,,,,,,,,,,,,,,
13/6/2011,Cristian Tello,67046417,796,8/11/1991,19,0,0,0,0,3500,5500,5500,125,106,1753741,178,66,AM/S R,2,3,3,1,2,3,3,1,1,1,3,7,11,12,11,9,9,8,8,10,7,11,10,5,13,7,11,9,11,11,9,11,7,10,12,13,7,12,11,14,13,7,9,7,12,13,20,13,9,9,16,10,12,12,7,20,15,8,7,5,7,10,1,1,15,20,20,1,1,AM/S R,512,1,1,18,1,1,20,1,1,1,1,1,1,15,1,1,0,0,0,0,0,0,0,0,0,0,0,0,0,0,0,0,0,0,0,0,0,0,0,0,0,0,0,0,0,0,0,0,0,0,0,0,0,0,0,0,0,0,0,0,0,0,0,0,0,Cristian Tello,£4.50m ,29,178,Forward - Left Winger,both,Real Betis Balompié,23,4,0,972,38,12,2,1737,34,8,6,1633,30,5,5,830,37,8,11,2119,35,4,5,2093,42,4,8,2416,33,6,4,1773,41,5,9,2413,LaLiga,30,3,1,993,7,2,0,316
13/6/2011,Cedric,67052395,53,3/5/1992,19,0,0,0,0,4100,5579,6250,145,124,11416664,167,62,AM RL,3,1,3,1,1,1,3,8,2,3,3,7,10,13,7,9,6,6,5,7,6,9,6,6,11,7,11,12,6,8,10,9,10,15,7,14,11,9,10,17,15,14,4,20,18,16,6,13,8,14,4,12,2,17,16,16,14,10,6,18,17,6,1,1,15,20,17,20,10,AM RL,505,1,1,15,10,20,17,1,1,1,1,1,15,15,1,1,8209,1,0,0,0,1,0,0,0,0,0,0,0,0,1,0,0,0,0,0,0,0,0,0,0,0,0,0,0,0,0,0,0,0,0,0,0,0,0,0,0,0,0,0,0,0,0,0,0,,,,,,,,,,,,,,,,,,,,,,,,,,,,,,,,,,,,,,,,,,,,,,,,,,,,
13/6/2011,Benjamin Jeannot,85015640,769,1/22/1992,19,0,0,0,0,4050,5050,5050,157,112,20960209,183,76,S ,1,2,2,1,1,1,1,1,3,2,2,5,5,11,11,11,7,13,12,5,4,8,12,3,12,8,12,14,11,12,7,10,13,13,5,13,6,11,13,15,12,14,12,8,13,13,20,13,14,12,8,14,9,5,15,13,15,11,14,14,14,6,1,1,1,1,1,1,1,S ,600,1,1,20,1,1,1,1,1,1,1,1,1,1,1,1,262144,0,0,0,0,0,0,0,0,0,0,0,0,0,0,0,0,0,0,1,0,0,0,0,0,0,0,0,0,0,0,0,0,0,0,0,0,0,0,0,0,0,0,0,0,0,0,0,0,Benjamin Jeannot,£720Th. ,28,183,Forward - Centre-Forward,right,SM Caen,9,0,0,521,7,0,0,225,39,10,1,2789,33,6,2,2222,33,7,6,2312,37,14,2,2434,20,1,1,710,27,4,1,1585,25,2,0,1696,Ligue 1,19,2,0,1189,7,0,1,110
13/6/2011,Andy Delort,85059211,769,10/9/1991,19,0,0,0,0,1600,3200,3200,130,98,9809229,182,82,S ,3,1,2,3,2,2,1,1,1,3,1,6,6,12,11,12,8,14,12,5,4,9,10,2,12,11,10,13,11,11,8,9,14,13,5,12,7,5,12,13,11,14,12,5,14,11,20,13,14,12,11,10,7,8,10,14,9,8,11,11,11,15,1,1,1,12,12,1,1,S ,600,1,1,20,1,1,12,1,1,1,1,1,1,1,1,1,8388608,0,0,0,0,0,0,0,0,0,0,0,0,0,0,0,0,0,0,0,0,0,0,0,1,0,0,0,0,0,0,0,0,0,0,0,0,0,0,0,0,0,0,0,0,0,0,0,0,Andy Delort,£450Th. ,29,182,Forward - Centre-Forward,right,Montpellier HSC,28,6,3,1089,22,1,0,892,18,1,1,371,39,25,8,3265,27,2,5,1829,38,13,2,3349,31,9,1,1904,36,5,5,2628,38,14,7,3242,Ligue 1,31,12,3,2684,7,3,2,519
13/6/2011,Andrew Halliday,61011716,793,10/11/1991,19,0,0,0,0,2650,4750,4750,127,95,2053679,181,64,AM L,2,3,2,1,2,3,2,3,1,3,2,4,9,13,12,12,7,9,12,2,5,12,7,6,12,9,12,11,7,6,7,10,9,10,5,12,8,7,10,13,12,9,9,20,11,13,10,9,8,10,5,8,5,8,13,10,8,6,11,6,8,7,1,1,9,20,14,20,1,AM L,503,1,1,15,1,20,14,1,1,1,1,1,9,1,1,1,5.49756E+11,1,0,0,0,0,0,0,0,0,0,0,0,0,0,0,0,0,0,0,0,0,0,0,0,0,0,0,0,0,0,0,0,0,0,0,0,0,0,0,1,0,0,0,0,0,0,0,0,,,,,,,,,,,,,,,,,,,,,,,,,,,,,,,,,,,,,,,,,,,,,,,,,,,,
13/6/2011,André Carrillo,77012583,1656,6/14/1991,19,2,0,9,2,1500,5750,5250,145,115,8199043,181,68,AM/S R,1,1,1,2,3,2,2,1,3,1,2,8,11,12,7,6,7,7,6,9,5,10,11,5,11,5,7,9,5,7,6,7,12,14,6,11,5,14,12,16,13,8,11,13,9,16,20,13,8,13,5,12,7,15,13,16,13,12,14,15,8,2,1,1,5,20,20,7,7,AM/S R,512,1,1,18,7,7,20,1,1,1,1,1,1,5,1,1,0,0,0,0,0,0,0,0,0,0,0,0,0,0,0,0,0,0,0,0,0,0,0,0,0,0,0,0,0,0,0,0,0,0,0,0,0,0,0,0,0,0,0,0,0,0,0,0,0,André Carrillo,£3.33m ,29,180,Forward - Right Winger,right,Al-Hilal Riyadh,9,3,1,411,46,3,9,2454,31,3,4,1778,32,2,5,1740,46,7,18,3091,7,1,3,609,32,3,3,1250,30,2,2,1662,33,6,8,2787,Liga NOS,35,6,7,2432,1,1,0,90
13/6/2011,Alhassane Keita,13100704,22,4/16/1992,19,0,0,0,0,1400,4600,2300,128,92,3265555,182,72,S ,2,3,3,2,1,2,3,2,3,2,3,5,7,11,11,10,8,13,12,5,3,7,12,2,12,11,11,12,11,8,5,10,10,13,6,12,4,7,9,14,12,13,11,5,14,12,20,12,11,13,11,10,7,10,9,18,6,10,13,1,7,8,1,1,1,1,1,1,1,S ,600,1,1,20,1,1,1,1,1,1,1,1,1,1,1,1,0,0,0,0,0,0,0,0,0,0,0,0,0,0,0,0,0,0,0,0,0,0,0,0,0,0,0,0,0,0,0,0,0,0,0,0,0,0,0,0,0,0,0,0,0,0,0,0,0,Alassane Plea, ,27,181,Forward - Centre-Forward,right,Borussia Mönchengladbach,nan,nan,nan,nan,0,0,0,0,3,0,0,91,25,4,1,1529,35,3,9,2603,19,6,4,1412,32,14,3,2328,49,21,7,4083,35,15,4,2598,Ligue 1,33,10,11,2452,5,1,1,322
13/6/2011,Alexander Aschauer,16016307,755,3/14/1992,19,0,0,0,0,2250,2000,4000,112,89,885487,190,81,S ,3,2,1,1,2,1,3,1,1,2,1,3,7,10,11,9,3,14,9,3,4,10,9,4,12,8,8,9,9,8,8,9,10,4,4,11,3,11,11,11,9,12,15,12,10,10,20,10,14,8,3,9,4,3,14,11,12,8,12,15,8,7,1,1,1,1,1,1,1,S ,600,1,1,20,1,1,1,1,1,1,1,1,1,1,1,1,0,0,0,0,0,0,0,0,0,0,0,0,0,0,0,0,0,0,0,0,0,0,0,0,0,0,0,0,0,0,0,0,0,0,0,0,0,0,0,0,0,0,0,0,0,0,0,0,0,Alexander Bugera,£450Th. ,42,180,Defender - Left-Back,left,Retired,17,0,2,1341,25,1,0,2244,13,0,0,1033,25,0,6,1991,23,1,1,1993,nan,nan,nan,nan,nan,nan,nan,nan,nan,nan,nan,nan,nan,nan,nan,nan,Bundesliga,nan,nan,nan,nan,nan,nan,nan,nan
13/6/2011,Akaki Gogia,92025869,771,1/18/1992,19,0,0,0,0,1500,5900,5900,128,110,4180992,177,74,M/AM C,3,3,1,3,1,2,1,6,2,3,1,10,8,12,13,12,14,8,13,3,10,11,10,13,13,5,11,10,11,9,14,8,7,10,10,9,9,12,12,14,10,7,8,14,13,14,20,12,7,10,6,9,9,10,7,14,16,10,8,13,12,3,1,1,18,20,1,1,20,M/AM C,521,1,1,15,20,1,1,1,1,1,1,18,1,1,1,1,0,0,0,0,0,0,0,0,0,0,0,0,0,0,0,0,0,0,0,0,0,0,0,0,0,0,0,0,0,0,0,0,0,0,0,0,0,0,0,0,0,0,0,0,0,0,0,0,0,Akaki Gogia,£540Th. ,28,178,Forward - Right Winger,both,1.FC Union Berlin,36,18,2,2954,14,0,1,588,25,1,3,1413,36,8,5,2962,38,13,10,3267,14,0,1,503,24,10,2,1800,22,2,5,1471,31,6,5,1505,Bundesliga,3,0,0,120,0,0,0,0
13/6/2011,Zé Luís,55027773,12,1/24/1991,20,1,0,0,0,3000,5500,5500,157,117,1449028,180,78,S ,3,2,3,2,1,2,2,2,3,3,1,9,12,13,14,12,9,12,9,6,6,9,9,6,12,14,12,12,12,9,9,8,14,14,8,13,6,6,9,11,14,10,14,12,14,13,20,7,11,10,8,12,8,10,14,14,13,15,14,12,12,7,1,1,1,6,6,6,6,S ,600,1,1,20,6,6,6,1,1,1,1,1,1,1,1,1,0,0,0,0,0,0,0,0,0,0,0,0,0,0,0,0,0,0,0,0,0,0,0,0,0,0,0,0,0,0,0,0,0,0,0,0,0,0,0,0,0,0,0,0,0,0,0,0,0,Zé Luís,£810Th. ,29,184,Forward - Centre-Forward,left,Lokomotiv Moscow,27,12,0,1759,16,5,0,731,36,8,1,1693,29,10,5,1577,25,11,5,1604,25,10,5,1768,24,5,6,1703,24,6,8,1546,36,14,4,2657,Liga NOS,31,10,2,1744,4,0,1,71
13/6/2011,Yannis Tafer,34011690,769,2/11/1991,20,0,0,0,0,4150,5219,5200,140,116,1997850,180,67,S ,2,2,3,3,1,3,1,7,2,1,1,5,8,12,12,13,8,8,11,5,3,9,15,2,13,7,12,9,14,12,8,11,13,14,6,13,7,11,13,16,14,13,9,20,15,15,5,16,9,12,7,15,6,6,12,14,15,14,16,14,14,6,1,1,1,10,1,10,1,S ,600,1,1,20,1,10,1,1,1,1,1,1,1,1,1,1,16,0,0,0,0,1,0,0,0,0,0,0,0,0,0,0,0,0,0,0,0,0,0,0,0,0,0,0,0,0,0,0,0,0,0,0,0,0,0,0,0,0,0,0,0,0,0,0,0,Yannis Tafer,£270Th. ,29,181,Midfielder - Right Midfield,left,Without Club,17,0,1,570,0,0,0,0,29,5,5,1520,37,9,7,2897,34,10,9,2582,19,8,1,1307,38,8,3,1967,23,2,0,982,27,0,4,1300,Ligue 1,9,0,1,339,nan,nan,nan,nan
13/6/2011,Yacine Qasmi,85057309,34,1/3/1991,20,0,0,0,0,1250,2550,2550,139,102,1886246,184,75,S ,3,3,1,3,1,3,2,2,2,2,3,10,7,10,12,13,10,14,8,5,3,8,12,3,12,7,13,11,9,10,9,11,15,11,8,10,5,15,13,13,11,14,12,20,14,12,8,13,13,13,7,10,14,10,9,13,16,15,14,13,13,8,1,1,10,14,1,14,1,S ,600,1,1,20,1,14,1,1,1,1,1,1,10,1,1,1,262144,0,0,0,0,0,0,0,0,0,0,0,0,0,0,0,0,0,0,1,0,0,0,0,0,0,0,0,0,0,0,0,0,0,0,0,0,0,0,0,0,0,0,0,0,0,0,0,0,Yacine Brahimi,£2.70m ,30,175,Forward - Left Winger,right,Al-Rayyan SC,26,6,3,1509,28,3,2,1130,28,0,2,1916,36,3,3,2858,42,13,10,2835,44,9,10,3245,31,7,4,1927,49,12,10,3914,49,13,9,3429,Ligue 1,23,15,5,2040,3,1,1,270
13/6/2011,Tobias Rühle,92012980,771,2/7/1991,20,0,0,0,0,2250,4350,4350,105,87,207259,179,79,S ,3,3,2,2,1,2,2,1,1,1,3,8,8,9,14,9,9,11,9,6,7,9,8,9,10,15,8,15,10,9,7,9,10,5,5,13,6,9,13,12,12,12,10,7,12,10,20,14,16,7,8,8,8,11,10,10,8,10,9,10,7,7,1,1,11,14,14,1,1,S ,600,1,1,20,1,1,14,1,1,1,1,1,1,11,1,1,66048,0,0,0,0,0,0,0,0,0,1,0,0,0,0,0,0,1,0,0,0,0,0,0,0,0,0,0,0,0,0,0,0,0,0,0,0,0,0,0,0,0,0,0,0,0,0,0,0,,,,,,,,,,,,,,,,,,,,,,,,,,,,,,,,,,,,,,,,,,,,,,,,,,,,
13/6/2011,Thomas Piaulet-Siena,85072442,769,6/3/1991,20,0,0,0,0,1000,2000,2000,100,81,129895,175,69,S R,1,2,3,2,2,3,1,1,1,2,2,12,10,9,9,11,12,4,10,5,3,7,12,2,11,6,8,9,12,10,8,11,13,12,6,10,3,8,11,12,12,12,7,8,13,13,20,11,9,13,6,14,6,10,11,13,9,6,7,13,7,7,1,1,15,15,15,10,12,S R,602,1,1,20,12,10,15,1,1,1,1,1,10,15,1,1,0,0,0,0,0,0,0,0,0,0,0,0,0,0,0,0,0,0,0,0,0,0,0,0,0,0,0,0,0,0,0,0,0,0,0,0,0,0,0,0,0,0,0,0,0,0,0,0,0,,,,,,,,,,,,,,,,,,,,,,,,,,,,,,,,,,,,,,,,,,,,,,,,,,,,
13/6/2011,Sergi Mut,67087471,796,1/21/1991,20,0,0,0,0,1750,3750,3750,113,73,1685601,180,77,S ,1,2,2,2,2,2,1,2,1,3,2,8,5,8,12,10,4,12,6,1,5,12,8,8,7,9,5,5,10,9,8,7,10,14,7,11,7,10,11,13,10,8,7,8,13,13,20,7,3,9,6,10,4,10,11,11,6,12,16,14,10,14,1,1,1,1,1,1,1,S ,600,1,1,20,1,1,1,1,1,1,1,1,1,1,1,1,16,0,0,0,0,1,0,0,0,0,0,0,0,0,0,0,0,0,0,0,0,0,0,0,0,0,0,0,0,0,0,0,0,0,0,0,0,0,0,0,0,0,0,0,0,0,0,0,0,,,,,,,,,,,,,,,,,,,,,,,,,,,,,,,,,,,,,,,,,,,,,,,,,,,,
13/6/2011,Sean Scannell,5007475,789,9/17/1990,20,0,0,9,0,2700,5500,5500,140,110,5133800,175,73,AM/S R,1,1,2,1,2,2,1,5,3,1,2,6,9,13,12,11,5,11,6,5,5,9,9,7,10,9,8,9,10,8,8,9,14,13,5,12,8,13,14,16,13,10,8,7,14,17,20,11,7,14,4,12,6,14,7,12,12,9,16,13,12,3,1,1,1,18,18,1,1,AM/S R,622,1,1,20,1,1,18,1,1,1,1,1,1,1,1,1,1.75923E+13,0,0,0,0,1,0,0,0,0,0,0,0,0,0,0,0,0,0,0,0,0,0,0,0,0,0,0,1,0,0,0,0,0,0,0,0,0,0,0,0,0,0,0,0,1,0,0,0,,,,,,,,,,,,,,,,,,,,,,,,,,,,,,,,,,,,,,,,,,,,,,,,,,,,
13/6/2011,Scipon Bektasi,91003261,752,9/14/1990,20,0,0,0,0,2750,4184,4250,125,93,776688,177,0,S ,1,3,1,2,1,3,2,1,2,3,2,6,8,10,14,11,7,7,10,8,7,11,5,6,11,8,8,10,6,9,11,11,10,8,7,12,13,10,12,13,12,12,8,10,12,13,20,12,11,9,7,10,5,10,12,7,11,5,7,12,12,12,1,1,10,14,1,14,1,S ,600,1,1,20,1,14,1,1,1,1,1,1,10,1,1,1,0,0,0,0,0,0,0,0,0,0,0,0,0,0,0,0,0,0,0,0,0,0,0,0,0,0,0,0,0,0,0,0,0,0,0,0,0,0,0,0,0,0,0,0,0,0,0,0,0,,,,,,,,,,,,,,,,,,,,,,,,,,,,,,,,,,,,,,,,,,,,,,,,,,,,
13/6/2011,Ryan Mason,28010315,765,6/13/1991,20,0,0,0,0,1750,4800,4800,148,96,1675814,176,64,AM/S C,1,1,1,3,2,1,1,1,3,1,3,8,10,12,12,11,9,6,10,4,3,12,12,6,11,11,8,9,11,5,10,8,10,12,7,11,12,11,11,13,13,10,9,10,14,13,20,14,8,14,7,14,10,10,10,5,9,11,14,12,12,5,1,1,15,20,10,1,20,AM/S C,511,1,1,17,20,1,10,1,1,1,1,15,1,10,1,1,0,0,0,0,0,0,0,0,0,0,0,0,0,0,0,0,0,0,0,0,0,0,0,0,0,0,0,0,0,0,0,0,0,0,0,0,0,0,0,0,0,0,0,0,0,0,0,0,0,Ryan Donaldson,- ,29,193,Forward - Right Winger,right,Hartlepool United,25,3,3,1875,12,3,4,972,39,8,6,3320,33,5,11,2803,44,7,10,3641,33,2,2,1854,33,2,2,1683,20,2,1,1201,45,1,3,4020,Premier League,38,3,0,3314,4,0,0,345
13/6/2011,Rubén Rochina,67038648,796,3/23/1991,20,0,0,0,0,5500,5750,6500,150,121,1457419,179,77,AM/S LC,3,1,1,3,1,3,2,2,2,2,1,10,10,16,14,14,10,8,14,2,2,12,10,5,14,8,12,10,14,10,13,8,12,15,8,14,10,11,10,14,13,13,9,20,16,12,6,14,12,8,6,15,7,7,10,16,12,14,15,12,14,14,1,1,12,16,12,15,16,AM/S LC,624,1,1,20,16,15,12,1,1,1,1,10,12,12,1,1,7.04031E+13,0,0,0,0,0,0,0,0,1,0,0,0,0,0,0,0,0,0,0,1,0,0,0,1,0,0,0,0,0,0,0,0,0,0,0,1,0,0,0,0,0,0,0,0,0,0,1,0,Rubén Rochina,£900Th. ,29,182,Midfielder - Attacking Midfield,left,Levante UD,22,9,2,851,23,6,2,1141,37,6,4,1871,22,3,1,1265,19,2,2,1134,38,6,6,2752,26,2,5,1442,10,1,0,374,29,4,7,1898,Premier League,29,5,5,1964,1,0,0,63
13/6/2011,Ronan Murray,28017150,789,9/12/1990,20,0,0,1,0,1850,4800,4100,103,91,758597,173,72,S R,3,3,3,2,1,3,2,1,3,3,3,1,9,9,11,8,7,6,3,1,1,7,7,5,9,17,9,6,9,7,8,8,10,15,11,11,7,11,12,14,9,7,6,10,14,14,20,7,7,10,13,10,13,8,11,11,8,8,7,12,10,7,1,1,15,15,15,1,1,S R,602,1,1,20,1,1,15,1,1,1,1,1,1,15,1,1,0,0,0,0,0,0,0,0,0,0,0,0,0,0,0,0,0,0,0,0,0,0,0,0,0,0,0,0,0,0,0,0,0,0,0,0,0,0,0,0,0,0,0,0,0,0,0,0,0,,,,,,,,,,,,,,,,,,,,,,,,,,,,,,,,,,,,,,,,,,,,,,,,,,,,
13/6/2011,Rodrigo,67086280,796,3/6/1991,20,0,0,1,0,5000,6000,6000,141,125,12000000,181,74,AM/S L,2,2,1,2,2,2,2,4,2,2,2,6,10,12,11,12,10,9,11,5,4,10,10,4,13,9,11,7,13,9,11,9,13,14,5,13,7,9,9,16,12,14,8,20,16,16,6,14,7,11,6,5,7,12,12,13,12,12,13,14,14,5,1,1,9,20,13,20,10,AM/S L,513,1,1,20,10,20,13,1,1,1,1,1,9,1,1,1,38654706305,1,0,0,0,0,0,0,1,0,1,0,0,0,0,0,0,0,0,0,0,0,0,0,0,0,0,0,0,0,0,0,0,1,0,0,1,0,0,0,0,0,0,0,0,0,0,0,0,Rodrigo,£6.30m ,29,182,Forward - Centre-Forward,left,Leeds United,24,3,1,928,38,16,4,1874,39,11,5,2140,42,18,8,2666,32,4,5,2161,38,7,3,2175,21,7,5,1588,44,19,7,2994,51,15,10,3775,Liga NOS,34,7,11,2506,7,1,0,410
13/6/2011,Richard Sukuta-Pasu,35015538,771,6/24/1990,20,0,0,10,1,3000,5550,5550,144,112,3489177,190,89,S ,1,2,2,2,3,3,2,1,1,3,1,5,7,10,12,11,7,9,8,6,4,8,11,9,12,12,10,11,13,9,7,10,12,14,6,11,5,11,11,15,13,14,13,7,17,16,20,12,15,13,6,17,7,4,8,14,10,11,12,10,9,7,1,1,1,13,13,13,5,S ,600,1,1,20,5,13,13,1,1,1,1,1,1,1,1,1,0,0,0,0,0,0,0,0,0,0,0,0,0,0,0,0,0,0,0,0,0,0,0,0,0,0,0,0,0,0,0,0,0,0,0,0,0,0,0,0,0,0,0,0,0,0,0,0,0,Richard Sukuta-Pasu,£720Th. ,30,190,Forward - Centre-Forward,right,Seoul E-Land,12,2,2,322,28,2,3,1361,33,12,3,2685,34,6,1,2666,29,3,1,1842,32,13,3,2755,28,6,3,1389,29,7,2,1926,30,8,0,1665,Bundesliga,22,5,1,1501,nan,nan,nan,nan
13/6/2011,Peniel Mlapa,91012819,771,2/20/1991,20,0,0,7,0,4550,6350,6350,157,123,7628562,193,85,AM/S R,3,3,3,2,3,1,2,4,1,3,1,6,12,13,9,14,8,7,10,6,5,11,10,9,13,16,8,15,10,9,13,9,10,11,5,8,7,16,14,14,10,13,14,10,13,17,20,10,16,10,17,10,9,12,13,5,18,6,1,5,16,14,1,1,1,18,18,12,14,AM/S R,622,1,1,20,14,12,18,1,1,1,1,1,1,1,1,1,1.77298E+13,0,0,0,0,0,0,0,0,0,0,0,0,0,0,0,0,0,0,0,0,0,0,0,0,0,0,0,1,0,0,0,0,0,0,0,0,0,1,0,0,0,0,0,0,1,0,0,0,Peniel Mlapa,£2.70m ,29,193,Forward - Centre-Forward,right,Al Ittihad Kalba Sports Club,34,5,4,1820,31,1,1,1456,30,3,3,977,7,2,0,226,25,3,2,953,31,5,1,1176,33,8,3,2445,24,4,0,1086,32,15,3,2589,Bundesliga,18,11,1,1620,1,0,0,90
13/6/2011,Pedro Henrique,19073583,1651,3/28/1991,20,0,0,0,0,250,3600,3000,85,72,26235,188,78,S ,3,1,1,1,2,2,3,1,2,3,3,5,7,8,12,12,8,12,7,8,1,11,6,4,12,8,8,8,10,7,6,7,10,11,3,12,5,6,9,12,12,12,8,6,17,12,20,4,7,10,6,10,11,8,11,14,6,8,10,7,10,7,1,1,1,1,1,1,1,S ,600,1,1,20,1,1,1,1,1,1,1,1,1,1,1,1,0,0,0,0,0,0,0,0,0,0,0,0,0,0,0,0,0,0,0,0,0,0,0,0,0,0,0,0,0,0,0,0,0,0,0,0,0,0,0,0,0,0,0,0,0,0,0,0,0,Edson Henrique,£450Th. ,33,183,Defender - Centre-Back,left,América Futebol Clube (RN),0,0,0,0,33,0,1,2835,nan,nan,nan,nan,35,2,0,2975,26,0,0,2000,14,0,0,1089,28,0,0,2498,25,0,0,2214,14,0,0,1151,Liga NOS,2,0,0,180,nan,nan,nan,nan
13/6/2011,Odhise Rroshi,11007620,752,5/22/1991,20,0,0,10,7,1500,5000,5550,145,111,3038628,187,78,AM RC,1,3,3,2,1,1,2,6,3,1,3,6,9,10,10,10,7,12,10,10,5,9,11,6,10,11,10,7,9,8,10,9,12,10,11,11,7,10,10,16,14,10,13,7,9,17,20,9,10,10,10,10,10,11,11,11,13,13,10,10,10,9,3,8,15,20,20,10,15,AM RC,503,1,1,15,15,10,20,1,3,3,1,8,7,15,3,8,0,0,0,0,0,0,0,0,0,0,0,0,0,0,0,0,0,0,0,0,0,0,0,0,0,0,0,0,0,0,0,0,0,0,0,0,0,0,0,0,0,0,0,0,0,0,0,0,0,Odise Roshi,£900Th. ,29,187,Forward - Right Winger,right,Akhmat Grozny,22,5,0,1486,20,1,1,555,32,2,1,891,25,1,3,874,22,3,2,1422,25,2,1,636,21,1,7,1167,21,1,3,1265,13,0,0,594,Bundesliga,28,8,1,1983,6,2,0,250
13/6/2011,Nicolas De Préville,85018475,769,1/8/1991,20,0,0,0,0,850,2700,2700,119,82,255563,178,77,S ,3,1,3,1,2,2,2,1,1,1,1,6,8,11,7,11,8,10,13,5,4,6,11,2,13,11,11,11,10,10,6,7,10,12,5,10,4,8,11,15,9,13,9,5,12,12,20,6,13,12,13,13,7,8,14,16,5,9,5,9,9,7,1,1,1,12,12,12,1,S ,600,1,1,20,1,12,12,1,1,1,1,1,1,1,1,1,0,0,0,0,0,0,0,0,0,0,0,0,0,0,0,0,0,0,0,0,0,0,0,0,0,0,0,0,0,0,0,0,0,0,0,0,0,0,0,0,0,0,0,0,0,0,0,0,0,,,,,,,,,,,,,,,,,,,,,,,,,,,,,,,,,,,,,,,,,,,,,,,,,,,,
13/6/2011,Nicholas Bignall,28004398,765,7/11/1990,20,0,0,0,0,1750,4450,4450,104,90,779549,177,82,S ,1,1,3,2,1,2,1,3,1,1,2,3,8,10,9,9,3,7,9,2,5,6,6,5,9,10,7,10,6,4,7,4,10,8,8,9,3,4,7,15,14,14,10,20,16,15,5,11,15,10,3,9,10,12,4,13,4,9,13,12,14,5,1,1,1,14,8,14,1,S ,600,1,1,20,1,14,8,1,1,1,1,1,1,1,1,1,134225920,0,0,0,0,0,0,0,0,0,0,0,0,0,1,0,0,0,0,0,0,0,0,0,0,0,0,0,1,0,0,0,0,0,0,0,0,0,0,0,0,0,0,0,0,0,0,0,0,,,,,,,,,,,,,,,,,,,,,,,,,,,,,,,,,,,,,,,,,,,,,,,,,,,,
13/6/2011,Nathan Delfouneso,28010535,765,2/2/1991,20,0,0,8,2,3500,6000,6000,152,118,6174013,186,78,S ,1,1,1,2,1,3,3,1,2,3,2,3,9,13,13,14,2,7,9,5,6,7,10,5,14,9,10,11,12,11,8,7,7,14,7,13,6,8,12,18,13,14,12,8,14,15,20,12,8,10,9,10,4,7,13,13,14,10,6,11,8,6,1,1,1,1,1,1,1,S ,600,1,1,20,1,1,1,1,1,1,1,1,1,1,1,1,34360262656,0,0,0,0,0,0,0,0,0,0,0,0,0,0,0,0,0,0,0,1,0,0,0,0,0,0,0,0,0,0,0,0,0,0,0,1,0,0,0,0,0,0,0,0,0,0,0,0,Nathan Delfouneso,£2.25m ,29,186,Forward - Centre-Forward,right,Bolton Wanderers,35,10,4,1949,16,2,1,576,43,7,4,2447,25,3,0,1255,40,3,0,2545,21,1,0,1160,44,8,2,3064,46,9,4,3170,45,7,3,3206,Premier League,35,7,3,2358,9,2,0,752
13/6/2011,Mehmet-Ali Fidan,92025400,799,7/22/1990,20,0,0,0,0,50,3000,3000,85,60,16706,182,0,S ,2,3,2,2,3,3,1,1,2,1,1,8,6,11,11,5,7,12,7,2,1,9,5,4,10,11,7,4,10,2,6,4,6,14,9,12,5,9,8,12,12,12,9,9,15,11,20,6,4,8,12,10,11,7,7,8,10,12,11,9,5,13,1,1,1,1,1,1,1,S ,600,1,1,20,1,1,1,1,1,1,1,1,1,1,1,1,0,0,0,0,0,0,0,0,0,0,0,0,0,0,0,0,0,0,0,0,0,0,0,0,0,0,0,0,0,0,0,0,0,0,0,0,0,0,0,0,0,0,0,0,0,0,0,0,0,,,,,,,,,,,,,,,,,,,,,,,,,,,,,,,,,,,,,,,,,,,,,,,,,,,,
13/6/2011,Maximilian Beister,91018468,771,9/6/1990,20,0,0,0,0,4850,6200,6200,157,124,4047117,180,78,M/AM/S RL,1,2,1,3,2,3,1,6,2,3,1,5,11,13,13,12,6,5,11,4,4,8,6,5,12,13,10,12,12,11,8,12,13,14,5,13,5,11,11,16,15,12,10,20,12,13,12,14,12,16,3,10,4,16,7,13,5,5,14,6,13,13,1,1,18,20,20,19,12,M/AM/S RL,535,1,1,18,12,19,20,1,1,1,1,1,17,18,1,1,0,0,0,0,0,0,0,0,0,0,0,0,0,0,0,0,0,0,0,0,0,0,0,0,0,0,0,0,0,0,0,0,0,0,0,0,0,0,0,0,0,0,0,0,0,0,0,0,0,,,,,,,,,,,,,,,,,,,,,,,,,,,,,,,,,,,,,,,,,,,,,,,,,,,,
13/6/2011,Maurice Exslager,35025445,771,2/12/1991,20,0,0,0,0,2250,5250,5250,128,105,1129545,173,67,S R,1,3,2,3,3,2,3,4,2,2,3,8,10,12,11,12,9,7,8,5,5,9,12,5,12,12,14,13,8,8,12,10,10,12,6,14,7,13,14,14,15,10,6,10,12,12,20,13,7,9,5,10,8,12,13,3,15,15,15,14,8,8,1,1,1,15,15,14,13,S R,602,1,1,20,13,14,15,1,1,1,1,1,1,1,1,1,0,0,0,0,0,0,0,0,0,0,0,0,0,0,0,0,0,0,0,0,0,0,0,0,0,0,0,0,0,0,0,0,0,0,0,0,0,0,0,0,0,0,0,0,0,0,0,0,0,,,,,,,,,,,,,,,,,,,,,,,,,,,,,,,,,,,,,,,,,,,,,,,,,,,,
13/6/2011,Mattia Destro,43008779,776,3/20/1991,20,0,0,8,2,4500,5750,5750,162,117,2534380,185,75,S ,1,1,1,1,1,1,1,1,1,1,1,3,9,13,14,13,3,13,10,3,3,13,14,5,14,11,14,8,13,10,14,13,13,14,10,14,4,11,10,12,12,13,13,8,14,12,20,13,12,15,5,15,13,11,10,12,16,14,16,14,12,5,1,1,1,9,1,9,1,S ,600,1,1,20,1,9,1,1,1,1,1,1,1,1,1,1,4096,0,0,0,0,0,0,0,0,0,0,0,0,1,0,0,0,0,0,0,0,0,0,0,0,0,0,0,0,0,0,0,0,0,0,0,0,0,0,0,0,0,0,0,0,0,0,0,0,Mattia Destro,£9.00m ,29,182,Forward - Centre-Forward,right,Genoa CFC,18,3,1,777,32,13,4,2304,26,11,3,1537,24,15,2,1515,34,8,0,1892,27,8,2,2135,33,11,2,2728,27,6,4,1662,18,4,1,563,Serie A,16,0,0,471,2,1,0,180
13/6/2011,Mathew Leckie,29065287,1435,2/4/1991,20,0,0,13,3,2500,5500,6000,142,116,3792602,180,78,M/AM/S R,1,2,2,1,1,1,2,1,2,2,1,7,9,14,11,7,3,9,8,10,7,10,10,8,10,9,12,13,11,10,10,13,13,10,4,14,8,11,14,17,11,14,10,6,15,15,20,12,11,9,5,10,7,12,12,15,12,11,14,13,11,3,1,1,18,20,20,1,1,M/AM/S R,532,1,1,16,1,1,20,1,1,1,1,1,1,18,1,1,0,0,0,0,0,0,0,0,0,0,0,0,0,0,0,0,0,0,0,0,0,0,0,0,0,0,0,0,0,0,0,0,0,0,0,0,0,0,0,0,0,0,0,0,0,0,0,0,0,Mathew Leckie,£630Th. ,29,181,Forward - Right Winger,right,Hertha BSC,15,5,0,995,21,3,0,985,35,9,6,2212,33,12,9,2733,32,7,7,2583,32,3,0,2476,32,0,3,2327,29,6,3,2026,19,2,1,938,Bundesliga,10,0,0,383,3,0,2,128
13/6/2011,Mario Balotelli,43001238,776,8/12/1990,20,2,0,14,6,7000,8250,7250,178,150,56518268,189,88,AM/S RL,1,1,1,1,1,1,1,1,1,1,1,14,13,15,14,12,14,11,15,6,7,14,18,7,16,12,10,12,16,7,14,10,10,16,8,15,6,5,4,15,15,11,13,12,14,16,20,13,15,9,17,14,8,15,5,14,3,8,3,3,3,19,1,1,8,16,16,15,11,AM/S RL,625,1,1,20,11,15,16,1,1,1,1,1,8,8,1,1,34359935232,0,0,0,0,0,0,0,0,1,0,0,0,0,0,0,0,1,1,0,0,0,0,0,0,0,0,0,0,0,0,0,0,0,0,0,1,0,0,0,0,0,0,0,0,0,0,0,0,Mario Balotelli,£28.80m ,30,189,Forward - Centre-Forward,right,Without Club,28,10,2,1712,32,17,2,1881,33,15,3,1964,41,18,8,3161,28,4,0,1510,23,3,1,994,28,17,0,2106,38,26,2,3043,25,8,1,1699,Premier League,19,5,0,1409,nan,nan,nan,nan
13/6/2011,Marco Terrazzino,35025621,771,4/15/1991,20,0,0,0,0,2400,5200,5400,129,104,1878509,176,70,AM/S R,2,1,2,1,3,1,2,1,1,2,3,8,10,14,12,13,10,6,11,4,3,13,12,4,14,9,9,12,12,8,13,10,14,13,10,11,6,10,10,13,13,9,7,8,11,13,20,10,7,11,5,9,5,10,12,12,9,11,13,14,12,5,1,1,12,20,20,14,10,AM/S R,512,1,1,18,10,14,20,1,1,1,1,1,10,12,1,1,2.3222E+15,0,0,0,0,0,0,0,0,0,0,0,0,0,0,0,0,0,0,0,0,0,0,0,0,0,0,0,0,0,0,0,0,0,0,0,1,0,0,0,0,0,0,0,0,0,0,1,0,,,,,,,,,,,,,,,,,,,,,,,,,,,,,,,,,,,,,,,,,,,,,,,,,,,,
13/6/2011,Marco Stiepermann,35011199,771,2/19/1991,20,0,0,0,0,4200,5400,6000,134,108,3237030,190,85,M/AM/S RLC,3,3,1,3,3,2,3,1,3,1,3,8,12,13,11,12,8,7,9,6,5,11,8,6,13,8,9,9,8,11,11,11,9,10,9,14,5,13,14,11,9,12,13,20,13,13,9,14,11,9,7,10,7,13,10,8,9,12,18,16,13,17,1,1,18,19,18,19,15,M/AM/S RLC,636,1,1,20,15,19,18,1,1,1,1,10,18,17,1,1,0,0,0,0,0,0,0,0,0,0,0,0,0,0,0,0,0,0,0,0,0,0,0,0,0,0,0,0,0,0,0,0,0,0,0,0,0,0,0,0,0,0,0,0,0,0,0,0,0,,,,,,,,,,,,,,,,,,,,,,,,,,,,,,,,,,,,,,,,,,,,,,,,,,,,
13/6/2011,Macauley Chrisantus,29022511,38,8/20/1990,20,0,0,0,0,4200,5500,5350,135,115,2680711,183,76,S ,2,2,2,3,2,1,1,4,1,1,1,7,7,13,13,14,10,12,12,2,3,11,14,3,13,5,12,10,12,7,13,10,13,10,8,14,8,11,13,12,12,12,12,9,13,12,20,12,14,9,5,9,5,3,10,9,8,11,9,12,10,12,1,1,1,1,1,1,1,S ,600,1,1,20,1,1,1,1,1,1,1,1,1,1,1,1,4.39805E+12,0,0,1,0,0,0,0,0,0,0,0,0,0,0,0,0,0,0,0,0,0,0,0,0,0,0,0,0,0,0,0,0,0,0,0,0,0,0,0,0,0,0,1,0,0,0,0,0,,,,,,,,,,,,,,,,,,,,,,,,,,,,,,,,,,,,,,,,,,,,,,,,,,,,
13/6/2011,Luis Fernando Muriel,76015142,1653,4/18/1991,20,0,0,2,1,2750,5309,4250,155,118,2826649,178,75,S ,2,2,3,1,1,1,1,2,3,2,1,10,10,14,15,11,8,12,9,9,5,11,10,5,12,8,11,9,12,12,11,12,13,14,13,14,12,11,12,13,11,13,13,12,15,13,20,12,10,7,12,9,12,10,10,7,10,5,11,11,6,12,1,1,1,1,1,1,1,S ,600,1,1,20,1,1,1,1,1,1,1,1,1,1,1,1,0,0,0,0,0,0,0,0,0,0,0,0,0,0,0,0,0,0,0,0,0,0,0,0,0,0,0,0,0,0,0,0,0,0,0,0,0,0,0,0,0,0,0,0,0,0,0,0,0,,,,,,,,,,,,,,,,,,,,,,,,,,,,,,,,,,,,,,,,,,,,,,,,,,,,
13/6/2011,Lorenzo Melgarejo,79010425,1655,8/10/1990,20,0,0,1,0,950,3250,3250,137,110,1399998,171,67,S ,3,1,1,2,3,1,3,1,1,1,1,10,12,16,12,12,10,8,11,7,8,11,10,7,13,9,9,7,7,11,11,13,10,15,5,14,8,8,12,16,14,9,7,20,11,13,7,10,8,9,8,12,12,10,10,13,7,8,13,13,13,5,1,1,7,13,10,13,7,S ,600,1,1,20,7,13,10,1,1,1,1,1,7,1,1,1,0,0,0,0,0,0,0,0,0,0,0,0,0,0,0,0,0,0,0,0,0,0,0,0,0,0,0,0,0,0,0,0,0,0,0,0,0,0,0,0,0,0,0,0,0,0,0,0,0,Lorenzo Melgarejo,£1.08m ,30,177,Forward - Left Winger,left,Racing Club,nan,nan,nan,nan,30,11,3,2371,40,2,5,3588,25,10,2,1782,15,1,0,990,28,11,3,1794,22,2,0,804,32,7,5,1495,33,5,5,2379,Liga NOS,20,1,0,857,nan,nan,nan,nan
13/6/2011,Lee Yong-Jae,66002199,135,6/8/1991,20,0,0,0,0,2400,5450,3600,127,109,7738520,181,70,S L,2,2,2,3,1,2,2,1,1,3,1,6,8,12,11,12,6,9,8,5,3,8,10,2,13,11,11,13,14,11,8,7,16,13,5,12,5,8,13,17,13,13,10,6,13,14,20,12,9,10,8,14,6,5,12,13,11,15,14,14,14,6,1,1,12,15,10,15,1,S L,603,1,1,20,1,15,10,1,1,1,1,1,12,10,1,1,2.2518E+15,0,0,0,0,1,0,0,0,0,0,0,0,0,0,0,0,0,0,0,0,0,0,0,0,0,0,0,0,0,0,0,0,0,0,0,0,0,0,0,0,0,0,0,0,0,0,0,0,,,,,,,,,,,,,,,,,,,,,,,,,,,,,,,,,,,,,,,,,,,,,,,,,,,,
13/6/2011,Lago Junior,67092251,24,12/31/1990,20,0,0,1,0,3000,5000,5250,130,108,1290774,182,74,S ,1,2,1,2,1,3,1,6,1,1,2,7,10,12,11,9,7,9,11,7,5,11,10,7,12,8,14,8,6,9,9,7,10,8,7,14,6,14,13,14,16,13,11,10,14,15,20,13,11,12,6,11,3,16,12,12,14,11,10,16,3,12,1,1,1,10,1,1,10,S ,600,1,1,20,10,1,1,1,1,1,1,1,1,1,1,1,0,0,0,0,0,0,0,0,0,0,0,0,0,0,0,0,0,0,0,0,0,0,0,0,0,0,0,0,0,0,0,0,0,0,0,0,0,0,0,0,0,0,0,0,0,0,0,0,0,,,,,,,,,,,,,,,,,,,,,,,,,,,,,,,,,,,,,,,,,,,,,,,,,,,,
13/6/2011,Knowledge Musona,65008768,55,6/22/1990,20,9,4,0,0,4100,6710,6100,155,122,2958833,182,72,S ,2,1,2,2,2,1,3,1,3,3,1,9,11,13,15,11,8,12,9,5,8,11,12,6,12,9,11,13,10,12,11,8,14,11,7,12,13,10,13,16,11,13,11,8,12,15,20,11,12,11,8,14,5,10,12,16,11,11,10,9,11,6,1,1,1,1,1,1,1,S ,600,1,1,20,1,1,1,1,1,1,1,1,1,1,1,1,0,0,0,0,0,0,0,0,0,0,0,0,0,0,0,0,0,0,0,0,0,0,0,0,0,0,0,0,0,0,0,0,0,0,0,0,0,0,0,0,0,0,0,0,0,0,0,0,0,Knowledge Musona,£1.35m ,30,177,Forward - Left Winger,both,KAS Eupen,35,19,8,2934,17,1,2,457,17,1,1,964,29,15,2,2109,15,5,1,1082,36,13,6,2583,33,13,5,2677,28,10,6,2283,16,2,2,988,Bundesliga,8,3,0,586,9,2,1,701
13/6/2011,Kieron Cadogan,28019850,765,8/16/1990,20,0,0,0,0,1750,4000,4000,113,91,689836,193,80,M/AM/S RL,1,3,1,2,3,1,2,3,3,2,2,1,7,12,9,12,3,5,8,3,2,7,10,5,9,11,10,12,8,5,7,7,16,12,3,8,8,11,11,12,9,7,10,8,10,14,20,10,8,9,11,4,3,10,15,6,15,13,15,9,8,11,1,1,20,18,20,18,1,M/AM/S RL,425,1,1,16,1,16,18,1,1,1,1,1,18,20,1,1,1.81421E+13,0,0,0,0,0,0,0,0,0,0,0,0,0,0,0,0,0,0,0,0,0,0,0,0,0,0,0,1,0,0,0,0,0,0,0,0,0,0,0,1,0,0,0,0,1,0,0,0,,,,,,,,,,,,,,,,,,,,,,,,,,,,,,,,,,,,,,,,,,,,,,,,,,,,
13/6/2011,Kevin Stephan,91018516,771,7/23/1990,20,0,0,0,0,2750,4750,4750,129,95,426801,184,78,AM/S C,2,1,1,3,3,2,2,5,2,2,1,6,7,9,12,11,7,9,9,5,2,9,7,5,12,8,12,10,12,10,12,9,10,8,7,12,5,9,9,12,11,8,10,16,8,12,20,8,10,8,9,6,8,8,11,12,10,13,14,13,12,9,1,1,1,17,14,13,17,AM/S C,621,1,1,20,17,13,14,1,1,1,1,1,1,1,1,1,1032,0,0,0,1,0,0,0,0,0,0,1,0,0,0,0,0,0,0,0,0,0,0,0,0,0,0,0,0,0,0,0,0,0,0,0,0,0,0,0,0,0,0,0,0,0,0,0,0,Kevin Stewart, ,27,182,Midfielder - Defensive Midfield,both,Without Club,nan,nan,nan,nan,0,0,0,0,19,1,0,1199,16,0,0,1252,25,4,1,1960,20,0,1,1526,19,1,1,1197,20,0,0,1207,30,0,1,1866,Premier League,28,2,1,2002,nan,nan,nan,nan
13/6/2011,Kevin Lehanka,92035379,771,9/5/1990,20,0,0,0,0,1250,4250,4250,119,85,406880,182,76,S ,1,1,2,2,2,2,2,1,2,2,3,8,6,13,13,12,9,12,5,1,2,11,9,5,11,8,10,10,8,6,10,8,6,9,13,13,8,7,9,13,13,13,10,4,14,13,20,5,9,10,5,10,6,10,11,5,14,8,18,5,16,9,1,1,1,1,1,1,1,S ,600,1,1,20,1,1,1,1,1,1,1,1,1,1,1,1,0,0,0,0,0,0,0,0,0,0,0,0,0,0,0,0,0,0,0,0,0,0,0,0,0,0,0,0,0,0,0,0,0,0,0,0,0,0,0,0,0,0,0,0,0,0,0,0,0,,,,,,,,,,,,,,,,,,,,,,,,,,,,,,,,,,,,,,,,,,,,,,,,,,,,
13/6/2011,Joselu,67103578,796,3/3/1991,20,0,0,0,0,1250,3500,3500,131,73,342883,177,70,S ,3,1,1,2,1,1,1,1,1,1,3,9,7,13,12,10,9,11,12,7,4,9,1,3,10,12,11,3,6,7,10,11,9,8,1,13,8,8,11,13,10,13,9,9,14,12,20,6,4,9,8,8,11,10,7,14,12,11,10,8,9,12,1,1,1,1,1,1,1,S ,600,1,1,20,1,1,1,1,1,1,1,1,1,1,1,1,0,0,0,0,0,0,0,0,0,0,0,0,0,0,0,0,0,0,0,0,0,0,0,0,0,0,0,0,0,0,0,0,0,0,0,0,0,0,0,0,0,0,0,0,0,0,0,0,0,Joselu,- ,30,192,Forward - Centre-Forward,right,Deportivo Alavés,37,15,4,1966,38,27,4,2834,25,5,2,1597,33,14,3,2116,32,10,4,2654,27,4,4,1455,24,6,1,1184,32,4,1,1695,20,3,1,968,LaLiga,37,11,3,2876,6,1,0,521
13/6/2011,Joel Acosta,14009499,1649,1/16/1991,20,0,0,0,0,2000,3000,3000,148,90,620669,177,76,AM/S RC,2,3,3,1,2,3,1,5,3,2,3,9,9,14,11,8,8,7,10,4,4,10,10,5,12,14,8,10,10,9,10,10,10,14,8,10,6,9,8,15,11,9,8,6,11,13,20,12,11,12,8,10,10,14,16,16,9,11,5,5,11,18,1,1,10,20,15,1,20,AM/S RC,513,1,1,17,20,1,15,1,1,1,1,9,1,10,1,1,0,0,0,0,0,0,0,0,0,0,0,0,0,0,0,0,0,0,0,0,0,0,0,0,0,0,0,0,0,0,0,0,0,0,0,0,0,0,0,0,0,0,0,0,0,0,0,0,0,Joel Acosta,£540Th. ,29,176,Forward - Right Winger,right,Liverpool FC Montevideo,1,0,0,2,15,3,0,1308,6,0,0,486,8,0,0,430,27,1,1,1563,11,1,1,321,29,3,2,1946,15,5,3,1162,22,0,0,1153,Serie A,2,0,0,64,nan,nan,nan,nan
13/6/2011,Joe Mason,28017168,789,5/13/1991,20,0,0,2,0,2250,5000,5250,135,100,1322500,178,73,S RLC,2,3,3,1,2,1,3,7,2,2,2,7,7,12,12,12,5,12,6,5,5,10,10,5,12,8,14,7,13,11,12,12,12,12,7,13,7,12,11,9,12,10,11,13,14,10,20,13,9,8,6,8,6,14,18,10,17,9,16,17,18,1,1,1,14,15,15,15,15,S RLC,606,1,1,20,15,15,15,1,1,1,1,10,14,14,1,1,1.75922E+13,0,0,0,0,0,0,0,0,0,0,1,0,0,1,0,0,0,0,0,1,0,0,0,0,0,0,0,0,0,0,0,0,0,0,0,0,0,0,0,0,0,0,0,0,1,0,0,0,,,,,,,,,,,,,,,,,,,,,,,,,,,,,,,,,,,,,,,,,,,,,,,,,,,,
13/6/2011,Ji Dong-Won,28016965,135,5/28/1991,20,0,0,0,0,2750,6500,6250,141,125,11960718,187,78,S ,2,2,2,1,3,1,2,1,2,1,2,8,11,13,14,15,14,15,12,2,6,13,14,7,13,15,16,13,11,14,14,14,12,17,9,15,6,14,10,12,12,15,14,9,13,12,20,11,12,17,8,16,8,11,7,14,13,9,8,11,7,9,1,1,1,12,1,1,12,S ,600,1,1,20,12,1,1,1,1,1,1,1,1,1,1,1,0,0,0,0,0,0,0,0,0,0,0,0,0,0,0,0,0,0,0,0,0,0,0,0,0,0,0,0,0,0,0,0,0,0,0,0,0,0,0,0,0,0,0,0,0,0,0,0,0,,,,,,,,,,,,,,,,,,,,,,,,,,,,,,,,,,,,,,,,,,,,,,,,,,,,
13/6/2011,Jerry Sitoe,13104505,35,11/23/1990,20,1,0,0,0,1000,4500,4500,139,100,8307190,182,75,S ,1,2,3,3,2,1,3,1,3,3,1,11,11,15,15,15,11,15,15,4,11,9,11,5,15,3,11,10,8,12,7,13,9,11,6,8,8,18,14,15,13,9,13,2,17,13,20,10,6,10,9,10,9,10,10,18,13,13,14,6,9,4,1,1,1,1,1,1,1,S ,600,1,1,20,1,1,1,1,1,1,1,1,1,1,1,1,0,0,0,0,0,0,0,0,0,0,0,0,0,0,0,0,0,0,0,0,0,0,0,0,0,0,0,0,0,0,0,0,0,0,0,0,0,0,0,0,0,0,0,0,0,0,0,0,0,Jerry Sitoe,£270Th. ,29,182,Forward - Left Winger,right,ENH de Vilankulos,nan,nan,nan,nan,9,1,0,392,10,1,0,497,9,0,0,610,nan,nan,nan,nan,nan,nan,nan,nan,nan,nan,nan,nan,nan,nan,nan,nan,nan,nan,nan,nan,Liga NOS,nan,nan,nan,nan,nan,nan,nan,nan
13/6/2011,Jean Pierre Barrientos,78035213,1657,9/16/1990,20,0,0,0,0,2750,5624,5400,143,125,10675210,178,74,AM/S R,3,3,3,3,3,1,1,7,2,2,3,14,14,14,12,10,13,10,12,9,7,13,13,7,14,13,11,9,12,9,12,10,14,14,5,13,8,8,10,14,14,9,8,12,16,14,20,14,10,11,7,12,10,15,14,1,7,10,11,12,12,5,1,1,9,20,20,14,8,AM/S R,512,1,1,18,8,14,20,1,1,1,1,1,1,9,1,1,0,0,0,0,0,0,0,0,0,0,0,0,0,0,0,0,0,0,0,0,0,0,0,0,0,0,0,0,0,0,0,0,0,0,0,0,0,0,0,0,0,0,0,0,0,0,0,0,0,Jean Barrientos,£1.17m ,30,174,Midfielder - Attacking Midfield,right,Volos NPS,28,9,0,2391,34,1,2,1794,25,4,0,1345,34,3,3,2373,25,1,1,1359,34,5,3,2256,27,1,1,1646,22,4,1,932,16,0,1,1127,Liga NOS,27,3,1,1459,6,2,1,443
13/6/2011,Jay Emmanuel-Thomas,28010572,765,12/27/1990,20,0,0,0,0,2750,5750,5400,154,116,7547713,191,86,DM/AM/S LC,1,2,3,3,2,1,3,1,1,3,3,2,10,13,14,14,3,13,14,4,7,11,7,11,14,8,10,10,10,8,9,9,14,14,13,12,8,8,6,12,14,16,16,20,13,13,8,14,16,14,6,12,4,17,7,14,13,14,10,8,11,13,13,12,15,20,12,16,20,DM/AM/S LC,534,1,1,17,20,16,12,12,13,1,17,15,15,12,12,1,5.49756E+11,1,0,0,0,0,0,0,0,0,1,0,0,0,0,0,0,0,0,0,0,0,0,0,0,0,0,0,0,0,0,0,0,0,0,0,0,0,0,0,1,0,0,0,0,0,0,0,0,,,,,,,,,,,,,,,,,,,,,,,,,,,,,,,,,,,,,,,,,,,,,,,,,,,,
13/6/2011,Isaac Cuenca,67071789,796,4/27/1991,20,0,0,0,0,2000,5250,5250,118,111,631717,175,76,AM RLC,3,1,3,3,1,2,2,3,2,1,3,10,11,12,8,8,9,6,10,6,4,12,8,4,13,8,10,8,10,9,11,10,10,12,7,12,6,7,7,14,11,6,8,13,9,12,20,12,7,11,6,9,12,11,10,4,8,11,11,5,14,12,1,1,14,20,19,17,20,AM RLC,506,1,1,15,20,17,19,1,1,1,1,10,13,14,1,1,0,0,0,0,0,0,0,0,0,0,0,0,0,0,0,0,0,0,0,0,0,0,0,0,0,0,0,0,0,0,0,0,0,0,0,0,0,0,0,0,0,0,0,0,0,0,0,0,0,Isaac Cuenca,£2.70m ,29,178,Midfielder - Left Midfield,right,Vegalta Sendai,27,4,0,2198,36,6,12,2143,5,0,1,304,nan,nan,nan,nan,29,2,3,1625,31,3,4,1775,26,2,0,1829,18,3,0,867,32,6,0,2393,LaLiga,4,0,0,93,nan,nan,nan,nan
13/6/2011,Idrissa Sylla,85047056,22,12/3/1990,20,0,0,0,0,1300,5300,2650,130,106,3956819,187,75,S ,3,1,3,1,1,1,3,1,1,2,3,5,7,12,12,12,7,13,9,5,6,8,12,2,13,8,10,11,12,12,8,9,14,13,5,11,4,6,9,15,13,15,13,20,14,14,5,13,12,12,8,15,6,10,14,13,10,8,11,14,14,7,1,1,1,12,1,12,1,S ,600,1,1,20,1,12,1,1,1,1,1,1,1,1,1,1,1,1,0,0,0,0,0,0,0,0,0,0,0,0,0,0,0,0,0,0,0,0,0,0,0,0,0,0,0,0,0,0,0,0,0,0,0,0,0,0,0,0,0,0,0,0,0,0,0,,,,,,,,,,,,,,,,,,,,,,,,,,,,,,,,,,,,,,,,,,,,,,,,,,,,
13/6/2011,Hiroshi Ibusuki,67071428,116,2/27/1991,20,0,0,2,0,2250,4499,4750,125,100,295881,195,82,S ,1,3,3,3,1,1,1,5,1,3,1,4,7,10,13,10,8,15,10,4,4,9,13,4,9,8,11,9,13,9,9,10,11,7,5,13,4,15,13,10,7,14,15,6,12,12,20,13,13,11,7,9,5,2,8,12,9,10,12,11,13,4,1,1,1,8,1,1,8,S ,600,1,1,20,8,1,1,1,1,1,1,1,1,1,1,1,262144,0,0,0,0,0,0,0,0,0,0,0,0,0,0,0,0,0,0,1,0,0,0,0,0,0,0,0,0,0,0,0,0,0,0,0,0,0,0,0,0,0,0,0,0,0,0,0,0,Hiroshi Ibusuki,- ,29,196,Forward - Centre-Forward,right,Shonan Bellmare,33,10,0,2289,33,20,0,2583,26,10,0,1817,50,9,3,3243,40,12,3,2738,22,2,2,1378,31,3,4,1169,35,11,7,1958,18,2,0,778,LaLiga,16,1,0,406,nan,nan,nan,nan
13/6/2011,Gilles Sunu,34003025,769,3/30/1991,20,0,0,0,0,4000,5000,5000,153,111,2543231,181,75,AM/S R,2,2,1,1,1,3,2,8,3,1,2,5,7,13,10,13,7,9,11,5,3,11,10,3,15,5,10,9,10,7,12,9,14,14,7,11,6,10,10,15,13,13,9,10,12,14,20,8,13,11,5,15,10,8,11,15,16,13,14,14,14,7,1,1,12,18,18,12,14,AM/S R,622,1,1,20,14,12,18,1,1,1,1,10,12,12,1,1,2.2518E+15,0,0,0,0,0,0,0,0,0,0,0,0,0,0,0,0,0,0,0,0,0,0,0,0,0,0,0,0,0,0,0,0,0,0,0,0,0,0,0,0,0,0,0,0,0,0,0,0,Gilles Sunu,£1.35m ,29,181,Forward - Centre-Forward,right,LB ChÃ¢teauroux,17,2,3,793,18,2,2,974,22,4,0,590,20,1,1,776,28,4,2,1679,35,2,1,2584,27,0,0,964,23,1,1,842,28,4,2,1951,Premier League,14,3,1,712,8,1,1,592
13/6/2011,Gianluca Marzullo,92023693,771,1/4/1991,20,0,0,0,0,500,3750,3750,95,75,87707,181,77,S ,3,3,1,3,1,3,3,1,2,1,2,5,1,11,10,8,7,7,9,5,3,9,7,4,4,4,9,4,8,6,4,7,7,9,11,11,4,6,9,11,11,11,7,16,11,11,20,5,7,9,10,10,12,9,10,12,9,17,8,12,15,11,1,1,1,1,1,1,1,S ,600,1,1,20,1,1,1,1,1,1,1,1,1,1,1,1,0,0,0,0,0,0,0,0,0,0,0,0,0,0,0,0,0,0,0,0,0,0,0,0,0,0,0,0,0,0,0,0,0,0,0,0,0,0,0,0,0,0,0,0,0,0,0,0,0,,,,,,,,,,,,,,,,,,,,,,,,,,,,,,,,,,,,,,,,,,,,,,,,,,,,
13/6/2011,Franck Julienne,28031633,769,3/7/1991,20,0,0,0,0,1300,2650,2650,130,106,2955223,171,63,AM/S L,3,2,2,3,2,2,3,1,1,3,3,7,9,13,11,13,8,6,12,5,1,10,13,2,13,7,11,6,14,11,10,10,13,14,5,13,5,7,9,16,14,10,6,20,14,14,5,12,6,14,7,6,6,8,7,14,13,13,9,14,14,7,1,1,10,18,12,18,1,AM/S L,623,1,1,20,1,18,12,1,1,1,1,1,10,10,1,1,2.2518E+15,0,0,0,0,1,0,0,0,0,0,0,0,0,0,0,0,0,0,0,0,0,0,0,0,0,0,0,0,0,0,0,0,0,0,0,0,0,0,0,0,0,0,0,0,0,0,0,0,Florian Julien, ,27,175,Defender - Right-Back,right,Unknown,nan,nan,nan,nan,0,0,0,0,2,0,1,96,2,0,0,10,nan,nan,nan,nan,nan,nan,nan,nan,nan,nan,nan,nan,nan,nan,nan,nan,nan,nan,nan,nan,Ligue 1,nan,nan,nan,nan,nan,nan,nan,nan
13/6/2011,Fodé Koita,34008678,769,10/21/1990,20,0,0,3,0,4100,5150,5150,140,114,3190769,186,86,S ,1,1,3,3,2,3,3,3,2,3,3,5,7,11,13,11,8,16,12,5,6,8,12,3,11,8,14,12,12,12,7,11,16,12,6,13,6,9,13,14,11,16,14,5,13,13,20,13,16,13,8,10,10,5,6,16,12,13,10,14,14,9,1,1,10,13,1,13,1,S ,600,1,1,20,1,13,1,1,1,1,1,1,10,1,1,1,0,0,0,0,0,0,0,0,0,0,0,0,0,0,0,0,0,0,0,0,0,0,0,0,0,0,0,0,0,0,0,0,0,0,0,0,0,0,0,0,0,0,0,0,0,0,0,0,0,,,,,,,,,,,,,,,,,,,,,,,,,,,,,,,,,,,,,,,,,,,,,,,,,,,,
13/6/2011,Florian Niederlechner,92037896,771,10/24/1990,20,0,0,0,0,3450,4850,4850,118,97,1838746,187,84,S ,2,1,3,3,3,3,2,3,2,3,3,3,7,12,12,12,8,12,9,1,1,9,8,3,10,6,11,9,12,6,8,11,10,9,8,10,7,7,12,12,12,12,12,16,16,10,20,7,6,9,10,9,4,10,11,15,15,14,13,14,8,7,1,1,1,1,1,1,1,S ,600,1,1,20,1,1,1,1,1,1,1,1,1,1,1,1,0,0,0,0,0,0,0,0,0,0,0,0,0,0,0,0,0,0,0,0,0,0,0,0,0,0,0,0,0,0,0,0,0,0,0,0,0,0,0,0,0,0,0,0,0,0,0,0,0,,,,,,,,,,,,,,,,,,,,,,,,,,,,,,,,,,,,,,,,,,,,,,,,,,,,
13/6/2011,Filipe,55037382,788,7/14/1990,20,0,0,0,0,50,600,500,103,63,93778,186,0,S ,2,3,3,1,1,3,1,1,2,3,2,3,2,9,12,11,6,11,2,1,5,7,8,2,9,13,10,2,10,5,7,6,7,12,1,10,4,14,11,12,10,8,13,8,10,9,20,8,7,10,8,8,10,10,14,14,12,10,14,8,9,2,1,1,1,1,1,1,1,S ,600,1,1,20,1,1,1,1,1,1,1,1,1,1,1,1,0,0,0,0,0,0,0,0,0,0,0,0,0,0,0,0,0,0,0,0,0,0,0,0,0,0,0,0,0,0,0,0,0,0,0,0,0,0,0,0,0,0,0,0,0,0,0,0,0,Felipe,£810Th. ,36,188,Defender - Centre-Back,left,Without Club,13,0,0,803,3,0,0,188,35,0,0,3071,25,0,0,1955,16,1,0,1197,27,1,1,2216,33,1,1,2902,30,1,0,2577,31,3,1,2453,Serie A,16,0,0,1086,nan,nan,nan,nan
13/6/2011,Fabio Borini,28018401,776,3/23/1991,20,0,0,11,1,4250,5624,5250,139,125,842053,179,75,S ,3,2,1,3,1,2,2,5,1,2,2,9,11,10,17,14,14,9,9,1,5,11,15,5,13,7,12,8,12,10,12,13,11,10,6,14,11,12,15,14,11,12,9,14,14,12,20,13,9,13,4,14,5,5,12,14,12,12,17,14,12,4,1,1,1,14,12,12,14,S ,600,1,1,20,14,12,12,1,1,1,1,1,1,1,1,1,0,0,0,0,0,0,0,0,0,0,0,0,0,0,0,0,0,0,0,0,0,0,0,0,0,0,0,0,0,0,0,0,0,0,0,0,0,0,0,0,0,0,0,0,0,0,0,0,0,Fabio Borini,£7.20m ,29,180,Forward - Left Winger,right,Without Club,20,18,7,1604,26,10,0,1744,20,2,1,955,41,12,5,2690,18,1,2,672,27,5,2,1988,26,2,0,1911,44,5,5,2429,29,3,1,1494,Serie A,16,3,0,880,nan,nan,nan,nan
13/6/2011,Emiliano Sala,85086466,1649,10/31/1990,20,0,0,0,0,1250,2550,2550,135,103,1729636,187,83,S ,1,2,2,3,2,1,1,4,1,1,3,4,6,11,12,11,6,14,9,5,5,7,13,4,11,12,12,13,10,9,7,10,16,9,7,12,6,13,16,14,11,14,13,20,14,12,5,11,15,13,9,13,7,5,13,14,13,14,14,13,13,6,1,1,1,10,1,10,1,S ,600,1,1,20,1,10,1,1,1,1,1,1,1,1,1,1,16,0,0,0,0,1,0,0,0,0,0,0,0,0,0,0,0,0,0,0,0,0,0,0,0,0,0,0,0,0,0,0,0,0,0,0,0,0,0,0,0,0,0,0,0,0,0,0,0,Emiliano Sala,£90Th. ,nan,187,Forward - Centre-Forward,right,---,nan,nan,nan,nan,1,0,0,14,37,19,0,3198,39,18,3,3242,25,6,3,1299,35,6,3,2170,39,15,5,2995,38,14,3,3214,21,13,2,1466,Ligue 1,nan,nan,nan,nan,nan,nan,nan,nan
13/6/2011,Diego Fabbrini,1414266,776,7/31/1990,20,0,0,11,1,2000,5500,5500,162,117,1982617,181,66,AM/S RLC,1,1,2,3,2,2,3,5,1,3,1,10,12,13,9,14,10,5,12,4,4,14,7,4,13,12,12,9,12,12,12,11,11,16,11,11,7,16,15,13,10,12,10,12,12,9,20,11,10,11,12,10,3,10,7,12,13,13,10,13,12,11,1,1,10,20,20,18,18,AM/S RLC,516,1,1,18,18,18,20,1,1,1,1,5,10,10,1,1,0,0,0,0,0,0,0,0,0,0,0,0,0,0,0,0,0,0,0,0,0,0,0,0,0,0,0,0,0,0,0,0,0,0,0,0,0,0,0,0,0,0,0,0,0,0,0,0,0,Diego Fabbrini,£2.70m ,30,181,Midfielder - Attacking Midfield,right,Dinamo Bucharest,28,2,0,1783,25,2,2,1152,22,2,1,1255,35,2,3,1638,21,1,2,1486,40,6,4,2238,27,1,0,1543,17,1,0,802,32,5,5,2513,Serie A,30,1,2,1952,7,0,1,332
13/6/2011,Dennis Wegner,92025468,771,1/10/1991,20,0,0,0,0,250,3250,3250,95,65,22767,182,76,S ,1,3,1,3,3,3,2,4,2,2,2,6,3,13,13,11,9,13,9,3,5,8,1,6,9,10,10,3,10,6,6,5,8,10,1,12,6,8,10,13,10,10,9,20,15,10,3,5,6,9,14,7,3,8,13,16,17,10,14,11,2,17,1,1,1,1,1,1,1,S ,600,1,1,20,1,1,1,1,1,1,1,1,1,1,1,1,0,0,0,0,0,0,0,0,0,0,0,0,0,0,0,0,0,0,0,0,0,0,0,0,0,0,0,0,0,0,0,0,0,0,0,0,0,0,0,0,0,0,0,0,0,0,0,0,0,,,,,,,,,,,,,,,,,,,,,,,,,,,,,,,,,,,,,,,,,,,,,,,,,,,,
13/6/2011,Danny Blum,35017408,771,1/7/1991,20,0,0,0,0,2500,4350,4350,110,87,186291,184,79,M L,2,1,1,2,1,3,1,1,1,2,2,6,8,11,13,11,5,11,14,9,7,10,10,8,12,6,9,10,12,7,12,8,10,13,2,13,7,13,15,12,11,13,11,20,8,12,4,10,8,9,10,10,17,14,10,14,8,9,16,18,15,15,7,1,20,15,1,20,1,M L,403,1,1,15,1,15,1,1,7,1,1,1,20,1,1,1,0,0,0,0,0,0,0,0,0,0,0,0,0,0,0,0,0,0,0,0,0,0,0,0,0,0,0,0,0,0,0,0,0,0,0,0,0,0,0,0,0,0,0,0,0,0,0,0,0,,,,,,,,,,,,,,,,,,,,,,,,,,,,,,,,,,,,,,,,,,,,,,,,,,,,
13/6/2011,Danijel Aleksic,5797637,802,4/30/1991,20,1,0,10,1,2750,5850,5400,146,113,1997229,181,78,S ,2,2,2,3,3,1,3,1,1,1,2,8,12,14,16,13,14,11,19,5,3,11,14,8,14,13,12,13,8,7,9,9,11,14,7,13,5,8,11,14,14,8,11,20,11,12,11,10,8,8,5,11,5,9,9,13,15,8,7,18,11,8,1,1,1,14,14,11,11,S ,600,1,1,20,11,11,14,1,1,1,1,1,1,1,1,1,5.66936E+11,0,0,0,0,0,0,0,0,0,1,0,0,0,0,1,0,0,0,0,0,0,0,0,0,0,0,0,0,0,0,0,0,0,0,1,0,0,0,0,1,0,0,0,0,0,0,0,0,Danijel Aleksic,£360Th. ,29,182,Midfielder - Attacking Midfield,left,Istanbul Basaksehir FK,17,2,1,862,1,0,0,7,2,0,0,43,1,0,0,90,8,1,2,356,35,12,5,2700,26,3,3,1275,31,8,4,1934,40,15,8,3170,Ligue 1,36,9,2,2140,6,0,0,253
13/6/2011,Daniel Pacheco,67039927,796,1/5/1991,20,0,0,1,0,3550,5750,5750,141,107,2369807,168,65,AM/S C,2,3,2,2,1,3,2,3,3,1,2,9,8,12,9,15,14,4,14,6,7,13,12,7,15,7,12,5,10,12,12,8,10,16,4,13,8,11,12,14,6,9,7,12,15,13,20,12,6,12,4,10,5,8,15,14,6,12,10,10,7,10,1,1,8,16,9,1,16,AM/S C,621,1,1,20,16,1,9,1,1,1,1,8,1,1,1,1,1.75922E+13,0,0,0,0,0,0,0,0,0,0,0,0,0,0,0,0,0,0,0,1,0,0,0,0,0,0,0,0,0,0,0,0,0,0,0,0,0,0,0,0,0,0,0,0,1,0,0,0,Dani Pacheco,£540Th. ,29,168,Forward - Left Winger,both,Without Club,22,5,2,1332,12,0,0,348,33,9,11,2793,37,7,8,2350,25,0,1,1031,38,3,7,2562,34,6,3,2534,12,0,0,196,24,1,3,1322,LaLiga,22,1,1,1371,nan,nan,nan,nan
13/6/2011,Daniel Ginczek,35017423,771,4/13/1991,20,0,0,2,0,3500,5500,5500,130,109,2789239,191,84,S ,1,3,1,1,3,2,2,2,2,1,3,3,6,9,13,12,7,12,7,6,4,9,8,5,11,8,12,12,13,11,8,11,12,9,6,13,7,10,13,10,10,13,14,11,10,14,20,13,13,13,8,10,11,5,13,3,14,8,12,10,8,8,1,1,1,1,1,1,1,S ,600,1,1,20,1,1,1,1,1,1,1,1,1,1,1,1,0,0,0,0,0,0,0,0,0,0,0,0,0,0,0,0,0,0,0,0,0,0,0,0,0,0,0,0,0,0,0,0,0,0,0,0,0,0,0,0,0,0,0,0,0,0,0,0,0,,,,,,,,,,,,,,,,,,,,,,,,,,,,,,,,,,,,,,,,,,,,,,,,,,,,
13/6/2011,Daniel Engelbrecht,91018554,771,11/5/1990,20,0,0,0,0,500,4750,4750,120,95,1538153,186,84,S ,1,2,2,1,2,3,3,1,1,3,1,3,2,12,9,10,5,12,4,2,5,9,8,2,11,13,4,9,12,5,10,11,10,13,7,12,5,14,12,12,11,12,11,16,10,12,20,8,6,10,9,8,13,10,6,13,11,5,15,10,5,19,1,1,1,1,1,1,1,S ,600,1,1,20,1,1,1,1,1,1,1,1,1,1,1,1,0,0,0,0,0,0,0,0,0,0,0,0,0,0,0,0,0,0,0,0,0,0,0,0,0,0,0,0,0,0,0,0,0,0,0,0,0,0,0,0,0,0,0,0,0,0,0,0,0,,,,,,,,,,,,,,,,,,,,,,,,,,,,,,,,,,,,,,,,,,,,,,,,,,,,
13/6/2011,Christopher Quiring,92021350,771,11/23/1990,20,0,0,0,0,3800,5800,5800,122,116,3266345,172,67,M/AM/S RL,2,3,2,2,2,1,2,4,1,1,3,11,14,13,14,14,7,8,12,7,10,10,10,11,14,7,13,10,13,5,13,9,10,11,13,10,5,6,11,14,14,14,6,8,12,14,20,8,5,15,9,10,9,10,14,3,12,13,12,17,10,10,1,1,18,20,20,16,1,M/AM/S RL,535,1,1,18,1,16,20,1,1,1,1,1,1,18,1,1,0,0,0,0,0,0,0,0,0,0,0,0,0,0,0,0,0,0,0,0,0,0,0,0,0,0,0,0,0,0,0,0,0,0,0,0,0,0,0,0,0,0,0,0,0,0,0,0,0,Christopher Jullien, ,27,196,Defender - Centre-Back,right,Celtic FC,nan,nan,nan,nan,0,0,0,0,26,3,0,2108,26,3,0,2288,24,2,8,2079,37,9,1,3360,37,5,1,3360,36,2,3,3118,35,1,0,3105,Ligue 1,46,7,2,4000,7,2,2,630
13/6/2011,Cédric Bakambu,34009930,769,4/11/1991,20,0,0,0,0,2500,5050,5050,152,112,2016070,180,70,S ,3,3,1,1,2,2,2,3,1,3,1,4,7,13,12,11,8,12,11,5,3,8,14,2,13,8,11,11,12,11,7,9,14,12,5,13,6,8,11,17,14,13,11,5,15,15,20,12,11,12,8,15,8,6,8,15,14,10,12,14,14,5,1,1,12,12,10,12,1,S ,600,1,1,20,1,12,10,1,1,1,1,1,12,10,1,1,2064,0,0,0,0,1,0,0,0,0,0,0,1,0,0,0,0,0,0,0,0,0,0,0,0,0,0,0,0,0,0,0,0,0,0,0,0,0,0,0,0,0,0,0,0,0,0,0,0,Cédric Bakambu,£900Th. ,29,182,Forward - Centre-Forward,right,Beijing Sinobo Guoan,11,0,0,197,23,3,0,952,38,11,1,2552,35,7,2,2382,39,21,7,2755,51,22,3,3034,34,11,2,2024,49,37,7,4075,26,16,7,2238,Ligue 1,17,13,6,1227,nan,nan,nan,nan
13/6/2011,Caetano,55013009,788,4/20/1991,20,0,0,0,0,1000,3000,5250,125,105,3586981,165,57,AM/S R,2,3,3,2,2,3,2,1,2,3,1,10,11,12,12,11,6,5,9,7,6,9,11,6,12,15,12,14,10,11,10,10,15,13,8,13,7,15,16,13,13,5,5,12,12,13,20,6,5,11,6,10,8,12,7,13,15,15,15,15,15,6,1,1,1,17,17,13,1,AM/S R,622,1,1,20,1,13,17,1,1,1,1,1,1,1,1,1,0,0,0,0,0,0,0,0,0,0,0,0,0,0,0,0,0,0,0,0,0,0,0,0,0,0,0,0,0,0,0,0,0,0,0,0,0,0,0,0,0,0,0,0,0,0,0,0,0,Caetano,£1.35m ,29,165,Midfielder - Attacking Midfield,left,Varzim SC,16,1,2,661,23,1,0,864,34,3,1,1010,29,2,2,1509,27,2,2,1498,40,1,2,2831,25,1,2,973,19,1,0,580,19,4,0,592,Liga NOS,8,0,0,285,2,0,0,14
13/6/2011,Bruno,67126612,1651,1/5/1991,20,0,0,0,0,1050,3050,3050,97,61,-1,180,70,S ,2,2,3,2,1,3,3,5,2,1,3,6,3,11,10,8,3,11,8,1,3,11,6,7,11,10,6,4,6,3,7,6,9,11,12,6,2,11,10,11,11,11,8,8,15,11,20,6,7,10,7,10,8,9,5,15,8,11,9,5,8,14,1,1,1,1,1,1,1,S ,600,1,1,20,1,1,1,1,1,1,1,1,1,1,1,1,0,0,0,0,0,0,0,0,0,0,0,0,0,0,0,0,0,0,0,0,0,0,0,0,0,0,0,0,0,0,0,0,0,0,0,0,0,0,0,0,0,0,0,0,0,0,0,0,0,Bruno,£1.80m ,40,180,Defender - Right-Back,right,Retired,25,0,1,2074,18,0,1,1179,31,1,6,2597,33,1,2,2722,37,3,1,3053,48,1,3,4236,42,0,5,3719,26,0,1,2107,18,0,1,1537,LaLiga,nan,nan,nan,nan,nan,nan,nan,nan
13/6/2011,Borja,67060845,796,11/2/1990,20,0,0,0,0,3000,5450,5450,130,112,1368500,172,65,M/AM/S RL,1,1,2,1,3,1,2,1,3,2,3,11,13,13,10,14,10,6,14,6,10,12,10,11,14,10,13,10,8,12,11,9,10,11,1,14,4,11,14,12,14,14,6,5,11,14,20,10,4,10,6,4,9,10,6,10,9,9,9,5,9,7,1,1,16,20,20,16,1,M/AM/S RL,535,1,1,17,1,16,20,1,1,1,1,1,15,16,1,1,0,0,0,0,0,0,0,0,0,0,0,0,0,0,0,0,0,0,0,0,0,0,0,0,0,0,0,0,0,0,0,0,0,0,0,0,0,0,0,0,0,0,0,0,0,0,0,0,0,,,,,,,,,,,,,,,,,,,,,,,,,,,,,,,,,,,,,,,,,,,,,,,,,,,,
13/6/2011,Bojan,1510565,796,8/28/1990,20,1,0,8,3,6500,7100,7100,166,143,25636207,170,65,S ,2,3,1,2,3,3,3,4,3,2,1,9,13,15,15,13,8,11,13,5,5,13,14,7,15,7,13,11,12,13,14,14,11,16,9,15,7,15,15,14,17,10,7,13,12,15,20,14,9,12,4,11,8,11,11,12,16,8,15,18,16,7,1,1,1,13,13,11,8,S ,600,1,1,20,8,11,13,1,1,1,1,1,1,1,1,1,1053712,0,0,0,0,1,0,0,0,0,0,1,0,1,0,0,0,0,0,0,0,1,0,0,0,0,0,0,0,0,0,0,0,0,0,0,0,0,0,0,0,0,0,0,0,0,0,0,0,,,,,,,,,,,,,,,,,,,,,,,,,,,,,,,,,,,,,,,,,,,,,,,,,,,,
13/6/2011,Bahattin Köse,92017037,799,8/26/1990,20,0,0,0,0,1500,4000,3900,100,78,93345,187,78,S ,1,1,1,3,1,1,3,1,1,3,3,5,6,9,12,12,8,12,10,4,5,9,8,2,9,7,9,4,12,3,7,3,9,11,7,7,5,12,11,12,10,7,12,9,12,10,20,7,4,8,9,10,13,8,7,19,13,5,8,10,17,3,1,1,1,1,1,1,1,S ,600,1,1,20,1,1,1,1,1,1,1,1,1,1,1,1,0,0,0,0,0,0,0,0,0,0,0,0,0,0,0,0,0,0,0,0,0,0,0,0,0,0,0,0,0,0,0,0,0,0,0,0,0,0,0,0,0,0,0,0,0,0,0,0,0,,,,,,,,,,,,,,,,,,,,,,,,,,,,,,,,,,,,,,,,,,,,,,,,,,,,
13/6/2011,Antonio Pedroza,51013187,379,2/20/1991,20,0,0,0,0,3250,5750,5250,150,113,2565382,174,69,S ,1,2,2,2,1,3,1,3,3,1,3,6,8,11,12,12,10,11,11,4,10,11,8,5,12,12,10,11,13,12,10,11,10,9,7,12,8,13,13,13,14,12,10,10,15,13,20,14,11,12,9,7,14,10,15,15,10,11,13,12,7,8,1,1,1,1,1,1,1,S ,600,1,1,20,1,1,1,1,1,1,1,1,1,1,1,1,0,0,0,0,0,0,0,0,0,0,0,0,0,0,0,0,0,0,0,0,0,0,0,0,0,0,0,0,0,0,0,0,0,0,0,0,0,0,0,0,0,0,0,0,0,0,0,0,0,Antonio German,£225Th. ,28,187,Forward - Centre-Forward,left,PDRM FA,13,2,0,464,18,3,0,1078,12,2,1,495,19,0,0,845,31,9,4,1460,15,0,2,637,nan,nan,nan,nan,nan,nan,nan,nan,8,3,0,654,Premier League,2,1,0,180,nan,nan,nan,nan
13/6/2011,Anthony Ujah,53056470,38,10/14/1990,20,0,0,0,0,4000,6000,6500,152,133,13708400,183,82,S ,1,3,3,3,1,1,3,7,2,1,2,5,7,11,15,8,7,13,12,5,5,7,10,6,10,12,14,17,13,9,7,9,13,13,6,10,6,12,14,15,14,11,15,13,14,17,20,11,16,15,12,12,6,4,14,15,15,12,17,11,11,2,1,1,1,1,1,1,1,S ,600,1,1,20,1,1,1,1,1,1,1,1,1,1,1,1,270848,0,0,0,0,0,0,0,0,0,1,0,0,0,1,0,0,0,0,1,0,0,0,0,0,0,0,0,0,0,0,0,0,0,0,0,0,0,0,0,0,0,0,0,0,0,0,0,0,Anthony Ujah,£1.58m ,30,180,Forward - Centre-Forward,right,1.FC Union Berlin,13,13,4,1200,16,2,0,675,31,13,3,2626,37,11,4,2394,35,12,3,2602,52,19,8,3883,24,5,4,2070,12,0,0,253,23,4,0,843,Bundesliga,28,4,4,1181,nan,nan,nan,nan
13/6/2011,Anthony Ihou,85059098,50,3/4/1991,20,0,0,0,0,1100,2200,2200,126,88,675469,185,82,AM L,3,3,3,2,1,2,3,6,2,3,3,5,6,13,7,13,7,10,8,5,4,7,10,2,15,6,12,11,10,10,9,8,15,12,5,11,4,5,7,15,13,13,12,20,15,11,5,10,11,13,6,10,7,8,16,14,9,13,12,14,14,7,1,1,12,20,12,20,1,AM L,503,1,1,15,1,20,12,1,1,1,1,1,12,12,1,1,1,1,0,0,0,0,0,0,0,0,0,0,0,0,0,0,0,0,0,0,0,0,0,0,0,0,0,0,0,0,0,0,0,0,0,0,0,0,0,0,0,0,0,0,0,0,0,0,0,Anthony Ujah,£1.58m ,30,180,Forward - Centre-Forward,right,1.FC Union Berlin,13,13,4,1200,16,2,0,675,31,13,3,2626,37,11,4,2394,35,12,3,2602,52,19,8,3883,24,5,4,2070,12,0,0,253,23,4,0,843,Bundesliga,28,4,4,1181,nan,nan,nan,nan
13/6/2011,Andreas Ludwig,92017389,771,9/11/1990,20,0,0,0,0,2250,4400,4400,110,88,461782,172,68,M/AM/S LC,1,2,3,1,3,2,2,7,3,3,3,10,11,11,10,11,9,5,9,5,7,11,8,6,12,11,9,11,12,10,13,12,9,8,8,13,8,12,12,12,13,9,7,20,9,10,6,11,6,9,5,9,5,18,5,2,11,12,16,8,6,6,1,1,17,17,10,17,15,M/AM/S LC,634,1,1,20,15,17,10,1,1,1,1,13,17,5,1,1,0,0,0,0,0,0,0,0,0,0,0,0,0,0,0,0,0,0,0,0,0,0,0,0,0,0,0,0,0,0,0,0,0,0,0,0,0,0,0,0,0,0,0,0,0,0,0,0,0,,,,,,,,,,,,,,,,,,,,,,,,,,,,,,,,,,,,,,,,,,,,,,,,,,,,
13/6/2011,André Schürrle,91002405,771,11/6/1990,20,5,2,4,3,5900,7550,7550,164,149,84780364,184,74,AM/S LC,2,1,1,3,2,1,3,4,3,1,2,9,9,14,15,9,10,7,15,5,6,11,14,8,12,18,12,9,10,12,13,11,18,10,7,14,10,15,19,18,16,12,11,9,13,17,20,18,9,14,2,11,5,15,13,15,10,14,13,14,17,5,1,1,12,20,14,20,15,AM/S LC,514,1,1,18,15,20,14,1,1,1,1,8,12,10,1,1,5.49891E+11,0,0,0,0,1,0,0,0,1,0,0,0,0,0,0,0,0,0,0,1,0,0,0,0,0,0,0,1,0,0,0,0,0,0,0,0,0,0,0,1,0,0,0,0,0,0,0,0,André Schürrle,£12.60m ,29,184,Forward - Left Winger,right,Retired,34,15,5,2569,40,9,6,3333,43,14,10,3456,43,9,3,2065,44,6,3,2048,41,12,7,2588,25,5,4,1126,26,3,6,1706,25,6,0,1732,Bundesliga,18,2,4,1139,nan,nan,nan,nan
13/6/2011,Anderson Melo,19132613,1651,8/14/1990,20,0,0,0,0,1500,5250,5250,124,105,29059,179,69,AM/S RC,1,1,2,2,2,3,2,2,2,3,3,11,13,13,12,12,9,13,11,3,8,13,9,13,13,17,9,10,12,10,12,12,10,13,1,10,8,9,13,13,13,13,6,11,7,13,20,9,4,11,10,9,12,9,13,10,6,8,5,8,5,8,1,1,10,20,19,1,20,AM/S RC,513,1,1,18,20,1,19,1,1,1,1,10,1,10,1,1,0,0,0,0,0,0,0,0,0,0,0,0,0,0,0,0,0,0,0,0,0,0,0,0,0,0,0,0,0,0,0,0,0,0,0,0,0,0,0,0,0,0,0,0,0,0,0,0,0,Uanderson Melo,£180Th. ,30,179,Forward - Centre-Forward,right,Grêmio Esportivo Anápolis (GO),nan,nan,nan,nan,3,0,0,95,nan,nan,nan,nan,nan,nan,nan,nan,nan,nan,nan,nan,nan,nan,nan,nan,nan,nan,nan,nan,nan,nan,nan,nan,nan,nan,nan,nan,Liga NOS,nan,nan,nan,nan,nan,nan,nan,nan
13/6/2011,Álvaro,67118371,796,4/27/1991,20,0,0,0,0,4400,6400,6400,150,128,19587301,182,77,S ,3,2,1,3,1,3,2,9,3,2,3,8,12,13,13,13,9,12,11,7,7,12,9,7,13,9,12,12,12,11,12,11,10,12,8,14,7,13,13,13,14,12,11,8,12,14,20,14,11,12,7,10,5,7,7,9,17,13,11,4,7,9,1,1,1,1,1,1,1,S ,600,1,1,20,1,1,1,1,1,1,1,1,1,1,1,1,0,0,0,0,0,0,0,0,0,0,0,0,0,0,0,0,0,0,0,0,0,0,0,0,0,0,0,0,0,0,0,0,0,0,0,0,0,0,0,0,0,0,0,0,0,0,0,0,0,,,,,,,,,,,,,,,,,,,,,,,,,,,,,,,,,,,,,,,,,,,,,,,,,,,,
13/6/2011,Alexandre Lacazette,34011687,769,5/28/1991,20,0,0,0,0,1500,5174,5150,160,115,2670368,174,69,S R,2,3,1,2,1,2,2,1,3,1,2,6,8,14,11,12,8,6,10,5,2,9,12,2,14,7,10,7,13,13,11,11,14,14,6,13,5,6,8,18,15,12,7,5,15,16,20,11,9,14,7,10,8,6,10,16,17,16,14,14,14,5,1,1,10,15,15,1,1,S R,602,1,1,20,1,1,15,1,1,1,1,1,1,10,1,1,2,0,1,0,0,0,0,0,0,0,0,0,0,0,0,0,0,0,0,0,0,0,0,0,0,0,0,0,0,0,0,0,0,0,0,0,0,0,0,0,0,0,0,0,0,0,0,0,0,Alexandre Lacazette,£5.40m ,29,176,Forward - Centre-Forward,right,Arsenal FC,11,2,2,185,43,10,6,2206,37,4,10,2756,54,22,8,4409,40,31,8,3468,44,23,4,3743,45,37,5,3477,39,17,5,2758,49,19,13,3327,Ligue 1,39,12,7,2581,7,3,0,440
13/6/2011,Alexander Zahavi,67022043,775,1/21/1991,20,0,0,5,1,2250,5000,5000,125,103,87464,173,69,AM RL,3,2,1,1,3,3,3,2,2,3,1,11,11,14,13,14,12,8,13,5,5,13,10,5,13,8,11,9,10,7,10,7,14,12,7,9,7,8,15,13,10,9,6,14,11,12,20,7,5,7,9,7,12,8,12,17,9,11,16,13,8,6,1,1,10,20,17,20,10,AM RL,505,1,1,15,10,20,17,1,1,1,1,10,10,10,1,1,5.49756E+11,0,0,0,0,0,0,0,0,0,0,0,0,0,0,0,0,0,0,0,0,0,0,0,0,0,0,0,0,0,0,0,0,0,0,0,0,0,0,0,1,0,0,0,0,0,0,0,0,Alex Zahavi,£180Th. ,29,175,Forward - Right Winger,right,Retired,10,0,0,267,1,0,0,10,nan,nan,nan,nan,nan,nan,nan,nan,nan,nan,nan,nan,nan,nan,nan,nan,nan,nan,nan,nan,nan,nan,nan,nan,nan,nan,nan,nan,Liga NOS,nan,nan,nan,nan,nan,nan,nan,nan
13/6/2011,Adriano Grimaldi,91017757,776,4/5/1991,20,0,0,2,0,4300,4500,5200,133,104,3026535,188,76,S ,1,1,3,3,2,1,1,1,2,1,1,6,9,12,11,9,7,12,8,4,4,11,9,7,11,10,11,8,9,11,9,13,17,8,13,13,9,11,7,12,12,14,14,15,9,11,20,11,10,12,6,10,7,9,12,9,12,9,7,6,18,12,1,1,1,10,10,10,1,S ,600,1,1,20,1,10,10,1,1,1,1,1,1,1,1,1,0,0,0,0,0,0,0,0,0,0,0,0,0,0,0,0,0,0,0,0,0,0,0,0,0,0,0,0,0,0,0,0,0,0,0,0,0,0,0,0,0,0,0,0,0,0,0,0,0,,,,,,,,,,,,,,,,,,,,,,,,,,,,,,,,,,,,,,,,,,,,,,,,,,,,
13/6/2011,Adrián Sardinero,67087749,796,10/13/1990,20,0,0,0,0,3000,5000,5000,113,101,3211385,180,78,AM/S C,3,1,3,1,1,1,3,4,1,2,1,8,6,14,11,12,4,12,12,4,5,10,3,6,13,12,10,10,12,6,10,10,10,13,6,15,8,13,14,15,13,12,11,5,16,15,20,9,8,10,8,10,17,10,7,4,13,11,8,13,9,6,1,1,5,18,10,12,18,AM/S C,621,1,1,20,18,12,10,1,1,1,1,1,5,1,1,1,0,0,0,0,0,0,0,0,0,0,0,0,0,0,0,0,0,0,0,0,0,0,0,0,0,0,0,0,0,0,0,0,0,0,0,0,0,0,0,0,0,0,0,0,0,0,0,0,0,,,,,,,,,,,,,,,,,,,,,,,,,,,,,,,,,,,,,,,,,,,,,,,,,,,,
13/6/2011,Abel Hernández,78020163,1657,8/8/1990,20,7,2,17,11,5500,7480,6750,169,136,46464062,185,75,S ,3,1,2,3,2,3,1,4,3,3,3,6,11,16,15,14,8,10,13,10,5,13,13,4,16,10,12,13,13,14,12,13,18,14,10,15,14,10,9,15,14,11,12,20,12,14,11,13,12,17,8,11,10,12,12,13,11,14,16,16,12,8,1,1,1,1,1,1,1,S ,600,1,1,20,1,1,1,1,1,1,1,1,1,1,1,1,0,0,0,0,0,0,0,0,0,0,0,0,0,0,0,0,0,0,0,0,0,0,0,0,0,0,0,0,0,0,0,0,0,0,0,0,0,0,0,0,0,0,0,0,0,0,0,0,0,Abel Hernández,£4.50m ,30,185,Forward - Centre-Forward,left,Sport Club Internacional,29,8,2,1805,20,6,2,1349,15,1,1,689,30,14,2,2079,26,4,1,1336,45,22,4,3263,29,5,3,1723,10,8,2,688,15,3,1,600,Serie A,30,11,2,2034,nan,nan,nan,nan
13/6/2011,Abdoulay Diaby,85054417,769,5/21/1991,20,0,0,0,0,2150,3250,3250,126,99,2890084,173,71,AM/S L,3,3,1,1,2,2,3,3,3,1,3,6,9,12,11,13,10,6,8,5,2,8,14,2,13,10,10,7,12,10,8,9,14,12,5,11,4,8,11,15,14,11,8,20,11,13,8,8,9,13,10,10,12,10,5,14,14,16,11,6,12,8,1,1,10,16,13,16,1,AM/S L,623,1,1,20,1,16,13,1,1,1,1,1,10,10,1,1,1.75922E+13,0,0,0,0,1,0,0,0,0,0,0,0,0,0,0,0,0,0,0,0,0,0,0,0,0,0,0,0,0,0,0,0,0,0,0,0,0,0,0,0,0,0,0,0,1,0,0,0,Abou Diaby,£4.50m ,34,191,Midfielder - Central Midfield,right,Retired,20,2,3,1257,6,1,0,158,16,0,1,1130,2,0,0,61,6,0,1,388,4,0,0,225,2,0,0,130,nan,nan,nan,nan,nan,nan,nan,nan,Premier League,nan,nan,nan,nan,nan,nan,nan,nan
13/6/2011,Yonathan Del Valle,86005931,1658,5/28/1990,21,9,0,18,6,3250,5500,5250,142,109,2582166,177,74,S ,2,2,1,3,1,3,1,1,1,2,2,9,12,13,11,14,6,10,13,4,4,11,10,3,13,4,10,9,12,10,11,11,12,11,13,12,11,12,11,13,12,11,10,10,11,15,20,6,8,10,6,10,11,10,11,9,7,6,12,5,11,14,1,1,1,1,1,1,1,S ,600,1,1,20,1,1,1,1,1,1,1,1,1,1,1,1,0,0,0,0,0,0,0,0,0,0,0,0,0,0,0,0,0,0,0,0,0,0,0,0,0,0,0,0,0,0,0,0,0,0,0,0,0,0,0,0,0,0,0,0,0,0,0,0,0,Yonathan Del Valle,£180Th. ,30,173,Forward - Left Winger,right,Bandirmaspor,22,2,4,761,1,0,0,90,28,2,1,1211,34,6,3,2154,44,9,4,2955,35,7,6,2056,26,2,2,1772,33,8,5,2627,27,7,6,1834,Ligue 1,32,7,4,2603,7,3,0,620
13/6/2011,Walter,19026466,1651,7/22/1989,21,0,0,9,5,3750,6250,6250,148,125,13271238,176,86,S ,2,1,3,3,1,3,3,3,3,2,3,8,12,12,14,11,13,12,14,9,6,11,12,7,12,14,13,14,14,9,10,12,9,13,7,13,9,10,13,12,10,14,9,11,7,14,20,13,14,13,8,12,12,9,9,15,7,7,6,8,8,15,1,1,1,1,1,1,1,S ,600,1,1,20,1,1,1,1,1,1,1,1,1,1,1,1,512,0,0,0,0,0,0,0,0,0,1,0,0,0,0,0,0,0,0,0,0,0,0,0,0,0,0,0,0,0,0,0,0,0,0,0,0,0,0,0,0,0,0,0,0,0,0,0,0,Walter,£2.70m ,31,178,Forward - Centre-Forward,right,Club Athletico Paranaense,25,10,3,954,36,21,3,2373,32,13,6,2649,24,2,2,1120,36,10,8,2879,30,6,5,1979,25,5,2,1996,15,2,2,808,nan,nan,nan,nan,Liga NOS,8,1,0,159,nan,nan,nan,nan
13/6/2011,Vedran Vinko,64003619,795,2/22/1990,21,0,0,4,0,2700,5600,4850,137,108,893383,172,68,S ,1,2,2,2,2,2,1,4,1,1,2,5,12,15,12,12,7,5,10,6,4,11,11,5,13,12,12,10,11,10,12,10,14,16,5,13,5,7,12,15,13,9,6,9,15,15,20,12,9,14,6,14,7,14,11,13,14,3,14,13,14,8,1,1,11,12,8,12,11,S ,600,1,1,20,11,12,8,1,1,1,1,1,11,6,1,1,5.84116E+11,0,0,0,0,1,0,0,0,0,0,1,0,0,0,0,0,0,0,0,0,0,0,0,0,0,0,0,0,0,0,0,0,0,0,0,1,0,0,0,1,0,0,0,0,0,0,0,0,,,,,,,,,,,,,,,,,,,,,,,,,,,,,,,,,,,,,,,,,,,,,,,,,,,,
13/6/2011,Valčre Germain,34001054,769,4/17/1990,21,0,0,0,0,1150,2350,2350,128,94,209217,182,75,AM/S C,1,3,2,2,2,3,1,3,2,3,2,5,8,12,11,13,7,14,11,5,4,9,10,3,13,7,12,13,12,12,12,11,14,12,7,12,6,13,14,12,11,13,12,5,14,10,20,9,13,12,7,13,5,16,8,13,16,12,14,14,14,6,8,8,12,18,10,1,18,AM/S C,621,1,1,20,18,1,10,1,1,8,12,12,1,10,1,8,0,0,0,0,0,0,0,0,0,0,0,0,0,0,0,0,0,0,0,0,0,0,0,0,0,0,0,0,0,0,0,0,0,0,0,0,0,0,0,0,0,0,0,0,0,0,0,0,0,,,,,,,,,,,,,,,,,,,,,,,,,,,,,,,,,,,,,,,,,,,,,,,,,,,,
13/6/2011,Urreta,78016324,1657,3/19/1990,21,0,0,6,2,4000,5950,5750,143,127,2243605,174,62,AM RL,2,3,1,2,1,1,3,5,1,1,1,13,13,13,11,10,13,7,9,7,4,10,13,4,13,12,9,7,9,5,11,8,12,15,9,12,4,8,6,17,15,6,5,10,14,14,20,13,3,8,9,10,9,13,11,15,5,10,10,8,14,13,1,1,11,20,20,16,10,AM RL,505,1,1,15,10,16,20,1,1,1,1,1,7,11,1,1,1.41837E+14,0,0,0,0,1,0,0,0,0,0,0,0,0,0,0,0,0,0,0,0,0,0,0,0,0,0,0,1,0,0,0,0,0,0,0,0,0,0,0,0,1,0,0,0,0,0,0,1,,,,,,,,,,,,,,,,,,,,,,,,,,,,,,,,,,,,,,,,,,,,,,,,,,,,
13/6/2011,Tunay Torun,35018672,799,4/21/1990,21,1,0,5,0,3750,5750,5950,142,109,2392891,179,72,AM/S RLC,3,3,2,2,2,1,3,3,2,1,3,7,9,14,11,14,10,6,7,4,4,13,9,6,15,8,10,5,11,8,12,10,6,14,4,12,6,7,8,14,13,9,8,20,14,12,10,9,11,10,11,8,5,10,7,12,10,14,10,4,6,17,1,1,14,20,16,15,20,AM/S RLC,516,1,1,17,20,15,16,1,1,1,1,10,10,14,1,1,0,0,0,0,0,0,0,0,0,0,0,0,0,0,0,0,0,0,0,0,0,0,0,0,0,0,0,0,0,0,0,0,0,0,0,0,0,0,0,0,0,0,0,0,0,0,0,0,0,Tunay Torun,£1.13m ,30,176,Forward - Right Winger,right,Caykur Rizespor,10,3,2,645,25,5,0,1214,16,1,1,723,17,3,1,550,31,5,9,2287,32,2,6,1874,29,3,7,2041,11,0,1,554,26,0,2,1316,Bundesliga,9,1,0,426,3,0,0,79
13/6/2011,Tommy Untereiner,85007147,769,6/30/1989,21,0,0,0,0,1000,3000,3000,109,92,114695,183,76,S ,2,3,3,2,2,2,1,2,2,1,3,6,8,11,9,11,3,12,14,3,4,9,12,2,11,9,10,11,12,12,7,9,9,11,6,11,6,10,12,13,10,13,11,8,15,11,20,13,13,12,9,14,7,8,6,2,15,5,15,14,5,8,1,1,1,13,1,1,13,S ,600,1,1,20,13,1,1,1,1,1,1,1,1,1,1,1,0,0,0,0,0,0,0,0,0,0,0,0,0,0,0,0,0,0,0,0,0,0,0,0,0,0,0,0,0,0,0,0,0,0,0,0,0,0,0,0,0,0,0,0,0,0,0,0,0,,,,,,,,,,,,,,,,,,,,,,,,,,,,,,,,,,,,,,,,,,,,,,,,,,,,
13/6/2011,Tommy Kind,35023248,771,7/8/1989,21,0,0,0,0,450,2900,2900,80,58,2647,190,87,M/AM/S RC,1,3,1,2,2,3,1,1,1,1,2,4,6,8,11,8,6,12,5,3,5,11,4,6,10,7,6,7,8,6,10,9,11,6,4,12,5,8,8,11,9,11,15,7,11,9,20,10,8,5,4,7,6,7,5,8,13,8,10,12,11,4,1,1,16,20,17,1,20,M/AM/S RC,533,1,1,17,20,1,17,1,1,1,1,16,1,14,1,1,0,0,0,0,0,0,0,0,0,0,0,0,0,0,0,0,0,0,0,0,0,0,0,0,0,0,0,0,0,0,0,0,0,0,0,0,0,0,0,0,0,0,0,0,0,0,0,0,0,,,,,,,,,,,,,,,,,,,,,,,,,,,,,,,,,,,,,,,,,,,,,,,,,,,,
13/6/2011,Thomas Müller,35011448,771,9/13/1989,21,18,7,6,1,7250,8700,8700,172,164,229999992,186,74,AM RLC,3,1,1,2,3,1,1,7,2,3,3,7,10,11,14,13,7,12,9,8,7,12,11,8,12,15,18,12,17,13,15,18,18,16,7,19,10,18,17,16,14,17,13,11,18,14,20,17,11,12,9,16,7,18,4,12,17,18,14,12,17,4,1,1,14,20,19,16,20,AM RLC,506,1,1,15,20,16,19,1,1,1,1,10,14,14,1,1,1573936,0,0,0,0,1,1,0,0,0,0,1,0,0,0,0,0,0,0,0,1,1,0,0,0,0,0,0,0,0,0,0,0,0,0,0,0,0,0,0,0,0,0,0,0,0,0,0,0,Thomas MÃ¼ller,£28.80m ,31,186,Forward - Second Striker,right,Bayern Munich,48,19,19,3942,53,11,20,3913,47,23,17,3571,51,26,14,3575,48,21,18,3579,49,32,12,3820,42,9,17,3004,45,15,18,3125,45,9,16,3251,Bundesliga,50,14,26,3499,9,5,5,775
13/6/2011,Teemu Pukki,8507078,768,3/29/1990,21,3,0,22,6,5000,5750,5750,148,118,2999998,176,67,S ,3,3,2,2,3,2,1,7,2,2,3,8,10,13,13,10,11,9,11,1,1,13,14,1,14,9,13,13,13,12,14,14,14,15,7,15,4,11,10,13,12,9,9,15,14,14,20,11,8,14,6,11,8,8,14,15,12,12,14,13,14,8,1,1,1,9,1,1,9,S ,600,1,1,20,9,1,1,1,1,1,1,1,1,1,1,1,5.80542E+14,0,0,0,1,0,0,0,0,1,0,0,0,0,0,0,0,0,0,0,0,0,0,0,0,0,0,0,0,0,0,0,0,0,0,0,0,0,0,0,0,0,0,0,0,1,0,0,0,Teemu Pukki,£3.15m ,30,180,Forward - Centre-Forward,right,Norwich City,19,11,8,1298,27,10,3,1133,24,3,2,809,35,7,2,1538,35,13,2,2798,44,13,1,3464,46,29,10,3531,44,19,11,3324,46,30,10,3854,Bundesliga,38,11,3,2995,7,2,1,545
13/6/2011,Stevan Jovetic,5789007,62002127,11/2/1989,21,14,6,6,2,6500,7850,7600,176,152,50253386,183,79,AM/S LC,2,1,2,1,2,1,2,7,2,3,1,10,13,16,14,16,12,12,13,10,7,16,8,6,17,12,14,11,12,12,16,13,13,14,12,14,7,14,14,15,14,13,12,12,14,14,20,12,11,15,10,16,8,10,15,15,13,16,16,14,16,5,1,1,1,18,12,16,18,AM/S LC,624,1,1,20,18,16,12,1,1,1,1,1,1,1,1,1,134218256,0,0,0,0,1,0,0,0,0,1,0,0,0,0,0,0,0,0,0,0,0,0,0,0,0,0,0,1,0,0,0,0,0,0,0,0,0,0,0,0,0,0,0,0,0,0,0,0,Stevan Jovetic,£22.50m ,30,183,Forward - Centre-Forward,right,AS Monaco,nan,nan,nan,nan,29,14,3,2524,34,13,5,2750,18,6,2,578,26,5,4,1184,28,7,4,1715,29,7,5,1449,21,10,2,1103,10,2,1,493,Serie A,13,2,1,611,7,0,0,189
13/6/2011,Sloan Privat,34001550,769,7/24/1989,21,0,0,1,0,4500,5600,5600,145,124,4464155,186,83,S ,3,1,3,3,2,2,1,3,3,2,3,4,7,11,14,12,11,16,13,5,5,10,15,4,12,9,13,13,14,13,10,11,15,14,6,13,7,12,12,14,13,15,13,20,13,11,8,14,15,14,9,14,8,5,7,14,14,13,13,14,14,7,1,1,1,10,1,10,1,S ,600,1,1,20,1,10,1,1,1,1,1,1,1,1,1,1,3.51844E+13,0,0,0,0,0,0,0,0,0,0,0,0,0,0,0,0,0,0,1,0,0,0,0,1,0,0,0,0,0,0,0,0,0,0,0,0,0,0,0,0,0,0,0,0,0,1,0,0,Sloan Privat,£1.58m ,31,186,Forward - Centre-Forward,right,Without Club,40,22,5,3388,34,5,2,1404,36,10,2,1955,26,4,0,1020,22,7,1,1132,32,9,1,1694,23,5,1,1087,13,3,1,741,7,0,0,220,Ligue 1,6,0,0,48,nan,nan,nan,nan
13/6/2011,Simone Guerra,43006969,776,8/30/1989,21,0,0,0,0,500,5150,5150,130,108,1613553,178,70,AM RL,1,1,3,1,3,1,1,1,1,3,3,6,10,12,10,10,9,7,11,3,4,14,13,6,10,11,7,13,10,8,11,12,12,12,4,13,5,14,15,13,12,11,7,8,14,13,20,11,9,14,6,14,4,14,10,14,9,8,14,10,7,3,1,1,14,20,20,20,1,AM RL,505,1,1,15,1,20,20,1,1,1,1,1,14,14,1,1,0,0,0,0,0,0,0,0,0,0,0,0,0,0,0,0,0,0,0,0,0,0,0,0,0,0,0,0,0,0,0,0,0,0,0,0,0,0,0,0,0,0,0,0,0,0,0,0,0,Simone Perrotta,£720Th. ,43,178,Midfielder - Attacking Midfield,right,Retired,35,4,2,2692,23,1,0,961,17,2,1,588,nan,nan,nan,nan,nan,nan,nan,nan,nan,nan,nan,nan,nan,nan,nan,nan,nan,nan,nan,nan,nan,nan,nan,nan,Serie A,nan,nan,nan,nan,nan,nan,nan,nan
13/6/2011,Sercan Sararer,35012153,796,11/27/1989,21,0,0,0,0,2200,5354,5750,138,119,901626,180,84,AM/S RL,1,2,2,2,2,1,3,3,2,2,1,5,9,14,12,13,8,11,10,17,4,10,10,6,14,15,10,11,11,8,8,9,15,15,4,10,4,7,10,14,14,15,10,10,16,15,20,10,14,7,8,14,12,10,10,9,12,13,7,11,13,12,1,1,10,20,20,19,14,AM/S RL,515,1,1,19,14,19,20,1,1,1,1,1,10,10,1,1,2.25183E+15,0,0,0,0,0,0,0,0,0,0,0,0,0,0,0,0,0,0,0,0,0,0,0,0,0,0,0,0,0,0,0,0,0,0,0,1,0,0,0,0,0,0,0,0,0,0,0,0,,,,,,,,,,,,,,,,,,,,,,,,,,,,,,,,,,,,,,,,,,,,,,,,,,,,
13/6/2011,Sebastian Latowski,92017803,771,3/31/1990,21,0,0,0,0,1000,3500,3500,100,70,157364,183,74,S C,3,2,1,1,1,2,2,6,3,1,1,6,8,10,7,13,4,11,6,4,3,11,9,9,8,8,8,4,7,11,10,10,8,12,6,13,8,8,11,9,13,13,10,5,11,13,20,6,6,10,15,9,17,9,14,13,11,10,13,6,14,4,1,1,1,15,14,14,15,S C,601,1,1,20,15,14,14,1,1,1,1,1,1,1,1,1,0,0,0,0,0,0,0,0,0,0,0,0,0,0,0,0,0,0,0,0,0,0,0,0,0,0,0,0,0,0,0,0,0,0,0,0,0,0,0,0,0,0,0,0,0,0,0,0,0,Sebastian Usai,- ,30,190,Goalkeeper,right,Friska Viljor FC,4,11,0,360,5,2,4,450,15,23,5,1350,5,12,1,450,0,0,0,0,nan,nan,nan,nan,nan,nan,nan,nan,nan,nan,nan,nan,nan,nan,nan,nan,Premier League,nan,nan,nan,nan,nan,nan,nan,nan
13/6/2011,Sam Vokes,29001407,801,10/21/1989,21,18,2,14,4,3200,6000,5600,138,115,4359444,188,76,S ,3,1,1,2,2,2,2,1,2,2,2,2,8,9,12,11,4,17,10,2,4,12,10,4,13,10,11,10,15,9,10,11,13,12,8,11,11,12,14,11,10,10,16,9,11,11,20,10,17,14,4,12,5,9,13,11,12,12,18,17,18,17,1,1,1,1,1,1,1,S ,600,1,1,20,1,1,1,1,1,1,1,1,1,1,1,1,262656,0,0,0,0,0,0,0,0,0,1,0,0,0,0,0,0,0,0,1,0,0,0,0,0,0,0,0,0,0,0,0,0,0,0,0,0,0,0,0,0,0,0,0,0,0,0,0,0,Sam Vokes,£675Th. ,31,186,Forward - Centre-Forward,right,Stoke City,16,2,0,579,32,7,3,1573,49,4,2,1821,44,21,4,3808,17,1,0,680,46,16,5,3688,42,12,4,2465,32,4,2,1140,40,7,1,2190,Premier League,41,7,2,2047,5,1,0,266
13/6/2011,Salomón Rondón,67063933,1658,9/16/1989,21,16,5,3,4,5750,7250,7000,160,139,19999999,190,86,S ,2,2,2,2,2,2,3,4,3,3,2,5,10,14,15,10,5,15,12,5,6,13,11,6,14,12,14,16,11,12,9,12,12,12,11,14,7,13,15,14,14,16,15,8,18,14,20,15,16,13,11,12,5,11,12,16,10,11,14,12,10,9,1,1,1,9,9,7,9,S ,600,1,1,20,9,7,9,1,1,1,1,1,1,1,1,1,142606848,0,0,0,0,0,0,0,0,0,1,0,0,0,0,0,0,0,0,0,0,0,0,0,1,0,0,0,1,0,0,0,0,0,0,0,0,0,0,0,0,0,0,0,0,0,0,0,0,Salomón Rondón,£8.10m ,31,186,Forward - Centre-Forward,right,Dalian Professional,32,16,3,2602,40,11,4,2553,37,12,2,2834,31,20,5,2311,44,20,4,2866,42,10,4,3106,40,8,2,3021,40,10,4,3066,45,17,10,3465,LaLiga,16,9,4,1434,nan,nan,nan,nan
13/6/2011,Rui Fonte,55003130,788,4/23/1990,21,0,0,0,0,3750,5444,5750,155,121,2506884,180,73,AM/S C,1,3,1,1,2,3,2,5,1,1,1,6,11,13,13,13,13,12,9,7,5,11,10,6,14,11,10,13,10,6,10,10,9,14,8,15,5,8,13,15,11,10,11,13,13,15,20,12,12,12,11,7,7,10,9,13,15,5,14,13,11,1,1,1,10,20,10,13,20,AM/S C,511,1,1,17,20,13,10,1,1,1,1,10,9,1,1,1,8.79953E+13,0,0,0,0,0,0,0,0,0,0,0,0,0,0,0,0,0,0,0,1,0,0,0,0,0,0,0,0,0,0,0,0,0,0,0,1,0,0,0,0,0,0,0,0,1,0,1,0,Rui Fonte,£1.26m ,30,180,Forward - Centre-Forward,right,SC Braga,9,0,1,73,24,3,1,889,13,0,0,665,4,1,0,218,35,19,3,2963,28,8,3,1622,38,15,3,3043,32,5,5,1845,21,1,0,738,LaLiga,37,6,4,1286,nan,nan,nan,nan
13/6/2011,Ronny Rodelin,85006064,769,11/18/1989,21,0,0,0,0,3400,5150,5150,140,114,2958833,192,70,S ,1,3,2,3,3,2,3,1,3,1,1,5,8,13,12,13,12,14,14,5,4,10,12,3,15,7,12,11,10,11,10,10,14,16,5,13,6,8,12,14,13,15,16,5,13,12,20,13,12,11,7,14,9,8,10,16,11,13,11,13,13,10,5,5,10,12,12,10,1,S ,600,1,1,20,1,10,12,1,1,5,1,1,10,10,1,5,4.43241E+12,0,0,0,0,1,0,0,0,0,1,0,0,0,0,0,0,0,0,0,0,0,0,0,0,0,0,0,0,0,0,0,0,0,0,0,1,0,0,0,0,0,0,1,0,0,0,0,0,Ronny Rodelin,£1.13m ,30,192,Forward - Right Winger,right,EA Guingamp,18,5,0,1331,15,0,0,136,32,4,6,2091,35,4,3,1504,35,3,3,2104,37,10,2,3068,40,11,4,3078,43,6,6,3645,24,1,1,1113,Ligue 1,26,6,6,1945,6,0,0,444
13/6/2011,Rodri,67131769,796,6/6/1990,21,0,0,2,1,3000,5350,5350,144,110,3889469,178,70,S ,1,3,1,2,3,2,1,4,3,3,1,5,7,12,15,11,10,12,10,3,5,11,10,5,11,11,12,13,7,13,11,13,10,13,15,16,5,11,14,12,15,8,7,12,8,13,20,13,9,11,7,15,10,10,13,13,11,11,7,11,13,5,1,1,1,1,1,1,1,S ,600,1,1,20,1,1,1,1,1,1,1,1,1,1,1,1,0,0,0,0,0,0,0,0,0,0,0,0,0,0,0,0,0,0,0,0,0,0,0,0,0,0,0,0,0,0,0,0,0,0,0,0,0,0,0,0,0,0,0,0,0,0,0,0,0,Rodrigo,£6.30m ,29,182,Forward - Centre-Forward,left,Leeds United,24,3,1,928,38,16,4,1874,39,11,5,2140,42,18,8,2666,32,4,5,2161,38,7,3,2175,21,7,5,1588,44,19,7,2994,51,15,10,3775,Liga NOS,34,7,11,2506,7,1,0,410
13/6/2011,Richard Steiner,35021039,771,10/1/1989,21,0,0,0,0,700,1850,1850,100,60,719,188,80,AM C,3,1,3,1,1,1,1,1,3,2,3,3,6,12,9,11,1,7,5,3,8,10,6,4,9,9,8,3,3,5,9,10,8,8,12,8,8,7,10,12,12,12,11,8,15,12,20,5,3,10,4,9,11,9,5,7,15,14,18,15,13,18,1,1,15,20,1,1,20,AM C,501,1,1,15,20,1,1,1,1,1,1,15,1,1,1,1,0,0,0,0,0,0,0,0,0,0,0,0,0,0,0,0,0,0,0,0,0,0,0,0,0,0,0,0,0,0,0,0,0,0,0,0,0,0,0,0,0,0,0,0,0,0,0,0,0,Richard Strebinger,£135Th. ,27,194,Goalkeeper,right,Rapid Vienna,23,34,6,2024,16,32,2,1401,22,30,5,1948,14,9,8,1260,21,30,6,1810,31,38,10,2673,22,28,4,1980,38,47,13,3450,49,67,17,4470,Bundesliga,22,26,6,1896,10,11,3,900
13/6/2011,Rasmus Jönsson,68007433,797,1/27/1990,21,0,0,9,2,6000,6000,6000,137,122,18630459,191,67,AM/S R,2,1,2,1,1,3,3,1,2,2,3,6,11,12,13,14,6,9,8,4,5,13,8,6,14,5,14,7,14,15,15,14,11,11,8,14,8,12,12,12,13,9,15,7,14,15,20,12,7,15,5,11,3,6,9,10,17,13,16,15,17,4,1,1,14,16,16,12,10,AM/S R,622,1,1,20,10,12,16,1,1,1,1,1,8,14,1,1,1.75922E+13,0,0,0,0,1,0,0,0,0,0,0,0,0,0,0,0,0,0,0,0,0,0,0,0,0,0,0,0,0,0,0,0,0,0,0,0,0,0,0,0,0,0,0,0,1,0,0,0,Rasmus Jönsson,£2.03m ,30,192,Forward - Centre-Forward,right,Helsingborgs IF,25,10,4,2167,15,1,1,710,12,1,0,404,20,6,6,1299,16,1,0,822,36,4,4,2403,38,13,4,2887,37,5,5,2624,16,4,0,1253,Bundesliga,23,3,0,1542,nan,nan,nan,nan
13/6/2011,Rabiola,55008636,788,7/25/1989,21,0,0,0,0,1500,5000,5000,137,106,2181935,180,75,S ,3,2,2,3,3,2,1,5,2,3,1,11,12,12,14,13,10,12,11,8,8,11,11,8,13,7,11,10,12,12,11,11,13,10,9,12,9,11,12,12,11,12,15,7,12,12,20,11,12,10,6,10,7,7,6,13,16,11,14,14,14,5,1,1,1,10,10,1,7,S ,600,1,1,20,7,1,10,1,1,1,1,1,1,1,1,1,0,0,0,0,0,0,0,0,0,0,0,0,0,0,0,0,0,0,0,0,0,0,0,0,0,0,0,0,0,0,0,0,0,0,0,0,0,0,0,0,0,0,0,0,0,0,0,0,0,Rabiola,£720Th. ,31,182,Forward - Centre-Forward,right,AD Fafe,20,9,1,1524,10,1,1,675,44,23,0,3430,16,0,1,629,30,8,4,1848,25,2,2,1038,nan,nan,nan,nan,0,0,0,0,1,0,0,71,Liga NOS,1,1,0,90,nan,nan,nan,nan
13/6/2011,Pierre-Emerick Aubameyang,43017197,19,6/18/1989,21,16,4,0,0,5000,6250,5600,145,126,836804,185,74,AM/S R,3,2,2,1,2,2,1,5,1,3,2,5,9,12,9,10,9,11,10,7,4,10,12,3,12,7,11,9,9,10,11,9,15,14,5,13,6,11,13,18,14,14,12,8,14,16,20,15,13,11,7,14,6,8,13,14,12,11,13,15,15,7,1,1,10,17,17,13,1,AM/S R,622,1,1,20,1,13,17,1,1,1,1,1,10,10,1,1,8208,0,0,0,0,1,0,0,0,0,0,0,0,0,1,0,0,0,0,0,0,0,0,0,0,0,0,0,0,0,0,0,0,0,0,0,0,0,0,0,0,0,0,0,0,0,0,0,0,Pierre-Emerick Aubameyang,£6.30m ,31,187,Forward - Centre-Forward,right,Arsenal FC,37,4,3,2529,38,18,11,3299,45,21,14,3850,48,16,5,2653,46,25,11,3813,49,39,12,3931,46,40,5,3959,38,31,7,3316,51,31,8,3859,Ligue 1,44,29,3,3725,8,3,1,659
13/6/2011,Patrick Schönfeld,91014480,771,6/21/1989,21,0,0,0,0,3000,4750,4750,112,90,1070040,186,82,AM/S RC,1,2,3,2,1,2,3,1,3,3,3,8,10,9,8,8,8,13,13,5,8,10,3,6,13,6,13,10,6,9,8,11,10,11,10,11,9,14,12,11,11,11,11,10,15,13,20,8,5,10,7,8,7,10,4,15,15,7,16,19,14,7,1,1,1,19,19,12,15,AM/S RC,623,1,1,20,15,12,19,1,1,1,1,1,1,1,1,1,0,0,0,0,0,0,0,0,0,0,0,0,0,0,0,0,0,0,0,0,0,0,0,0,0,0,0,0,0,0,0,0,0,0,0,0,0,0,0,0,0,0,0,0,0,0,0,0,0,,,,,,,,,,,,,,,,,,,,,,,,,,,,,,,,,,,,,,,,,,,,,,,,,,,,
13/6/2011,Pato,2111393,1651,9/2/1989,21,16,6,18,10,8000,8250,8400,180,168,102197420,179,78,S ,2,3,1,2,3,3,3,5,2,3,1,5,11,17,16,16,12,13,14,7,3,13,14,4,16,13,14,11,15,12,14,13,15,16,11,17,5,10,12,17,16,13,9,14,12,18,20,13,11,14,7,13,17,13,16,18,15,10,13,13,14,6,1,1,1,14,14,12,11,S ,600,1,1,20,11,12,14,1,1,1,1,1,1,1,1,1,7.03689E+13,0,0,0,1,1,0,0,0,0,0,0,0,0,0,0,0,0,0,0,0,0,0,0,0,0,0,0,1,0,0,0,0,0,0,0,0,0,0,0,0,0,0,0,0,0,0,1,0,,,,,,,,,,,,,,,,,,,,,,,,,,,,,,,,,,,,,,,,,,,,,,,,,,,,
13/6/2011,Ömer Kanca,91002957,799,12/24/1989,21,0,0,0,0,2700,2500,4000,103,80,12127,177,75,AM/S RL,1,1,1,3,1,2,1,1,1,1,3,7,10,10,11,7,7,7,5,1,1,11,7,8,8,5,9,5,11,11,6,6,10,8,8,9,2,5,9,11,11,11,6,16,11,11,20,4,3,10,10,10,10,10,4,10,12,7,9,8,8,5,1,1,15,18,18,18,12,AM/S RL,625,1,1,20,12,18,18,1,1,1,1,1,15,15,1,1,0,0,0,0,0,0,0,0,0,0,0,0,0,0,0,0,0,0,0,0,0,0,0,0,0,0,0,0,0,0,0,0,0,0,0,0,0,0,0,0,0,0,0,0,0,0,0,0,0,,,,,,,,,,,,,,,,,,,,,,,,,,,,,,,,,,,,,,,,,,,,,,,,,,,,
13/6/2011,Omar Wade,85055653,41,5/15/1990,21,0,0,0,0,1350,5400,2700,140,108,2174361,180,75,S ,2,3,2,1,3,1,1,8,2,3,2,5,7,11,13,10,12,12,11,5,3,7,14,3,11,6,12,10,15,11,7,12,14,12,6,13,5,6,8,14,14,13,10,10,11,13,20,11,12,13,6,14,13,5,15,15,1,7,13,13,13,11,1,1,13,13,10,13,1,S ,600,1,1,20,1,13,10,1,1,1,1,1,13,10,1,1,0,0,0,0,0,0,0,0,0,0,0,0,0,0,0,0,0,0,0,0,0,0,0,0,0,0,0,0,0,0,0,0,0,0,0,0,0,0,0,0,0,0,0,0,0,0,0,0,0,Omar Wade,£90Th. ,30,180,Forward - Centre-Forward,right,Annecy FC,2,0,0,1,9,0,0,345,15,1,1,402,nan,nan,nan,nan,nan,nan,nan,nan,nan,nan,nan,nan,nan,nan,nan,nan,nan,nan,nan,nan,nan,nan,nan,nan,Ligue 1,nan,nan,nan,nan,5,1,0,265
13/6/2011,Odion Ighalo,12009301,38,6/16/1989,21,0,0,0,0,5000,5800,6000,160,128,1284111,188,70,S ,3,2,3,3,1,3,1,2,2,2,1,5,7,17,14,12,2,12,5,2,2,10,8,2,15,10,12,12,10,10,9,12,12,18,6,13,8,12,12,17,12,15,14,9,14,14,20,10,14,12,8,18,3,10,16,11,9,10,14,12,12,10,1,1,1,10,10,1,10,S ,600,1,1,20,10,1,10,1,1,1,1,1,1,1,1,1,2.25403E+15,0,0,0,0,0,0,0,0,0,1,0,0,1,0,0,0,0,0,0,0,0,0,0,0,0,0,0,0,0,0,0,0,0,0,0,1,0,0,0,0,0,1,0,0,0,0,0,0,Odion Ighalo,£1.80m ,31,181,Forward - Centre-Forward,right,Manchester United,29,5,0,1300,30,6,3,1718,30,6,3,1878,18,4,0,556,38,20,5,2178,42,18,5,3382,47,17,8,3858,28,21,1,2424,19,10,0,1351,LaLiga,19,5,1,629,3,0,0,157
13/6/2011,Nabil Ghilas,85050729,769,4/20/1990,21,0,0,0,0,500,2150,3000,110,73,9115,185,80,S ,3,2,1,1,1,1,1,1,3,2,1,7,6,7,8,8,5,11,10,2,1,5,12,1,8,7,8,13,9,6,5,10,11,10,9,11,3,7,11,12,8,13,11,20,15,11,8,10,13,12,6,9,8,10,14,18,9,4,12,7,7,9,1,1,5,10,1,10,10,S ,600,1,1,20,10,10,1,1,1,1,1,1,5,1,1,1,0,0,0,0,0,0,0,0,0,0,0,0,0,0,0,0,0,0,0,0,0,0,0,0,0,0,0,0,0,0,0,0,0,0,0,0,0,0,0,0,0,0,0,0,0,0,0,0,0,,,,,,,,,,,,,,,,,,,,,,,,,,,,,,,,,,,,,,,,,,,,,,,,,,,,
13/6/2011,Mouhamed Soly,85040246,41,11/25/1989,21,0,0,0,0,1700,4679,3400,127,104,456601,185,77,S ,1,3,3,2,1,2,1,1,1,2,3,5,6,11,12,10,6,12,9,5,4,8,11,2,11,7,11,10,11,9,9,8,13,14,5,13,4,8,8,15,13,14,12,5,12,14,20,13,14,13,7,13,6,5,12,13,12,9,8,11,11,15,1,1,1,10,1,1,10,S ,600,1,1,20,10,1,1,1,1,1,1,1,1,1,1,1,16,0,0,0,0,1,0,0,0,0,0,0,0,0,0,0,0,0,0,0,0,0,0,0,0,0,0,0,0,0,0,0,0,0,0,0,0,0,0,0,0,0,0,0,0,0,0,0,0,,,,,,,,,,,,,,,,,,,,,,,,,,,,,,,,,,,,,,,,,,,,,,,,,,,,
13/6/2011,Mickaël Alphonse,85052147,769,7/12/1989,21,0,0,0,0,850,2400,2400,125,96,127561,182,75,S ,3,2,2,3,2,3,2,6,1,1,1,6,7,10,8,12,7,12,8,5,2,8,9,2,10,9,11,13,7,11,7,9,13,11,6,12,3,9,12,17,12,13,12,5,13,13,20,15,12,13,9,14,9,8,6,14,13,14,13,15,15,6,1,1,1,1,1,1,1,S ,600,1,1,20,1,1,1,1,1,1,1,1,1,1,1,1,16,0,0,0,0,1,0,0,0,0,0,0,0,0,0,0,0,0,0,0,0,0,0,0,0,0,0,0,0,0,0,0,0,0,0,0,0,0,0,0,0,0,0,0,0,0,0,0,0,,,,,,,,,,,,,,,,,,,,,,,,,,,,,,,,,,,,,,,,,,,,,,,,,,,,
13/6/2011,Mathieu Manset,85044057,769,8/5/1989,21,0,0,0,0,1550,4499,5000,125,100,1207500,187,85,S ,1,2,3,1,1,1,2,1,3,2,1,5,8,10,9,9,6,13,9,5,5,9,11,3,11,15,9,15,8,7,11,7,13,11,6,10,7,9,12,14,8,14,14,20,8,13,10,10,17,8,11,8,4,5,11,10,9,8,10,7,8,10,1,1,1,5,1,5,1,S ,600,1,1,20,1,5,1,1,1,1,1,1,1,1,1,1,512,0,0,0,0,0,0,0,0,0,1,0,0,0,0,0,0,0,0,0,0,0,0,0,0,0,0,0,0,0,0,0,0,0,0,0,0,0,0,0,0,0,0,0,0,0,0,0,0,,,,,,,,,,,,,,,,,,,,,,,,,,,,,,,,,,,,,,,,,,,,,,,,,,,,
13/6/2011,Martyn Waghorn,28005574,765,1/23/1990,21,0,0,0,0,3250,5665,5850,129,103,4631053,177,83,AM/S L,3,2,3,2,2,3,3,2,2,3,3,10,10,12,12,12,10,12,10,3,3,11,14,10,10,17,10,9,12,8,10,8,16,11,8,10,8,12,15,12,10,9,9,20,10,13,10,13,11,12,16,8,11,9,7,11,10,8,7,7,6,12,1,1,10,16,1,16,12,AM/S L,623,1,1,20,12,16,1,1,1,1,1,1,10,1,1,1,4.39912E+12,0,0,0,0,0,0,0,0,0,0,0,0,0,0,0,0,0,0,0,0,0,0,0,0,0,0,0,0,0,0,1,0,0,0,0,0,0,0,0,0,0,0,1,0,0,0,0,0,,,,,,,,,,,,,,,,,,,,,,,,,,,,,,,,,,,,,,,,,,,,,,,,,,,,
13/6/2011,Mario Gavranovic,69005559,798,11/24/1989,21,1,0,17,3,3700,6000,5950,156,119,2922955,175,68,S C,1,1,1,1,2,1,1,2,2,2,2,5,8,12,13,14,8,13,11,5,3,13,9,3,13,14,13,11,13,13,14,16,7,10,9,14,15,10,12,14,15,15,10,5,12,13,20,11,9,8,12,11,13,9,14,13,14,11,12,11,13,19,1,1,1,15,1,1,15,S C,601,1,1,20,15,1,1,1,1,1,1,1,1,1,1,1,0,0,0,0,0,0,0,0,0,0,0,0,0,0,0,0,0,0,0,0,0,0,0,0,0,0,0,0,0,0,0,0,0,0,0,0,0,0,0,0,0,0,0,0,0,0,0,0,0,Mario Gavranovic,£720Th. ,30,175,Forward - Centre-Forward,right,GNK Dinamo Zagreb,12,3,1,690,9,2,0,368,36,15,6,2525,40,19,7,3176,13,1,0,591,37,11,6,2483,36,18,6,2645,46,24,8,3569,40,12,7,2242,Bundesliga,30,7,2,1214,9,5,2,492
13/6/2011,Marcel Gaus,91014208,771,8/2/1989,21,0,0,0,0,3000,5300,5300,122,100,699928,181,76,AM/S L,2,1,2,2,3,3,1,3,1,2,3,10,12,11,11,14,9,14,7,5,4,9,9,9,12,6,12,3,11,9,8,12,7,10,5,8,6,8,12,14,12,13,12,20,8,13,8,8,6,10,10,8,7,10,5,16,11,5,14,7,14,11,1,1,1,18,1,18,1,AM/S L,623,1,1,20,1,18,1,1,1,1,1,1,1,1,1,1,0,0,0,0,0,0,0,0,0,0,0,0,0,0,0,0,0,0,0,0,0,0,0,0,0,0,0,0,0,0,0,0,0,0,0,0,0,0,0,0,0,0,0,0,0,0,0,0,0,,,,,,,,,,,,,,,,,,,,,,,,,,,,,,,,,,,,,,,,,,,,,,,,,,,,
13/6/2011,Kléber,19042340,1651,5/2/1990,21,0,0,0,0,4000,6119,6800,160,136,23833948,189,69,S ,3,3,1,3,2,1,1,6,3,1,2,10,10,11,15,12,10,15,13,8,6,11,12,6,12,10,16,14,11,13,12,12,14,11,10,15,10,11,12,15,12,15,15,9,14,12,20,12,15,12,5,12,10,8,14,14,10,12,14,14,14,5,1,1,1,5,1,1,5,S ,600,1,1,20,5,1,1,1,1,1,1,1,1,1,1,1,0,0,0,0,0,0,0,0,0,0,0,0,0,0,0,0,0,0,0,0,0,0,0,0,0,0,0,0,0,0,0,0,0,0,0,0,0,0,0,0,0,0,0,0,0,0,0,0,0,Kléber,£4.05m ,30,188,Forward - Centre-Forward,right,JEF United Chiba,20,8,1,1459,33,10,3,1826,15,2,0,730,15,3,0,1232,37,12,4,2320,4,0,0,186,31,10,3,1968,19,6,0,1502,44,20,5,3296,Liga NOS,18,3,0,1180,nan,nan,nan,nan
13/6/2011,Kike,67065538,796,11/25/1989,21,0,0,0,0,3250,5700,5700,138,115,1662111,186,79,S ,1,1,2,3,1,3,1,3,3,3,1,7,10,12,12,12,9,13,11,8,5,10,11,8,12,10,11,11,13,13,10,12,10,9,10,12,8,11,14,11,12,13,12,11,14,12,20,13,14,13,12,12,10,10,12,9,12,12,6,8,8,10,1,1,1,1,1,1,1,S ,600,1,1,20,1,1,1,1,1,1,1,1,1,1,1,1,0,0,0,0,0,0,0,0,0,0,0,0,0,0,0,0,0,0,0,0,0,0,0,0,0,0,0,0,0,0,0,0,0,0,0,0,0,0,0,0,0,0,0,0,0,0,0,0,0,Koke,£3.15m ,28,176,Midfielder - Central Midfield,right,Atlético Madrid,32,4,1,2128,40,2,6,1907,48,3,13,3391,58,7,18,4624,49,4,18,4195,51,5,17,4430,54,5,10,4694,51,6,7,4093,41,6,7,3511,LaLiga,42,5,6,3526,6,0,0,421
13/6/2011,Karim Bellarabi,92017768,771,4/8/1990,21,0,0,0,0,1500,6000,6000,135,115,3167792,183,76,AM/S R,2,1,2,3,3,1,3,5,1,2,3,12,14,14,12,14,10,13,12,5,8,14,10,9,12,14,13,9,14,6,13,12,10,10,10,12,10,8,13,15,13,12,10,3,17,14,20,10,6,10,8,10,6,10,17,16,11,18,15,17,6,14,1,1,14,20,20,1,1,AM/S R,512,1,1,18,1,1,20,1,1,1,1,1,1,14,1,1,0,0,0,0,0,0,0,0,0,0,0,0,0,0,0,0,0,0,0,0,0,0,0,0,0,0,0,0,0,0,0,0,0,0,0,0,0,0,0,0,0,0,0,0,0,0,0,0,0,Karim Bellarabi,£900Th. ,30,184,Forward - Right Winger,right,Bayer 04 Leverkusen,36,8,17,2944,14,2,0,386,11,2,3,658,29,3,5,1940,46,13,14,3939,49,12,14,3922,19,4,6,1349,29,2,4,1385,24,9,6,1428,Bundesliga,39,6,12,2233,6,2,1,353
13/6/2011,Junior Torunarigha,35026105,38,4/18/1990,21,0,0,0,0,1250,1750,3750,105,75,1293,191,92,S ,3,3,2,2,1,1,2,4,2,3,1,6,9,11,12,11,4,8,6,2,2,8,8,3,7,13,3,7,6,5,8,10,6,8,12,12,6,10,9,12,12,12,14,6,10,12,20,6,5,10,6,10,7,10,10,8,6,7,12,11,5,12,1,1,1,1,1,1,1,S ,600,1,1,20,1,1,1,1,1,1,1,1,1,1,1,1,0,0,0,0,0,0,0,0,0,0,0,0,0,0,0,0,0,0,0,0,0,0,0,0,0,0,0,0,0,0,0,0,0,0,0,0,0,0,0,0,0,0,0,0,0,0,0,0,0,,,,,,,,,,,,,,,,,,,,,,,,,,,,,,,,,,,,,,,,,,,,,,,,,,,,
13/6/2011,Junior Hoilett,28000482,364,6/5/1990,21,0,0,0,0,5000,7500,7250,158,137,12423828,173,70,AM/S RLC,1,2,2,2,3,1,2,5,3,1,1,7,7,14,10,11,7,3,12,5,3,10,10,3,14,8,9,10,9,11,10,7,12,16,4,13,7,11,11,17,14,9,6,11,16,16,20,12,8,10,3,10,5,14,10,19,8,10,14,15,15,14,1,1,14,20,20,15,16,AM/S RLC,516,1,1,17,16,15,20,1,1,1,1,1,12,14,1,1,2.25455E+15,0,0,0,0,0,0,0,0,1,0,0,0,0,0,0,0,0,0,0,0,0,0,0,0,0,0,0,1,0,0,0,0,0,0,0,0,0,0,0,1,0,1,0,0,0,0,0,0,Junior Hoilett,£8.10m ,30,174,Forward - Left Winger,right,Cardiff City,35,8,3,2457,37,7,7,3095,28,3,3,1598,39,4,7,2484,24,0,1,1013,31,6,2,2083,33,2,5,2421,50,11,12,4034,33,3,1,2142,Premier League,45,7,2,2696,8,0,1,557
13/6/2011,Jorge Mosquera,76003746,1653,4/22/1990,21,0,0,4,1,3350,2750,4650,115,93,369865,176,76,S ,3,2,3,2,2,2,2,1,3,1,1,4,7,12,10,13,9,7,10,4,3,10,12,3,12,8,9,12,9,8,12,8,12,13,6,12,9,8,9,14,14,12,8,10,11,13,20,10,8,8,13,7,8,5,8,9,7,10,9,8,8,12,1,1,1,1,1,1,1,S ,600,1,1,20,1,1,1,1,1,1,1,1,1,1,1,1,7.04031E+13,0,0,0,0,0,0,0,0,0,0,0,0,0,0,0,0,0,0,0,0,0,0,0,0,0,0,0,0,0,0,0,0,0,0,0,1,0,0,0,0,0,0,0,0,0,0,1,0,,,,,,,,,,,,,,,,,,,,,,,,,,,,,,,,,,,,,,,,,,,,,,,,,,,,
13/6/2011,Jonathan Kodjia,28032014,24,10/22/1989,21,0,0,0,0,1550,3100,3100,120,95,134394,189,77,S ,3,2,2,3,2,3,1,1,2,1,3,5,5,8,11,10,7,13,11,5,4,7,12,2,10,7,12,12,12,12,7,10,14,11,5,12,6,8,11,13,9,15,14,5,10,12,20,14,13,13,7,10,13,5,5,12,13,12,14,17,17,5,1,1,1,1,1,1,1,S ,600,1,1,20,1,1,1,1,1,1,1,1,1,1,1,1,0,0,0,0,0,0,0,0,0,0,0,0,0,0,0,0,0,0,0,0,0,0,0,0,0,0,0,0,0,0,0,0,0,0,0,0,0,0,0,0,0,0,0,0,0,0,0,0,0,Jonathan Woodgate,£1.35m ,40,188,Defender - Centre-Back,right,Retired,1,0,0,31,21,0,0,1639,25,1,0,1957,25,0,1,2040,9,1,0,598,1,0,0,98,nan,nan,nan,nan,nan,nan,nan,nan,nan,nan,nan,nan,Premier League,nan,nan,nan,nan,nan,nan,nan,nan
13/6/2011,Jonathan Franks,5128553,765,4/8/1990,21,0,0,0,0,1800,4900,4900,135,98,206991,178,73,AM/S R,3,1,2,2,2,1,1,3,3,3,3,11,11,11,12,9,10,7,8,6,7,10,3,6,12,7,11,7,9,8,7,9,5,10,6,9,7,10,10,17,14,10,7,6,11,14,20,8,6,7,2,10,9,11,8,13,7,7,14,16,8,5,1,1,15,18,18,12,1,AM/S R,622,1,1,20,1,12,18,1,1,1,1,1,12,15,1,1,268435456,0,0,0,0,0,0,0,0,0,0,0,0,0,0,0,0,0,0,0,0,0,0,0,0,0,0,0,0,1,0,0,0,0,0,0,0,0,0,0,0,0,0,0,0,0,0,0,0,,,,,,,,,,,,,,,,,,,,,,,,,,,,,,,,,,,,,,,,,,,,,,,,,,,,
13/6/2011,Joăo Silva,55021903,788,5/21/1990,21,0,0,0,0,2250,5250,5250,129,106,1970593,189,80,S ,2,1,3,1,3,3,3,3,2,3,1,10,10,11,13,12,9,14,8,6,6,8,13,6,11,11,15,10,12,12,10,12,13,11,10,13,7,10,11,11,12,14,14,8,13,11,20,12,13,12,6,11,7,6,13,12,13,13,14,14,14,5,1,1,1,1,1,1,1,S ,600,1,1,20,1,1,1,1,1,1,1,1,1,1,1,1,0,0,0,0,0,0,0,0,0,0,0,0,0,0,0,0,0,0,0,0,0,0,0,0,0,0,0,0,0,0,0,0,0,0,0,0,0,0,0,0,0,0,0,0,0,0,0,0,0,João Silva,£990Th. ,30,189,Forward - Centre-Forward,right,Nantong Zhiyun,15,4,0,910,28,6,3,1760,31,8,3,1291,47,8,5,3263,3,0,0,185,23,2,2,1005,20,0,0,496,34,7,0,2637,37,9,1,2137,Premier League,10,0,0,628,nan,nan,nan,nan
13/6/2011,Jô,55042167,1651,9/19/1989,21,0,0,0,0,500,2000,2000,132,110,594018,170,70,AM/S RL,2,1,1,1,2,3,3,4,3,3,2,9,10,12,10,12,8,5,9,5,4,9,10,5,13,10,13,9,9,8,9,9,13,15,6,14,5,8,10,15,14,6,4,10,14,15,20,8,6,9,5,10,9,11,12,1,3,8,14,13,14,6,1,1,9,20,20,17,13,AM/S RL,515,1,1,17,13,17,20,1,1,1,1,1,1,9,1,1,0,0,0,0,0,0,0,0,0,0,0,0,0,0,0,0,0,0,0,0,0,0,0,0,0,0,0,0,0,0,0,0,0,0,0,0,0,0,0,0,0,0,0,0,0,0,0,0,0,Jô,£720Th. ,32,170,Forward - Second Striker,both,NK Krsko,nan,nan,nan,nan,15,0,1,869,1,0,0,12,34,1,7,2510,23,2,2,1637,11,0,0,502,17,2,1,978,nan,nan,nan,nan,nan,nan,nan,nan,Liga NOS,nan,nan,nan,nan,3,0,0,165
13/6/2011,Jefferson Montero,80001392,1654,9/1/1989,21,9,2,0,0,4700,6700,6650,161,134,962913,169,64,AM RL,3,3,1,2,2,1,1,2,3,1,1,11,13,16,10,14,10,6,12,7,5,13,11,6,16,10,11,8,11,7,13,9,13,18,5,13,5,9,10,16,15,8,6,15,14,14,20,12,6,11,9,15,8,12,13,16,10,12,13,12,13,9,1,1,13,20,19,20,11,AM RL,505,1,1,15,11,20,19,1,1,1,1,1,13,13,1,1,5.49756E+11,0,0,0,0,1,0,0,0,0,0,0,0,0,0,0,0,0,0,0,0,0,0,0,0,0,0,0,0,0,0,0,0,0,0,0,0,0,0,0,1,0,0,0,0,0,0,0,0,Jefferson Montero,£2.25m ,31,170,Forward - Left Winger,right,Without Club,30,2,3,1224,33,1,3,2189,43,8,7,2537,29,7,5,1901,34,1,8,1867,25,1,2,1519,15,0,1,523,18,1,3,655,17,1,3,505,LaLiga,18,0,1,568,nan,nan,nan,nan
13/6/2011,Igor Martínez,67046027,796,7/19/1989,21,0,0,0,0,3750,5500,5500,142,114,3323638,170,65,AM/S RC,2,3,3,1,1,2,3,3,2,3,1,8,12,12,12,10,5,11,10,5,7,11,10,6,12,12,11,12,10,10,12,12,12,14,9,13,7,12,13,14,13,11,6,8,12,14,20,13,11,9,5,9,7,11,12,13,12,15,8,7,8,4,1,1,6,20,16,13,20,AM/S RC,513,1,1,18,20,13,16,1,1,1,1,6,1,1,1,1,0,0,0,0,0,0,0,0,0,0,0,0,0,0,0,0,0,0,0,0,0,0,0,0,0,0,0,0,0,0,0,0,0,0,0,0,0,0,0,0,0,0,0,0,0,0,0,0,0,Igor Martínez,£720Th. ,31,170,Midfielder - Attacking Midfield,right,Retired,29,1,2,2045,6,0,0,188,14,2,0,700,29,2,1,1507,41,3,4,2981,21,1,1,790,13,1,0,487,34,1,0,1671,43,1,0,2173,LaLiga,5,0,1,382,nan,nan,nan,nan
13/6/2011,Ibai Gómez,67087553,796,11/11/1989,21,0,0,0,0,2500,5300,5300,129,117,1132226,179,71,AM/S RL,1,3,1,3,1,2,2,7,1,2,1,12,12,12,11,10,14,9,12,2,3,9,11,3,12,12,10,13,10,9,10,10,10,13,8,12,2,9,12,14,12,9,9,13,13,13,20,10,7,11,6,6,10,12,12,13,6,11,10,5,8,7,1,1,9,20,17,20,11,AM/S RL,515,1,1,18,11,20,17,1,1,1,1,1,9,1,1,1,4,0,0,1,0,0,0,0,0,0,0,0,0,0,0,0,0,0,0,0,0,0,0,0,0,0,0,0,0,0,0,0,0,0,0,0,0,0,0,0,0,0,0,0,0,0,0,0,0,Ibai Gómez,£900Th. ,30,178,Forward - Right Winger,right,Athletic Bilbao,15,4,0,888,45,12,6,2595,46,5,12,2472,24,8,2,1020,34,2,4,1674,9,0,1,339,35,7,3,2111,38,7,6,2560,34,3,4,2133,LaLiga,20,1,1,899,nan,nan,nan,nan
13/6/2011,Iago Falqué,1510571,796,4/4/1990,21,0,0,0,0,3750,6000,6000,155,128,808272,173,67,AM LC,3,1,3,3,1,3,1,1,3,2,2,15,14,16,13,17,15,6,14,6,4,15,15,6,18,8,12,7,15,7,16,13,10,18,6,13,6,10,8,13,14,10,7,20,11,11,9,11,8,8,10,12,8,9,14,11,12,9,13,13,5,11,1,1,12,20,13,18,20,AM LC,504,1,1,15,20,18,13,1,1,1,1,8,12,7,1,1,2097296,0,0,0,0,1,0,0,1,0,0,0,0,0,0,0,0,0,0,0,0,0,1,0,0,0,0,0,0,0,0,0,0,0,0,0,0,0,0,0,0,0,0,0,0,0,0,0,0,,,,,,,,,,,,,,,,,,,,,,,,,,,,,,,,,,,,,,,,,,,,,,,,,,,,
13/6/2011,Hilaire Momi,13103504,13,3/16/1990,21,7,3,0,0,3100,5000,4500,135,100,1416809,187,75,S ,2,2,2,1,3,2,1,5,2,3,2,10,7,11,12,11,10,10,14,5,10,7,6,5,13,12,12,9,13,11,6,5,5,12,5,11,5,7,9,9,12,14,13,5,9,14,20,8,14,10,6,10,9,10,11,15,12,9,7,4,16,12,1,1,1,1,1,1,1,S ,600,1,1,20,1,1,1,1,1,1,1,1,1,1,1,1,0,0,0,0,0,0,0,0,0,0,0,0,0,0,0,0,0,0,0,0,0,0,0,0,0,0,0,0,0,0,0,0,0,0,0,0,0,0,0,0,0,0,0,0,0,0,0,0,0,,,,,,,,,,,,,,,,,,,,,,,,,,,,,,,,,,,,,,,,,,,,,,,,,,,,
13/6/2011,Hamady Tamboura,85057336,769,6/23/1989,21,0,0,0,0,1200,2450,2450,120,98,610379,173,68,S ,1,1,2,2,3,3,2,5,3,2,3,10,7,14,11,11,10,14,8,2,3,6,10,3,11,5,9,10,8,8,6,9,10,11,2,11,4,8,13,16,14,12,6,5,11,15,20,8,9,12,4,6,8,10,13,5,8,9,10,8,10,13,1,1,10,10,10,1,1,S ,600,1,1,20,1,1,10,1,1,1,1,1,1,10,1,1,0,0,0,0,0,0,0,0,0,0,0,0,0,0,0,0,0,0,0,0,0,0,0,0,0,0,0,0,0,0,0,0,0,0,0,0,0,0,0,0,0,0,0,0,0,0,0,0,0,,,,,,,,,,,,,,,,,,,,,,,,,,,,,,,,,,,,,,,,,,,,,,,,,,,,
13/6/2011,Guido Marilungo,43000093,776,8/9/1989,21,0,0,7,2,4600,6350,6350,162,127,4275884,176,69,AM/S RL,2,2,1,2,1,3,1,7,3,1,1,10,12,16,13,13,8,12,9,5,4,10,10,6,14,15,9,15,9,8,10,12,17,14,8,15,12,8,15,16,14,8,9,9,13,15,20,11,6,10,11,15,7,12,13,18,12,13,12,13,11,9,1,1,11,18,15,18,13,AM/S RL,625,1,1,20,13,18,15,1,1,1,1,1,11,9,1,1,532480,0,0,0,0,0,0,0,0,0,0,0,0,0,1,0,0,0,0,0,1,0,0,0,0,0,0,0,0,0,0,0,0,0,0,0,0,0,0,0,0,0,0,0,0,0,0,0,0,Guido Marilungo,£3.15m ,31,174,Forward - Centre-Forward,right,SS Monopoli 1966,36,2,6,2087,19,4,2,869,4,0,0,159,33,5,5,1973,9,2,0,810,34,7,6,2642,21,0,4,1013,39,10,3,2493,39,10,2,2958,Serie A,32,3,2,1604,6,0,0,283
13/6/2011,Freddie Sears,28006280,765,11/27/1989,21,0,0,3,1,2900,5250,5250,135,114,2463643,173,64,AM/S R,2,2,3,1,2,2,1,7,1,2,2,10,12,11,10,11,10,6,10,3,5,10,10,6,12,9,11,11,11,9,11,10,7,7,8,12,8,9,12,16,11,8,7,10,14,15,20,10,9,9,7,9,8,8,8,12,18,8,15,12,10,11,1,1,12,20,20,7,1,AM/S R,512,1,1,18,1,7,20,1,1,1,1,1,1,12,1,1,0,0,0,0,0,0,0,0,0,0,0,0,0,0,0,0,0,0,0,0,0,0,0,0,0,0,0,0,0,0,0,0,0,0,0,0,0,0,0,0,0,0,0,0,0,0,0,0,0,,,,,,,,,,,,,,,,,,,,,,,,,,,,,,,,,,,,,,,,,,,,,,,,,,,,
13/6/2011,Fousseyni Cissé,85003766,769,7/17/1989,21,0,0,0,0,2600,5219,5200,145,116,4471616,195,80,S ,1,3,2,2,3,1,2,3,1,3,2,4,7,10,11,12,7,14,9,5,4,10,11,2,12,10,13,12,11,11,7,9,12,11,6,12,8,9,13,16,12,16,16,20,14,13,5,13,16,12,10,15,7,5,14,13,14,10,13,13,13,7,1,1,1,12,1,12,1,S ,600,1,1,20,1,12,1,1,1,1,1,1,1,1,1,1,262144,0,0,0,0,0,0,0,0,0,0,0,0,0,0,0,0,0,0,1,0,0,0,0,0,0,0,0,0,0,0,0,0,0,0,0,0,0,0,0,0,0,0,0,0,0,0,0,0,,,,,,,,,,,,,,,,,,,,,,,,,,,,,,,,,,,,,,,,,,,,,,,,,,,,
13/6/2011,Fidélis,55023998,1651,6/14/1989,21,0,0,0,0,500,1000,4500,107,90,587897,185,80,S ,1,3,2,3,2,2,2,4,2,2,1,9,5,10,13,13,4,13,12,8,3,10,9,5,11,6,11,9,10,3,9,11,8,9,10,13,11,8,10,13,11,10,10,6,16,13,20,6,6,10,8,10,7,10,12,15,8,10,8,12,10,6,1,1,1,7,1,1,7,S ,600,1,1,20,7,1,1,1,1,1,1,1,1,1,1,1,0,0,0,0,0,0,0,0,0,0,0,0,0,0,0,0,0,0,0,0,0,0,0,0,0,0,0,0,0,0,0,0,0,0,0,0,0,0,0,0,0,0,0,0,0,0,0,0,0,Fidelis,£180Th. ,31,185,Forward - Centre-Forward,left,Al-Taawon Club,7,1,0,68,11,2,0,461,33,6,0,2104,20,0,3,735,35,7,3,2715,40,5,5,1977,40,7,2,1838,nan,nan,nan,nan,1,0,0,79,Liga NOS,nan,nan,nan,nan,nan,nan,nan,nan
13/6/2011,Emmanuel Rivičre,34002601,769,3/3/1990,21,0,0,12,4,4500,5624,5600,145,125,11999999,182,76,AM/S R,1,3,1,2,2,1,1,6,1,2,1,5,11,11,11,11,9,11,12,5,5,9,12,6,12,8,12,13,9,11,9,10,15,12,6,13,9,12,14,16,15,14,12,8,14,15,20,14,14,11,8,14,7,10,10,16,13,8,12,14,14,10,8,8,12,18,18,10,1,AM/S R,622,1,1,20,1,10,18,1,1,8,1,1,10,12,1,8,16,0,0,0,0,1,0,0,0,0,0,0,0,0,0,0,0,0,0,0,0,0,0,0,0,0,0,0,0,0,0,0,0,0,0,0,0,0,0,0,0,0,0,0,0,0,0,0,0,Emmanuel Rivière,£4.50m ,30,182,Forward - Centre-Forward,right,FC Crotone,38,8,11,2943,26,5,1,1657,35,9,3,1441,36,13,2,2158,28,3,1,1553,3,0,0,63,17,0,1,895,31,6,2,2139,16,3,0,541,Ligue 1,31,13,3,2269,2,1,0,60
13/6/2011,Emilio Nsué,1504124,796,9/30/1989,21,0,0,0,0,4750,6600,6600,150,137,12000000,178,75,AM/S RL,3,3,3,2,2,1,3,5,1,2,3,10,12,13,11,13,8,10,12,5,4,12,12,6,14,9,10,14,11,9,13,10,10,16,9,17,9,12,13,15,12,15,9,10,16,16,20,15,12,12,7,14,7,11,9,10,5,14,12,7,7,5,1,1,9,19,19,15,12,AM/S RL,625,1,1,20,12,15,19,1,1,1,1,1,3,9,1,1,134217744,0,0,0,0,1,0,0,0,0,0,0,0,0,0,0,0,0,0,0,0,0,0,0,0,0,0,0,1,0,0,0,0,0,0,0,0,0,0,0,0,0,0,0,0,0,0,0,0,Emilio Nsue,£2.70m ,31,178,Defender - Right-Back,right,APOEL Nicosia,42,6,3,3243,34,4,4,2228,35,2,3,2354,41,4,2,3545,29,0,3,1384,46,3,2,3730,23,1,0,2012,37,7,4,3039,13,3,1,1137,LaLiga,16,1,0,984,6,0,2,570
13/6/2011,Ekele Udojoh,75015782,38,9/29/1989,21,0,0,0,0,1050,4000,4000,103,80,784431,182,78,S ,3,3,1,3,2,1,3,1,1,2,1,7,9,12,11,12,4,11,7,2,6,6,8,5,12,11,10,9,12,5,2,9,10,12,12,12,8,11,12,12,10,12,7,9,13,11,20,8,8,10,4,10,5,9,18,6,13,12,10,13,8,12,1,1,1,1,1,1,1,S ,600,1,1,20,1,1,1,1,1,1,1,1,1,1,1,1,0,0,0,0,0,0,0,0,0,0,0,0,0,0,0,0,0,0,0,0,0,0,0,0,0,0,0,0,0,0,0,0,0,0,0,0,0,0,0,0,0,0,0,0,0,0,0,0,0,,,,,,,,,,,,,,,,,,,,,,,,,,,,,,,,,,,,,,,,,,,,,,,,,,,,
13/6/2011,Eduardo Salvio,14000699,1649,5/13/1990,21,1,0,23,6,4750,6500,6500,160,134,17534724,173,71,AM/S R,1,2,1,2,3,3,3,4,2,2,2,11,13,14,13,13,10,5,11,4,5,13,14,7,15,11,9,16,11,10,13,11,16,18,7,13,6,8,8,16,17,12,6,8,13,14,20,14,8,13,5,13,11,11,11,14,15,16,13,13,12,9,1,1,15,20,20,1,11,AM/S R,512,1,1,16,11,1,20,1,1,1,1,1,1,15,1,1,34359738368,0,0,0,0,0,0,0,0,0,0,0,0,0,0,0,0,0,0,0,0,0,0,0,0,0,0,0,0,0,0,0,0,0,0,0,1,0,0,0,0,0,0,0,0,0,0,0,0,Eduardo Salvio,£9.00m ,30,173,Forward - Right Winger,right,Club Atlético Boca Juniors,39,10,7,2446,48,8,5,2351,51,13,11,4044,22,2,4,1117,38,13,11,3148,12,0,0,362,42,9,11,2902,34,9,6,2279,34,7,5,1703,LaLiga,22,12,3,1543,nan,nan,nan,nan
13/6/2011,Driss Fettouhi,85029078,34,9/30/1989,21,0,0,0,0,1300,5000,4500,135,100,683385,182,70,DM/M C,2,2,1,1,3,3,2,1,2,2,3,9,9,10,6,12,14,7,13,5,7,12,8,7,12,8,12,11,12,12,13,11,13,12,6,10,9,11,13,15,13,13,11,20,14,12,5,14,10,13,8,13,5,8,15,13,11,12,14,14,14,6,1,1,16,12,1,1,16,DM/M C,311,1,1,15,12,1,1,1,1,1,20,16,1,1,1,1,0,0,0,0,0,0,0,0,0,0,0,0,0,0,0,0,0,0,0,0,0,0,0,0,0,0,0,0,0,0,0,0,0,0,0,0,0,0,0,0,0,0,0,0,0,0,0,0,0,,,,,,,,,,,,,,,,,,,,,,,,,,,,,,,,,,,,,,,,,,,,,,,,,,,,
13/6/2011,Dieylani Fall,13106856,41,11/30/1989,21,4,0,0,0,3750,5250,4700,135,105,2297020,190,80,S ,3,2,2,1,3,3,1,4,2,2,3,4,7,12,13,10,10,14,11,5,4,9,15,2,12,8,12,11,12,9,7,11,10,13,5,11,4,8,9,14,13,15,17,8,14,11,20,10,12,12,8,10,7,7,10,16,5,6,13,10,19,16,1,1,1,12,10,10,12,S ,600,1,1,20,12,10,10,1,1,1,1,1,1,1,1,1,0,0,0,0,0,0,0,0,0,0,0,0,0,0,0,0,0,0,0,0,0,0,0,0,0,0,0,0,0,0,0,0,0,0,0,0,0,0,0,0,0,0,0,0,0,0,0,0,0,Dieylani Fall,£180Th. ,30,190,Forward - Centre-Forward,right,Without Club,nan,nan,nan,nan,nan,nan,nan,nan,15,2,0,550,10,0,0,154,12,3,1,495,5,0,0,354,nan,nan,nan,nan,nan,nan,nan,nan,nan,nan,nan,nan,Ligue 1,nan,nan,nan,nan,nan,nan,nan,nan
13/6/2011,Diafra Sakho,85044891,41,12/24/1989,21,0,0,0,0,2400,4994,3650,135,111,1864464,184,79,S ,2,2,1,2,2,2,2,1,3,1,1,4,6,11,11,12,8,14,10,5,4,8,13,2,11,8,11,12,10,10,6,9,16,13,5,13,5,8,13,16,13,14,12,5,14,14,20,15,14,12,8,13,6,5,12,14,13,12,10,15,15,11,1,1,1,1,1,1,1,S ,600,1,1,20,1,1,1,1,1,1,1,1,1,1,1,1,16,0,0,0,0,1,0,0,0,0,0,0,0,0,0,0,0,0,0,0,0,0,0,0,0,0,0,0,0,0,0,0,0,0,0,0,0,0,0,0,0,0,0,0,0,0,0,0,0,,,,,,,,,,,,,,,,,,,,,,,,,,,,,,,,,,,,,,,,,,,,,,,,,,,,
13/6/2011,David Ball,2019042,765,12/14/1989,21,0,0,0,0,1750,4500,4500,123,90,896738,183,74,S ,3,1,1,2,1,2,3,4,1,2,1,5,6,9,12,10,4,11,9,6,5,7,11,4,10,11,8,11,11,7,5,5,13,11,6,12,8,10,12,13,13,13,11,8,13,12,20,14,12,11,8,9,7,6,14,11,8,5,8,12,10,3,1,1,1,10,10,8,1,S ,600,1,1,20,1,8,10,1,1,1,1,1,1,1,1,1,0,0,0,0,0,0,0,0,0,0,0,0,0,0,0,0,0,0,0,0,0,0,0,0,0,0,0,0,0,0,0,0,0,0,0,0,0,0,0,0,0,0,0,0,0,0,0,0,0,David Barral,£2.70m ,37,180,Forward - Centre-Forward,right,Without Club,35,6,2,2353,32,9,2,2277,29,6,6,1732,36,8,0,2496,38,13,1,2706,24,3,1,1142,23,3,1,1120,50,18,1,2990,18,6,1,1168,LaLiga,13,1,0,459,nan,nan,nan,nan
13/6/2011,Dani Schahin,35017376,771,7/9/1989,21,0,0,0,0,1550,5250,5250,125,109,453047,187,79,S ,2,2,3,3,1,2,1,1,2,1,3,4,9,12,11,12,8,12,12,4,4,10,11,8,12,12,8,14,11,9,8,8,15,14,4,12,3,10,10,13,11,11,13,14,13,13,20,10,12,8,12,10,15,7,7,14,5,10,12,13,11,5,1,1,1,8,8,8,8,S ,600,1,1,20,8,8,8,1,1,1,1,1,1,1,1,1,0,0,0,0,0,0,0,0,0,0,0,0,0,0,0,0,0,0,0,0,0,0,0,0,0,0,0,0,0,0,0,0,0,0,0,0,0,0,0,0,0,0,0,0,0,0,0,0,0,,,,,,,,,,,,,,,,,,,,,,,,,,,,,,,,,,,,,,,,,,,,,,,,,,,,
13/6/2011,Damien Le Tallec,34004620,769,4/19/1990,21,0,0,4,0,3500,5050,5600,141,112,4078960,185,77,AM/S R,3,2,3,2,1,3,3,6,3,1,3,7,9,13,12,12,9,13,10,4,3,10,11,6,13,9,12,11,10,8,11,9,12,12,5,13,6,13,9,14,13,12,11,10,10,12,20,14,11,10,7,14,15,13,12,12,12,10,13,12,11,11,1,1,14,18,18,14,14,AM/S R,622,1,1,20,14,14,18,1,1,1,1,1,13,14,1,1,131072,0,0,0,0,0,0,0,0,0,0,0,0,0,0,0,0,0,1,0,0,0,0,0,0,0,0,0,0,0,0,0,0,0,0,0,0,0,0,0,0,0,0,0,0,0,0,0,0,Damien Le Tallec,£135Th. ,30,187,Midfielder - Defensive Midfield,right,Montpellier HSC,27,11,2,1946,19,1,0,1190,22,5,3,1510,22,2,4,1583,31,0,0,2687,29,3,5,2426,48,4,2,4163,42,1,0,3796,37,3,1,2902,Bundesliga,33,2,1,2875,8,0,0,587
13/6/2011,Christian Pasquato,43006605,776,7/20/1989,21,0,0,5,0,2500,5624,5300,151,125,442038,174,68,AM/S LC,3,2,1,2,1,3,2,8,1,3,3,7,8,14,16,14,15,7,13,7,5,15,14,6,13,7,9,8,8,10,13,11,10,13,8,12,10,10,11,15,17,10,10,10,13,15,20,13,7,9,12,9,12,10,8,15,8,11,10,10,11,16,1,1,9,20,12,20,18,AM/S LC,514,1,1,16,18,20,12,1,1,1,1,1,9,1,1,1,0,0,0,0,0,0,0,0,0,0,0,0,0,0,0,0,0,0,0,0,0,0,0,0,0,0,0,0,0,0,0,0,0,0,0,0,0,0,0,0,0,0,0,0,0,0,0,0,0,Cristian Pasquato,£990Th. ,31,173,Forward - Second Striker,right,AS Gubbio 1910,42,9,14,2885,15,1,2,635,18,4,1,574,39,8,5,2703,38,7,7,1544,34,5,4,2256,28,5,8,1876,29,5,6,1400,9,1,0,250,Serie A,13,4,3,1025,5,0,2,407
13/6/2011,Carsten Kammlott,92011965,771,2/28/1990,21,0,0,0,0,2750,4850,4850,139,97,287500,180,75,S ,2,3,3,1,3,2,3,2,2,3,2,5,7,12,13,11,6,8,8,5,5,10,11,6,12,12,10,14,12,10,12,11,11,12,6,13,7,11,13,13,14,12,10,11,13,10,20,10,9,12,11,6,14,11,12,13,9,7,11,12,15,5,1,1,1,13,12,13,7,S ,600,1,1,20,7,13,12,1,1,1,1,1,1,1,1,1,0,0,0,0,0,0,0,0,0,0,0,0,0,0,0,0,0,0,0,0,0,0,0,0,0,0,0,0,0,0,0,0,0,0,0,0,0,0,0,0,0,0,0,0,0,0,0,0,0,,,,,,,,,,,,,,,,,,,,,,,,,,,,,,,,,,,,,,,,,,,,,,,,,,,,
13/6/2011,Boris Vukcevic,35025623,771,3/16/1990,21,0,0,5,0,4400,6250,6250,135,118,2908221,182,78,M/AM/S LC,3,3,2,1,1,1,2,6,1,3,3,10,11,14,13,14,10,9,8,10,10,11,10,6,12,8,11,9,10,12,14,14,10,9,11,12,8,9,7,14,13,13,12,20,12,14,15,11,7,10,12,10,8,17,9,11,20,8,15,12,15,6,1,1,20,17,1,20,17,M/AM/S LC,424,1,1,18,17,9,1,1,1,1,1,1,20,1,1,1,0,0,0,0,0,0,0,0,0,0,0,0,0,0,0,0,0,0,0,0,0,0,0,0,0,0,0,0,0,0,0,0,0,0,0,0,0,0,0,0,0,0,0,0,0,0,0,0,0,,,,,,,,,,,,,,,,,,,,,,,,,,,,,,,,,,,,,,,,,,,,,,,,,,,,
13/6/2011,Ben Sahar,42000032,775,8/10/1989,21,24,5,16,8,5100,6000,6000,148,125,2025981,180,72,S ,1,2,2,2,3,2,2,4,3,2,1,6,10,14,12,14,10,11,9,5,6,13,12,6,14,9,13,10,10,9,12,9,10,14,6,15,8,9,15,14,12,13,9,12,12,14,20,13,13,10,9,14,5,5,13,14,5,5,16,11,11,6,1,1,1,10,1,10,1,S ,600,1,1,20,1,10,1,1,1,1,1,1,1,1,1,1,4.39805E+12,0,0,0,0,1,0,0,0,0,0,0,0,0,0,0,0,0,0,0,0,0,0,0,0,0,0,0,0,0,0,0,0,0,0,0,0,0,0,0,0,0,0,1,0,0,0,0,0,Ben Sahar,£1.35m ,31,180,Forward - Centre-Forward,right,APOEL Nicosia,47,19,2,3407,23,4,4,1234,19,3,1,696,22,7,1,1551,34,8,4,2234,29,10,2,1353,47,17,3,2457,36,13,3,2288,42,16,4,2712,Ligue 1,46,16,0,3053,8,1,0,553
13/6/2011,Artur Sobiech,54006889,787,6/12/1990,21,3,0,7,1,4250,5624,6150,141,125,2677658,184,75,S ,2,2,2,2,2,2,1,3,3,3,1,9,10,13,14,12,9,13,11,6,6,11,9,8,12,11,14,12,11,12,12,12,12,13,9,13,9,12,12,13,14,13,13,9,14,14,20,12,13,12,9,13,11,10,11,10,10,12,10,10,10,14,1,1,1,9,7,4,9,S ,600,1,1,20,9,4,7,1,1,1,1,1,1,1,1,1,0,0,0,0,0,0,0,0,0,0,0,0,0,0,0,0,0,0,0,0,0,0,0,0,0,0,0,0,0,0,0,0,0,0,0,0,0,0,0,0,0,0,0,0,0,0,0,0,0,Artur Sobiech,£1.58m ,30,185,Forward - Centre-Forward,right,Fatih Karagümrük,31,10,9,2537,21,4,1,619,37,8,5,1345,19,6,0,1152,20,2,1,554,27,8,0,1658,25,3,2,1081,23,3,4,1165,30,10,5,1731,Bundesliga,40,13,4,2741,5,2,0,367
13/6/2011,Alexandru Ionita,57009838,790,8/5/1989,21,0,0,8,2,2750,5219,5800,135,116,5120212,185,85,S ,1,2,1,3,2,1,1,4,2,2,2,8,8,12,12,10,5,12,7,5,5,10,10,9,12,10,11,12,12,11,10,10,15,11,6,12,11,7,13,13,9,10,12,15,14,13,20,12,14,14,8,14,7,10,8,18,13,10,10,10,10,5,1,1,1,7,7,7,5,S ,600,1,1,20,5,7,7,1,1,1,1,1,1,1,1,1,2097156,0,0,1,0,0,0,0,0,0,0,0,0,0,0,0,0,0,0,0,0,0,1,0,0,0,0,0,0,0,0,0,0,0,0,0,0,0,0,0,0,0,0,0,0,0,0,0,0,,,,,,,,,,,,,,,,,,,,,,,,,,,,,,,,,,,,,,,,,,,,,,,,,,,,
13/6/2011,Alexander Esswein,29022519,771,3/25/1990,21,0,0,1,0,4550,5850,6100,137,120,932269,183,83,AM/S R,1,1,3,1,1,1,1,4,2,3,1,10,8,12,13,13,6,10,9,2,2,10,8,5,13,14,8,16,9,10,8,8,11,8,5,12,5,8,12,15,13,12,12,10,11,16,20,11,15,9,4,9,7,6,10,11,8,9,12,11,11,5,1,1,1,16,16,1,12,AM/S R,622,1,1,20,12,1,16,1,1,1,1,1,1,1,1,1,512,0,0,0,0,0,0,0,0,0,1,0,0,0,0,0,0,0,0,0,0,0,0,0,0,0,0,0,0,0,0,0,0,0,0,0,0,0,0,0,0,0,0,0,0,0,0,0,0,Alexander Esswein,£3.15m ,30,182,Forward - Right Winger,right,SV Sandhausen,33,17,8,2949,29,5,4,1982,28,3,2,1794,19,0,1,780,19,1,3,864,38,4,3,2381,30,2,3,1346,22,2,2,1013,24,2,1,1807,Bundesliga,10,1,1,492,2,0,0,89
13/6/2011,Alberto Paloschi,43017207,776,1/4/1990,21,0,0,18,8,3300,6350,6350,163,127,3368296,183,70,S ,1,3,2,3,3,3,3,9,3,2,1,3,9,12,14,13,2,11,10,3,5,10,13,4,12,13,16,14,16,15,8,10,18,8,8,16,12,12,16,12,16,13,11,7,13,16,20,15,9,13,5,12,14,10,6,17,15,12,18,14,12,5,1,1,1,8,8,1,1,S ,600,1,1,20,1,1,8,1,1,1,1,1,1,1,1,1,4.39805E+12,0,0,0,0,0,0,0,0,0,0,0,0,0,1,0,0,0,0,0,0,0,0,0,0,0,0,0,0,0,0,0,0,0,0,0,0,0,0,0,0,0,0,1,0,0,0,0,0,Alberto Paloschi,£3.60m ,30,183,Forward - Centre-Forward,right,SPAL,13,2,0,432,36,6,4,2044,20,7,0,1287,37,15,3,2658,37,9,3,2661,32,11,1,2461,14,0,0,499,37,7,1,2279,25,2,0,959,Serie A,19,1,3,818,4,1,0,254
13/6/2011,Alain Eizmendi,67055064,796,6/10/1990,21,0,0,0,0,2000,3650,3650,119,82,1406596,171,65,AM/S R,2,2,2,3,1,3,1,1,1,3,1,9,10,11,11,10,7,7,8,1,2,8,10,3,13,10,9,11,7,10,8,9,10,11,7,10,2,6,5,15,13,9,6,5,14,14,20,8,5,6,6,10,8,10,7,11,13,6,11,12,5,4,1,1,14,20,20,1,1,AM/S R,512,1,1,16,1,1,20,1,1,1,1,1,1,14,1,1,0,0,0,0,0,0,0,0,0,0,0,0,0,0,0,0,0,0,0,0,0,0,0,0,0,0,0,0,0,0,0,0,0,0,0,0,0,0,0,0,0,0,0,0,0,0,0,0,0,,,,,,,,,,,,,,,,,,,,,,,,,,,,,,,,,,,,,,,,,,,,,,,,,,,,
13/6/2011,Zoltán Stieber,28000417,773,10/6/1988,22,0,0,1,0,4750,5849,6500,149,130,2958833,175,67,AM/S RLC,3,2,3,1,3,1,3,2,1,1,3,10,15,14,12,13,12,4,7,5,8,11,10,8,13,10,11,9,12,10,13,12,16,16,5,13,7,11,12,16,12,11,6,20,11,15,10,13,7,10,12,10,14,15,12,13,7,13,14,14,14,7,1,1,15,20,15,20,18,AM/S RLC,516,1,1,17,18,20,15,1,1,1,1,1,15,12,1,1,1,1,0,0,0,0,0,0,0,0,0,0,0,0,0,0,0,0,0,0,0,0,0,0,0,0,0,0,0,0,0,0,0,0,0,0,0,0,0,0,0,0,0,0,0,0,0,0,0,Zoltán Stieber,£1.13m ,32,175,Forward - Left Winger,left,Újpest FC,36,10,18,2973,12,0,5,896,17,3,2,1267,36,9,12,2986,28,3,3,1696,8,1,0,257,28,3,5,1989,29,5,6,1955,9,0,0,301,Bundesliga,25,2,6,1931,5,0,0,151
13/6/2011,Zhang Chengdong,23020214,110,2/9/1989,22,1,0,0,0,1500,4950,4500,121,90,21613,184,73,AM/S RL,1,3,3,2,1,1,1,2,1,3,2,8,11,9,10,11,7,9,4,1,1,10,2,4,10,5,4,9,8,8,8,9,14,13,8,11,7,13,13,14,12,9,10,8,13,14,20,8,9,10,11,7,7,10,14,12,13,13,16,16,16,4,1,1,1,17,17,17,7,AM/S RL,625,1,1,20,7,17,17,1,1,1,1,1,1,1,1,1,0,0,0,0,0,0,0,0,0,0,0,0,0,0,0,0,0,0,0,0,0,0,0,0,0,0,0,0,0,0,0,0,0,0,0,0,0,0,0,0,0,0,0,0,0,0,0,0,0,,,,,,,,,,,,,,,,,,,,,,,,,,,,,,,,,,,,,,,,,,,,,,,,,,,,
13/6/2011,Yazalde,55008237,788,9/21/1988,22,0,0,0,0,2250,5450,5450,133,107,527077,183,79,S ,1,2,2,2,2,2,3,3,2,1,2,10,10,11,12,12,9,10,12,8,6,10,11,7,12,10,11,11,13,11,10,11,13,13,9,12,7,11,10,12,12,14,11,8,16,12,20,12,15,11,6,10,6,12,12,13,15,13,13,14,14,6,1,1,1,13,13,10,10,S ,600,1,1,20,10,10,13,1,1,1,1,1,1,1,1,1,0,0,0,0,0,0,0,0,0,0,0,0,0,0,0,0,0,0,0,0,0,0,0,0,0,0,0,0,0,0,0,0,0,0,0,0,0,0,0,0,0,0,0,0,0,0,0,0,0,Yazalde,£2.52m ,32,183,Forward - Centre-Forward,right,Without Club,34,10,5,2496,29,8,3,2187,31,3,1,2518,34,8,2,2181,29,1,0,1520,35,3,5,1974,19,1,0,900,9,1,1,364,25,6,1,765,Liga NOS,37,6,5,2186,nan,nan,nan,nan
13/6/2011,Yaya Diané,85030794,22,1/16/1989,22,0,0,0,0,950,4769,2650,132,106,226106,185,83,S ,3,3,1,3,2,2,3,4,3,1,3,5,7,10,13,10,8,15,12,5,6,7,14,4,10,17,13,12,12,12,8,11,7,11,7,14,5,8,10,14,10,16,12,5,7,11,20,7,16,14,10,4,6,5,5,7,13,7,6,10,10,12,1,1,1,1,1,1,1,S ,600,1,1,20,1,1,1,1,1,1,1,1,1,1,1,1,0,0,0,0,0,0,0,0,0,0,0,0,0,0,0,0,0,0,0,0,0,0,0,0,0,0,0,0,0,0,0,0,0,0,0,0,0,0,0,0,0,0,0,0,0,0,0,0,0,,,,,,,,,,,,,,,,,,,,,,,,,,,,,,,,,,,,,,,,,,,,,,,,,,,,
13/6/2011,Yala Bolasie,83000374,765,5/24/1989,22,0,0,0,0,2100,4850,4850,120,89,431250,179,84,M/AM/S RL,1,2,1,2,3,2,3,2,2,1,1,8,7,12,8,8,8,9,10,1,5,7,10,5,8,9,9,8,7,8,11,6,14,16,6,10,6,13,8,14,16,10,10,6,12,14,20,12,10,9,3,8,11,10,13,16,12,11,9,10,12,5,1,1,18,20,19,20,8,M/AM/S RL,535,1,1,16,8,20,19,1,1,1,1,1,18,18,1,1,2.25184E+15,0,0,0,0,0,1,0,0,0,0,0,0,0,0,0,0,0,0,0,0,0,0,0,0,0,0,0,0,0,0,1,0,0,0,0,1,0,0,0,0,0,0,0,0,0,0,0,0,,,,,,,,,,,,,,,,,,,,,,,,,,,,,,,,,,,,,,,,,,,,,,,,,,,,
13/6/2011,Vincenzo Rennella,85005319,776,10/8/1988,22,0,0,0,0,3750,5950,5950,141,119,1629065,188,78,S ,1,3,2,3,2,2,2,2,1,2,3,12,11,14,16,12,5,13,15,5,3,14,15,3,16,18,11,11,13,9,8,14,14,12,8,13,9,7,6,12,16,12,12,20,12,12,10,10,11,10,5,10,12,5,18,15,7,12,8,9,10,5,1,1,1,12,1,12,10,S ,600,1,1,20,10,12,1,1,1,1,1,1,1,1,1,1,2.2518E+15,0,0,0,0,0,0,0,0,0,0,0,0,0,0,0,0,0,0,0,0,0,0,0,0,0,0,0,0,0,0,0,0,0,0,0,0,0,0,0,0,0,0,0,0,0,0,0,0,Vincenzo Rennella,£360Th. ,32,188,Forward - Centre-Forward,left,Without Club,22,8,3,1264,19,1,0,1052,37,8,1,2201,36,13,3,2682,38,7,4,1757,34,7,0,1968,29,12,6,1920,1,0,0,67,19,1,2,842,Serie A,13,0,1,775,nan,nan,nan,nan
13/6/2011,Tufan Tosunoglu,92002944,799,7/22/1988,22,0,0,2,0,3000,4500,5000,122,102,669413,180,72,AM/S C,2,3,1,3,1,2,1,1,1,1,3,10,8,13,12,12,10,14,13,5,10,12,10,13,13,5,13,14,10,12,14,12,9,13,6,14,7,14,12,10,13,8,9,6,13,12,20,11,11,10,5,10,17,10,6,7,9,11,10,8,14,7,1,1,14,17,12,12,17,AM/S C,621,1,1,20,17,12,12,1,1,1,1,14,1,1,1,1,0,0,0,0,0,0,0,0,0,0,0,0,0,0,0,0,0,0,0,0,0,0,0,0,0,0,0,0,0,0,0,0,0,0,0,0,0,0,0,0,0,0,0,0,0,0,0,0,0,,,,,,,,,,,,,,,,,,,,,,,,,,,,,,,,,,,,,,,,,,,,,,,,,,,,
13/6/2011,Tomas Pekhart,28005831,763,5/26/1989,22,1,0,22,16,5550,5399,6300,143,120,3945109,189,75,S ,2,1,1,3,2,2,3,1,2,1,3,6,7,11,14,8,6,14,11,7,8,9,7,8,11,8,11,11,14,9,6,10,14,15,13,14,8,8,9,13,10,14,14,9,12,16,20,11,14,12,12,13,15,9,8,14,10,10,9,9,10,10,1,1,1,5,1,1,5,S ,600,1,1,20,5,1,1,1,1,1,1,1,1,1,1,1,0,0,0,0,0,0,0,0,0,0,0,0,0,0,0,0,0,0,0,0,0,0,0,0,0,0,0,0,0,0,0,0,0,0,0,0,0,0,0,0,0,0,0,0,0,0,0,0,0,Tomas Pekhart,£3.60m ,31,194,Forward - Centre-Forward,right,Legia Warszawa,27,18,0,1768,34,10,4,2808,32,4,2,2057,24,1,1,848,15,0,0,178,22,3,1,637,31,12,1,1639,38,11,5,2002,17,1,0,293,Bundesliga,30,10,2,1577,13,8,0,977
13/6/2011,Tomas Micola,25002228,763,9/26/1988,22,0,0,6,1,4250,5354,5350,140,119,2799634,178,75,S ,1,1,3,2,1,1,2,4,3,2,3,7,7,13,7,12,7,9,8,5,3,9,7,4,14,11,12,13,9,10,10,7,14,13,5,11,5,10,15,16,12,11,8,10,14,15,20,13,11,12,11,13,9,10,11,7,10,9,13,18,11,11,1,1,1,12,12,12,1,S ,600,1,1,20,1,12,12,1,1,1,1,1,1,1,1,1,0,0,0,0,0,0,0,0,0,0,0,0,0,0,0,0,0,0,0,0,0,0,0,0,0,0,0,0,0,0,0,0,0,0,0,0,0,0,0,0,0,0,0,0,0,0,0,0,0,Tomas Micola,£630Th. ,32,179,Midfielder - Attacking Midfield,right,FC Odra Petrkovice,20,1,2,1071,3,0,0,90,20,6,1,1146,9,2,1,556,nan,nan,nan,nan,6,0,1,394,27,7,2,1998,12,2,1,743,nan,nan,nan,nan,Ligue 1,1,0,0,83,nan,nan,nan,nan
13/6/2011,Timo Gebhart,35014477,771,4/12/1989,22,0,0,3,1,4750,6650,6650,157,133,22973058,182,78,M/AM RLC,1,3,1,1,2,3,3,6,1,2,2,11,14,16,12,15,12,6,10,8,10,13,14,8,16,16,7,15,14,6,7,7,14,17,9,10,6,3,14,17,18,15,10,6,17,15,20,12,10,8,14,10,15,12,4,17,9,13,8,9,7,15,1,1,17,20,18,16,20,M/AM RLC,526,1,1,15,20,16,18,1,1,1,1,10,15,17,1,1,2.32274E+15,0,0,0,0,0,0,0,0,0,0,0,0,0,0,0,0,0,0,0,0,0,0,0,0,0,0,0,0,0,0,1,0,0,0,1,0,0,0,0,1,0,0,0,0,0,0,1,0,Timo Gebhart,£2.25m ,31,183,Midfielder - Attacking Midfield,right,FC Memmingen,34,6,8,2151,13,0,0,313,19,2,2,1172,7,0,0,206,9,1,1,555,7,0,0,324,21,6,4,1394,12,5,4,793,13,3,5,778,Bundesliga,31,5,2,1273,1,0,0,90
13/6/2011,Theo Walcott,5125014,765,3/16/1989,22,17,3,21,6,6600,7650,7700,172,155,29545037,176,71,AM/S R,3,3,3,2,1,1,2,8,3,3,3,7,12,14,13,12,10,5,6,4,7,11,10,7,13,7,12,9,11,11,12,9,15,12,3,12,7,14,13,19,16,14,7,11,16,19,20,14,9,10,4,13,13,14,12,17,15,14,16,18,18,1,1,1,14,19,19,14,1,AM/S R,622,1,1,20,1,14,19,1,1,1,1,1,12,14,1,1,7.25679E+13,0,1,0,0,0,0,0,0,0,0,0,0,0,0,0,0,0,0,0,0,0,0,0,0,0,0,0,1,0,0,0,0,0,0,0,0,0,0,0,0,0,1,0,0,0,0,1,0,Theo Walcott,£17.10m ,31,175,Forward - Right Winger,both,Southampton FC,38,13,9,2272,46,11,12,3518,43,21,16,2988,18,6,7,1203,22,7,1,795,42,9,7,2076,37,19,2,2495,30,7,8,2069,40,6,2,2168,Premier League,29,2,4,1449,3,0,1,192
13/6/2011,Sven Schipplock,35016037,771,11/8/1988,22,0,0,0,0,4000,6000,6000,133,120,3923716,186,81,S ,3,3,2,3,3,1,1,6,3,3,3,8,9,11,14,11,8,15,12,8,8,10,5,8,11,17,11,16,11,12,12,14,14,5,9,12,8,11,16,13,11,13,13,7,13,12,20,17,17,13,6,11,5,6,14,14,13,12,13,10,12,6,1,1,1,1,1,1,1,S ,600,1,1,20,1,1,1,1,1,1,1,1,1,1,1,1,528,0,0,0,0,1,0,0,0,0,1,0,0,0,0,0,0,0,0,0,0,0,0,0,0,0,0,0,0,0,0,0,0,0,0,0,0,0,0,0,0,0,0,0,0,0,0,0,0,Sven Schipplock,£1.13m ,31,186,Forward - Centre-Forward,right,Arminia Bielefeld,28,12,2,1548,26,8,5,1143,22,7,3,854,28,11,8,1127,30,10,4,1205,21,0,4,978,25,3,0,1211,11,0,0,344,4,2,1,217,Bundesliga,9,1,1,194,5,1,0,78
13/6/2011,Stephan Hain,91002834,771,9/27/1988,22,0,0,0,0,4000,6050,6050,137,121,4265241,178,72,AM/S RLC,1,2,1,2,3,3,2,1,1,3,1,12,11,13,12,12,10,7,8,4,6,12,13,8,12,9,10,13,8,8,9,10,10,10,7,14,5,12,13,14,16,8,8,17,11,13,20,10,8,10,8,9,11,17,10,13,14,7,11,14,16,6,1,1,9,20,18,18,20,AM/S RLC,516,1,1,20,20,18,18,1,1,1,1,9,1,1,1,1,24,0,0,0,1,1,0,0,0,0,0,0,0,0,0,0,0,0,0,0,0,0,0,0,0,0,0,0,0,0,0,0,0,0,0,0,0,0,0,0,0,0,0,0,0,0,0,0,0,Stephan Hain,£1.13m ,32,178,Forward - Centre-Forward,both,SpVgg Unterhaching,27,10,5,1873,14,1,0,395,18,2,0,755,13,0,0,700,12,1,0,520,8,2,0,440,34,35,6,2740,40,20,2,3466,30,14,4,2628,Bundesliga,25,5,1,1326,nan,nan,nan,nan
13/6/2011,Stefan Kutschke,35023160,771,11/3/1988,22,0,0,0,0,2500,4600,4600,117,92,34143,194,84,S ,1,1,1,1,2,2,1,1,3,1,3,5,6,7,12,11,7,15,11,12,7,9,8,11,8,14,12,15,11,10,11,12,14,7,11,11,8,13,16,9,9,11,16,6,11,10,20,11,14,13,14,10,6,11,12,15,12,11,14,12,7,9,1,1,1,1,1,1,1,S ,600,1,1,20,1,1,1,1,1,1,1,1,1,1,1,1,0,0,0,0,0,0,0,0,0,0,0,0,0,0,0,0,0,0,0,0,0,0,0,0,0,0,0,0,0,0,0,0,0,0,0,0,0,0,0,0,0,0,0,0,0,0,0,0,0,,,,,,,,,,,,,,,,,,,,,,,,,,,,,,,,,,,,,,,,,,,,,,,,,,,,
13/6/2011,Simon Church,5102088,801,12/10/1988,22,12,1,15,8,3000,5900,5500,135,110,2873850,186,84,S ,1,1,1,2,2,1,2,5,1,3,1,8,10,10,13,10,10,11,9,4,5,9,13,7,11,8,14,13,12,12,9,9,10,5,4,13,7,11,13,13,10,11,12,8,15,13,20,15,14,10,5,14,5,7,8,10,12,10,14,8,8,12,1,1,1,10,10,1,1,S ,600,1,1,20,1,1,10,1,1,1,1,1,1,1,1,1,524544,0,0,0,0,0,0,0,0,1,0,0,0,0,0,0,0,0,0,0,1,0,0,0,0,0,0,0,0,0,0,0,0,0,0,0,0,0,0,0,0,0,0,0,0,0,0,0,0,,,,,,,,,,,,,,,,,,,,,,,,,,,,,,,,,,,,,,,,,,,,,,,,,,,,
13/6/2011,Scott Sinclair,5008069,765,3/25/1989,22,0,0,7,1,4750,6350,6350,140,125,5888049,177,69,AM RLC,2,3,2,2,3,3,2,2,3,3,1,6,9,14,14,7,7,8,8,1,3,6,15,4,11,9,8,10,10,7,7,7,14,15,7,9,4,10,9,15,12,12,6,12,14,18,20,12,6,10,3,13,6,8,5,18,10,14,18,15,18,4,1,1,9,20,16,20,15,AM RLC,506,1,1,15,15,20,16,1,1,1,1,1,9,1,1,1,134217729,1,0,0,0,0,0,0,0,0,0,0,0,0,0,0,0,0,0,0,0,0,0,0,0,0,0,0,1,0,0,0,0,0,0,0,0,0,0,0,0,0,0,0,0,0,0,0,0,Scott Sinclair,£7.20m ,31,177,Forward - Left Winger,right,Preston North End,50,27,3,4146,40,8,5,3145,18,2,1,537,11,0,1,531,16,3,0,604,33,6,0,2049,50,25,13,4055,55,18,17,3768,55,17,6,3484,Premier League,25,5,0,1071,10,4,1,610
13/6/2011,Rudy Gestede,34000480,769,10/10/1988,22,0,0,0,0,3550,4450,4950,125,99,326043,193,86,S ,3,2,3,1,3,2,3,1,2,1,3,5,5,9,11,12,7,14,11,5,6,10,12,2,12,9,13,13,12,12,7,10,12,12,6,12,8,12,12,9,8,17,16,5,8,11,20,14,17,12,9,13,15,5,6,15,13,10,11,14,14,7,1,1,1,1,1,1,1,S ,600,1,1,20,1,1,1,1,1,1,1,1,1,1,1,1,262144,0,0,0,0,0,0,0,0,0,0,0,0,0,0,0,0,0,0,1,0,0,0,0,0,0,0,0,0,0,0,0,0,0,0,0,0,0,0,0,0,0,0,0,0,0,0,0,0,,,,,,,,,,,,,,,,,,,,,,,,,,,,,,,,,,,,,,,,,,,,,,,,,,,,
13/6/2011,Roberto,55023133,788,11/28/1988,22,0,0,0,0,1000,4500,4500,119,98,71339,182,75,S ,2,1,3,3,3,1,1,3,2,3,2,10,12,12,10,12,9,9,6,9,9,9,11,7,12,6,14,8,13,5,8,10,13,12,1,14,11,10,12,11,11,9,8,9,14,13,20,7,5,11,8,10,7,10,11,14,11,3,16,13,11,6,1,1,1,10,1,1,10,S ,600,1,1,20,10,1,1,1,1,1,1,1,1,1,1,1,0,0,0,0,0,0,0,0,0,0,0,0,0,0,0,0,0,0,0,0,0,0,0,0,0,0,0,0,0,0,0,0,0,0,0,0,0,0,0,0,0,0,0,0,0,0,0,0,0,Roberto,£4.50m ,34,192,Goalkeeper,right,Real Valladolid CF,41,46,15,3666,40,64,10,3600,33,51,5,2970,40,27,25,3600,41,39,18,3690,36,32,16,3197,6,14,0,517,34,51,6,3060,6,9,1,570,LaLiga,19,40,3,1655,6,10,0,540
13/6/2011,Robert Lewandowski,719601,787,8/21/1988,22,30,10,3,0,5350,6750,6850,153,137,14652371,184,78,S ,3,2,2,2,1,3,3,4,2,3,1,7,9,14,15,14,6,13,11,3,9,11,6,8,13,12,14,16,12,10,11,13,14,12,6,14,8,14,15,14,13,13,13,14,12,13,20,14,13,11,6,11,6,10,11,15,10,15,12,14,10,5,1,1,1,14,8,10,14,S ,600,1,1,20,14,10,8,1,1,1,1,1,1,1,1,1,2097408,0,0,0,0,0,0,0,0,1,0,0,0,0,0,0,0,0,0,0,0,0,1,0,0,0,0,0,0,0,0,0,0,0,0,0,0,0,0,0,0,0,0,0,0,0,0,0,0,Robert Lewandowski,£18.00m ,32,184,Forward - Centre-Forward,right,Bayern Munich,43,9,4,1983,47,30,12,4086,49,36,13,4113,48,28,13,4192,49,25,13,4003,51,42,6,4237,47,43,10,4021,48,41,5,3787,47,40,13,4179,Bundesliga,47,55,10,4133,8,10,4,653
13/6/2011,Robbie Kruse,1302381,1435,10/5/1988,22,7,1,5,0,4600,6000,5700,139,114,396498,179,72,S R,3,2,1,1,2,2,3,5,2,1,3,5,12,14,14,12,8,6,14,6,8,12,8,6,12,13,12,9,14,11,14,12,13,12,5,15,8,14,7,14,14,11,8,6,12,13,20,12,9,14,11,12,8,14,5,9,10,10,12,6,12,14,1,1,8,15,15,12,10,S R,602,1,1,20,10,12,15,1,1,1,1,1,4,8,1,1,5.66936E+11,0,0,0,0,0,0,0,0,0,0,1,0,0,0,0,0,0,1,0,0,0,0,0,0,0,0,0,0,0,0,0,0,0,0,1,0,0,0,0,1,0,0,0,0,0,0,0,0,Robbie Keane,£4.05m ,40,175,Forward - Centre-Forward,right,Retired,32,7,3,1603,46,26,8,4058,30,18,11,2621,38,25,13,3420,27,23,7,2308,23,12,1,1756,nan,nan,nan,nan,11,8,0,870,nan,nan,nan,nan,Premier League,nan,nan,nan,nan,nan,nan,nan,nan
13/6/2011,Ricky van Wolfswinkel,860481,784,1/27/1989,22,1,0,7,3,4850,6050,6050,150,125,10651801,186,70,S ,3,3,3,3,2,1,3,5,1,2,3,9,9,12,14,14,13,12,11,4,5,11,15,5,12,9,14,12,14,13,13,12,12,12,7,13,5,12,13,13,15,14,14,12,13,13,20,12,8,10,6,11,8,10,9,15,13,10,14,11,11,6,1,1,1,12,12,1,12,S ,600,1,1,20,12,1,12,1,1,1,1,1,1,1,1,1,0,0,0,0,0,0,0,0,0,0,0,0,0,0,0,0,0,0,0,0,0,0,0,0,0,0,0,0,0,0,0,0,0,0,0,0,0,0,0,0,0,0,0,0,0,0,0,0,0,Ricky van Wolfswinkel,£8.10m ,31,186,Forward - Right Winger,right,FC Basel 1893,44,23,4,3462,47,25,3,3708,41,20,2,3690,27,1,2,1528,40,9,3,2483,21,5,2,1035,37,23,6,3152,26,12,2,1630,42,17,8,3131,Liga NOS,18,6,2,896,6,0,0,439
13/6/2011,Pierre Merkel,92035409,771,5/25/1989,22,0,0,0,0,1500,4250,4250,110,85,239492,190,83,S ,1,3,1,1,3,1,3,2,1,3,3,9,8,10,13,11,9,13,9,2,9,12,6,5,8,9,11,5,10,10,8,7,9,16,11,7,10,8,12,13,13,13,13,3,11,13,20,8,11,8,10,10,14,9,6,20,13,7,15,8,12,8,1,1,1,12,1,1,12,S ,600,1,1,20,12,1,1,1,1,1,1,1,1,1,1,1,0,0,0,0,0,0,0,0,0,0,0,0,0,0,0,0,0,0,0,0,0,0,0,0,0,0,0,0,0,0,0,0,0,0,0,0,0,0,0,0,0,0,0,0,0,0,0,0,0,,,,,,,,,,,,,,,,,,,,,,,,,,,,,,,,,,,,,,,,,,,,,,,,,,,,
13/6/2011,Pablo Piatti,14004181,1649,3/31/1989,22,1,0,6,0,5600,6569,7100,165,146,36790201,163,58,AM/S RLC,3,1,3,3,3,3,2,2,2,1,1,11,15,15,14,15,12,5,13,2,6,15,14,6,16,9,14,13,13,12,15,14,18,18,8,16,4,13,12,15,16,12,4,20,11,14,8,14,7,11,4,15,11,14,13,16,14,17,13,14,15,9,1,1,10,20,16,19,20,AM/S RLC,516,1,1,18,20,19,16,1,1,1,1,1,10,7,1,1,2.2518E+15,0,0,0,1,0,0,0,0,0,0,1,0,0,0,0,0,0,0,0,0,0,0,0,0,0,0,0,0,0,0,0,0,0,0,0,0,0,0,0,0,0,0,0,0,0,0,0,0,Pablo Piatti,£7.20m ,31,163,Forward - Left Winger,both,Toronto FC,41,10,5,3264,47,6,5,2106,19,1,4,1081,29,7,5,1555,30,7,8,2044,37,2,8,1759,31,10,12,2475,31,2,4,1812,26,2,2,1237,LaLiga,25,4,4,1624,nan,nan,nan,nan
13/6/2011,Nils Petersen,35011356,771,12/6/1988,22,0,0,2,0,3500,6600,6600,150,131,9347940,188,79,S ,2,2,2,1,2,2,3,5,2,3,2,4,6,7,16,9,6,12,10,3,4,8,16,6,8,9,15,12,15,13,7,14,15,6,8,16,6,12,10,12,13,10,15,16,14,15,20,12,14,10,7,12,9,5,9,16,14,13,14,14,14,9,1,1,1,7,1,7,1,S ,600,1,1,20,1,7,1,1,1,1,1,1,1,1,1,1,262672,0,0,0,0,1,0,0,0,0,1,0,0,0,0,0,0,0,0,1,0,0,0,0,0,0,0,0,0,0,0,0,0,0,0,0,0,0,0,0,0,0,0,0,0,0,0,0,0,Nils Petersen,£2.70m ,31,188,Forward - Centre-Forward,right,SC Freiburg,38,28,8,3352,18,6,1,786,35,11,6,2861,29,7,2,1736,20,9,2,758,34,25,6,2512,34,11,4,1349,37,19,1,2639,26,12,3,2138,Bundesliga,36,11,2,2606,6,2,2,479
13/6/2011,Moestafa El Kabir,37005407,34,10/5/1988,22,0,0,0,0,3500,5444,6050,130,121,3332625,177,80,S ,1,2,1,2,3,1,1,1,3,3,1,10,12,14,13,11,4,8,13,4,8,12,10,8,14,16,11,12,13,10,14,12,12,5,8,11,11,9,15,14,12,12,7,10,13,14,20,11,12,12,12,11,5,12,16,18,6,10,8,8,6,16,1,1,1,14,14,14,10,S ,600,1,1,20,10,14,14,1,1,1,1,1,1,1,1,1,131072,0,0,0,0,0,0,0,0,0,0,0,0,0,0,0,0,0,1,0,0,0,0,0,0,0,0,0,0,0,0,0,0,0,0,0,0,0,0,0,0,0,0,0,0,0,0,0,0,Mostapha El Kabir,£1.35m ,32,176,Forward - Centre-Forward,right,Örgryte IS,10,5,0,723,17,5,3,743,26,15,3,1971,13,7,3,907,30,8,11,2360,36,9,3,2604,11,3,2,799,28,4,1,1502,24,6,0,1789,Serie A,5,0,1,149,nan,nan,nan,nan
13/6/2011,Mike Könnecke,35026150,771,8/23/1988,22,0,0,0,0,2500,5100,5100,110,98,183925,174,70,AM/S RC,1,1,1,2,2,1,3,4,2,3,2,6,8,10,11,11,7,8,7,6,6,10,7,7,11,13,12,14,10,11,11,12,10,10,7,11,7,13,12,12,12,12,7,20,14,10,16,9,9,11,6,8,9,12,8,15,10,6,11,14,13,12,1,1,13,18,18,13,16,AM/S RC,623,1,1,20,16,13,18,1,1,1,1,11,10,13,1,1,0,0,0,0,0,0,0,0,0,0,0,0,0,0,0,0,0,0,0,0,0,0,0,0,0,0,0,0,0,0,0,0,0,0,0,0,0,0,0,0,0,0,0,0,0,0,0,0,0,,,,,,,,,,,,,,,,,,,,,,,,,,,,,,,,,,,,,,,,,,,,,,,,,,,,
13/6/2011,Maxim Choupo-Moting,35015916,11,3/23/1989,22,10,2,0,0,4900,6700,6500,149,124,5171949,189,82,AM/S C,1,3,1,2,3,3,2,2,3,1,3,8,12,14,9,16,6,7,6,3,4,14,12,5,15,6,8,7,13,8,15,14,6,14,4,9,6,12,7,13,14,9,13,16,6,16,20,11,12,10,5,8,17,8,12,7,14,6,8,12,17,5,1,1,1,18,14,10,18,AM/S C,621,1,1,20,18,10,14,1,1,1,1,1,1,1,1,1,1.75923E+13,0,0,0,0,0,0,0,0,0,0,0,0,0,0,0,0,0,0,0,1,0,0,0,0,1,0,1,0,0,0,0,0,0,0,0,0,0,0,0,0,0,0,0,0,1,0,0,0,Eric Maxim Choupo-Moting,£3.15m ,31,191,Forward - Centre-Forward,right,Bayern Munich,19,2,1,1023,38,10,4,2563,11,1,1,644,34,11,3,2108,40,10,7,3160,36,9,3,2408,30,3,7,2072,32,5,5,2356,31,3,2,1295,Bundesliga,20,6,1,823,4,2,1,110
13/6/2011,Matthias Fetsch,92025921,771,9/30/1988,22,0,0,0,0,2750,4500,4500,120,90,296829,189,80,S ,3,1,1,1,2,1,2,1,2,2,1,7,3,13,13,12,9,12,11,4,9,8,9,5,12,12,6,9,12,9,6,10,10,15,11,13,8,7,10,13,10,10,13,11,12,13,20,5,4,10,11,9,7,10,6,14,13,15,16,9,10,6,1,1,1,1,1,1,1,S ,600,1,1,20,1,1,1,1,1,1,1,1,1,1,1,1,0,0,0,0,0,0,0,0,0,0,0,0,0,0,0,0,0,0,0,0,0,0,0,0,0,0,0,0,0,0,0,0,0,0,0,0,0,0,0,0,0,0,0,0,0,0,0,0,0,,,,,,,,,,,,,,,,,,,,,,,,,,,,,,,,,,,,,,,,,,,,,,,,,,,,
13/6/2011,Marko Marin,156766,771,3/13/1989,22,16,1,12,1,7100,7000,7000,170,145,30080261,170,63,AM RLC,1,3,1,1,2,1,1,10,2,3,3,14,15,18,8,17,13,8,10,6,4,13,12,5,18,5,9,8,13,10,12,7,12,19,6,14,4,5,7,18,20,6,6,15,13,14,20,11,4,14,12,10,6,12,8,10,9,15,12,7,14,5,1,1,12,20,18,20,16,AM RLC,506,1,1,15,16,20,18,1,1,1,1,8,11,12,1,1,7.09196E+13,1,1,0,0,0,0,0,0,0,0,0,0,0,0,0,0,0,0,0,0,0,0,0,0,0,0,0,0,0,0,1,0,0,0,0,0,0,0,0,1,0,0,0,0,0,0,1,0,Marko Marin,£11.70m ,31,170,Midfielder - Attacking Midfield,right,Al-Ahli Jeddah,44,5,12,3293,22,1,5,1434,19,3,2,621,30,2,7,1530,12,2,0,713,29,2,5,1844,23,4,5,1361,36,8,5,2356,31,7,13,2405,Bundesliga,42,6,13,3336,2,0,0,165
13/6/2011,Marko Arnautovic,37003555,755,4/19/1989,22,11,4,4,2,6150,6524,6750,170,145,30611474,192,83,AM/S R,1,3,2,2,1,1,1,8,2,1,1,8,15,16,10,18,14,9,12,5,3,13,10,6,18,14,8,15,6,6,14,7,5,18,4,9,6,3,11,14,13,18,14,18,12,17,20,11,15,6,13,9,9,14,14,17,3,7,3,10,6,18,1,1,9,20,20,14,14,AM/S R,512,1,1,19,14,14,20,1,1,1,1,1,1,9,1,1,7.04031E+13,0,0,0,0,0,0,0,1,0,0,0,1,0,0,0,0,0,1,0,0,0,0,0,0,0,0,0,0,0,0,0,0,0,0,0,1,0,0,0,0,0,0,0,0,0,0,1,0,Marko Arnautovic,£5.85m ,31,189,Forward - Centre-Forward,both,Shanghai SIPG,34,5,4,2046,20,6,0,991,27,5,9,2020,38,5,12,2768,35,2,8,2389,40,12,6,3304,35,7,6,2966,35,11,8,2472,45,20,7,3079,Bundesliga,17,8,1,1208,nan,nan,nan,nan
13/6/2011,Marcelo Larrondo,14004177,1649,8/16/1988,22,0,0,0,0,1000,3000,5500,138,113,3180329,191,79,S ,3,3,1,3,1,1,3,3,2,1,3,3,9,12,14,10,5,16,11,3,5,11,8,2,14,10,11,10,14,11,13,10,8,13,13,14,12,15,15,11,10,11,17,5,18,11,20,10,14,15,3,9,5,11,8,9,9,8,9,9,8,3,1,1,1,1,1,1,1,S ,600,1,1,20,1,1,1,1,1,1,1,1,1,1,1,1,0,0,0,0,0,0,0,0,0,0,0,0,0,0,0,0,0,0,0,0,0,0,0,0,0,0,0,0,0,0,0,0,0,0,0,0,0,0,0,0,0,0,0,0,0,0,0,0,0,Marcelo Larrondo,£405Th. ,32,191,Forward - Centre-Forward,right,CD O'Higgins,29,6,4,1101,19,1,2,802,11,2,0,406,7,1,0,309,34,11,7,2437,7,5,2,548,13,2,1,448,nan,nan,nan,nan,29,5,1,1864,Serie A,5,1,0,358,nan,nan,nan,nan
13/6/2011,Manuel Schäffler,35016443,771,2/6/1989,22,0,0,0,0,4450,5250,5250,121,105,541359,186,84,S ,2,2,2,1,2,2,2,3,2,2,3,3,6,10,11,10,4,13,8,9,8,9,8,9,9,12,12,14,9,11,8,12,9,8,8,13,9,15,14,11,9,13,14,10,12,13,20,13,16,10,5,10,7,4,12,15,17,12,12,17,13,6,1,1,1,1,1,1,1,S ,600,1,1,20,1,1,1,1,1,1,1,1,1,1,1,1,0,0,0,0,0,0,0,0,0,0,0,0,0,0,0,0,0,0,0,0,0,0,0,0,0,0,0,0,0,0,0,0,0,0,0,0,0,0,0,0,0,0,0,0,0,0,0,0,0,Marcel Schäfer,£5.40m ,36,184,Defender - Left-Back,left,Retired,36,1,8,3240,35,5,7,3103,35,0,3,2350,27,3,2,873,25,0,3,1142,27,1,3,1492,38,7,11,3112,13,0,4,1117,nan,nan,nan,nan,Bundesliga,nan,nan,nan,nan,nan,nan,nan,nan
13/6/2011,Manuel Pforr,92022202,771,1/3/1989,22,0,0,0,0,250,3000,3000,85,60,4960,176,0,S ,3,3,3,1,2,1,2,4,3,1,1,7,7,10,13,9,9,10,3,1,5,9,6,5,10,12,5,6,11,9,5,10,10,8,10,9,5,16,11,9,12,13,7,2,11,13,20,6,4,8,7,1,6,10,5,16,14,14,15,13,17,11,1,1,1,1,1,1,1,S ,600,1,1,20,1,1,1,1,1,1,1,1,1,1,1,1,0,0,0,0,0,0,0,0,0,0,0,0,0,0,0,0,0,0,0,0,0,0,0,0,0,0,0,0,0,0,0,0,0,0,0,0,0,0,0,0,0,0,0,0,0,0,0,0,0,,,,,,,,,,,,,,,,,,,,,,,,,,,,,,,,,,,,,,,,,,,,,,,,,,,,
13/6/2011,Mana Dembelé,85029592,769,11/29/1988,22,0,0,0,0,2100,4454,3250,130,99,295749,180,68,AM/S R,3,1,1,1,1,2,2,1,1,2,1,6,8,11,11,12,7,11,11,5,4,8,12,4,12,9,12,9,12,10,7,7,14,12,6,13,4,8,12,14,13,13,11,5,12,13,20,13,9,12,9,10,7,8,10,14,18,11,14,14,14,6,1,1,1,16,16,10,1,AM/S R,622,1,1,20,1,10,16,1,1,1,1,1,1,1,1,1,0,0,0,0,0,0,0,0,0,0,0,0,0,0,0,0,0,0,0,0,0,0,0,0,0,0,0,0,0,0,0,0,0,0,0,0,0,0,0,0,0,0,0,0,0,0,0,0,0,,,,,,,,,,,,,,,,,,,,,,,,,,,,,,,,,,,,,,,,,,,,,,,,,,,,
13/6/2011,Lynel Kitambala,8438121,769,10/26/1988,22,0,0,6,4,3500,5350,5350,145,119,3018466,177,72,S ,3,3,2,1,1,2,3,2,1,1,1,6,11,12,13,13,8,11,10,5,3,9,11,3,13,9,12,9,13,11,8,11,14,15,7,15,6,8,11,12,15,13,9,20,14,15,10,15,13,12,8,14,6,9,13,14,14,13,10,14,14,11,8,8,10,14,14,12,1,S ,600,1,1,20,1,12,14,1,1,8,1,1,1,10,1,8,8388624,0,0,0,0,1,0,0,0,0,0,0,0,0,0,0,0,0,0,0,0,0,0,0,1,0,0,0,0,0,0,0,0,0,0,0,0,0,0,0,0,0,0,0,0,0,0,0,0,Lynel Kitambala,£1.80m ,32,178,Forward - Centre-Forward,left,Football Club 93 Bobigny,33,8,4,2316,22,0,3,873,18,2,0,699,33,4,1,1865,33,5,2,1724,16,2,0,1080,nan,nan,nan,nan,12,6,0,587,7,1,0,411,Ligue 1,0,0,0,0,2,0,0,156
13/6/2011,Lukas Jutkiewicz,5130321,765,3/20/1989,22,0,0,0,0,2700,5750,5750,135,114,3370239,186,81,S ,1,1,1,2,1,3,3,1,3,2,1,10,9,11,14,14,9,13,10,10,4,12,15,9,12,15,10,14,12,7,6,9,15,11,8,14,9,13,13,12,5,11,13,20,13,13,11,12,14,11,3,10,12,9,13,15,13,13,10,14,10,4,1,1,1,1,1,1,1,S ,600,1,1,20,1,1,1,1,1,1,1,1,1,1,1,1,512,0,0,0,0,0,0,0,0,0,1,0,0,0,0,0,0,0,0,0,0,0,0,0,0,0,0,0,0,0,0,0,0,0,0,0,0,0,0,0,0,0,0,0,0,0,0,0,0,,,,,,,,,,,,,,,,,,,,,,,,,,,,,,,,,,,,,,,,,,,,,,,,,,,,
13/6/2011,Livio Nabab,34006509,769,6/14/1988,22,0,0,0,0,3850,4859,4850,125,108,803537,185,72,AM/S R,2,2,1,2,2,1,1,1,2,3,1,5,8,11,9,11,8,13,11,6,3,9,10,3,11,7,10,11,7,9,8,6,13,11,5,12,5,9,11,17,13,13,12,5,13,16,20,14,11,11,7,13,11,8,13,13,12,10,9,10,10,8,1,1,12,17,17,12,1,AM/S R,622,1,1,20,1,12,17,1,1,1,1,1,12,12,1,1,16,0,0,0,0,1,0,0,0,0,0,0,0,0,0,0,0,0,0,0,0,0,0,0,0,0,0,0,0,0,0,0,0,0,0,0,0,0,0,0,0,0,0,0,0,0,0,0,0,Livio Nabab,£720Th. ,32,185,Forward - Centre-Forward,right,US Granville,22,1,0,1101,25,6,3,1867,37,5,1,2589,39,10,4,2955,31,4,0,1861,22,2,2,706,35,5,2,2809,24,1,0,750,24,5,3,1917,Ligue 1,22,4,1,1288,6,2,0,376
13/6/2011,Libor Kozák,43023887,763,5/30/1989,22,0,0,10,3,3000,5399,6000,145,120,2884322,193,82,S ,1,1,1,1,1,1,1,1,1,1,1,5,8,10,16,9,6,20,8,4,7,10,11,13,10,13,9,16,11,15,9,13,11,5,3,10,6,13,16,11,7,16,17,7,17,13,20,17,19,10,16,11,6,4,9,10,6,9,7,8,9,8,1,1,1,1,1,1,1,S ,600,1,1,20,1,1,1,1,1,1,1,1,1,1,1,1,0,0,0,0,0,0,0,0,0,0,0,0,0,0,0,0,0,0,0,0,0,0,0,0,0,0,0,0,0,0,0,0,0,0,0,0,0,0,0,0,0,0,0,0,0,0,0,0,0,Libor Kozak,£3.60m ,31,193,Forward - Centre-Forward,right,AC Sparta Praha,25,9,8,1269,24,5,5,930,31,10,0,1536,15,4,0,826,1,0,0,67,10,4,1,756,6,5,1,386,17,2,0,738,26,7,1,1808,Serie A,38,18,3,2008,6,2,0,170
13/6/2011,Lennart Hasenbeck,92037898,771,12/26/1988,22,0,0,0,0,3000,4100,4100,104,82,29955,182,74,S ,1,1,1,3,1,2,2,2,3,3,3,7,9,13,13,10,9,13,7,3,3,8,9,3,7,9,10,9,13,8,3,9,8,12,14,13,9,8,11,11,10,6,10,8,14,12,20,9,8,10,17,10,13,10,9,14,5,6,9,5,11,6,1,1,1,1,1,1,1,S ,600,1,1,20,1,1,1,1,1,1,1,1,1,1,1,1,0,0,0,0,0,0,0,0,0,0,0,0,0,0,0,0,0,0,0,0,0,0,0,0,0,0,0,0,0,0,0,0,0,0,0,0,0,0,0,0,0,0,0,0,0,0,0,0,0,,,,,,,,,,,,,,,,,,,,,,,,,,,,,,,,,,,,,,,,,,,,,,,,,,,,
13/6/2011,Lee Tomlin,5133423,765,1/12/1989,22,0,0,0,0,3000,5600,5600,140,113,3731922,181,74,M/AM/S RLC,2,1,3,2,1,2,1,1,1,1,1,10,10,14,12,14,12,6,11,3,2,13,11,6,14,15,9,13,13,10,13,11,12,16,3,12,5,10,11,11,9,12,10,10,12,14,20,9,11,10,12,11,5,13,12,14,9,10,13,7,8,10,1,1,16,20,18,20,20,M/AM/S RLC,536,1,1,16,20,20,18,1,1,1,1,14,16,16,1,1,721408,0,0,0,0,0,0,0,0,0,1,0,0,0,0,0,0,1,1,0,1,0,0,0,0,0,0,0,0,0,0,0,0,0,0,0,0,0,0,0,0,0,0,0,0,0,0,0,0,,,,,,,,,,,,,,,,,,,,,,,,,,,,,,,,,,,,,,,,,,,,,,,,,,,,
13/6/2011,Jonathan Béhé,34000006,769,1/13/1989,22,0,0,0,0,1250,2550,2550,125,102,111837,187,75,S ,1,2,3,1,3,2,3,3,3,2,2,5,6,11,12,10,8,14,10,5,4,7,12,4,11,8,9,14,10,13,8,11,14,11,5,12,7,7,12,12,9,15,13,6,15,16,20,13,13,14,8,13,9,6,8,14,8,13,9,11,11,12,1,1,1,12,1,1,12,S ,600,1,1,20,12,1,1,1,1,1,1,1,1,1,1,1,0,0,0,0,0,0,0,0,0,0,0,0,0,0,0,0,0,0,0,0,0,0,0,0,0,0,0,0,0,0,0,0,0,0,0,0,0,0,0,0,0,0,0,0,0,0,0,0,0,Jonathan,£4.05m ,34,170,Defender - Right-Back,right,Club Athletico Paranaense,7,1,0,566,18,1,2,1170,23,1,1,1727,32,4,8,2692,8,0,3,491,11,0,0,898,38,2,5,3247,33,2,6,2766,17,1,0,1312,Serie A,12,0,2,877,nan,nan,nan,nan
13/6/2011,Jimmy Roye,8443369,769,9/8/1988,22,0,0,0,0,1150,2350,2350,115,95,38373,174,68,AM/S C,2,2,3,1,1,1,2,7,2,2,1,6,8,11,7,12,10,7,9,6,4,9,11,4,12,8,11,9,11,12,9,10,14,12,5,12,6,11,15,14,13,11,7,5,15,17,20,13,7,14,7,14,5,12,10,12,12,11,14,13,13,6,1,1,12,20,12,1,20,AM/S C,511,1,1,18,20,1,12,1,1,1,1,12,1,12,1,1,4,0,0,1,0,0,0,0,0,0,0,0,0,0,0,0,0,0,0,0,0,0,0,0,0,0,0,0,0,0,0,0,0,0,0,0,0,0,0,0,0,0,0,0,0,0,0,0,0,,,,,,,,,,,,,,,,,,,,,,,,,,,,,,,,,,,,,,,,,,,,,,,,,,,,
13/6/2011,Javier Acuńa,8836000,1655,6/23/1988,22,0,0,0,0,4250,5750,5350,132,107,3305163,175,70,S ,2,1,1,2,1,1,2,1,2,3,1,6,5,8,12,6,7,14,8,10,5,9,10,6,8,11,11,13,9,7,8,6,9,11,4,11,5,9,13,15,10,8,11,13,9,17,20,12,14,10,8,6,15,9,8,15,12,8,9,11,11,11,1,1,1,13,10,13,8,S ,600,1,1,20,8,13,10,1,1,1,1,1,1,1,1,1,8388608,0,0,0,0,0,0,0,0,0,0,0,0,0,0,0,0,0,0,0,0,0,0,0,1,0,0,0,0,0,0,0,0,0,0,0,0,0,0,0,0,0,0,0,0,0,0,0,0,,,,,,,,,,,,,,,,,,,,,,,,,,,,,,,,,,,,,,,,,,,,,,,,,,,,
13/6/2011,James Vaughan,5003747,765,7/14/1988,22,0,0,4,0,3800,6000,6150,153,126,2300000,180,80,S ,1,3,2,1,2,2,1,9,2,2,1,7,6,11,13,12,10,15,11,2,3,10,10,8,11,16,11,18,12,9,5,9,17,11,10,14,9,17,19,16,16,12,13,4,12,16,20,14,12,10,12,10,15,3,14,12,13,10,13,9,9,2,1,1,1,1,1,1,1,S ,600,1,1,20,1,1,1,1,1,1,1,1,1,1,1,1,1.37439E+11,0,0,0,0,0,0,0,0,0,1,0,0,0,0,0,0,0,0,0,0,0,0,0,0,0,0,0,0,0,0,0,0,0,0,0,0,0,1,0,0,0,0,0,0,0,0,0,0,James Vaughan,£1.35m ,32,181,Forward - Centre-Forward,right,Tranmere Rovers,32,9,3,2364,8,2,0,327,37,14,3,2904,26,12,2,2050,28,7,2,1935,20,0,1,727,41,24,2,3434,46,5,1,2418,31,3,0,937,Premier League,35,13,1,2793,7,6,0,584
13/6/2011,Innocent Emeghara,98001614,798,5/27/1989,22,1,0,8,5,4500,6500,5750,135,119,5000000,170,68,S RL,2,3,2,1,3,3,1,2,3,1,1,3,6,11,11,7,5,7,9,3,6,9,13,8,8,12,8,14,13,7,6,7,13,14,7,10,4,12,15,18,14,12,8,8,13,17,20,14,12,10,5,8,3,12,12,13,7,9,12,11,12,13,1,1,1,15,15,15,1,S RL,605,1,1,20,1,15,15,1,1,1,1,1,1,1,1,1,2.2518E+15,0,0,0,0,0,0,0,0,0,0,0,0,0,0,0,0,0,0,0,0,0,0,0,0,0,0,0,0,0,0,0,0,0,0,0,0,0,0,0,0,0,0,0,0,0,0,0,0,Innocent Emeghara,£2.03m ,31,170,Forward - Centre-Forward,right,FC Winterthur,39,10,11,2660,38,12,3,2099,18,7,2,1381,30,4,7,1583,15,6,0,1052,7,0,0,183,nan,nan,nan,nan,28,9,4,2117,18,5,2,1281,Ligue 1,32,7,0,1798,2,0,0,27
13/6/2011,Hugo Vieira,55021889,788,7/25/1988,22,0,0,0,0,3000,5500,5500,137,112,3194821,172,70,AM/S RL,1,3,3,3,2,1,2,4,1,2,3,9,11,11,11,11,9,5,9,4,6,9,10,6,12,11,12,15,8,10,8,9,13,14,11,13,7,8,13,15,13,6,6,10,10,14,20,8,7,11,7,12,8,14,12,16,8,11,10,13,13,6,1,1,9,20,20,20,7,AM/S RL,515,1,1,17,7,20,20,1,1,1,1,1,9,1,1,1,0,0,0,0,0,0,0,0,0,0,0,0,0,0,0,0,0,0,0,0,0,0,0,0,0,0,0,0,0,0,0,0,0,0,0,0,0,0,0,0,0,0,0,0,0,0,0,0,0,Hugo Vieira,£1.62m ,32,178,Forward - Centre-Forward,right,Without Club,28,11,0,1582,33,7,3,2653,18,8,0,1258,20,3,2,1324,22,3,2,1356,35,20,10,2458,54,26,2,3327,44,21,5,2709,nan,nan,nan,nan,Liga NOS,13,2,1,486,nan,nan,nan,nan
13/6/2011,Hernán Pérez,79003362,1655,2/25/1989,22,10,0,0,0,4000,5750,6000,148,123,3390333,180,77,AM R,3,3,2,3,1,1,1,3,2,3,3,10,10,13,12,13,10,10,9,9,5,11,10,8,12,7,12,12,11,11,13,12,10,9,10,15,7,11,13,15,13,9,8,11,10,13,20,12,9,9,9,10,13,10,10,9,15,7,6,15,9,6,1,1,8,20,20,7,13,AM R,502,1,1,15,13,7,20,1,1,1,1,1,1,8,1,1,0,0,0,0,0,0,0,0,0,0,0,0,0,0,0,0,0,0,0,0,0,0,0,0,0,0,0,0,0,0,0,0,0,0,0,0,0,0,0,0,0,0,0,0,0,0,0,0,0,Hernán Pérez,£1.80m ,31,180,Forward - Right Winger,right,Al-Ahli SC,34,4,1,2449,27,4,1,1538,16,2,2,889,27,3,3,1712,16,4,4,1250,33,7,2,2517,35,4,0,1977,17,0,0,701,21,2,2,892,LaLiga,20,4,3,1755,4,1,0,359
13/6/2011,Hal Robson-Kanu,4002231,801,5/21/1989,22,3,0,4,2,2450,5450,5200,129,107,1059398,171,74,AM/S RL,2,1,2,3,2,3,2,4,3,1,2,10,10,12,10,9,8,10,8,3,5,8,12,7,13,6,8,9,8,10,10,11,17,14,4,12,7,10,12,14,9,13,11,20,18,14,10,12,14,10,2,7,3,9,10,15,15,15,15,16,13,4,1,1,15,20,19,20,1,AM/S RL,515,1,1,18,1,20,19,1,1,1,1,1,15,15,1,1,0,0,0,0,0,0,0,0,0,0,0,0,0,0,0,0,0,0,0,0,0,0,0,0,0,0,0,0,0,0,0,0,0,0,0,0,0,0,0,0,0,0,0,0,0,0,0,0,0,,,,,,,,,,,,,,,,,,,,,,,,,,,,,,,,,,,,,,,,,,,,,,,,,,,,
13/6/2011,Guido Koçer,35011615,799,9/15/1988,22,0,0,1,0,2800,4450,5000,112,97,655583,175,78,M/AM RL,1,3,1,3,1,2,2,3,1,1,3,9,10,12,12,11,9,8,10,5,7,9,9,7,12,8,10,12,9,9,11,10,10,8,7,12,9,10,11,13,13,8,7,20,10,12,7,9,10,8,5,8,6,4,13,11,2,20,18,4,4,20,1,1,16,20,18,20,13,M/AM RL,525,1,1,15,13,20,18,1,1,1,1,11,16,15,1,1,0,0,0,0,0,0,0,0,0,0,0,0,0,0,0,0,0,0,0,0,0,0,0,0,0,0,0,0,0,0,0,0,0,0,0,0,0,0,0,0,0,0,0,0,0,0,0,0,0,,,,,,,,,,,,,,,,,,,,,,,,,,,,,,,,,,,,,,,,,,,,,,,,,,,,
13/6/2011,Gaëtan Courtet,85012670,769,2/22/1989,22,0,0,0,0,1150,2350,2350,125,95,117745,180,72,S ,3,2,3,2,2,1,3,2,3,3,2,6,6,11,12,11,7,14,9,5,3,7,12,3,11,9,13,12,12,12,7,11,14,9,6,13,6,11,13,12,11,13,11,5,15,11,20,15,11,14,9,10,7,5,8,13,14,18,6,7,11,5,1,1,1,1,1,1,1,S ,600,1,1,20,1,1,1,1,1,1,1,1,1,1,1,1,0,0,0,0,0,0,0,0,0,0,0,0,0,0,0,0,0,0,0,0,0,0,0,0,0,0,0,0,0,0,0,0,0,0,0,0,0,0,0,0,0,0,0,0,0,0,0,0,0,,,,,,,,,,,,,,,,,,,,,,,,,,,,,,,,,,,,,,,,,,,,,,,,,,,,
13/6/2011,Franco Jara,14004715,1649,7/15/1988,22,1,1,0,0,3500,6650,6650,143,133,10740545,182,77,S ,1,1,1,1,1,2,3,5,1,3,2,11,13,14,15,13,10,11,15,5,6,12,16,7,14,11,13,15,13,12,13,13,15,14,10,14,4,12,14,13,15,14,11,12,14,14,20,15,13,12,6,12,8,13,13,11,12,13,12,12,14,10,1,1,1,14,14,8,5,S ,600,1,1,20,5,8,14,1,1,1,1,1,1,1,1,1,525312,0,0,0,0,0,0,0,0,0,0,1,0,0,0,0,0,0,0,0,1,0,0,0,0,0,0,0,0,0,0,0,0,0,0,0,0,0,0,0,0,0,0,0,0,0,0,0,0,Franco Jara,£4.50m ,32,181,Forward - Centre-Forward,right,FC Dallas,43,11,3,1763,35,3,7,2214,26,2,0,1674,23,4,3,1621,17,6,0,1135,39,18,2,3076,35,20,7,2702,32,8,4,1965,37,21,5,2946,LaLiga,44,21,1,3313,nan,nan,nan,nan
13/6/2011,Franco di Santo,75000260,1649,4/7/1989,22,0,0,25,5,4750,5850,6500,140,120,5740041,193,83,S ,2,3,1,3,3,1,1,3,2,3,3,4,7,7,12,13,4,12,7,4,8,11,8,7,14,8,13,8,10,12,12,12,18,8,7,13,8,17,18,14,10,15,17,10,18,12,20,16,14,14,7,13,4,7,14,12,14,14,13,14,12,5,1,1,1,1,1,1,1,S ,600,1,1,20,1,1,1,1,1,1,1,1,1,1,1,1,262160,0,0,0,0,1,0,0,0,0,0,0,0,0,0,0,0,0,0,1,0,0,0,0,0,0,0,0,0,0,0,0,0,0,0,0,0,0,0,0,0,0,0,0,0,0,0,0,0,Franco Di Santo,£3.15m ,31,193,Forward - Centre-Forward,right,Club Atlético San Lorenzo de Almagro,29,1,3,1128,33,7,2,2123,35,5,5,2131,23,4,4,1663,28,14,2,2475,34,8,2,1901,15,0,2,501,34,4,2,1874,34,4,1,2123,Premier League,3,0,0,262,nan,nan,nan,nan
13/6/2011,Férébory Doré,85041478,49,1/21/1989,22,0,0,0,0,2400,5400,3600,138,108,323172,193,82,S ,3,1,1,1,3,2,2,2,1,1,1,5,8,10,10,12,6,15,9,5,5,7,12,2,12,8,12,12,11,11,7,9,8,9,5,12,4,7,10,14,10,17,16,7,12,11,20,13,17,13,8,7,6,5,5,14,12,9,12,8,7,6,1,1,1,10,10,10,1,S ,600,1,1,20,1,10,10,1,1,1,1,1,1,1,1,1,131072,0,0,0,0,0,0,0,0,0,0,0,0,0,0,0,0,0,1,0,0,0,0,0,0,0,0,0,0,0,0,0,0,0,0,0,0,0,0,0,0,0,0,0,0,0,0,0,0,,,,,,,,,,,,,,,,,,,,,,,,,,,,,,,,,,,,,,,,,,,,,,,,,,,,
13/6/2011,Edouard Butin,8439280,769,6/16/1988,22,0,0,3,2,4300,5400,5400,146,120,1388291,180,76,S ,3,3,1,2,1,1,3,4,1,2,2,5,9,12,12,12,8,13,10,6,3,12,14,3,12,7,12,11,14,13,9,10,12,12,7,15,8,7,13,15,14,14,10,10,14,11,20,12,13,14,7,15,8,5,12,11,15,11,13,13,10,10,1,1,1,1,1,1,1,S ,600,1,1,20,1,1,1,1,1,1,1,1,1,1,1,1,0,0,0,0,0,0,0,0,0,0,0,0,0,0,0,0,0,0,0,0,0,0,0,0,0,0,0,0,0,0,0,0,0,0,0,0,0,0,0,0,0,0,0,0,0,0,0,0,0,Édouard Butin,£2.25m ,32,180,Forward - Centre-Forward,right,Without Club,19,2,2,583,28,6,2,1953,6,1,0,237,12,2,0,300,33,5,1,1770,16,4,1,995,23,2,0,1174,38,6,4,1871,30,3,1,878,Ligue 1,5,0,0,191,nan,nan,nan,nan
13/6/2011,Dominique Malonga,8440232,769,1/8/1989,22,0,0,0,0,3000,5750,6250,148,128,2484367,183,80,AM/S LC,3,2,3,1,2,2,1,8,1,3,3,8,11,12,16,11,14,15,16,6,6,9,12,7,13,9,13,9,15,11,12,12,12,12,6,14,8,8,7,14,12,14,12,7,15,14,20,12,15,12,7,14,6,8,16,16,13,10,12,11,12,8,1,1,1,18,10,16,18,AM/S LC,624,1,1,20,18,16,10,1,1,1,1,1,1,1,1,1,0,0,0,0,0,0,0,0,0,0,0,0,0,0,0,0,0,0,0,0,0,0,0,0,0,0,0,0,0,0,0,0,0,0,0,0,0,0,0,0,0,0,0,0,0,0,0,0,0,Dominique Malonga,£630Th. ,31,185,Forward - Centre-Forward,right,Lokomotiv Plovdiv,23,2,2,777,13,0,0,712,37,9,1,2473,29,5,1,1183,31,16,5,2326,39,9,3,2196,9,1,3,132,13,7,0,609,39,14,3,2639,Serie A,nan,nan,nan,nan,nan,nan,nan,nan
13/6/2011,Djamel Bakar,8432564,769,4/6/1989,22,0,0,8,1,4400,5500,5500,150,122,1956830,171,67,S ,1,3,2,1,3,1,1,7,3,1,2,8,10,14,8,14,10,7,9,6,2,10,12,3,15,7,12,9,10,11,10,10,14,14,6,14,6,7,14,15,15,12,5,12,10,17,20,13,9,12,7,15,14,8,16,14,14,10,14,14,16,6,1,1,10,13,13,13,1,S ,600,1,1,20,1,13,13,1,1,1,1,1,10,10,1,1,2.2518E+15,0,0,0,0,1,0,0,0,0,0,0,0,0,0,0,0,0,0,0,0,0,0,0,0,0,0,0,0,0,0,0,0,0,0,0,0,0,0,0,0,0,0,0,0,0,0,0,0,Djamel Bakar,£1.58m ,31,171,Forward - Centre-Forward,right,Without Club,23,1,0,1164,36,4,2,2433,39,7,5,3089,14,1,1,626,15,1,1,283,7,0,0,290,18,2,1,828,10,0,0,299,nan,nan,nan,nan,Ligue 1,nan,nan,nan,nan,nan,nan,nan,nan
13/6/2011,Diego Costa,55002038,1651,10/7/1988,22,0,0,0,0,5000,6500,6800,155,140,2208266,186,78,AM/S C,2,1,2,2,1,3,3,1,1,2,3,11,10,15,14,16,11,12,13,7,4,14,13,7,15,16,15,14,13,11,14,13,14,16,8,15,6,9,9,16,14,13,13,7,15,14,20,14,14,11,14,13,7,13,14,15,11,13,10,12,11,14,1,1,5,16,7,12,16,AM/S C,621,1,1,20,16,12,7,1,1,1,1,4,5,1,1,1,2.26939E+15,0,0,0,0,1,0,0,0,0,0,0,0,0,0,0,0,0,0,0,1,0,0,0,0,0,0,0,0,0,0,0,0,0,0,0,0,0,0,0,0,0,0,0,0,1,0,0,0,Diego Costa,£5.85m ,32,186,Forward - Centre-Forward,right,Atlético Madrid,39,8,5,2060,16,10,4,1317,44,20,13,3054,51,36,4,4155,37,20,5,2935,41,16,11,3370,42,22,8,3490,23,7,6,1615,21,5,3,1530,LaLiga,30,5,5,1808,4,1,0,167
13/6/2011,David Pollet,8189947,757,8/21/1988,22,0,0,4,0,3250,4994,4950,138,111,273621,188,79,S ,1,2,1,3,1,2,1,6,2,1,3,5,6,9,13,12,11,14,11,5,5,8,13,2,12,8,13,13,11,11,7,10,15,12,7,14,6,9,12,13,11,15,14,8,14,11,20,14,15,14,8,14,6,5,11,14,14,11,13,14,14,6,1,1,8,8,8,1,1,S ,600,1,1,20,1,1,8,1,1,1,1,1,1,8,1,1,262144,0,0,0,0,0,0,0,0,0,0,0,0,0,0,0,0,0,0,1,0,0,0,0,0,0,0,0,0,0,0,0,0,0,0,0,0,0,0,0,0,0,0,0,0,0,0,0,0,,,,,,,,,,,,,,,,,,,,,,,,,,,,,,,,,,,,,,,,,,,,,,,,,,,,
13/6/2011,David N'Gog,8440127,769,4/1/1989,22,0,0,17,3,5250,5850,6850,152,130,10557564,188,75,S ,3,2,3,2,1,3,2,6,2,1,2,5,8,12,14,13,7,14,12,5,3,9,13,3,13,8,14,12,11,10,9,10,14,14,6,13,7,9,14,14,12,15,14,9,9,17,20,13,12,12,8,13,14,6,14,17,12,10,13,14,14,7,1,1,1,10,1,10,1,S ,600,1,1,20,1,10,1,1,1,1,1,1,1,1,1,1,16,0,0,0,0,1,0,0,0,0,0,0,0,0,0,0,0,0,0,0,0,0,0,0,0,0,0,0,0,0,0,0,0,0,0,0,0,0,0,0,0,0,0,0,0,0,0,0,0,David N'Gog,£2.70m ,31,190,Forward - Centre-Forward,right,Retired,40,8,1,2062,40,6,5,2452,35,9,5,2252,23,4,2,1134,30,7,2,1837,18,3,1,990,16,3,1,469,10,1,0,400,31,12,5,1416,Premier League,13,4,1,905,nan,nan,nan,nan
13/6/2011,David Goodwillie,5218670,793,3/28/1989,22,1,0,9,1,3700,6300,6300,153,125,4600000,176,75,S ,2,3,1,1,3,2,1,3,3,2,2,6,10,14,15,12,6,12,12,6,5,10,13,6,14,10,12,14,12,13,15,12,17,14,5,14,7,11,16,12,13,13,8,11,12,13,20,14,15,9,11,13,5,8,14,12,12,12,11,11,13,13,1,1,1,12,12,1,1,S ,600,1,1,20,1,1,12,1,1,1,1,1,1,1,1,1,0,0,0,0,0,0,0,0,0,0,0,0,0,0,0,0,0,0,0,0,0,0,0,0,0,0,0,0,0,0,0,0,0,0,0,0,0,0,0,0,0,0,0,0,0,0,0,0,0,David Goodwillie,£2.25m ,31,175,Forward - Centre-Forward,right,Clyde FC,46,19,13,4020,28,5,3,1297,11,1,1,375,36,9,3,1890,38,6,11,2342,34,3,6,1508,23,2,4,1197,22,16,4,1922,42,22,11,3632,Premier League,35,25,5,2834,3,2,0,270
13/6/2011,Cristian,67131975,796,12/22/1988,22,0,0,0,0,1800,4000,4000,114,85,159165,178,70,S ,1,1,3,1,3,1,3,1,2,1,2,9,5,13,13,13,4,13,6,1,9,12,9,3,13,12,11,3,8,5,9,8,8,11,13,13,10,16,13,13,13,13,8,9,12,13,20,8,3,9,7,10,13,10,6,9,11,10,7,3,7,13,1,1,1,1,1,1,1,S ,600,1,1,20,1,1,1,1,1,1,1,1,1,1,1,1,0,0,0,0,0,0,0,0,0,0,0,0,0,0,0,0,0,0,0,0,0,0,0,0,0,0,0,0,0,0,0,0,0,0,0,0,0,0,0,0,0,0,0,0,0,0,0,0,0,Cristiano,- ,37,174,Forward - Left Winger,left,Without Club,14,0,1,579,12,2,3,806,28,2,4,1853,nan,nan,nan,nan,nan,nan,nan,nan,nan,nan,nan,nan,nan,nan,nan,nan,nan,nan,nan,nan,nan,nan,nan,nan,Liga NOS,nan,nan,nan,nan,nan,nan,nan,nan
13/6/2011,Carlos Vela,51000001,379,3/1/1989,22,35,9,8,0,5150,7000,6750,165,133,4994175,179,72,AM/S LC,3,3,3,1,2,3,1,4,2,1,1,11,12,15,15,15,10,8,12,1,4,12,13,6,15,10,11,10,16,10,14,11,11,17,4,13,5,9,10,17,16,15,7,20,10,14,7,14,8,12,6,14,9,12,16,19,8,15,9,14,13,7,1,1,10,17,1,17,17,AM/S LC,624,1,1,20,17,17,1,1,1,1,1,1,10,1,1,1,2098192,0,0,0,0,1,0,0,0,0,0,1,0,0,0,0,0,0,0,0,0,0,1,0,0,0,0,0,0,0,0,0,0,0,0,0,0,0,0,0,0,0,0,0,0,0,0,0,0,Carlos Vela,£5.40m ,31,177,Forward - Right Winger,left,Los Angeles FC,23,6,2,885,37,12,7,2594,37,14,11,2728,52,21,13,4195,32,10,4,2173,36,5,4,2805,39,10,4,2830,48,16,12,3289,36,38,12,3176,LaLiga,5,4,0,418,nan,nan,nan,nan
13/6/2011,Ariday,67044583,796,9/26/1988,22,0,0,0,0,2250,4100,4100,110,85,672638,168,60,AM/S C,3,3,1,3,1,3,1,1,1,2,1,7,7,13,11,10,7,5,10,6,5,10,8,5,12,15,12,12,7,8,11,7,10,12,8,14,5,10,10,16,12,5,5,5,8,16,20,10,5,10,15,10,8,10,10,12,14,8,8,12,8,7,1,1,1,18,10,10,18,AM/S C,621,1,1,20,18,10,10,1,1,1,1,1,1,1,1,1,131072,0,0,0,0,0,0,0,0,0,0,0,0,0,0,0,0,0,1,0,0,0,0,0,0,0,0,0,0,0,0,0,0,0,0,0,0,0,0,0,0,0,0,0,0,0,0,0,0,,,,,,,,,,,,,,,,,,,,,,,,,,,,,,,,,,,,,,,,,,,,,,,,,,,,
13/6/2011,Andy Carroll,5128259,765,1/6/1989,22,2,1,5,2,6000,7400,7400,170,143,117479129,191,76,S ,3,2,1,1,2,2,2,4,2,1,3,4,12,11,14,16,7,17,9,6,8,12,13,8,12,15,16,18,13,14,10,12,16,10,10,16,12,15,16,9,9,16,18,20,11,14,10,13,18,14,12,13,7,8,12,10,10,14,5,7,9,15,4,1,1,1,1,1,4,S ,600,1,1,20,1,1,1,4,1,1,1,1,1,1,1,1,4.41523E+12,0,0,0,0,0,0,0,0,0,1,0,0,0,0,0,0,0,0,1,0,0,0,0,0,0,0,0,0,0,0,0,0,0,0,1,0,0,0,0,0,0,0,1,0,0,0,0,0,Andy Carroll,£13.95m ,31,193,Forward - Centre-Forward,left,Newcastle United,29,13,7,2229,47,9,6,2904,26,7,4,1954,16,2,5,1138,16,5,3,1236,32,9,2,1729,22,7,2,1580,18,3,1,859,14,1,0,568,Premier League,21,0,5,710,6,0,0,238
13/6/2011,Andis Shala,61012886,752,11/15/1988,22,0,0,0,0,1200,4015,3650,96,73,23443,192,0,S ,1,1,3,2,3,1,2,3,1,1,3,2,6,8,9,8,5,13,10,2,3,8,10,5,10,10,8,10,8,9,9,7,5,11,3,9,10,9,10,10,12,8,15,20,12,10,8,12,13,8,12,8,6,4,13,12,11,11,11,11,13,11,1,1,1,1,1,1,1,S ,600,1,1,20,1,1,1,1,1,1,1,1,1,1,1,1,0,0,0,0,0,0,0,0,0,0,0,0,0,0,0,0,0,0,0,0,0,0,0,0,0,0,0,0,0,0,0,0,0,0,0,0,0,0,0,0,0,0,0,0,0,0,0,0,0,,,,,,,,,,,,,,,,,,,,,,,,,,,,,,,,,,,,,,,,,,,,,,,,,,,,
13/6/2011,Alexis Sánchez,75000261,1652,12/19/1988,22,41,14,4,1,7250,8400,8400,184,169,161361023,168,69,AM/S RLC,1,3,2,1,2,2,1,6,2,2,1,10,14,19,12,16,8,12,14,7,6,14,12,12,16,15,16,18,14,8,15,8,16,17,7,14,4,9,16,19,16,15,6,7,17,16,20,16,14,13,9,14,6,14,11,19,15,15,16,11,14,4,1,1,10,20,20,15,19,AM/S RLC,516,1,1,19,19,15,20,1,1,1,1,1,1,10,1,1,7.04031E+13,0,0,0,0,1,0,0,0,0,0,0,0,0,0,0,0,0,0,0,0,0,0,0,0,0,0,0,0,0,0,0,0,0,0,0,1,0,0,0,0,0,0,0,0,0,0,1,0,Alexis Sánchez,£27.00m ,31,168,Forward - Centre-Forward,right,Inter Milan,33,12,11,2517,41,14,7,2640,46,11,14,2619,54,21,16,3418,52,25,12,4326,41,17,11,3289,51,30,18,4229,40,11,9,3252,27,2,4,1240,LaLiga,32,4,10,1392,5,0,2,165
13/6/2011,Zé Eduardo,316618,1651,10/29/1987,23,0,0,1,0,3250,6650,6500,145,130,3870858,179,83,M/AM/S C,1,2,3,3,1,3,3,4,3,2,3,5,12,14,12,13,5,11,11,3,7,11,13,7,14,10,13,14,9,12,12,13,12,15,4,14,7,12,16,14,15,13,10,11,14,15,20,14,13,10,7,12,7,12,6,18,5,16,8,11,14,8,1,1,18,19,13,12,19,M/AM/S C,631,1,1,20,19,12,13,1,1,1,11,18,7,9,1,1,134217744,0,0,0,0,1,0,0,0,0,0,0,0,0,0,0,0,0,0,0,0,0,0,0,0,0,0,0,1,0,0,0,0,0,0,0,0,0,0,0,0,0,0,0,0,0,0,0,0,Zé Eduardo,£450Th. ,29,186,Midfielder - Defensive Midfield,right,Sandefjord Fotball,14,0,0,1140,20,0,0,1328,35,4,3,2778,41,3,5,3331,14,1,1,735,16,0,1,1104,nan,nan,nan,nan,27,4,1,2019,30,0,1,2455,Serie A,4,1,0,166,nan,nan,nan,nan
13/6/2011,Yannick Sagbo,34001056,24,4/12/1988,23,0,0,5,2,4050,5700,5100,140,114,3625951,183,78,S R,3,1,2,3,3,3,3,2,2,1,3,5,9,12,11,13,7,11,12,6,4,11,12,2,13,7,12,11,12,12,9,10,15,12,7,14,7,9,12,15,11,14,10,5,14,14,20,7,14,12,7,14,10,8,14,13,13,12,14,14,14,5,1,1,10,15,15,1,1,S R,602,1,1,20,1,1,15,1,1,1,1,1,1,10,1,1,16,0,0,0,0,1,0,0,0,0,0,0,0,0,0,0,0,0,0,0,0,0,0,0,0,0,0,0,0,0,0,0,0,0,0,0,0,0,0,0,0,0,0,0,0,0,0,0,0,Yannick Sagbo,£2.25m ,32,183,Forward - Centre-Forward,right,Without Club,34,10,5,2505,35,12,5,2778,41,8,6,2795,34,4,2,2034,13,0,0,520,13,11,0,1156,19,13,2,1698,20,10,1,1711,21,9,0,1890,Ligue 1,10,4,1,900,3,0,0,233
13/6/2011,Yannick Agro,85013484,769,5/15/1988,23,0,0,0,0,1000,2050,2050,105,83,11341,182,69,AM R,3,3,1,1,3,1,3,1,2,3,2,6,7,11,7,11,6,8,7,8,2,6,8,2,11,6,9,9,10,8,6,7,13,12,5,10,4,8,10,15,12,13,10,5,14,14,20,10,8,12,6,10,6,10,9,11,10,11,11,14,14,7,1,1,10,20,20,1,1,AM R,502,1,1,15,1,1,20,1,1,1,1,1,1,10,1,1,2,0,1,0,0,0,0,0,0,0,0,0,0,0,0,0,0,0,0,0,0,0,0,0,0,0,0,0,0,0,0,0,0,0,0,0,0,0,0,0,0,0,0,0,0,0,0,0,0,Yannick Aguemon, ,28,180,Forward - Left Winger,right,Oud-Heverlee Leuven,nan,nan,nan,nan,3,0,0,85,0,0,0,0,29,8,0,2051,28,0,1,1504,18,0,0,839,38,6,4,2879,33,13,8,2412,17,3,5,1093,Ligue 1,27,2,6,1793,3,0,0,191
13/6/2011,Victor Anichebe,5003736,38,4/23/1988,23,7,1,0,0,4150,6500,6150,140,122,5913481,186,80,AM/S R,1,2,3,3,3,3,2,2,3,1,2,6,10,11,13,11,7,14,10,5,7,9,12,4,9,16,9,13,13,11,13,13,13,9,6,13,11,14,14,13,9,16,14,6,14,15,20,9,18,12,8,10,10,9,7,11,10,12,13,14,11,5,1,1,13,18,18,14,1,AM/S R,622,1,1,20,1,14,18,1,1,1,1,1,13,13,1,1,1.75922E+13,0,1,0,0,0,0,0,0,0,1,0,0,0,0,0,0,0,0,0,0,0,0,0,0,0,0,0,0,0,0,0,0,0,0,0,0,0,0,0,0,0,0,0,0,1,0,0,0,Victor Anichebe,£3.15m ,32,190,Forward - Centre-Forward,right,Without Club,22,2,1,1080,17,6,0,707,33,8,10,2187,25,3,3,1216,26,6,3,1360,14,0,0,628,29,5,2,2007,nan,nan,nan,nan,nan,nan,nan,nan,Premier League,nan,nan,nan,nan,nan,nan,nan,nan
13/6/2011,Ugur Albayrak,35025417,799,6/8/1988,23,0,0,0,0,250,3500,3500,95,70,21531,181,77,S ,1,1,2,3,2,1,3,3,1,3,1,7,4,12,12,12,8,12,10,3,5,8,8,3,9,4,11,3,4,7,7,5,8,8,14,12,6,15,11,12,9,11,9,8,10,11,20,6,2,10,14,10,12,10,14,14,8,11,7,5,5,12,1,1,1,8,8,8,1,S ,600,1,1,20,1,8,8,1,1,1,1,1,1,1,1,1,0,0,0,0,0,0,0,0,0,0,0,0,0,0,0,0,0,0,0,0,0,0,0,0,0,0,0,0,0,0,0,0,0,0,0,0,0,0,0,0,0,0,0,0,0,0,0,0,0,,,,,,,,,,,,,,,,,,,,,,,,,,,,,,,,,,,,,,,,,,,,,,,,,,,,
13/6/2011,Toni Pfeffing,91015340,771,10/25/1987,23,0,0,0,0,100,3050,3050,75,61,1730,175,75,AM/S RLC,2,3,2,3,2,1,2,1,2,3,2,6,8,11,7,9,6,6,5,3,6,8,1,4,8,7,6,2,11,7,4,7,8,10,6,9,4,8,10,11,10,10,7,17,9,10,20,5,2,9,5,10,17,8,4,10,11,11,7,11,13,7,1,1,13,20,20,16,18,AM/S RLC,516,1,1,17,18,16,20,1,1,1,1,13,12,12,1,1,0,0,0,0,0,0,0,0,0,0,0,0,0,0,0,0,0,0,0,0,0,0,0,0,0,0,0,0,0,0,0,0,0,0,0,0,0,0,0,0,0,0,0,0,0,0,0,0,0,,,,,,,,,,,,,,,,,,,,,,,,,,,,,,,,,,,,,,,,,,,,,,,,,,,,
13/6/2011,Tayfun Pektürk,91003611,771,5/13/1988,23,0,0,0,0,1650,5100,5100,118,110,146724,177,74,AM/S RL,1,1,1,2,3,2,1,7,3,1,3,7,8,11,9,10,10,5,8,2,3,8,9,6,11,9,9,13,9,5,7,7,8,12,7,10,5,6,7,14,13,7,7,15,10,14,20,9,7,6,6,9,6,12,6,13,9,6,7,12,8,17,1,1,14,20,18,20,12,AM/S RL,515,1,1,18,12,20,18,1,1,1,1,1,14,14,1,1,0,0,0,0,0,0,0,0,0,0,0,0,0,0,0,0,0,0,0,0,0,0,0,0,0,0,0,0,0,0,0,0,0,0,0,0,0,0,0,0,0,0,0,0,0,0,0,0,0,,,,,,,,,,,,,,,,,,,,,,,,,,,,,,,,,,,,,,,,,,,,,,,,,,,,
13/6/2011,Takayuki Morimoto,785537,116,5/7/1988,23,6,1,7,5,4000,6545,5850,137,119,1249504,180,75,S ,1,1,1,1,1,1,1,1,1,1,1,5,11,11,14,9,8,9,7,5,5,10,16,8,12,15,13,15,10,14,11,10,18,10,10,15,9,15,15,16,14,11,10,8,12,14,20,11,10,11,8,14,15,10,14,14,18,11,20,15,10,1,1,1,1,14,14,10,1,S ,600,1,1,20,1,10,14,1,1,1,1,1,1,1,1,1,5.49757E+11,0,0,0,0,0,0,0,0,0,0,0,0,0,0,0,0,0,0,0,0,1,0,0,0,0,0,0,0,0,0,0,0,0,0,0,0,0,0,0,1,0,0,0,0,0,0,0,0,Takayuki Morimoto,£2.25m ,32,180,Forward - Centre-Forward,right,AEP Kozanis,13,2,0,572,19,4,2,973,42,11,2,2173,37,12,0,2357,30,5,1,1991,18,4,2,577,22,7,1,677,29,6,2,1727,25,1,0,724,Serie A,3,0,0,70,nan,nan,nan,nan
13/6/2011,Takashi Inui,45005560,116,6/2/1988,23,3,0,2,0,5000,5650,5450,137,110,1358375,169,59,S C,1,2,3,3,3,2,2,3,2,3,2,8,9,12,12,11,6,11,9,1,6,11,8,1,11,12,12,6,12,8,11,12,9,15,3,11,11,8,12,14,13,12,5,11,14,15,20,11,6,10,10,2,3,10,12,17,5,8,15,8,12,11,1,1,8,15,1,1,15,S C,601,1,1,20,15,1,1,1,1,1,1,8,1,1,1,1,0,0,0,0,0,0,0,0,0,0,0,0,0,0,0,0,0,0,0,0,0,0,0,0,0,0,0,0,0,0,0,0,0,0,0,0,0,0,0,0,0,0,0,0,0,0,0,0,0,,,,,,,,,,,,,,,,,,,,,,,,,,,,,,,,,,,,,,,,,,,,,,,,,,,,
13/6/2011,Simon Terodde,91014806,771,3/2/1988,23,0,0,0,0,4350,5350,5550,125,107,1734862,192,75,S ,2,1,1,2,3,2,2,1,3,3,1,8,7,9,13,9,10,15,6,3,8,11,11,8,10,9,11,10,10,11,13,13,8,6,13,11,11,11,12,11,10,11,17,5,12,12,20,12,15,10,6,10,14,10,7,2,14,5,8,12,14,11,1,1,1,1,1,1,1,S ,600,1,1,20,1,1,1,1,1,1,1,1,1,1,1,1,0,0,0,0,0,0,0,0,0,0,0,0,0,0,0,0,0,0,0,0,0,0,0,0,0,0,0,0,0,0,0,0,0,0,0,0,0,0,0,0,0,0,0,0,0,0,0,0,0,,,,,,,,,,,,,,,,,,,,,,,,,,,,,,,,,,,,,,,,,,,,,,,,,,,,
13/6/2011,Simon Hébras,34008278,769,3/9/1988,23,0,0,0,0,1400,2800,2800,115,86,30834,175,68,S ,3,1,2,2,2,3,2,2,1,1,2,7,7,11,12,11,6,9,9,5,2,9,14,2,11,8,13,11,11,12,7,11,10,11,5,13,5,9,12,14,14,12,7,5,14,11,20,14,8,14,8,10,7,5,7,17,15,6,14,14,14,13,1,1,1,1,1,1,1,S ,600,1,1,20,1,1,1,1,1,1,1,1,1,1,1,1,0,0,0,0,0,0,0,0,0,0,0,0,0,0,0,0,0,0,0,0,0,0,0,0,0,0,0,0,0,0,0,0,0,0,0,0,0,0,0,0,0,0,0,0,0,0,0,0,0,,,,,,,,,,,,,,,,,,,,,,,,,,,,,,,,,,,,,,,,,,,,,,,,,,,,
13/6/2011,Sidney Sam,35006408,771,1/31/1988,23,0,0,7,1,5000,7000,7000,158,142,11690515,174,72,AM RL,2,1,1,1,3,3,1,1,2,2,2,9,13,16,17,16,10,5,17,7,5,12,14,6,15,11,9,10,13,9,8,8,12,18,5,10,5,6,12,18,18,9,7,20,13,16,7,13,8,10,6,13,6,12,10,14,11,13,14,13,11,8,1,1,14,20,20,16,14,AM RL,505,1,1,15,14,16,20,1,1,1,1,8,13,14,1,1,5.49756E+11,1,1,0,0,0,0,0,0,1,0,0,1,0,0,0,0,0,0,0,0,0,0,0,0,0,0,0,0,0,0,0,0,0,0,0,0,0,0,0,1,0,0,0,0,0,0,0,0,Sidney Sam,£5.85m ,32,174,Forward - Right Winger,left,Antalyaspor,40,12,8,2870,25,6,4,2045,28,5,5,1177,31,13,9,2026,16,0,1,762,8,1,0,318,23,4,3,1669,24,0,1,1726,19,2,3,1147,Bundesliga,23,6,8,1544,3,1,0,123
13/6/2011,Sergio Agüero,957002,1649,6/2/1988,23,30,13,10,3,8250,8800,8800,186,176,45000000,172,74,AM/S C,2,2,3,3,2,1,1,4,3,1,1,7,14,18,15,17,15,10,15,3,5,17,17,6,18,10,17,14,16,13,16,16,15,19,13,18,7,10,12,18,19,13,7,15,12,15,20,13,10,11,6,16,7,12,15,16,8,16,15,14,14,11,1,1,1,18,11,11,18,AM/S C,621,1,1,20,18,11,11,1,1,1,1,1,1,1,1,1,1.75922E+13,0,0,1,0,0,0,0,0,1,0,1,0,0,0,0,0,0,0,0,1,0,0,0,0,0,0,0,0,0,0,0,0,0,0,0,0,0,0,0,0,0,0,0,0,1,0,0,0,Sergio Agüero,£45.90m ,32,173,Forward - Centre-Forward,right,Manchester City,41,27,7,3366,48,30,12,3471,40,17,5,2716,34,28,14,2288,42,32,9,3200,44,29,5,3523,45,33,7,3503,39,30,7,2933,46,32,10,3370,Premier League,32,23,4,2092,3,1,0,178
13/6/2011,Sebastián Ribas,78004965,1657,3/11/1988,23,0,0,0,0,3300,5669,6050,140,126,3260044,189,86,S ,3,2,2,2,1,1,1,4,3,2,2,4,5,8,16,11,10,16,12,4,6,12,15,4,11,12,14,15,15,13,9,13,17,12,13,14,9,11,13,12,10,17,14,12,16,9,20,13,17,15,12,14,5,5,12,14,12,13,16,13,13,7,1,1,1,1,1,1,1,S ,600,1,1,20,1,1,1,1,1,1,1,1,1,1,1,1,262144,0,0,0,0,0,0,0,0,0,0,0,0,0,0,0,0,0,0,1,0,0,0,0,0,0,0,0,0,0,0,0,0,0,0,0,0,0,0,0,0,0,0,0,0,0,0,0,0,Sebastián Ribas,£2.16m ,32,189,Forward - Centre-Forward,right,Club Atlético Central Córdoba (SdE),39,23,4,3399,7,0,0,346,7,0,0,356,13,4,0,757,24,6,0,1735,21,1,1,910,28,11,0,1993,29,14,4,2398,21,5,1,1257,Serie A,21,3,2,828,nan,nan,nan,nan
13/6/2011,Sandro Wagner,8707861,771,11/29/1987,23,0,0,8,4,4000,6100,6100,138,122,4901459,194,87,S ,1,2,1,3,1,3,3,4,3,1,2,5,7,9,13,11,5,13,11,8,5,9,11,7,11,9,12,13,11,13,11,12,10,12,8,13,10,15,15,11,10,14,17,20,14,13,12,16,16,7,8,13,5,4,15,11,8,8,9,14,7,13,1,1,1,1,1,1,1,S ,600,1,1,20,1,1,1,1,1,1,1,1,1,1,1,1,0,0,0,0,0,0,0,0,0,0,0,0,0,0,0,0,0,0,0,0,0,0,0,0,0,0,0,0,0,0,0,0,0,0,0,0,0,0,0,0,0,0,0,0,0,0,0,0,0,Sandro Wagner,£720Th. ,32,194,Forward - Centre-Forward,right,Retired,30,6,0,1541,28,3,1,1716,33,7,2,1176,28,2,0,822,17,0,1,356,34,15,4,2656,33,12,4,2811,35,15,6,2187,38,13,2,2557,Bundesliga,nan,nan,nan,nan,nan,nan,nan,nan
13/6/2011,Rodrigo Mora,78004963,1657,10/29/1987,23,0,0,0,0,3250,6250,6000,137,126,4878640,171,71,S ,2,1,3,2,1,2,1,1,3,3,3,13,13,14,13,12,14,7,12,7,6,13,13,4,14,13,13,10,13,8,13,13,14,15,12,14,8,9,12,16,15,8,8,13,14,14,20,14,12,12,11,10,7,13,13,15,4,10,11,13,12,9,1,1,6,12,7,10,12,S ,600,1,1,20,12,10,7,1,1,1,1,4,6,4,1,1,0,0,0,0,0,0,0,0,0,0,0,0,0,0,0,0,0,0,0,0,0,0,0,0,0,0,0,0,0,0,0,0,0,0,0,0,0,0,0,0,0,0,0,0,0,0,0,0,0,Rodrigo Mora,£900Th. ,32,170,Forward - Centre-Forward,right,Retired,15,11,7,1303,24,11,10,1666,33,7,1,1981,35,6,4,2107,56,18,5,4117,19,5,1,1312,18,3,2,809,19,2,3,935,6,2,0,349,Liga NOS,nan,nan,nan,nan,nan,nan,nan,nan
13/6/2011,Robinho,19054414,1651,9/8/1987,23,0,0,0,0,2250,5900,5900,136,118,3608897,176,66,S ,1,3,1,3,2,1,3,1,1,3,2,8,7,13,11,12,6,12,8,6,3,10,12,3,14,12,13,11,12,13,12,13,13,14,9,14,6,9,13,15,15,8,8,20,13,15,10,14,8,12,5,10,6,11,11,13,11,13,12,9,8,8,1,1,1,1,1,1,1,S ,600,1,1,20,1,1,1,1,1,1,1,1,1,1,1,1,34359738384,0,0,0,0,1,0,0,0,0,0,0,0,0,0,0,0,0,0,0,0,0,0,0,0,0,0,0,0,0,0,0,0,0,0,0,1,0,0,0,0,0,0,0,0,0,0,0,0,Robinho,£16.65m ,36,172,Forward - Left Winger,right,Without Club,45,15,6,3096,40,10,14,2534,27,2,5,1138,48,9,5,2926,13,5,1,929,38,13,7,2588,37,9,5,2508,14,4,3,908,34,12,5,2717,Serie A,25,0,0,944,nan,nan,nan,nan
13/6/2011,Robert Acquafresca,1408487,776,9/11/1987,23,0,0,21,14,4750,6650,6650,148,132,4351954,184,67,S ,2,2,1,3,3,3,1,5,2,2,1,4,8,10,14,10,7,14,12,7,5,13,16,6,14,10,15,15,14,15,10,13,12,10,9,16,10,17,15,11,14,14,13,12,16,14,20,16,12,10,6,11,6,6,6,12,16,10,12,18,15,2,1,1,1,1,1,1,1,S ,600,1,1,20,1,1,1,1,1,1,1,1,1,1,1,1,1024,0,0,0,0,0,0,0,0,0,0,1,0,0,0,0,0,0,0,0,0,0,0,0,0,0,0,0,0,0,0,0,0,0,0,0,0,0,0,0,0,0,0,0,0,0,0,0,0,Robert Acquafresca,£3.15m ,33,184,Forward - Centre-Forward,right,Without Club,39,9,3,2450,34,5,2,1773,23,3,0,1392,20,0,0,860,29,4,1,1674,7,0,0,249,6,0,0,200,8,5,0,373,1,0,0,4,Serie A,nan,nan,nan,nan,nan,nan,nan,nan
13/6/2011,Raúl Bobadilla,14001323,1649,6/18/1987,23,0,0,0,0,4250,5250,6250,136,124,3563980,180,82,S ,3,3,1,1,3,2,1,7,1,1,1,8,12,15,7,15,12,11,10,6,5,13,12,8,16,14,10,19,6,6,7,7,13,17,4,9,8,4,17,15,13,18,10,12,8,17,20,10,16,7,10,9,13,4,6,14,10,7,4,9,5,16,1,1,1,1,1,1,1,S ,600,1,1,20,1,1,1,1,1,1,1,1,1,1,1,1,2.25184E+15,0,0,0,0,0,0,0,0,0,0,0,1,0,0,0,0,0,0,1,0,0,0,0,0,0,0,0,0,0,0,1,0,0,0,0,1,0,0,0,0,0,0,0,0,0,0,0,0,Raúl Bobadilla,£2.25m ,33,180,Forward - Centre-Forward,right,Club Guaraní,24,5,3,1518,28,8,6,1675,33,15,7,2398,22,4,1,1046,32,10,4,2618,36,11,3,2364,19,5,2,1134,14,0,0,454,21,0,0,1186,Bundesliga,25,12,4,1473,nan,nan,nan,nan
13/6/2011,Raphaël Cacérčs,34005433,769,9/1/1987,23,0,0,0,0,3450,5250,5250,135,117,2485947,187,80,AM/S C,1,1,3,1,3,3,1,1,3,2,1,10,7,13,11,13,13,10,12,5,4,11,12,3,16,9,10,12,13,13,11,11,16,12,7,12,8,14,15,15,12,14,13,5,14,12,20,17,14,14,9,14,7,8,9,12,12,11,14,14,14,6,1,1,9,20,12,12,20,AM/S C,511,1,1,18,20,12,12,1,1,1,1,9,1,1,1,1,3.52187E+13,0,0,1,0,0,0,0,0,0,0,0,0,0,0,0,0,0,0,0,0,0,0,0,0,0,0,0,0,0,0,0,0,0,0,0,1,0,0,0,0,0,0,0,0,0,1,0,0,Raphaël Cacérès,£720Th. ,33,187,Forward - Centre-Forward,right,Retired,30,6,2,1674,34,11,2,2010,33,12,1,2342,51,6,4,2285,26,4,1,1684,24,7,3,1166,17,1,0,712,1,0,0,44,nan,nan,nan,nan,Ligue 1,nan,nan,nan,nan,nan,nan,nan,nan
13/6/2011,Rachid Bouallal,35020966,34,11/9/1987,23,0,0,0,0,1000,3550,3550,95,76,233187,182,83,AM RL,1,3,2,2,1,3,3,3,2,3,2,9,9,11,7,9,8,7,7,6,5,9,7,7,11,13,8,7,6,6,11,6,10,12,5,8,6,8,7,11,11,8,11,20,7,12,15,8,8,8,14,6,8,9,14,12,15,13,6,8,6,14,1,5,13,20,20,17,10,AM RL,505,1,1,15,10,17,20,1,1,1,1,7,10,13,3,5,0,0,0,0,0,0,0,0,0,0,0,0,0,0,0,0,0,0,0,0,0,0,0,0,0,0,0,0,0,0,0,0,0,0,0,0,0,0,0,0,0,0,0,0,0,0,0,0,0,,,,,,,,,,,,,,,,,,,,,,,,,,,,,,,,,,,,,,,,,,,,,,,,,,,,
13/6/2011,Paul Taylor,30019837,765,10/4/1987,23,0,0,0,0,2000,4450,4450,106,92,134938,173,71,AM C,2,1,2,1,1,3,1,1,2,1,1,10,8,14,12,13,6,9,7,1,6,9,12,4,12,13,10,14,11,8,7,8,9,13,2,14,3,10,10,15,13,13,7,7,5,14,20,6,6,8,12,12,6,3,5,13,5,11,1,2,4,19,1,1,9,20,8,4,20,AM C,501,1,1,15,20,4,8,1,1,1,1,9,1,1,1,1,1.75923E+13,0,0,0,0,0,0,0,0,0,0,0,0,0,0,0,0,0,0,0,1,0,0,0,0,0,0,0,1,0,0,0,0,0,0,0,0,0,0,0,0,0,0,0,0,1,0,0,0,,,,,,,,,,,,,,,,,,,,,,,,,,,,,,,,,,,,,,,,,,,,,,,,,,,,
13/6/2011,Patrick Mayer,35015111,771,3/28/1988,23,0,0,0,0,2500,5800,5800,128,115,3178809,179,74,S ,1,2,1,2,3,3,3,5,2,1,3,5,9,10,15,10,6,12,12,5,6,11,11,6,11,8,12,13,15,12,12,12,11,9,7,14,9,11,13,14,12,11,11,8,12,13,20,11,10,14,4,11,4,6,9,14,9,10,10,10,11,8,1,1,1,1,1,1,1,S ,600,1,1,20,1,1,1,1,1,1,1,1,1,1,1,1,0,0,0,0,0,0,0,0,0,0,0,0,0,0,0,0,0,0,0,0,0,0,0,0,0,0,0,0,0,0,0,0,0,0,0,0,0,0,0,0,0,0,0,0,0,0,0,0,0,Patrick Mayer,£450Th. ,32,180,Forward - Centre-Forward,right,Retired,30,19,6,2573,6,1,4,404,9,2,1,308,23,9,1,1237,14,3,1,343,9,0,0,427,12,2,2,648,13,4,1,542,nan,nan,nan,nan,Bundesliga,nan,nan,nan,nan,nan,nan,nan,nan
13/6/2011,Pascal Stadelmann,35016268,771,8/10/1987,23,0,0,0,0,500,2500,2500,81,60,4784,191,85,S ,2,1,1,1,2,3,2,1,3,3,1,3,3,11,11,9,7,11,4,5,1,4,6,4,6,14,8,5,11,8,5,5,10,16,2,11,5,6,9,9,10,10,10,17,9,11,20,4,2,9,8,10,8,9,14,11,13,15,14,14,7,11,1,1,1,1,1,1,1,S ,600,1,1,20,1,1,1,1,1,1,1,1,1,1,1,1,0,0,0,0,0,0,0,0,0,0,0,0,0,0,0,0,0,0,0,0,0,0,0,0,0,0,0,0,0,0,0,0,0,0,0,0,0,0,0,0,0,0,0,0,0,0,0,0,0,,,,,,,,,,,,,,,,,,,,,,,,,,,,,,,,,,,,,,,,,,,,,,,,,,,,
13/6/2011,Oscar Trejo,958318,1649,4/26/1988,23,0,0,0,0,4600,5600,6500,147,130,1972554,180,79,S ,2,1,1,3,1,3,3,2,3,1,3,8,11,13,14,15,8,7,10,7,4,13,13,6,15,9,11,12,13,10,11,11,7,14,6,14,5,11,12,17,15,10,8,11,12,15,20,13,11,10,6,13,6,9,13,5,8,5,13,11,9,1,1,1,1,12,5,5,12,S ,600,1,1,20,12,5,5,1,1,1,1,1,1,1,1,1,1040,0,0,0,0,1,0,0,0,0,0,1,0,0,0,0,0,0,0,0,0,0,0,0,0,0,0,0,0,0,0,0,0,0,0,0,0,0,0,0,0,0,0,0,0,0,0,0,0,Óscar Trejo,£2.25m ,32,180,Midfielder - Attacking Midfield,right,Rayo Vallecano,41,10,0,3086,33,4,2,2333,42,6,10,3537,35,3,1,2246,32,4,3,2137,38,5,6,2408,31,2,6,2467,36,12,5,3034,27,1,4,1856,LaLiga,39,5,1,3103,6,0,0,221
13/6/2011,Nolan Roux,8440066,769,3/1/1988,23,0,0,1,2,4750,5950,5950,150,132,4676730,182,79,S ,2,2,3,3,1,1,1,7,2,1,2,5,10,14,12,14,11,9,13,5,4,10,12,5,14,11,12,12,13,11,11,12,15,13,7,14,7,11,15,16,15,14,12,8,15,14,20,15,13,13,11,16,8,8,14,15,12,13,15,13,13,8,1,1,1,12,12,12,1,S ,600,1,1,20,1,12,12,1,1,1,1,1,1,1,1,1,4.39805E+12,0,0,0,0,1,0,0,0,0,0,0,0,0,0,0,0,0,0,0,0,0,0,0,0,0,0,0,0,0,0,0,0,0,0,0,0,0,0,0,0,0,0,1,0,0,0,0,0,Nolan Roux,£5.85m ,32,182,Forward - Centre-Forward,right,Nîmes Olympique,30,6,5,2463,38,12,6,2717,44,11,4,2568,33,10,7,2453,43,10,3,2832,44,11,8,3149,33,5,1,1894,38,16,1,3075,31,3,0,1887,Ligue 1,23,5,0,1272,5,0,0,214
13/6/2011,Nikita Rukavytsya,15001996,1435,6/22/1987,23,7,0,13,1,3700,5500,5750,134,122,3300103,183,74,AM/S L,1,3,2,1,1,3,3,3,1,3,2,6,8,13,9,12,12,7,13,6,4,9,5,5,13,10,9,8,10,10,8,9,17,13,7,11,10,9,12,17,15,14,12,20,15,17,6,15,11,10,8,10,7,10,10,15,14,10,15,10,10,1,1,1,9,20,14,20,10,AM/S L,513,1,1,18,10,20,14,1,1,1,1,1,9,1,1,1,1.75923E+13,0,0,0,0,0,0,0,0,0,1,0,0,0,0,0,0,0,0,0,0,0,0,0,1,0,0,0,1,0,0,0,0,0,0,0,0,0,0,0,0,0,0,0,0,1,0,0,0,Nikita Rukavytsya,£1.58m ,33,185,Forward - Centre-Forward,left,Maccabi Haifa,32,4,13,2290,26,2,4,1468,10,0,0,520,22,2,0,763,28,4,4,2048,29,14,2,2335,25,6,1,1621,36,13,2,2719,37,9,2,2620,Bundesliga,42,23,6,3291,6,8,4,451
13/6/2011,Nicolas Burel,85076574,769,6/6/1988,23,0,0,0,0,1050,2150,2150,105,86,8265,180,78,S ,3,3,2,1,2,2,2,2,3,2,1,5,5,9,9,12,7,14,9,5,3,10,11,2,9,9,12,13,11,11,8,11,15,8,6,10,6,12,14,12,11,13,10,5,14,11,20,14,13,12,9,13,6,10,13,10,13,10,14,14,14,5,8,1,1,12,1,1,12,S ,600,1,1,20,12,1,1,8,1,1,1,1,1,1,1,1,262144,0,0,0,0,0,0,0,0,0,0,0,0,0,0,0,0,0,0,1,0,0,0,0,0,0,0,0,0,0,0,0,0,0,0,0,0,0,0,0,0,0,0,0,0,0,0,0,0,Nicolas Frey,£1.08m ,36,184,Defender - Right-Back,right,Without Club,21,0,2,1682,29,0,0,2422,22,0,1,1900,33,0,1,2797,32,0,1,2736,20,0,0,1603,17,0,0,1275,12,0,1,1017,5,0,0,226,Serie A,10,0,0,750,nan,nan,nan,nan
13/6/2011,Nicklas Bendtner,940318,764,1/16/1988,23,38,12,4,2,6250,7700,7250,160,140,14322413,194,84,S ,1,3,1,1,2,1,3,7,1,2,2,9,11,14,13,13,10,15,10,3,3,13,14,7,16,14,13,14,13,9,13,12,14,14,5,16,6,7,14,14,11,16,16,12,12,13,20,11,15,12,8,14,8,10,15,20,13,12,12,7,10,19,1,1,1,14,14,12,1,S ,600,1,1,20,1,12,14,1,1,1,1,1,1,1,1,1,1576960,0,0,0,0,0,0,0,0,0,0,0,0,1,0,0,0,0,0,0,1,1,0,0,0,0,0,0,0,0,0,0,0,0,0,0,0,0,0,0,0,0,0,0,0,0,0,0,0,Nicklas Bendtner,£7.65m ,32,194,Forward - Centre-Forward,right,Retired,32,9,5,1454,31,8,5,2420,11,0,0,397,14,2,1,419,28,5,0,894,19,4,0,571,49,21,4,3465,38,13,7,3216,16,3,4,1124,Premier League,13,3,1,720,nan,nan,nan,nan
13/6/2011,Moussa Dembélé,8161845,757,7/17/1987,23,33,5,1,0,6000,7100,7000,155,139,12328679,177,64,AM/S LC,2,1,2,3,3,2,2,7,1,2,3,8,12,15,11,16,9,12,8,7,4,11,12,7,16,12,12,15,12,10,12,9,14,15,7,14,5,12,14,13,14,15,11,20,11,14,14,14,15,12,8,13,13,11,18,11,16,11,14,12,10,2,1,1,1,19,14,17,19,AM/S LC,624,1,1,20,19,17,14,1,1,1,1,1,1,1,1,1,1.75922E+13,0,0,0,0,0,0,0,0,0,0,0,0,0,0,0,0,0,0,0,0,1,0,0,0,0,0,0,0,0,0,0,0,0,0,0,0,0,0,0,0,0,0,0,0,1,0,0,0,Mousa Dembélé,£11.70m ,33,185,Midfielder - Central Midfield,left,Guangzhou R&F,28,5,4,2225,45,2,4,3487,44,2,5,3148,42,2,2,2916,40,1,1,2018,35,4,1,2511,39,1,2,2502,39,0,0,2578,39,1,5,2847,Premier League,10,0,0,773,nan,nan,nan,nan
13/6/2011,Moses Lamidi,35014947,771,1/5/1988,23,0,0,0,0,2850,5450,5450,125,109,655592,177,71,AM/S RL,1,3,2,2,3,2,3,4,3,1,2,8,12,13,11,12,6,5,9,6,4,12,9,5,13,7,8,9,7,7,8,7,12,12,5,11,4,11,12,16,16,9,7,9,8,15,20,10,9,9,9,8,12,10,15,13,7,10,12,11,10,9,1,1,12,16,16,15,5,AM/S RL,625,1,1,20,5,15,16,1,1,1,1,1,8,12,1,1,0,0,0,0,0,0,0,0,0,0,0,0,0,0,0,0,0,0,0,0,0,0,0,0,0,0,0,0,0,0,0,0,0,0,0,0,0,0,0,0,0,0,0,0,0,0,0,0,0,,,,,,,,,,,,,,,,,,,,,,,,,,,,,,,,,,,,,,,,,,,,,,,,,,,,
13/6/2011,Momar N'Diaye,8440174,41,7/13/1987,23,2,0,0,0,3750,5039,5400,120,112,699928,181,76,S ,2,2,1,2,2,1,1,1,1,2,1,5,8,12,10,12,7,11,8,5,5,11,12,7,12,5,12,12,9,10,9,7,11,12,5,13,5,10,13,16,12,14,10,12,12,13,20,12,13,8,8,3,7,8,5,11,16,12,10,14,14,7,1,1,1,14,12,12,14,S ,600,1,1,20,14,12,12,1,1,1,1,1,1,1,1,1,8192,0,0,0,0,0,0,0,0,0,0,0,0,0,1,0,0,0,0,0,0,0,0,0,0,0,0,0,0,0,0,0,0,0,0,0,0,0,0,0,0,0,0,0,0,0,0,0,0,Momar Ndoye, ,28,178,Forward - Left Winger,right,Unknown,4,0,0,131,23,2,0,675,28,4,0,1365,30,1,3,1312,9,0,0,223,11,1,0,343,13,3,0,638,nan,nan,nan,nan,nan,nan,nan,nan,LaLiga,nan,nan,nan,nan,nan,nan,nan,nan
13/6/2011,Modibo Maďga,8633054,31,9/3/1987,23,25,3,5,0,5550,6850,6150,150,137,9307386,185,76,AM/S L,3,1,2,2,3,3,1,5,3,2,2,12,11,14,14,14,11,16,13,5,6,12,14,4,15,12,13,13,13,10,11,12,16,13,8,15,9,12,12,14,13,15,13,20,14,13,8,14,15,13,10,14,7,8,12,18,5,13,5,14,14,14,1,1,12,17,12,17,10,AM/S L,623,1,1,20,10,17,12,1,1,1,1,1,12,12,1,1,262656,0,0,0,0,0,0,0,0,0,1,0,0,0,0,0,0,0,0,1,0,0,0,0,0,0,0,0,0,0,0,0,0,0,0,0,0,0,0,0,0,0,0,0,0,0,0,0,0,Modibo Maïga,£4.50m ,33,185,Forward - Centre-Forward,left,Without Club,39,16,3,3258,25,9,2,1792,20,4,2,678,27,3,3,1581,27,9,2,2000,37,12,5,2416,23,9,2,1984,19,10,2,1447,6,2,0,343,Ligue 1,nan,nan,nan,nan,nan,nan,nan,nan
13/6/2011,Mirkan Aydin,35021345,771,7/8/1987,23,0,0,0,0,3250,5800,5800,125,116,1403572,188,83,S R,2,3,2,3,3,2,1,4,3,3,3,9,13,13,14,13,8,6,11,8,7,13,9,7,14,13,12,12,12,13,12,11,10,11,10,12,7,13,14,13,11,11,14,10,13,11,20,11,11,13,6,11,7,8,12,12,9,13,13,15,5,10,1,1,1,15,15,1,1,S R,602,1,1,20,1,1,15,1,1,1,1,1,1,1,1,1,0,0,0,0,0,0,0,0,0,0,0,0,0,0,0,0,0,0,0,0,0,0,0,0,0,0,0,0,0,0,0,0,0,0,0,0,0,0,0,0,0,0,0,0,0,0,0,0,0,,,,,,,,,,,,,,,,,,,,,,,,,,,,,,,,,,,,,,,,,,,,,,,,,,,,
13/6/2011,Mijo Tunjic,91017719,784,2/24/1988,23,0,0,0,0,3750,4589,5100,120,102,470849,186,77,S ,3,1,1,2,2,2,2,5,1,3,1,7,5,12,12,13,9,13,4,6,8,6,9,3,13,5,12,5,13,10,9,11,8,14,10,13,11,11,11,13,13,13,12,20,17,13,6,7,9,10,9,9,8,10,16,10,13,7,12,7,6,10,1,1,1,14,1,1,14,S ,600,1,1,20,14,1,1,1,1,1,1,1,1,1,1,1,0,0,0,0,0,0,0,0,0,0,0,0,0,0,0,0,0,0,0,0,0,0,0,0,0,0,0,0,0,0,0,0,0,0,0,0,0,0,0,0,0,0,0,0,0,0,0,0,0,,,,,,,,,,,,,,,,,,,,,,,,,,,,,,,,,,,,,,,,,,,,,,,,,,,,
13/6/2011,Max Gradel,29001331,24,11/30/1987,23,1,0,0,0,3000,6000,6000,138,120,3429533,181,70,M/AM/S RL,2,1,1,3,1,3,1,1,2,2,1,8,9,13,13,12,12,4,14,3,5,11,10,8,15,16,8,9,7,7,7,6,19,14,5,13,7,11,13,16,14,9,6,7,12,17,20,15,10,7,12,15,4,11,16,18,13,8,10,8,5,9,1,1,20,20,20,19,1,M/AM/S RL,425,1,1,17,1,19,20,1,1,1,1,1,17,20,1,1,7.09529E+13,0,0,0,0,0,0,0,0,0,1,0,0,0,0,0,0,0,1,0,0,0,0,0,0,0,0,0,0,0,0,0,0,0,0,0,1,0,0,0,1,0,0,0,0,0,0,1,0,Max Gradel,£2.70m ,32,175,Forward - Left Winger,right,Sivasspor,44,18,7,3520,35,7,3,2165,26,3,2,1622,20,5,5,1087,40,17,5,2999,15,1,5,989,13,1,0,333,35,11,4,2897,39,13,10,3481,Ligue 1,22,4,2,1701,5,2,0,421
13/6/2011,Marvin Emnes,860744,784,5/27/1988,23,0,0,3,0,3750,6300,5800,140,118,3163932,180,66,AM/S RLC,3,3,3,1,3,1,1,2,2,3,1,9,11,12,10,10,8,5,10,7,3,10,6,7,12,6,12,12,12,11,7,9,15,9,6,15,7,10,14,15,14,8,10,12,15,14,20,14,8,12,6,6,10,10,9,13,12,10,14,14,13,8,1,1,1,19,19,18,18,AM/S RLC,626,1,1,20,18,18,19,1,1,1,1,1,1,1,1,1,0,0,0,0,0,0,0,0,0,0,0,0,0,0,0,0,0,0,0,0,0,0,0,0,0,0,0,0,0,0,0,0,0,0,0,0,0,0,0,0,0,0,0,0,0,0,0,0,0,,,,,,,,,,,,,,,,,,,,,,,,,,,,,,,,,,,,,,,,,,,,,,,,,,,,
13/6/2011,Marvin Ellmann,92038158,771,9/21/1987,23,0,0,0,0,500,4000,4000,90,78,30419,183,76,S ,3,3,1,3,2,1,2,1,3,2,1,9,6,9,7,10,4,8,6,3,9,7,5,6,10,8,8,3,13,9,9,10,8,9,13,13,8,7,9,13,10,11,9,16,13,11,20,5,3,10,8,10,12,10,7,13,12,11,18,11,11,7,1,1,1,1,1,1,1,S ,600,1,1,20,1,1,1,1,1,1,1,1,1,1,1,1,0,0,0,0,0,0,0,0,0,0,0,0,0,0,0,0,0,0,0,0,0,0,0,0,0,0,0,0,0,0,0,0,0,0,0,0,0,0,0,0,0,0,0,0,0,0,0,0,0,,,,,,,,,,,,,,,,,,,,,,,,,,,,,,,,,,,,,,,,,,,,,,,,,,,,
13/6/2011,Mario Benincasa,91017242,796,9/16/1987,23,0,0,0,0,500,2000,2750,75,60,2286,194,95,S ,1,3,2,3,3,1,3,1,1,2,3,6,6,11,12,12,1,11,11,1,2,8,8,7,9,7,7,1,7,8,4,8,6,8,11,12,5,15,9,12,12,12,14,1,13,12,20,7,6,10,11,10,8,9,6,1,12,14,12,10,9,4,1,1,1,1,1,1,1,S ,600,1,1,20,1,1,1,1,1,1,1,1,1,1,1,1,0,0,0,0,0,0,0,0,0,0,0,0,0,0,0,0,0,0,0,0,0,0,0,0,0,0,0,0,0,0,0,0,0,0,0,0,0,0,0,0,0,0,0,0,0,0,0,0,0,,,,,,,,,,,,,,,,,,,,,,,,,,,,,,,,,,,,,,,,,,,,,,,,,,,,
13/6/2011,Luís Carlos,19019169,1651,6/15/1987,23,0,0,0,0,1250,5300,5300,120,105,712754,169,63,AM/S L,2,3,3,2,3,2,2,4,3,3,3,11,11,13,11,11,8,7,10,7,6,8,10,8,12,10,12,10,11,11,9,9,12,13,7,15,7,10,12,14,14,9,6,20,12,14,7,12,9,10,8,10,7,12,12,12,14,10,12,12,12,7,1,1,9,20,14,20,10,AM/S L,513,1,1,17,10,20,14,1,1,1,1,1,9,1,1,1,0,0,0,0,0,0,0,0,0,0,0,0,0,0,0,0,0,0,0,0,0,0,0,0,0,0,0,0,0,0,0,0,0,0,0,0,0,0,0,0,0,0,0,0,0,0,0,0,0,Luís Carlos,£900Th. ,33,170,Forward - Left Winger,right,Doxa Katokopias,38,12,0,2604,28,4,3,1816,33,6,3,2415,35,5,4,2484,37,8,6,2959,22,0,2,776,17,3,3,935,30,7,3,2225,27,8,0,2169,Liga NOS,19,2,0,1232,4,0,0,199
13/6/2011,Lucas Pratto,14006355,1649,6/4/1988,23,0,0,0,0,1000,4000,6000,140,129,4259257,188,82,S ,2,1,2,2,2,3,1,1,3,2,3,5,6,10,14,11,4,14,14,4,6,11,13,12,9,14,12,13,13,14,9,11,11,12,6,13,8,11,12,14,12,16,15,10,12,13,20,15,15,12,6,12,4,10,15,16,10,11,11,8,6,10,1,1,1,12,1,1,12,S ,600,1,1,20,12,1,1,1,1,1,1,1,1,1,1,1,262144,0,0,0,0,0,0,0,0,0,0,0,0,0,0,0,0,0,0,1,0,0,0,0,0,0,0,0,0,0,0,0,0,0,0,0,0,0,0,0,0,0,0,0,0,0,0,0,0,Lucas Pratto,£1.98m ,32,188,Forward - Centre-Forward,right,Club Atlético River Plate,28,12,7,2091,36,6,5,1806,45,11,4,3882,42,15,10,3573,59,27,7,5117,28,9,2,1997,37,7,5,3192,28,8,6,2088,46,10,8,3012,Serie A,21,2,3,623,nan,nan,nan,nan
13/6/2011,Louis Ngwat-Mahop,35007949,11,9/16/1987,23,0,0,0,0,2750,5000,5500,120,110,696281,183,84,AM/S RL,1,1,1,3,3,1,2,5,1,2,1,9,9,11,13,11,6,13,15,5,6,11,6,8,12,6,9,11,8,10,11,10,8,8,5,13,5,11,12,13,11,12,13,8,14,14,20,13,12,9,5,5,10,12,9,14,8,9,8,8,9,12,1,1,1,18,18,17,10,AM/S RL,625,1,1,20,10,17,18,1,1,1,1,1,1,1,1,1,0,0,0,0,0,0,0,0,0,0,0,0,0,0,0,0,0,0,0,0,0,0,0,0,0,0,0,0,0,0,0,0,0,0,0,0,0,0,0,0,0,0,0,0,0,0,0,0,0,,,,,,,,,,,,,,,,,,,,,,,,,,,,,,,,,,,,,,,,,,,,,,,,,,,,
13/6/2011,Lionel Messi,7458500,1649,6/24/1987,23,50,13,7,6,9750,9750,9750,199,195,165166248,170,67,AM/S RLC,2,2,3,2,1,3,1,9,1,3,1,11,14,20,19,17,14,9,16,5,6,17,18,7,20,7,17,13,16,16,17,17,19,20,12,16,6,11,12,18,20,16,5,20,15,16,12,15,8,17,6,18,11,15,17,19,16,19,16,15,14,6,1,1,15,20,19,17,20,AM/S RLC,516,1,1,20,20,17,19,1,1,1,1,9,15,15,1,1,2.32217E+15,0,0,0,1,0,0,0,1,0,0,1,0,1,0,0,0,0,0,0,1,1,0,0,0,0,0,0,0,0,0,0,0,0,0,0,0,0,0,0,0,0,0,0,0,0,0,1,0,Lionel Messi,£90.00m ,33,170,Forward - Right Winger,left,FC Barcelona,55,53,24,4579,60,73,33,5221,50,60,16,4070,46,41,14,3742,57,58,30,5060,49,41,24,4229,52,54,18,4452,54,45,18,4468,50,51,20,4023,LaLiga,44,31,27,3810,6,2,3,540
13/6/2011,Lautaro Acosta,14001291,1649,3/14/1988,23,0,0,0,0,5000,6500,6000,150,131,1000097,169,65,AM/S RC,3,3,2,1,2,2,1,1,1,1,2,12,16,14,10,14,9,3,11,4,4,14,12,4,16,9,8,14,9,10,14,10,9,16,5,11,5,12,12,17,16,15,4,11,8,16,20,13,5,11,4,12,17,11,10,11,14,12,16,15,17,14,1,1,14,20,19,10,20,AM/S RC,513,1,1,18,20,10,19,1,1,1,1,9,1,14,1,1,16777216,0,0,0,0,0,0,0,0,0,0,0,0,0,0,0,0,0,0,0,0,0,0,0,0,1,0,0,0,0,0,0,0,0,0,0,0,0,0,0,0,0,0,0,0,0,0,0,0,Lautaro Acosta,£1.08m ,32,169,Forward - Left Winger,right,Club Atlético Lanús,13,1,2,463,25,2,2,1467,32,1,6,1819,25,6,3,1568,45,11,9,3593,16,3,4,1438,38,8,8,3140,24,4,4,1730,30,3,4,2608,LaLiga,20,3,3,1684,nan,nan,nan,nan
13/6/2011,Kévin Bérigaud,85065989,769,5/9/1988,23,0,0,0,0,1300,2650,2650,130,107,501859,178,69,S ,2,3,1,3,2,1,3,3,3,1,2,6,7,12,14,12,7,11,9,5,4,8,12,2,12,9,12,11,13,13,7,12,14,12,7,15,8,9,11,15,13,13,9,5,14,12,20,13,12,14,9,15,8,5,12,14,15,13,13,11,11,8,1,1,1,13,1,13,1,S ,600,1,1,20,1,13,1,1,1,1,1,1,1,1,1,1,16,0,0,0,0,1,0,0,0,0,0,0,0,0,0,0,0,0,0,0,0,0,0,0,0,0,0,0,0,0,0,0,0,0,0,0,0,0,0,0,0,0,0,0,0,0,0,0,0,Kévin Bérigaud,£810Th. ,32,176,Forward - Centre-Forward,right,Pafos FC,39,7,5,2835,21,7,0,1131,41,8,5,2888,35,10,5,2699,35,4,3,2236,21,3,1,1112,32,3,2,1468,23,8,4,1590,3,0,0,195,Ligue 1,7,2,1,461,7,2,1,474
13/6/2011,Karim Benzema,8435089,769,12/19/1987,23,37,12,5,0,7650,8250,8150,180,165,-1,187,79,S ,2,1,3,2,2,3,3,9,3,2,3,9,11,16,16,17,14,13,14,8,4,13,12,6,17,6,14,11,18,13,13,14,11,16,8,17,7,13,7,13,14,14,11,15,14,16,20,15,14,11,6,13,12,8,6,11,14,12,8,14,8,11,1,1,1,12,10,12,7,S ,600,1,1,20,7,12,10,1,1,1,1,1,1,1,1,1,1049616,0,0,0,0,1,0,0,0,0,0,1,0,0,0,0,0,0,0,0,0,1,0,0,0,0,0,0,0,0,0,0,0,0,0,0,0,0,0,0,0,0,0,0,0,0,0,0,0,Karim Benzema,£31.50m ,32,184,Forward - Centre-Forward,both,Real Madrid,48,26,9,2779,52,32,19,3443,50,20,21,2882,52,24,16,4054,46,22,15,3669,36,28,8,2593,48,19,8,3239,47,12,11,3237,53,30,11,4305,LaLiga,48,27,11,3981,7,1,2,581
13/6/2011,Juan Mata,67011232,796,4/28/1988,23,11,4,25,8,7000,8000,8000,170,160,76929671,170,63,M/AM LC,3,3,2,3,1,2,2,1,2,1,2,13,14,17,16,17,11,9,12,7,5,16,12,7,17,10,13,11,14,9,16,13,15,17,6,18,7,14,11,16,18,9,6,20,13,16,11,13,7,13,10,16,7,12,12,17,9,16,13,13,12,7,1,3,16,20,9,19,20,M/AM LC,524,1,1,15,20,19,9,1,1,1,1,5,16,5,3,1,4.39805E+12,0,0,0,1,1,0,0,1,0,0,0,0,0,0,0,0,0,0,0,0,0,0,0,0,0,0,0,0,0,0,0,0,0,0,0,0,0,0,0,0,0,0,1,0,0,0,0,0,Juan Mata,£34.20m ,32,170,Midfielder - Attacking Midfield,left,Manchester United,43,9,18,3306,54,12,20,4138,64,19,35,4914,32,7,8,2347,35,10,4,2442,54,10,11,4115,42,10,6,2739,40,3,7,2677,32,6,4,1779,Premier League,37,3,7,1939,4,2,2,316
13/6/2011,John Jairo Mosquera,8835391,1653,1/15/1988,23,0,0,8,4,3950,4859,5400,126,108,1279107,192,82,S RL,3,3,3,2,1,3,3,1,2,3,2,10,7,12,12,11,10,12,8,3,3,9,8,5,12,13,11,12,10,11,7,11,12,12,6,13,7,9,10,13,11,13,16,10,11,13,20,12,13,7,12,10,12,10,13,10,14,12,10,11,14,11,1,1,1,15,15,15,1,S RL,605,1,1,20,1,15,15,1,1,1,1,1,1,1,1,1,0,0,0,0,0,0,0,0,0,0,0,0,0,0,0,0,0,0,0,0,0,0,0,0,0,0,0,0,0,0,0,0,0,0,0,0,0,0,0,0,0,0,0,0,0,0,0,0,0,,,,,,,,,,,,,,,,,,,,,,,,,,,,,,,,,,,,,,,,,,,,,,,,,,,,
13/6/2011,Joăo Rodrigues,55023256,788,12/21/1987,23,0,0,0,0,750,4000,4000,95,80,13192,175,74,S L,2,1,2,1,2,3,2,5,1,1,1,10,12,9,10,12,8,12,4,2,1,11,4,6,11,8,9,5,12,5,6,6,10,10,2,10,5,10,11,12,12,12,6,7,14,12,20,6,2,10,9,10,10,8,14,12,10,15,14,13,13,5,1,1,1,15,13,15,10,S L,603,1,1,20,10,15,13,1,1,1,1,1,1,1,1,1,16,0,0,0,0,1,0,0,0,0,0,0,0,0,0,0,0,0,0,0,0,0,0,0,0,0,0,0,0,0,0,0,0,0,0,0,0,0,0,0,0,0,0,0,0,0,0,0,0,,,,,,,,,,,,,,,,,,,,,,,,,,,,,,,,,,,,,,,,,,,,,,,,,,,,
13/6/2011,Javier Patińo,67147995,796,2/14/1988,23,0,0,0,0,2000,4250,4250,99,90,246059,187,84,S ,3,1,1,2,2,2,1,1,3,1,2,4,5,13,12,10,4,13,8,1,8,7,9,7,10,13,12,9,10,11,6,11,10,10,1,13,11,16,13,13,13,13,9,9,11,13,20,8,6,10,12,8,6,10,11,9,5,15,13,10,7,13,1,1,1,1,1,1,1,S ,600,1,1,20,1,1,1,1,1,1,1,1,1,1,1,1,0,0,0,0,0,0,0,0,0,0,0,0,0,0,0,0,0,0,0,0,0,0,0,0,0,0,0,0,0,0,0,0,0,0,0,0,0,0,0,0,0,0,0,0,0,0,0,0,0,Javier Pastore,£26.10m ,31,187,Midfielder - Attacking Midfield,right,AS Roma,45,13,7,3804,43,16,6,3379,48,9,14,3503,41,3,4,2140,51,6,16,3958,26,3,6,1242,23,3,9,1151,37,5,6,1850,17,4,1,790,Ligue 1,15,0,2,795,nan,nan,nan,nan
13/6/2011,Javier Hernández,51001380,379,6/1/1988,23,29,21,0,0,7000,8500,8000,175,156,25819886,175,71,S ,3,3,1,1,1,1,1,5,3,1,2,5,9,11,16,12,7,16,10,6,3,11,14,5,13,10,14,12,14,14,8,12,17,14,8,18,7,11,15,18,16,14,13,12,15,17,20,14,8,15,6,15,5,8,18,15,16,15,16,13,16,5,1,1,1,10,10,1,1,S ,600,1,1,20,1,1,10,1,1,1,1,1,1,1,1,1,8192,0,0,0,0,0,0,0,0,0,0,0,0,0,1,0,0,0,0,0,0,0,0,0,0,0,0,0,0,0,0,0,0,0,0,0,0,0,0,0,0,0,0,0,0,0,0,0,0,,,,,,,,,,,,,,,,,,,,,,,,,,,,,,,,,,,,,,,,,,,,,,,,,,,,
13/6/2011,Iriome,67009522,796,6/22/1987,23,0,0,0,0,3000,5000,5000,116,98,1440603,186,78,AM R,1,3,2,3,3,3,3,7,2,3,1,8,10,10,11,9,5,7,8,4,4,10,8,7,10,10,12,13,7,9,9,8,12,12,7,15,6,12,14,13,11,9,13,8,11,14,20,13,12,11,7,13,13,11,9,10,15,7,14,15,14,5,1,3,12,20,20,10,1,AM R,502,1,1,15,1,10,20,1,1,1,1,1,6,12,1,3,2,0,1,0,0,0,0,0,0,0,0,0,0,0,0,0,0,0,0,0,0,0,0,0,0,0,0,0,0,0,0,0,0,0,0,0,0,0,0,0,0,0,0,0,0,0,0,0,0,,,,,,,,,,,,,,,,,,,,,,,,,,,,,,,,,,,,,,,,,,,,,,,,,,,,
13/6/2011,Iago Aspas,67010455,796,8/11/1987,23,0,0,0,0,3450,5400,5400,125,109,334057,176,67,AM C,3,3,1,3,3,2,3,1,2,3,3,11,9,14,11,13,12,9,12,4,5,14,13,5,14,10,13,8,13,8,14,12,15,17,6,12,7,9,10,13,13,10,7,20,15,13,7,13,7,10,2,15,5,12,15,13,15,14,11,12,6,3,1,1,1,20,14,12,20,AM C,501,1,1,15,20,12,14,1,1,1,1,1,1,1,1,1,2.19902E+12,0,0,0,0,0,0,0,0,0,0,0,0,0,0,0,0,0,1,0,0,0,0,0,0,0,0,0,0,0,0,0,0,0,0,0,0,0,0,0,0,0,1,0,0,0,0,0,0,,,,,,,,,,,,,,,,,,,,,,,,,,,,,,,,,,,,,,,,,,,,,,,,,,,,
13/6/2011,Hilal Soudani,12002680,5,11/25/1987,23,1,0,0,0,2000,6000,5750,140,115,1578044,178,75,AM/S L,2,3,3,2,3,1,3,1,2,3,2,7,8,13,13,12,9,13,12,6,4,9,11,5,12,15,15,14,12,10,9,13,12,12,10,14,4,7,13,14,14,13,15,20,15,14,6,13,13,12,8,12,6,6,12,15,14,9,12,11,9,6,1,1,8,16,1,16,10,AM/S L,623,1,1,20,10,16,1,1,1,1,1,1,8,1,1,1,0,0,0,0,0,0,0,0,0,0,0,0,0,0,0,0,0,0,0,0,0,0,0,0,0,0,0,0,0,0,0,0,0,0,0,0,0,0,0,0,0,0,0,0,0,0,0,0,0,,,,,,,,,,,,,,,,,,,,,,,,,,,,,,,,,,,,,,,,,,,,,,,,,,,,
13/6/2011,Gonzalo Higuaín,962988,1649,12/10/1987,23,9,6,0,0,8100,8400,8250,178,167,-1,184,79,S ,3,1,2,3,1,3,2,8,2,1,2,8,12,15,18,15,10,13,14,7,4,13,14,6,15,10,17,13,18,12,13,14,16,15,11,18,8,13,13,13,15,14,12,15,13,16,20,15,13,14,9,12,6,12,18,14,15,17,17,16,15,8,1,1,1,10,10,10,8,S ,600,1,1,20,8,10,10,1,1,1,1,1,1,1,1,1,16,0,0,0,0,1,0,0,0,0,0,0,0,0,0,0,0,0,0,0,0,0,0,0,0,0,0,0,0,0,0,0,0,0,0,0,0,0,0,0,0,0,0,0,0,0,0,0,0,Gonzalo Higuaín,£31.50m ,32,184,Forward - Centre-Forward,right,Inter Miami CF,25,13,6,1823,54,26,13,2646,44,18,9,2498,46,24,12,3505,58,29,11,4191,42,38,3,3287,55,32,4,4486,50,23,4,3877,40,13,3,3174,LaLiga,50,12,9,3177,nan,nan,nan,nan
13/6/2011,Frédéric Nimani,8432558,769,5/13/1988,23,0,0,8,2,4300,5400,5400,140,120,879841,191,87,S ,2,3,1,1,2,1,2,5,2,3,2,5,9,12,12,12,7,15,9,5,5,7,12,3,12,8,12,12,12,12,8,9,11,13,5,13,5,7,11,11,12,16,15,20,12,16,8,13,16,11,8,14,11,7,6,14,14,11,13,15,15,6,1,1,1,8,1,8,1,S ,600,1,1,20,1,8,1,1,1,1,1,1,1,1,1,1,16,0,0,0,0,1,0,0,0,0,0,0,0,0,0,0,0,0,0,0,0,0,0,0,0,0,0,0,0,0,0,0,0,0,0,0,0,0,0,0,0,0,0,0,0,0,0,0,0,,,,,,,,,,,,,,,,,,,,,,,,,,,,,,,,,,,,,,,,,,,,,,,,,,,,
13/6/2011,Fonseca,55013905,788,8/23/1987,23,0,0,0,0,500,1500,1500,115,93,21715,180,74,S L,3,2,2,2,3,1,2,3,1,3,2,9,11,12,13,8,9,11,10,4,3,9,9,4,10,5,12,5,13,11,8,7,9,9,13,10,9,9,14,13,12,13,8,10,9,12,20,9,4,10,8,10,6,10,12,15,8,8,12,15,10,12,1,1,7,15,13,15,13,S L,603,1,1,20,13,15,13,1,1,1,1,1,1,7,1,1,0,0,0,0,0,0,0,0,0,0,0,0,0,0,0,0,0,0,0,0,0,0,0,0,0,0,0,0,0,0,0,0,0,0,0,0,0,0,0,0,0,0,0,0,0,0,0,0,0,,,,,,,,,,,,,,,,,,,,,,,,,,,,,,,,,,,,,,,,,,,,,,,,,,,,
13/6/2011,Firat Karaduman,92025319,771,12/4/1987,23,0,0,0,0,250,3000,3000,78,60,16154,177,0,S ,3,3,1,3,3,3,3,2,1,1,3,6,3,11,12,9,8,11,6,1,6,5,8,1,6,8,8,3,11,5,3,6,9,7,13,12,7,6,10,12,12,12,8,9,12,12,20,6,3,10,4,10,5,9,9,12,11,6,12,13,6,16,1,1,1,1,1,1,1,S ,600,1,1,20,1,1,1,1,1,1,1,1,1,1,1,1,0,0,0,0,0,0,0,0,0,0,0,0,0,0,0,0,0,0,0,0,0,0,0,0,0,0,0,0,0,0,0,0,0,0,0,0,0,0,0,0,0,0,0,0,0,0,0,0,0,,,,,,,,,,,,,,,,,,,,,,,,,,,,,,,,,,,,,,,,,,,,,,,,,,,,
13/6/2011,Filip Djordjevic,5747715,802,9/28/1987,23,0,0,11,6,4100,5700,5100,135,114,537235,186,80,S ,2,1,3,3,1,3,1,1,3,3,1,10,11,14,12,14,10,12,4,4,6,11,10,4,14,11,9,11,11,12,12,12,14,12,10,13,9,13,11,11,12,14,12,20,14,11,10,12,14,12,11,10,11,10,12,18,9,9,14,13,10,18,1,1,5,10,1,1,10,S ,600,1,1,20,10,1,1,1,1,1,1,5,1,1,1,1,0,0,0,0,0,0,0,0,0,0,0,0,0,0,0,0,0,0,0,0,0,0,0,0,0,0,0,0,0,0,0,0,0,0,0,0,0,0,0,0,0,0,0,0,0,0,0,0,0,,,,,,,,,,,,,,,,,,,,,,,,,,,,,,,,,,,,,,,,,,,,,,,,,,,,
13/6/2011,Fernando Uribe,8829170,1653,1/1/1988,23,2,0,6,0,4500,5750,6150,145,123,3435213,181,74,S ,1,2,2,2,1,1,1,1,1,1,1,8,9,12,13,10,8,14,12,7,8,11,7,8,12,8,12,12,12,12,11,12,14,8,11,12,12,12,12,13,12,12,13,20,10,13,13,14,13,9,8,9,8,10,12,13,9,12,12,11,6,9,1,1,1,14,1,1,14,S ,600,1,1,20,14,1,1,1,1,1,1,1,1,1,1,1,0,0,0,0,0,0,0,0,0,0,0,0,0,0,0,0,0,0,0,0,0,0,0,0,0,0,0,0,0,0,0,0,0,0,0,0,0,0,0,0,0,0,0,0,0,0,0,0,0,Fernando Uribe,£540Th. ,32,182,Forward - Centre-Forward,left,Without Club,7,1,0,151,9,4,1,502,19,3,0,770,20,13,3,1550,12,7,0,1066,35,20,2,2524,42,22,5,2773,63,25,7,4182,12,1,0,427,Serie A,4,0,0,128,nan,nan,nan,nan
13/6/2011,Fabian Klos,91017839,771,12/2/1987,23,0,0,0,0,2000,4500,4500,110,90,94053,194,93,S ,2,2,1,3,1,2,1,2,3,1,1,8,5,6,12,12,7,12,9,6,2,6,8,4,12,15,8,9,7,11,9,11,10,11,4,12,10,6,10,12,9,11,14,10,14,11,20,6,6,10,9,10,4,10,7,12,16,10,16,14,9,3,1,1,1,1,1,1,1,S ,600,1,1,20,1,1,1,1,1,1,1,1,1,1,1,1,0,0,0,0,0,0,0,0,0,0,0,0,0,0,0,0,0,0,0,0,0,0,0,0,0,0,0,0,0,0,0,0,0,0,0,0,0,0,0,0,0,0,0,0,0,0,0,0,0,Fabiano,£1.17m ,32,197,Goalkeeper,right,Omonia Nicosia,nan,nan,nan,nan,34,40,11,3116,13,8,7,1096,28,22,15,2488,38,22,24,3342,17,16,7,1484,14,12,7,1169,1,0,1,10,9,6,5,864,Liga NOS,11,6,7,990,11,8,5,1080
13/6/2011,Eren Derdiyok,69002453,798,6/12/1988,23,34,3,7,8,6900,7250,7050,160,141,14147950,191,83,S ,1,2,1,1,2,3,1,5,1,2,2,6,9,12,13,13,12,18,11,4,4,9,12,7,14,10,12,13,9,10,12,9,6,13,8,15,7,14,9,13,13,13,19,15,15,16,20,14,15,6,4,10,6,11,14,9,13,14,11,18,15,12,1,1,1,14,8,4,14,S ,600,1,1,20,14,4,8,1,1,1,1,1,1,1,1,1,4.39805E+12,0,0,0,0,0,0,0,0,0,1,0,0,0,0,0,0,0,0,0,0,0,0,0,0,0,0,0,0,0,0,0,0,0,0,0,0,0,0,0,0,0,0,1,0,0,0,0,0,Eren Derdiyok,£6.75m ,32,191,Forward - Centre-Forward,right,Pakhtakor Tashkent,44,11,7,2630,33,10,3,1481,20,1,1,875,26,1,2,784,7,2,2,285,32,14,5,2197,38,12,2,2042,28,4,4,1042,18,10,0,1418,Bundesliga,35,14,4,1749,nan,nan,nan,nan
13/6/2011,Emile Sinclair,29012450,765,12/29/1987,23,0,0,0,0,1500,4000,4000,109,84,234300,186,72,S ,2,2,1,1,1,2,1,1,2,3,2,6,8,10,10,9,3,6,6,1,1,5,6,2,8,6,7,8,9,8,6,6,8,10,4,8,3,9,9,13,10,6,11,7,14,15,20,8,11,2,5,8,5,9,9,11,16,10,8,8,13,20,1,1,1,14,14,10,1,S ,600,1,1,20,1,10,14,1,1,1,1,1,1,1,1,1,1.76267E+13,0,0,0,0,0,0,0,0,0,0,0,0,0,0,0,0,0,0,0,0,0,0,0,0,0,0,0,1,0,0,0,0,0,0,0,1,0,0,0,0,0,0,0,0,1,0,0,0,,,,,,,,,,,,,,,,,,,,,,,,,,,,,,,,,,,,,,,,,,,,,,,,,,,,
13/6/2011,Éder,55011711,23,12/22/1987,23,0,0,0,0,3000,5000,5500,127,111,1049469,188,81,S ,1,2,1,2,1,2,1,1,2,3,3,11,11,12,12,12,10,11,9,8,7,10,10,8,12,7,10,10,12,11,11,10,13,12,7,13,7,10,12,11,11,15,12,10,15,11,20,12,13,10,5,9,9,10,15,14,14,12,15,15,15,4,1,1,1,10,10,10,10,S ,600,1,1,20,10,10,10,1,1,1,1,1,1,1,1,1,0,0,0,0,0,0,0,0,0,0,0,0,0,0,0,0,0,0,0,0,0,0,0,0,0,0,0,0,0,0,0,0,0,0,0,0,0,0,0,0,0,0,0,0,0,0,0,0,0,Éder,£2.70m ,32,190,Forward - Centre-Forward,both,Lokomotiv Moscow,27,5,2,1384,22,7,4,1858,31,16,5,2413,16,4,3,1064,38,14,3,2268,29,6,4,1582,37,7,5,2842,28,4,2,1414,35,3,1,1524,Liga NOS,30,6,1,2210,12,1,0,755
13/6/2011,Diego Buonanotte,962978,1649,4/19/1988,23,0,0,14,1,4950,6500,6500,160,135,8876500,161,60,AM RLC,1,1,2,1,3,2,2,1,3,2,1,13,13,16,13,14,14,1,13,1,7,13,15,7,16,10,11,13,13,11,14,11,17,17,4,14,7,13,13,16,16,5,5,20,13,16,5,12,5,9,12,15,12,11,11,15,15,11,15,11,6,16,1,1,9,20,16,17,20,AM RLC,506,1,1,15,20,17,16,1,1,1,1,9,1,1,1,1,2.2518E+15,0,0,0,0,0,0,0,0,0,0,0,0,0,0,0,0,0,1,0,0,0,0,0,0,0,0,0,0,0,0,0,0,0,0,0,0,0,0,0,0,0,0,0,0,0,0,0,0,Diego Buonanotte,£2.25m ,32,161,Midfielder - Attacking Midfield,left,CD Universidad Católica,26,2,2,1216,14,1,0,454,32,5,7,1463,25,0,1,1092,26,2,2,1478,37,11,1,1898,43,16,11,3488,26,7,2,2284,25,2,0,1094,LaLiga,8,0,2,304,nan,nan,nan,nan
13/6/2011,Deniz Yilmaz,35003453,799,2/26/1988,23,0,0,8,2,2250,5500,5500,127,109,1559851,182,79,S ,1,3,1,2,2,3,3,1,3,3,1,4,10,13,8,12,5,8,8,6,6,11,10,8,13,14,10,12,7,9,10,10,15,13,7,12,6,11,13,16,13,11,10,13,11,14,20,11,9,10,13,10,8,10,11,12,8,6,13,11,7,6,1,1,1,14,14,10,10,S ,600,1,1,20,10,10,14,1,1,1,1,1,1,1,1,1,0,0,0,0,0,0,0,0,0,0,0,0,0,0,0,0,0,0,0,0,0,0,0,0,0,0,0,0,0,0,0,0,0,0,0,0,0,0,0,0,0,0,0,0,0,0,0,0,0,Deniz Yilmaz,£270Th. ,32,182,Forward - Centre-Forward,right,Without Club,27,6,5,2265,18,10,1,1501,26,5,2,1767,35,13,6,2709,15,2,0,1005,21,7,4,1491,21,5,1,1764,15,3,1,875,26,3,6,1324,Bundesliga,nan,nan,nan,nan,nan,nan,nan,nan
13/6/2011,Denis Stracqualursi,14011364,1649,10/20/1987,23,0,0,0,0,3000,6000,6000,142,130,2232978,190,87,S ,1,3,1,1,3,3,3,7,1,2,3,5,9,9,15,13,5,15,10,10,8,13,13,8,12,11,14,15,16,14,13,14,11,7,5,11,10,16,16,11,11,12,16,9,13,12,20,13,16,12,9,12,8,4,12,11,19,12,12,7,11,6,1,1,1,1,1,1,1,S ,600,1,1,20,1,1,1,1,1,1,1,1,1,1,1,1,0,0,0,0,0,0,0,0,0,0,0,0,0,0,0,0,0,0,0,0,0,0,0,0,0,0,0,0,0,0,0,0,0,0,0,0,0,0,0,0,0,0,0,0,0,0,0,0,0,Denis Stracqualursi,£1.80m ,33,191,Forward - Centre-Forward,right,Taranto FC 1927,38,21,1,3128,31,3,1,1261,50,19,3,3804,19,6,5,1413,33,6,2,1983,34,8,3,2315,24,1,3,1478,19,0,0,1002,14,2,0,803,Premier League,15,0,0,633,3,1,0,139
13/6/2011,David Jansen,91004073,771,12/4/1987,23,0,0,0,0,2750,4600,4600,110,92,323490,192,89,S ,3,2,3,3,3,1,3,2,2,1,1,4,3,6,11,12,8,16,13,3,4,8,13,2,9,6,8,8,12,10,9,9,12,7,9,10,16,12,8,9,9,12,17,11,12,9,20,14,17,6,13,5,8,8,9,11,5,8,7,8,8,4,1,1,1,12,1,1,12,S ,600,1,1,20,12,1,1,1,1,1,1,1,1,1,1,1,1.75922E+13,0,0,0,0,0,0,0,0,0,1,0,0,0,0,0,0,0,0,1,0,0,0,0,0,0,0,0,0,0,0,0,0,0,0,0,0,0,0,0,0,0,0,0,0,1,0,0,0,David Jones,£1.35m ,35,183,Midfielder,left,Retired,17,2,1,1405,17,0,1,1254,30,2,1,2237,49,2,5,4326,38,0,0,3346,43,1,7,3563,32,0,2,2078,33,1,1,2291,2,0,0,101,Premier League,6,0,0,431,nan,nan,nan,nan
13/6/2011,Danny Haynes,5123032,765,1/19/1988,23,0,0,0,0,2750,5400,5400,127,115,1322500,181,75,AM/S R,3,3,3,3,1,3,3,7,1,3,1,1,11,12,12,10,2,11,11,2,3,9,12,3,13,4,10,12,10,10,9,6,12,13,3,14,9,10,16,17,13,11,10,3,13,17,20,12,10,11,5,13,3,13,10,14,13,12,11,8,8,10,3,1,5,18,18,1,8,AM/S R,622,1,1,20,8,1,18,3,1,1,1,5,1,1,1,1,134217728,0,0,0,0,0,0,0,0,0,0,0,0,0,0,0,0,0,0,0,0,0,0,0,0,0,0,0,1,0,0,0,0,0,0,0,0,0,0,0,0,0,0,0,0,0,0,0,0,,,,,,,,,,,,,,,,,,,,,,,,,,,,,,,,,,,,,,,,,,,,,,,,,,,,
13/6/2011,Daniele Paponi,43000080,776,4/16/1988,23,0,0,0,0,2250,5600,5600,131,113,1731778,182,82,S ,2,3,3,3,2,3,2,4,3,2,2,10,11,13,14,14,9,16,11,6,8,13,13,11,13,11,10,15,12,12,10,10,10,10,9,13,10,12,13,12,12,11,12,5,8,12,20,14,9,13,5,12,12,10,13,13,5,12,10,14,13,11,1,1,1,1,1,1,1,S ,600,1,1,20,1,1,1,1,1,1,1,1,1,1,1,1,0,0,0,0,0,0,0,0,0,0,0,0,0,0,0,0,0,0,0,0,0,0,0,0,0,0,0,0,0,0,0,0,0,0,0,0,0,0,0,0,0,0,0,0,0,0,0,0,0,Daniele Paponi,£360Th. ,32,182,Forward - Centre-Forward,right,Calcio Padova,16,2,0,658,4,1,0,138,24,5,1,1100,7,1,0,369,24,5,2,1683,12,1,1,369,37,8,1,2350,29,10,3,1960,37,15,7,2831,Serie A,28,13,1,1957,2,0,0,99
13/6/2011,Daniel Heinze,35014610,771,10/17/1987,23,0,0,0,0,700,3900,3900,95,78,24501,178,70,AM/S RL,1,2,1,3,3,2,1,1,2,3,1,6,9,11,13,9,4,5,15,6,5,10,5,5,11,15,10,12,7,9,8,11,9,11,9,10,5,11,11,12,10,9,10,9,11,10,20,9,7,9,7,16,3,12,6,11,10,14,13,13,12,5,1,1,14,20,20,16,14,AM/S RL,515,1,1,18,14,16,20,1,1,1,1,11,13,14,1,1,256,0,0,0,0,0,0,0,0,1,0,0,0,0,0,0,0,0,0,0,0,0,0,0,0,0,0,0,0,0,0,0,0,0,0,0,0,0,0,0,0,0,0,0,0,0,0,0,0,Gabriel Heinze,£1.35m ,42,179,Defender - Centre-Back,left,Retired,41,4,1,3644,32,0,0,2652,36,1,0,3047,31,2,1,2669,nan,nan,nan,nan,nan,nan,nan,nan,nan,nan,nan,nan,nan,nan,nan,nan,nan,nan,nan,nan,Serie A,nan,nan,nan,nan,nan,nan,nan,nan
13/6/2011,Daniel Barton,35011570,771,8/11/1987,23,0,0,0,0,50,2750,2750,70,55,2509,185,77,S ,2,1,2,3,1,2,3,1,1,1,2,8,4,10,12,12,6,6,5,1,2,3,8,3,9,13,10,4,8,7,6,6,8,12,11,12,5,11,6,12,12,11,10,4,17,12,20,2,3,7,11,7,5,8,8,11,14,14,6,9,7,10,1,1,1,10,1,1,10,S ,600,1,1,20,10,1,1,1,1,1,1,1,1,1,1,1,0,0,0,0,0,0,0,0,0,0,0,0,0,0,0,0,0,0,0,0,0,0,0,0,0,0,0,0,0,0,0,0,0,0,0,0,0,0,0,0,0,0,0,0,0,0,0,0,0,Daniel Batz,£270Th. ,29,190,Goalkeeper,both,1.FC Saarbrücken,3,6,0,270,9,12,2,810,13,16,1,1170,9,11,2,810,5,8,0,450,18,16,7,1620,36,25,19,3240,37,36,12,3314,33,34,14,2970,Bundesliga,30,29,13,2760,6,5,2,540
13/6/2011,Claudio Beauvue,34011705,769,4/16/1988,23,0,0,0,0,2400,4994,3650,130,111,154745,174,66,AM/S R,2,3,3,2,2,2,3,3,1,1,2,7,11,13,10,12,12,14,11,8,2,9,11,3,13,8,13,8,10,10,10,9,12,12,5,13,5,7,10,14,13,11,8,5,14,16,20,14,8,12,8,14,6,8,9,14,12,10,7,11,11,13,1,1,14,20,20,10,1,AM/S R,512,1,1,16,1,10,20,1,1,1,1,1,10,14,1,1,2.2518E+15,0,0,0,0,0,0,0,0,0,0,0,0,0,0,0,0,0,0,0,0,0,0,0,0,0,0,0,0,0,0,0,0,0,0,0,0,0,0,0,0,0,0,0,0,0,0,0,0,Claudio Bravo,£4.50m ,37,184,Goalkeeper,right,Real Betis Balompié,38,66,9,3420,37,51,12,3330,31,40,9,2790,44,61,15,3960,37,19,23,3330,35,23,18,3148,33,36,11,2952,13,10,5,1185,1,0,1,90,LaLiga,17,16,5,1491,4,5,2,360
13/6/2011,Christopher Nöthe,35011193,771,1/3/1988,23,0,0,1,0,2700,6000,6000,136,120,2120720,184,76,S ,1,2,1,3,2,1,2,1,2,3,2,4,9,10,15,11,6,15,12,8,6,9,12,7,10,10,12,14,13,14,8,13,9,9,9,14,7,10,10,12,12,13,14,12,12,14,20,12,12,15,4,14,13,8,14,9,12,13,13,16,19,3,1,1,1,14,14,10,5,S ,600,1,1,20,5,10,14,1,1,1,1,1,1,1,1,1,1024,0,0,0,0,0,0,0,0,0,0,1,0,0,0,0,0,0,0,0,0,0,0,0,0,0,0,0,0,0,0,0,0,0,0,0,0,0,0,0,0,0,0,0,0,0,0,0,0,,,,,,,,,,,,,,,,,,,,,,,,,,,,,,,,,,,,,,,,,,,,,,,,,,,,
13/6/2011,Christopher Nguyen,91005100,771,1/13/1988,23,0,0,0,0,750,3600,3600,91,72,11518,171,68,AM/S R,3,3,1,3,2,1,2,1,3,2,2,8,9,10,7,10,7,4,11,2,2,8,6,3,10,6,8,7,8,5,10,7,8,12,7,10,3,5,5,14,13,9,6,8,12,14,20,7,6,8,5,8,14,8,9,11,9,10,10,9,8,10,1,1,14,20,20,10,1,AM/S R,512,1,1,18,1,10,20,1,1,1,1,1,6,14,1,1,7.03687E+13,0,1,0,0,0,0,0,0,0,0,0,0,0,0,0,0,0,0,0,0,0,0,0,0,0,0,0,0,0,0,0,0,0,0,0,0,0,0,0,0,0,0,0,0,0,0,1,0,Christopher Jullien, ,27,196,Defender - Centre-Back,right,Celtic FC,nan,nan,nan,nan,0,0,0,0,26,3,0,2108,26,3,0,2288,24,2,8,2079,37,9,1,3360,37,5,1,3360,36,2,3,3118,35,1,0,3105,Ligue 1,46,7,2,4000,7,2,2,630
13/6/2011,Cheick Diabaté,12001328,31,4/25/1988,23,8,2,1,0,4950,6100,5500,140,122,3526714,194,88,S ,2,2,1,2,2,2,3,3,1,2,2,4,6,12,11,11,7,14,11,5,6,9,14,4,12,10,14,15,13,12,7,11,15,12,5,13,8,13,16,13,10,17,17,8,7,12,20,14,17,12,9,14,15,7,11,17,12,15,14,10,14,7,1,1,1,10,1,1,10,S ,600,1,1,20,10,1,1,1,1,1,1,1,1,1,1,1,262144,0,0,0,0,0,0,0,0,0,0,0,0,0,0,0,0,0,0,1,0,0,0,0,0,0,0,0,0,0,0,0,0,0,0,0,0,0,0,0,0,0,0,0,0,0,0,0,0,Cheick Diabaté,£2.70m ,32,194,Forward - Centre-Forward,right,Esteghlal FC,18,6,2,903,26,8,3,1292,35,18,3,2189,28,12,1,1903,17,9,2,1218,28,13,5,1880,30,14,2,1742,11,8,0,662,19,10,2,1563,Ligue 1,17,11,3,1145,nan,nan,nan,nan
13/6/2011,Bruno Moreira,744576,788,9/6/1987,23,0,0,0,0,750,4500,4500,105,90,94062,184,77,S ,1,2,1,2,2,2,1,5,1,1,3,9,10,10,11,9,8,10,9,6,6,10,11,6,10,11,10,12,9,9,8,9,14,10,10,12,11,13,13,10,11,12,12,8,12,10,20,13,13,10,8,10,11,8,8,15,12,13,13,10,10,11,1,1,1,10,8,8,10,S ,600,1,1,20,10,8,8,1,1,1,1,1,1,1,1,1,4.52119E+15,0,0,0,0,0,0,0,0,0,0,0,0,0,0,0,0,0,0,0,1,0,0,0,0,0,0,0,0,0,0,0,0,0,0,0,0,0,0,0,0,0,0,0,0,1,0,0,0,Bruno Moraes,£630Th. ,36,180,Forward - Centre-Forward,right,CD Trofense,23,4,0,1194,21,7,2,1155,10,5,1,709,11,2,0,560,nan,nan,nan,nan,24,3,1,969,nan,nan,nan,nan,1,0,0,20,2,1,0,169,Liga NOS,1,0,0,27,nan,nan,nan,nan
13/6/2011,Brett Pitman,5006434,765,1/31/1988,23,0,0,0,0,2500,5250,5250,135,110,1471193,183,70,S ,3,3,1,1,2,3,3,3,3,1,1,11,10,11,15,12,13,9,14,2,3,9,15,4,12,8,12,9,14,11,10,10,7,13,5,15,10,12,12,11,12,11,11,11,12,12,20,12,10,12,8,12,4,12,15,12,10,12,8,7,12,15,1,1,10,14,14,12,10,S ,600,1,1,20,10,12,14,1,1,1,1,1,1,10,1,1,16,0,0,0,0,1,0,0,0,0,0,0,0,0,0,0,0,0,0,0,0,0,0,0,0,0,0,0,0,0,0,0,0,0,0,0,0,0,0,0,0,0,0,0,0,0,0,0,0,,,,,,,,,,,,,,,,,,,,,,,,,,,,,,,,,,,,,,,,,,,,,,,,,,,,
13/6/2011,Bogdan Müller,91100528,771,6/12/1988,23,0,0,0,0,750,3900,3900,95,78,45163,184,78,S ,3,2,2,1,3,3,3,1,1,3,1,8,8,9,10,7,6,7,7,3,2,9,11,4,10,8,7,12,10,8,8,8,10,10,5,12,5,11,13,14,12,10,11,5,10,14,20,12,9,8,6,7,8,5,10,9,8,9,10,14,10,8,1,1,1,1,1,1,1,S ,600,1,1,20,1,1,1,1,1,1,1,1,1,1,1,1,0,0,0,0,0,0,0,0,0,0,0,0,0,0,0,0,0,0,0,0,0,0,0,0,0,0,0,0,0,0,0,0,0,0,0,0,0,0,0,0,0,0,0,0,0,0,0,0,0,,,,,,,,,,,,,,,,,,,,,,,,,,,,,,,,,,,,,,,,,,,,,,,,,,,,
13/6/2011,Billy Clarke,5121496,789,12/13/1987,23,0,0,7,0,2550,5084,5250,131,113,1107643,171,65,AM/S RL,1,2,1,2,1,3,2,3,2,1,3,7,12,15,12,11,2,7,13,3,3,12,8,3,10,4,11,9,11,11,13,13,13,8,5,13,12,9,13,16,14,10,6,20,9,12,6,10,7,5,5,10,6,4,13,16,12,6,13,11,13,4,1,1,9,20,20,20,10,AM/S RL,515,1,1,20,10,20,20,1,1,1,1,1,9,1,1,1,7.09185E+13,0,0,0,1,0,0,0,0,0,0,0,0,0,0,0,0,0,0,0,0,0,0,0,0,0,0,0,0,0,0,0,0,0,0,0,0,0,0,0,1,0,0,0,0,0,0,1,0,,,,,,,,,,,,,,,,,,,,,,,,,,,,,,,,,,,,,,,,,,,,,,,,,,,,
13/6/2011,Baba,55013851,41,1/5/1988,23,0,0,0,0,3750,5849,6500,150,130,11684370,185,79,S ,1,3,3,3,1,2,2,6,3,1,3,10,10,11,15,12,9,14,11,7,8,10,13,7,12,9,13,11,13,12,10,12,13,11,8,15,8,10,12,14,13,15,13,7,15,13,20,14,16,11,6,11,7,9,12,12,13,13,14,14,15,5,1,1,1,5,1,1,5,S ,600,1,1,20,5,1,1,1,1,1,1,1,1,1,1,1,0,0,0,0,0,0,0,0,0,0,0,0,0,0,0,0,0,0,0,0,0,0,0,0,0,0,0,0,0,0,0,0,0,0,0,0,0,0,0,0,0,0,0,0,0,0,0,0,0,,,,,,,,,,,,,,,,,,,,,,,,,,,,,,,,,,,,,,,,,,,,,,,,,,,,
13/6/2011,Aykut Öztürk,91004237,799,11/7/1987,23,0,0,0,0,2500,4750,4500,110,95,103299,182,82,M/AM/S RL,2,3,3,2,1,2,2,2,1,3,1,8,11,13,7,11,8,7,8,5,6,10,9,7,13,12,10,14,12,9,11,9,10,13,7,13,6,10,11,11,14,11,10,5,10,13,20,8,10,9,9,10,6,18,7,16,5,11,13,11,12,10,1,1,20,18,20,15,1,M/AM/S RL,425,1,1,17,1,15,18,1,1,1,1,1,15,20,1,1,0,0,0,0,0,0,0,0,0,0,0,0,0,0,0,0,0,0,0,0,0,0,0,0,0,0,0,0,0,0,0,0,0,0,0,0,0,0,0,0,0,0,0,0,0,0,0,0,0,,,,,,,,,,,,,,,,,,,,,,,,,,,,,,,,,,,,,,,,,,,,,,,,,,,,
13/6/2011,Ariel Nahuelpan,14004032,1649,10/15/1987,23,0,0,0,0,4250,6300,6300,135,128,5601769,187,87,S ,2,1,1,1,1,3,3,3,2,2,3,7,9,10,12,12,9,16,12,5,6,12,11,8,10,18,13,18,9,14,11,12,17,5,10,10,5,12,19,12,11,19,16,20,12,12,13,12,19,15,14,12,7,3,14,16,4,12,11,6,5,16,1,1,1,1,1,1,1,S ,600,1,1,20,1,1,1,1,1,1,1,1,1,1,1,1,1074200576,0,0,0,0,0,0,0,0,0,0,0,0,0,0,0,0,1,1,1,0,0,0,0,0,0,0,0,0,0,0,1,0,0,0,0,0,0,0,0,0,0,0,0,0,0,0,0,0,Ariel Nahuelpán,£1.35m ,33,188,Forward - Centre-Forward,left,Without Club,32,3,0,1511,55,14,5,2868,23,13,6,1853,34,5,7,2363,40,19,4,2368,31,10,3,1362,35,6,2,1544,33,8,4,1645,21,6,3,1537,LaLiga,27,11,2,2056,4,0,0,304
13/6/2011,Anton Fink,35003482,771,7/30/1987,23,0,0,0,0,3400,5750,5250,128,115,540640,171,74,AM/S R,1,3,1,1,3,1,1,4,3,1,1,6,11,14,12,13,7,7,13,4,3,13,12,3,13,6,9,11,12,12,13,9,11,12,7,13,6,13,12,14,14,12,8,3,14,15,20,12,11,10,4,10,8,11,11,12,12,12,12,15,13,6,1,1,12,20,20,12,10,AM/S R,512,1,1,18,10,12,20,1,1,1,1,5,8,12,1,1,7.03687E+13,0,1,0,0,0,0,0,0,0,0,0,0,0,0,0,0,0,0,0,0,0,0,0,0,0,0,0,0,0,0,0,0,0,0,0,0,0,0,0,0,0,0,0,0,0,0,1,0,,,,,,,,,,,,,,,,,,,,,,,,,,,,,,,,,,,,,,,,,,,,,,,,,,,,
13/6/2011,Anthony Modeste,8443059,769,4/14/1988,23,0,0,14,6,4650,5850,5850,145,130,4931388,186,83,S ,2,2,2,3,3,2,1,2,3,1,3,6,8,12,13,12,9,13,14,7,5,9,16,5,13,13,15,8,9,12,9,9,14,13,6,14,7,10,14,16,14,14,13,8,12,14,20,16,15,12,10,14,9,5,12,16,13,11,12,11,11,10,1,1,1,10,10,10,1,S ,600,1,1,20,1,10,10,1,1,1,1,1,1,1,1,1,4.39805E+12,0,0,0,0,0,0,0,0,0,0,1,0,0,0,0,0,0,0,0,0,0,0,0,0,0,0,0,0,0,0,0,0,0,0,0,0,0,0,0,0,0,0,1,0,0,0,0,0,Anthony Modeste,£3.15m ,32,187,Forward - Centre-Forward,right,1. FC Köln,40,12,4,2662,26,3,2,1017,38,17,5,3197,33,14,5,1809,29,9,2,1389,36,18,3,3054,45,34,6,3935,21,9,6,1766,10,6,0,367,Premier League,29,4,1,1294,2,0,0,21
13/6/2011,Andrea Catellani,43001305,776,5/26/1988,23,0,0,0,0,1750,5000,5000,140,100,2605139,180,77,AM/S L,1,1,1,1,1,1,1,1,1,1,1,3,8,13,13,10,4,8,6,2,2,9,9,4,11,8,7,8,7,11,5,8,6,12,7,11,9,8,10,14,13,7,7,10,14,14,20,12,8,10,5,10,7,10,10,14,11,12,13,10,15,14,1,1,9,20,1,20,14,AM/S L,513,1,1,20,14,20,1,1,1,1,1,1,9,1,1,1,0,0,0,0,0,0,0,0,0,0,0,0,0,0,0,0,0,0,0,0,0,0,0,0,0,0,0,0,0,0,0,0,0,0,0,0,0,0,0,0,0,0,0,0,0,0,0,0,0,Andrea Catellani,£810Th. ,32,179,Forward - Centre-Forward,both,Retired,35,4,3,2451,24,2,2,785,34,6,7,2073,24,1,1,1297,40,19,5,3365,43,4,6,2645,35,9,2,2348,nan,nan,nan,nan,nan,nan,nan,nan,Serie A,nan,nan,nan,nan,nan,nan,nan,nan
13/6/2011,Alberto Bueno,67011211,796,3/20/1988,23,0,0,1,0,4100,5800,5800,139,116,2108853,178,64,AM/S C,1,2,1,1,3,3,3,5,1,2,2,12,8,14,15,14,12,9,13,4,3,13,13,6,16,9,14,10,13,14,12,13,16,16,9,14,5,9,9,13,13,7,9,7,14,15,20,12,5,13,8,12,6,10,15,16,15,10,16,15,16,6,1,1,1,16,12,10,16,AM/S C,621,1,1,20,16,10,12,1,1,1,1,1,1,1,1,1,525332,0,0,1,0,1,0,0,0,0,0,1,0,0,0,0,0,0,0,0,1,0,0,0,0,0,0,0,0,0,0,0,0,0,0,0,0,0,0,0,0,0,0,0,0,0,0,0,0,Alberto Moreno, ,28,171,Defender - Left-Back,left,Villarreal CF,nan,nan,nan,nan,31,4,0,1839,36,3,4,2952,44,3,2,3619,41,2,1,3377,50,1,6,4149,18,0,1,835,27,0,3,2097,5,0,0,344,LaLiga,19,0,0,1594,nan,nan,nan,nan
13/6/2011,Airam,67062196,796,10/21/1987,23,0,0,0,0,1500,4750,4750,121,105,1082060,181,75,S ,2,2,3,3,3,2,3,5,3,2,1,7,7,8,14,11,5,12,12,7,3,10,20,5,9,9,12,8,13,13,8,13,15,11,11,13,8,11,10,11,9,14,12,12,13,10,20,12,13,15,8,10,8,5,9,14,9,16,12,12,13,10,1,1,1,10,1,1,10,S ,600,1,1,20,10,1,1,1,1,1,1,1,1,1,1,1,262144,0,0,0,0,0,0,0,0,0,0,0,0,0,0,0,0,0,0,1,0,0,0,0,0,0,0,0,0,0,0,0,0,0,0,0,0,0,0,0,0,0,0,0,0,0,0,0,0,,,,,,,,,,,,,,,,,,,,,,,,,,,,,,,,,,,,,,,,,,,,,,,,,,,,
13/6/2011,Ahmet Kulabas,35021017,799,10/8/1987,23,0,0,0,0,1000,3700,4000,100,80,133104,177,81,AM/S RL,1,1,1,3,2,3,2,7,1,1,1,9,12,12,10,12,8,11,9,6,5,3,8,8,9,6,9,9,12,12,10,9,11,12,12,10,5,11,13,12,12,12,7,5,10,12,20,9,2,10,10,4,9,10,13,18,8,13,14,11,7,5,1,1,12,20,18,20,1,AM/S RL,515,1,1,18,1,20,18,1,1,1,1,1,12,10,1,1,0,0,0,0,0,0,0,0,0,0,0,0,0,0,0,0,0,0,0,0,0,0,0,0,0,0,0,0,0,0,0,0,0,0,0,0,0,0,0,0,0,0,0,0,0,0,0,0,0,,,,,,,,,,,,,,,,,,,,,,,,,,,,,,,,,,,,,,,,,,,,,,,,,,,,
13/6/2011,Adrián,1509231,796,1/8/1988,23,0,0,8,1,5250,7000,7000,161,143,17635191,180,72,S ,3,1,3,2,3,1,2,6,3,2,3,5,7,16,13,14,6,11,9,5,4,13,13,5,15,6,10,12,14,13,13,12,13,15,8,15,7,12,13,16,14,14,11,11,8,16,20,12,12,12,6,15,13,7,9,12,9,10,12,11,12,9,1,1,8,13,13,1,12,S ,600,1,1,20,12,1,13,1,1,1,1,1,1,8,1,1,524304,0,0,0,0,1,0,0,0,0,0,0,0,0,0,0,0,0,0,0,1,0,0,0,0,0,0,0,0,0,0,0,0,0,0,0,0,0,0,0,0,0,0,0,0,0,0,0,0,Adrián, ,33,190,Goalkeeper,right,Liverpool FC,9,6,4,810,11,12,5,990,32,46,11,2869,26,42,7,2340,42,54,10,3781,36,44,10,3300,19,36,6,1710,22,31,8,1980,5,8,2,450,LaLiga,18,24,3,1563,5,11,2,450
13/6/2011,Adil Chihi,8727174,34,2/21/1988,23,1,0,0,0,3750,5669,6250,145,126,5160029,183,78,AM L,1,2,2,2,1,1,3,2,2,1,3,7,12,15,10,14,9,8,11,8,5,14,10,5,16,8,10,8,8,9,14,7,9,14,6,13,6,7,6,16,17,14,11,20,6,15,8,11,11,7,5,8,4,12,15,8,5,6,8,13,5,14,1,1,9,20,13,20,8,AM L,503,1,1,15,8,20,13,1,1,1,1,6,9,4,1,1,7.03913E+13,1,0,0,0,0,0,0,0,0,0,0,0,0,0,0,0,0,0,0,0,0,0,0,0,0,0,0,0,0,0,1,0,1,0,1,0,0,0,0,0,0,0,0,0,0,0,1,0,Adil Chihi,£1.13m ,32,183,Forward - Right Winger,left,Without Club,14,1,2,766,13,2,0,934,23,5,2,1311,3,0,0,121,1,0,0,30,6,0,0,381,9,0,3,544,nan,nan,nan,nan,nan,nan,nan,nan,Bundesliga,8,5,1,381,nan,nan,nan,nan
13/6/2011,Adam Szalai,35008102,773,12/9/1987,23,6,4,6,5,4800,6250,6750,149,135,6298679,193,78,S ,1,2,2,3,1,2,3,1,2,2,1,10,11,13,13,11,5,14,12,5,6,13,10,9,13,13,14,9,13,9,13,13,13,8,8,12,14,11,12,13,12,15,16,15,13,13,20,13,11,13,9,12,11,11,11,14,6,12,9,11,12,7,1,1,1,5,1,1,5,S ,600,1,1,20,5,1,1,1,1,1,1,1,1,1,1,1,0,0,0,0,0,0,0,0,0,0,0,0,0,0,0,0,0,0,0,0,0,0,0,0,0,0,0,0,0,0,0,0,0,0,0,0,0,0,0,0,0,0,0,0,0,0,0,0,0,Ádám Szalai,£2.70m ,32,193,Forward - Centre-Forward,right,1.FSV Mainz 05,22,5,3,1334,15,3,3,1066,33,15,6,2787,40,9,4,2226,27,5,6,1436,17,0,1,808,23,8,1,787,20,5,1,946,37,6,5,2016,Bundesliga,28,2,1,1212,1,1,0,30
13/6/2011,Adam Rooney,2005767,789,4/21/1988,23,0,0,9,0,2750,5150,5650,131,113,1577397,178,78,S ,2,1,2,3,3,1,3,2,2,3,1,4,6,12,12,13,6,14,11,5,5,12,19,9,11,15,14,13,14,12,11,11,12,7,5,12,9,13,15,10,12,12,10,7,13,12,20,13,14,14,10,11,7,8,13,8,12,13,10,10,13,4,1,1,5,11,11,5,10,S ,600,1,1,20,10,5,11,1,1,1,1,1,4,5,1,1,0,0,0,0,0,0,0,0,0,0,0,0,0,0,0,0,0,0,0,0,0,0,0,0,0,0,0,0,0,0,0,0,0,0,0,0,0,0,0,0,0,0,0,0,0,0,0,0,0,,,,,,,,,,,,,,,,,,,,,,,,,,,,,,,,,,,,,,,,,,,,,,,,,,,,
13/6/2011,Xavier Pentecôte,8438858,769,8/13/1986,24,0,0,0,0,1600,5450,5450,140,122,3001013,180,77,S ,3,1,3,1,3,2,3,2,2,3,3,6,8,12,14,12,7,11,12,5,2,9,13,2,12,7,13,11,14,14,9,12,14,12,7,14,5,7,11,16,12,13,10,8,13,14,20,13,13,14,7,14,7,5,10,13,15,14,14,14,14,6,1,1,1,1,1,1,1,S ,600,1,1,20,1,1,1,1,1,1,1,1,1,1,1,1,528,0,0,0,0,1,0,0,0,0,1,0,0,0,0,0,0,0,0,0,0,0,0,0,0,0,0,0,0,0,0,0,0,0,0,0,0,0,0,0,0,0,0,0,0,0,0,0,0,Xavier Pentecôte,£900Th. ,34,180,Forward - Centre-Forward,right,Retired,6,2,0,182,14,2,0,706,2,0,0,53,nan,nan,nan,nan,nan,nan,nan,nan,nan,nan,nan,nan,nan,nan,nan,nan,nan,nan,nan,nan,nan,nan,nan,nan,Ligue 1,nan,nan,nan,nan,nan,nan,nan,nan
13/6/2011,Víctor Meza,14022832,1649,1/28/1987,24,0,0,0,0,500,4750,4750,120,95,122804,189,86,S ,3,3,1,3,1,3,2,4,1,3,3,7,4,12,12,12,8,11,6,3,7,10,8,5,12,11,10,3,12,10,8,10,9,11,9,11,5,8,13,12,12,13,13,10,14,12,20,12,14,10,10,4,14,10,13,2,13,12,11,7,12,7,1,1,1,1,1,1,1,S ,600,1,1,20,1,1,1,1,1,1,1,1,1,1,1,1,0,0,0,0,0,0,0,0,0,0,0,0,0,0,0,0,0,0,0,0,0,0,0,0,0,0,0,0,0,0,0,0,0,0,0,0,0,0,0,0,0,0,0,0,0,0,0,0,0,Víctor Meza,£360Th. ,33,190,Forward - Centre-Forward,right,Club Leandro Niceforo Alem,11,2,1,703,7,0,0,148,nan,nan,nan,nan,nan,nan,nan,nan,nan,nan,nan,nan,nan,nan,nan,nan,nan,nan,nan,nan,nan,nan,nan,nan,nan,nan,nan,nan,Liga NOS,nan,nan,nan,nan,nan,nan,nan,nan
13/6/2011,Valeri Domovchiyski,7506723,760,10/5/1986,24,11,2,15,3,4000,5354,5950,129,119,1048226,180,74,S C,3,2,3,1,3,2,1,4,3,3,3,5,10,11,13,13,8,11,12,4,2,10,15,5,13,7,13,9,11,10,13,10,11,12,7,14,4,9,12,16,13,9,10,20,11,14,12,10,9,5,7,6,8,8,5,14,15,5,14,15,8,3,1,1,1,15,12,12,15,S C,601,1,1,20,15,12,12,1,1,1,1,1,1,1,1,1,5136,0,0,0,0,1,0,0,0,0,0,1,0,1,0,0,0,0,0,0,0,0,0,0,0,0,0,0,0,0,0,0,0,0,0,0,0,0,0,0,0,0,0,0,0,0,0,0,0,,,,,,,,,,,,,,,,,,,,,,,,,,,,,,,,,,,,,,,,,,,,,,,,,,,,
13/6/2011,Urko Vera,67037812,796,5/12/1987,24,0,0,0,0,3500,5250,5250,120,110,777376,190,86,S ,2,1,3,3,3,3,1,8,2,2,1,5,10,9,14,10,8,16,9,2,4,9,7,3,10,14,13,15,11,11,8,11,12,10,11,10,4,9,15,9,9,14,16,13,17,11,20,12,17,10,14,10,13,12,13,12,10,15,11,12,10,5,1,1,1,1,1,1,1,S ,600,1,1,20,1,1,1,1,1,1,1,1,1,1,1,1,0,0,0,0,0,0,0,0,0,0,0,0,0,0,0,0,0,0,0,0,0,0,0,0,0,0,0,0,0,0,0,0,0,0,0,0,0,0,0,0,0,0,0,0,0,0,0,0,0,,,,,,,,,,,,,,,,,,,,,,,,,,,,,,,,,,,,,,,,,,,,,,,,,,,,
13/6/2011,Tomer Hemed,7862103,775,5/2/1987,24,1,0,3,0,3250,6250,5900,135,125,3624681,183,81,S R,3,3,1,2,3,1,1,1,2,2,1,11,7,11,15,12,12,14,12,11,11,13,12,9,12,13,14,13,13,14,12,10,15,11,8,13,13,14,16,12,11,10,13,10,12,13,20,13,14,16,7,14,5,6,9,16,9,11,12,14,12,9,1,1,1,15,15,13,1,S R,602,1,1,20,1,13,15,1,1,1,1,1,1,1,1,1,0,0,0,0,0,0,0,0,0,0,0,0,0,0,0,0,0,0,0,0,0,0,0,0,0,0,0,0,0,0,0,0,0,0,0,0,0,0,0,0,0,0,0,0,0,0,0,0,0,Tomer Hemed,£1.80m ,33,182,Forward - Centre-Forward,right,Without Club,35,13,0,2243,34,10,1,2076,38,11,2,2485,24,2,1,1198,35,8,4,2328,48,17,5,3302,41,14,5,1997,19,2,2,1076,29,7,0,1426,LaLiga,19,0,0,826,nan,nan,nan,nan
13/6/2011,Thomas Kraus,35008174,771,4/5/1987,24,0,0,0,0,1200,4300,4300,110,86,127526,183,75,S ,2,2,3,1,1,2,1,1,1,1,1,7,7,7,10,6,10,9,6,4,7,7,4,3,7,14,8,13,12,5,7,5,12,6,6,8,8,12,17,9,8,8,12,18,10,13,20,18,12,10,13,10,8,10,6,15,14,7,7,6,14,7,8,8,8,10,10,7,5,S ,600,1,1,20,5,7,10,1,1,8,1,1,1,8,1,8,0,0,0,0,0,0,0,0,0,0,0,0,0,0,0,0,0,0,0,0,0,0,0,0,0,0,0,0,0,0,0,0,0,0,0,0,0,0,0,0,0,0,0,0,0,0,0,0,0,Thomas Kraft,£1.80m ,32,187,Goalkeeper,right,Retired,25,28,10,2205,38,67,5,3353,28,18,14,2520,34,50,8,3090,34,49,11,3084,7,7,3,585,1,3,0,90,8,6,4,720,5,9,2,434,Bundesliga,6,14,0,570,nan,nan,nan,nan
13/6/2011,Thomas Bertels,91017074,771,11/5/1986,24,0,0,0,0,2000,5000,5000,115,95,794130,193,82,D/AM/S L,1,3,2,3,1,3,2,2,2,3,2,7,10,10,8,10,5,11,3,2,7,12,4,10,5,7,10,5,10,8,10,12,10,9,2,7,8,7,11,12,12,12,14,20,13,11,7,7,3,10,12,6,10,10,13,7,8,16,17,18,14,8,20,13,1,18,12,20,1,D/AM/S L,123,1,1,17,1,18,12,1,20,10,1,1,1,1,13,9,0,0,0,0,0,0,0,0,0,0,0,0,0,0,0,0,0,0,0,0,0,0,0,0,0,0,0,0,0,0,0,0,0,0,0,0,0,0,0,0,0,0,0,0,0,0,0,0,0,,,,,,,,,,,,,,,,,,,,,,,,,,,,,,,,,,,,,,,,,,,,,,,,,,,,
13/6/2011,Tamás Priskin,7523013,773,9/27/1986,24,32,8,6,2,4000,5650,5000,120,106,924839,191,85,S ,1,3,3,1,2,2,1,1,1,2,3,7,9,13,12,13,6,7,11,7,7,13,13,7,14,7,11,10,12,9,11,7,9,14,5,10,10,7,8,14,14,11,14,6,14,14,20,12,11,7,8,9,7,11,11,16,13,11,13,6,9,9,1,1,1,10,10,10,1,S ,600,1,1,20,1,10,10,1,1,1,1,1,1,1,1,1,1.75922E+13,0,0,0,0,0,0,0,0,0,0,0,0,0,0,0,0,0,0,0,0,0,0,0,0,0,0,0,0,0,0,0,0,0,0,0,0,0,0,0,0,0,0,0,0,1,0,0,0,,,,,,,,,,,,,,,,,,,,,,,,,,,,,,,,,,,,,,,,,,,,,,,,,,,,
13/6/2011,Steven Fletcher,5207451,793,3/26/1987,24,8,1,7,5,4650,6800,6500,155,135,13131521,186,77,S ,3,1,3,3,3,1,1,7,1,3,3,9,12,15,14,17,13,15,14,8,4,14,17,9,14,12,13,11,13,11,13,12,14,16,9,14,7,15,13,13,14,13,14,20,14,14,5,14,15,11,10,9,9,12,12,16,15,13,14,12,12,6,1,1,12,13,10,13,13,S ,600,1,1,20,13,13,10,1,1,1,1,10,12,1,1,1,17179869184,0,0,0,0,0,0,0,0,0,0,0,0,0,0,0,0,0,0,0,0,0,0,0,0,0,0,0,0,0,0,0,0,0,0,1,0,0,0,0,0,0,0,0,0,0,0,0,0,Steven Fletcher,£5.40m ,33,185,Forward - Centre-Forward,left,Stoke City,34,12,5,1814,35,12,3,2457,31,11,4,2616,25,3,0,1549,34,5,3,2102,36,7,5,2271,41,11,2,2262,20,3,1,1146,45,11,4,2941,Premier League,30,13,2,2134,10,2,1,540
13/6/2011,Simon Cox,5119985,789,4/28/1987,24,4,2,0,0,3750,6750,6350,142,128,5824324,178,69,AM/S C,1,3,1,2,1,1,3,6,2,3,1,3,10,14,13,13,7,9,12,4,8,12,11,8,14,10,13,10,12,10,11,12,13,10,7,14,10,14,16,13,14,13,9,12,14,13,20,15,12,13,9,11,3,13,10,13,14,14,14,8,13,5,1,1,13,19,8,8,19,AM/S C,621,1,1,20,19,8,8,1,1,1,1,13,1,1,1,1,2147491840,0,0,0,0,0,0,0,0,0,0,0,0,0,1,0,0,0,0,0,0,0,0,0,0,0,0,0,0,0,0,0,1,0,0,0,0,0,0,0,0,0,0,0,0,0,0,0,0,Simon Cox,£1.80m ,33,180,Forward - Centre-Forward,left,Western Sydney Wanderers,28,5,1,1549,22,4,2,1110,41,6,10,3026,41,8,6,2457,43,8,5,2777,21,1,1,853,50,16,11,3749,47,10,2,3518,51,16,8,4153,Premier League,36,6,4,2599,nan,nan,nan,nan
13/6/2011,Simeon Jackson,5123253,364,3/28/1987,24,19,2,7,0,3650,5700,5550,128,111,2130642,173,73,S ,1,1,1,1,2,3,2,5,1,1,1,3,8,12,14,9,4,9,10,1,4,8,16,4,10,9,11,9,14,10,8,10,15,12,6,13,7,13,14,15,12,12,7,12,15,15,20,10,9,14,4,14,5,8,18,8,15,12,15,12,17,8,1,1,12,14,14,1,1,S ,600,1,1,20,1,1,14,1,1,1,1,1,1,12,1,1,2106368,0,0,0,0,0,0,0,0,0,0,1,0,0,1,0,0,0,0,0,0,0,1,0,0,0,0,0,0,0,0,0,0,0,0,0,0,0,0,0,0,0,0,0,0,0,0,0,0,Simeon Jackson,£1.35m ,33,170,Forward - Centre-Forward,right,Without Club,41,13,2,1943,28,5,4,1361,19,3,1,663,24,2,0,1039,30,3,2,1399,29,2,3,794,41,7,1,2543,14,1,1,432,32,6,2,2259,Premier League,9,0,0,357,nan,nan,nan,nan
13/6/2011,Shane Long,5130729,789,1/22/1987,24,21,6,0,0,5350,7250,7000,147,135,10350000,178,71,S ,2,1,2,2,1,1,3,3,3,2,1,6,9,11,13,13,8,14,10,5,7,10,15,9,9,14,15,15,10,9,8,8,15,8,7,15,5,14,17,17,12,12,11,8,17,16,20,15,13,15,12,14,6,12,15,12,11,16,15,15,5,8,4,1,1,10,10,1,4,S ,600,1,1,20,1,1,10,4,1,1,1,1,1,1,1,1,2.2562E+15,0,0,0,0,0,1,0,0,0,0,0,0,0,0,0,0,0,0,0,0,0,0,0,0,0,0,0,1,0,0,0,0,0,0,0,0,0,0,0,0,0,0,1,0,0,0,0,0,Shane Long,£4.05m ,33,180,Forward - Centre-Forward,both,Southampton FC,52,25,14,4413,34,8,2,2284,37,11,5,2351,32,7,3,2421,41,7,7,2179,34,13,6,2374,45,5,4,2071,35,2,2,1839,28,5,3,1431,Premier League,31,3,4,1657,5,0,0,31
13/6/2011,Serge Gakpé,919971,50,5/7/1987,24,0,0,0,0,4400,5500,5500,140,122,1790705,177,79,AM/S R,3,3,1,1,2,1,2,3,2,2,1,8,12,14,8,14,11,9,13,7,3,12,8,3,14,5,11,9,11,11,11,9,12,14,5,13,5,11,9,15,14,13,8,10,10,14,20,10,13,11,5,13,12,10,13,14,14,13,13,15,15,6,8,8,12,18,18,13,1,AM/S R,622,1,1,20,1,13,18,1,1,8,1,1,10,12,1,8,0,0,0,0,0,0,0,0,0,0,0,0,0,0,0,0,0,0,0,0,0,0,0,0,0,0,0,0,0,0,0,0,0,0,0,0,0,0,0,0,0,0,0,0,0,0,0,0,0,,,,,,,,,,,,,,,,,,,,,,,,,,,,,,,,,,,,,,,,,,,,,,,,,,,,
13/6/2011,Saër Sčne,91016509,769,11/4/1986,24,0,0,0,0,2250,4949,5500,122,110,1272982,190,87,S ,3,1,2,3,3,3,3,6,1,2,1,8,10,10,12,11,10,14,13,3,5,10,6,6,11,5,10,5,9,10,10,14,10,13,11,14,7,7,12,11,11,15,15,20,12,13,14,11,17,10,6,10,14,10,14,4,12,17,7,17,11,6,1,1,1,14,14,14,10,S ,600,1,1,20,10,14,14,1,1,1,1,1,1,1,1,1,0,0,0,0,0,0,0,0,0,0,0,0,0,0,0,0,0,0,0,0,0,0,0,0,0,0,0,0,0,0,0,0,0,0,0,0,0,0,0,0,0,0,0,0,0,0,0,0,0,,,,,,,,,,,,,,,,,,,,,,,,,,,,,,,,,,,,,,,,,,,,,,,,,,,,
13/6/2011,Saber Khelifa,12000864,51,10/14/1986,24,2,1,0,0,4100,5100,5100,130,113,5029230,183,73,S ,1,2,2,1,1,3,2,4,1,2,1,7,9,12,11,12,11,11,12,8,4,10,11,4,13,10,11,11,10,10,11,7,15,14,7,13,6,10,11,15,14,13,11,8,12,14,20,13,12,11,10,13,7,10,16,12,8,7,7,11,11,12,1,1,1,13,13,13,1,S ,600,1,1,20,1,13,13,1,1,1,1,1,1,1,1,1,16,0,0,0,0,1,0,0,0,0,0,0,0,0,0,0,0,0,0,0,0,0,0,0,0,0,0,0,0,0,0,0,0,0,0,0,0,0,0,0,0,0,0,0,0,0,0,0,0,Saber Khalifa,£1.58m ,34,183,Forward - Centre-Forward,right,Club Africain Tunis,10,1,4,742,32,4,5,2481,29,16,6,2421,36,1,2,1248,31,15,11,2639,20,5,4,1327,22,7,6,1878,26,13,3,2130,13,3,0,1087,Ligue 1,15,1,0,896,nan,nan,nan,nan
13/6/2011,Ryan Harper,67025479,796,4/16/1987,24,0,0,0,0,2150,4150,4150,115,83,47808,184,78,S R,2,2,1,3,3,3,3,1,3,3,3,10,6,7,13,10,8,14,9,2,8,12,6,5,8,6,10,12,12,12,6,12,10,11,13,16,11,13,12,8,8,12,8,5,10,11,20,13,13,10,13,5,11,10,8,10,5,11,9,12,19,19,1,1,1,15,15,1,10,S R,602,1,1,20,10,1,15,1,1,1,1,1,1,1,1,1,262160,0,0,0,0,1,0,0,0,0,0,0,0,0,0,0,0,0,0,1,0,0,0,0,0,0,0,0,0,0,0,0,0,0,0,0,0,0,0,0,0,0,0,0,0,0,0,0,0,,,,,,,,,,,,,,,,,,,,,,,,,,,,,,,,,,,,,,,,,,,,,,,,,,,,
13/6/2011,Ryan Babel,856957,784,12/19/1986,24,39,5,5,2,7500,7250,7250,157,145,24510110,185,79,AM/S LC,2,3,3,1,2,1,2,5,2,3,3,9,13,16,15,12,7,8,15,5,5,14,13,6,15,4,10,9,11,8,10,9,4,15,7,15,7,6,7,17,15,16,12,9,16,18,20,13,15,7,5,14,4,15,14,14,11,5,7,10,9,15,1,1,9,20,14,18,20,AM/S LC,514,1,1,16,20,18,14,1,1,1,1,9,1,1,1,1,5.68009E+11,1,0,0,0,0,0,0,0,0,1,0,0,0,0,0,0,0,0,0,0,0,0,0,0,0,0,0,0,0,0,1,0,0,0,1,0,0,0,0,1,0,0,0,0,0,0,0,0,Ryan Babel,£4.05m ,33,185,Forward - Left Winger,right,Galatasaray SK,34,3,2,2189,35,5,3,2731,22,5,7,1305,30,5,7,2479,29,9,5,2480,8,1,2,367,37,13,5,2818,45,15,7,3721,35,11,5,2801,Bundesliga,29,6,2,2380,9,1,2,499
13/6/2011,Ross McCormack,5204783,793,8/18/1986,24,7,1,13,4,3500,6000,6000,140,114,4513322,176,75,AM/S RL,1,2,2,1,2,2,1,2,1,1,2,14,12,13,12,14,14,8,13,2,5,11,12,7,13,8,12,11,14,8,10,10,14,12,5,11,11,12,13,12,11,11,8,13,8,12,20,12,10,10,6,13,12,13,16,15,10,13,8,9,11,10,1,1,12,17,15,17,10,AM/S RL,625,1,1,20,10,17,15,1,1,1,1,1,12,11,1,1,8192,0,0,0,0,0,0,0,0,0,0,0,0,0,1,0,0,0,0,0,0,0,0,0,0,0,0,0,0,0,0,0,0,0,0,0,0,0,0,0,0,0,0,0,0,0,0,0,0,,,,,,,,,,,,,,,,,,,,,,,,,,,,,,,,,,,,,,,,,,,,,,,,,,,,
13/6/2011,Romain Armand,8428615,769,2/27/1987,24,0,0,0,0,3150,4650,4650,118,103,46482,181,75,S ,2,1,2,2,2,3,3,1,2,3,2,4,7,11,12,12,11,14,12,5,4,8,14,3,12,8,13,13,12,12,7,11,13,9,6,13,7,12,12,11,11,13,11,5,14,13,20,14,13,13,8,13,8,5,6,12,14,11,13,14,14,6,1,1,1,1,1,1,1,S ,600,1,1,20,1,1,1,1,1,1,1,1,1,1,1,1,262144,0,0,0,0,0,0,0,0,0,0,0,0,0,0,0,0,0,0,1,0,0,0,0,0,0,0,0,0,0,0,0,0,0,0,0,0,0,0,0,0,0,0,0,0,0,0,0,0,,,,,,,,,,,,,,,,,,,,,,,,,,,,,,,,,,,,,,,,,,,,,,,,,,,,
13/6/2011,Robin Prévitali,8439279,769,6/5/1987,24,0,0,0,0,2200,4450,4500,105,85,49627,185,84,S ,1,1,1,2,1,3,2,2,2,2,1,4,6,10,11,10,7,13,10,5,3,8,11,2,10,9,10,12,10,10,6,8,14,11,7,12,7,9,11,12,10,14,11,5,14,10,20,12,14,14,9,14,6,5,6,12,13,13,14,14,14,6,1,1,1,10,1,1,10,S ,600,1,1,20,10,1,1,1,1,1,1,1,1,1,1,1,17179869184,0,0,0,0,0,0,0,0,0,0,0,0,0,0,0,0,0,0,0,0,0,0,0,0,0,0,0,0,0,0,0,0,0,0,1,0,0,0,0,0,0,0,0,0,0,0,0,0,,,,,,,,,,,,,,,,,,,,,,,,,,,,,,,,,,,,,,,,,,,,,,,,,,,,
13/6/2011,Ricardo Vaz Tę,5119861,788,10/1/1986,24,0,0,19,4,2750,5500,5500,110,98,1203703,188,78,M/AM/S R,3,3,2,1,3,1,2,1,1,2,2,6,11,10,10,10,7,6,7,3,2,9,6,6,11,11,9,11,10,7,11,7,12,13,10,11,10,12,11,11,11,9,12,13,9,13,20,10,7,9,4,12,11,10,9,8,9,9,9,4,10,11,1,1,17,20,20,13,10,M/AM/S R,532,1,1,18,10,13,20,1,1,1,1,1,13,17,1,1,402662400,0,0,0,0,0,0,0,0,0,0,1,0,0,1,0,0,0,0,0,0,0,0,0,0,0,0,0,1,1,0,0,0,0,0,0,0,0,0,0,0,0,0,0,0,0,0,0,0,,,,,,,,,,,,,,,,,,,,,,,,,,,,,,,,,,,,,,,,,,,,,,,,,,,,
13/6/2011,Rémy Dugimont,85096551,769,7/1/1986,24,0,0,0,0,1050,2100,2100,110,85,17086,182,75,S ,1,1,1,1,3,1,1,4,1,3,1,8,4,13,10,10,6,12,13,1,5,7,4,2,13,9,12,4,8,13,7,11,7,11,12,12,6,11,11,13,11,12,10,5,10,12,20,7,11,10,15,9,3,10,16,13,11,8,10,7,12,5,1,1,1,12,1,1,12,S ,600,1,1,20,12,1,1,1,1,1,1,1,1,1,1,1,0,0,0,0,0,0,0,0,0,0,0,0,0,0,0,0,0,0,0,0,0,0,0,0,0,0,0,0,0,0,0,0,0,0,0,0,0,0,0,0,0,0,0,0,0,0,0,0,0,,,,,,,,,,,,,,,,,,,,,,,,,,,,,,,,,,,,,,,,,,,,,,,,,,,,
13/6/2011,Pedro,1511447,796,12/12/1986,24,0,0,0,0,3400,5450,5450,123,109,533947,178,72,AM/S R,2,2,2,1,2,2,3,3,2,1,1,4,11,14,12,13,8,10,9,2,4,12,9,2,13,10,8,14,11,10,11,10,10,12,9,14,9,11,12,13,12,11,8,8,14,14,20,12,10,8,8,8,8,12,8,1,8,11,11,6,9,11,1,1,15,20,20,13,1,AM/S R,512,1,1,18,1,13,20,1,1,1,1,1,8,15,1,1,0,0,0,0,0,0,0,0,0,0,0,0,0,0,0,0,0,0,0,0,0,0,0,0,0,0,0,0,0,0,0,0,0,0,0,0,0,0,0,0,0,0,0,0,0,0,0,0,0,Pedro,£25.20m ,33,167,Forward - Right Winger,both,AS Roma,53,22,13,3588,48,13,6,2774,45,10,11,3413,54,19,13,3320,50,11,9,2199,43,9,3,2781,43,13,12,2723,48,7,5,2509,52,13,5,3099,LaLiga,23,2,3,1273,5,2,1,400
13/6/2011,Oriol Riera,7459580,796,7/3/1986,24,0,0,0,0,3500,5300,5300,115,110,531745,185,78,S ,1,2,1,3,3,2,1,7,2,3,3,6,8,13,12,10,9,13,10,6,4,8,14,7,11,14,13,10,11,11,9,12,10,11,9,12,7,14,15,13,14,13,11,6,16,14,20,16,13,14,6,11,8,14,11,13,8,14,10,11,9,11,1,1,1,1,1,1,1,S ,600,1,1,20,1,1,1,1,1,1,1,1,1,1,1,1,16,0,0,0,0,1,0,0,0,0,0,0,0,0,0,0,0,0,0,0,0,0,0,0,0,0,0,0,0,0,0,0,0,0,0,0,0,0,0,0,0,0,0,0,0,0,0,0,0,,,,,,,,,,,,,,,,,,,,,,,,,,,,,,,,,,,,,,,,,,,,,,,,,,,,
13/6/2011,Olivier Giroud,34000647,769,9/30/1986,24,0,0,0,0,4900,6100,6100,145,136,5422192,192,88,S ,2,1,3,3,1,1,3,4,3,3,3,5,7,11,14,12,13,17,13,6,6,11,15,3,12,9,15,15,14,13,9,13,14,12,10,14,8,13,14,13,12,17,16,20,15,12,8,15,17,14,9,16,7,5,8,14,14,14,14,14,14,5,1,1,1,1,1,1,1,S ,600,1,1,20,1,1,1,1,1,1,1,1,1,1,1,1,262144,0,0,0,0,0,0,0,0,0,0,0,0,0,0,0,0,0,0,1,0,0,0,0,0,0,0,0,0,0,0,0,0,0,0,0,0,0,0,0,0,0,0,0,0,0,0,0,0,Olivier Giroud,£11.70m ,34,193,Forward - Centre-Forward,left,Chelsea FC,43,14,5,3481,42,25,12,3698,47,17,12,3201,51,22,12,4092,36,19,4,2379,53,24,6,3373,40,16,7,1780,44,12,3,2187,45,13,10,2186,Ligue 1,25,10,1,1408,3,1,0,111
13/6/2011,Nicolas Belvito,34005497,769,12/18/1986,24,0,0,0,0,1500,3000,3000,105,91,93396,189,80,S ,3,2,1,1,3,3,3,1,3,3,3,4,6,8,11,10,6,14,8,5,6,8,13,3,10,12,12,13,10,12,8,8,14,9,5,12,7,12,12,10,8,17,14,5,13,12,20,11,17,13,12,13,7,5,13,14,7,11,9,13,13,10,1,1,1,10,1,10,1,S ,600,1,1,20,1,10,1,1,1,1,1,1,1,1,1,1,262144,0,0,0,0,0,0,0,0,0,0,0,0,0,0,0,0,0,0,1,0,0,0,0,0,0,0,0,0,0,0,0,0,0,0,0,0,0,0,0,0,0,0,0,0,0,0,0,0,Nicolas Bovi,£90Th. ,27,182,Forward - Right Winger,right,ASC Arcetana,8,0,0,329,14,1,0,872,12,1,0,825,3,0,0,56,25,2,2,1627,15,6,0,1113,28,5,0,1502,19,3,1,791,nan,nan,nan,nan,Serie A,nan,nan,nan,nan,nan,nan,nan,nan
13/6/2011,Nico Klotz,91000767,771,9/20/1986,24,0,0,0,0,3600,4750,4750,110,95,18512,173,64,M/AM/S R,3,2,2,2,2,2,2,1,3,1,1,8,11,13,10,11,7,6,7,5,4,10,7,6,12,7,11,12,8,9,12,10,11,13,6,12,7,11,13,15,14,8,7,7,12,12,20,10,7,8,5,8,4,13,1,12,10,14,13,11,12,5,1,1,16,20,20,11,1,M/AM/S R,532,1,1,18,1,11,20,1,1,1,1,1,9,16,1,1,2.2518E+15,0,1,0,0,0,0,0,0,0,0,0,0,0,0,0,0,0,0,0,0,0,0,0,0,0,0,0,1,0,0,0,0,0,0,0,0,0,0,0,0,0,0,0,0,0,0,0,0,,,,,,,,,,,,,,,,,,,,,,,,,,,,,,,,,,,,,,,,,,,,,,,,,,,,
13/6/2011,Nicky Maynard,5118461,765,12/11/1986,24,0,0,0,0,3150,6050,6050,135,122,4754931,180,70,S ,1,1,3,3,3,3,3,2,1,1,1,1,3,13,15,11,4,10,16,2,3,10,8,4,14,5,13,11,14,10,8,11,15,14,9,14,13,10,14,16,12,10,9,12,16,15,20,10,7,14,2,15,14,8,7,16,14,14,14,17,15,3,1,1,5,14,13,14,1,S ,600,1,1,20,1,14,13,1,1,1,1,1,5,5,1,1,0,0,0,0,0,0,0,0,0,0,0,0,0,0,0,0,0,0,0,0,0,0,0,0,0,0,0,0,0,0,0,0,0,0,0,0,0,0,0,0,0,0,0,0,0,0,0,0,0,,,,,,,,,,,,,,,,,,,,,,,,,,,,,,,,,,,,,,,,,,,,,,,,,,,,
13/6/2011,Nick Proschwitz,8728257,771,11/28/1986,24,0,0,0,0,4150,5500,5550,124,113,1212885,192,85,S ,2,2,1,3,3,3,3,2,2,2,2,10,7,9,14,9,10,16,11,5,10,13,10,10,9,9,13,8,12,12,12,13,10,12,4,14,12,16,14,10,11,12,17,5,6,11,20,9,15,10,9,10,11,10,6,13,16,18,17,7,6,1,1,1,1,1,1,1,1,S ,600,1,1,20,1,1,1,1,1,1,1,1,1,1,1,1,0,0,0,0,0,0,0,0,0,0,0,0,0,0,0,0,0,0,0,0,0,0,0,0,0,0,0,0,0,0,0,0,0,0,0,0,0,0,0,0,0,0,0,0,0,0,0,0,0,,,,,,,,,,,,,,,,,,,,,,,,,,,,,,,,,,,,,,,,,,,,,,,,,,,,
13/6/2011,Mohamed M'Changama,85077781,919586,6/9/1987,24,3,0,0,0,2150,4900,3250,115,98,194200,187,79,AM/S L,3,3,3,3,2,2,3,1,3,3,3,4,8,10,11,12,7,11,12,5,5,8,10,2,10,8,11,12,13,9,9,10,13,11,6,13,5,8,12,11,10,15,12,8,14,14,20,12,13,12,8,14,6,7,8,11,12,14,13,15,15,6,1,1,10,20,1,20,1,AM/S L,513,1,1,16,1,20,1,1,1,1,1,1,10,1,1,1,1041,1,0,0,0,1,0,0,0,0,0,1,0,0,0,0,0,0,0,0,0,0,0,0,0,0,0,0,0,0,0,0,0,0,0,0,0,0,0,0,0,0,0,0,0,0,0,0,0,,,,,,,,,,,,,,,,,,,,,,,,,,,,,,,,,,,,,,,,,,,,,,,,,,,,
13/6/2011,Michel,55013070,1651,8/22/1986,24,0,0,0,0,1250,2000,5500,139,121,3408345,182,80,S ,1,2,3,2,2,2,3,7,1,2,3,13,14,14,15,14,12,14,13,8,7,13,13,8,14,10,12,11,13,12,12,13,11,13,10,12,8,12,12,11,12,16,13,20,12,11,8,15,17,10,7,12,9,10,14,14,13,12,12,12,12,6,1,1,1,14,5,5,14,S ,600,1,1,20,14,5,5,1,1,1,1,1,1,1,1,1,5.27766E+13,0,0,0,0,0,0,0,0,1,1,0,0,0,0,0,0,0,0,0,1,0,0,0,0,0,0,0,0,0,0,0,0,0,0,0,0,0,0,0,0,0,0,0,0,1,1,0,0,Michel,£360Th. ,35,183,Defender - Right-Back,right,Retired,12,1,0,578,6,0,0,448,nan,nan,nan,nan,8,0,0,432,0,0,0,0,nan,nan,nan,nan,nan,nan,nan,nan,nan,nan,nan,nan,nan,nan,nan,nan,Liga NOS,nan,nan,nan,nan,nan,nan,nan,nan
13/6/2011,Michel Lugo,19112674,1651,6/9/1987,24,0,0,0,0,750,4550,4550,111,91,656149,182,80,AM/S C,2,1,3,1,3,1,2,1,3,3,3,10,12,12,12,10,7,12,12,4,8,12,3,8,9,8,11,9,8,7,8,11,10,11,13,12,9,11,12,12,12,12,8,9,9,12,20,12,6,10,8,10,12,10,5,13,9,7,16,13,14,7,1,1,1,18,1,1,18,AM/S C,621,1,1,20,18,1,1,1,1,1,1,1,1,1,1,1,0,0,0,0,0,0,0,0,0,0,0,0,0,0,0,0,0,0,0,0,0,0,0,0,0,0,0,0,0,0,0,0,0,0,0,0,0,0,0,0,0,0,0,0,0,0,0,0,0,Michel Lugo,£180Th. ,33,182,Forward - Left Winger,left,Without Club,nan,nan,nan,nan,8,1,0,288,0,0,0,0,19,7,0,1723,16,1,5,853,16,5,2,1094,21,6,8,1286,16,6,0,990,22,9,10,1632,Liga NOS,12,3,2,758,nan,nan,nan,nan
13/6/2011,Mevlüt Erdinç,8440958,799,2/25/1987,24,13,1,2,2,5450,6350,6050,150,135,5943400,181,85,S ,2,1,2,1,1,1,3,2,2,2,3,6,10,12,12,13,8,15,12,6,5,9,12,4,13,8,14,15,9,10,9,9,15,12,9,14,6,8,14,17,13,16,11,10,15,14,20,16,16,10,8,14,8,8,11,16,14,9,14,14,13,7,1,1,1,10,10,1,1,S ,600,1,1,20,1,1,10,1,1,1,1,1,1,1,1,1,4.39805E+12,0,0,0,0,1,0,0,0,0,1,0,0,0,1,0,0,0,0,0,0,0,0,0,0,0,0,0,0,0,0,0,0,0,0,0,0,0,0,0,0,0,0,1,0,0,0,0,0,Mevlüt Erdinc,£5.85m ,33,181,Forward - Centre-Forward,right,Fatih Karagümrük,54,9,4,3472,33,7,4,1557,37,13,6,2650,33,13,4,2110,36,9,1,2224,29,4,1,1454,27,6,1,1528,26,6,0,1024,27,14,3,1685,Ligue 1,19,4,0,712,5,1,1,220
13/6/2011,Mauro Zárate,961289,1649,3/18/1987,24,0,0,5,2,7000,6750,7450,161,148,15660859,176,76,AM/S RLC,1,1,2,3,2,3,1,3,1,1,1,12,14,17,13,15,15,6,15,3,4,13,15,6,17,14,10,15,12,11,13,11,16,17,11,14,6,4,12,16,15,11,6,12,14,16,20,15,10,14,14,15,11,12,15,17,13,13,9,11,14,15,1,1,1,16,16,16,15,AM/S RLC,626,1,1,20,15,16,16,1,1,1,1,1,1,1,1,1,8.79621E+13,0,0,0,0,0,0,0,0,0,0,0,0,0,0,0,0,0,1,0,0,0,0,0,0,0,0,0,1,0,0,1,0,0,0,0,0,0,0,0,0,0,0,0,0,1,0,1,0,Mauro Zárate,£8.55m ,33,175,Forward - Centre-Forward,right,Club Atlético Boca Juniors,36,9,9,2583,31,3,3,1437,10,3,3,491,32,18,6,2565,12,2,1,527,38,8,4,2111,12,4,2,482,27,14,2,2097,44,11,11,2691,Serie A,13,2,2,497,nan,nan,nan,nan
13/6/2011,Matteo Ardemagni,7983989,776,3/26/1987,24,0,0,0,0,2000,5400,5400,135,117,6758681,185,81,S ,1,3,3,1,1,3,2,5,1,3,3,5,9,10,15,12,8,12,10,5,5,10,15,6,12,15,13,10,13,9,9,11,15,11,10,15,8,14,14,13,10,10,12,10,13,13,20,14,14,16,13,14,12,10,14,15,15,11,16,16,9,4,1,1,1,12,1,1,12,S ,600,1,1,20,12,1,1,1,1,1,1,1,1,1,1,1,0,0,0,0,0,0,0,0,0,0,0,0,0,0,0,0,0,0,0,0,0,0,0,0,0,0,0,0,0,0,0,0,0,0,0,0,0,0,0,0,0,0,0,0,0,0,0,0,0,Matteo Ardemagni,£900Th. ,33,185,Forward - Centre-Forward,right,Frosinone Calcio,39,5,4,2626,20,5,2,1460,41,25,1,3656,19,5,1,1048,27,6,1,1723,38,13,3,2698,35,13,2,2674,34,7,2,2475,18,8,1,1426,Serie A,32,4,3,1455,2,0,1,116
13/6/2011,Martin Harnik,35002612,755,6/10/1987,24,24,5,3,1,5650,6074,6750,141,135,23226449,185,76,AM/S RC,3,3,2,1,2,2,2,6,1,1,1,6,12,14,10,14,8,7,9,4,5,12,10,6,13,10,8,11,9,10,10,9,14,15,5,13,6,11,15,17,15,9,12,16,15,17,20,13,8,14,9,10,8,10,15,15,10,10,11,12,13,9,12,14,1,18,18,14,15,AM/S RC,623,1,1,20,15,14,18,1,8,12,1,1,1,1,5,14,524306,0,1,0,0,1,0,0,0,0,0,0,0,0,0,0,0,0,0,0,1,0,0,0,0,0,0,0,0,0,0,0,0,0,0,0,0,0,0,0,0,0,0,0,0,0,0,0,0,Martin Harnik,£9.90m ,33,185,Forward - Right Winger,right,TuS Dassendorf,44,17,12,2477,38,17,10,3072,47,12,7,3656,35,10,3,2316,29,9,3,2320,21,3,0,1084,33,21,4,2554,32,11,4,2067,22,7,4,917,Bundesliga,25,3,2,1383,2,1,1,116
13/6/2011,Marquinho,55010242,1651,8/7/1986,24,0,0,0,0,1000,2000,5000,115,105,1493984,177,74,AM/S R,1,3,3,1,3,1,2,5,2,1,2,10,11,12,10,11,9,9,9,8,6,10,10,8,11,11,11,11,9,10,10,10,11,13,9,13,10,10,11,14,14,10,11,8,11,14,20,10,9,9,6,10,13,12,13,11,12,11,13,14,14,6,1,1,1,17,17,13,10,AM/S R,622,1,1,20,10,13,17,1,1,1,1,1,1,1,1,1,0,0,0,0,0,0,0,0,0,0,0,0,0,0,0,0,0,0,0,0,0,0,0,0,0,0,0,0,0,0,0,0,0,0,0,0,0,0,0,0,0,0,0,0,0,0,0,0,0,Marquinho,£4.05m ,34,182,Midfielder - Attacking Midfield,left,Figueirense Futebol Clube,38,5,9,2921,15,3,1,969,30,4,2,1471,28,2,1,1573,27,10,7,2221,53,5,3,2842,5,0,0,98,nan,nan,nan,nan,7,0,0,323,Serie A,15,0,2,1178,nan,nan,nan,nan
13/6/2011,Marcus Berg,8111329,797,8/17/1986,24,19,5,19,8,5900,6250,6350,143,131,10761721,184,78,S ,3,2,2,3,1,2,3,4,1,1,2,5,7,9,16,8,7,14,12,3,4,7,17,5,8,8,19,13,17,16,10,18,9,7,7,18,6,10,9,12,14,8,12,16,10,12,20,13,11,11,14,12,5,4,14,14,14,10,15,8,9,5,1,1,1,10,1,1,10,S ,600,1,1,20,10,1,1,1,1,1,1,1,1,1,1,1,2.19902E+13,0,0,0,0,0,0,0,0,0,0,1,0,0,1,0,0,0,0,0,0,0,1,0,0,0,0,0,0,0,0,0,0,0,0,0,0,0,0,0,0,0,0,1,0,1,0,0,0,Marcus Berg,£3.60m ,34,184,Forward - Centre-Forward,right,FK Krasnodar,41,11,7,2642,14,2,1,936,12,1,0,361,40,23,10,3221,33,22,5,2240,34,19,3,2513,46,31,10,3912,29,32,11,2444,29,14,1,2251,Bundesliga,32,10,3,2050,13,5,3,1041
13/6/2011,Marco Ruben,961949,1649,10/26/1986,24,1,1,0,0,5000,7000,7000,150,138,5463856,179,72,S ,3,1,1,1,3,1,2,3,2,1,2,9,10,13,16,13,10,15,12,7,6,12,14,8,13,14,14,15,12,11,12,13,18,13,9,16,7,11,13,14,13,13,10,13,14,13,20,13,11,14,8,12,6,12,14,15,16,15,13,13,17,7,1,1,1,1,1,1,1,S ,600,1,1,20,1,1,1,1,1,1,1,1,1,1,1,1,16,0,0,0,0,1,0,0,0,0,0,0,0,0,0,0,0,0,0,0,0,0,0,0,0,0,0,0,0,0,0,0,0,0,0,0,0,0,0,0,0,0,0,0,0,0,0,0,0,Marco Ruben,£5.40m ,34,179,Forward - Centre-Forward,right,Without Club,47,11,8,2266,37,9,4,2589,15,1,1,510,31,1,1,1920,42,22,3,3144,19,15,1,1552,21,6,1,1618,19,3,0,1245,43,11,2,3424,LaLiga,8,5,0,706,nan,nan,nan,nan
13/6/2011,Luis Suárez,78000335,1657,1/24/1987,24,42,17,4,2,7250,8300,8300,178,163,73606631,181,81,AM/S RL,1,2,3,3,1,3,1,5,3,2,1,10,14,15,15,16,14,12,13,9,5,15,13,5,17,11,15,13,14,14,15,12,18,15,10,15,6,14,15,15,15,15,12,13,14,15,20,15,12,14,8,13,5,11,13,16,13,15,10,4,8,7,1,1,1,17,17,17,14,AM/S RL,625,1,1,20,14,17,17,1,1,1,1,1,1,1,1,1,65568,0,0,0,0,0,1,0,0,0,0,0,0,0,0,0,0,1,0,0,0,0,0,0,0,0,0,0,0,0,0,0,0,0,0,0,0,0,0,0,0,0,0,0,0,0,0,0,0,Luis Suárez,£26.10m ,33,182,Forward - Centre-Forward,right,Atlético Madrid,37,16,16,3213,39,17,10,3254,44,30,13,3720,37,31,19,3249,43,25,23,3532,53,59,24,4766,51,36,19,4302,51,31,20,4447,49,23,15,4132,Premier League,36,21,12,2658,6,4,1,382
13/6/2011,Luís Leal,55014715,40,5/29/1987,24,0,0,0,0,1250,5000,4500,125,109,46687,176,75,AM/S RL,2,1,2,1,1,3,1,3,3,2,2,9,10,12,12,10,7,9,9,6,5,10,11,8,11,10,11,10,9,8,9,9,12,13,6,12,6,9,10,13,11,13,9,13,15,13,20,10,12,9,6,9,7,13,13,11,12,11,14,14,14,5,1,1,9,20,17,20,10,AM/S RL,515,1,1,20,10,20,17,1,1,1,1,1,9,1,1,1,0,0,0,0,0,0,0,0,0,0,0,0,0,0,0,0,0,0,0,0,0,0,0,0,0,0,0,0,0,0,0,0,0,0,0,0,0,0,0,0,0,0,0,0,0,0,0,0,0,Luís Leal,£720Th. ,33,176,Forward - Right Winger,right,Club Tijuana,29,8,1,1958,19,2,1,675,35,10,4,2698,34,17,2,2686,24,6,3,1595,33,6,8,2625,21,5,3,1377,24,9,1,2029,21,4,1,1280,Liga NOS,15,5,0,1109,7,0,0,330
13/6/2011,Loris Arnaud,8428656,769,4/16/1987,24,0,0,0,0,4100,5150,5150,130,115,3818544,182,80,AM/S R,2,2,1,2,3,1,1,3,3,2,1,5,8,10,11,12,9,15,13,6,4,9,12,2,11,8,14,12,12,12,8,11,14,11,5,12,7,9,12,15,12,14,12,7,13,13,20,13,14,13,8,14,8,8,12,13,16,11,14,14,14,6,1,1,10,16,16,12,1,AM/S R,622,1,1,20,1,12,16,1,1,1,1,1,10,10,1,1,262160,0,0,0,0,1,0,0,0,0,0,0,0,0,0,0,0,0,0,1,0,0,0,0,0,0,0,0,0,0,0,0,0,0,0,0,0,0,0,0,0,0,0,0,0,0,0,0,0,Loris Arnaud,£270Th. ,33,182,Forward - Centre-Forward,right,Without Club,24,1,1,1092,nan,nan,nan,nan,6,2,0,248,18,1,0,853,19,0,0,1055,nan,nan,nan,nan,2,0,1,180,29,15,7,2601,27,9,2,2335,Ligue 1,nan,nan,nan,nan,nan,nan,nan,nan
13/6/2011,Loďc Rémy,8444388,769,1/2/1987,24,11,1,11,4,6050,7500,6750,165,150,24822755,185,78,AM/S R,1,1,2,2,3,1,3,8,2,2,3,7,10,13,14,13,9,15,12,7,5,10,15,5,14,6,14,12,11,13,9,13,15,13,6,16,6,12,14,17,15,14,13,10,15,16,20,17,14,14,8,15,7,8,11,16,13,13,12,14,14,9,1,1,12,17,17,10,1,AM/S R,622,1,1,20,1,10,17,1,1,1,1,1,10,12,1,1,8720,0,0,0,0,1,0,0,0,0,1,0,0,0,1,0,0,0,0,0,0,0,0,0,0,0,0,0,0,0,0,0,0,0,0,0,0,0,0,0,0,0,0,0,0,0,0,0,0,Loïc Rémy,£17.10m ,33,185,Forward - Centre-Forward,right,Caykur Rizespor,44,18,4,3011,47,22,8,3534,37,9,1,2226,27,14,3,2108,29,9,2,1228,20,3,1,615,8,0,0,283,24,9,0,1234,29,7,2,1396,Ligue 1,30,14,0,1532,5,4,0,291
13/6/2011,Lhadji Badiane,8443037,769,4/16/1987,24,0,0,0,0,3350,5100,5100,135,113,3175693,180,71,AM/S R,1,1,1,3,2,1,3,7,1,1,2,8,11,13,8,11,8,10,9,6,4,9,12,4,13,9,10,8,11,11,11,10,12,13,5,13,6,8,11,15,13,13,10,8,12,14,20,13,11,12,9,13,10,8,6,14,13,12,11,13,13,8,1,1,10,20,20,13,1,AM/S R,512,1,1,17,1,13,20,1,1,1,1,1,10,10,1,1,2.2518E+15,0,0,0,0,0,0,0,0,0,0,0,0,0,0,0,0,0,0,0,0,0,0,0,0,0,0,0,0,0,0,0,0,0,0,0,0,0,0,0,0,0,0,0,0,0,0,0,0,,,,,,,,,,,,,,,,,,,,,,,,,,,,,,,,,,,,,,,,,,,,,,,,,,,,
13/6/2011,Leon Best,5111884,789,9/19/1986,24,7,0,1,0,3750,6250,6500,136,125,12144839,186,84,S ,1,1,1,1,1,3,1,1,3,3,2,7,12,13,12,13,10,13,9,4,8,10,11,7,11,9,6,13,11,7,9,9,11,13,7,12,10,12,11,13,11,10,13,16,15,15,20,10,15,9,11,12,6,3,9,11,5,9,12,13,9,6,1,1,1,1,1,1,1,S ,600,1,1,20,1,1,1,1,1,1,1,1,1,1,1,1,4.39805E+12,0,0,0,0,0,0,0,0,0,1,0,0,0,0,0,0,0,0,0,0,0,0,0,0,0,0,0,0,0,0,0,0,0,0,0,0,0,0,0,0,0,0,1,0,0,0,0,0,Leon Best,£2.70m ,34,187,Forward - Centre-Forward,right,Retired,13,6,2,883,21,4,4,1492,10,1,0,650,24,7,2,1577,34,0,1,1146,16,4,0,859,12,0,0,612,7,0,0,316,nan,nan,nan,nan,Premier League,nan,nan,nan,nan,nan,nan,nan,nan
13/6/2011,Kevin Gameiro,8428716,769,5/9/1987,24,5,1,4,1,6050,7500,6750,165,150,41748031,172,69,S ,1,3,3,3,2,3,2,1,1,2,1,11,12,13,17,14,8,11,13,5,2,13,15,4,14,6,15,11,14,13,13,13,16,13,9,17,7,11,14,17,15,12,7,12,16,16,20,14,9,15,6,15,8,5,5,17,13,14,14,15,15,7,1,1,1,12,12,10,1,S ,600,1,1,20,1,10,12,1,1,1,1,1,1,1,1,1,4.39805E+12,0,0,0,0,1,0,0,0,0,0,1,0,0,1,0,0,0,0,0,0,1,0,0,0,0,0,0,0,0,0,0,0,0,0,0,0,0,0,0,0,0,0,1,0,0,0,0,0,Kévin Gameiro,£12.60m ,33,172,Forward - Centre-Forward,right,Valencia CF,41,24,5,3633,45,14,3,2695,32,9,3,1168,49,21,4,2709,44,17,6,1912,52,29,7,3572,46,16,7,2363,36,11,4,1744,55,12,8,2653,Ligue 1,39,8,3,2082,5,0,0,223
13/6/2011,Kevin Dupuis,8438859,769,1/14/1987,24,0,0,0,0,2600,5250,5250,135,117,738093,187,82,S ,3,3,3,1,3,2,2,6,1,1,3,5,7,12,13,12,8,13,11,5,4,9,11,4,14,12,12,12,11,11,8,10,15,12,10,14,6,7,12,14,10,14,13,12,14,12,20,12,14,12,12,14,7,5,11,14,14,11,14,14,13,7,1,1,10,13,1,13,1,S ,600,1,1,20,1,13,1,1,1,1,1,1,10,1,1,1,0,0,0,0,0,0,0,0,0,0,0,0,0,0,0,0,0,0,0,0,0,0,0,0,0,0,0,0,0,0,0,0,0,0,0,0,0,0,0,0,0,0,0,0,0,0,0,0,0,Kevin Davies,£900Th. ,43,183,Forward - Centre-Forward,right,Retired,45,10,8,3887,37,8,2,2110,38,6,6,2555,45,5,4,2822,44,1,7,1721,nan,nan,nan,nan,nan,nan,nan,nan,nan,nan,nan,nan,nan,nan,nan,nan,Premier League,nan,nan,nan,nan,nan,nan,nan,nan
13/6/2011,Ken Ilsř,935565,764,12/2/1986,24,0,0,2,0,5200,6000,5850,136,125,1200000,183,79,AM/S C,1,2,3,1,3,2,2,7,2,2,1,12,11,14,13,12,13,10,12,12,3,13,13,3,15,12,11,11,12,11,12,11,12,17,5,11,10,14,14,15,12,12,11,12,13,13,20,14,9,11,11,13,8,14,15,19,5,11,13,12,12,12,1,1,1,19,13,13,19,AM/S C,621,1,1,20,19,13,13,1,1,1,1,1,1,1,1,1,8.79953E+13,0,0,0,0,0,0,0,0,0,0,0,0,0,0,0,0,0,1,0,0,0,0,0,0,0,0,0,0,0,0,0,0,0,0,0,1,0,0,0,0,0,0,0,0,1,0,1,0,,,,,,,,,,,,,,,,,,,,,,,,,,,,,,,,,,,,,,,,,,,,,,,,,,,,
13/6/2011,Julien Quercia,8428703,769,8/17/1986,24,0,0,9,2,4500,5650,5650,135,126,3458011,168,65,AM/S R,1,2,3,2,1,1,1,1,3,2,2,10,10,12,12,12,8,9,12,5,1,13,12,4,14,6,13,11,12,12,12,11,16,15,6,13,7,12,13,17,15,11,5,8,9,16,20,13,7,13,6,11,14,7,6,14,14,14,14,14,16,8,1,1,10,16,16,1,1,AM/S R,622,1,1,20,1,1,16,1,1,1,1,1,1,10,1,1,1042,0,1,0,0,1,0,0,0,0,0,1,0,0,0,0,0,0,0,0,0,0,0,0,0,0,0,0,0,0,0,0,0,0,0,0,0,0,0,0,0,0,0,0,0,0,0,0,0,Julien Quercia,£1.13m ,34,168,Forward - Centre-Forward,both,FC Thionville,29,5,4,1607,3,1,0,198,8,3,1,381,nan,nan,nan,nan,nan,nan,nan,nan,nan,nan,nan,nan,2,1,1,37,6,0,1,135,nan,nan,nan,nan,Ligue 1,nan,nan,nan,nan,nan,nan,nan,nan
13/6/2011,Juan Albín,5513030,1657,7/17/1986,24,0,0,14,7,5750,6850,6700,151,134,3945109,179,77,AM LC,2,3,3,2,2,3,1,4,2,3,1,15,14,15,12,14,16,9,14,5,4,14,15,4,16,7,14,7,11,9,17,13,11,16,6,15,7,13,8,15,17,8,8,20,13,16,4,11,10,8,8,12,5,14,15,13,8,11,12,11,12,8,1,1,5,20,10,18,20,AM LC,504,1,1,15,20,18,10,1,1,1,1,1,5,1,1,1,1.76437E+13,0,0,0,0,1,0,0,0,0,0,0,0,0,0,0,0,0,0,0,0,0,0,0,0,0,0,0,0,0,0,0,0,0,0,1,1,0,0,0,0,0,0,0,0,1,0,0,0,Juan Albín,£1.80m ,34,179,Midfielder - Attacking Midfield,left,Defensor Sporting Club,27,2,3,1491,8,1,0,286,21,2,2,943,28,10,5,2100,42,11,3,2583,34,11,5,2574,16,0,2,846,12,0,0,501,32,7,5,2665,LaLiga,12,2,0,427,nan,nan,nan,nan
13/6/2011,José Callejón,67011213,796,2/11/1987,24,0,0,4,1,5000,7250,7250,157,146,-1,179,73,AM/S RL,3,3,3,1,1,3,2,4,1,2,2,10,13,15,13,11,9,10,11,8,5,12,13,6,15,9,12,14,13,13,12,12,10,16,9,15,8,12,15,15,14,12,10,12,13,14,20,13,13,13,7,10,10,12,7,13,6,14,8,6,10,7,1,1,13,18,18,17,14,AM/S RL,625,1,1,20,14,17,18,1,1,1,1,1,13,13,1,1,8.79609E+12,0,0,0,0,1,0,0,0,0,0,0,0,0,1,0,0,0,0,0,0,0,0,0,0,0,0,0,0,0,0,0,0,0,0,0,0,0,0,0,0,0,0,0,1,0,0,0,0,José Callejón,£7.20m ,33,178,Forward - Right Winger,right,ACF Fiorentina,38,6,10,2982,36,13,2,1333,41,7,5,2037,52,20,11,4055,59,12,7,4337,47,13,7,3389,49,17,15,4146,50,12,13,4163,47,4,15,3708,LaLiga,45,4,10,3001,2,0,0,78
13/6/2011,Jonathan Pereira,7458328,796,5/12/1987,24,0,0,1,0,4500,6550,6550,152,130,6963489,166,61,AM/S LC,2,3,3,1,3,2,2,6,2,3,1,7,12,16,13,14,8,5,6,6,4,13,12,6,17,8,11,8,12,10,14,11,13,17,4,15,4,13,12,16,15,5,4,14,13,16,20,11,4,11,5,14,8,15,15,15,12,13,14,15,12,6,1,1,9,17,12,17,17,AM/S LC,624,1,1,20,17,17,12,1,1,1,1,1,9,5,1,1,5.49756E+11,0,0,0,0,1,0,0,0,0,0,0,0,0,0,0,0,0,0,0,0,0,0,0,0,0,0,0,0,0,0,0,0,0,0,0,0,0,0,0,1,0,0,0,0,0,0,0,0,Jonathan Pereira,£2.25m ,33,167,Forward - Centre-Forward,right,Without Club,19,3,0,850,31,4,7,1456,27,7,5,1480,34,4,8,1703,25,7,5,1221,36,9,6,2549,15,2,1,669,34,6,2,2003,31,2,3,1159,LaLiga,17,1,0,717,nan,nan,nan,nan
13/6/2011,Jean-Eudes Maurice,85030342,375,6/21/1986,24,0,0,0,0,4300,5400,5400,130,120,1071861,180,73,S R,1,2,3,2,2,2,3,5,2,3,2,11,11,12,10,12,8,11,9,6,3,9,12,4,13,6,12,9,11,11,10,9,15,12,7,13,5,9,14,17,12,12,10,5,13,15,20,14,12,14,6,13,7,8,5,12,13,12,15,15,15,7,1,1,12,15,15,14,1,S R,602,1,1,20,1,14,15,1,1,1,1,1,10,12,1,1,1024,0,0,0,0,0,0,0,0,0,0,1,0,0,0,0,0,0,0,0,0,0,0,0,0,0,0,0,0,0,0,0,0,0,0,0,0,0,0,0,0,0,0,0,0,0,0,0,0,Jean-Eudes Maurice,£450Th. ,34,180,Forward - Centre-Forward,right,Union Namur Fosses-la-Ville,21,0,2,686,23,1,3,796,8,0,0,368,8,1,0,353,5,1,0,213,nan,nan,nan,nan,25,4,0,1789,13,1,0,579,nan,nan,nan,nan,Ligue 1,nan,nan,nan,nan,nan,nan,nan,nan
13/6/2011,Jandson,19001937,1651,9/16/1986,24,0,0,0,0,2000,5650,5650,129,113,3459273,189,89,S ,3,2,1,1,3,1,1,3,2,2,2,9,7,13,10,13,9,13,13,6,4,5,9,5,8,8,13,10,11,12,12,11,11,12,12,11,4,16,12,12,10,15,13,10,15,12,20,15,16,13,5,10,7,10,11,11,10,10,10,9,10,9,1,1,1,1,1,1,1,S ,600,1,1,20,1,1,1,1,1,1,1,1,1,1,1,1,0,0,0,0,0,0,0,0,0,0,0,0,0,0,0,0,0,0,0,0,0,0,0,0,0,0,0,0,0,0,0,0,0,0,0,0,0,0,0,0,0,0,0,0,0,0,0,0,0,,,,,,,,,,,,,,,,,,,,,,,,,,,,,,,,,,,,,,,,,,,,,,,,,,,,
13/6/2011,Itay Shechter,7868835,775,2/22/1987,24,8,2,16,5,5000,7250,7250,151,135,15063110,179,74,S RL,3,3,3,3,1,2,2,3,3,2,2,9,12,15,16,11,5,7,8,10,8,11,15,8,14,9,11,10,13,14,12,10,15,10,14,13,12,8,12,16,12,11,11,13,13,14,20,12,12,12,6,13,11,10,10,14,8,15,14,12,9,12,1,1,1,15,15,15,1,S RL,605,1,1,20,1,15,15,1,1,1,1,1,1,1,1,1,7.03689E+13,0,0,0,0,0,0,0,0,0,0,0,0,0,0,0,0,0,0,0,0,0,0,0,0,0,0,0,1,0,0,0,0,0,0,0,0,0,0,0,0,0,0,0,0,0,0,1,0,Itay Shechter,£1.80m ,33,178,Forward - Centre-Forward,both,Maccabi Tel Aviv,21,6,1,1429,26,4,0,1620,19,1,1,678,32,8,1,2067,30,5,0,1495,26,3,5,1958,47,19,9,3542,37,9,10,2527,40,8,10,2594,Bundesliga,37,6,1,1675,7,2,0,263
13/6/2011,Hulk,2105510,1651,7/25/1986,24,3,0,0,0,6450,7154,7950,175,159,35224606,182,75,AM/S RL,3,2,1,2,3,2,3,9,3,1,2,12,14,15,15,13,16,7,17,9,6,12,15,8,14,13,13,15,12,11,10,11,16,17,10,15,8,9,9,17,15,16,8,20,19,16,4,16,18,12,10,13,6,11,16,16,15,12,14,10,7,10,1,1,1,20,20,20,10,AM/S RL,515,1,1,17,10,20,20,1,1,1,1,1,1,1,1,1,3.58544E+13,0,0,0,0,0,0,0,0,0,1,0,0,0,0,0,0,0,0,0,0,0,0,0,0,0,0,0,0,0,0,0,0,0,0,1,1,1,0,0,1,0,0,0,0,0,1,0,0,Hulk,£30.60m ,34,180,Forward - Right Winger,left,Shanghai SIPG,53,35,27,4402,39,21,14,3162,33,13,7,2753,34,21,13,2847,45,21,15,3757,47,27,26,4074,44,30,25,3958,35,17,17,3081,37,17,10,3161,Liga NOS,14,7,1,1093,nan,nan,nan,nan
13/6/2011,Hugues Ayivi,85051355,769,10/20/1986,24,0,0,0,0,1150,4229,2350,110,94,10970,183,82,S ,1,3,1,1,3,3,3,3,1,2,2,9,7,9,11,8,8,6,12,5,3,6,6,2,7,7,9,12,12,12,9,10,13,13,7,11,3,9,11,13,11,14,11,10,16,15,20,13,14,15,7,14,11,11,16,13,15,13,13,14,14,10,1,1,12,12,12,10,1,S ,600,1,1,20,1,10,12,1,1,1,1,1,10,12,1,1,0,0,0,0,0,0,0,0,0,0,0,0,0,0,0,0,0,0,0,0,0,0,0,0,0,0,0,0,0,0,0,0,0,0,0,0,0,0,0,0,0,0,0,0,0,0,0,0,0,,,,,,,,,,,,,,,,,,,,,,,,,,,,,,,,,,,,,,,,,,,,,,,,,,,,
13/6/2011,Horácio,735936,788,1/7/1987,24,0,0,0,0,750,3000,3000,93,75,9973,184,78,S ,2,3,2,3,3,3,1,1,3,2,1,4,3,5,12,12,6,11,4,1,4,3,2,1,9,12,7,9,12,5,7,9,9,12,11,10,6,8,10,12,12,12,9,5,13,12,20,6,9,8,8,10,5,10,15,15,9,10,15,10,5,15,1,1,1,10,5,10,5,S ,600,1,1,20,5,10,5,1,1,1,1,1,1,1,1,1,17179869200,0,0,0,0,1,0,0,0,0,0,0,0,0,0,0,0,0,0,0,0,0,0,0,0,0,0,0,0,0,0,0,0,0,0,1,0,0,0,0,0,0,0,0,0,0,0,0,0,,,,,,,,,,,,,,,,,,,,,,,,,,,,,,,,,,,,,,,,,,,,,,,,,,,,
13/6/2011,Henrique,19056823,1651,1/19/1987,24,0,0,0,0,1250,5300,5000,109,95,1113295,185,82,S ,3,2,1,3,3,1,3,2,2,1,2,7,8,11,9,10,7,10,9,7,7,9,13,7,11,8,12,8,11,10,10,7,8,14,8,11,7,10,10,10,9,14,14,8,10,11,20,11,13,7,7,9,11,7,4,16,8,11,9,18,9,17,1,1,1,1,1,1,1,S ,600,1,1,20,1,1,1,1,1,1,1,1,1,1,1,1,0,0,0,0,0,0,0,0,0,0,0,0,0,0,0,0,0,0,0,0,0,0,0,0,0,0,0,0,0,0,0,0,0,0,0,0,0,0,0,0,0,0,0,0,0,0,0,0,0,Henrique,£1.35m ,37,189,Defender - Centre-Back,right,Retired,2,0,0,88,25,2,0,2213,37,2,2,3041,50,4,0,4341,8,0,1,615,nan,nan,nan,nan,nan,nan,nan,nan,nan,nan,nan,nan,nan,nan,nan,nan,Ligue 1,nan,nan,nan,nan,nan,nan,nan,nan
13/6/2011,Haluk Türkeri,35000587,799,11/7/1986,24,0,0,2,0,1750,4250,3700,86,74,26823,187,80,S ,2,1,3,3,3,2,1,1,1,3,3,6,7,10,12,10,8,12,10,4,5,8,11,4,10,5,7,8,10,12,6,10,10,7,7,12,11,7,5,8,9,10,15,6,8,10,20,11,12,11,7,8,8,6,14,5,8,14,6,9,11,5,1,1,1,10,10,10,1,S ,600,1,1,20,1,10,10,1,1,1,1,1,1,1,1,1,4.39805E+12,0,0,0,0,0,0,0,0,0,0,0,0,0,0,0,0,0,0,0,0,0,0,0,0,0,0,0,0,0,0,0,0,0,0,0,0,0,0,0,0,0,0,1,0,0,0,0,0,,,,,,,,,,,,,,,,,,,,,,,,,,,,,,,,,,,,,,,,,,,,,,,,,,,,
13/6/2011,Giuseppe Rossi,5124471,776,2/1/1987,24,23,6,22,11,8000,8000,8250,173,166,39999998,175,73,AM/S C,2,1,3,1,2,1,2,3,1,2,3,15,14,17,16,18,14,10,15,6,5,16,18,8,19,8,16,9,18,12,17,15,16,18,10,18,8,11,10,16,17,11,8,20,12,13,13,13,9,11,12,12,10,10,17,18,10,11,15,14,12,3,1,1,7,16,10,12,16,AM/S C,621,1,1,20,16,12,10,1,1,1,1,1,7,5,1,1,17180396560,0,0,0,0,1,0,0,0,0,0,1,1,0,0,0,0,0,0,0,1,0,0,0,0,0,0,0,0,0,0,0,0,0,0,1,0,0,0,0,0,0,0,0,0,0,0,0,0,Giuseppe Rossi,£18.00m ,33,173,Forward - Centre-Forward,left,Real Salt Lake City,55,32,11,4405,14,5,1,1198,1,0,0,26,24,17,5,1686,nan,nan,nan,nan,33,8,5,1872,30,6,1,1316,10,1,0,264,nan,nan,nan,nan,LaLiga,7,1,0,168,nan,nan,nan,nan
13/6/2011,Gabby Agbonlahor,5123498,765,10/13/1986,24,3,0,16,4,6050,7100,7100,155,146,16048831,180,79,AM/S RL,1,1,3,3,1,2,2,3,1,2,1,2,10,10,12,9,3,13,6,1,4,11,7,3,9,14,10,13,11,10,8,10,12,7,6,11,5,11,12,18,9,11,9,8,16,19,20,14,16,14,9,16,8,13,14,12,19,12,14,13,13,9,1,1,1,18,18,18,1,AM/S RL,625,1,1,20,1,18,18,1,1,1,1,1,1,1,1,1,134488080,0,0,0,0,1,0,0,0,0,0,0,0,0,1,0,0,0,0,1,0,0,0,0,0,0,0,0,1,0,0,0,0,0,0,0,0,0,0,0,0,0,0,0,0,0,0,0,0,Gabriel Agbonlahor,£10.80m ,34,183,Forward - Centre-Forward,right,Retired,32,5,2,1988,36,6,7,2968,34,12,6,2638,31,4,8,2513,36,6,1,2823,18,1,2,1195,17,1,2,763,6,1,1,284,nan,nan,nan,nan,Premier League,nan,nan,nan,nan,nan,nan,nan,nan
13/6/2011,Fausto,744592,788,1/19/1987,24,0,0,0,0,1000,3750,3750,98,82,19593,175,72,AM/S RC,2,1,2,2,3,3,3,5,1,3,3,10,11,13,11,13,12,6,10,4,4,12,11,4,12,11,6,7,12,10,10,7,13,12,6,13,7,6,6,12,11,7,6,7,10,11,20,11,6,7,8,9,8,10,9,17,12,12,12,12,13,8,1,1,1,18,15,12,18,AM/S RC,623,1,1,20,18,12,15,1,1,1,1,1,1,1,1,1,5124,0,0,1,0,0,0,0,0,0,0,1,0,1,0,0,0,0,0,0,0,0,0,0,0,0,0,0,0,0,0,0,0,0,0,0,0,0,0,0,0,0,0,0,0,0,0,0,0,,,,,,,,,,,,,,,,,,,,,,,,,,,,,,,,,,,,,,,,,,,,,,,,,,,,
13/6/2011,Fatih Duran,35009352,799,2/28/1987,24,0,0,0,0,750,4150,4150,90,83,27227,171,70,M/AM L,3,3,3,1,3,2,2,1,1,3,1,7,9,9,12,6,8,4,11,8,8,9,3,8,8,10,11,9,11,9,9,12,11,8,9,9,6,11,14,12,12,12,2,20,17,12,10,11,4,8,9,10,10,10,5,9,13,18,15,12,5,13,11,1,20,17,1,20,1,M/AM L,413,1,1,15,1,17,1,1,11,1,1,1,20,1,1,1,0,0,0,0,0,0,0,0,0,0,0,0,0,0,0,0,0,0,0,0,0,0,0,0,0,0,0,0,0,0,0,0,0,0,0,0,0,0,0,0,0,0,0,0,0,0,0,0,0,,,,,,,,,,,,,,,,,,,,,,,,,,,,,,,,,,,,,,,,,,,,,,,,,,,,
13/6/2011,Erwin Hoffer,5607304,755,4/14/1987,24,24,3,12,6,5500,6250,6100,138,122,1634912,176,72,S ,2,3,3,3,3,3,3,2,1,1,2,6,9,14,13,11,8,10,11,4,6,11,8,7,12,5,13,13,13,12,11,11,14,11,5,13,8,14,15,15,15,11,8,10,12,15,20,13,11,11,6,11,14,8,12,14,11,11,12,14,10,8,1,1,1,1,1,1,1,S ,600,1,1,20,1,1,1,1,1,1,1,1,1,1,1,1,7.03687E+13,0,0,0,0,0,0,0,0,0,0,0,0,0,0,0,0,0,0,0,0,0,0,0,0,0,0,0,0,0,0,0,0,0,0,0,0,0,0,0,0,0,0,0,0,0,0,1,0,,,,,,,,,,,,,,,,,,,,,,,,,,,,,,,,,,,,,,,,,,,,,,,,,,,,
13/6/2011,Erik Jendrisek,7563339,794,10/26/1986,24,26,3,0,0,4950,6500,6000,137,125,1380789,176,74,AM/S L,2,3,1,2,2,3,1,6,2,1,1,4,12,13,10,13,7,10,9,2,6,12,7,8,14,5,12,9,8,10,8,9,11,10,9,14,7,10,18,17,15,13,8,20,13,15,7,17,11,14,2,14,2,13,12,15,13,13,14,13,12,6,1,1,1,16,1,16,14,AM/S L,623,1,1,20,14,16,1,1,1,1,1,1,1,1,1,1,17180409872,0,0,0,0,1,0,0,0,0,0,0,0,0,0,1,0,0,0,0,1,0,0,0,0,0,0,0,0,0,0,0,0,0,0,1,0,0,0,0,0,0,0,0,0,0,0,0,0,Erik Jendrisek,£900Th. ,34,176,Forward - Centre-Forward,left,Volos NPS,13,0,1,484,20,2,4,768,12,0,2,571,32,2,3,2055,35,10,2,2598,38,14,2,3042,34,1,1,2150,33,12,0,2475,25,8,1,1968,Bundesliga,25,4,0,1572,2,0,0,20
13/6/2011,Edinson Cavani,78005742,1657,2/14/1987,24,19,3,13,9,7500,7900,8250,176,165,32343929,188,72,AM/S R,3,2,1,3,1,3,3,6,1,1,3,8,8,13,17,15,6,15,15,8,4,15,15,2,14,11,12,15,15,14,12,15,14,11,15,17,12,14,19,13,13,14,14,11,18,17,20,20,15,16,7,14,7,16,13,14,14,17,15,17,15,2,1,1,1,17,17,10,6,AM/S R,622,1,1,20,6,10,17,1,1,1,1,1,1,1,1,1,4.39805E+12,0,0,0,0,0,0,0,0,0,0,0,0,0,0,0,0,0,0,0,1,0,0,0,0,0,0,0,0,0,0,0,0,0,0,0,0,0,0,0,0,0,0,1,0,0,0,0,0,Edinson Cavani,£31.50m ,33,184,Forward - Centre-Forward,right,Manchester United,47,33,7,3833,48,33,3,4064,43,38,4,3653,43,25,6,3418,53,31,2,4151,52,25,6,3629,50,49,6,4138,48,40,11,3956,33,23,9,2391,Serie A,22,7,3,1096,1,0,0,32
13/6/2011,Edgar Silva,2114495,1651,1/3/1987,24,0,0,0,0,2000,5250,6250,133,126,1472792,190,76,S ,2,3,1,1,2,2,3,2,3,2,3,9,9,12,17,13,12,16,13,9,7,11,14,7,11,11,14,10,11,13,9,13,13,7,8,13,6,13,13,12,12,16,18,7,14,13,20,15,11,10,6,10,8,5,12,13,6,11,15,16,15,5,1,1,1,1,1,1,1,S ,600,1,1,20,1,1,1,1,1,1,1,1,1,1,1,1,0,0,0,0,0,0,0,0,0,0,0,0,0,0,0,0,0,0,0,0,0,0,0,0,0,0,0,0,0,0,0,0,0,0,0,0,0,0,0,0,0,0,0,0,0,0,0,0,0,Edgar Silva,£3.42m ,33,191,Forward - Centre-Forward,right,Daegu FC,38,15,2,2799,35,11,3,2680,31,18,0,2406,21,14,4,1721,25,8,10,2193,13,7,2,1161,16,2,0,661,46,24,8,3900,31,15,5,2579,Liga NOS,16,5,3,1086,nan,nan,nan,nan
13/6/2011,Eden Ben-Basat,7862595,775,9/8/1986,24,0,0,0,0,1250,5500,5500,122,110,93011,186,74,S ,3,3,1,1,2,1,2,4,2,1,1,8,8,13,15,11,14,12,13,8,6,10,12,6,14,9,10,12,11,10,12,7,12,13,9,12,12,15,11,10,13,11,13,10,13,13,20,11,11,9,10,11,14,10,7,6,3,6,10,11,4,2,1,1,1,1,1,1,1,S ,600,1,1,20,1,1,1,1,1,1,1,1,1,1,1,1,262144,0,0,0,0,0,0,0,0,0,0,0,0,0,0,0,0,0,0,1,0,0,0,0,0,0,0,0,0,0,0,0,0,0,0,0,0,0,0,0,0,0,0,0,0,0,0,0,0,Eden Ben Basat,£1.35m ,34,184,Forward - Centre-Forward,right,Hapoel Haifa,31,19,0,2752,34,4,3,2444,30,13,0,2117,28,5,0,1115,30,7,0,1596,32,4,0,1344,35,4,3,1902,33,12,1,2407,23,2,0,995,Ligue 1,26,5,0,1870,nan,nan,nan,nan
13/6/2011,Diego Ifrán,78013636,1657,6/8/1987,24,0,0,0,0,4200,6000,6250,145,133,3644924,170,69,S ,1,1,2,2,2,1,1,6,2,1,3,12,12,12,14,12,14,13,12,3,6,12,14,5,14,12,12,11,13,11,12,13,14,13,10,14,7,12,14,15,15,12,8,12,13,14,20,13,11,13,13,10,12,11,12,13,11,11,13,13,12,7,1,1,1,5,4,1,5,S ,600,1,1,20,5,1,4,1,1,1,1,1,1,1,1,1,0,0,0,0,0,0,0,0,0,0,0,0,0,0,0,0,0,0,0,0,0,0,0,0,0,0,0,0,0,0,0,0,0,0,0,0,0,0,0,0,0,0,0,0,0,0,0,0,0,Diego Ifrán,£1.35m ,33,174,Forward - Centre-Forward,right,Retired,10,2,0,327,19,3,0,658,28,2,3,1022,11,4,1,589,28,11,5,2090,34,9,3,2115,11,4,2,610,nan,nan,nan,nan,nan,nan,nan,nan,LaLiga,nan,nan,nan,nan,nan,nan,nan,nan
13/6/2011,Davide Lanzafame,1414503,776,2/9/1987,24,0,0,7,1,4000,6200,6200,140,124,1618130,180,75,M/AM/S RL,1,2,1,3,3,2,3,6,1,2,1,12,13,13,12,12,12,12,4,7,7,12,11,10,14,11,11,12,10,8,9,11,8,11,9,12,8,13,13,13,12,10,11,10,16,15,20,13,11,8,5,12,3,12,6,12,8,14,12,7,10,5,1,1,16,20,20,18,8,M/AM/S RL,535,1,1,16,8,18,20,1,1,1,1,1,16,16,1,1,0,0,0,0,0,0,0,0,0,0,0,0,0,0,0,0,0,0,0,0,0,0,0,0,0,0,0,0,0,0,0,0,0,0,0,0,0,0,0,0,0,0,0,0,0,0,0,0,0,Davide Lanzafame,£900Th. ,33,180,Forward - Centre-Forward,right,Adana Demirspor,22,0,0,805,13,2,0,505,28,7,6,1744,nan,nan,nan,nan,25,1,3,1589,35,1,5,1993,27,12,6,2313,41,22,15,3660,34,17,8,2614,Serie A,35,15,3,2656,5,0,0,70
13/6/2011,Daniel Frahn,8728157,771,6/3/1987,24,0,0,0,0,3000,5200,5200,116,104,654164,187,82,S ,3,1,2,3,2,1,3,1,3,1,2,6,10,10,15,13,7,15,11,6,5,12,14,8,11,13,13,14,12,11,9,12,13,9,12,14,8,13,14,11,11,14,14,5,13,10,20,12,13,14,7,10,10,9,13,14,12,11,15,14,14,8,1,1,1,14,11,14,12,S ,600,1,1,20,12,14,11,1,1,1,1,1,1,1,1,1,32768,0,0,0,0,0,0,0,0,0,0,0,0,0,0,0,1,0,0,0,0,0,0,0,0,0,0,0,0,0,0,0,0,0,0,0,0,0,0,0,0,0,0,0,0,0,0,0,0,Daniel Braaten,£2.48m ,38,184,Forward - Right Winger,right,Skeid Oslo,33,5,3,2312,32,1,1,1482,35,2,5,1580,30,2,1,1781,24,1,6,1221,25,0,3,1998,17,3,3,1283,15,1,1,696,22,3,3,1293,Ligue 1,12,0,0,1037,nan,nan,nan,nan
13/6/2011,Cristian Chávez,965449,1649,6/4/1987,24,0,0,0,0,1800,4500,4500,128,109,2801954,171,70,S C,2,3,1,2,2,2,3,4,2,1,1,12,11,13,13,14,7,6,8,4,5,11,9,6,13,13,12,14,13,10,13,12,10,12,9,12,7,11,11,14,13,10,8,7,11,13,20,13,13,8,8,10,9,13,8,19,6,5,9,14,12,6,1,1,1,15,1,1,15,S C,601,1,1,20,15,1,1,1,1,1,1,1,1,1,1,1,0,0,0,0,0,0,0,0,0,0,0,0,0,0,0,0,0,0,0,0,0,0,0,0,0,0,0,0,0,0,0,0,0,0,0,0,0,0,0,0,0,0,0,0,0,0,0,0,0,Cristian Chávez,£720Th. ,33,175,Forward - Centre-Forward,right,Defensor Sporting Club,30,11,6,2675,14,1,1,456,4,1,0,337,19,3,2,1126,29,8,6,2445,21,7,3,1690,8,1,0,720,11,5,0,848,28,9,4,2129,Serie A,12,0,0,318,nan,nan,nan,nan
13/6/2011,Cristhian Stuani,78000806,1657,12/12/1986,24,0,0,6,0,4250,5759,6500,140,128,1688203,183,74,S ,1,3,2,2,2,2,2,1,3,1,2,3,11,13,15,11,7,15,9,6,6,12,14,5,13,12,13,13,14,14,12,12,14,13,12,14,8,11,11,13,12,13,13,10,15,13,20,14,12,13,8,10,8,7,14,13,8,11,13,12,12,7,1,1,1,1,1,1,1,S ,600,1,1,20,1,1,1,1,1,1,1,1,1,1,1,1,0,0,0,0,0,0,0,0,0,0,0,0,0,0,0,0,0,0,0,0,0,0,0,0,0,0,0,0,0,0,0,0,0,0,0,0,0,0,0,0,0,0,0,0,0,0,0,0,0,Cristhian Stuani,£2.25m ,34,184,Forward - Centre-Forward,right,Girona FC,33,10,1,1446,36,13,3,2485,34,7,4,2252,38,7,5,2788,45,15,0,2322,39,11,1,2156,28,5,0,1607,33,21,0,2724,34,20,0,2872,LaLiga,40,31,3,3524,2,0,0,119
13/6/2011,Conor Sammon,56001120,789,11/6/1986,24,0,0,3,0,3250,5950,6100,122,116,2070000,183,75,S ,2,3,2,1,3,3,3,3,3,3,3,9,8,11,15,12,6,10,9,9,9,10,10,9,12,12,9,12,8,11,9,13,16,9,7,11,11,14,15,15,12,11,12,10,18,14,20,11,16,6,8,13,8,11,12,13,12,10,12,13,15,2,1,1,1,10,10,7,1,S ,600,1,1,20,1,7,10,1,1,1,1,1,1,1,1,1,18253611008,0,0,0,0,0,0,0,0,0,0,0,0,0,0,0,0,0,0,0,0,0,0,0,0,0,0,0,0,0,0,1,0,0,0,1,0,0,0,0,0,0,0,0,0,0,0,0,0,Conor Sammon,£675Th. ,33,188,Forward - Centre-Forward,right,Falkirk FC,35,19,2,2415,30,2,1,1195,47,9,5,3757,42,4,3,1017,36,4,0,1759,33,6,1,1817,41,7,5,2530,37,10,3,2335,22,3,1,918,Premier League,35,10,4,2076,4,0,0,25
13/6/2011,Claudiu Keserü,7541477,790,12/2/1986,24,0,0,25,6,4200,5264,5250,135,117,1878735,178,80,S ,3,1,3,2,2,3,2,8,2,3,2,11,7,10,13,13,14,12,16,5,3,10,15,3,12,8,14,11,14,14,9,13,14,13,10,14,7,11,13,13,10,14,9,20,13,11,10,14,14,14,8,14,11,5,11,14,13,9,16,14,14,6,1,1,1,12,12,8,1,S ,600,5,1,20,1,8,12,1,1,1,1,1,1,1,1,1,3.95824E+13,0,0,0,0,0,0,0,0,0,0,1,0,0,0,0,0,0,0,0,0,0,0,0,0,0,0,0,0,0,0,0,0,0,0,0,0,0,0,0,0,0,0,1,0,0,1,0,0,,,,,,,,,,,,,,,,,,,,,,,,,,,,,,,,,,,,,,,,,,,,,,,,,,,,
13/6/2011,Christopher Mayulu,85047328,769,9/6/1986,24,0,0,0,0,450,4004,2200,115,89,7248,180,80,S ,1,1,2,3,1,2,1,4,1,3,2,5,7,9,11,9,7,11,10,5,4,6,11,4,12,8,12,10,10,6,8,7,12,13,5,12,4,8,11,16,11,13,10,5,12,12,20,8,13,12,8,14,6,5,7,11,12,15,9,13,13,7,1,1,1,10,10,1,1,S ,600,1,1,20,1,1,10,1,1,1,1,1,1,1,1,1,16,0,0,0,0,1,0,0,0,0,0,0,0,0,0,0,0,0,0,0,0,0,0,0,0,0,0,0,0,0,0,0,0,0,0,0,0,0,0,0,0,0,0,0,0,0,0,0,0,Christopher Mfuyi,£180Th. ,31,187,Defender - Centre-Back,right,Etoile Carouge FC,1,0,0,20,1,0,0,90,27,0,0,2337,25,0,0,1760,27,1,1,2430,28,1,0,2458,32,1,1,2835,24,1,1,2066,19,0,0,958,Ligue 1,15,0,1,1350,4,1,0,269
13/6/2011,Christopher Kullmann,8728131,771,9/19/1986,24,0,0,0,0,2500,4500,4500,95,83,60664,187,73,S ,1,2,1,1,3,2,3,2,3,1,1,5,6,7,13,7,6,13,5,3,5,8,8,6,8,11,12,13,5,12,7,12,8,6,8,12,5,10,12,9,8,14,13,11,12,12,20,14,14,13,6,10,6,2,11,12,13,5,10,12,14,8,1,1,1,10,10,8,1,S ,600,1,1,20,1,8,10,1,1,1,1,1,1,1,1,1,0,0,0,0,0,0,0,0,0,0,0,0,0,0,0,0,0,0,0,0,0,0,0,0,0,0,0,0,0,0,0,0,0,0,0,0,0,0,0,0,0,0,0,0,0,0,0,0,0,Christopher Buchtmann,£270Th. ,28,175,Midfielder - Central Midfield,left,FC St. Pauli,19,1,7,1137,13,1,2,979,17,0,3,1067,28,0,6,2343,18,2,1,1508,30,1,2,2544,32,6,3,2620,18,4,3,1419,24,5,4,1920,Bundesliga,13,0,0,450,nan,nan,nan,nan
13/6/2011,Christian Pouga,5635691,11,6/19/1986,24,0,0,1,0,2000,4994,5250,118,111,1849738,193,94,S ,1,1,3,3,1,2,1,1,2,2,1,5,5,13,13,8,7,14,10,4,3,8,12,3,13,12,10,12,11,10,15,12,15,10,7,11,5,9,10,14,13,17,12,6,13,13,20,15,16,10,8,9,5,8,7,11,12,7,12,13,13,6,1,1,1,1,1,1,1,S ,600,1,1,20,1,1,1,1,1,1,1,1,1,1,1,1,0,0,0,0,0,0,0,0,0,0,0,0,0,0,0,0,0,0,0,0,0,0,0,0,0,0,0,0,0,0,0,0,0,0,0,0,0,0,0,0,0,0,0,0,0,0,0,0,0,Christian Pouga,£900Th. ,34,193,Forward - Centre-Forward,right,SA Mamertins,23,3,2,878,17,3,0,726,27,5,5,1408,2,0,0,54,12,1,1,473,1,0,0,0,2,0,1,167,nan,nan,nan,nan,nan,nan,nan,nan,Liga NOS,nan,nan,nan,nan,nan,nan,nan,nan
13/6/2011,Chinedu Ede,8728342,771,2/5/1987,24,0,0,5,0,3750,5550,5550,123,111,1393417,179,78,M/AM L,1,2,2,3,1,1,1,1,3,2,3,7,10,13,7,11,7,6,5,6,5,10,11,5,12,8,7,8,11,9,10,10,11,14,6,10,4,8,15,14,17,8,8,20,13,15,16,10,10,10,5,9,13,10,12,10,12,12,11,15,15,5,1,1,17,20,1,20,1,M/AM L,523,1,1,15,1,20,1,1,1,1,1,1,17,1,1,1,134225921,1,0,0,0,0,0,0,0,0,0,0,0,0,1,0,0,0,0,0,0,0,0,0,0,0,0,0,1,0,0,0,0,0,0,0,0,0,0,0,0,0,0,0,0,0,0,0,0,,,,,,,,,,,,,,,,,,,,,,,,,,,,,,,,,,,,,,,,,,,,,,,,,,,,
13/6/2011,Chhunly Pagenburg,8728473,771,11/10/1986,24,0,0,0,0,1800,4700,4700,114,94,252533,177,74,AM/S RL,1,1,2,2,3,2,2,3,3,2,1,6,10,12,9,10,4,4,4,2,1,9,8,3,11,7,8,8,5,5,6,5,7,11,5,11,2,7,8,15,14,6,5,6,10,15,20,8,5,2,5,10,7,11,7,5,18,7,5,11,15,12,1,1,13,20,20,16,14,AM/S RL,515,1,1,16,14,16,20,1,1,1,1,10,11,13,1,1,0,0,0,0,0,0,0,0,0,0,0,0,0,0,0,0,0,0,0,0,0,0,0,0,0,0,0,0,0,0,0,0,0,0,0,0,0,0,0,0,0,0,0,0,0,0,0,0,0,,,,,,,,,,,,,,,,,,,,,,,,,,,,,,,,,,,,,,,,,,,,,,,,,,,,
13/6/2011,Cameron Jerome,5006313,765,10/14/1986,24,0,0,10,0,3950,6500,6500,140,128,6277739,185,86,S ,3,2,2,2,3,3,2,4,1,2,1,1,10,12,11,10,5,15,12,2,7,11,11,7,11,8,11,11,10,8,11,8,13,10,6,11,10,12,15,17,14,13,12,9,13,17,20,12,14,8,8,10,7,8,8,17,8,8,10,12,10,9,1,1,1,10,10,1,1,S ,600,1,1,20,1,1,10,1,1,1,1,1,1,1,1,1,16,0,0,0,0,1,0,0,0,0,0,0,0,0,0,0,0,0,0,0,0,0,0,0,0,0,0,0,0,0,0,0,0,0,0,0,0,0,0,0,0,0,0,0,0,0,0,0,0,Cameron Jerome,£3.60m ,34,185,Forward - Centre-Forward,right,Milton Keynes Dons,42,5,10,3127,37,8,3,1685,30,4,3,1309,30,2,2,1859,45,21,8,3248,35,3,2,1866,41,16,9,2975,37,8,3,2033,30,6,3,2152,Premier League,24,3,1,1704,3,2,0,156
13/6/2011,Boubacar Kébé,8439309,9,5/10/1987,24,0,0,15,7,2250,4679,3400,120,104,274642,180,77,M/AM/S RC,3,3,1,3,1,1,1,2,1,1,3,7,9,14,8,14,8,11,12,5,3,9,10,3,14,9,11,8,11,10,11,10,14,14,6,13,5,9,10,14,13,13,9,8,7,12,20,9,13,11,9,14,16,8,11,15,12,9,7,10,10,12,1,1,17,20,17,12,20,M/AM/S RC,533,1,1,16,20,12,17,1,1,1,1,14,12,17,1,1,2.2518E+15,0,0,0,0,0,0,0,0,0,0,0,0,0,0,0,0,0,0,0,0,0,0,0,0,0,0,0,0,0,0,0,0,0,0,0,0,0,0,0,0,0,0,0,0,0,0,0,0,,,,,,,,,,,,,,,,,,,,,,,,,,,,,,,,,,,,,,,,,,,,,,,,,,,,
13/6/2011,Bédi Buval,8438131,769,6/16/1986,24,0,0,0,0,2500,3250,3750,124,105,666192,186,76,S ,2,3,3,3,3,1,3,2,2,3,3,5,6,12,10,12,6,11,11,5,3,7,8,3,13,16,12,13,7,7,8,6,10,14,6,12,6,8,12,14,15,14,14,9,14,13,20,12,14,11,6,11,8,6,12,9,12,7,10,14,14,6,1,1,1,10,1,1,10,S ,600,1,1,20,10,1,1,1,1,1,1,1,1,1,1,1,532496,0,0,0,0,1,0,0,0,0,0,0,0,0,1,0,0,0,0,0,1,0,0,0,0,0,0,0,0,0,0,0,0,0,0,0,0,0,0,0,0,0,0,0,0,0,0,0,0,Bédi Buval,£1.53m ,34,187,Forward - Centre-Forward,right,Retired,29,3,1,2088,21,9,4,1858,26,1,1,1511,22,2,0,1110,31,4,0,2244,22,1,4,1479,32,11,2,1341,22,5,1,1508,nan,nan,nan,nan,Liga NOS,nan,nan,nan,nan,nan,nan,nan,nan
13/6/2011,Aziz Bouhaddouz,91000061,771,3/30/1987,24,0,0,0,0,3000,4650,4650,112,93,117363,188,81,S ,3,3,1,1,2,2,1,1,3,3,1,8,8,10,10,9,7,10,6,1,4,12,2,1,10,11,9,9,10,9,8,8,7,11,11,11,7,6,9,12,12,12,12,12,13,12,20,5,8,10,9,10,9,10,9,14,14,9,11,17,10,11,1,1,1,1,1,1,1,S ,600,1,1,20,1,1,1,1,1,1,1,1,1,1,1,1,0,0,0,0,0,0,0,0,0,0,0,0,0,0,0,0,0,0,0,0,0,0,0,0,0,0,0,0,0,0,0,0,0,0,0,0,0,0,0,0,0,0,0,0,0,0,0,0,0,,,,,,,,,,,,,,,,,,,,,,,,,,,,,,,,,,,,,,,,,,,,,,,,,,,,
13/6/2011,Ali Mathlouthi,34000924,51,4/22/1987,24,0,0,0,0,3350,5100,5100,125,113,2356565,176,74,S ,3,1,1,2,2,3,3,8,2,2,1,8,10,13,12,13,8,7,9,6,2,10,10,5,13,8,10,9,10,10,9,7,15,9,6,11,6,6,7,18,14,12,8,8,13,15,20,13,12,12,8,13,7,8,11,13,12,12,8,12,12,14,1,1,10,14,14,10,1,S ,600,1,1,20,1,10,14,1,1,1,1,1,10,10,1,1,2.2518E+15,0,0,0,0,0,0,0,0,0,0,0,0,0,0,0,0,0,0,0,0,0,0,0,0,0,0,0,0,0,0,0,0,0,0,0,0,0,0,0,0,0,0,0,0,0,0,0,0,,,,,,,,,,,,,,,,,,,,,,,,,,,,,,,,,,,,,,,,,,,,,,,,,,,,
13/6/2011,Alharbi El Jadeyaoui,8443740,34,8/8/1986,24,0,0,1,0,2400,5084,3700,118,113,423727,175,68,AM/S C,1,2,1,3,2,1,1,2,2,2,1,12,12,13,7,13,9,8,12,6,4,11,10,4,15,8,12,11,12,11,12,9,14,13,8,12,5,8,10,16,14,12,7,20,13,15,5,15,11,13,8,14,9,10,12,15,11,11,12,13,13,11,1,1,14,20,10,14,20,AM/S C,511,1,1,16,20,14,10,1,1,1,1,10,14,10,1,1,34359738368,0,0,0,0,0,0,0,0,0,0,0,0,0,0,0,0,0,0,0,0,0,0,0,0,0,0,0,0,0,0,0,0,0,0,0,1,0,0,0,0,0,0,0,0,0,0,0,0,,,,,,,,,,,,,,,,,,,,,,,,,,,,,,,,,,,,,,,,,,,,,,,,,,,,
13/6/2011,Alexis Allart,919618,769,8/7/1986,24,0,0,0,0,4350,5450,5450,135,121,1642021,180,70,S ,2,1,1,1,1,1,2,4,1,2,1,8,8,12,13,12,8,12,12,7,4,8,12,4,12,8,12,11,13,13,9,12,10,13,9,15,7,8,12,13,13,13,10,10,14,16,20,13,10,14,8,16,7,6,12,15,10,12,8,12,14,8,1,1,1,12,12,12,1,S ,600,1,1,20,1,12,12,1,1,1,1,1,1,1,1,1,16,0,0,0,0,1,0,0,0,0,0,0,0,0,0,0,0,0,0,0,0,0,0,0,0,0,0,0,0,0,0,0,0,0,0,0,0,0,0,0,0,0,0,0,0,0,0,0,0,,,,,,,,,,,,,,,,,,,,,,,,,,,,,,,,,,,,,,,,,,,,,,,,,,,,
13/6/2011,Alejandro Alfaro,1504996,796,11/23/1986,24,0,0,4,0,4750,6800,6800,153,138,1610887,173,71,AM/S RC,3,3,3,1,1,3,1,5,1,1,3,10,13,14,15,15,10,13,14,5,4,13,12,5,15,8,12,9,13,9,14,15,13,16,10,16,7,11,10,14,15,8,8,13,10,14,20,12,8,12,8,15,8,12,12,14,14,12,14,15,15,6,1,1,8,20,15,12,20,AM/S RC,513,1,1,18,20,12,15,1,1,1,1,1,5,8,1,1,1424,0,0,0,0,1,0,0,1,1,0,1,0,0,0,0,0,0,0,0,0,0,0,0,0,0,0,0,0,0,0,0,0,0,0,0,0,0,0,0,0,0,0,0,0,0,0,0,0,Alejandro Alfaro,£2.70m ,33,175,Forward - Left Winger,right,Retired,27,7,2,1168,35,3,2,1745,31,7,2,1622,39,9,8,2866,7,1,1,444,13,1,1,797,33,7,1,2172,29,2,3,1209,23,5,3,1409,LaLiga,15,0,0,560,nan,nan,nan,nan
13/6/2011,Adam Le Fondre,5123286,765,12/2/1986,24,0,0,0,0,2350,5350,5350,115,94,1552500,176,72,S ,2,1,2,1,2,2,2,3,2,2,2,3,5,9,14,12,5,10,9,3,4,9,19,4,12,8,13,7,13,13,8,11,14,13,4,12,9,12,13,12,12,11,8,5,14,13,20,13,8,14,2,12,2,6,11,16,9,10,13,12,3,2,1,1,1,1,1,1,1,S ,600,1,1,20,1,1,1,1,1,1,1,1,1,1,1,1,1.75922E+13,0,0,0,0,0,0,0,0,0,0,1,0,0,1,0,0,0,0,0,0,0,0,0,1,0,0,0,0,0,0,0,0,0,0,0,0,0,0,0,0,0,0,0,0,1,0,0,0,,,,,,,,,,,,,,,,,,,,,,,,,,,,,,,,,,,,,,,,,,,,,,,,,,,,
13/6/2011,Abraham Guie Guie,65000059,24,7/25/1986,24,2,0,14,3,4200,5900,5300,135,118,2999998,180,70,S ,3,2,2,3,3,2,2,2,1,2,2,7,7,13,13,13,7,9,10,5,3,8,11,3,13,8,13,11,12,12,7,12,14,13,5,13,5,9,12,17,14,13,10,5,14,16,20,14,11,12,8,15,6,6,7,14,12,12,14,14,14,5,1,1,1,1,1,1,1,S ,600,1,1,20,1,1,1,1,1,1,1,1,1,1,1,1,16,0,0,0,0,1,0,0,0,0,0,0,0,0,0,0,0,0,0,0,0,0,0,0,0,0,0,0,0,0,0,0,0,0,0,0,0,0,0,0,0,0,0,0,0,0,0,0,0,Abraham Gneki Guié,£1.13m ,34,180,Forward - Centre-Forward,right,Retired,33,13,5,2553,25,1,1,1101,15,3,0,738,21,8,2,1179,26,11,0,1688,31,6,0,2104,18,8,4,1391,2,1,0,124,nan,nan,nan,nan,Ligue 1,nan,nan,nan,nan,nan,nan,nan,nan
13/6/2011,Ablaď Baldé,8434266,769,11/30/1986,24,0,0,3,0,3100,4700,4700,135,105,585440,183,77,S ,3,3,1,1,1,1,2,2,2,2,3,6,8,12,11,12,7,13,14,5,4,7,12,4,12,12,9,7,11,11,7,7,10,14,5,14,5,7,9,16,11,14,11,20,14,14,5,9,14,12,6,14,9,10,9,16,11,7,12,12,5,16,1,1,1,12,1,12,1,S ,600,1,1,20,1,12,1,1,1,1,1,1,1,1,1,1,528,0,0,0,0,1,0,0,0,0,1,0,0,0,0,0,0,0,0,0,0,0,0,0,0,0,0,0,0,0,0,0,0,0,0,0,0,0,0,0,0,0,0,0,0,0,0,0,0,,,,,,,,,,,,,,,,,,,,,,,,,,,,,,,,,,,,,,,,,,,,,,,,,,,,
13/6/2011,Aaron Hunt,894135,771,9/4/1986,24,2,0,13,3,5500,6800,6800,150,138,22926307,183,73,AM RLC,3,3,3,2,1,2,1,9,3,2,3,10,14,13,16,15,10,7,14,6,5,15,12,7,16,6,12,7,11,7,16,16,5,17,6,17,8,9,11,12,15,10,10,20,7,14,10,12,9,7,15,11,17,17,3,16,10,14,4,7,9,18,1,1,14,20,19,18,20,AM RLC,506,1,1,15,20,18,19,1,1,1,1,14,14,1,1,1,6.01296E+11,0,0,0,0,0,0,0,0,0,0,0,0,0,0,1,0,0,0,0,0,1,0,0,0,0,0,0,0,0,0,0,0,0,0,1,1,0,0,0,1,0,0,0,0,0,0,0,0,Aaron Hunt,£4.50m ,34,183,Midfielder - Attacking Midfield,left,Hamburger SV,38,3,4,2493,19,3,4,1671,29,11,4,2433,32,7,9,2796,22,4,1,822,23,1,3,1739,26,4,2,1575,30,3,2,2246,24,5,4,1676,Bundesliga,24,8,2,1725,5,1,1,344
13/6/2011,Youssef Adnane,8446446,769,7/16/1985,25,0,0,0,0,4550,5174,5100,125,115,5875793,178,71,S ,2,1,1,3,3,3,3,4,2,1,2,5,8,12,14,12,11,12,11,5,3,10,14,3,12,7,12,9,15,13,8,11,10,13,5,13,6,8,10,14,12,13,10,8,14,13,20,14,12,13,7,14,7,8,14,14,12,12,14,14,16,7,1,1,1,10,10,10,1,S ,600,1,1,20,1,10,10,1,1,1,1,1,1,1,1,1,0,0,0,0,0,0,0,0,0,0,0,0,0,0,0,0,0,0,0,0,0,0,0,0,0,0,0,0,0,0,0,0,0,0,0,0,0,0,0,0,0,0,0,0,0,0,0,0,0,Youssef Adnane,£630Th. ,35,178,Forward - Centre-Forward,right,Retired,39,10,4,2244,11,0,1,362,21,3,0,897,37,7,8,2044,39,16,3,3092,29,10,2,1986,nan,nan,nan,nan,nan,nan,nan,nan,nan,nan,nan,nan,Ligue 1,nan,nan,nan,nan,nan,nan,nan,nan
13/6/2011,Yoan Gouffran,8438591,769,5/25/1986,25,0,0,24,4,4650,5850,5850,145,130,5465735,175,70,AM/S R,2,2,3,2,3,1,3,4,1,3,1,5,9,13,11,13,10,12,15,5,4,11,13,4,14,9,13,11,8,10,11,8,14,13,6,14,8,13,14,16,14,12,9,10,14,16,20,14,11,10,8,13,8,10,8,15,11,11,13,14,14,13,1,1,15,18,18,10,12,AM/S R,622,1,1,20,12,10,18,1,1,1,1,12,10,15,1,1,5.54051E+11,0,0,0,0,0,0,0,0,0,0,0,0,0,1,0,0,0,0,0,0,0,0,0,0,0,0,0,0,0,0,0,0,1,0,0,0,0,0,0,1,0,0,0,0,0,0,0,0,Yoan Gouffran,£5.40m ,34,175,Midfielder - Attacking Midfield,right,FC Ararat-Armenia Yerevan,24,2,1,1527,37,14,3,2874,42,15,3,3271,39,7,5,2966,33,2,1,2066,10,0,0,403,45,7,5,3267,31,1,1,2057,22,1,2,1042,Ligue 1,15,1,1,712,8,0,0,598
13/6/2011,Yannick Djaló,744161,788,5/5/1986,25,1,0,14,1,4750,6600,6600,149,132,6105582,171,68,AM/S RL,1,2,3,2,2,1,1,2,2,3,2,11,12,14,11,12,9,6,11,7,7,10,10,7,14,10,10,11,7,9,9,8,14,16,10,15,8,9,12,16,14,10,7,10,16,15,20,12,11,10,6,13,6,12,13,16,15,14,13,14,14,6,1,1,1,20,20,17,10,AM/S RL,515,1,1,16,10,17,20,1,1,1,1,1,1,1,1,1,34360270860,0,0,1,1,0,0,0,0,0,0,0,0,0,1,0,0,0,0,0,1,0,0,0,0,0,0,0,0,0,0,0,0,0,0,0,1,0,0,0,0,0,0,0,0,0,0,0,0,Yannick Djaló,£4.05m ,34,171,Forward - Left Winger,right,Retired,33,9,2,2276,10,0,1,470,20,1,0,1033,18,3,1,1134,10,1,0,771,34,16,7,2378,nan,nan,nan,nan,19,4,0,955,nan,nan,nan,nan,Liga NOS,nan,nan,nan,nan,nan,nan,nan,nan
13/6/2011,Wilfried Louisy-Daniel,85078621,769,5/29/1986,25,0,0,0,0,1300,2600,2600,115,104,19664,187,82,S ,1,1,1,3,2,1,2,2,2,1,1,4,6,11,12,11,7,14,9,5,5,8,10,2,11,8,11,12,13,11,6,9,15,11,6,11,5,7,9,14,11,15,13,5,13,13,20,13,15,14,8,14,8,5,7,12,11,13,14,14,14,7,1,1,1,1,1,1,1,S ,600,1,1,20,1,1,1,1,1,1,1,1,1,1,1,1,0,0,0,0,0,0,0,0,0,0,0,0,0,0,0,0,0,0,0,0,0,0,0,0,0,0,0,0,0,0,0,0,0,0,0,0,0,0,0,0,0,0,0,0,0,0,0,0,0,,,,,,,,,,,,,,,,,,,,,,,,,,,,,,,,,,,,,,,,,,,,,,,,,,,,
13/6/2011,Wayne Rooney,5108390,765,10/24/1985,25,70,26,0,0,8500,9000,9000,184,180,111183002,178,78,S ,2,1,1,3,2,1,3,8,2,2,3,10,15,12,16,16,12,15,13,5,5,16,16,8,17,17,16,19,14,16,16,15,19,16,14,17,8,18,19,16,14,17,11,14,17,15,20,18,16,15,15,17,9,12,4,18,10,14,14,8,8,10,1,1,10,14,13,14,14,S ,600,5,1,20,14,14,13,1,1,1,1,8,8,10,1,1,1.40875E+14,0,0,0,0,0,0,0,0,0,0,0,0,0,0,0,0,0,1,0,1,0,0,0,0,0,0,0,0,0,0,0,0,0,0,0,0,0,1,0,0,0,0,0,0,0,0,0,1,Wayne Rooney,£58.50m ,35,176,Midfielder - Attacking Midfield,right,Derby County,40,16,14,3207,43,34,9,3644,37,16,14,2825,40,19,22,3317,37,14,6,3236,42,15,6,3549,39,8,10,2445,61,23,9,4782,31,13,8,2636,Premier League,24,6,3,2100,6,1,0,475
13/6/2011,Virgile Reset,7822441,769,8/3/1985,25,0,0,0,0,4100,5150,5150,125,115,2393489,175,65,AM/S L,1,3,3,2,2,3,2,1,3,1,3,10,12,14,9,12,9,6,9,5,2,12,10,4,14,8,11,8,11,10,12,11,13,13,7,13,6,10,13,12,14,12,7,8,14,16,20,13,7,12,8,14,8,8,13,14,12,12,15,14,14,7,1,1,15,20,14,20,1,AM/S L,513,1,1,16,1,20,14,1,1,1,1,1,15,14,1,1,2.2518E+15,0,0,0,0,0,0,0,0,0,0,0,0,0,0,0,0,0,0,0,0,0,0,0,0,0,0,0,0,0,0,0,0,0,0,0,0,0,0,0,0,0,0,0,0,0,0,0,0,,,,,,,,,,,,,,,,,,,,,,,,,,,,,,,,,,,,,,,,,,,,,,,,,,,,
13/6/2011,Valeri Bojinov,832606,760,2/15/1986,25,21,5,3,1,5500,7150,6500,142,130,24999999,178,78,S ,1,1,1,1,1,1,1,1,1,1,1,10,12,12,13,13,11,10,13,3,5,13,13,6,14,13,12,11,12,10,12,10,15,14,10,15,8,8,10,14,12,14,10,20,13,14,10,13,16,12,8,13,16,8,16,18,12,12,12,12,10,14,1,1,1,14,14,12,8,S ,600,1,1,20,8,12,14,1,1,1,1,1,1,1,1,1,5.49756E+11,0,0,0,0,0,0,0,0,1,1,0,0,0,0,0,0,0,0,0,0,0,0,0,0,0,0,0,0,0,0,0,0,0,0,0,0,0,0,0,1,0,0,0,0,0,0,0,0,Valeri Bojinov,£2.25m ,34,185,Forward - Centre-Forward,left,Levski Sofia,33,3,3,1462,26,4,1,947,33,5,1,1525,15,7,0,1031,32,7,0,1450,45,18,8,2572,35,10,6,2258,11,1,2,560,23,11,0,1389,Serie A,11,0,0,332,1,0,0,4
13/6/2011,Torsten Oehrl,8718378,771,1/7/1986,25,0,0,0,0,4050,6000,6000,130,120,980535,191,84,AM/S C,3,3,3,1,3,3,2,4,1,2,2,9,8,11,14,11,10,14,12,1,5,11,11,9,12,10,13,13,13,11,10,11,10,9,10,13,7,13,12,12,9,14,16,13,12,12,20,12,14,12,6,10,10,11,11,10,13,7,6,8,7,19,1,1,9,20,1,1,20,AM/S C,511,1,1,20,20,1,1,1,1,1,1,9,1,1,1,1,262144,0,0,0,0,0,0,0,0,0,0,0,0,0,0,0,0,0,0,1,0,0,0,0,0,0,0,0,0,0,0,0,0,0,0,0,0,0,0,0,0,0,0,0,0,0,0,0,0,Torsten Oehrl,£1.13m ,34,192,Forward - Centre-Forward,right,Retired,32,8,7,2086,18,5,2,1419,28,1,1,1224,16,2,2,893,nan,nan,nan,nan,28,9,1,2038,16,5,1,1070,nan,nan,nan,nan,nan,nan,nan,nan,Bundesliga,nan,nan,nan,nan,nan,nan,nan,nan
13/6/2011,Tobias Werner,8720186,771,7/19/1985,25,0,0,0,0,3900,6000,6000,122,117,3042612,177,67,M/AM/S L,1,2,2,3,2,3,3,2,3,1,1,13,12,13,8,12,11,12,12,10,5,12,8,8,11,12,10,15,10,9,11,9,13,8,10,15,6,13,15,14,14,9,11,20,13,14,8,12,10,13,9,12,10,14,7,12,14,11,11,10,7,13,1,1,17,20,1,20,1,M/AM/S L,533,1,1,18,1,20,1,1,1,1,1,1,17,1,1,1,2.19916E+12,1,0,0,0,0,0,0,0,0,0,0,0,0,0,0,0,0,0,0,0,0,0,0,0,0,0,0,1,0,0,0,0,0,0,0,0,0,0,0,0,0,1,0,0,0,0,0,0,Tobias Werner,£900Th. ,35,174,Forward - Left Winger,left,Retired,24,5,3,1626,25,1,3,1411,33,5,8,2455,34,11,9,2312,32,8,5,2724,19,1,3,1050,7,0,0,324,28,2,5,1284,16,0,3,1284,Bundesliga,nan,nan,nan,nan,nan,nan,nan,nan
13/6/2011,Timo Röttger,8718887,771,7/12/1985,25,0,0,0,0,2950,4850,4850,100,97,599718,176,76,AM/S RL,2,1,3,3,2,1,2,2,2,2,1,4,11,12,10,9,4,4,7,5,4,9,8,5,9,12,10,12,10,9,12,11,12,7,9,13,7,11,14,13,9,6,8,14,12,12,20,10,8,9,5,9,14,15,8,13,6,12,13,11,9,7,1,1,15,20,20,17,1,AM/S RL,515,1,1,16,1,17,20,1,1,1,1,1,13,15,1,1,134225920,0,0,0,0,0,0,0,0,0,0,0,0,0,1,0,0,0,0,0,0,0,0,0,0,0,0,0,1,0,0,0,0,0,0,0,0,0,0,0,0,0,0,0,0,0,0,0,0,,,,,,,,,,,,,,,,,,,,,,,,,,,,,,,,,,,,,,,,,,,,,,,,,,,,
13/6/2011,Thiago Ribeiro,8438645,1651,2/24/1986,25,0,0,0,0,4000,6900,6900,145,138,3291875,185,74,S ,3,3,2,2,3,1,3,5,2,3,2,12,13,14,13,14,11,12,13,5,10,14,13,11,14,11,13,14,13,13,14,13,13,14,7,14,6,15,15,15,16,11,13,4,16,15,20,15,11,12,8,14,5,14,5,6,7,13,14,12,11,11,1,1,1,14,14,13,12,S ,600,1,1,20,12,13,14,1,1,1,1,1,1,1,1,1,3.57688E+13,0,0,0,0,1,0,0,0,0,1,0,0,0,0,0,0,0,0,0,0,0,0,0,0,0,0,0,0,1,0,0,0,0,0,0,1,0,0,0,1,0,0,0,0,0,1,0,0,Thiago Ribeiro,£2.70m ,34,183,Forward - Left Winger,right,Associação Chapecoense de Futebol,13,5,0,655,36,4,3,2407,56,12,5,3622,21,4,4,1513,35,9,3,2082,12,1,1,704,13,0,0,580,23,3,2,1194,20,5,2,881,Serie A,6,0,1,195,nan,nan,nan,nan
13/6/2011,Tarmo Kink,7681332,766,10/6/1985,25,50,4,5,0,5150,5940,5400,130,108,3219726,183,74,AM RL,1,2,1,1,1,2,3,1,1,1,2,9,8,14,11,10,12,5,18,2,3,10,12,7,13,8,9,4,12,7,11,7,11,10,5,14,5,6,9,14,14,7,11,20,18,13,12,11,6,10,7,9,3,6,13,8,10,8,14,7,12,3,1,1,9,20,20,19,1,AM RL,505,1,1,15,1,19,20,1,1,1,1,1,1,9,1,1,7.09185E+13,0,0,0,0,0,0,0,0,0,1,0,0,0,0,0,0,0,0,0,0,0,0,0,0,0,0,0,0,0,0,0,0,0,0,0,0,0,0,0,1,0,0,0,0,0,0,1,0,,,,,,,,,,,,,,,,,,,,,,,,,,,,,,,,,,,,,,,,,,,,,,,,,,,,
13/6/2011,Sylvan Ebanks-Blake,5112072,765,3/29/1986,25,0,0,1,0,4200,6300,6300,140,130,5760630,178,84,S ,1,1,1,1,1,1,1,1,1,1,1,4,10,12,14,13,5,10,12,2,5,11,17,4,13,13,13,12,13,11,8,11,13,13,4,13,6,13,15,15,10,12,11,12,15,15,20,12,16,10,6,11,6,8,15,14,11,11,14,14,15,5,1,1,1,1,1,1,1,S ,600,1,1,20,1,1,1,1,1,1,1,1,1,1,1,1,34368127504,0,0,0,0,1,0,0,0,0,1,0,0,0,0,0,0,0,0,0,0,0,0,0,1,0,0,0,0,0,0,0,0,0,0,0,1,0,0,0,0,0,0,0,0,0,0,0,0,Sylvan Ebanks-Blake,£1.35m ,34,173,Forward - Centre-Forward,right,Retired,36,7,2,1721,28,3,3,1442,42,14,4,2888,10,0,0,313,13,1,1,299,37,10,4,2641,21,3,3,1211,nan,nan,nan,nan,nan,nan,nan,nan,Premier League,nan,nan,nan,nan,nan,nan,nan,nan
13/6/2011,Sven Krause,8718064,771,1/19/1986,25,0,0,0,0,3100,4500,4500,100,90,80824,183,83,S ,3,2,2,3,1,3,1,2,1,1,3,5,4,10,11,10,7,11,12,4,3,8,9,3,10,6,9,8,7,12,13,8,8,12,6,12,6,8,10,12,12,14,10,13,12,12,20,9,11,8,2,7,8,5,16,13,7,10,12,10,9,9,1,1,1,1,1,1,1,S ,600,1,1,20,1,1,1,1,1,1,1,1,1,1,1,1,16,0,0,0,0,1,0,0,0,0,0,0,0,0,0,0,0,0,0,0,0,0,0,0,0,0,0,0,0,0,0,0,0,0,0,0,0,0,0,0,0,0,0,0,0,0,0,0,0,,,,,,,,,,,,,,,,,,,,,,,,,,,,,,,,,,,,,,,,,,,,,,,,,,,,
13/6/2011,Stephen Ward,562179,789,8/20/1985,25,3,1,5,3,3350,6250,6400,135,125,5462412,186,78,D L,1,1,1,1,1,1,1,1,1,1,1,4,12,11,9,10,10,11,9,8,11,11,6,13,11,12,13,15,13,12,6,11,11,9,6,13,7,13,15,12,13,13,12,20,16,12,12,14,10,11,8,12,8,16,8,10,15,9,14,12,13,2,20,7,12,10,3,20,10,D L,103,1,1,15,10,10,1,1,20,3,1,10,12,1,7,1,1.37439E+11,0,0,0,0,0,1,0,0,0,0,0,0,0,0,0,0,0,0,0,0,0,0,0,0,0,0,0,0,0,0,0,0,0,0,0,0,0,1,0,0,0,0,0,0,0,0,0,0,Stephen Ward,£3.60m ,35,184,Defender - Left-Back,left,Ipswich Town,38,1,2,2674,41,3,1,3607,41,2,1,3450,47,4,4,4138,10,0,0,713,27,2,4,2352,38,1,1,3322,28,1,1,2462,10,0,0,835,Premier League,18,0,0,1494,5,0,0,382
13/6/2011,Shinji Okazaki,788545,116,4/16/1986,25,43,21,0,0,5300,6850,6500,144,137,10296721,174,76,S C,3,1,1,1,1,2,2,9,2,2,1,6,7,12,14,14,7,17,12,5,6,9,11,9,13,15,16,18,13,13,7,11,13,8,7,14,6,8,16,15,16,14,10,17,14,13,20,12,9,10,9,10,5,11,13,9,9,11,12,6,5,10,1,1,1,15,10,14,15,S C,601,1,1,20,15,14,10,1,1,1,1,1,1,1,1,1,4.53549E+12,0,0,0,0,1,1,0,0,0,1,0,0,0,0,0,0,0,0,0,0,0,0,0,0,0,0,0,0,0,0,0,0,0,0,0,0,0,1,0,0,0,0,1,0,0,0,0,0,Shinji Okazaki,£4.50m ,34,175,Forward - Centre-Forward,both,SD Huesca,14,2,0,1173,29,7,1,1757,42,4,1,2023,35,15,1,2885,35,14,6,3087,39,6,2,2222,41,6,1,2211,32,7,4,1578,26,1,1,584,Bundesliga,38,12,0,2474,5,0,0,370
13/6/2011,Sebastián Balsas,78015616,1657,3/5/1986,25,0,0,0,0,2250,5219,4400,128,116,384376,196,90,S ,2,3,1,2,3,2,2,2,1,2,2,10,9,9,13,12,10,13,12,10,7,10,13,7,12,12,11,12,11,8,9,12,11,8,11,13,8,12,11,9,11,14,17,11,9,14,20,13,13,10,14,7,4,10,13,13,6,4,13,8,7,6,1,1,1,1,1,1,1,S ,600,1,1,20,1,1,1,1,1,1,1,1,1,1,1,1,1310720,0,0,0,0,0,0,0,0,0,0,0,0,0,0,0,0,0,0,1,0,1,0,0,0,0,0,0,0,0,0,0,0,0,0,0,0,0,0,0,0,0,0,0,0,0,0,0,0,Sebastián Ribas,£2.16m ,32,189,Forward - Centre-Forward,right,Club Atlético Central Córdoba (SdE),39,23,4,3399,7,0,0,346,7,0,0,356,13,4,0,757,24,6,0,1735,21,1,1,910,28,11,0,1993,29,14,4,2398,21,5,1,1257,Serie A,21,3,2,828,nan,nan,nan,nan
13/6/2011,Saúl,67000817,796,5/24/1986,25,0,0,0,0,3700,5550,5550,121,113,903796,178,78,S L,1,1,1,2,2,1,1,4,3,3,3,5,7,13,13,8,8,11,14,5,5,7,13,5,12,10,12,11,13,11,12,12,12,13,9,13,8,8,8,15,11,13,9,20,12,13,8,11,15,10,10,11,5,12,10,15,5,11,8,12,8,15,1,1,1,15,1,15,1,S L,603,1,1,20,1,15,1,1,1,1,1,1,1,1,1,1,512,0,0,0,0,0,0,0,0,0,1,0,0,0,0,0,0,0,0,0,0,0,0,0,0,0,0,0,0,0,0,0,0,0,0,0,0,0,0,0,0,0,0,0,0,0,0,0,0,Raúl,£4.50m ,43,178,Forward - Second Striker,both,Retired,51,19,10,4451,47,21,11,4139,22,9,0,1980,22,2,0,1812,32,9,3,2621,nan,nan,nan,nan,nan,nan,nan,nan,nan,nan,nan,nan,nan,nan,nan,nan,Bundesliga,nan,nan,nan,nan,nan,nan,nan,nan
13/6/2011,Sami Allagui,8186000,51,5/28/1986,25,10,3,0,0,5100,6164,6850,150,137,7036001,186,77,S ,2,2,2,1,3,1,1,7,3,2,3,8,10,13,16,11,9,14,10,4,6,11,10,8,16,12,14,10,14,11,12,13,14,15,8,14,12,11,11,15,15,14,13,10,13,14,20,12,13,11,11,14,6,10,9,14,12,16,11,13,11,7,1,1,1,14,11,14,14,S ,600,1,1,20,14,14,11,1,1,1,1,1,1,1,1,1,5.49756E+11,0,0,0,0,0,0,0,0,0,0,0,0,0,0,0,0,0,0,0,0,0,0,0,0,0,0,0,0,0,0,0,0,0,0,0,0,0,0,0,1,0,0,0,0,0,0,0,0,Sami Allagui,£2.25m ,34,184,Forward - Centre-Forward,right,Retired,30,10,5,1721,23,5,1,1399,26,6,5,1677,31,10,4,2189,20,2,1,809,nan,nan,nan,nan,16,4,1,364,32,5,4,2170,23,4,4,1561,Bundesliga,12,2,1,770,nan,nan,nan,nan
13/6/2011,Salomon Kalou,859510,24,8/5/1985,25,39,12,0,0,7000,8000,7600,165,147,19368782,186,79,AM/S RL,3,2,3,1,1,1,3,2,3,2,1,7,12,13,11,14,9,13,10,4,8,10,16,7,10,7,16,13,11,14,13,8,16,13,8,15,12,11,12,16,17,13,12,12,16,15,20,15,12,7,6,14,5,13,15,17,10,12,14,15,17,12,1,1,10,20,18,20,12,AM/S RL,515,1,1,16,12,20,18,1,1,1,1,1,10,10,1,1,4.43254E+12,0,0,0,1,0,0,0,0,0,0,0,0,0,0,0,0,0,0,0,0,0,0,0,0,0,0,0,1,0,0,0,0,0,0,0,1,0,0,0,0,0,0,1,0,0,0,0,0,Salomon Kalou,£5.40m ,35,184,Forward - Left Winger,right,Botafogo de Futebol e Regatas,42,13,7,2178,26,5,3,1476,37,16,6,2900,40,18,5,3285,31,6,2,2099,37,17,2,2972,31,8,5,2490,36,12,3,2535,33,8,4,2573,Premier League,20,3,0,1074,nan,nan,nan,nan
13/6/2011,Roy O'Donovan,5112229,789,8/10/1985,25,0,0,9,2,1850,4900,4100,102,91,181419,169,64,M/AM/S R,1,1,1,1,1,1,1,1,1,1,1,11,12,10,13,10,9,4,5,2,4,10,14,4,9,6,10,10,13,9,9,8,12,11,4,11,8,10,13,13,10,11,7,8,16,13,20,10,7,14,2,8,6,8,4,10,14,7,10,10,9,10,1,1,19,20,20,1,1,M/AM/S R,532,1,1,18,1,1,20,1,1,1,1,1,1,19,1,1,0,0,0,0,0,0,0,0,0,0,0,0,0,0,0,0,0,0,0,0,0,0,0,0,0,0,0,0,0,0,0,0,0,0,0,0,0,0,0,0,0,0,0,0,0,0,0,0,0,,,,,,,,,,,,,,,,,,,,,,,,,,,,,,,,,,,,,,,,,,,,,,,,,,,,
13/6/2011,Robert Koch,35014703,771,2/26/1986,25,0,0,0,0,3000,5000,5000,103,100,301001,182,78,M/AM/S RL,1,3,2,2,1,3,2,2,2,1,3,11,12,12,13,10,11,6,9,3,4,12,8,4,11,6,10,12,13,9,10,10,10,14,7,11,6,12,11,11,9,9,11,20,12,10,15,11,9,12,5,10,5,18,8,12,14,13,10,15,13,11,1,1,17,20,18,20,1,M/AM/S RL,535,1,1,20,1,20,18,1,1,1,1,1,17,15,1,1,0,0,0,0,0,0,0,0,0,0,0,0,0,0,0,0,0,0,0,0,0,0,0,0,0,0,0,0,0,0,0,0,0,0,0,0,0,0,0,0,0,0,0,0,0,0,0,0,0,Roberto,£4.50m ,34,192,Goalkeeper,right,Real Valladolid CF,41,46,15,3666,40,64,10,3600,33,51,5,2970,40,27,25,3600,41,39,18,3690,36,32,16,3197,6,14,0,517,34,51,6,3060,6,9,1,570,LaLiga,19,40,3,1655,6,10,0,540
13/6/2011,Riccardo Meggiorini,7988419,776,9/4/1985,25,0,0,0,0,2500,6150,6150,130,126,1769472,183,75,S ,1,1,1,1,1,1,1,1,1,1,1,2,12,12,14,11,7,12,11,2,5,12,15,5,12,11,11,12,12,12,9,10,12,10,7,14,8,12,11,14,15,12,13,20,16,14,10,13,12,15,12,14,7,10,12,11,14,5,13,15,6,8,1,1,1,1,1,1,1,S ,600,1,1,20,1,1,1,1,1,1,1,1,1,1,1,1,0,0,0,0,0,0,0,0,0,0,0,0,0,0,0,0,0,0,0,0,0,0,0,0,0,0,0,0,0,0,0,0,0,0,0,0,0,0,0,0,0,0,0,0,0,0,0,0,0,Riccardo Meggiorini,£2.07m ,35,182,Forward - Second Striker,left,LR Vicenza Virtus,32,3,3,1712,34,9,0,2004,33,3,3,1656,34,0,4,940,30,4,2,1934,26,5,7,1652,29,4,0,1826,15,0,0,788,25,3,0,1555,Serie A,28,9,4,2049,1,0,0,63
13/6/2011,Ramon Núńez,980475,376,11/14/1985,25,44,5,9,1,3000,5500,5500,125,110,441897,171,72,AM RLC,2,2,2,3,1,1,1,1,2,2,1,12,11,14,11,13,13,8,12,2,8,11,6,9,12,7,10,8,12,12,13,11,10,13,7,12,8,8,12,13,13,10,4,12,13,13,20,12,9,12,5,10,11,12,12,13,12,10,10,11,13,10,1,1,9,20,15,15,20,AM RLC,506,1,1,15,20,15,15,1,1,1,1,9,1,1,1,1,5.49756E+11,0,0,0,0,0,1,0,1,0,0,0,1,0,0,0,0,0,0,0,0,0,0,0,0,0,0,0,0,0,0,0,0,0,0,0,0,0,0,0,1,0,0,0,0,0,0,0,0,,,,,,,,,,,,,,,,,,,,,,,,,,,,,,,,,,,,,,,,,,,,,,,,,,,,
13/6/2011,Mustapha Yatabaré,8442121,31,1/26/1986,25,9,3,0,0,4100,5700,5100,125,114,2596615,182,70,S ,3,1,3,3,1,2,3,4,1,2,2,4,7,10,11,11,7,14,11,5,3,8,12,3,11,12,14,13,12,11,7,10,14,11,6,14,7,9,13,15,12,14,11,8,12,14,20,14,14,13,12,16,8,7,8,16,8,9,12,10,10,12,1,1,10,14,14,12,1,S ,600,1,1,20,1,12,14,1,1,1,1,1,10,10,1,1,0,0,0,0,0,0,0,0,0,0,0,0,0,0,0,0,0,0,0,0,0,0,0,0,0,0,0,0,0,0,0,0,0,0,0,0,0,0,0,0,0,0,0,0,0,0,0,0,0,,,,,,,,,,,,,,,,,,,,,,,,,,,,,,,,,,,,,,,,,,,,,,,,,,,,
13/6/2011,Moussa Sow,8431730,41,1/19/1986,25,11,3,0,0,5950,7350,6600,155,147,8623791,180,76,S ,3,2,3,2,3,2,3,3,3,3,2,6,10,13,16,12,9,13,12,5,4,10,13,3,13,10,16,12,15,13,9,13,16,12,6,16,7,9,13,16,15,14,11,12,15,15,20,15,14,15,10,13,6,8,9,16,11,14,12,12,11,12,1,1,10,14,14,14,1,S ,600,1,1,20,1,14,14,1,1,1,1,1,10,10,1,1,8389128,0,0,0,1,0,0,0,0,0,1,0,0,0,0,0,0,0,0,0,0,0,0,0,1,0,0,0,0,0,0,0,0,0,0,0,0,0,0,0,0,0,0,0,0,0,0,0,0,Moussa Sow,£10.80m ,34,180,Forward - Centre-Forward,right,Ümraniyespor,51,26,7,3443,39,18,6,2997,54,19,10,4078,35,16,8,2897,40,16,8,2954,29,14,2,2353,37,15,3,2447,20,5,0,1287,15,4,1,638,Ligue 1,nan,nan,nan,nan,1,0,0,2
13/6/2011,Mohammed Abdellaoue,760798,786,10/23/1985,25,14,2,1,0,6000,7150,7150,146,144,14790374,184,82,S ,2,3,1,2,1,1,3,3,3,1,3,6,9,11,14,14,8,9,12,5,4,11,14,8,15,12,16,10,17,15,10,16,14,9,6,17,9,13,15,17,16,12,10,20,13,15,9,13,9,13,5,12,8,8,14,14,18,10,16,15,13,5,1,1,1,14,10,14,10,S ,600,1,1,20,10,14,10,1,1,1,1,1,1,1,1,1,1.76094E+13,0,0,0,0,1,0,0,0,0,0,1,0,1,0,0,0,0,0,0,0,0,0,0,0,0,0,0,0,0,0,0,0,0,0,1,0,0,0,0,0,0,0,0,0,1,0,0,0,Mohammed Abdellaoue,£6.75m ,35,182,Forward - Centre-Forward,left,Retired,26,10,1,2097,42,16,6,2996,35,9,3,1490,18,1,1,828,8,1,1,547,19,6,3,1432,14,2,0,901,nan,nan,nan,nan,nan,nan,nan,nan,Bundesliga,nan,nan,nan,nan,nan,nan,nan,nan
13/6/2011,Miku,1502910,1658,8/19/1985,25,31,9,0,0,4750,6250,6500,139,132,3349721,182,70,S ,2,1,2,2,2,2,1,5,3,1,1,10,12,14,15,12,11,11,12,10,8,12,14,8,13,13,12,11,12,11,11,11,12,14,11,14,8,12,12,13,13,13,12,13,15,14,20,14,13,9,13,10,6,15,14,13,9,10,11,7,7,15,1,1,7,13,10,5,13,S ,600,1,1,20,13,5,10,1,1,1,1,1,1,7,1,1,512,0,0,0,0,0,0,0,0,0,1,0,0,0,0,0,0,0,0,0,0,0,0,0,0,0,0,0,0,0,0,0,0,0,0,0,0,0,0,0,0,0,0,0,0,0,0,0,0,Mika,£1.35m ,29,195,Goalkeeper,left,Académica Coimbra,4,8,1,390,0,0,0,0,30,43,5,2700,16,36,14,1440,31,39,10,2769,29,26,12,2640,7,6,4,630,4,9,0,360,7,15,1,660,Liga NOS,22,21,7,1980,7,3,4,630
13/6/2011,Michel Simplício,2108457,1651,3/26/1986,25,0,0,0,0,1000,5250,5250,125,105,87675,180,75,AM/S RL,3,1,3,1,2,3,2,4,1,1,1,8,10,12,9,12,8,10,8,7,8,10,8,12,13,14,11,9,9,10,12,8,12,12,12,10,8,7,12,13,13,9,9,10,15,14,20,13,9,10,5,10,13,9,8,11,15,5,10,3,11,13,1,8,9,20,20,20,13,AM/S RL,515,1,1,18,13,20,20,1,1,1,1,1,9,6,1,8,0,0,0,0,0,0,0,0,0,0,0,0,0,0,0,0,0,0,0,0,0,0,0,0,0,0,0,0,0,0,0,0,0,0,0,0,0,0,0,0,0,0,0,0,0,0,0,0,0,,,,,,,,,,,,,,,,,,,,,,,,,,,,,,,,,,,,,,,,,,,,,,,,,,,,
13/6/2011,Maurice Dalé,34011781,769,7/12/1985,25,0,0,0,0,4100,5150,5150,120,114,1024468,187,80,S ,2,1,2,3,1,2,2,7,3,3,2,4,7,12,12,10,11,16,11,5,5,8,14,4,12,8,13,11,10,11,8,10,13,11,8,13,7,9,12,14,11,16,13,10,12,11,20,13,16,12,8,14,7,7,7,14,12,12,11,15,15,5,1,1,1,12,12,1,1,S ,600,1,1,20,1,1,12,1,1,1,1,1,1,1,1,1,16,0,0,0,0,1,0,0,0,0,0,0,0,0,0,0,0,0,0,0,0,0,0,0,0,0,0,0,0,0,0,0,0,0,0,0,0,0,0,0,0,0,0,0,0,0,0,0,0,,,,,,,,,,,,,,,,,,,,,,,,,,,,,,,,,,,,,,,,,,,,,,,,,,,,
13/6/2011,Matty Fryatt,5113662,765,3/5/1986,25,0,0,0,0,2900,6000,6000,133,121,4140000,178,70,S ,1,3,3,2,2,3,3,4,3,3,2,7,10,13,14,15,10,12,10,4,6,11,16,7,14,9,15,9,13,12,13,11,10,13,8,16,9,11,14,10,14,15,11,11,9,11,20,13,11,11,7,14,7,8,13,17,10,12,12,13,15,8,1,1,1,1,1,1,1,S ,600,1,1,20,1,1,1,1,1,1,1,1,1,1,1,1,1024,0,0,0,0,0,0,0,0,0,0,1,0,0,0,0,0,0,0,0,0,0,0,0,0,0,0,0,0,0,0,0,0,0,0,0,0,0,0,0,0,0,0,0,0,0,0,0,0,,,,,,,,,,,,,,,,,,,,,,,,,,,,,,,,,,,,,,,,,,,,,,,,,,,,
13/6/2011,Mário Rondon,55004729,1658,3/26/1986,25,1,0,0,0,2500,6000,6000,130,120,5468726,178,76,S ,1,2,2,1,2,1,1,8,1,3,1,11,11,12,15,12,11,12,12,8,8,11,13,9,12,10,15,12,12,11,11,11,10,11,10,13,10,10,13,13,13,13,13,8,12,13,20,12,12,10,7,12,8,11,12,14,9,12,12,11,11,9,1,1,1,12,12,5,5,S ,600,1,1,20,5,5,12,1,1,1,1,1,1,1,1,1,0,0,0,0,0,0,0,0,0,0,0,0,0,0,0,0,0,0,0,0,0,0,0,0,0,0,0,0,0,0,0,0,0,0,0,0,0,0,0,0,0,0,0,0,0,0,0,0,0,Mario Rondón,£1.71m ,34,182,Forward - Centre-Forward,right,CFR Cluj,34,13,4,2545,40,12,2,3113,30,4,7,2429,32,12,0,2332,60,14,14,5056,1,0,0,90,nan,nan,nan,nan,28,13,3,2485,18,10,4,1396,Liga NOS,37,5,4,2213,11,3,2,825
13/6/2011,Mario Mandzukic,661804,761,5/21/1986,25,19,3,9,1,6250,7500,7050,148,141,34646981,186,76,S ,3,1,2,3,2,1,3,6,1,1,3,6,10,12,11,14,5,15,10,6,7,13,12,10,15,17,12,16,10,14,14,9,17,14,10,12,9,10,18,13,14,16,14,13,18,16,20,18,13,10,9,18,7,13,13,17,8,12,10,3,9,10,1,1,10,14,12,12,14,S ,600,1,1,20,14,12,12,1,1,1,1,1,9,10,1,1,2.2518E+15,0,0,0,0,0,0,0,0,0,0,0,0,0,0,0,0,1,1,0,0,0,1,0,0,0,0,0,0,0,0,1,0,0,0,0,0,0,0,0,0,0,0,0,0,0,0,0,0,Mario Mandzukic,£12.60m ,34,190,Forward - Centre-Forward,right,Without Club,28,10,3,1746,33,12,10,2800,40,22,4,2857,48,26,10,3314,43,20,5,3078,36,13,3,2678,50,11,6,3879,43,10,3,3208,33,10,5,2599,Bundesliga,7,1,0,572,nan,nan,nan,nan
13/6/2011,Mario Gómez,893408,771,7/10/1985,25,46,19,6,1,7300,7950,7950,167,161,229999992,189,84,S ,1,3,3,3,3,1,2,10,1,1,2,5,9,11,18,8,7,15,12,5,4,8,13,7,9,13,16,17,14,19,8,10,16,8,11,18,8,7,13,15,10,13,15,17,15,17,20,15,17,13,15,9,12,3,4,17,13,9,14,9,8,6,1,1,1,1,1,1,1,S ,600,1,1,20,1,1,1,1,1,1,1,1,1,1,1,1,2.19902E+13,0,0,0,0,1,0,0,0,0,1,0,0,0,1,0,0,0,0,0,0,0,0,0,0,0,0,0,0,0,0,0,0,0,0,0,0,0,0,0,0,0,0,1,0,1,0,0,0,Mario Gómez,£37.80m ,35,189,Forward - Centre-Forward,right,Retired,45,39,7,3364,52,41,7,4032,32,19,4,1213,15,4,2,889,32,10,4,2342,41,28,6,3328,37,18,1,3153,31,9,5,2491,34,8,2,2392,Bundesliga,24,7,1,1324,nan,nan,nan,nan
13/6/2011,Marco Sailer,8718080,771,11/16/1985,25,0,0,0,0,3250,4900,4900,117,98,115790,171,73,S ,2,3,3,2,2,3,1,1,3,1,3,6,8,9,11,10,8,13,9,8,7,8,13,10,10,15,12,16,9,11,7,11,13,7,10,11,9,18,16,12,13,13,8,9,18,12,20,14,14,8,9,10,5,5,5,10,9,10,10,10,14,10,1,1,1,1,1,1,1,S ,600,1,1,20,1,1,1,1,1,1,1,1,1,1,1,1,0,0,0,0,0,0,0,0,0,0,0,0,0,0,0,0,0,0,0,0,0,0,0,0,0,0,0,0,0,0,0,0,0,0,0,0,0,0,0,0,0,0,0,0,0,0,0,0,0,Marco Knaller,£135Th. ,33,192,Goalkeeper,right,FC Wacker Innsbruck,27,31,5,2430,19,26,6,1647,4,4,1,360,2,1,1,180,5,9,0,450,35,50,11,3210,35,42,12,3180,3,11,0,270,11,21,1,990,Bundesliga,8,7,3,676,8,9,4,720
13/6/2011,Mamadou Samassa,8431807,31,5/1/1986,25,3,1,0,0,5550,6200,5550,135,124,7451225,188,84,S ,2,2,1,2,2,1,1,4,3,3,1,5,8,12,12,13,10,14,13,5,6,10,14,4,12,12,13,11,11,14,8,10,11,11,7,13,9,14,14,15,13,15,13,8,12,12,20,15,15,13,10,14,12,8,6,14,13,11,13,14,13,7,1,1,1,1,1,1,1,S ,600,1,1,20,1,1,1,1,1,1,1,1,1,1,1,1,262656,0,0,0,0,0,0,0,0,0,1,0,0,0,0,0,0,0,0,1,0,0,0,0,0,0,0,0,0,0,0,0,0,0,0,0,0,0,0,0,0,0,0,0,0,0,0,0,0,Mamadou Samassa,£1.35m ,34,188,Forward - Centre-Forward,right,Without Club,22,3,1,1171,32,5,0,1103,12,1,1,514,3,0,0,41,10,2,1,681,1,0,0,23,14,4,2,1188,13,6,1,898,17,3,3,1214,Ligue 1,1,0,0,70,nan,nan,nan,nan
13/6/2011,Luke Moore,5110360,765,2/13/1986,25,0,0,5,0,3850,5500,5500,127,115,862500,180,76,S ,2,1,3,2,2,1,1,4,3,2,1,4,10,13,13,13,4,11,9,2,4,10,10,8,13,7,12,6,11,9,10,8,12,11,3,13,7,8,10,14,12,12,10,12,14,14,20,11,13,4,7,8,7,8,12,11,11,10,7,13,14,12,1,1,1,12,12,8,1,S ,600,1,1,20,1,8,12,1,1,1,1,1,1,1,1,1,8192,0,0,0,0,0,0,0,0,0,0,0,0,0,1,0,0,0,0,0,0,0,0,0,0,0,0,0,0,0,0,0,0,0,0,0,0,0,0,0,0,0,0,0,0,0,0,0,0,Luke Moore,£900Th. ,34,180,Forward - Centre-Forward,nan,Retired,34,7,6,2042,24,5,1,866,19,5,3,727,54,8,4,3309,17,1,3,720,nan,nan,nan,nan,nan,nan,nan,nan,nan,nan,nan,nan,nan,nan,nan,nan,Premier League,nan,nan,nan,nan,nan,nan,nan,nan
13/6/2011,Ladislas Douniama,8443048,49,5/24/1986,25,6,1,0,0,1300,5250,2600,120,105,56568,163,62,S ,3,1,1,1,2,1,2,6,3,3,2,6,10,13,12,11,8,7,14,5,4,8,13,4,13,6,12,8,12,12,9,10,14,13,6,14,6,8,12,14,15,9,1,5,13,17,20,13,6,14,6,14,8,6,13,13,12,14,14,18,18,6,1,1,1,14,14,14,1,S ,600,1,1,20,1,14,14,1,1,1,1,1,1,1,1,1,16,0,0,0,0,1,0,0,0,0,0,0,0,0,0,0,0,0,0,0,0,0,0,0,0,0,0,0,0,0,0,0,0,0,0,0,0,0,0,0,0,0,0,0,0,0,0,0,0,Ladislas Douniama,£450Th. ,34,164,Forward - Second Striker,right,Jeanne d'Arc de Drancy,23,4,5,1035,24,2,1,1405,37,10,7,2047,20,1,2,834,12,1,0,214,21,4,1,1088,14,3,0,742,5,3,1,501,nan,nan,nan,nan,Ligue 1,nan,nan,nan,nan,nan,nan,nan,nan
13/6/2011,Kingsley Onuegbu,92011957,38,3/5/1986,25,0,0,0,0,1800,5354,5700,127,119,1326068,191,94,S ,2,1,3,1,2,2,1,2,2,3,2,3,7,11,12,12,5,11,5,5,2,10,11,5,11,13,14,14,17,9,12,11,12,13,7,14,5,12,9,10,8,15,16,12,13,14,20,8,17,8,8,7,13,10,13,9,11,13,11,14,15,6,1,1,1,1,1,1,1,S ,600,1,1,20,1,1,1,1,1,1,1,1,1,1,1,1,1.75922E+13,0,0,0,0,0,0,0,0,0,0,0,0,1,0,0,0,0,0,1,0,0,0,0,0,0,0,0,0,0,0,0,0,0,0,0,0,0,0,0,0,0,0,0,0,1,0,0,0,,,,,,,,,,,,,,,,,,,,,,,,,,,,,,,,,,,,,,,,,,,,,,,,,,,,
13/6/2011,Kike Sola,67013748,796,2/25/1986,25,0,0,0,0,4600,6600,6600,143,135,5725984,184,80,S ,1,1,1,1,3,2,3,5,3,2,3,10,10,12,17,12,10,14,12,8,9,12,14,9,12,12,11,15,13,12,12,12,12,14,11,15,11,14,14,12,12,15,13,10,14,13,20,15,15,14,7,14,9,10,6,10,15,6,10,14,10,5,1,1,1,10,5,5,10,S ,600,1,1,20,10,5,5,1,1,1,1,1,1,1,1,1,0,0,0,0,0,0,0,0,0,0,0,0,0,0,0,0,0,0,0,0,0,0,0,0,0,0,0,0,0,0,0,0,0,0,0,0,0,0,0,0,0,0,0,0,0,0,0,0,0,Kike Sola,£1.62m ,34,184,Forward - Centre-Forward,right,Retired,18,7,2,1124,7,0,1,508,31,9,2,2061,9,1,2,418,6,0,0,129,13,4,0,483,17,0,0,493,1,0,0,62,nan,nan,nan,nan,LaLiga,nan,nan,nan,nan,nan,nan,nan,nan
13/6/2011,Julien Toudic,8440054,769,12/19/1985,25,0,0,0,0,4250,5300,5300,135,118,1430100,172,68,S ,3,2,2,3,2,3,3,4,2,2,3,7,9,13,12,12,9,7,13,5,2,11,11,3,13,11,13,11,13,13,11,11,14,14,6,15,7,11,13,16,14,11,6,8,13,15,20,13,8,13,7,13,7,7,18,12,15,13,13,15,15,7,1,1,1,14,10,14,1,S ,600,1,1,20,1,14,10,1,1,1,1,1,1,1,1,1,4.41523E+12,0,0,0,0,1,0,0,0,0,0,0,0,0,0,0,0,0,0,0,0,0,0,0,0,0,0,0,0,0,0,0,0,0,0,1,0,0,0,0,0,0,0,1,0,0,0,0,0,,,,,,,,,,,,,,,,,,,,,,,,,,,,,,,,,,,,,,,,,,,,,,,,,,,,
13/6/2011,Juanjo,1507841,796,10/20/1985,25,0,0,0,0,3750,5700,5700,124,109,1925505,185,76,S ,3,1,2,1,2,2,1,2,3,3,2,7,7,11,11,11,6,15,9,11,7,12,11,8,11,7,11,11,12,12,8,10,8,9,6,12,7,12,14,12,9,11,13,12,14,11,20,15,12,12,5,10,6,4,13,12,13,6,16,15,14,8,1,1,1,1,1,1,1,S ,600,1,1,20,1,1,1,1,1,1,1,1,1,1,1,1,262144,0,0,0,0,0,0,0,0,0,0,0,0,0,0,0,0,0,0,1,0,0,0,0,0,0,0,0,0,0,0,0,0,0,0,0,0,0,0,0,0,0,0,0,0,0,0,0,0,Juan,£1.80m ,41,182,Defender - Centre-Back,right,Retired,37,2,2,3165,22,4,2,1619,32,4,0,2835,21,0,1,1783,18,1,1,1517,12,0,1,908,23,2,1,1961,9,0,0,765,1,0,0,0,Serie A,nan,nan,nan,nan,nan,nan,nan,nan
13/6/2011,Jonathan Soriano,7440266,796,9/24/1985,25,0,0,4,0,4250,6500,6500,135,130,2134309,180,75,S ,1,3,3,2,1,2,1,8,3,1,1,8,11,12,14,12,9,12,11,6,6,12,14,8,13,9,13,13,13,12,12,12,12,14,11,15,7,14,12,15,14,9,11,10,12,14,20,14,11,13,7,12,12,9,9,12,15,9,15,10,12,2,1,1,1,14,9,5,14,S ,600,1,1,20,14,5,9,1,1,1,1,1,1,1,1,1,0,0,0,0,0,0,0,0,0,0,0,0,0,0,0,0,0,0,0,0,0,0,0,0,0,0,0,0,0,0,0,0,0,0,0,0,0,0,0,0,0,0,0,0,0,0,0,0,0,Jonathan Tinhan,£360Th. ,31,177,Forward - Centre-Forward,right,Retired,21,4,1,1115,5,1,0,111,19,2,2,862,4,0,0,122,29,3,1,2035,33,12,1,2476,34,8,2,1659,9,0,0,276,22,2,1,707,Ligue 1,24,1,3,1372,nan,nan,nan,nan
13/6/2011,Jonathan Ayité,34011235,50,7/21/1985,25,2,1,0,0,3500,5900,3900,135,118,1972554,184,75,S ,2,2,3,2,3,1,3,7,2,3,2,5,6,12,13,14,8,14,11,5,5,9,15,2,14,11,14,12,12,12,8,11,14,12,6,13,5,10,11,13,12,14,13,8,14,12,20,14,14,13,11,14,7,5,9,14,12,12,11,13,13,9,1,1,1,1,1,1,1,S ,600,1,1,20,1,1,1,1,1,1,1,1,1,1,1,1,262144,0,0,0,0,0,0,0,0,0,0,0,0,0,0,0,0,0,0,1,0,0,0,0,0,0,0,0,0,0,0,0,0,0,0,0,0,0,0,0,0,0,0,0,0,0,0,0,0,Jonathan Ayité,£810Th. ,35,184,Forward - Centre-Forward,right,Unknown,37,12,3,2737,6,0,0,263,24,3,0,1086,24,9,1,1467,33,20,6,2876,32,13,4,2758,19,4,4,892,26,3,2,1618,19,5,1,1057,Ligue 1,21,5,1,1383,nan,nan,nan,nan
13/6/2011,Johannes Rahn,8718118,771,1/16/1986,25,0,0,0,0,3350,4700,4700,100,94,725469,190,84,AM/S RL,3,3,2,1,3,2,3,4,1,1,1,9,11,12,12,9,9,14,10,5,6,11,12,6,10,8,11,10,11,9,10,10,10,8,9,11,7,11,11,10,9,15,15,4,12,11,20,15,14,12,5,11,5,15,6,11,13,13,10,15,17,15,1,1,14,19,19,17,14,AM/S RL,625,1,1,20,14,17,19,1,1,1,1,1,14,14,1,1,0,0,0,0,0,0,0,0,0,0,0,0,0,0,0,0,0,0,0,0,0,0,0,0,0,0,0,0,0,0,0,0,0,0,0,0,0,0,0,0,0,0,0,0,0,0,0,0,0,,,,,,,,,,,,,,,,,,,,,,,,,,,,,,,,,,,,,,,,,,,,,,,,,,,,
13/6/2011,Jimmy Briand,3504311,769,8/2/1985,25,4,0,22,9,6500,6659,6650,160,148,15485595,181,84,AM/S R,3,1,1,3,2,3,3,1,3,1,3,7,12,14,11,13,8,12,11,5,6,12,13,4,14,9,14,13,9,13,13,12,17,14,7,16,9,14,16,17,14,15,11,8,14,16,20,15,15,14,9,13,7,8,12,16,13,14,13,15,15,10,1,1,12,20,20,1,1,AM/S R,512,1,1,18,1,1,20,1,1,1,1,1,1,12,1,1,18,0,1,0,0,1,0,0,0,0,0,0,0,0,0,0,0,0,0,0,0,0,0,0,0,0,0,0,0,0,0,0,0,0,0,0,0,0,0,0,0,0,0,0,0,0,0,0,0,Jimmy Briand,£6.30m ,35,183,Forward - Centre-Forward,right,FC Girondins Bordeaux,44,8,7,2874,56,14,8,3904,20,3,1,1057,40,9,7,2239,30,3,8,2155,39,8,7,3218,39,13,6,3232,40,11,2,3337,46,11,4,3258,Ligue 1,26,8,1,1774,8,1,2,206
13/6/2011,Ilian Micanski,7503181,760,12/20/1985,25,1,0,8,0,2250,6000,6000,140,120,3116968,186,77,S ,1,3,1,1,1,3,3,6,1,1,3,3,9,13,14,13,5,13,10,2,7,13,9,7,13,9,12,10,13,12,11,12,11,11,9,13,10,14,14,14,12,14,13,6,13,13,20,11,13,11,6,11,5,11,14,11,14,12,14,14,11,6,1,1,1,13,13,1,1,S ,600,1,1,20,1,1,13,1,1,1,1,1,1,1,1,1,0,0,0,0,0,0,0,0,0,0,0,0,0,0,0,0,0,0,0,0,0,0,0,0,0,0,0,0,0,0,0,0,0,0,0,0,0,0,0,0,0,0,0,0,0,0,0,0,0,Iliyan Mitsanski,£810Th. ,34,186,Forward - Centre-Forward,right,Without Club,17,3,0,822,15,9,5,1217,13,1,2,639,20,4,1,725,41,6,5,2015,nan,nan,nan,nan,17,4,2,813,nan,nan,nan,nan,17,4,2,761,Bundesliga,3,1,0,131,nan,nan,nan,nan
13/6/2011,Hugo Rodallega,8835582,1653,7/25/1985,25,40,8,22,18,5750,7700,7000,155,140,15479911,181,72,AM/S RL,2,1,2,2,1,2,1,3,1,1,3,14,7,13,13,11,12,14,11,6,4,12,15,6,13,12,13,12,13,13,15,11,12,12,13,14,6,11,14,14,13,13,12,12,14,14,20,14,13,11,7,13,10,12,12,18,9,13,14,16,13,12,1,1,1,17,17,17,2,AM/S RL,625,1,1,20,2,17,17,1,1,1,1,1,1,1,1,1,524864,0,0,0,0,0,0,1,0,0,1,0,0,0,0,0,0,0,0,0,1,0,0,0,0,0,0,0,0,0,0,0,0,0,0,0,0,0,0,0,0,0,0,0,0,0,0,0,0,Hugo Rodallega,£4.05m ,35,181,Forward - Centre-Forward,right,Denizlispor,37,9,2,3094,24,2,7,1337,33,3,3,1783,17,6,2,853,38,11,9,2834,37,21,1,3199,32,10,3,2443,28,13,1,936,37,16,3,2909,Premier League,32,6,1,2762,5,1,0,432
13/6/2011,Henry Giménez,78002298,1657,3/13/1986,25,2,0,0,0,2750,6000,6650,140,131,4174165,176,69,AM/S RLC,2,1,1,3,1,1,3,3,1,3,2,13,13,14,11,12,11,11,11,11,8,12,14,8,16,12,11,9,11,8,12,13,14,15,12,14,8,10,12,15,15,8,8,20,15,13,12,14,10,12,13,11,8,12,12,8,10,12,15,14,13,6,1,1,1,18,15,15,18,AM/S RLC,626,1,1,20,18,15,15,1,1,1,1,1,1,1,1,1,5.49756E+11,0,0,0,0,0,0,0,0,0,0,0,0,0,0,0,0,0,0,0,0,0,0,0,0,0,0,0,0,0,0,0,0,0,0,0,0,0,0,0,1,0,0,0,0,0,0,0,0,Henry Giménez,£720Th. ,34,176,Forward - Centre-Forward,left,Rivera Hinterland,29,4,1,1104,18,1,3,600,17,1,2,1221,7,1,0,337,21,2,2,1346,5,0,0,186,24,2,2,1588,20,3,1,1447,14,0,0,893,Serie A,nan,nan,nan,nan,nan,nan,nan,nan
13/6/2011,Halil Savran,92012917,771,6/20/1985,25,0,0,0,0,3850,5100,5100,105,102,227951,183,82,S ,2,3,1,2,1,3,3,1,2,1,1,7,8,11,14,14,10,14,6,6,8,8,9,3,12,4,12,9,12,14,6,9,8,9,14,14,12,8,12,12,11,11,11,16,10,9,20,9,8,10,8,8,6,10,3,16,11,17,13,9,18,13,1,1,1,1,1,1,1,S ,600,1,1,20,1,1,1,1,1,1,1,1,1,1,1,1,0,0,0,0,0,0,0,0,0,0,0,0,0,0,0,0,0,0,0,0,0,0,0,0,0,0,0,0,0,0,0,0,0,0,0,0,0,0,0,0,0,0,0,0,0,0,0,0,0,,,,,,,,,,,,,,,,,,,,,,,,,,,,,,,,,,,,,,,,,,,,,,,,,,,,
13/6/2011,Grégory Bettiol,8428565,769,3/30/1986,25,0,0,0,0,3350,5050,5050,120,113,1630659,180,79,AM/S L,2,2,2,2,2,2,2,6,2,1,2,5,7,11,10,12,12,13,13,5,4,11,13,3,11,10,12,14,12,12,9,11,13,8,7,13,8,12,13,12,11,14,11,10,10,14,20,13,14,12,9,14,11,6,11,12,13,13,14,14,14,6,1,1,1,16,1,16,12,AM/S L,623,1,1,20,12,16,1,1,1,1,1,1,1,1,1,1,16,0,0,0,0,1,0,0,0,0,0,0,0,0,0,0,0,0,0,0,0,0,0,0,0,0,0,0,0,0,0,0,0,0,0,0,0,0,0,0,0,0,0,0,0,0,0,0,0,Grégory Sertic,£1.13m ,31,183,Midfielder - Defensive Midfield,right,Without Club,24,0,2,1099,22,0,1,1008,44,1,5,3112,37,3,11,3061,30,1,1,2341,3,0,0,141,28,1,1,2319,13,0,0,716,17,0,0,1103,Ligue 1,nan,nan,nan,nan,nan,nan,nan,nan
13/6/2011,Graziano Pellč,7980410,776,7/15/1985,25,0,0,16,4,4500,5950,5950,126,119,3038249,193,86,S ,1,1,1,1,1,1,1,1,1,1,1,2,6,10,9,13,8,16,12,5,5,12,12,6,14,7,8,13,13,13,13,10,11,6,7,13,3,12,8,12,15,17,14,10,10,12,20,13,17,13,6,12,9,4,3,18,12,10,12,6,12,12,1,1,1,1,1,1,1,S ,600,1,1,20,1,1,1,1,1,1,1,1,1,1,1,1,262208,0,0,0,0,0,0,1,0,0,0,0,0,0,0,0,0,0,0,1,0,0,0,0,0,0,0,0,0,0,0,0,0,0,0,0,0,0,0,0,0,0,0,0,0,0,0,0,0,Graziano Pellè,£900Th. ,35,194,Forward - Centre-Forward,right,Shandong Luneng Taishan,20,6,1,891,29,6,1,1421,34,29,9,3000,33,26,6,2984,44,16,3,3727,51,19,9,3955,26,7,5,2340,32,16,11,2815,38,27,4,3216,Serie A,15,7,1,909,nan,nan,nan,nan
13/6/2011,Gili Vermut,7861328,775,8/5/1985,25,14,0,12,1,4500,7150,7150,142,133,1923925,175,68,AM/S RLC,2,2,2,2,1,3,1,5,3,3,3,12,14,16,12,12,6,4,6,1,8,16,10,5,17,7,15,7,12,12,18,14,14,13,11,14,8,12,13,12,14,10,8,12,10,13,20,12,8,12,3,13,3,14,8,14,14,14,17,19,13,4,1,1,13,20,20,15,15,AM/S RLC,516,1,1,16,15,15,20,1,1,1,1,8,13,13,1,1,7.09529E+13,0,0,0,0,0,0,0,0,0,0,0,0,0,0,0,0,0,0,0,1,0,0,0,0,1,0,0,0,0,0,0,0,0,0,0,1,0,0,0,1,0,0,0,0,0,0,1,0,Gil Vermouth,£1.35m ,35,173,Midfielder - Right Midfield,right,Without Club,46,5,0,3860,20,2,4,1456,14,1,5,1060,38,8,0,2974,24,3,1,2002,39,2,3,2211,36,7,3,2783,31,1,4,1911,32,2,7,2011,Bundesliga,23,0,2,792,nan,nan,nan,nan
13/6/2011,Ghislain Gimbert,8427420,769,8/7/1985,25,0,0,0,0,2550,3850,3850,125,116,483839,183,75,S ,2,2,3,2,1,3,1,4,2,3,2,5,9,11,11,12,6,14,11,5,5,11,13,6,12,13,13,15,11,11,9,12,16,11,9,15,9,14,17,14,11,14,11,8,16,11,20,15,14,13,13,14,7,8,13,13,12,14,14,13,13,7,1,1,1,10,10,10,1,S ,600,1,1,20,1,10,10,1,1,1,1,1,1,1,1,1,262144,0,0,0,0,0,0,0,0,0,0,0,0,0,0,0,0,0,0,1,0,0,0,0,0,0,0,0,0,0,0,0,0,0,0,0,0,0,0,0,0,0,0,0,0,0,0,0,0,,,,,,,,,,,,,,,,,,,,,,,,,,,,,,,,,,,,,,,,,,,,,,,,,,,,
13/6/2011,Garra Dembelé,8428376,31,2/21/1986,25,1,0,0,0,5500,6650,6500,147,140,4536876,187,75,S ,3,1,2,1,3,2,2,4,1,1,2,4,8,11,15,10,6,13,12,4,4,11,14,12,11,19,11,17,15,12,10,12,18,12,11,13,10,12,16,16,11,15,14,15,15,14,20,14,15,18,11,14,8,11,11,10,12,9,5,5,6,17,1,1,12,14,14,10,7,S ,600,1,1,20,7,10,14,1,1,1,1,3,5,12,1,1,2.3366E+12,0,0,0,0,0,0,0,0,0,1,0,0,0,0,0,0,0,0,0,0,0,0,0,0,0,0,0,1,0,0,0,0,0,0,0,0,0,1,0,0,0,1,0,0,0,0,0,0,,,,,,,,,,,,,,,,,,,,,,,,,,,,,,,,,,,,,,,,,,,,,,,,,,,,
13/6/2011,Franck Dja Djédjé,8430845,24,6/2/1986,25,0,0,2,0,4250,5309,5300,130,118,2801114,176,70,AM/S R,3,1,2,3,1,1,3,4,1,2,2,7,10,12,10,12,7,13,14,6,5,10,11,3,14,9,12,8,11,12,10,8,8,12,5,14,6,7,10,13,13,13,9,8,11,17,20,13,11,11,9,13,7,10,10,14,12,9,14,12,12,7,5,5,10,16,16,10,13,AM/S R,622,1,1,20,13,10,16,1,1,5,1,1,10,10,1,5,16,0,0,0,0,1,0,0,0,0,0,0,0,0,0,0,0,0,0,0,0,0,0,0,0,0,0,0,0,0,0,0,0,0,0,0,0,0,0,0,0,0,0,0,0,0,0,0,0,Franck Dja Djédjé,£1.35m ,34,175,Forward - Right Winger,both,AS Cannes,34,4,1,2478,37,5,4,2231,30,4,4,2028,57,15,3,4272,21,3,2,936,nan,nan,nan,nan,26,3,4,1347,19,2,0,711,nan,nan,nan,nan,Ligue 1,nan,nan,nan,nan,nan,nan,nan,nan
13/6/2011,Francesco Volpe,7987866,776,3/3/1986,25,0,0,0,0,250,5050,4900,112,91,108838,180,71,AM/S RL,1,1,1,1,1,1,1,1,1,1,1,4,12,10,9,7,6,7,8,4,3,8,9,5,10,6,8,10,8,9,5,8,9,11,11,9,8,10,11,13,11,9,9,7,19,13,20,11,9,11,9,7,3,18,10,16,10,9,9,13,12,13,1,1,9,20,20,20,10,AM/S RL,515,1,1,17,10,20,20,1,1,1,1,1,9,1,1,1,0,0,0,0,0,0,0,0,0,0,0,0,0,0,0,0,0,0,0,0,0,0,0,0,0,0,0,0,0,0,0,0,0,0,0,0,0,0,0,0,0,0,0,0,0,0,0,0,0,Francesco Urso,£68Th. ,26,175,Midfielder - Defensive Midfield,right,US Catanzaro,nan,nan,nan,nan,19,1,0,1392,nan,nan,nan,nan,1,0,0,90,19,2,0,1542,28,0,0,1712,24,1,2,1884,21,1,2,1681,6,0,0,116,Serie A,13,1,2,524,2,0,0,99
13/6/2011,Florian Taulemesse,34000340,769,1/31/1986,25,0,0,0,0,3250,3750,5250,120,108,294127,182,74,S ,2,1,3,3,2,2,3,2,3,1,1,5,6,10,12,10,8,13,12,6,6,11,12,3,10,8,12,12,12,12,7,12,10,11,8,14,9,11,14,11,11,13,11,12,11,11,20,13,12,15,8,10,10,5,13,11,9,6,15,12,9,14,1,1,1,1,1,1,1,S ,600,1,1,20,1,1,1,1,1,1,1,1,1,1,1,1,0,0,0,0,0,0,0,0,0,0,0,0,0,0,0,0,0,0,0,0,0,0,0,0,0,0,0,0,0,0,0,0,0,0,0,0,0,0,0,0,0,0,0,0,0,0,0,0,0,,,,,,,,,,,,,,,,,,,,,,,,,,,,,,,,,,,,,,,,,,,,,,,,,,,,
13/6/2011,Falcao,950975,1653,2/10/1986,25,34,9,11,4,7500,8000,7750,174,167,269956373,177,73,S ,2,2,3,3,2,1,3,6,2,1,2,10,13,14,18,14,11,18,12,4,8,13,14,9,14,14,16,17,17,16,13,17,18,14,14,15,8,9,14,15,15,17,12,12,14,15,20,17,15,15,9,17,13,11,18,16,15,18,17,16,14,11,1,1,1,3,1,1,3,S ,600,1,1,20,3,1,1,1,1,1,1,1,1,1,1,1,0,0,0,0,0,0,0,0,0,0,0,0,0,0,0,0,0,0,0,0,0,0,0,0,0,0,0,0,0,0,0,0,0,0,0,0,0,0,0,0,0,0,0,0,0,0,0,0,0,Falcao,£36.00m ,34,177,Forward - Centre-Forward,right,Galatasaray SK,42,38,7,3317,52,36,6,4289,41,34,3,3528,19,11,1,1499,33,6,5,1686,12,1,0,363,43,30,6,2965,36,24,5,2870,39,16,2,2990,LaLiga,22,11,1,1484,7,5,2,482
13/6/2011,Fabián Orellana,8835313,1652,1/27/1986,25,17,2,0,0,4300,6500,6500,149,133,1780287,170,68,AM/S RL,3,2,2,3,2,3,2,3,2,2,1,13,13,15,10,13,12,5,8,4,4,13,14,5,15,8,10,8,10,11,13,12,14,16,8,16,9,14,12,16,16,8,5,10,14,15,20,11,9,15,14,15,4,7,10,12,13,14,15,13,9,5,1,1,9,20,20,18,14,AM/S RL,515,1,1,20,14,18,20,1,1,1,1,1,1,9,1,1,1.77296E+13,0,0,0,0,1,0,0,0,0,0,0,0,0,1,0,0,0,0,0,0,0,0,0,0,0,0,0,0,0,0,0,0,0,0,0,0,0,1,0,0,0,0,0,0,1,0,0,0,,,,,,,,,,,,,,,,,,,,,,,,,,,,,,,,,,,,,,,,,,,,,,,,,,,,
13/6/2011,Edward Ofere,8119593,38,3/28/1986,25,3,0,0,0,4000,5534,6150,134,123,3445662,190,80,S ,2,2,2,2,3,2,1,2,2,3,2,7,7,10,13,6,8,14,12,5,7,12,11,12,9,14,12,13,14,13,10,12,12,8,5,13,13,14,15,13,4,13,15,9,13,15,20,17,17,8,14,11,8,9,14,11,13,12,13,13,9,2,1,1,1,5,1,1,5,S ,600,1,1,20,5,1,1,1,1,1,1,1,1,1,1,1,0,0,0,0,0,0,0,0,0,0,0,0,0,0,0,0,0,0,0,0,0,0,0,0,0,0,0,0,0,0,0,0,0,0,0,0,0,0,0,0,0,0,0,0,0,0,0,0,0,Edward Ofere,£360Th. ,34,190,Forward - Centre-Forward,right,Without Club,12,3,1,740,8,0,0,200,11,8,2,990,17,2,0,916,13,6,0,916,24,5,4,1222,10,1,0,536,9,4,3,729,nan,nan,nan,nan,Serie A,nan,nan,nan,nan,nan,nan,nan,nan
13/6/2011,Edivaldo,8830335,1650,11/17/1985,25,0,0,0,0,1000,5250,5250,120,106,89677,180,69,AM/S C,1,3,2,3,2,1,3,4,1,1,1,10,11,12,12,11,9,11,10,7,7,11,12,7,12,11,12,11,11,11,10,12,14,12,9,12,8,10,14,12,12,12,12,10,12,12,20,12,12,11,6,10,9,12,10,11,11,11,14,14,14,5,1,1,1,17,14,14,17,AM/S C,621,1,1,20,17,14,14,1,1,1,1,1,1,1,1,1,80,0,0,0,0,1,0,1,0,0,0,0,0,0,0,0,0,0,0,0,0,0,0,0,0,0,0,0,0,0,0,0,0,0,0,0,0,0,0,0,0,0,0,0,0,0,0,0,0,Evaldo,£3.24m ,38,183,Defender - Left-Back,left,SC União Torreense,47,1,2,4008,25,2,0,1565,16,0,1,1299,nan,nan,nan,nan,35,3,1,3035,35,1,2,3165,44,4,2,3852,43,1,5,3900,38,0,3,3450,Liga NOS,1,0,0,90,nan,nan,nan,nan
13/6/2011,Edin Dzeko,8502440,759,3/17/1986,25,34,18,2,1,7250,8965,8400,180,163,74841212,193,84,S ,3,1,3,2,1,3,1,9,3,2,1,6,10,13,16,18,7,17,14,2,4,13,16,4,17,8,16,15,12,11,14,12,13,13,10,14,6,16,9,12,13,17,18,18,12,13,20,13,16,16,8,12,4,5,18,10,14,12,17,10,11,7,1,1,1,1,1,1,1,S ,600,1,1,20,1,1,1,1,1,1,1,1,1,1,1,1,68419584,0,0,0,0,0,0,0,0,0,0,0,0,0,0,0,0,0,0,1,0,1,0,0,0,0,0,1,0,0,0,0,0,0,0,0,0,0,0,0,0,0,0,0,0,0,0,0,0,Edin Dzeko,£26.10m ,34,193,Forward - Centre-Forward,right,AS Roma,40,17,6,3004,43,19,9,2396,45,15,7,2505,48,26,16,3241,32,6,4,1556,39,10,4,2555,51,39,15,4038,49,24,7,4112,40,14,10,3169,Premier League,43,19,14,3539,4,2,1,295
13/6/2011,Douglas,19012918,1651,1/30/1986,25,0,0,0,0,2500,5100,5500,125,114,933021,186,82,S ,3,2,2,2,1,2,1,3,1,3,2,10,10,10,13,11,8,13,11,9,7,10,13,8,11,11,13,11,11,11,10,11,10,14,9,14,10,9,10,13,12,12,15,9,14,14,20,12,12,12,8,12,12,10,12,9,10,5,8,13,14,5,1,1,1,7,1,1,7,S ,600,1,1,20,7,1,1,1,1,1,1,1,1,1,1,1,0,0,0,0,0,0,0,0,0,0,0,0,0,0,0,0,0,0,0,0,0,0,0,0,0,0,0,0,0,0,0,0,0,0,0,0,0,0,0,0,0,0,0,0,0,0,0,0,0,Douglas,- ,34,186,Forward - Centre-Forward,right,Ji-Paraná Futebol Clube (RO),9,2,0,465,31,6,0,1930,8,0,0,121,3,0,0,179,25,3,3,1483,nan,nan,nan,nan,nan,nan,nan,nan,nan,nan,nan,nan,nan,nan,nan,nan,Liga NOS,nan,nan,nan,nan,nan,nan,nan,nan
13/6/2011,Djordje Rakic,5781593,802,10/31/1985,25,0,0,11,0,4600,6000,5000,121,110,245680,188,83,S C,3,1,3,2,2,1,1,2,1,3,2,6,11,10,13,10,4,15,8,10,6,11,9,10,11,12,10,13,10,11,11,12,16,11,10,12,11,14,15,12,13,10,14,10,15,12,20,16,12,11,7,10,5,8,15,13,14,11,13,15,11,2,1,1,1,15,1,1,15,S C,601,1,1,20,15,1,1,1,1,1,1,1,1,1,1,1,0,0,0,0,0,0,0,0,0,0,0,0,0,0,0,0,0,0,0,0,0,0,0,0,0,0,0,0,0,0,0,0,0,0,0,0,0,0,0,0,0,0,0,0,0,0,0,0,0,,,,,,,,,,,,,,,,,,,,,,,,,,,,,,,,,,,,,,,,,,,,,,,,,,,,
13/6/2011,Deniz Ömer Sari,70035646,799,7/29/1985,25,0,0,0,0,50,1750,1750,57,50,1334,189,0,S ,3,3,1,2,1,2,2,1,3,2,2,1,1,8,10,8,1,11,5,1,1,7,7,1,10,9,9,2,6,11,1,9,8,12,3,11,8,13,10,11,10,10,7,8,13,11,20,8,9,10,10,7,7,9,9,5,10,11,6,8,8,17,1,1,1,1,1,1,1,S ,600,1,1,20,1,1,1,1,1,1,1,1,1,1,1,1,0,0,0,0,0,0,0,0,0,0,0,0,0,0,0,0,0,0,0,0,0,0,0,0,0,0,0,0,0,0,0,0,0,0,0,0,0,0,0,0,0,0,0,0,0,0,0,0,0,,,,,,,,,,,,,,,,,,,,,,,,,,,,,,,,,,,,,,,,,,,,,,,,,,,,
13/6/2011,David Rodríguez,1501527,796,2/14/1986,25,0,0,0,0,3750,6100,6100,128,123,2566133,178,72,S ,3,1,2,1,3,1,1,4,2,2,2,5,6,12,15,9,10,12,8,6,5,8,12,7,12,11,13,16,12,11,11,11,15,12,7,16,8,14,16,16,14,8,9,11,13,14,20,15,9,11,5,10,7,6,10,8,12,7,15,10,15,12,1,1,1,13,13,11,1,S ,600,1,1,20,1,11,13,1,1,1,1,1,1,1,1,1,8208,0,0,0,0,1,0,0,0,0,0,0,0,0,1,0,0,0,0,0,0,0,0,0,0,0,0,0,0,0,0,0,0,0,0,0,0,0,0,0,0,0,0,0,0,0,0,0,0,Maxi Rodríguez,£3.15m ,39,173,Forward - Left Winger,right,Club Atlético Newell's Old Boys,35,10,1,2458,21,6,3,1427,38,8,3,3178,27,11,4,2280,46,21,6,3875,16,4,0,1415,41,15,3,3313,34,9,3,2139,10,5,0,852,Premier League,24,6,1,2115,nan,nan,nan,nan
13/6/2011,David Clarkson,146916,793,9/10/1985,25,2,1,13,2,3300,5500,5150,124,100,339385,178,65,S C,3,1,3,2,1,2,3,3,3,2,3,3,9,8,10,12,4,10,10,1,3,14,16,8,13,11,9,12,11,10,11,10,16,9,7,13,7,13,14,10,9,8,9,15,15,10,20,16,12,8,6,12,5,13,7,13,18,14,14,17,11,1,1,1,5,15,11,11,15,S C,601,1,1,20,15,11,11,1,1,1,1,5,1,1,1,1,1581056,0,0,0,0,0,0,0,0,0,0,0,0,0,1,0,0,0,0,0,1,1,0,0,0,0,0,0,0,0,0,0,0,0,0,0,0,0,0,0,0,0,0,0,0,0,0,0,0,,,,,,,,,,,,,,,,,,,,,,,,,,,,,,,,,,,,,,,,,,,,,,,,,,,,
13/6/2011,Dave Hibbert,5112884,765,1/28/1986,25,0,0,0,0,1250,4150,4150,90,83,183234,188,74,S ,1,2,3,2,1,2,3,1,2,1,3,8,10,8,9,8,9,14,10,6,8,10,9,9,10,12,10,16,7,10,10,7,12,11,7,9,11,10,12,11,11,10,13,7,12,11,20,14,13,10,5,9,13,6,11,10,8,9,12,12,13,5,1,1,1,1,1,1,1,S ,600,1,1,20,1,1,1,1,1,1,1,1,1,1,1,1,263168,0,0,0,0,0,0,0,0,0,0,1,0,0,0,0,0,0,0,1,0,0,0,0,0,0,0,0,0,0,0,0,0,0,0,0,0,0,0,0,0,0,0,0,0,0,0,0,0,,,,,,,,,,,,,,,,,,,,,,,,,,,,,,,,,,,,,,,,,,,,,,,,,,,,
13/6/2011,Danny Graham,5118406,765,8/12/1985,25,0,0,0,0,3800,6500,6500,140,130,8050000,181,79,S ,1,3,1,1,2,3,3,1,3,2,3,7,10,10,16,14,9,14,12,9,11,11,16,8,14,11,16,15,15,13,7,13,14,8,13,16,8,17,18,12,12,13,11,9,13,7,20,16,18,15,7,12,4,12,8,11,11,6,12,11,12,6,1,1,1,1,1,1,1,S ,600,5,1,20,1,1,1,1,1,1,1,1,1,1,1,1,1.75922E+13,0,0,0,1,0,0,0,0,0,0,0,0,0,0,0,0,0,0,0,0,0,0,0,0,0,0,0,0,0,0,0,0,0,0,0,0,0,0,0,0,0,0,0,0,1,0,0,0,Danny Graham,£3.60m ,35,183,Forward - Centre-Forward,right,Sunderland AFC,49,27,9,4098,39,14,4,3053,36,7,5,2098,38,7,5,2645,23,2,2,1150,30,7,0,1988,40,13,8,2876,48,17,9,2880,46,16,6,3300,Premier League,39,4,1,1570,6,1,1,212
13/6/2011,Daniel Osvaldo,962383,776,1/12/1986,25,0,0,12,2,5500,6900,7500,160,152,31560891,185,78,AM/S RL,3,3,2,1,2,3,3,3,1,2,3,9,13,14,15,12,11,14,13,7,9,13,13,9,15,14,14,18,14,14,12,13,12,13,16,14,8,14,16,13,12,15,13,12,13,14,20,15,15,12,12,13,13,13,12,16,8,11,10,9,11,10,1,1,5,16,15,16,10,AM/S RL,625,1,1,20,10,16,15,1,1,1,1,1,5,1,1,1,4.43241E+12,0,0,0,0,0,0,0,0,0,0,0,0,0,0,0,0,0,0,0,0,0,0,0,1,0,0,0,0,0,0,0,0,0,0,0,1,0,0,0,0,0,0,1,0,0,0,0,0,Daniel Osvaldo,£13.50m ,34,182,Forward - Centre-Forward,right,Without Club,25,13,3,1775,26,11,5,2092,31,17,2,2385,31,6,1,1542,34,13,7,1983,17,1,2,788,nan,nan,nan,nan,nan,nan,nan,nan,nan,nan,nan,nan,Serie A,2,0,0,60,nan,nan,nan,nan
13/6/2011,Craig Davies,4002261,801,1/9/1986,25,5,0,9,3,2750,4800,4800,115,96,257379,188,85,S ,2,1,3,3,1,2,2,4,2,2,3,3,8,9,14,10,4,12,16,3,5,9,12,4,13,9,10,12,10,7,5,8,16,10,6,12,6,11,10,13,11,13,10,7,13,13,20,11,13,11,9,10,4,7,5,13,4,11,11,11,9,11,1,1,1,12,10,12,1,S ,600,1,1,20,1,12,10,1,1,1,1,1,1,1,1,1,532993,1,0,0,0,0,0,0,0,0,1,0,0,0,1,0,0,0,0,0,1,0,0,0,0,0,0,0,0,0,0,0,0,0,0,0,0,0,0,0,0,0,0,0,0,0,0,0,0,Charlie Davies,£450Th. ,34,178,Forward - Centre-Forward,right,Retired,26,11,1,1551,2,0,0,25,30,0,0,713,23,7,5,1553,34,10,4,2182,18,1,1,377,4,1,0,113,nan,nan,nan,nan,nan,nan,nan,nan,Ligue 1,nan,nan,nan,nan,nan,nan,nan,nan
13/6/2011,Cody McDonald,89009043,765,5/30/1986,25,0,0,0,0,2500,4750,4750,110,90,2512477,178,70,S ,3,3,2,3,2,2,3,4,3,1,1,6,5,9,13,10,5,11,9,5,2,9,12,5,9,10,10,10,11,8,10,10,14,11,4,12,9,10,12,14,11,12,9,7,13,13,20,10,9,10,8,8,1,8,10,14,7,6,9,8,10,3,1,1,9,10,9,1,10,S ,600,5,1,20,10,1,9,1,1,1,1,1,1,9,1,1,2.19902E+12,0,0,0,1,1,0,0,0,0,1,0,0,0,0,0,0,0,0,0,0,0,0,0,0,0,0,0,0,0,0,0,0,0,0,0,0,0,0,0,0,0,1,0,0,0,0,0,0,,,,,,,,,,,,,,,,,,,,,,,,,,,,,,,,,,,,,,,,,,,,,,,,,,,,
13/6/2011,Ciprian Marica,7540772,790,10/2/1985,25,49,16,10,4,6400,6250,6500,139,132,6460548,184,78,S ,2,3,3,3,1,1,1,1,1,3,1,7,12,15,8,17,7,12,9,5,3,14,11,5,16,6,8,5,7,12,13,7,4,15,4,9,6,7,6,18,16,7,13,15,12,16,20,11,12,6,5,14,4,6,16,9,12,6,9,10,19,13,1,1,1,11,8,11,1,S ,600,1,1,20,1,11,8,1,1,1,1,1,1,1,1,1,1074007056,0,0,0,0,1,0,0,0,0,0,1,1,0,0,0,0,0,0,1,0,0,0,0,0,0,0,0,0,0,0,1,0,0,0,0,0,0,0,0,0,0,0,0,0,0,0,0,0,,,,,,,,,,,,,,,,,,,,,,,,,,,,,,,,,,,,,,,,,,,,,,,,,,,,
13/6/2011,Cícero,8875654,23,5/8/1986,25,0,0,0,0,2000,4500,4500,113,100,344909,185,89,S ,3,1,1,3,3,1,1,3,2,2,2,4,6,10,11,7,4,16,11,4,5,8,9,5,11,10,10,14,15,10,7,7,14,10,3,11,9,11,11,12,11,14,15,5,17,12,20,13,14,10,6,10,18,7,15,15,12,12,15,14,14,5,1,1,1,1,1,1,1,S ,600,1,1,20,1,1,1,1,1,1,1,1,1,1,1,1,1.75922E+13,0,0,0,0,0,0,0,0,0,0,0,0,0,0,0,0,0,0,0,0,0,1,0,0,0,0,0,0,0,0,0,0,0,0,0,0,0,0,0,0,0,0,0,0,1,0,0,0,,,,,,,,,,,,,,,,,,,,,,,,,,,,,,,,,,,,,,,,,,,,,,,,,,,,
13/6/2011,Chu-Young Park,5708178,135,7/10/1985,25,53,17,10,1,6050,7500,6750,155,150,6999999,182,75,AM/S LC,3,3,1,2,1,1,1,2,2,1,1,8,9,13,11,16,14,15,12,5,5,14,12,4,16,9,14,13,11,12,14,14,15,14,12,15,9,14,16,17,15,14,12,10,12,13,20,15,13,13,9,16,9,12,14,16,13,14,17,17,16,5,1,1,12,18,10,16,18,AM/S LC,624,1,1,20,18,16,10,1,1,1,1,1,12,10,1,1,1056784,0,0,0,0,1,0,0,0,0,0,0,0,0,1,0,0,0,0,0,0,1,0,0,0,0,0,0,0,0,0,0,0,0,0,0,0,0,0,0,0,0,0,0,0,0,0,0,0,Chu-young Park,£3.60m ,35,182,Forward - Centre-Forward,right,FC Seoul,35,12,1,3024,10,3,0,596,25,4,1,1066,3,0,0,100,31,10,2,2255,49,11,9,2796,39,10,3,1769,22,4,1,1049,36,12,7,2876,Premier League,26,7,2,1826,nan,nan,nan,nan
13/6/2011,Christian Essig,8727510,771,1/24/1986,25,0,0,0,0,2750,4400,4400,100,88,57344,180,76,M/AM/S L,2,3,2,1,1,2,2,1,1,3,1,8,9,10,9,10,7,5,9,10,8,9,7,7,10,7,9,7,7,9,10,9,8,11,8,10,7,9,8,13,12,10,10,20,10,12,15,9,9,8,5,9,9,13,13,11,9,12,6,12,6,6,1,1,20,20,13,20,1,M/AM/S L,423,1,1,17,1,20,11,1,1,1,1,1,20,13,1,1,0,0,0,0,0,0,0,0,0,0,0,0,0,0,0,0,0,0,0,0,0,0,0,0,0,0,0,0,0,0,0,0,0,0,0,0,0,0,0,0,0,0,0,0,0,0,0,0,0,Christian Eigler,£1.13m ,36,185,Forward - Right Winger,right,SV Unterreichenbach,36,8,4,2418,25,1,2,1360,28,6,3,2336,24,2,1,1330,nan,nan,nan,nan,nan,nan,nan,nan,nan,nan,nan,nan,nan,nan,nan,nan,nan,nan,nan,nan,Bundesliga,nan,nan,nan,nan,nan,nan,nan,nan
13/6/2011,Chinedu Obasi,766769,38,6/1/1986,25,16,4,8,3,6850,6794,7600,165,151,23826586,188,78,AM/S R,2,3,3,1,3,1,1,9,2,2,3,8,15,17,8,17,7,9,11,6,5,14,12,13,18,9,14,6,12,10,15,14,7,18,5,13,6,12,17,17,17,7,12,8,3,16,20,10,11,8,6,9,18,10,10,15,10,11,14,12,5,13,1,1,1,18,18,1,1,AM/S R,622,1,1,20,1,1,18,1,1,1,1,1,1,1,1,1,34359750672,0,0,0,0,1,0,0,0,0,0,0,0,1,1,0,0,0,0,0,0,0,0,0,0,0,0,0,0,0,0,0,0,0,0,0,1,0,0,0,0,0,0,0,0,0,0,0,0,Chinedu Obasi,£4.05m ,34,188,Forward - Centre-Forward,right,SCR Altach,6,0,1,175,30,2,4,1863,7,0,0,197,19,3,1,701,10,1,1,367,11,8,4,817,26,10,8,2112,11,5,2,950,18,5,2,1252,Bundesliga,6,1,0,305,6,3,1,359
13/6/2011,Caio,2100326,1651,5/29/1986,25,0,0,0,0,4100,6000,6350,132,127,1952393,186,85,AM C,2,1,2,2,2,2,3,4,1,1,2,15,10,14,11,15,15,11,17,8,3,15,12,6,14,6,13,6,13,12,13,11,6,14,5,13,6,9,7,13,11,13,12,16,4,12,20,8,13,9,6,13,6,10,1,8,10,11,2,10,13,6,1,1,15,20,12,10,20,AM C,501,1,1,15,20,10,12,1,1,1,2,15,9,8,1,1,34359738912,0,0,0,0,0,1,0,0,0,1,0,0,0,0,0,0,0,0,0,0,0,0,0,0,0,0,0,0,0,0,0,0,0,0,0,1,0,0,0,0,0,0,0,0,0,0,0,0,Cani,£5.40m ,39,178,Midfielder - Attacking Midfield,right,Retired,53,10,6,3182,35,1,4,2399,38,3,5,2787,27,3,6,2065,20,2,4,960,19,0,0,900,32,1,3,2181,nan,nan,nan,nan,nan,nan,nan,nan,LaLiga,nan,nan,nan,nan,nan,nan,nan,nan
13/6/2011,Bryan Ruíz,18003360,366,8/21/1985,25,35,9,0,0,6500,7500,8000,163,158,23638537,185,78,AM RL,1,3,1,3,2,1,1,8,2,1,1,12,14,16,14,16,12,13,12,7,6,15,15,5,18,10,13,15,14,11,15,12,14,19,11,15,7,10,12,15,15,10,13,20,14,15,10,12,12,16,10,10,13,10,8,13,14,14,14,17,15,1,1,1,14,20,20,17,12,AM RL,505,1,1,15,12,17,20,1,1,1,1,1,14,14,1,1,0,0,0,0,0,0,0,0,0,0,0,0,0,0,0,0,0,0,0,0,0,0,0,0,0,0,0,0,0,0,0,0,0,0,0,0,0,0,0,0,0,0,0,0,0,0,0,0,0,Bryan Ruíz,£9.00m ,35,188,Midfielder - Attacking Midfield,left,LD Alajuelense,40,10,11,3268,38,7,9,2409,31,5,9,2544,28,6,7,2055,32,5,4,2189,46,13,15,3611,42,3,8,2707,47,2,5,2241,nan,nan,nan,nan,Premier League,nan,nan,nan,nan,8,2,1,562
13/6/2011,Braulio,1503801,796,9/18/1985,25,0,0,0,0,3650,6150,6150,132,125,3191825,178,80,S ,2,2,3,2,3,1,3,2,1,1,2,6,9,14,13,13,8,12,11,5,5,12,13,6,14,16,11,13,9,12,12,11,13,15,8,15,8,13,15,14,11,12,9,13,10,12,20,11,13,12,10,12,10,12,11,11,12,11,15,13,13,7,1,1,1,13,13,9,10,S ,600,1,1,20,10,9,13,1,1,1,1,1,1,1,1,1,16,0,0,0,0,1,0,0,0,0,0,0,0,0,0,0,0,0,0,0,0,0,0,0,0,0,0,0,0,0,0,0,0,0,0,0,0,0,0,0,0,0,0,0,0,0,0,0,0,,,,,,,,,,,,,,,,,,,,,,,,,,,,,,,,,,,,,,,,,,,,,,,,,,,,
13/6/2011,Billy Sharp,5112702,765,2/5/1986,25,0,0,0,0,3100,5900,5900,135,125,5478631,176,70,S ,1,1,2,2,3,2,2,4,1,1,2,3,10,13,14,12,5,10,11,2,2,9,16,3,12,13,11,13,13,11,13,11,15,11,9,14,7,10,14,14,13,12,7,13,13,13,20,12,12,11,4,12,5,5,5,13,17,12,13,10,11,14,1,1,1,1,1,1,1,S ,600,1,1,20,1,1,1,1,1,1,1,1,1,1,1,1,2.19902E+13,0,0,0,0,0,0,0,0,0,0,0,1,0,0,0,0,0,0,0,0,1,0,0,0,0,0,0,0,0,0,0,0,0,0,0,0,0,0,0,0,0,0,1,0,1,0,0,0,,,,,,,,,,,,,,,,,,,,,,,,,,,,,,,,,,,,,,,,,,,,,,,,,,,,
13/6/2011,Bastian Heidenfelder,35020896,771,1/8/1986,25,0,0,0,0,2750,4500,4500,105,90,94723,174,80,S RL,3,3,3,3,1,3,3,2,1,3,1,6,10,10,11,10,7,8,7,4,4,9,6,5,10,9,10,9,9,10,9,11,10,8,8,9,9,11,11,12,9,11,8,15,7,10,20,13,13,9,6,9,6,7,6,6,6,10,15,20,7,11,1,1,1,15,15,15,1,S RL,605,1,1,20,1,15,15,1,1,1,1,1,1,1,1,1,0,0,0,0,0,0,0,0,0,0,0,0,0,0,0,0,0,0,0,0,0,0,0,0,0,0,0,0,0,0,0,0,0,0,0,0,0,0,0,0,0,0,0,0,0,0,0,0,0,,,,,,,,,,,,,,,,,,,,,,,,,,,,,,,,,,,,,,,,,,,,,,,,,,,,
13/6/2011,Barreto,7987008,1651,7/12/1985,25,0,0,0,0,4000,7040,6400,135,128,3942330,171,72,S RL,2,3,2,2,2,1,2,4,2,2,3,5,9,15,14,14,14,4,12,9,7,13,12,5,15,12,9,8,13,7,12,10,18,17,6,14,8,12,13,16,17,9,8,8,10,15,20,14,6,12,4,15,14,11,16,18,13,17,12,14,10,6,1,1,1,15,15,15,1,S RL,605,1,1,20,1,15,15,1,1,1,1,1,1,1,1,1,16,0,0,0,0,1,0,0,0,0,0,0,0,0,0,0,0,0,0,0,0,0,0,0,0,0,0,0,0,0,0,0,0,0,0,0,0,0,0,0,0,0,0,0,0,0,0,0,0,Barreto,£2.25m ,35,171,Forward - Second Striker,right,Without Club,13,4,1,988,9,1,0,346,20,3,2,1214,11,0,1,508,6,1,0,280,5,0,0,217,nan,nan,nan,nan,nan,nan,nan,nan,nan,nan,nan,nan,Serie A,5,0,0,72,nan,nan,nan,nan
13/6/2011,Bafétimbi Gomis,919763,769,8/6/1985,25,5,2,0,0,5700,6350,6350,146,141,13519221,184,77,S ,1,2,3,3,3,1,1,3,2,1,2,5,8,12,14,13,9,14,13,6,4,12,14,4,13,8,15,13,12,12,11,12,15,15,7,14,8,12,14,15,13,16,12,13,13,13,20,15,16,13,8,16,9,5,13,17,11,13,13,13,13,7,1,1,1,8,1,1,8,S ,600,1,1,20,8,1,1,1,1,1,1,1,1,1,1,1,8397328,0,0,0,0,1,0,0,0,0,1,0,0,0,1,0,0,0,0,0,0,0,0,0,1,0,0,0,0,0,0,0,0,0,0,0,0,0,0,0,0,0,0,0,0,0,0,0,0,Bafétimbi Gomis,£10.80m ,35,184,Forward - Centre-Forward,right,Al-Hilal Riyadh,45,12,3,3005,54,25,3,3900,45,21,6,3243,49,22,4,3489,36,10,3,2054,35,7,0,1812,34,21,4,2859,40,32,6,3212,48,35,6,4138,Ligue 1,37,32,4,2680,2,0,0,51
13/6/2011,Babacar Gueye,8431107,41,3/2/1986,25,25,7,0,0,3750,5400,5500,120,108,662471,186,78,AM/S RL,2,3,1,2,2,1,3,3,2,3,2,6,9,11,9,13,8,12,10,6,3,7,12,3,13,7,11,11,9,11,9,8,11,14,8,13,5,12,14,13,13,14,12,20,13,14,8,14,14,10,7,13,7,5,9,15,13,8,10,13,13,10,1,1,10,20,15,20,14,AM/S RL,515,1,1,20,14,20,15,1,1,1,1,1,10,1,1,1,1048576,0,0,0,0,0,0,0,0,0,0,0,0,0,0,0,0,0,0,0,0,1,0,0,0,0,0,0,0,0,0,0,0,0,0,0,0,0,0,0,0,0,0,0,0,0,0,0,0,,,,,,,,,,,,,,,,,,,,,,,,,,,,,,,,,,,,,,,,,,,,,,,,,,,,
13/6/2011,Ashley Young,5113149,765,7/9/1985,25,15,2,10,0,6400,7700,7750,165,152,78273183,175,65,AM RLC,1,1,2,3,1,1,1,4,1,1,3,16,15,14,14,16,12,6,11,3,3,13,12,4,14,7,14,8,13,12,12,10,13,14,5,15,7,11,13,18,15,12,7,10,15,16,20,14,6,14,5,15,5,13,16,12,8,12,13,7,14,4,1,1,14,20,18,20,19,AM RLC,506,1,1,15,19,20,18,1,1,1,1,1,14,14,1,1,7.09185E+13,1,0,0,0,0,0,0,0,0,0,1,1,0,0,0,0,0,0,0,0,0,0,0,0,0,0,0,0,0,0,0,0,0,0,0,0,0,0,0,1,0,0,0,0,0,0,1,0,Ashley Young,£24.30m ,35,175,Midfielder - Left Midfield,both,Inter Milan,40,9,13,3538,33,8,12,2222,23,0,5,1471,30,3,5,1489,30,2,6,2256,27,1,3,1627,23,0,1,1469,39,2,7,3156,41,2,3,3509,Premier League,43,5,6,3005,3,0,1,152
13/6/2011,Andrew Keogh,5112533,789,5/16/1986,25,13,1,4,3,3750,6000,5750,130,114,2149559,183,73,S ,1,2,1,2,2,3,1,5,1,3,3,5,10,13,9,12,4,10,8,2,7,11,12,4,13,10,8,6,8,13,11,11,18,11,3,12,8,16,17,14,14,14,8,15,14,14,20,17,10,15,4,14,1,10,10,12,15,14,15,10,10,6,1,1,1,12,10,12,10,S ,600,1,1,20,10,12,10,1,1,1,1,1,1,1,1,1,17826816,0,0,0,0,0,0,0,0,0,0,1,0,0,0,0,0,0,0,0,0,1,0,0,0,1,0,0,0,0,0,0,0,0,0,0,0,0,0,0,0,0,0,0,0,0,0,0,0,Andy Keogh,£900Th. ,34,183,Forward - Centre-Forward,right,Perth Glory,28,3,1,1626,43,12,3,3114,42,6,6,2852,31,5,3,1530,35,11,1,3040,15,10,3,1264,28,12,5,2488,24,6,4,2054,28,15,2,2021,Premier League,7,1,0,612,nan,nan,nan,nan
13/6/2011,André-Pierre Gignac,8431784,769,12/5/1985,25,16,4,0,0,5250,5850,5850,150,130,8534169,187,87,S ,1,3,1,1,1,2,2,1,1,1,3,5,11,12,13,13,12,11,14,5,7,11,15,6,13,12,14,16,11,12,11,10,16,12,11,14,8,12,17,15,12,17,13,8,9,12,20,14,17,10,13,13,13,7,9,16,12,10,8,13,11,12,1,1,10,14,10,14,1,S ,600,1,1,20,1,14,10,1,1,1,1,1,10,10,1,1,4.96498E+12,0,0,0,0,0,0,0,0,0,1,0,1,0,0,0,0,0,0,0,0,0,0,0,0,0,0,0,0,0,0,0,0,0,0,1,0,0,0,0,1,0,0,1,0,0,0,0,0,André-Pierre Gignac,£5.40m ,34,187,Forward - Centre-Forward,right,Tigres UANL,41,13,7,2646,27,2,0,1018,40,18,1,2953,44,22,4,3410,43,24,2,3509,46,32,5,4111,50,26,9,4475,46,21,9,3931,42,24,3,3504,Ligue 1,32,22,6,2859,15,10,1,1350
13/6/2011,Álvaro Negredo,1501655,796,8/20/1985,25,4,2,1,0,6200,7600,7600,160,154,71259735,186,85,S ,3,1,2,2,2,2,3,4,3,1,3,8,12,14,16,12,7,16,15,7,5,13,16,8,13,13,14,16,14,14,13,14,15,12,10,14,9,13,16,13,12,17,13,20,14,14,14,16,16,13,12,13,5,11,13,15,13,12,16,12,7,7,1,1,1,8,3,8,5,S ,600,1,1,20,5,8,3,1,1,1,1,1,1,1,1,1,1040,0,0,0,0,1,0,0,0,0,0,1,0,0,0,0,0,0,0,0,0,0,0,0,0,0,0,0,0,0,0,0,0,0,0,0,0,0,0,0,0,0,0,0,0,0,0,0,0,Álvaro Negredo,£16.20m ,35,186,Forward - Centre-Forward,left,Cádiz CF,55,26,12,3541,36,14,5,2733,42,31,4,3523,49,23,8,2552,34,6,5,1733,40,12,3,2160,39,10,4,3037,43,15,9,2085,26,21,4,2112,LaLiga,17,8,5,1530,6,1,2,380
13/6/2011,Alban Ramaj,8728403,752,11/8/1985,25,0,0,0,0,4150,5250,5250,112,109,158086,180,74,AM/S R,2,3,1,2,2,3,1,3,2,3,1,9,10,12,12,11,9,9,9,6,3,10,11,5,11,13,10,11,9,8,11,9,10,12,8,13,10,10,12,15,13,10,9,11,9,13,20,10,10,8,11,8,12,9,13,12,9,9,9,9,13,9,1,1,14,20,20,14,1,AM/S R,512,1,1,18,1,14,20,1,1,1,1,1,11,14,1,1,134217728,0,0,0,0,0,0,0,0,0,0,0,0,0,0,0,0,0,0,0,0,0,0,0,0,0,0,0,1,0,0,0,0,0,0,0,0,0,0,0,0,0,0,0,0,0,0,0,0,,,,,,,,,,,,,,,,,,,,,,,,,,,,,,,,,,,,,,,,,,,,,,,,,,,,
13/6/2011,Adrián Ramos,8829000,1653,1/22/1986,25,19,2,11,3,5750,7000,7000,148,141,13309989,185,72,S L,1,3,1,1,2,3,3,3,1,1,1,5,7,14,8,10,5,14,6,6,6,9,13,7,13,15,11,17,9,10,9,11,15,12,7,15,10,7,17,16,15,11,16,14,17,18,20,15,12,12,8,13,9,12,12,16,8,11,12,12,16,11,1,1,1,15,14,15,1,S L,603,1,1,20,1,15,14,1,1,1,1,1,1,1,1,1,2.25235E+15,0,0,0,0,1,0,0,0,0,0,1,0,0,0,0,0,0,0,0,1,0,0,0,0,0,0,0,0,0,0,0,0,0,0,0,0,0,0,0,1,0,0,0,0,0,0,0,0,Adrián Ramos,£4.05m ,34,185,Forward - Centre-Forward,right,CD América de Cali,35,17,10,3049,37,10,8,2739,33,11,9,2570,34,16,6,2740,29,6,2,955,39,10,6,1503,25,7,2,1799,26,4,0,1822,39,6,3,2248,Bundesliga,16,3,1,984,nan,nan,nan,nan
13/6/2011,Adam Nemec,7562297,794,9/2/1985,25,2,0,0,0,4000,6050,6250,134,125,1273478,190,84,M/AM/S C,1,3,3,3,1,2,2,3,3,2,3,2,8,11,12,14,3,16,8,8,13,14,7,14,13,4,14,14,11,16,11,13,13,12,10,12,15,19,20,10,4,19,17,8,13,11,20,18,19,13,5,11,9,7,8,12,11,9,12,13,9,9,1,1,17,20,1,1,20,M/AM/S C,531,1,1,20,20,1,1,1,1,1,1,17,1,1,1,1,262144,0,0,0,0,0,0,0,0,0,0,0,0,0,0,0,0,0,0,1,0,0,0,0,0,0,0,0,0,0,0,0,0,0,0,0,0,0,0,0,0,0,0,0,0,0,0,0,0,Adam Nemec,£630Th. ,35,190,Forward - Centre-Forward,both,Dinamo Bucharest,27,4,2,1073,24,5,1,1523,30,9,2,2221,29,5,2,1661,18,2,1,1034,19,6,0,1095,31,13,3,2263,33,7,4,2188,28,16,2,2407,Bundesliga,14,1,3,1125,5,1,0,450
