GameDate,Name,UID,NationID,Born,Age,IntCaps,IntGoals,U21Caps,U21Goals,WorldReputation,HomeReputation,CurrentReputation,PA,CA,Price,Height,Weight,PositionsString,GK.AerialAbility,GK.CommandOfArea,GK.Communication,GK.Eccentricity,GK.Handling,GK.Kicking,GK.OneOnOnes,GK.Reflexes,GK.RushingOut,GK.TendencyToPunch,GK.Throwing,Tech.Corners,Tech.Crossing,Tech.Dribbling,Tech.Finishing,Tech.FirstTouch, Tech.Freekicks,Tech.Heading,Tech.LongShots,Tech.Longthrows,Tech.Marking,Tech.Passing,Tech.PenaltyTaking, Tech.Tackling,Tech.Technique,Mental.Aggression,Mental.Anticipation,Mental.Bravery,Mental.Composure,Mental.Concentration,Mental.Vision,Mental.Decisions,Mental.Determination,Mental.Flair,Mental.Leadership, Mental.OffTheBall,Mental.Positioning,Mental.Teamwork,Mental.Workrate,Phy.Acceleration,Phy.Agility,Phy.Balance,Phy.Jumping,Phy.LeftFoot,Phy.NaturalFitness,Phy.Pace,Phy.RightFoot,Phy.Stamina,Phy.Strength, Hidden.Consistency,Hidden.Dirtiness,Hidden.ImportantMatches,Hidden.InjuryProness,Hidden.Versatility,Personality.Adaptability,Personality.Ambition,Personality.Loyalty,Personality.Pressure,Personality.Professional,Personality.Sportsmanship,Personality.Temperament,Personality.Controversy,Positions.Defender,Positions.WingBack,Positions.Midfielder,Positions.AttackingMidfielder,Positions.Right,Positions.Left,Positions.Centre,Positions.PositionsDesc,Positions.PositionsDescVal,Positions.Goalkeeper,Positions.Sweeper,Positions.Striker,Positions.AttackingMidCentral,Positions.AttackingMidLeft,Positions.AttackingMidRight,Positions.DefenderCentral,Positions.DefenderLeft, Positions.DefenderRight,Positions.DefensiveMidfielder,Positions.MidfielderCentral,Positions.MidfielderLeft,Positions.MidfielderRight,Positions.WingBackLeft,Positions.WingBackRight,PPMVal,PPM0,PPM1,PPM2,PPM3,PPM4,PPM5,PPM6,PPM7,PPM8,PPM9,PPM10,PPM11,PPM12,PPM13,PPM14,PPM15,PPM16,PPM17,PPM18,PPM19,PPM20,PPM21,PPM22,PPM23,PPM24,PPM25,PPM26,PPM27,PPM28,PPM29,PPM30,PPM31,PPM32,PPM33,PPM34,PPM35,PPM36,PPM37,PPM38,PPM39,PPM40,PPM41,PPM42,PPM43,PPM44,PPM45,PPM46,PPM47,name,Market Value,age,height,position,foot,current club,10/11 games,10/11 goals/conceded,10/11 assists/clean,10/11 minutes,11/12 games,11/12 goals/conceded,11/12 assists/clean,11/12 minutes,12/13 games,12/13 goals/conceded,12/13 assists/clean,12/13 minutes,13/14 games,13/14 goals/conceded,13/14 assists/clean,13/14 minutes,14/15 games,14/15 goals/conceded,14/15 assists/clean,14/15 minutes,15/16 games,15/16 goals/conceded,15/16 assists/clean,15/16 minutes,16/17 games,16/17 goals/conceded,16/17 assists/clean,16/17 minutes,17/18 games,17/18 goals/conceded,17/18 assists/clean,17/18 minutes,18/19 games,18/19 goals/conceded,18/19 assists/clean,18/19 minutes,current league,19/20 games,19/20 goals/conceded,19/20 assists/clean,19/20 minutes,20/21 games,20/21 goals/conceded,20/21 assists/clean,20/21 minutes
13/6/2011,Sebastian Maier,92026377,771,9/18/1993,17,0,0,0,0,2250,4900,4900,139,98,4531129,176,64,M/AM LC,2,2,1,2,2,3,3,2,1,3,1,11,14,14,10,14,10,8,11,4,7,14,10,10,11,12,11,10,5,11,12,13,10,8,11,13,9,13,15,14,11,14,7,20,13,10,8,11,4,10,8,7,8,10,8,3,9,8,14,5,13,14,1,1,18,20,12,18,20,M/AM LC,524,1,1,1,20,18,12,1,1,1,14,18,15,10,1,1,0,0,0,0,0,0,0,0,0,0,0,0,0,0,0,0,0,0,0,0,0,0,0,0,0,0,0,0,0,0,0,0,0,0,0,0,0,0,0,0,0,0,0,0,0,0,0,0,0,Sebastian Usai,- ,30,190,Goalkeeper,right,Friska Viljor FC,4,11,0,360,5,2,4,450,15,23,5,1350,5,12,1,450,0,0,0,0,nan,nan,nan,nan,nan,nan,nan,nan,nan,nan,nan,nan,nan,nan,nan,nan,Premier League,nan,nan,nan,nan,nan,nan,nan,nan
13/6/2011,Reuben Noble-Lazarus,28036609,765,8/16/1993,17,0,0,0,0,2000,4000,4000,154,80,5805354,181,86,AM/S RL,1,3,3,3,2,3,2,1,2,2,3,8,13,7,10,12,9,4,8,3,2,8,9,8,7,4,12,8,8,3,13,4,10,8,5,10,2,9,9,12,12,13,8,14,9,11,20,9,4,7,14,6,10,9,3,10,17,8,12,12,12,19,1,1,9,20,20,18,1,AM/S RL,515,1,1,17,1,18,20,1,1,1,1,1,1,9,1,1,0,0,0,0,0,0,0,0,0,0,0,0,0,0,0,0,0,0,0,0,0,0,0,0,0,0,0,0,0,0,0,0,0,0,0,0,0,0,0,0,0,0,0,0,0,0,0,0,0,,,,,,,,,,,,,,,,,,,,,,,,,,,,,,,,,,,,,,,,,,,,,,,,,,,,
13/6/2011,Nathan Redmond,28053447,765,3/6/1994,17,0,0,0,0,1750,5150,5150,140,103,28175280,162,65,M/AM RL,1,2,3,3,2,1,1,1,1,3,3,7,10,13,7,10,7,2,10,2,4,8,5,4,11,10,7,6,7,9,10,5,15,14,4,10,5,8,8,16,10,11,3,7,12,16,20,9,5,10,5,12,5,8,8,13,14,12,13,15,14,5,1,1,20,20,20,19,1,M/AM RL,415,1,1,1,1,19,20,1,1,1,1,1,15,20,1,1,2,0,1,0,0,0,0,0,0,0,0,0,0,0,0,0,0,0,0,0,0,0,0,0,0,0,0,0,0,0,0,0,0,0,0,0,0,0,0,0,0,0,0,0,0,0,0,0,0,,,,,,,,,,,,,,,,,,,,,,,,,,,,,,,,,,,,,,,,,,,,,,,,,,,,
13/6/2011,Julian Draxler,92030193,771,9/20/1993,17,0,0,0,0,4750,6750,6750,144,125,62993082,183,68,AM RLC,2,3,2,1,1,1,2,1,2,2,3,11,13,12,13,17,10,5,15,8,5,15,10,6,16,8,14,7,7,8,14,11,10,15,5,13,5,10,13,11,10,9,10,18,11,14,20,11,7,10,5,14,4,14,8,12,11,12,9,17,12,6,1,1,12,20,17,18,20,AM RLC,506,1,1,1,20,18,17,1,1,1,1,12,1,1,1,1,4.50415E+15,0,0,0,0,0,0,0,0,1,0,0,0,0,0,0,0,0,0,0,0,1,0,0,0,0,0,0,0,0,0,0,0,0,0,0,0,0,0,0,1,0,0,0,0,0,0,0,0,Julian Draxler,£9.90m ,27,187,Midfielder - Attacking Midfield,right,Paris Saint-Germain,36,12,2,1810,46,5,9,2779,39,13,7,2762,38,6,10,3101,19,2,2,1068,35,9,8,2584,39,10,5,2721,47,5,10,2630,46,5,12,2977,Bundesliga,22,0,7,1194,6,2,0,400
13/6/2011,Jordan Obita,28052366,765,12/8/1993,17,0,0,0,0,1650,4650,4650,151,85,6898207,181,63,AM LC,2,1,3,2,3,1,3,1,2,1,3,5,9,12,7,10,9,8,5,3,4,13,9,4,8,12,12,3,11,6,8,11,8,13,10,7,6,16,14,14,11,13,6,20,15,13,8,9,5,10,6,10,3,10,11,11,10,6,15,9,5,5,1,1,9,20,10,20,15,AM LC,504,1,1,15,15,20,10,1,1,1,1,1,9,1,1,1,0,0,0,0,0,0,0,0,0,0,0,0,0,0,0,0,0,0,0,0,0,0,0,0,0,0,0,0,0,0,0,0,0,0,0,0,0,0,0,0,0,0,0,0,0,0,0,0,0,,,,,,,,,,,,,,,,,,,,,,,,,,,,,,,,,,,,,,,,,,,,,,,,,,,,
13/6/2011,Ibrahima Tandia,85028025,769,7/12/1993,17,0,0,0,0,1250,2500,2500,152,101,8793513,169,65,AM RL,3,1,2,3,1,1,1,2,3,1,1,8,10,14,8,12,6,6,8,5,1,9,11,3,14,6,10,7,12,9,9,9,6,14,5,11,5,8,11,16,14,9,5,5,12,15,20,11,6,13,6,6,6,8,12,14,20,19,8,5,6,13,1,1,12,20,16,20,14,AM RL,505,1,1,10,14,20,16,1,1,1,1,10,12,12,1,1,0,0,0,0,0,0,0,0,0,0,0,0,0,0,0,0,0,0,0,0,0,0,0,0,0,0,0,0,0,0,0,0,0,0,0,0,0,0,0,0,0,0,0,0,0,0,0,0,0,Ibrahima Tandia,£360Th. ,27,171,Forward - Left Winger,right,Al-Hazm,nan,nan,nan,nan,3,0,0,124,nan,nan,nan,nan,nan,nan,nan,nan,22,3,3,1168,30,5,1,1414,9,0,0,345,23,5,2,1662,34,11,5,3002,Ligue 1,27,3,1,1621,nan,nan,nan,nan
13/6/2011,Wellington Silva,19086339,1651,1/6/1993,18,0,0,0,0,2750,5600,5600,154,108,9989488,171,68,AM/S LC,1,3,2,3,1,3,2,3,1,3,2,8,11,15,11,14,9,7,9,2,4,11,9,4,15,11,9,9,10,11,12,10,12,16,4,12,5,9,14,14,16,5,5,10,13,13,20,10,5,10,6,9,10,13,8,18,6,12,5,7,8,13,1,1,1,18,13,18,15,AM/S LC,624,1,1,20,15,18,13,1,1,1,1,1,1,1,1,1,34360262672,0,0,0,0,1,0,0,0,0,0,0,0,0,0,0,0,0,0,0,1,0,0,0,0,0,0,0,0,0,0,0,0,0,0,0,1,0,0,0,0,0,0,0,0,0,0,0,0,Wellington Silva,£450Th. ,27,170,Forward - Right Winger,right,Fluminense Football Club,2,0,0,37,16,3,0,858,23,4,0,624,39,3,5,1808,35,0,7,2235,45,4,5,3002,23,2,2,1322,10,1,2,262,25,1,1,989,LaLiga,16,2,1,792,nan,nan,nan,nan
13/6/2011,Steven Skrzybski,92037586,771,11/18/1992,18,0,0,0,0,2500,4200,4200,95,84,892390,173,64,S RLC,2,3,2,3,3,2,3,6,3,1,1,8,11,9,10,10,8,10,8,3,4,9,8,5,11,13,8,4,8,5,5,6,10,10,9,10,3,15,12,12,12,9,4,16,12,11,20,8,4,10,12,10,5,10,3,10,11,12,13,8,13,12,1,1,1,15,15,15,15,S RLC,606,1,1,20,15,15,15,1,1,1,1,1,1,1,1,1,0,0,0,0,0,0,0,0,0,0,0,0,0,0,0,0,0,0,0,0,0,0,0,0,0,0,0,0,0,0,0,0,0,0,0,0,0,0,0,0,0,0,0,0,0,0,0,0,0,,,,,,,,,,,,,,,,,,,,,,,,,,,,,,,,,,,,,,,,,,,,,,,,,,,,
13/6/2011,Ryo Miyaichi,28060849,116,12/14/1992,18,0,0,0,0,3250,5489,5750,143,122,129178817,180,71,AM RL,2,1,1,1,1,1,3,1,1,1,2,8,10,15,10,13,8,7,7,8,3,11,9,3,13,5,11,13,9,9,13,9,8,16,5,14,4,12,11,15,14,10,7,12,16,15,20,11,5,11,8,10,17,10,12,17,14,12,14,14,13,6,1,1,9,20,19,20,1,AM RL,505,1,1,1,1,20,19,1,1,1,1,1,9,1,1,1,0,0,0,0,0,0,0,0,0,0,0,0,0,0,0,0,0,0,0,0,0,0,0,0,0,0,0,0,0,0,0,0,0,0,0,0,0,0,0,0,0,0,0,0,0,0,0,0,0,Ryo Miyaichi,£2.70m ,27,183,Forward - Right Winger,right,FC St. Pauli,12,3,5,1030,24,2,4,1457,7,0,1,182,11,1,1,720,25,3,1,1730,5,2,1,114,20,0,1,804,1,0,0,13,29,5,1,1721,Premier League,30,1,7,2634,nan,nan,nan,nan
13/6/2011,Richard van den Bosch,92022263,771,7/25/1992,18,0,0,0,0,250,3250,3250,110,72,51649,169,64,AM/S RL,1,3,1,1,3,1,2,1,1,3,1,8,10,12,9,9,3,12,7,2,2,12,5,5,8,15,8,1,8,5,9,9,6,7,6,9,4,9,10,12,9,8,3,20,15,10,16,6,5,10,10,10,5,7,7,2,16,14,15,11,11,13,1,1,14,20,19,20,12,AM/S RL,515,1,1,17,12,20,19,1,1,1,1,1,14,13,1,1,0,0,0,0,0,0,0,0,0,0,0,0,0,0,0,0,0,0,0,0,0,0,0,0,0,0,0,0,0,0,0,0,0,0,0,0,0,0,0,0,0,0,0,0,0,0,0,0,0,,,,,,,,,,,,,,,,,,,,,,,,,,,,,,,,,,,,,,,,,,,,,,,,,,,,
13/6/2011,Phillipp Steinhart,35017459,771,7/7/1992,18,0,0,0,0,2750,4600,4600,127,92,1623968,182,69,D/WB L,1,3,1,3,3,3,3,1,1,1,1,7,9,10,2,12,3,6,7,6,7,11,1,13,13,6,10,8,13,10,11,13,9,10,8,9,11,11,13,13,11,9,10,20,10,11,8,11,4,10,12,10,10,10,13,12,17,9,2,14,14,8,20,18,15,1,9,20,10,D/WB L,113,1,1,1,1,1,1,10,20,9,1,1,15,1,18,1,0,0,0,0,0,0,0,0,0,0,0,0,0,0,0,0,0,0,0,0,0,0,0,0,0,0,0,0,0,0,0,0,0,0,0,0,0,0,0,0,0,0,0,0,0,0,0,0,0,,,,,,,,,,,,,,,,,,,,,,,,,,,,,,,,,,,,,,,,,,,,,,,,,,,,
13/6/2011,Nico Schulz,92027397,771,4/1/1993,18,0,0,0,0,500,5000,4500,139,95,3052921,180,78,D L,1,2,2,1,2,3,3,5,3,1,2,8,11,9,9,10,7,8,10,5,14,10,6,10,9,12,10,13,9,8,11,10,16,8,5,11,9,12,13,13,10,11,8,20,13,15,10,9,13,10,5,10,17,9,14,11,15,12,14,11,13,11,20,5,10,15,10,20,1,D L,103,1,1,1,1,15,8,1,20,10,1,1,10,8,5,1,1.75922E+13,0,0,0,1,0,1,0,0,0,0,0,0,0,0,0,0,0,0,0,0,0,0,0,0,0,0,0,0,0,0,0,0,0,0,0,0,0,0,0,0,0,0,0,0,1,0,0,0,Nico Schulz,£450Th. ,27,180,Defender - Left-Back,left,Borussia Dortmund,31,0,5,1274,24,1,3,2104,21,1,4,1459,25,0,1,1641,29,1,1,2077,4,0,1,95,18,1,2,705,34,2,4,2344,37,2,9,3139,Bundesliga,18,1,0,1164,2,0,0,29
13/6/2011,Moritz Leitner,16020473,771,12/8/1992,18,0,0,0,0,3150,6000,6000,145,120,114999996,174,65,M/AM RLC,2,3,3,1,3,2,3,3,3,1,1,9,13,14,7,13,13,5,13,2,5,14,6,5,14,9,10,14,11,11,13,11,12,13,4,13,4,13,14,14,16,8,7,15,12,13,20,10,7,8,3,10,4,17,8,14,11,9,13,12,13,9,1,1,19,20,18,18,20,M/AM RLC,526,1,1,1,20,16,16,1,1,1,12,19,18,18,1,1,268435456,0,0,0,0,0,0,0,0,0,0,0,0,0,0,0,0,0,0,0,0,0,0,0,0,0,0,0,0,1,0,0,0,0,0,0,0,0,0,0,0,0,0,0,0,0,0,0,0,Moritz Leitner,£3.60m ,27,174,Midfielder - Central Midfield,right,Norwich City,27,0,5,1318,25,0,3,998,31,0,3,1222,24,1,2,1751,21,1,2,1208,21,3,6,1087,8,0,0,248,12,0,0,863,31,2,2,1802,Bundesliga,10,0,0,805,1,0,0,45
13/6/2011,Michael Vitzthum,92037893,771,6/20/1992,18,0,0,0,0,2650,4600,4600,122,92,448704,185,70,D/WB L,3,1,2,2,3,2,3,1,2,2,2,8,10,13,2,14,10,14,10,6,9,10,7,13,13,7,6,9,12,10,11,10,10,4,10,6,7,12,13,14,14,14,12,20,12,14,8,9,4,10,11,10,7,10,5,13,4,5,13,14,6,13,20,18,15,1,12,20,12,D/WB L,113,1,1,1,1,1,1,12,20,12,15,1,15,1,18,1,0,0,0,0,0,0,0,0,0,0,0,0,0,0,0,0,0,0,0,0,0,0,0,0,0,0,0,0,0,0,0,0,0,0,0,0,0,0,0,0,0,0,0,0,0,0,0,0,0,,,,,,,,,,,,,,,,,,,,,,,,,,,,,,,,,,,,,,,,,,,,,,,,,,,,
13/6/2011,Markus Mendler,91100204,771,1/7/1993,18,0,0,0,0,4500,5900,6000,135,118,13223477,173,67,M/AM RLC,2,2,3,2,3,3,3,4,1,2,1,11,12,13,7,12,8,5,10,5,9,11,3,11,12,10,10,9,14,13,11,14,8,12,5,10,10,14,13,13,12,12,6,20,16,13,12,13,9,10,17,3,5,10,2,14,19,15,8,6,9,13,1,1,18,20,20,18,18,M/AM RLC,526,1,1,1,16,18,20,1,1,1,1,18,14,16,1,1,0,0,0,0,0,0,0,0,0,0,0,0,0,0,0,0,0,0,0,0,0,0,0,0,0,0,0,0,0,0,0,0,0,0,0,0,0,0,0,0,0,0,0,0,0,0,0,0,0,Markus Mendler,£720Th. ,27,173,Forward - Left Winger,left,1.FC Saarbrücken,25,5,1,1740,17,2,1,1002,11,4,0,855,11,0,0,711,20,3,0,876,30,4,1,1611,23,4,5,1184,32,12,18,2233,34,9,11,2196,Bundesliga,28,9,5,1679,4,2,0,114
13/6/2011,Luke Williams,28048007,765,6/11/1993,18,0,0,0,0,2200,4500,4750,134,90,2873850,174,70,AM/S RLC,1,1,3,2,3,3,1,6,3,1,3,9,8,13,8,7,6,6,10,5,4,11,8,6,10,11,9,14,11,7,11,8,15,12,6,10,8,14,15,14,18,5,5,12,12,10,20,7,5,8,6,10,5,10,6,12,18,12,15,16,12,3,1,1,12,16,16,15,15,AM/S RLC,626,1,1,20,15,15,16,1,1,1,1,1,1,12,1,1,0,0,0,0,0,0,0,0,0,0,0,0,0,0,0,0,0,0,0,0,0,0,0,0,0,0,0,0,0,0,0,0,0,0,0,0,0,0,0,0,0,0,0,0,0,0,0,0,0,Mike Williamson,£3.15m ,36,194,Defender - Centre-Back,right,Gateshead FC,32,0,3,2771,26,0,1,2165,28,0,0,2472,35,0,0,3121,33,1,1,2596,7,1,1,630,9,0,0,715,17,0,0,1449,32,0,0,2830,Premier League,nan,nan,nan,nan,nan,nan,nan,nan
13/6/2011,Kostas Fortounis,36042095,772,10/16/1992,18,0,0,8,0,2000,5174,5750,160,115,10470223,182,69,AM RLC,2,2,2,3,1,2,2,7,1,2,1,12,11,13,8,14,12,9,12,7,8,13,10,8,14,11,13,11,10,12,13,13,14,12,7,14,8,9,12,13,14,11,11,8,13,13,20,10,10,10,6,8,11,10,5,17,9,14,14,9,9,6,1,1,14,20,18,17,20,AM RLC,506,1,1,5,20,17,18,1,1,1,1,14,10,12,1,1,0,0,0,0,0,0,0,0,0,0,0,0,0,0,0,0,0,0,0,0,0,0,0,0,0,0,0,0,0,0,0,0,0,0,0,0,0,0,0,0,0,0,0,0,0,0,0,0,0,Konstantinos Fortounis,£2.25m ,28,183,Midfielder - Attacking Midfield,both,Olympiacos Piraeus,26,1,2,783,30,0,5,1907,26,3,4,1665,21,0,1,697,37,10,5,1653,39,21,17,2761,40,8,8,3044,37,11,14,2475,43,17,16,3300,Bundesliga,21,3,4,1093,6,1,2,228
13/6/2011,Kevin Volland,91014650,771,7/30/1992,18,0,0,0,0,4500,6050,6050,145,121,2475485,179,75,AM/S RL,1,3,3,1,3,1,3,3,2,1,3,6,11,12,13,14,5,13,6,3,4,11,9,5,15,10,10,11,12,10,9,11,16,12,6,14,6,11,8,15,14,12,10,20,11,14,8,13,11,13,8,6,3,15,4,15,12,17,14,5,11,3,1,1,14,18,15,18,11,AM/S RL,625,1,1,20,11,18,15,1,1,1,1,1,14,12,1,1,0,0,0,0,0,0,0,0,0,0,0,0,0,0,0,0,0,0,0,0,0,0,0,0,0,0,0,0,0,0,0,0,0,0,0,0,0,0,0,0,0,0,0,0,0,0,0,0,0,,,,,,,,,,,,,,,,,,,,,,,,,,,,,,,,,,,,,,,,,,,,,,,,,,,,
13/6/2011,Kelvin,19144895,1651,6/1/1993,18,0,0,0,0,1500,5500,5500,146,108,3999999,175,71,AM/S LC,3,2,2,3,2,3,1,7,1,1,3,12,14,16,12,16,11,4,12,4,4,13,13,5,15,6,13,10,13,11,11,9,11,16,6,13,5,6,11,15,14,5,5,20,13,14,3,7,5,10,6,10,9,12,12,12,9,13,9,5,11,7,1,1,1,18,10,17,18,AM/S LC,624,1,1,20,18,17,10,1,1,1,1,1,1,1,1,1,2.25183E+15,0,0,0,0,1,0,0,0,0,0,0,0,0,0,0,0,0,0,0,0,0,0,0,0,0,0,0,0,0,0,0,0,0,0,0,1,0,0,0,0,0,0,0,0,0,0,0,0,Kelvin,£1.80m ,27,175,Forward - Right Winger,left,Botafogo de Futebol e Regatas,4,1,0,324,27,2,2,1449,24,5,1,1382,23,1,2,1196,24,2,8,1464,35,2,3,2415,6,0,1,302,22,1,4,902,10,1,0,401,Liga NOS,6,0,0,346,nan,nan,nan,nan
13/6/2011,Jules Schwadorf,91014710,771,10/19/1992,18,0,0,0,0,2000,4600,4600,104,92,567407,177,71,WB/M L,2,3,3,2,3,2,2,1,1,3,1,9,13,12,4,14,7,7,11,3,7,10,8,12,9,11,12,6,9,11,9,6,10,11,7,5,8,8,12,14,14,14,8,20,16,14,8,10,6,10,13,5,14,10,10,15,14,12,12,11,16,6,15,16,20,12,1,20,1,WB/M L,423,1,1,1,1,12,1,1,15,1,1,1,20,1,16,1,0,0,0,0,0,0,0,0,0,0,0,0,0,0,0,0,0,0,0,0,0,0,0,0,0,0,0,0,0,0,0,0,0,0,0,0,0,0,0,0,0,0,0,0,0,0,0,0,0,,,,,,,,,,,,,,,,,,,,,,,,,,,,,,,,,,,,,,,,,,,,,,,,,,,,
13/6/2011,Joel Campbell,80010074,366,6/26/1992,18,19,4,0,0,5500,5250,5250,125,107,7540707,178,70,AM/S RL,3,1,2,2,3,1,1,1,3,3,3,10,13,8,10,13,9,9,11,6,4,6,9,7,13,17,8,7,13,9,8,9,12,11,12,12,5,7,10,13,13,13,7,20,12,13,10,6,3,9,6,9,11,9,11,12,11,10,13,13,10,10,1,1,9,20,20,20,1,AM/S RL,515,1,1,20,1,20,20,1,1,1,1,1,9,1,1,1,0,0,0,0,0,0,0,0,0,0,0,0,0,0,0,0,0,0,0,0,0,0,0,0,0,0,0,0,0,0,0,0,0,0,0,0,0,0,0,0,0,0,0,0,0,0,0,0,0,Joel Campbell,£1.35m ,28,178,Forward - Right Winger,left,Club León FC,8,0,0,416,27,4,3,1252,33,2,3,1889,43,11,11,3185,33,1,1,1832,31,4,6,1696,29,3,4,1246,9,2,1,232,38,4,4,2399,Ligue 1,23,1,3,1210,14,0,0,525
13/6/2011,Jeffrey Schlupp,29045055,771,12/23/1992,18,0,0,0,0,1600,2000,4800,131,96,2232442,173,70,AM/S L,2,1,1,3,2,1,1,1,2,2,3,4,8,10,10,8,4,6,7,3,3,7,9,6,8,7,7,5,8,7,7,8,10,9,5,10,6,8,12,14,11,7,5,20,10,16,10,8,9,10,5,10,6,7,14,10,10,10,10,10,10,3,7,7,14,17,1,17,1,AM/S L,623,1,1,20,1,17,1,1,7,1,1,1,14,1,7,1,0,0,0,0,0,0,0,0,0,0,0,0,0,0,0,0,0,0,0,0,0,0,0,0,0,0,0,0,0,0,0,0,0,0,0,0,0,0,0,0,0,0,0,0,0,0,0,0,0,,,,,,,,,,,,,,,,,,,,,,,,,,,,,,,,,,,,,,,,,,,,,,,,,,,,
13/6/2011,Jean-Christophe Bahebeck,85057300,769,5/1/1993,18,0,0,0,0,4000,5000,5000,134,111,4730963,182,76,AM RL,1,2,1,2,3,3,3,1,2,2,2,9,9,12,11,10,11,12,13,5,3,8,10,2,13,6,12,10,11,9,7,9,14,14,6,12,4,8,9,14,13,13,11,12,13,16,20,10,13,13,6,14,10,12,7,14,15,13,15,13,13,6,1,1,10,20,15,20,1,AM RL,505,1,1,12,1,20,15,1,1,1,1,1,10,10,1,1,5.49756E+11,0,0,0,0,0,0,0,0,0,1,0,0,0,0,0,0,0,0,0,0,0,0,0,0,0,0,0,0,0,0,0,0,0,0,0,0,0,0,0,1,0,0,0,0,0,0,0,0,Jean-Christophe Bahebeck,£1.35m ,27,182,Forward - Centre-Forward,right,FK Partizan Belgrade,13,1,1,281,15,2,1,402,33,6,3,1728,21,2,1,1259,24,3,5,868,24,3,0,1183,15,4,1,822,7,3,1,372,15,5,6,814,Ligue 1,19,5,1,767,1,0,0,37
13/6/2011,Iker Muniain,67037570,796,12/19/1992,18,0,0,0,0,4650,6750,6750,164,139,24000000,169,63,AM/S LC,1,3,2,2,1,3,2,5,3,2,3,6,12,16,14,13,7,8,10,3,3,12,10,6,17,13,14,14,12,13,13,14,14,17,11,14,3,10,13,17,15,14,5,9,12,14,20,11,11,12,7,11,6,11,13,17,13,12,11,7,9,13,1,1,11,18,11,18,15,AM/S LC,624,1,1,20,15,18,11,1,1,1,1,1,11,1,1,1,7.04031E+13,0,0,1,0,0,0,0,0,0,0,0,0,0,0,0,0,0,0,0,0,0,0,0,0,0,0,0,0,0,0,0,0,0,0,0,1,0,0,0,0,0,0,0,0,0,0,1,0,Iker Muniain,£18.00m ,27,169,Forward - Left Winger,right,Athletic Bilbao,38,5,3,2629,58,9,8,4717,43,2,3,2868,39,9,4,3021,41,2,4,3245,28,2,1,1364,46,7,5,3150,20,5,4,1298,37,7,5,2543,LaLiga,37,6,2,2868,6,0,0,409
13/6/2011,Felix Stemmer,92037895,771,3/2/1993,18,0,0,0,0,1750,3250,3250,106,65,125007,178,70,M/AM RL,1,1,2,3,1,3,3,1,1,1,2,9,11,8,9,12,8,8,5,5,8,7,8,4,12,12,9,4,6,4,5,5,10,11,2,8,3,9,12,11,9,6,6,20,11,9,16,8,4,6,17,6,7,9,6,20,5,8,10,13,17,9,1,1,20,18,15,20,1,M/AM RL,415,1,1,1,1,18,12,1,1,1,1,1,20,15,1,1,0,0,0,0,0,0,0,0,0,0,0,0,0,0,0,0,0,0,0,0,0,0,0,0,0,0,0,0,0,0,0,0,0,0,0,0,0,0,0,0,0,0,0,0,0,0,0,0,0,,,,,,,,,,,,,,,,,,,,,,,,,,,,,,,,,,,,,,,,,,,,,,,,,,,,
13/6/2011,Felix Klaus,91016409,771,9/13/1992,18,0,0,0,0,1600,5700,5700,146,115,4243668,179,72,M/AM RL,1,1,1,2,1,2,1,9,2,1,3,6,11,12,11,11,7,11,10,5,4,11,10,8,11,12,12,13,10,9,12,11,14,13,6,11,7,14,10,16,13,9,9,11,9,16,20,7,7,9,8,10,9,10,14,13,13,15,15,13,14,10,1,1,18,20,20,19,14,M/AM RL,525,1,1,14,14,19,20,1,1,1,1,1,16,18,1,1,2.25235E+15,0,0,0,0,0,0,0,0,0,0,0,0,0,0,0,0,0,0,0,0,0,0,0,0,0,0,0,0,0,0,0,0,0,0,0,0,0,0,0,1,0,0,0,0,0,0,0,0,,,,,,,,,,,,,,,,,,,,,,,,,,,,,,,,,,,,,,,,,,,,,,,,,,,,
13/6/2011,Fábio Nunes,55024262,788,7/24/1992,18,0,0,0,0,1500,3500,3500,112,75,103736,180,75,AM L,3,1,2,2,1,3,2,2,1,1,2,10,11,12,8,12,8,6,9,6,5,9,9,5,12,8,10,9,9,9,9,9,10,14,7,11,6,8,8,11,10,7,7,20,10,11,5,8,8,10,6,10,12,10,5,14,10,14,7,13,11,5,1,1,10,20,1,20,7,AM L,503,1,1,7,7,20,1,1,1,1,1,1,10,1,1,1,0,0,0,0,0,0,0,0,0,0,0,0,0,0,0,0,0,0,0,0,0,0,0,0,0,0,0,0,0,0,0,0,0,0,0,0,0,0,0,0,0,0,0,0,0,0,0,0,0,Fábio Luis,£360Th. ,37,185,Forward - Centre-Forward,right,Retired,nan,nan,nan,nan,17,2,1,429,nan,nan,nan,nan,nan,nan,nan,nan,nan,nan,nan,nan,nan,nan,nan,nan,nan,nan,nan,nan,nan,nan,nan,nan,nan,nan,nan,nan,Liga NOS,nan,nan,nan,nan,nan,nan,nan,nan
13/6/2011,David Alaba,16010162,755,6/24/1992,18,10,0,5,0,5750,6250,6450,154,131,34925978,178,72,M LC,3,1,2,1,2,3,2,3,3,1,1,10,14,12,7,16,13,5,10,9,9,15,11,11,15,7,9,10,13,9,13,12,19,14,11,10,8,12,15,14,16,15,9,20,18,16,9,13,12,10,8,16,6,16,15,17,8,16,16,16,16,6,12,14,20,14,1,18,20,M LC,404,1,1,1,14,14,1,1,12,1,14,20,18,1,14,1,4194304,0,0,0,0,0,0,0,0,0,0,0,0,0,0,0,0,0,0,0,0,0,0,1,0,0,0,0,0,0,0,0,0,0,0,0,0,0,0,0,0,0,0,0,0,0,0,0,0,David Alaba,£14.40m ,28,180,Defender - Centre-Back,left,Bayern Munich,31,2,3,2474,47,3,3,2787,38,5,6,3195,49,4,9,4241,29,5,3,2556,46,2,4,4022,47,5,7,3799,36,2,6,2638,43,3,7,3631,Bundesliga,42,2,2,3693,6,0,1,562
13/6/2011,Connor Wickham,28030306,765,3/31/1993,18,0,0,3,0,3900,6215,6500,153,113,114999996,191,90,S RL,1,2,3,2,1,3,3,2,2,1,3,4,8,13,12,14,2,11,5,18,3,13,12,8,12,10,8,12,10,10,11,12,15,10,9,12,10,12,12,13,10,10,15,8,12,14,20,7,17,10,3,12,9,10,10,15,14,10,12,10,12,6,1,1,1,15,15,15,1,S RL,605,1,1,20,1,15,15,1,1,1,1,1,1,1,1,1,1.1259E+15,0,0,1,0,0,0,0,0,0,1,0,0,0,0,0,0,0,0,0,0,0,0,0,0,0,0,0,0,0,0,0,0,0,0,0,0,0,0,0,0,0,0,0,0,0,0,0,0,Connor Wickham,£5.40m ,27,189,Forward - Centre-Forward,right,Crystal Palace,41,9,2,2727,19,1,1,670,25,7,0,1282,36,15,7,2531,40,6,1,2974,24,6,3,1586,10,3,0,545,nan,nan,nan,nan,8,1,1,159,Premier League,21,3,1,1135,nan,nan,nan,nan
13/6/2011,Carles Gil,67103542,796,11/22/1992,18,0,0,0,0,2800,5000,5000,135,101,1762457,170,69,M/AM L,2,3,2,1,1,1,3,7,2,2,1,12,13,13,6,11,11,5,7,10,5,15,8,5,15,7,11,6,10,10,15,13,9,14,7,15,5,14,9,12,15,5,5,20,9,13,4,11,6,10,15,10,5,10,13,14,15,13,10,5,9,14,1,1,17,20,1,20,13,M/AM L,523,1,1,1,13,20,1,1,1,1,1,5,17,1,1,1,0,0,0,0,0,0,0,0,0,0,0,0,0,0,0,0,0,0,0,0,0,0,0,0,0,0,0,0,0,0,0,0,0,0,0,0,0,0,0,0,0,0,0,0,0,0,0,0,0,,,,,,,,,,,,,,,,,,,,,,,,,,,,,,,,,,,,,,,,,,,,,,,,,,,,
13/6/2011,Cameron Park,28022930,793,7/6/1992,18,0,0,0,0,1750,4200,4200,117,84,1702059,178,76,AM RL,2,3,1,2,3,2,1,1,3,3,1,7,11,13,10,11,9,6,9,3,5,11,10,6,9,12,11,10,8,9,10,8,12,12,4,11,3,5,8,14,14,7,7,20,11,13,7,8,5,9,10,10,14,9,13,10,11,10,15,17,6,7,1,1,14,20,19,20,10,AM RL,505,1,1,13,10,20,19,1,1,1,1,8,14,10,1,1,0,0,0,0,0,0,0,0,0,0,0,0,0,0,0,0,0,0,0,0,0,0,0,0,0,0,0,0,0,0,0,0,0,0,0,0,0,0,0,0,0,0,0,0,0,0,0,0,0,,,,,,,,,,,,,,,,,,,,,,,,,,,,,,,,,,,,,,,,,,,,,,,,,,,,
13/6/2011,Sissoko,55024969,24,11/29/1991,19,0,0,3,0,2250,4500,4500,131,90,930098,177,67,AM RL,3,3,2,3,3,1,1,1,1,3,1,11,12,13,11,13,10,6,10,6,6,11,11,6,14,9,9,8,9,8,11,9,8,15,7,12,6,9,10,13,13,9,8,20,13,13,5,9,8,7,8,10,8,10,13,15,9,13,9,13,12,10,1,1,10,20,17,20,13,AM RL,505,1,1,5,13,20,17,1,1,1,1,1,10,1,1,1,1.81763E+13,0,0,0,0,0,0,0,1,0,0,0,0,0,0,0,0,0,0,0,0,0,0,0,0,0,0,0,0,0,0,0,0,0,0,0,1,0,0,0,1,0,0,0,0,1,0,0,0,,,,,,,,,,,,,,,,,,,,,,,,,,,,,,,,,,,,,,,,,,,,,,,,,,,,
13/6/2011,Salvador Agra,55021884,788,11/11/1991,19,0,0,0,0,1000,4500,4500,131,100,3233685,166,60,AM RL,1,3,1,2,3,3,2,2,2,3,2,9,10,12,11,12,8,4,9,5,5,9,10,6,11,10,11,11,7,7,7,7,14,14,5,12,5,8,9,14,13,7,6,10,13,13,20,7,7,9,8,8,8,12,12,13,15,13,14,15,15,6,1,1,9,20,20,20,5,AM RL,505,1,1,7,5,20,20,1,1,1,1,1,9,1,1,1,0,0,0,0,0,0,0,0,0,0,0,0,0,0,0,0,0,0,0,0,0,0,0,0,0,0,0,0,0,0,0,0,0,0,0,0,0,0,0,0,0,0,0,0,0,0,0,0,0,Salvador Agra,£720Th. ,28,166,Forward - Right Winger,right,CD Tondela,36,2,0,2218,31,4,4,2335,23,1,3,1095,27,4,2,1342,35,4,4,1287,41,13,14,3167,31,3,4,2535,36,3,3,2545,15,0,1,632,Liga NOS,6,0,0,292,5,0,1,431
13/6/2011,Robbie Brady,28019284,789,1/14/1992,19,0,0,2,0,1900,5250,5800,133,97,2632349,176,73,AM LC,1,3,1,2,3,2,2,3,3,2,3,8,12,14,10,12,14,4,12,2,4,10,13,5,12,15,6,11,7,9,8,8,16,14,8,11,5,10,12,16,8,12,9,20,12,15,9,7,12,13,14,7,14,12,20,12,12,12,12,12,8,10,10,10,15,20,12,20,15,AM LC,504,1,1,10,15,20,12,1,10,1,1,15,15,8,10,1,2.25195E+15,0,0,0,1,0,0,0,0,0,0,0,0,0,0,0,0,0,0,0,0,0,0,0,0,0,0,0,0,0,0,0,0,0,0,1,0,0,1,0,0,0,0,0,0,0,0,0,0,Robbie Blake,£450Th. ,44,175,Forward - Second Striker,nan,Retired,12,1,0,390,8,0,0,502,14,1,0,558,nan,nan,nan,nan,nan,nan,nan,nan,nan,nan,nan,nan,nan,nan,nan,nan,nan,nan,nan,nan,nan,nan,nan,nan,Premier League,nan,nan,nan,nan,nan,nan,nan,nan
13/6/2011,Renato Santos,55012992,788,10/5/1991,19,0,0,0,0,1000,3750,3750,95,85,271283,175,67,AM RL,2,1,2,3,1,1,2,1,2,3,3,10,10,12,10,13,9,5,8,5,6,10,10,5,13,13,9,12,7,7,10,10,8,13,8,12,8,8,9,12,10,6,7,7,13,11,20,7,6,11,10,11,14,12,6,14,14,9,12,11,10,5,1,1,9,20,20,15,5,AM RL,505,1,1,10,5,15,20,1,1,1,1,1,1,9,1,1,0,0,0,0,0,0,0,0,0,0,0,0,0,0,0,0,0,0,0,0,0,0,0,0,0,0,0,0,0,0,0,0,0,0,0,0,0,0,0,0,0,0,0,0,0,0,0,0,0,Renato Neto,£990Th. ,29,184,Midfielder - Defensive Midfield,right,KMSK Deinze,45,5,4,3540,30,2,3,2159,41,1,3,2986,39,4,4,3113,39,7,0,2854,49,3,2,4088,35,7,1,3075,nan,nan,nan,nan,1,0,0,0,Liga NOS,11,0,0,600,4,0,0,305
13/6/2011,Palhinhas,55037387,788,2/18/1992,19,0,0,0,0,50,800,1100,117,47,3035,175,0,AM L,2,2,3,3,2,2,3,1,3,2,2,7,11,11,4,11,3,3,4,7,2,4,1,4,11,5,4,3,7,6,9,5,9,11,1,1,3,13,10,11,11,11,7,20,15,11,7,5,2,7,12,10,17,10,11,7,12,11,14,15,12,3,1,1,9,20,1,20,1,AM L,503,1,1,1,1,20,1,1,1,1,1,1,9,1,1,1,0,0,0,0,0,0,0,0,0,0,0,0,0,0,0,0,0,0,0,0,0,0,0,0,0,0,0,0,0,0,0,0,0,0,0,0,0,0,0,0,0,0,0,0,0,0,0,0,0,,,,,,,,,,,,,,,,,,,,,,,,,,,,,,,,,,,,,,,,,,,,,,,,,,,,
13/6/2011,Pablo Sarabia,67045428,796,5/11/1992,19,0,0,0,0,4050,6050,6050,177,124,37290959,177,72,M/AM LC,2,2,3,3,2,1,2,1,3,2,3,13,15,16,11,15,12,8,10,5,4,15,12,6,17,10,11,9,12,8,15,11,10,16,8,14,5,11,9,15,16,9,7,20,12,13,8,11,8,10,9,15,10,9,8,9,12,10,14,12,5,18,1,1,16,20,13,20,18,M/AM LC,524,1,1,10,18,20,13,1,1,1,1,15,16,9,1,1,2192,0,0,0,0,1,0,0,1,0,0,0,1,0,0,0,0,0,0,0,0,0,0,0,0,0,0,0,0,0,0,0,0,0,0,0,0,0,0,0,0,0,0,0,0,0,0,0,0,Pablo Sarabia,£2.25m ,28,174,Forward - Right Winger,left,Paris Saint-Germain,34,12,4,2628,20,0,1,983,16,2,0,629,36,2,6,2141,41,4,7,2927,32,7,6,2553,46,11,12,2809,53,9,9,3753,52,23,17,3729,LaLiga,40,14,8,2409,9,1,4,464
13/6/2011,Nicky Ajose,28010492,765,10/7/1991,19,0,0,0,0,1950,4500,4500,140,87,3030139,178,73,AM/S RL,3,2,3,1,2,2,3,5,2,3,1,11,8,11,11,10,5,5,4,4,2,7,4,3,10,3,9,5,9,8,7,10,15,13,2,12,5,11,11,14,11,9,7,10,13,14,20,9,7,10,3,5,3,15,12,11,6,9,16,10,14,2,6,1,8,18,17,18,10,AM/S RL,625,1,1,20,10,18,17,1,6,1,1,1,8,6,1,1,34359738368,0,0,0,0,0,0,0,0,0,0,0,0,0,0,0,0,0,0,0,0,0,0,0,0,0,0,0,0,0,0,0,0,0,0,0,1,0,0,0,0,0,0,0,0,0,0,0,0,,,,,,,,,,,,,,,,,,,,,,,,,,,,,,,,,,,,,,,,,,,,,,,,,,,,
13/6/2011,Mario Götze,35017438,771,6/3/1992,19,6,0,2,0,7500,7700,7700,182,155,114999996,176,64,AM RLC,1,2,3,3,1,3,2,7,3,1,2,12,13,17,9,18,12,10,9,4,5,17,11,7,18,11,16,11,12,8,17,17,14,18,7,17,7,15,14,17,18,14,8,9,13,13,20,12,8,14,7,14,11,15,11,13,13,11,14,10,8,7,1,1,14,20,19,20,19,AM RLC,506,1,1,12,19,20,19,1,1,1,10,13,14,14,1,1,5.49774E+11,0,0,0,0,1,0,0,1,0,0,0,0,0,0,0,0,0,0,0,0,1,0,0,0,1,0,0,0,0,0,0,0,0,0,0,0,0,0,0,1,0,0,0,0,0,0,0,0,Mario Götze,£27.00m ,28,176,Midfielder - Attacking Midfield,right,PSV Eindhoven,41,8,16,3055,26,7,8,1818,44,16,20,3231,45,15,13,2807,48,15,7,3362,21,6,4,1279,16,2,2,1175,32,2,7,2202,34,7,7,2266,Bundesliga,21,3,1,609,2,2,0,112
13/6/2011,Koke,67047092,796,1/8/1992,19,0,0,0,0,4000,6150,6150,140,123,30012540,175,72,M/AM LC,1,1,2,2,1,3,3,3,3,3,1,8,13,12,8,13,12,8,13,6,11,15,10,12,15,7,11,12,14,13,14,15,15,13,12,11,10,13,14,10,12,13,8,20,14,12,10,13,10,13,5,12,5,10,8,14,14,13,15,11,12,6,1,1,20,17,10,15,20,M/AM LC,414,1,1,1,17,8,1,1,1,1,14,20,15,10,1,1,4194304,0,0,0,0,0,0,0,0,0,0,0,0,0,0,0,0,0,0,0,0,0,0,1,0,0,0,0,0,0,0,0,0,0,0,0,0,0,0,0,0,0,0,0,0,0,0,0,0,Koke,£3.15m ,28,176,Midfielder - Central Midfield,right,Atlético Madrid,32,4,1,2128,40,2,6,1907,48,3,13,3391,58,7,18,4624,49,4,18,4195,51,5,17,4430,54,5,10,4694,51,6,7,4093,41,6,7,3511,LaLiga,42,5,6,3526,6,0,0,421
13/6/2011,Kévin Malcuit,85067228,769,7/31/1991,19,0,0,0,0,1250,4544,2500,134,101,854175,181,73,AM RL,1,3,1,1,2,1,1,6,3,1,3,7,7,12,8,12,7,5,9,6,2,8,9,3,14,6,9,8,8,8,8,11,14,13,5,13,4,9,13,16,14,12,10,5,14,15,20,12,11,13,6,14,5,8,13,14,13,14,12,15,15,6,1,1,10,20,17,20,1,AM RL,505,1,1,13,1,20,17,1,1,1,1,1,10,10,1,1,2.2518E+15,0,0,0,0,0,0,0,0,0,0,0,0,0,0,0,0,0,0,0,0,0,0,0,0,0,0,0,0,0,0,0,0,0,0,0,0,0,0,0,0,0,0,0,0,0,0,0,0,,,,,,,,,,,,,,,,,,,,,,,,,,,,,,,,,,,,,,,,,,,,,,,,,,,,
13/6/2011,Kervens Belfort,85091724,375,5/16/1992,19,4,0,0,0,1050,3824,2100,107,85,1514786,182,70,AM RL,1,1,1,1,1,1,2,1,2,3,2,9,12,11,8,9,8,3,4,2,6,8,8,5,10,12,9,1,10,6,9,5,7,9,7,7,8,14,11,12,8,10,10,9,9,12,20,8,6,8,9,10,11,8,12,5,13,6,10,14,14,3,1,1,15,20,20,15,1,AM RL,505,1,1,1,1,15,20,1,1,1,1,1,15,15,1,1,0,0,0,0,0,0,0,0,0,0,0,0,0,0,0,0,0,0,0,0,0,0,0,0,0,0,0,0,0,0,0,0,0,0,0,0,0,0,0,0,0,0,0,0,0,0,0,0,0,,,,,,,,,,,,,,,,,,,,,,,,,,,,,,,,,,,,,,,,,,,,,,,,,,,,
13/6/2011,Julián Luque,67103360,796,3/27/1992,19,0,0,1,0,3500,5500,5500,156,113,13865441,175,73,M/AM RLC,2,3,1,1,1,3,1,4,3,3,1,12,12,13,12,12,11,5,11,5,3,13,11,5,15,6,8,8,13,12,14,13,12,15,6,13,6,11,11,13,12,7,7,13,12,13,20,10,7,13,4,13,6,12,12,13,12,11,14,18,17,5,1,1,18,20,18,20,15,M/AM RLC,526,1,1,6,15,20,18,1,1,1,1,1,18,17,1,1,8,0,0,0,1,0,0,0,0,0,0,0,0,0,0,0,0,0,0,0,0,0,0,0,0,0,0,0,0,0,0,0,0,0,0,0,0,0,0,0,0,0,0,0,0,0,0,0,0,Julián Luque,£450Th. ,28,176,Midfielder - Attacking Midfield,right,Cultural Leonesa,7,0,1,220,17,0,0,691,7,0,0,143,16,1,0,657,35,2,0,2288,36,1,0,2343,38,4,0,2707,34,2,0,2444,36,6,0,3236,LaLiga,26,3,3,1570,1,0,0,10
13/6/2011,Juan Muńiz,67101569,796,3/14/1992,19,0,0,0,0,2500,4750,4750,134,99,1613373,177,73,M/AM LC,2,3,2,1,3,1,2,1,3,1,1,12,10,12,7,12,17,9,7,9,7,12,3,11,13,9,10,6,7,6,13,11,10,13,5,9,4,10,11,13,11,8,7,20,17,13,10,6,3,10,6,6,6,10,9,10,16,13,14,7,8,10,1,1,16,20,5,20,16,M/AM LC,524,1,1,1,16,20,5,1,1,1,1,1,16,5,1,1,0,0,0,0,0,0,0,0,0,0,0,0,0,0,0,0,0,0,0,0,0,0,0,0,0,0,0,0,0,0,0,0,0,0,0,0,0,0,0,0,0,0,0,0,0,0,0,0,0,Juan Muñiz, ,28,175,Midfielder - Attacking Midfield,left,Atromitos Athen,37,7,0,2798,31,8,1,2486,22,3,2,1156,21,3,2,896,30,3,5,1048,20,1,4,653,27,4,2,1872,24,1,1,1165,25,2,4,1167,LaLiga,32,5,4,2604,4,0,0,106
13/6/2011,James Rodríguez,76002390,1653,7/12/1991,19,0,0,11,3,5250,6500,7050,167,141,19863154,180,78,M/AM LC,3,2,3,2,1,3,2,4,3,3,3,15,16,16,13,16,14,6,15,6,8,15,14,7,16,9,12,11,13,11,12,12,16,15,9,14,9,11,10,15,17,13,7,20,13,15,8,11,11,8,5,10,8,15,15,16,12,14,15,15,17,10,1,1,16,20,14,17,20,M/AM LC,524,1,1,3,20,17,14,1,1,1,10,13,16,10,1,1,34896610048,0,0,0,0,0,0,0,0,1,1,0,0,0,0,0,0,0,0,0,0,0,0,0,0,0,0,0,0,0,1,0,0,0,0,0,1,0,0,0,0,0,0,0,0,0,0,0,0,James Rodríguez,£11.70m ,29,181,Midfielder - Attacking Midfield,left,Everton FC,32,6,18,1859,38,14,11,2600,38,12,12,2781,38,10,14,2898,46,17,18,3526,32,8,10,1889,33,11,12,1884,39,8,14,2643,28,7,6,1654,Liga NOS,14,1,2,758,7,3,4,602
13/6/2011,Gökhan Töre,35017569,799,1/20/1992,19,0,0,2,0,4750,6400,6550,141,119,23703491,176,80,AM RLC,3,1,1,2,2,2,2,3,3,2,3,13,15,16,9,12,13,3,10,6,3,14,9,5,15,14,7,15,8,7,8,7,10,17,4,8,5,3,10,17,17,16,6,20,12,14,14,10,12,10,13,15,8,5,10,17,6,8,7,6,5,14,1,1,15,20,17,20,18,AM RLC,506,1,1,14,18,20,17,1,1,1,1,8,15,10,1,1,2.39312E+15,0,0,0,0,0,0,0,0,0,0,0,0,0,0,0,0,0,0,0,0,0,0,0,0,0,0,0,0,0,0,1,0,0,0,0,1,0,0,0,1,0,0,0,0,0,0,0,1,Gökhan Töre,£4.50m ,28,176,Forward - Right Winger,left,Besiktas JK,16,3,1,1374,24,0,6,1642,7,0,0,278,33,4,8,2329,43,9,11,3425,35,6,9,2164,8,0,1,449,1,0,0,8,8,0,1,210,Bundesliga,28,2,5,1792,3,1,0,141
13/6/2011,Gaël Kakuta,34001371,769,6/21/1991,19,0,0,0,0,5000,5400,6150,164,120,13048179,173,65,AM RLC,1,2,3,2,3,1,1,1,3,1,2,8,11,16,12,15,12,7,13,1,2,9,14,2,17,5,12,9,13,12,15,11,12,17,4,11,8,9,10,15,13,12,7,20,14,14,6,10,10,12,2,12,5,8,15,15,11,15,16,13,18,5,1,1,9,20,15,18,20,AM RLC,506,1,1,12,20,18,15,1,1,1,1,9,1,1,1,1,51539607808,0,0,0,0,0,0,0,0,1,0,0,0,0,0,0,0,0,0,0,0,0,0,0,0,0,0,0,0,0,0,0,0,0,0,1,1,0,0,0,0,0,0,0,0,0,0,0,0,Gaël Kakuta,£3.60m ,29,173,Midfielder - Attacking Midfield,left,RC Lens,21,1,1,742,24,6,1,1606,29,2,6,2335,20,4,0,679,35,5,7,3061,29,3,4,1679,10,2,1,542,38,6,6,3198,12,1,0,720,Premier League,24,2,5,2010,7,4,1,519
13/6/2011,Florian Trinks,92002691,771,3/11/1992,19,0,0,0,0,3250,5250,5750,134,108,7917370,185,74,M/AM RLC,1,2,3,1,1,2,1,5,1,1,1,13,14,16,10,14,16,6,14,6,4,11,12,5,14,13,10,7,8,7,12,6,5,15,3,14,5,7,11,14,13,7,10,13,12,12,20,10,9,8,14,13,10,13,9,18,8,12,6,3,5,18,1,1,17,20,19,19,20,M/AM RLC,526,1,1,13,20,19,19,1,1,1,5,17,15,15,1,1,0,0,0,0,0,0,0,0,0,0,0,0,0,0,0,0,0,0,0,0,0,0,0,0,0,0,0,0,0,0,0,0,0,0,0,0,0,0,0,0,0,0,0,0,0,0,0,0,0,Florian Trinks,£540Th. ,28,185,Midfielder - Attacking Midfield,right,Without Club,14,0,2,743,23,1,0,1593,22,4,9,1797,32,4,7,1626,20,1,0,932,17,1,2,773,13,4,2,879,10,1,1,529,24,9,4,1771,Bundesliga,nan,nan,nan,nan,nan,nan,nan,nan
13/6/2011,Flamur Kastrati,53024848,786,11/14/1991,19,0,0,1,0,3000,5219,5800,139,116,5682536,185,75,AM/S RLC,2,2,2,2,2,1,2,2,3,2,2,6,8,14,10,13,8,11,8,4,5,10,10,5,13,12,11,12,11,8,9,10,8,11,5,14,7,11,13,16,15,11,12,8,11,12,20,11,12,11,6,10,8,12,18,13,10,6,6,11,8,12,1,1,14,18,15,18,15,AM/S RLC,626,1,1,20,15,18,15,1,1,1,1,10,14,14,1,1,0,0,0,0,0,0,0,0,0,0,0,0,0,0,0,0,0,0,0,0,0,0,0,0,0,0,0,0,0,0,0,0,0,0,0,0,0,0,0,0,0,0,0,0,0,0,0,0,0,,,,,,,,,,,,,,,,,,,,,,,,,,,,,,,,,,,,,,,,,,,,,,,,,,,,
13/6/2011,Erik Lamela,14005628,1649,3/4/1992,19,1,0,0,0,5000,6250,6250,162,130,47341335,183,73,AM LC,1,1,3,2,2,3,1,1,2,2,3,13,12,16,11,15,14,3,12,4,4,13,13,8,17,13,10,11,14,10,13,11,14,18,5,15,9,10,12,14,15,10,9,20,14,14,10,10,9,12,12,11,6,16,8,14,12,11,14,9,11,7,1,1,15,20,1,17,20,AM LC,504,1,1,7,20,17,1,1,1,1,1,9,15,1,1,1,2.25194E+15,0,0,0,0,0,0,0,0,0,0,0,0,0,0,0,0,0,0,0,0,0,0,0,0,0,0,0,0,0,0,1,0,0,0,0,0,0,1,0,0,0,0,0,0,0,0,0,0,Erik Lamela,£13.05m ,28,184,Forward - Right Winger,left,Tottenham Hotspur,34,4,6,2756,31,6,7,2048,36,15,6,2857,17,1,4,951,46,5,10,2919,44,11,10,3072,14,2,7,944,34,4,7,1380,33,6,3,1550,Serie A,35,4,6,1659,7,2,0,347
13/6/2011,Coutinho,19046041,1651,6/12/1992,19,1,0,7,3,4500,5759,6400,147,128,28869324,172,64,AM LC,2,2,3,3,1,3,1,7,2,1,1,12,12,16,11,16,14,4,12,3,4,15,10,5,16,11,11,9,10,12,16,13,13,18,5,13,8,14,14,15,16,8,6,10,12,12,20,12,8,12,10,12,9,12,16,16,6,13,18,14,16,8,1,1,12,20,13,17,20,AM LC,504,1,1,10,20,17,13,1,1,1,1,12,10,8,1,1,1048576,0,0,0,0,0,0,0,0,0,0,0,0,0,0,0,0,0,0,0,0,1,0,0,0,0,0,0,0,0,0,0,0,0,0,0,0,0,0,0,0,0,0,0,0,0,0,0,0,,,,,,,,,,,,,,,,,,,,,,,,,,,,,,,,,,,,,,,,,,,,,,,,,,,,
13/6/2011,Christopher Buchtmann,35017431,771,4/25/1992,19,0,0,0,0,2000,4500,4500,117,95,2826529,175,72,AM L,3,1,1,3,1,3,1,1,2,3,2,8,12,12,9,9,12,8,9,6,6,12,13,9,11,8,9,8,10,10,11,11,10,14,7,12,8,10,11,13,11,10,8,20,12,12,8,11,10,10,5,14,5,12,15,15,7,7,10,12,9,6,8,10,14,20,12,20,1,AM L,503,1,1,1,1,20,12,1,8,8,1,1,14,10,10,8,32,0,0,0,0,0,1,0,0,0,0,0,0,0,0,0,0,0,0,0,0,0,0,0,0,0,0,0,0,0,0,0,0,0,0,0,0,0,0,0,0,0,0,0,0,0,0,0,0,Christopher Buchtmann,£270Th. ,28,175,Midfielder - Central Midfield,left,FC St. Pauli,19,1,7,1137,13,1,2,979,17,0,3,1067,28,0,6,2343,18,2,1,1508,30,1,2,2544,32,6,3,2620,18,4,3,1419,24,5,4,1920,Bundesliga,13,0,0,450,nan,nan,nan,nan
13/6/2011,Christian Clemens,35014354,771,8/4/1991,19,0,0,1,0,4000,6100,6100,150,122,45050543,180,81,AM RL,1,3,1,1,3,2,3,1,1,1,1,12,13,12,8,12,11,8,10,10,7,12,10,8,13,14,8,9,9,10,10,8,11,12,7,13,7,10,12,15,14,13,9,10,9,16,20,14,9,7,7,9,9,13,5,12,14,8,12,11,12,5,1,5,15,20,20,17,11,AM RL,505,1,1,5,11,17,20,1,1,1,5,9,10,15,3,5,0,0,0,0,0,0,0,0,0,0,0,0,0,0,0,0,0,0,0,0,0,0,0,0,0,0,0,0,0,0,0,0,0,0,0,0,0,0,0,0,0,0,0,0,0,0,0,0,0,Christian Clemens,£2.70m ,29,179,Midfielder - Right Midfield,right,1. FC Köln,31,2,4,2048,33,5,3,2167,33,7,5,2563,18,0,2,885,19,1,0,753,29,6,5,1800,18,1,1,1222,20,2,1,914,21,2,7,1461,Bundesliga,1,0,0,15,2,0,0,154
13/6/2011,Christian Atsu,55038591,21,1/10/1992,19,0,0,0,0,2250,4500,4250,150,85,796345,172,68,AM L,3,1,2,1,1,3,1,1,3,1,3,11,12,13,10,12,9,4,8,4,4,9,10,7,13,10,13,9,12,12,10,13,15,15,8,12,5,7,9,12,12,7,4,20,14,12,5,8,9,11,6,12,8,10,15,14,16,14,18,17,18,5,1,1,9,20,10,20,7,AM L,503,1,1,7,7,20,10,1,1,1,1,1,9,1,1,1,0,0,0,0,0,0,0,0,0,0,0,0,0,0,0,0,0,0,0,0,0,0,0,0,0,0,0,0,0,0,0,0,0,0,0,0,0,0,0,0,0,0,0,0,0,0,0,0,0,Christian Atsu,£1.80m ,28,165,Forward - Left Winger,left,Newcastle United,0,0,0,0,31,6,4,2401,31,1,4,1103,30,5,6,2477,13,0,2,365,14,2,1,543,35,5,3,1711,29,2,2,1789,32,1,0,1620,Liga NOS,24,0,5,992,1,0,0,10
13/6/2011,Cedric,67052395,53,3/5/1992,19,0,0,0,0,4100,5579,6250,145,124,11416664,167,62,AM RL,3,1,3,1,1,1,3,8,2,3,3,7,10,13,7,9,6,6,5,7,6,9,6,6,11,7,11,12,6,8,10,9,10,15,7,14,11,9,10,17,15,14,4,20,18,16,6,13,8,14,4,12,2,17,16,16,14,10,6,18,17,6,1,1,15,20,17,20,10,AM RL,505,1,1,15,10,20,17,1,1,1,1,1,15,15,1,1,8209,1,0,0,0,1,0,0,0,0,0,0,0,0,1,0,0,0,0,0,0,0,0,0,0,0,0,0,0,0,0,0,0,0,0,0,0,0,0,0,0,0,0,0,0,0,0,0,0,,,,,,,,,,,,,,,,,,,,,,,,,,,,,,,,,,,,,,,,,,,,,,,,,,,,
13/6/2011,Burakcan Kunt,92025972,799,5/15/1992,19,0,0,0,0,1750,4500,4750,121,90,1236105,184,83,M/AM RLC,2,3,2,2,3,2,2,1,3,2,3,9,13,12,6,11,7,9,12,9,7,11,9,11,11,13,9,10,13,7,11,8,9,9,8,13,5,10,12,12,9,7,7,15,13,10,20,9,3,9,14,3,13,12,4,15,10,10,15,15,4,16,1,1,18,20,19,16,20,M/AM RLC,526,1,1,12,20,16,19,1,1,1,1,15,15,18,1,1,0,0,0,0,0,0,0,0,0,0,0,0,0,0,0,0,0,0,0,0,0,0,0,0,0,0,0,0,0,0,0,0,0,0,0,0,0,0,0,0,0,0,0,0,0,0,0,0,0,,,,,,,,,,,,,,,,,,,,,,,,,,,,,,,,,,,,,,,,,,,,,,,,,,,,
13/6/2011,Andrew Halliday,61011716,793,10/11/1991,19,0,0,0,0,2650,4750,4750,127,95,2053679,181,64,AM L,2,3,2,1,2,3,2,3,1,3,2,4,9,13,12,12,7,9,12,2,5,12,7,6,12,9,12,11,7,6,7,10,9,10,5,12,8,7,10,13,12,9,9,20,11,13,10,9,8,10,5,8,5,8,13,10,8,6,11,6,8,7,1,1,9,20,14,20,1,AM L,503,1,1,15,1,20,14,1,1,1,1,1,9,1,1,1,5.49756E+11,1,0,0,0,0,0,0,0,0,0,0,0,0,0,0,0,0,0,0,0,0,0,0,0,0,0,0,0,0,0,0,0,0,0,0,0,0,0,0,1,0,0,0,0,0,0,0,0,,,,,,,,,,,,,,,,,,,,,,,,,,,,,,,,,,,,,,,,,,,,,,,,,,,,
13/6/2011,Aidan White,29038413,789,10/10/1991,19,0,0,0,0,2250,5000,5000,142,102,1326200,178,65,WB/M/AM RL,1,2,3,2,1,1,3,1,3,3,3,9,11,11,8,9,7,10,11,7,9,10,7,11,11,11,10,12,11,10,11,11,12,9,8,10,12,13,13,15,10,10,9,20,10,15,3,10,9,10,8,8,8,9,6,10,10,4,14,14,13,2,14,16,20,17,15,20,1,WB/M/AM RL,435,1,1,1,1,17,13,1,14,1,1,1,20,15,16,1,134217728,0,0,0,0,0,0,0,0,0,0,0,0,0,0,0,0,0,0,0,0,0,0,0,0,0,0,0,1,0,0,0,0,0,0,0,0,0,0,0,0,0,0,0,0,0,0,0,0,,,,,,,,,,,,,,,,,,,,,,,,,,,,,,,,,,,,,,,,,,,,,,,,,,,,
13/6/2011,Adrien Régattin,85044861,769,8/22/1991,19,0,0,0,0,3850,4859,4850,149,108,2856287,166,67,M/AM RL,1,1,2,3,3,2,1,4,2,3,3,10,12,14,6,14,8,5,9,5,1,11,8,2,16,11,8,8,12,12,13,11,10,15,5,14,3,6,9,16,16,8,3,8,14,12,20,12,8,13,9,10,7,10,12,14,14,13,9,14,20,13,1,1,17,20,20,17,10,M/AM RL,525,1,1,1,10,17,20,1,1,1,1,10,17,15,1,1,2.2518E+15,0,0,0,0,0,0,0,0,0,0,0,0,0,0,0,0,0,0,0,0,0,0,0,0,0,0,0,0,0,0,0,0,0,0,0,0,0,0,0,0,0,0,0,0,0,0,0,0,Adrien Regattin,£900Th. ,29,168,Forward - Right Winger,right,Altay SK,4,0,0,50,23,2,6,1287,30,3,0,1337,23,1,1,1036,35,3,6,1795,40,2,5,1941,42,1,3,2838,35,6,2,2478,39,7,3,2350,Ligue 1,11,0,2,689,4,0,1,226
13/6/2011,Adem Ljajic,62012544,802,9/13/1991,19,4,0,10,1,4250,6700,6300,157,128,45480095,181,73,AM LC,2,1,2,1,3,3,3,2,3,3,1,10,14,14,12,14,10,11,12,10,7,14,11,5,15,14,10,12,11,10,13,11,13,15,5,13,12,12,12,15,14,11,12,7,13,14,20,11,10,12,4,11,8,10,14,15,13,14,13,13,11,8,1,1,9,20,14,20,18,AM LC,504,1,1,1,18,20,14,1,1,1,1,8,9,1,1,1,1056,0,0,0,0,0,1,0,0,0,0,1,0,0,0,0,0,0,0,0,0,0,0,0,0,0,0,0,0,0,0,0,0,0,0,0,0,0,0,0,0,0,0,0,0,0,0,0,0,Adem Ljajic,£5.85m ,29,182,Midfielder - Attacking Midfield,right,Besiktas JK,28,3,7,1597,18,1,1,749,31,12,5,1796,33,6,6,1870,41,9,2,2588,29,4,3,1690,36,12,9,2754,28,6,12,2254,33,9,14,2603,Serie A,29,7,7,1995,5,0,0,185
13/6/2011,Yannis Salibur,8434934,769,1/24/1991,20,0,0,0,0,1300,2600,2600,140,105,3711657,176,74,AM LC,1,3,2,3,1,3,3,8,1,2,2,12,12,13,7,13,10,8,8,6,3,9,8,4,15,7,10,10,11,11,11,8,11,14,6,13,5,7,12,17,12,12,8,20,12,13,5,13,12,11,7,14,11,8,11,14,12,7,10,13,13,9,1,1,15,20,1,20,17,AM LC,504,1,1,10,17,20,1,1,1,1,1,12,15,1,1,1,2.2518E+15,0,0,0,0,0,1,0,0,0,0,0,0,0,0,0,0,0,0,0,0,0,0,0,0,0,0,0,0,0,0,0,0,0,0,0,0,0,0,0,0,0,0,0,0,0,0,0,0,,,,,,,,,,,,,,,,,,,,,,,,,,,,,,,,,,,,,,,,,,,,,,,,,,,,
13/6/2011,Wilson Eduardo,55009688,788,7/8/1990,20,0,0,0,0,2500,5500,5500,142,116,2504707,176,72,AM RL,1,2,1,3,3,3,2,2,3,1,1,12,13,13,13,13,10,9,13,6,7,10,13,8,13,11,14,9,14,9,10,11,11,14,8,13,8,9,9,14,13,9,10,11,13,13,20,11,12,10,6,10,10,11,7,10,13,10,14,14,15,5,1,1,9,20,20,17,10,AM RL,505,1,1,10,10,17,20,1,1,1,1,1,1,9,1,1,0,0,0,0,0,0,0,0,0,0,0,0,0,0,0,0,0,0,0,0,0,0,0,0,0,0,0,0,0,0,0,0,0,0,0,0,0,0,0,0,0,0,0,0,0,0,0,0,0,Wilson Eduardo,£1.71m ,30,179,Forward - Left Winger,right,Al-Ain FC,32,5,2,1511,30,7,2,2505,37,11,3,2817,24,5,7,1328,31,3,2,1796,31,6,1,1650,30,8,14,2233,21,8,3,1473,42,16,6,2914,Liga NOS,31,8,2,1352,1,1,0,90
13/6/2011,Victor Moses,5007466,38,12/12/1990,20,0,0,0,0,4500,6300,6700,135,130,18601570,177,75,AM RL,1,1,3,3,2,1,3,8,2,1,1,8,12,14,12,12,9,9,10,16,4,12,9,5,12,7,9,8,12,6,11,7,8,15,6,12,8,9,11,16,13,12,9,13,10,16,20,10,13,5,10,10,13,13,11,14,12,11,11,8,12,7,1,1,9,20,20,20,13,AM RL,505,1,1,13,13,20,20,1,1,1,1,1,9,1,1,1,34368127504,0,0,0,0,1,0,0,0,0,1,0,0,0,0,0,0,0,0,0,0,0,0,0,1,0,0,0,0,0,0,0,0,0,0,0,1,0,0,0,0,0,0,0,0,0,0,0,0,Victor Moses,£5.85m ,29,177,Midfielder - Right Midfield,right,Spartak Moscow,28,2,3,1231,39,6,6,3229,44,10,5,2480,22,2,0,853,23,4,6,1666,27,2,2,1333,40,4,4,3045,38,4,4,3038,22,4,1,1250,Premier League,27,1,6,1243,2,1,0,102
13/6/2011,Shervin Radjabali-Fardi,92003482,771,5/17/1991,20,0,0,1,0,3000,5700,5700,118,114,1169175,178,65,D/WB/M RL,2,1,3,2,1,1,3,5,3,1,2,5,12,11,7,13,5,7,5,8,11,12,5,12,12,13,11,12,12,11,10,11,14,11,5,12,12,12,13,14,13,11,9,20,12,12,10,14,8,13,4,9,4,15,5,16,14,5,14,16,11,5,20,19,16,14,19,20,1,D/WB/M RL,125,1,1,1,1,14,12,1,20,19,1,1,16,15,19,18,33,1,0,0,0,0,1,0,0,0,0,0,0,0,0,0,0,0,0,0,0,0,0,0,0,0,0,0,0,0,0,0,0,0,0,0,0,0,0,0,0,0,0,0,0,0,0,0,0,,,,,,,,,,,,,,,,,,,,,,,,,,,,,,,,,,,,,,,,,,,,,,,,,,,,
13/6/2011,Rubén Rochina,67038648,796,3/23/1991,20,0,0,0,0,5500,5750,6500,150,121,1457419,179,77,AM/S LC,3,1,1,3,1,3,2,2,2,2,1,10,10,16,14,14,10,8,14,2,2,12,10,5,14,8,12,10,14,10,13,8,12,15,8,14,10,11,10,14,13,13,9,20,16,12,6,14,12,8,6,15,7,7,10,16,12,14,15,12,14,14,1,1,12,16,12,15,16,AM/S LC,624,1,1,20,16,15,12,1,1,1,1,10,12,12,1,1,7.04031E+13,0,0,0,0,0,0,0,0,1,0,0,0,0,0,0,0,0,0,0,1,0,0,0,1,0,0,0,0,0,0,0,0,0,0,0,1,0,0,0,0,0,0,0,0,0,0,1,0,Rubén Rochina,£900Th. ,29,182,Midfielder - Attacking Midfield,left,Levante UD,22,9,2,851,23,6,2,1141,37,6,4,1871,22,3,1,1265,19,2,2,1134,38,6,6,2752,26,2,5,1442,10,1,0,374,29,4,7,1898,Premier League,29,5,5,1964,1,0,0,63
13/6/2011,Rodrigo,67086280,796,3/6/1991,20,0,0,1,0,5000,6000,6000,141,125,12000000,181,74,AM/S L,2,2,1,2,2,2,2,4,2,2,2,6,10,12,11,12,10,9,11,5,4,10,10,4,13,9,11,7,13,9,11,9,13,14,5,13,7,9,9,16,12,14,8,20,16,16,6,14,7,11,6,5,7,12,12,13,12,12,13,14,14,5,1,1,9,20,13,20,10,AM/S L,513,1,1,20,10,20,13,1,1,1,1,1,9,1,1,1,38654706305,1,0,0,0,0,0,0,1,0,1,0,0,0,0,0,0,0,0,0,0,0,0,0,0,0,0,0,0,0,0,0,0,1,0,0,1,0,0,0,0,0,0,0,0,0,0,0,0,Rodrigo,£6.30m ,29,182,Forward - Centre-Forward,left,Leeds United,24,3,1,928,38,16,4,1874,39,11,5,2140,42,18,8,2666,32,4,5,2161,38,7,3,2175,21,7,5,1588,44,19,7,2994,51,15,10,3775,Liga NOS,34,7,11,2506,7,1,0,410
13/6/2011,Robert Mak,28018617,794,3/8/1991,20,0,0,11,0,4750,2500,6000,132,124,10629971,179,71,M/AM RL,1,1,1,1,1,1,2,1,2,3,3,7,10,11,13,11,8,7,9,5,4,9,10,6,11,9,11,12,12,9,10,9,10,11,8,15,8,11,13,16,13,11,8,16,14,15,20,14,11,10,8,12,6,11,15,7,11,14,12,9,13,10,1,1,18,20,20,18,1,M/AM RL,525,1,1,14,1,18,20,1,1,1,1,1,16,18,1,1,0,0,0,0,0,0,0,0,0,0,0,0,0,0,0,0,0,0,0,0,0,0,0,0,0,0,0,0,0,0,0,0,0,0,0,0,0,0,0,0,0,0,0,0,0,0,0,0,0,Robert Mak,£1.58m ,29,179,Forward - Left Winger,right,Ferencvárosi TC,22,3,1,789,21,4,3,1178,26,6,3,1462,20,0,2,879,35,8,5,2658,46,20,3,3760,27,6,5,1431,36,5,6,2121,35,6,5,2123,Bundesliga,14,2,3,423,4,0,2,129
13/6/2011,Riyad Mahrez,85078058,769,2/21/1991,20,0,0,0,0,1150,2300,2300,116,92,295687,179,61,AM L,3,2,3,2,3,2,3,1,2,3,2,12,12,12,7,12,11,7,10,5,1,7,8,2,14,6,9,7,11,7,7,8,17,14,5,11,4,6,8,16,14,10,8,20,11,13,5,12,5,13,6,10,7,9,11,15,10,11,9,14,14,7,1,1,12,20,1,20,1,AM L,503,1,1,10,1,20,1,1,1,1,1,1,12,1,1,1,1,1,0,0,0,0,0,0,0,0,0,0,0,0,0,0,0,0,0,0,0,0,0,0,0,0,0,0,0,0,0,0,0,0,0,0,0,0,0,0,0,0,0,0,0,0,0,0,0,,,,,,,,,,,,,,,,,,,,,,,,,,,,,,,,,,,,,,,,,,,,,,,,,,,,
13/6/2011,Paul Schinke,92022264,771,5/16/1991,20,0,0,0,0,1500,4350,4350,119,87,106332,174,70,M/AM RL,3,2,3,2,1,1,2,1,1,3,1,9,10,13,8,11,7,6,9,7,5,11,7,6,13,12,9,11,7,7,11,9,10,12,7,10,6,12,12,13,12,9,7,20,13,10,11,10,8,11,11,10,5,11,13,3,14,7,6,19,19,11,1,1,17,20,16,20,1,M/AM RL,525,1,1,12,1,20,16,1,1,1,1,1,17,15,1,1,0,0,0,0,0,0,0,0,0,0,0,0,0,0,0,0,0,0,0,0,0,0,0,0,0,0,0,0,0,0,0,0,0,0,0,0,0,0,0,0,0,0,0,0,0,0,0,0,0,Paul Scharner,£1.80m ,40,191,Defender - Centre-Back,right,Retired,35,4,1,2853,30,3,2,1618,24,1,1,1846,nan,nan,nan,nan,nan,nan,nan,nan,nan,nan,nan,nan,nan,nan,nan,nan,nan,nan,nan,nan,nan,nan,nan,nan,Premier League,nan,nan,nan,nan,nan,nan,nan,nan
13/6/2011,Nicolas Roth,91016401,771,8/28/1990,20,0,0,0,0,2750,4250,4250,115,86,207259,183,0,M/AM RL,1,2,3,3,1,3,1,2,3,2,1,11,13,13,8,13,9,8,7,2,5,12,9,4,13,7,9,10,9,6,9,9,10,12,13,11,5,13,13,8,12,11,10,10,12,13,20,10,3,10,8,5,11,10,9,14,8,12,13,5,8,7,1,1,18,20,20,18,12,M/AM RL,525,1,1,12,12,18,20,1,1,1,1,1,18,18,1,1,0,0,0,0,0,0,0,0,0,0,0,0,0,0,0,0,0,0,0,0,0,0,0,0,0,0,0,0,0,0,0,0,0,0,0,0,0,0,0,0,0,0,0,0,0,0,0,0,0,Nicolas Bovi,£90Th. ,27,182,Forward - Right Winger,right,ASC Arcetana,8,0,0,329,14,1,0,872,12,1,0,825,3,0,0,56,25,2,2,1627,15,6,0,1113,28,5,0,1502,19,3,1,791,nan,nan,nan,nan,Serie A,nan,nan,nan,nan,nan,nan,nan,nan
13/6/2011,Ness Zamir,42008801,775,10/31/1990,20,0,0,10,1,1600,3960,3600,92,72,241685,178,69,AM LC,3,1,2,3,2,1,2,1,3,3,3,8,9,6,10,8,3,1,9,1,7,10,6,8,13,11,8,3,9,7,9,10,8,12,4,9,7,14,13,12,12,12,5,9,12,12,20,9,2,10,11,7,12,10,13,13,15,5,10,11,11,5,1,1,15,20,13,18,20,AM LC,504,1,1,8,20,18,13,1,1,1,1,15,15,10,1,1,0,0,0,0,0,0,0,0,0,0,0,0,0,0,0,0,0,0,0,0,0,0,0,0,0,0,0,0,0,0,0,0,0,0,0,0,0,0,0,0,0,0,0,0,0,0,0,0,0,,,,,,,,,,,,,,,,,,,,,,,,,,,,,,,,,,,,,,,,,,,,,,,,,,,,
13/6/2011,Mubarak Wakaso,12006112,21,7/25/1990,20,0,0,0,0,4250,5489,6250,148,122,4451815,169,67,DM/M LC,2,1,1,2,2,2,3,4,3,3,2,12,13,12,8,11,11,5,14,8,10,13,9,13,12,18,11,16,7,8,12,9,14,12,6,12,8,13,17,16,16,13,6,20,17,14,7,18,11,12,14,10,5,9,9,11,9,7,8,8,7,14,10,12,20,9,1,15,20,DM/M LC,424,1,1,1,8,9,1,1,10,1,16,20,15,1,12,1,1.37573E+11,0,0,0,0,0,0,0,0,0,0,0,0,0,0,0,0,0,1,0,0,0,0,0,0,0,0,0,1,0,0,0,0,0,0,0,0,0,1,0,0,0,0,0,0,0,0,0,0,Mubarak Wakaso,£1.80m ,30,171,Midfielder - Central Midfield,left,Jiangsu Suning,38,3,1,2011,10,0,0,311,27,3,6,1917,18,2,2,841,13,1,1,849,24,2,2,1204,27,2,3,2158,24,0,2,1374,29,1,1,1663,LaLiga,32,0,1,2466,nan,nan,nan,nan
13/6/2011,Mickaël Barreto,167576,769,1/18/1991,20,0,0,0,0,1400,2800,2800,130,85,654434,175,67,AM LC,2,3,1,2,3,3,2,5,2,2,3,9,10,13,7,13,4,7,10,2,8,11,9,6,11,13,7,10,5,9,11,10,11,10,11,9,11,10,14,13,13,13,10,20,5,13,9,10,3,10,11,2,15,10,14,2,9,12,13,13,6,10,12,12,15,20,1,18,20,AM LC,504,1,1,1,20,18,1,1,12,1,1,15,15,1,12,1,0,0,0,0,0,0,0,0,0,0,0,0,0,0,0,0,0,0,0,0,0,0,0,0,0,0,0,0,0,0,0,0,0,0,0,0,0,0,0,0,0,0,0,0,0,0,0,0,0,Mickaël Charvet,£45Th. ,32,179,Defender - Centre-Back,right,AS Saint-Priest,3,0,0,270,2,0,0,90,26,0,0,2292,nan,nan,nan,nan,nan,nan,nan,nan,nan,nan,nan,nan,32,0,0,2683,16,0,0,1205,1,0,0,90,Ligue 1,nan,nan,nan,nan,6,0,0,431
13/6/2011,Maximilian Beister,91018468,771,9/6/1990,20,0,0,0,0,4850,6200,6200,157,124,4047117,180,78,M/AM/S RL,1,2,1,3,2,3,1,6,2,3,1,5,11,13,13,12,6,5,11,4,4,8,6,5,12,13,10,12,12,11,8,12,13,14,5,13,5,11,11,16,15,12,10,20,12,13,12,14,12,16,3,10,4,16,7,13,5,5,14,6,13,13,1,1,18,20,20,19,12,M/AM/S RL,535,1,1,18,12,19,20,1,1,1,1,1,17,18,1,1,0,0,0,0,0,0,0,0,0,0,0,0,0,0,0,0,0,0,0,0,0,0,0,0,0,0,0,0,0,0,0,0,0,0,0,0,0,0,0,0,0,0,0,0,0,0,0,0,0,,,,,,,,,,,,,,,,,,,,,,,,,,,,,,,,,,,,,,,,,,,,,,,,,,,,
13/6/2011,Maxime Bourgeois,85009981,769,2/3/1991,20,0,0,5,0,2400,4814,4800,145,107,1873783,183,78,AM L,1,2,3,3,2,3,2,1,1,2,3,8,11,13,8,13,6,8,10,7,3,10,7,2,14,6,10,9,11,10,11,8,16,13,5,12,4,6,7,16,13,13,10,8,11,15,20,9,11,12,6,14,7,8,11,13,14,14,14,14,14,5,1,1,15,20,12,20,10,AM L,503,1,1,10,10,20,12,1,1,1,1,1,15,12,1,1,2.25235E+15,0,0,0,0,0,0,0,0,0,0,0,0,0,0,0,0,0,0,0,0,0,0,0,0,0,0,0,0,1,0,0,0,0,0,0,0,0,0,0,1,0,0,0,0,0,0,0,0,,,,,,,,,,,,,,,,,,,,,,,,,,,,,,,,,,,,,,,,,,,,,,,,,,,,
13/6/2011,Matthew Briggs,28010395,765,3/6/1991,20,0,0,12,1,3200,5500,5500,138,105,7784267,186,75,D LC,1,3,1,1,3,2,3,5,3,2,2,5,11,9,7,13,4,11,12,7,12,12,7,12,11,13,10,13,10,12,9,10,13,10,9,12,12,14,13,12,10,10,13,20,13,12,5,15,12,10,8,10,7,13,6,18,18,13,15,13,12,13,20,15,15,1,7,20,17,D LC,104,1,1,1,1,1,1,17,20,7,1,1,15,1,15,1,0,0,0,0,0,0,0,0,0,0,0,0,0,0,0,0,0,0,0,0,0,0,0,0,0,0,0,0,0,0,0,0,0,0,0,0,0,0,0,0,0,0,0,0,0,0,0,0,0,Matthew Briggs,£1.35m ,29,183,Defender - Centre-Back,left,Vejle Boldklub,4,0,1,254,25,1,1,2033,27,1,1,2020,6,0,0,274,30,1,4,2464,32,0,2,2676,15,0,0,1135,13,0,1,846,nan,nan,nan,nan,Premier League,17,0,0,1466,1,0,1,90
13/6/2011,Matt Phillips,29020283,765,3/13/1991,20,0,0,0,0,2900,5850,6050,152,121,4456340,183,81,M/AM RL,3,2,2,2,2,2,1,4,3,3,2,9,13,14,12,13,3,12,9,1,6,13,7,9,12,4,11,11,10,10,11,12,11,10,5,12,11,11,10,15,12,14,12,10,11,15,20,12,8,10,2,10,4,10,13,12,13,13,13,10,9,7,10,1,20,20,20,15,1,M/AM RL,415,1,1,1,1,15,20,1,1,10,1,1,14,20,1,1,0,0,0,0,0,0,0,0,0,0,0,0,0,0,0,0,0,0,0,0,0,0,0,0,0,0,0,0,0,0,0,0,0,0,0,0,0,0,0,0,0,0,0,0,0,0,0,0,0,,,,,,,,,,,,,,,,,,,,,,,,,,,,,,,,,,,,,,,,,,,,,,,,,,,,
13/6/2011,Mario Balotelli,43001238,776,8/12/1990,20,2,0,14,6,7000,8250,7250,178,150,56518268,189,88,AM/S RL,1,1,1,1,1,1,1,1,1,1,1,14,13,15,14,12,14,11,15,6,7,14,18,7,16,12,10,12,16,7,14,10,10,16,8,15,6,5,4,15,15,11,13,12,14,16,20,13,15,9,17,14,8,15,5,14,3,8,3,3,3,19,1,1,8,16,16,15,11,AM/S RL,625,1,1,20,11,15,16,1,1,1,1,1,8,8,1,1,34359935232,0,0,0,0,0,0,0,0,1,0,0,0,0,0,0,0,1,1,0,0,0,0,0,0,0,0,0,0,0,0,0,0,0,0,0,1,0,0,0,0,0,0,0,0,0,0,0,0,Mario Balotelli,£28.80m ,30,189,Forward - Centre-Forward,right,Without Club,28,10,2,1712,32,17,2,1881,33,15,3,1964,41,18,8,3161,28,4,0,1510,23,3,1,994,28,17,0,2106,38,26,2,3043,25,8,1,1699,Premier League,19,5,0,1409,nan,nan,nan,nan
13/6/2011,Marco Stiepermann,35011199,771,2/19/1991,20,0,0,0,0,4200,5400,6000,134,108,3237030,190,85,M/AM/S RLC,3,3,1,3,3,2,3,1,3,1,3,8,12,13,11,12,8,7,9,6,5,11,8,6,13,8,9,9,8,11,11,11,9,10,9,14,5,13,14,11,9,12,13,20,13,13,9,14,11,9,7,10,7,13,10,8,9,12,18,16,13,17,1,1,18,19,18,19,15,M/AM/S RLC,636,1,1,20,15,19,18,1,1,1,1,10,18,17,1,1,0,0,0,0,0,0,0,0,0,0,0,0,0,0,0,0,0,0,0,0,0,0,0,0,0,0,0,0,0,0,0,0,0,0,0,0,0,0,0,0,0,0,0,0,0,0,0,0,0,,,,,,,,,,,,,,,,,,,,,,,,,,,,,,,,,,,,,,,,,,,,,,,,,,,,
13/6/2011,Marcel Avdic,35016513,759,2/28/1991,20,0,0,0,0,3600,4544,5050,117,101,1634831,177,73,M/AM RLC,2,2,1,2,2,1,3,4,3,1,1,6,11,13,9,12,8,6,9,4,3,12,10,4,13,6,10,9,11,8,12,10,11,13,5,11,4,11,8,13,12,9,8,14,12,12,20,14,10,11,7,6,6,12,12,9,7,12,10,11,9,14,1,1,20,18,20,15,16,M/AM RLC,416,1,1,5,16,13,18,1,1,1,1,14,15,20,1,1,34359738368,0,0,0,0,0,0,0,0,0,0,0,0,0,0,0,0,0,0,0,0,0,0,0,0,0,0,0,0,0,0,0,0,0,0,0,1,0,0,0,0,0,0,0,0,0,0,0,0,,,,,,,,,,,,,,,,,,,,,,,,,,,,,,,,,,,,,,,,,,,,,,,,,,,,
13/6/2011,Luis Carlos,67072502,796,12/16/1990,20,0,0,0,0,1200,3200,3200,115,64,225884,176,75,AM L,1,1,1,1,1,3,1,3,1,2,1,10,13,10,11,12,5,3,6,3,3,9,9,9,9,9,11,12,10,10,8,6,10,10,12,11,1,16,12,11,10,7,9,20,13,10,5,7,3,10,7,10,7,10,8,7,12,15,8,7,10,16,1,1,14,20,5,20,10,AM L,503,1,1,5,10,20,5,1,1,1,1,1,14,1,1,1,1.13387E+12,0,0,0,0,0,0,0,0,0,0,0,0,0,0,0,0,0,0,0,0,0,0,0,0,0,0,0,0,0,0,0,0,0,0,0,1,0,0,0,0,1,0,0,0,0,0,0,0,Luís Carlos,£900Th. ,33,170,Forward - Left Winger,right,Doxa Katokopias,38,12,0,2604,28,4,3,1816,33,6,3,2415,35,5,4,2484,37,8,6,2959,22,0,2,776,17,3,3,935,30,7,3,2225,27,8,0,2169,Liga NOS,19,2,0,1232,4,0,0,199
13/6/2011,Ludovic,55021853,788,6/18/1990,20,0,0,0,0,1000,5250,5250,111,102,1917655,168,59,AM L,2,1,2,3,2,1,1,1,2,3,3,8,8,10,7,9,5,5,8,5,8,8,8,8,9,14,11,12,8,8,6,7,10,11,7,13,8,10,12,15,13,8,6,8,14,15,20,9,7,11,8,10,10,12,15,7,14,13,15,13,12,15,1,1,7,20,12,20,10,AM L,503,1,1,7,10,20,12,1,1,1,1,1,7,1,1,1,0,0,0,0,0,0,0,0,0,0,0,0,0,0,0,0,0,0,0,0,0,0,0,0,0,0,0,0,0,0,0,0,0,0,0,0,0,0,0,0,0,0,0,0,0,0,0,0,0,Ludovic,£1.44m ,30,168,Midfielder - Right Midfield,right,FC Penafiel,20,2,0,524,31,2,2,2164,37,0,0,1660,20,2,2,1007,21,0,3,1594,18,2,1,691,30,2,0,1606,38,5,11,2726,36,3,4,2673,Liga NOS,28,2,3,2219,6,0,1,351
13/6/2011,Lilian Bochet,85042902,769,3/4/1991,20,0,0,0,0,3750,4724,4700,135,105,1127601,177,69,M/AM L,2,1,3,3,3,1,1,4,1,2,2,10,10,13,7,13,10,5,9,5,2,10,8,3,13,7,8,8,11,11,11,10,15,13,6,11,6,6,13,15,14,11,7,20,12,13,12,14,8,14,7,10,8,8,8,13,14,12,15,14,14,6,1,1,16,20,10,20,14,M/AM L,523,1,1,1,14,20,10,1,1,1,1,12,16,10,1,1,2.2518E+15,0,0,0,0,0,0,0,0,0,0,0,0,0,0,0,0,0,0,0,0,0,0,0,0,0,0,0,0,0,0,0,0,0,0,0,0,0,0,0,0,0,0,0,0,0,0,0,0,,,,,,,,,,,,,,,,,,,,,,,,,,,,,,,,,,,,,,,,,,,,,,,,,,,,
13/6/2011,Lewis Holtby,91000734,771,9/18/1990,20,2,0,10,5,5750,7050,7050,161,140,54065637,174,66,AM LC,3,1,3,1,2,3,3,6,3,3,3,13,12,14,11,17,11,7,12,5,6,17,10,7,16,9,14,8,10,7,17,11,13,15,10,13,6,8,14,14,16,12,6,20,11,13,15,14,8,9,5,11,4,9,12,15,11,11,15,12,14,6,1,1,15,20,14,18,20,AM LC,504,1,1,10,20,18,14,1,1,1,8,15,14,10,1,1,5.49774E+11,0,0,1,0,0,0,0,1,0,0,0,0,0,0,0,0,0,0,0,0,1,0,0,0,1,0,0,0,0,0,0,0,0,0,0,0,0,0,0,1,0,0,0,0,0,0,0,0,Lewis Holtby,£7.20m ,30,176,Midfielder - Attacking Midfield,left,Blackburn Rovers,32,6,10,2157,41,9,5,2981,44,4,13,2934,37,6,9,2148,28,0,2,1918,35,3,4,2977,30,1,6,2511,17,6,0,1240,31,5,6,2300,Bundesliga,27,3,4,1301,8,1,0,630
13/6/2011,Lee Yong-Jae,66002199,135,6/8/1991,20,0,0,0,0,2400,5450,3600,127,109,7738520,181,70,S L,2,2,2,3,1,2,2,1,1,3,1,6,8,12,11,12,6,9,8,5,3,8,10,2,13,11,11,13,14,11,8,7,16,13,5,12,5,8,13,17,13,13,10,6,13,14,20,12,9,10,8,14,6,5,12,13,11,15,14,14,14,6,1,1,12,15,10,15,1,S L,603,1,1,20,1,15,10,1,1,1,1,1,12,10,1,1,2.2518E+15,0,0,0,0,1,0,0,0,0,0,0,0,0,0,0,0,0,0,0,0,0,0,0,0,0,0,0,0,0,0,0,0,0,0,0,0,0,0,0,0,0,0,0,0,0,0,0,0,,,,,,,,,,,,,,,,,,,,,,,,,,,,,,,,,,,,,,,,,,,,,,,,,,,,
13/6/2011,Larence,55037390,785,7/30/1990,20,0,0,0,0,50,50,50,82,45,45469,170,0,AM L,3,2,2,2,1,1,1,2,3,1,1,4,8,11,6,11,4,5,3,8,6,8,3,2,10,12,4,8,9,6,5,6,10,13,9,5,4,15,12,12,7,4,2,20,14,9,7,7,2,9,7,10,6,8,14,14,12,7,2,14,14,8,10,1,15,20,10,20,1,AM L,503,1,1,1,1,20,10,1,10,1,1,1,15,1,1,1,0,0,0,0,0,0,0,0,0,0,0,0,0,0,0,0,0,0,0,0,0,0,0,0,0,0,0,0,0,0,0,0,0,0,0,0,0,0,0,0,0,0,0,0,0,0,0,0,0,,,,,,,,,,,,,,,,,,,,,,,,,,,,,,,,,,,,,,,,,,,,,,,,,,,,
13/6/2011,Kieron Cadogan,28019850,765,8/16/1990,20,0,0,0,0,1750,4000,4000,113,91,689836,193,80,M/AM/S RL,1,3,1,2,3,1,2,3,3,2,2,1,7,12,9,12,3,5,8,3,2,7,10,5,9,11,10,12,8,5,7,7,16,12,3,8,8,11,11,12,9,7,10,8,10,14,20,10,8,9,11,4,3,10,15,6,15,13,15,9,8,11,1,1,20,18,20,18,1,M/AM/S RL,425,1,1,16,1,16,18,1,1,1,1,1,18,20,1,1,1.81421E+13,0,0,0,0,0,0,0,0,0,0,0,0,0,0,0,0,0,0,0,0,0,0,0,0,0,0,0,1,0,0,0,0,0,0,0,0,0,0,0,1,0,0,0,0,1,0,0,0,,,,,,,,,,,,,,,,,,,,,,,,,,,,,,,,,,,,,,,,,,,,,,,,,,,,
13/6/2011,Ju Tae-Yun,92038147,135,6/22/1990,20,0,0,0,0,3000,5100,5100,125,102,1460283,181,75,AM RL,3,3,3,3,1,3,3,1,1,1,1,9,12,12,7,10,8,1,12,8,6,11,8,8,11,5,10,4,9,7,9,9,10,13,10,8,6,15,12,12,12,12,9,17,10,12,20,8,3,10,10,10,7,10,9,19,10,11,14,14,5,7,1,1,15,20,20,18,1,AM RL,505,1,1,1,1,18,20,1,1,1,1,1,12,15,1,1,0,0,0,0,0,0,0,0,0,0,0,0,0,0,0,0,0,0,0,0,0,0,0,0,0,0,0,0,0,0,0,0,0,0,0,0,0,0,0,0,0,0,0,0,0,0,0,0,0,,,,,,,,,,,,,,,,,,,,,,,,,,,,,,,,,,,,,,,,,,,,,,,,,,,,
13/6/2011,Joe Mason,28017168,789,5/13/1991,20,0,0,2,0,2250,5000,5250,135,100,1322500,178,73,S RLC,2,3,3,1,2,1,3,7,2,2,2,7,7,12,12,12,5,12,6,5,5,10,10,5,12,8,14,7,13,11,12,12,12,12,7,13,7,12,11,9,12,10,11,13,14,10,20,13,9,8,6,8,6,14,18,10,17,9,16,17,18,1,1,1,14,15,15,15,15,S RLC,606,1,1,20,15,15,15,1,1,1,1,10,14,14,1,1,1.75922E+13,0,0,0,0,0,0,0,0,0,0,1,0,0,1,0,0,0,0,0,1,0,0,0,0,0,0,0,0,0,0,0,0,0,0,0,0,0,0,0,0,0,0,0,0,1,0,0,0,,,,,,,,,,,,,,,,,,,,,,,,,,,,,,,,,,,,,,,,,,,,,,,,,,,,
13/6/2011,Jay Emmanuel-Thomas,28010572,765,12/27/1990,20,0,0,0,0,2750,5750,5400,154,116,7547713,191,86,DM/AM/S LC,1,2,3,3,2,1,3,1,1,3,3,2,10,13,14,14,3,13,14,4,7,11,7,11,14,8,10,10,10,8,9,9,14,14,13,12,8,8,6,12,14,16,16,20,13,13,8,14,16,14,6,12,4,17,7,14,13,14,10,8,11,13,13,12,15,20,12,16,20,DM/AM/S LC,534,1,1,17,20,16,12,12,13,1,17,15,15,12,12,1,5.49756E+11,1,0,0,0,0,0,0,0,0,1,0,0,0,0,0,0,0,0,0,0,0,0,0,0,0,0,0,0,0,0,0,0,0,0,0,0,0,0,0,1,0,0,0,0,0,0,0,0,,,,,,,,,,,,,,,,,,,,,,,,,,,,,,,,,,,,,,,,,,,,,,,,,,,,
13/6/2011,Jaime,30024204,796,7/31/1990,20,0,0,0,0,3900,5900,6000,160,118,2552607,176,74,M/AM L,3,1,1,1,2,3,2,7,2,3,3,10,15,15,10,10,10,3,11,5,5,12,12,4,14,6,10,6,11,11,14,12,14,16,11,14,6,9,9,15,16,6,7,20,8,15,5,12,7,11,7,13,6,7,8,15,11,10,17,11,9,6,1,1,17,20,13,20,10,M/AM L,523,1,1,1,10,20,13,1,1,1,1,1,17,10,1,1,7.14683E+13,0,0,0,0,0,0,0,0,0,0,0,0,0,0,0,0,0,0,0,0,0,0,0,0,0,0,0,0,0,0,0,0,0,0,0,0,0,0,0,0,1,0,0,0,0,0,1,0,,,,,,,,,,,,,,,,,,,,,,,,,,,,,,,,,,,,,,,,,,,,,,,,,,,,
13/6/2011,Isaac Cuenca,67071789,796,4/27/1991,20,0,0,0,0,2000,5250,5250,118,111,631717,175,76,AM RLC,3,1,3,3,1,2,2,3,2,1,3,10,11,12,8,8,9,6,10,6,4,12,8,4,13,8,10,8,10,9,11,10,10,12,7,12,6,7,7,14,11,6,8,13,9,12,20,12,7,11,6,9,12,11,10,4,8,11,11,5,14,12,1,1,14,20,19,17,20,AM RLC,506,1,1,15,20,17,19,1,1,1,1,10,13,14,1,1,0,0,0,0,0,0,0,0,0,0,0,0,0,0,0,0,0,0,0,0,0,0,0,0,0,0,0,0,0,0,0,0,0,0,0,0,0,0,0,0,0,0,0,0,0,0,0,0,0,Isaac Cuenca,£2.70m ,29,178,Midfielder - Left Midfield,right,Vegalta Sendai,27,4,0,2198,36,6,12,2143,5,0,1,304,nan,nan,nan,nan,29,2,3,1625,31,3,4,1775,26,2,0,1829,18,3,0,867,32,6,0,2393,LaLiga,4,0,0,93,nan,nan,nan,nan
13/6/2011,Henri Lansbury,29003724,765,10/12/1990,20,0,0,9,0,3000,6000,5850,148,122,3323080,183,86,M RLC,2,1,1,2,1,2,2,1,2,1,1,12,14,15,14,15,11,6,13,4,6,13,6,11,14,13,11,9,10,10,13,11,14,14,6,14,8,11,11,13,13,12,8,8,11,16,20,12,9,12,7,10,7,9,11,16,17,11,10,11,9,16,1,1,20,13,15,15,20,M RLC,406,1,1,1,13,13,13,1,1,1,1,20,15,15,1,1,16512,0,0,0,0,0,0,0,1,0,0,0,0,0,0,1,0,0,0,0,0,0,0,0,0,0,0,0,0,0,0,0,0,0,0,0,0,0,0,0,0,0,0,0,0,0,0,0,0,Henri Lansbury,£1.35m ,30,183,Midfielder - Central Midfield,right,Aston Villa,26,5,5,1660,26,1,3,1462,32,5,4,2084,30,7,3,2617,40,11,5,3184,29,4,5,2366,37,6,3,3098,13,3,3,722,6,0,1,308,Premier League,15,0,5,542,3,0,1,258
13/6/2011,Guilherme,55024926,1651,5/21/1991,20,0,0,0,0,2000,2500,4650,150,93,691457,174,70,AM LC,3,1,2,1,1,1,1,1,2,2,3,11,12,12,10,14,13,5,12,7,6,12,12,8,13,12,12,11,7,9,11,11,12,15,12,13,7,8,11,12,12,8,7,20,12,12,6,9,7,12,9,12,6,10,14,15,6,12,10,10,10,5,1,1,15,20,7,15,20,AM LC,504,1,1,1,20,15,7,1,1,1,1,15,8,7,1,1,0,0,0,0,0,0,0,0,0,0,0,0,0,0,0,0,0,0,0,0,0,0,0,0,0,0,0,0,0,0,0,0,0,0,0,0,0,0,0,0,0,0,0,0,0,0,0,0,0,Guilherme,£450Th. ,29,174,Forward - Right Winger,left,Göztepe,8,2,0,383,27,1,1,1067,32,3,7,2522,2,0,0,164,30,1,2,2157,55,8,11,3830,41,7,8,2955,34,7,4,2469,35,5,7,2577,Liga NOS,44,9,8,2649,5,2,0,312
13/6/2011,Frédéric Bulot,34000470,769,9/27/1990,20,0,0,2,0,4300,5400,5400,150,120,11212056,179,72,M/AM L,1,2,1,1,1,2,2,9,1,3,2,10,12,14,7,14,13,8,12,5,3,11,8,3,15,7,11,9,12,11,13,10,13,14,5,13,6,11,10,17,14,13,10,20,13,15,5,13,10,13,7,13,10,12,12,15,13,12,12,15,15,7,1,1,17,20,10,20,14,M/AM L,523,1,1,10,14,20,10,1,1,1,7,12,17,10,1,1,2.2518E+15,0,0,0,0,0,0,0,0,0,0,0,0,0,0,0,0,0,0,0,0,1,0,0,0,0,0,0,0,0,0,0,0,0,0,0,0,0,0,0,0,0,0,0,0,0,0,0,0,Frédéric Bulot,£2.25m ,30,179,Forward - Left Winger,left,FELDA United FC,12,0,0,469,39,4,7,3133,38,4,8,2950,38,4,5,1851,28,5,2,1598,16,1,1,1021,nan,nan,nan,nan,11,1,0,733,14,0,1,889,Ligue 1,5,0,0,331,nan,nan,nan,nan
13/6/2011,Franck Julienne,28031633,769,3/7/1991,20,0,0,0,0,1300,2650,2650,130,106,2955223,171,63,AM/S L,3,2,2,3,2,2,3,1,1,3,3,7,9,13,11,13,8,6,12,5,1,10,13,2,13,7,11,6,14,11,10,10,13,14,5,13,5,7,9,16,14,10,6,20,14,14,5,12,6,14,7,6,6,8,7,14,13,13,9,14,14,7,1,1,10,18,12,18,1,AM/S L,623,1,1,20,1,18,12,1,1,1,1,1,10,10,1,1,2.2518E+15,0,0,0,0,1,0,0,0,0,0,0,0,0,0,0,0,0,0,0,0,0,0,0,0,0,0,0,0,0,0,0,0,0,0,0,0,0,0,0,0,0,0,0,0,0,0,0,0,Florian Julien, ,27,175,Defender - Right-Back,right,Unknown,nan,nan,nan,nan,0,0,0,0,2,0,1,96,2,0,0,10,nan,nan,nan,nan,nan,nan,nan,nan,nan,nan,nan,nan,nan,nan,nan,nan,nan,nan,nan,nan,Ligue 1,nan,nan,nan,nan,nan,nan,nan,nan
13/6/2011,Ezequiel,67131753,796,1/12/1991,20,0,0,0,0,3600,6100,6100,155,122,1873763,168,60,M/AM RLC,2,2,3,1,2,3,1,4,2,1,2,10,11,15,7,14,6,4,6,2,2,13,16,5,17,6,13,12,12,10,14,8,12,18,5,13,7,8,12,16,16,7,3,12,14,15,20,10,4,10,3,13,5,18,8,16,13,15,12,13,12,6,1,1,16,20,19,20,19,M/AM RLC,526,1,1,1,19,20,19,1,1,1,1,1,16,1,1,1,7.09529E+13,0,0,0,0,0,0,0,0,0,0,0,0,0,0,0,0,0,0,0,0,0,0,0,0,0,0,0,0,0,0,0,0,0,0,0,1,0,0,0,1,0,0,0,0,0,0,1,0,,,,,,,,,,,,,,,,,,,,,,,,,,,,,,,,,,,,,,,,,,,,,,,,,,,,
13/6/2011,Eden Hazard,18004418,757,1/7/1991,20,20,0,0,0,6600,8000,7200,180,160,54251331,172,72,M/AM LC,1,3,3,3,3,1,3,4,3,2,2,14,13,18,10,18,13,7,13,5,3,16,13,3,18,8,12,9,13,13,15,13,10,15,6,14,7,11,12,18,16,13,6,14,16,15,20,14,12,14,8,15,7,8,15,17,15,13,12,14,14,9,1,1,16,20,14,19,20,M/AM LC,524,1,1,10,20,19,14,1,1,1,1,16,12,12,1,1,2.3222E+15,0,0,0,0,0,0,0,1,0,0,0,0,0,0,0,0,0,0,0,0,1,0,0,0,0,0,0,0,0,0,0,0,0,0,0,1,0,0,0,0,0,0,0,0,0,0,1,0,Eden Hazard,£29.70m ,29,175,Forward - Left Winger,both,Real Madrid,54,12,14,4110,49,22,22,4193,62,13,24,4523,49,17,10,3943,52,19,13,4441,43,6,8,3079,43,17,7,3373,52,17,13,3804,52,21,17,3878,Ligue 1,22,1,7,1545,nan,nan,nan,nan
13/6/2011,Diego Fabbrini,1414266,776,7/31/1990,20,0,0,11,1,2000,5500,5500,162,117,1982617,181,66,AM/S RLC,1,1,2,3,2,2,3,5,1,3,1,10,12,13,9,14,10,5,12,4,4,14,7,4,13,12,12,9,12,12,12,11,11,16,11,11,7,16,15,13,10,12,10,12,12,9,20,11,10,11,12,10,3,10,7,12,13,13,10,13,12,11,1,1,10,20,20,18,18,AM/S RLC,516,1,1,18,18,18,20,1,1,1,1,5,10,10,1,1,0,0,0,0,0,0,0,0,0,0,0,0,0,0,0,0,0,0,0,0,0,0,0,0,0,0,0,0,0,0,0,0,0,0,0,0,0,0,0,0,0,0,0,0,0,0,0,0,0,Diego Fabbrini,£2.70m ,30,181,Midfielder - Attacking Midfield,right,Dinamo Bucharest,28,2,0,1783,25,2,2,1152,22,2,1,1255,35,2,3,1638,21,1,2,1486,40,6,4,2238,27,1,0,1543,17,1,0,802,32,5,5,2513,Serie A,30,1,2,1952,7,0,1,332
13/6/2011,David Blacha,35011174,787,10/22/1990,20,0,0,0,0,2750,2500,4500,120,93,18903,174,71,M/AM RL,2,1,3,2,1,2,1,2,1,3,3,8,11,13,9,12,8,6,8,5,6,11,9,8,13,8,9,13,7,7,12,6,10,11,5,9,8,6,12,13,13,8,7,15,13,12,20,8,8,9,9,6,4,18,11,8,14,5,7,11,6,19,12,1,20,19,20,15,10,M/AM RL,415,1,1,10,10,12,19,1,1,12,1,1,15,20,1,1,2,0,1,0,0,0,0,0,0,0,0,0,0,0,0,0,0,0,0,0,0,0,0,0,0,0,0,0,0,0,0,0,0,0,0,0,0,0,0,0,0,0,0,0,0,0,0,0,0,David Alaba,£14.40m ,28,180,Defender - Centre-Back,left,Bayern Munich,31,2,3,2474,47,3,3,2787,38,5,6,3195,49,4,9,4241,29,5,3,2556,46,2,4,4022,47,5,7,3799,36,2,6,2638,43,3,7,3631,Bundesliga,42,2,2,3693,6,0,1,562
13/6/2011,Danny Rose,5134489,765,7/2/1990,20,0,0,20,3,2750,5750,5400,143,115,23815623,175,73,M/AM L,3,3,3,3,1,1,1,6,3,1,2,6,11,11,11,12,4,10,10,5,4,11,8,10,12,19,10,14,10,10,10,10,12,12,6,11,10,12,12,17,10,9,5,20,15,15,11,11,10,14,8,14,7,10,8,14,6,11,7,13,10,8,15,9,20,20,12,20,14,M/AM L,413,1,1,14,14,20,12,1,15,1,1,10,20,10,9,1,0,0,0,0,0,0,0,0,0,0,0,0,0,0,0,0,0,0,0,0,0,0,0,0,0,0,0,0,0,0,0,0,0,0,0,0,0,0,0,0,0,0,0,0,0,0,0,0,0,Danny Rose,£2.70m ,30,173,Defender - Left-Back,left,Tottenham Hotspur,21,0,3,1587,20,0,1,996,29,1,1,2330,31,2,4,2486,34,4,5,2790,30,1,4,2659,21,2,4,1803,17,0,1,1319,37,0,5,2564,Premier League,29,0,2,2284,nan,nan,nan,nan
13/6/2011,Danny Blum,35017408,771,1/7/1991,20,0,0,0,0,2500,4350,4350,110,87,186291,184,79,M L,2,1,1,2,1,3,1,1,1,2,2,6,8,11,13,11,5,11,14,9,7,10,10,8,12,6,9,10,12,7,12,8,10,13,2,13,7,13,15,12,11,13,11,20,8,12,4,10,8,9,10,10,17,14,10,14,8,9,16,18,15,15,7,1,20,15,1,20,1,M L,403,1,1,15,1,15,1,1,7,1,1,1,20,1,1,1,0,0,0,0,0,0,0,0,0,0,0,0,0,0,0,0,0,0,0,0,0,0,0,0,0,0,0,0,0,0,0,0,0,0,0,0,0,0,0,0,0,0,0,0,0,0,0,0,0,,,,,,,,,,,,,,,,,,,,,,,,,,,,,,,,,,,,,,,,,,,,,,,,,,,,
13/6/2011,Daniel Nieto,67046587,796,5/4/1991,20,0,0,0,0,2500,4500,4500,117,98,3312318,173,60,M/AM L,1,1,2,3,1,2,1,1,1,2,3,11,14,14,13,14,10,8,10,3,7,12,10,9,14,5,10,3,14,11,11,9,7,14,11,9,4,9,11,10,12,12,9,20,11,12,9,8,4,10,13,4,4,10,7,11,8,13,12,15,11,3,1,1,17,20,1,20,3,M/AM L,523,1,1,14,3,20,1,1,1,1,1,1,17,1,1,1,0,0,0,0,0,0,0,0,0,0,0,0,0,0,0,0,0,0,0,0,0,0,0,0,0,0,0,0,0,0,0,0,0,0,0,0,0,0,0,0,0,0,0,0,0,0,0,0,0,Daniel Niculae,£1.80m ,38,186,Forward - Centre-Forward,right,Retired,19,5,1,1331,32,6,2,2557,13,2,0,715,15,7,0,1284,14,3,4,1163,21,2,5,833,34,7,7,2172,nan,nan,nan,nan,nan,nan,nan,nan,Ligue 1,nan,nan,nan,nan,nan,nan,nan,nan
13/6/2011,Christopher Quiring,92021350,771,11/23/1990,20,0,0,0,0,3800,5800,5800,122,116,3266345,172,67,M/AM/S RL,2,3,2,2,2,1,2,4,1,1,3,11,14,13,14,14,7,8,12,7,10,10,10,11,14,7,13,10,13,5,13,9,10,11,13,10,5,6,11,14,14,14,6,8,12,14,20,8,5,15,9,10,9,10,14,3,12,13,12,17,10,10,1,1,18,20,20,16,1,M/AM/S RL,535,1,1,18,1,16,20,1,1,1,1,1,1,18,1,1,0,0,0,0,0,0,0,0,0,0,0,0,0,0,0,0,0,0,0,0,0,0,0,0,0,0,0,0,0,0,0,0,0,0,0,0,0,0,0,0,0,0,0,0,0,0,0,0,0,Christopher Jullien, ,27,196,Defender - Centre-Back,right,Celtic FC,nan,nan,nan,nan,0,0,0,0,26,3,0,2108,26,3,0,2288,24,2,8,2079,37,9,1,3360,37,5,1,3360,36,2,3,3118,35,1,0,3105,Ligue 1,46,7,2,4000,7,2,2,630
13/6/2011,Christopher Benkada,85081895,769,7/28/1990,20,0,0,0,0,1150,2300,2300,120,92,398415,170,72,AM RL,3,2,2,1,2,2,3,1,2,1,3,7,9,11,8,11,7,7,12,5,2,8,12,2,13,8,10,9,11,8,8,6,16,12,6,11,4,9,12,15,14,10,5,5,14,14,20,11,10,14,8,10,7,8,8,14,14,8,17,12,12,12,1,1,12,20,20,16,1,AM RL,505,1,1,14,1,16,20,1,1,1,1,1,12,12,1,1,2.2518E+15,0,0,0,0,0,0,0,0,0,0,0,0,0,0,0,0,0,0,0,0,0,0,0,0,0,0,0,0,0,0,0,0,0,0,0,0,0,0,0,0,0,0,0,0,0,0,0,0,Christophe Berra,£3.60m ,35,190,Defender - Centre-Back,left,Heart of Midlothian FC,36,0,4,3210,35,0,0,2968,32,0,1,2739,45,5,0,3947,50,6,3,4489,44,1,1,3960,46,2,1,4086,44,3,1,3990,35,2,0,3135,Premier League,31,1,3,2855,nan,nan,nan,nan
13/6/2011,Borja,67060845,796,11/2/1990,20,0,0,0,0,3000,5450,5450,130,112,1368500,172,65,M/AM/S RL,1,1,2,1,3,1,2,1,3,2,3,11,13,13,10,14,10,6,14,6,10,12,10,11,14,10,13,10,8,12,11,9,10,11,1,14,4,11,14,12,14,14,6,5,11,14,20,10,4,10,6,4,9,10,6,10,9,9,9,5,9,7,1,1,16,20,20,16,1,M/AM/S RL,535,1,1,17,1,16,20,1,1,1,1,1,15,16,1,1,0,0,0,0,0,0,0,0,0,0,0,0,0,0,0,0,0,0,0,0,0,0,0,0,0,0,0,0,0,0,0,0,0,0,0,0,0,0,0,0,0,0,0,0,0,0,0,0,0,,,,,,,,,,,,,,,,,,,,,,,,,,,,,,,,,,,,,,,,,,,,,,,,,,,,
13/6/2011,Antonio Esposito,43017503,776,9/5/1990,20,0,0,0,0,1000,3550,3550,110,77,76607,183,75,D/WB/M L,1,1,1,1,1,1,1,1,1,1,1,8,11,10,8,10,5,6,7,6,5,10,6,6,11,10,11,9,11,10,9,11,12,12,8,11,7,11,10,12,12,10,9,20,11,11,5,11,10,13,9,11,10,13,8,13,14,14,15,15,14,4,16,18,20,15,1,20,1,D/WB/M L,433,1,1,1,1,15,1,1,16,1,1,1,20,1,18,1,128,0,0,0,0,0,0,0,1,0,0,0,0,0,0,0,0,0,0,0,0,0,0,0,0,0,0,0,0,0,0,0,0,0,0,0,0,0,0,0,0,0,0,0,0,0,0,0,0,Alessio Esposito,£68Th. ,26,180,Midfielder - Defensive Midfield,right,Audace Cerignola,2,0,0,99,3,0,0,126,28,0,0,1826,1,0,0,49,21,1,0,1187,26,2,0,1656,34,1,5,2907,29,1,0,1936,32,5,0,2185,Serie A,3,0,0,138,4,1,0,349
13/6/2011,Antoine Griezmann,67086656,769,3/21/1991,20,0,0,2,0,4700,6254,6750,169,139,24000000,174,72,AM LC,3,3,3,14,3,1,2,6,1,3,3,14,16,13,14,13,14,9,14,4,3,12,12,8,16,13,12,13,13,12,13,13,14,16,11,13,5,12,12,14,14,13,10,20,13,14,14,13,7,12,4,11,5,13,13,15,13,12,12,11,10,9,1,1,14,20,10,20,18,AM LC,504,1,1,10,18,20,10,1,1,1,1,1,14,4,1,1,260,0,0,1,0,0,0,0,0,1,0,0,0,0,0,0,0,0,0,0,0,0,0,0,0,0,0,0,0,0,0,0,0,0,0,0,0,0,0,0,0,0,0,0,0,0,0,0,0,Antoine Griezmann,£7.20m ,29,176,Forward - Centre-Forward,left,FC Barcelona,39,7,4,3028,38,8,4,2795,35,11,5,2923,50,20,5,3678,53,25,6,3420,54,32,7,4380,53,26,12,4559,49,29,15,3872,48,21,10,4068,LaLiga,48,15,4,3499,5,0,0,273
13/6/2011,Anthony Ihou,85059098,50,3/4/1991,20,0,0,0,0,1100,2200,2200,126,88,675469,185,82,AM L,3,3,3,2,1,2,3,6,2,3,3,5,6,13,7,13,7,10,8,5,4,7,10,2,15,6,12,11,10,10,9,8,15,12,5,11,4,5,7,15,13,13,12,20,15,11,5,10,11,13,6,10,7,8,16,14,9,13,12,14,14,7,1,1,12,20,12,20,1,AM L,503,1,1,15,1,20,12,1,1,1,1,1,12,12,1,1,1,1,0,0,0,0,0,0,0,0,0,0,0,0,0,0,0,0,0,0,0,0,0,0,0,0,0,0,0,0,0,0,0,0,0,0,0,0,0,0,0,0,0,0,0,0,0,0,0,Anthony Ujah,£1.58m ,30,180,Forward - Centre-Forward,right,1.FC Union Berlin,13,13,4,1200,16,2,0,675,31,13,3,2626,37,11,4,2394,35,12,3,2602,52,19,8,3883,24,5,4,2070,12,0,0,253,23,4,0,843,Bundesliga,28,4,4,1181,nan,nan,nan,nan
13/6/2011,Andreas Ludwig,92017389,771,9/11/1990,20,0,0,0,0,2250,4400,4400,110,88,461782,172,68,M/AM/S LC,1,2,3,1,3,2,2,7,3,3,3,10,11,11,10,11,9,5,9,5,7,11,8,6,12,11,9,11,12,10,13,12,9,8,8,13,8,12,12,12,13,9,7,20,9,10,6,11,6,9,5,9,5,18,5,2,11,12,16,8,6,6,1,1,17,17,10,17,15,M/AM/S LC,634,1,1,20,15,17,10,1,1,1,1,13,17,5,1,1,0,0,0,0,0,0,0,0,0,0,0,0,0,0,0,0,0,0,0,0,0,0,0,0,0,0,0,0,0,0,0,0,0,0,0,0,0,0,0,0,0,0,0,0,0,0,0,0,0,,,,,,,,,,,,,,,,,,,,,,,,,,,,,,,,,,,,,,,,,,,,,,,,,,,,
13/6/2011,André Schürrle,91002405,771,11/6/1990,20,5,2,4,3,5900,7550,7550,164,149,84780364,184,74,AM/S LC,2,1,1,3,2,1,3,4,3,1,2,9,9,14,15,9,10,7,15,5,6,11,14,8,12,18,12,9,10,12,13,11,18,10,7,14,10,15,19,18,16,12,11,9,13,17,20,18,9,14,2,11,5,15,13,15,10,14,13,14,17,5,1,1,12,20,14,20,15,AM/S LC,514,1,1,18,15,20,14,1,1,1,1,8,12,10,1,1,5.49891E+11,0,0,0,0,1,0,0,0,1,0,0,0,0,0,0,0,0,0,0,1,0,0,0,0,0,0,0,1,0,0,0,0,0,0,0,0,0,0,0,1,0,0,0,0,0,0,0,0,André Schürrle,£12.60m ,29,184,Forward - Left Winger,right,Retired,34,15,5,2569,40,9,6,3333,43,14,10,3456,43,9,3,2065,44,6,3,2048,41,12,7,2588,25,5,4,1126,26,3,6,1706,25,6,0,1732,Bundesliga,18,2,4,1139,nan,nan,nan,nan
13/6/2011,Alper Uludag,92014216,799,12/11/1990,20,0,0,2,1,4700,5650,5700,139,114,1923696,180,77,M/AM LC,2,3,1,3,1,3,2,2,1,1,3,5,12,13,9,13,6,6,10,6,8,11,8,9,13,11,12,12,11,11,12,8,14,13,6,14,10,12,12,14,13,11,9,20,13,13,10,12,11,14,6,8,10,14,13,9,15,7,15,14,10,5,1,1,20,18,1,20,15,M/AM LC,414,1,1,1,15,18,1,1,1,1,1,1,20,1,1,1,0,0,0,0,0,0,0,0,0,0,0,0,0,0,0,0,0,0,0,0,0,0,0,0,0,0,0,0,0,0,0,0,0,0,0,0,0,0,0,0,0,0,0,0,0,0,0,0,0,,,,,,,,,,,,,,,,,,,,,,,,,,,,,,,,,,,,,,,,,,,,,,,,,,,,
13/6/2011,Alexander Zahavi,67022043,775,1/21/1991,20,0,0,5,1,2250,5000,5000,125,103,87464,173,69,AM RL,3,2,1,1,3,3,3,2,2,3,1,11,11,14,13,14,12,8,13,5,5,13,10,5,13,8,11,9,10,7,10,7,14,12,7,9,7,8,15,13,10,9,6,14,11,12,20,7,5,7,9,7,12,8,12,17,9,11,16,13,8,6,1,1,10,20,17,20,10,AM RL,505,1,1,15,10,20,17,1,1,1,1,10,10,10,1,1,5.49756E+11,0,0,0,0,0,0,0,0,0,0,0,0,0,0,0,0,0,0,0,0,0,0,0,0,0,0,0,0,0,0,0,0,0,0,0,0,0,0,0,1,0,0,0,0,0,0,0,0,Alex Zahavi,£180Th. ,29,175,Forward - Right Winger,right,Retired,10,0,0,267,1,0,0,10,nan,nan,nan,nan,nan,nan,nan,nan,nan,nan,nan,nan,nan,nan,nan,nan,nan,nan,nan,nan,nan,nan,nan,nan,nan,nan,nan,nan,Liga NOS,nan,nan,nan,nan,nan,nan,nan,nan
13/6/2011,Alberto Perea,67120790,796,12/19/1990,20,0,0,0,0,1750,4550,4550,130,96,4284891,177,68,M/AM RL,2,1,2,3,2,3,1,1,3,2,2,10,14,14,7,11,10,10,10,9,10,14,10,12,14,13,8,10,10,10,12,5,10,11,10,12,6,10,13,12,13,13,7,5,10,13,20,9,4,10,11,10,12,10,4,14,13,9,16,10,7,17,1,1,16,20,20,15,6,M/AM RL,525,1,1,1,6,15,20,1,1,1,1,1,10,16,1,1,0,0,0,0,0,0,0,0,0,0,0,0,0,0,0,0,0,0,0,0,0,0,0,0,0,0,0,0,0,0,0,0,0,0,0,0,0,0,0,0,0,0,0,0,0,0,0,0,0,Alberto Perea,£270Th. ,29,175,Forward - Left Winger,right,Cádiz CF,26,0,0,1663,21,5,0,1528,24,7,0,1547,10,1,0,554,20,1,0,777,31,11,4,2248,38,10,8,2540,23,2,1,1069,28,1,1,1675,LaLiga,33,5,2,2225,2,0,0,46
13/6/2011,Abdoulay Diaby,85054417,769,5/21/1991,20,0,0,0,0,2150,3250,3250,126,99,2890084,173,71,AM/S L,3,3,1,1,2,2,3,3,3,1,3,6,9,12,11,13,10,6,8,5,2,8,14,2,13,10,10,7,12,10,8,9,14,12,5,11,4,8,11,15,14,11,8,20,11,13,8,8,9,13,10,10,12,10,5,14,14,16,11,6,12,8,1,1,10,16,13,16,1,AM/S L,623,1,1,20,1,16,13,1,1,1,1,1,10,10,1,1,1.75922E+13,0,0,0,0,1,0,0,0,0,0,0,0,0,0,0,0,0,0,0,0,0,0,0,0,0,0,0,0,0,0,0,0,0,0,0,0,0,0,0,0,0,0,0,0,1,0,0,0,Abou Diaby,£4.50m ,34,191,Midfielder - Central Midfield,right,Retired,20,2,3,1257,6,1,0,158,16,0,1,1130,2,0,0,61,6,0,1,388,4,0,0,225,2,0,0,130,nan,nan,nan,nan,nan,nan,nan,nan,Premier League,nan,nan,nan,nan,nan,nan,nan,nan
13/6/2011,Younčs Belhanda,34008669,34,2/25/1990,21,0,0,0,0,4600,5759,5750,165,128,4796943,174,75,AM RL,3,1,3,2,2,2,3,1,2,3,2,13,10,14,7,14,13,8,13,8,6,14,8,9,16,11,14,12,13,13,14,13,14,14,8,11,10,13,16,15,13,13,7,5,15,12,20,13,13,14,11,16,7,12,11,15,9,9,9,12,14,5,10,1,15,20,20,15,10,AM RL,505,1,1,1,10,15,20,10,1,1,10,10,15,15,1,1,256,0,0,0,0,0,0,0,0,1,0,0,0,0,0,0,0,0,0,0,0,0,0,0,0,0,0,0,0,0,0,0,0,0,0,0,0,0,0,0,0,0,0,0,0,0,0,0,0,Younès Belhanda,£12.60m ,30,175,Midfielder - Attacking Midfield,right,Galatasaray SK,42,3,5,2957,31,13,6,2435,37,12,4,2859,33,7,6,2260,41,4,8,2918,31,2,3,1592,36,3,7,2809,35,3,10,2828,35,4,10,2730,Ligue 1,33,7,3,2459,9,2,0,578
13/6/2011,Yoric Ravet,85033191,769,9/12/1989,21,0,0,0,0,4150,5219,5200,140,116,2695557,178,74,AM RL,2,1,3,1,2,3,3,5,3,3,1,7,10,14,10,13,12,9,13,6,4,10,11,4,14,8,12,10,12,11,11,10,14,14,6,13,6,9,12,16,13,12,9,20,13,14,5,12,12,12,8,13,9,8,6,16,15,11,9,13,13,12,1,1,14,20,17,20,12,AM RL,505,1,1,12,12,20,17,1,1,1,1,1,14,14,1,1,2097152,0,0,0,0,0,0,0,0,0,0,0,0,0,0,0,0,0,0,0,0,0,1,0,0,0,0,0,0,0,0,0,0,0,0,0,0,0,0,0,0,0,0,0,0,0,0,0,0,Yoric Ravet,£450Th. ,31,178,Forward - Right Winger,right,Grenoble Foot 38,21,3,2,1183,2,0,0,67,31,3,3,1570,32,9,10,2604,43,10,8,3035,38,13,17,3135,44,10,20,3438,20,2,7,1181,21,3,1,1413,Ligue 1,0,0,0,0,7,1,2,599
13/6/2011,Yohan Mollo,34001050,769,7/18/1989,21,0,0,7,0,4650,5894,5850,165,131,1999999,175,74,M/AM RL,1,2,1,1,2,1,1,3,3,1,3,13,12,15,7,15,13,8,12,5,3,12,10,3,17,12,11,10,11,10,13,8,15,16,6,13,5,10,9,17,15,12,7,10,13,14,20,14,12,11,10,14,9,8,14,17,8,12,14,12,12,15,1,1,17,20,17,20,10,M/AM RL,525,1,1,10,10,20,17,1,1,1,1,1,17,14,1,1,2.25183E+15,0,0,0,0,0,0,0,0,0,0,0,0,0,0,1,0,0,0,0,0,0,0,0,0,0,0,0,0,0,0,0,0,0,0,0,1,0,0,0,0,0,0,0,0,0,0,0,0,Yohan Mollo,£2.70m ,31,175,Forward - Left Winger,right,Panathinaikos Athens,38,4,2,2547,26,3,6,1769,43,7,13,2779,21,1,3,1119,31,4,3,1765,28,0,7,2231,20,6,4,1317,12,0,2,692,23,2,4,1570,LaLiga,12,1,4,678,1,0,0,22
13/6/2011,Yoann Court,85003856,769,1/14/1990,21,0,0,0,0,2450,3700,3700,140,112,1159105,172,65,AM LC,1,2,2,3,2,3,3,1,1,1,2,10,12,13,10,12,11,7,9,8,2,12,7,6,14,8,9,8,12,12,13,11,14,13,7,12,6,11,14,15,15,11,6,20,15,13,7,16,7,14,7,16,5,10,12,13,13,16,14,14,14,6,1,1,15,20,10,18,20,AM LC,504,1,1,12,20,18,10,1,1,1,1,12,15,10,1,1,34359738369,1,0,0,0,0,0,0,0,0,0,0,0,0,0,0,0,0,0,0,0,0,0,0,0,0,0,0,0,0,0,0,0,0,0,0,1,0,0,0,0,0,0,0,0,0,0,0,0,Yoann Poulard,£360Th. ,44,190,Defender - Centre-Back,right,Retired,42,4,0,3810,36,2,0,3240,37,0,0,3351,nan,nan,nan,nan,nan,nan,nan,nan,nan,nan,nan,nan,nan,nan,nan,nan,nan,nan,nan,nan,nan,nan,nan,nan,Ligue 1,nan,nan,nan,nan,nan,nan,nan,nan
13/6/2011,Yacine Brahimi,34002647,769,2/8/1990,21,0,0,5,1,4350,5450,5450,160,121,2286973,175,65,AM RLC,2,1,3,3,2,2,2,4,2,3,3,12,12,15,7,16,13,5,10,5,1,13,12,2,16,6,10,7,13,11,14,10,13,16,7,13,5,7,10,16,15,12,7,10,15,13,20,14,7,13,6,14,6,8,14,16,14,11,12,14,14,8,1,1,15,20,18,18,20,AM RLC,506,1,1,1,20,18,18,1,1,1,1,15,12,12,1,1,2.25183E+15,0,0,0,0,0,0,0,0,0,0,0,0,0,0,0,0,0,0,0,0,1,0,0,0,0,0,0,0,0,0,0,0,0,0,0,1,0,0,0,0,0,0,0,0,0,0,0,0,Yacine Brahimi,£2.70m ,30,175,Forward - Left Winger,right,Al-Rayyan SC,26,6,3,1509,28,3,2,1130,28,0,2,1916,36,3,3,2858,42,13,10,2835,44,9,10,3245,31,7,4,1927,49,12,10,3914,49,13,9,3429,Ligue 1,23,15,5,2040,3,1,1,270
13/6/2011,Vladimir Weiss,4001874,794,11/30/1989,21,18,1,7,0,5300,6800,6800,164,131,9064167,176,69,M/AM RLC,2,1,1,3,3,2,2,2,3,1,2,13,14,15,12,15,13,3,12,3,3,13,9,5,15,9,15,10,11,11,15,10,15,15,7,15,5,11,11,16,15,16,6,4,13,15,20,14,9,12,8,13,7,13,15,14,9,14,14,9,15,7,1,1,17,20,20,17,15,M/AM RLC,526,1,1,7,15,14,20,1,1,1,1,15,17,15,1,1,7.04206E+13,0,1,0,0,0,0,0,0,0,0,0,0,0,0,0,0,0,0,0,0,0,0,0,0,0,0,0,0,1,0,0,0,0,0,1,1,0,0,0,0,0,0,0,0,0,0,1,0,Vladimir Weiss,£3.15m ,30,173,Forward - Left Winger,right,Slovan Bratislava,35,5,15,1858,33,4,5,2146,23,5,5,1492,39,11,10,2585,31,10,7,2060,24,10,5,1882,21,10,4,1821,7,5,1,500,20,8,2,1431,LaLiga,8,1,0,292,6,0,2,188
13/6/2011,Urreta,78016324,1657,3/19/1990,21,0,0,6,2,4000,5950,5750,143,127,2243605,174,62,AM RL,2,3,1,2,1,1,3,5,1,1,1,13,13,13,11,10,13,7,9,7,4,10,13,4,13,12,9,7,9,5,11,8,12,15,9,12,4,8,6,17,15,6,5,10,14,14,20,13,3,8,9,10,9,13,11,15,5,10,10,8,14,13,1,1,11,20,20,16,10,AM RL,505,1,1,15,10,16,20,1,1,1,1,1,7,11,1,1,1.41837E+14,0,0,0,0,1,0,0,0,0,0,0,0,0,0,0,0,0,0,0,0,0,0,0,0,0,0,0,1,0,0,0,0,0,0,0,0,0,0,0,0,1,0,0,0,0,0,0,1,,,,,,,,,,,,,,,,,,,,,,,,,,,,,,,,,,,,,,,,,,,,,,,,,,,,
13/6/2011,Tunay Torun,35018672,799,4/21/1990,21,1,0,5,0,3750,5750,5950,142,109,2392891,179,72,AM/S RLC,3,3,2,2,2,1,3,3,2,1,3,7,9,14,11,14,10,6,7,4,4,13,9,6,15,8,10,5,11,8,12,10,6,14,4,12,6,7,8,14,13,9,8,20,14,12,10,9,11,10,11,8,5,10,7,12,10,14,10,4,6,17,1,1,14,20,16,15,20,AM/S RLC,516,1,1,17,20,15,16,1,1,1,1,10,10,14,1,1,0,0,0,0,0,0,0,0,0,0,0,0,0,0,0,0,0,0,0,0,0,0,0,0,0,0,0,0,0,0,0,0,0,0,0,0,0,0,0,0,0,0,0,0,0,0,0,0,0,Tunay Torun,£1.13m ,30,176,Forward - Right Winger,right,Caykur Rizespor,10,3,2,645,25,5,0,1214,16,1,1,723,17,3,1,550,31,5,9,2287,32,2,6,1874,29,3,7,2041,11,0,1,554,26,0,2,1316,Bundesliga,9,1,0,426,3,0,0,79
13/6/2011,Tripy Makonda,85030344,769,1/24/1990,21,0,0,8,0,2600,5219,5200,135,116,4218733,180,70,D/WB L,2,3,2,3,3,3,1,3,3,2,1,11,14,12,6,13,11,12,10,13,9,11,7,12,13,10,11,12,11,10,11,10,13,11,8,13,10,14,13,15,13,13,10,20,15,14,5,14,13,12,10,13,7,10,5,11,15,11,15,13,13,5,20,17,15,10,1,20,8,D/WB L,113,1,1,1,1,10,1,1,20,1,8,8,15,1,17,1,1.09951E+12,1,0,0,0,0,1,0,0,0,0,0,0,0,0,0,0,0,0,0,0,0,0,0,0,0,0,0,0,0,0,0,0,0,0,0,0,0,0,0,0,1,0,0,0,0,0,0,0,Tripy Makonda,£540Th. ,30,180,Defender - Left-Back,left,FC RM Hamm Benfica,17,0,1,711,8,0,1,619,10,0,0,848,22,0,1,1396,15,0,0,600,1,0,0,13,37,2,1,2758,nan,nan,nan,nan,nan,nan,nan,nan,Ligue 1,13,2,1,1009,1,0,0,13
13/6/2011,Toni,67056003,796,4/4/1990,21,0,0,0,0,3150,5150,5150,134,103,800768,175,69,M/AM LC,2,1,2,2,2,1,2,1,3,1,1,12,12,13,9,14,10,7,10,6,6,13,12,5,13,6,8,8,13,8,12,11,5,12,6,12,8,9,10,13,11,10,7,20,14,12,8,13,9,11,3,11,5,12,14,18,15,14,7,8,6,5,9,1,17,20,13,20,16,M/AM LC,524,1,1,1,16,20,13,1,9,1,1,13,17,1,1,1,0,0,0,0,0,0,0,0,0,0,0,0,0,0,0,0,0,0,0,0,0,0,0,0,0,0,0,0,0,0,0,0,0,0,0,0,0,0,0,0,0,0,0,0,0,0,0,0,0,Tony,£450Th. ,39,174,Defender - Right-Back,right,Retired,15,0,1,1236,8,0,0,583,27,1,0,2385,27,0,0,2271,14,0,0,1111,nan,nan,nan,nan,nan,nan,nan,nan,nan,nan,nan,nan,nan,nan,nan,nan,Liga NOS,nan,nan,nan,nan,nan,nan,nan,nan
13/6/2011,Toni Kroos,156772,771,1/4/1990,21,18,0,10,2,6600,7950,7950,175,149,49683171,182,74,M/AM LC,3,2,3,2,2,2,2,5,3,3,3,16,18,13,14,19,15,6,17,6,6,18,14,10,17,7,13,8,15,9,17,16,8,11,9,8,11,15,8,11,13,8,9,17,12,13,20,12,10,10,3,14,6,15,13,12,16,9,13,15,18,4,1,1,20,19,14,16,20,M/AM LC,414,1,1,1,19,16,14,1,1,1,10,20,14,13,1,1,4.5124E+15,0,0,0,0,0,0,0,0,0,0,0,1,0,0,0,0,0,0,0,0,0,0,1,0,0,0,0,0,0,0,0,0,0,0,0,0,0,0,0,0,0,0,0,1,0,0,0,0,Toni Kroos,£20.70m ,30,183,Midfielder - Central Midfield,right,Real Madrid,37,2,8,2409,51,7,19,4095,37,9,8,2857,51,4,9,3931,55,2,14,4600,44,1,13,3741,48,4,16,4170,43,5,10,3570,43,1,6,3431,Bundesliga,45,6,9,3569,5,0,0,323
13/6/2011,Tom Cleverley,28000906,765,8/12/1989,21,0,0,16,0,4850,7100,7100,160,136,19491209,175,67,M/AM RLC,2,2,2,2,2,2,2,2,2,2,2,11,15,13,13,14,6,9,14,9,9,14,4,10,14,13,13,13,14,10,10,10,18,12,9,14,9,15,15,14,11,12,8,13,15,14,20,14,11,14,10,10,9,16,9,11,14,16,16,12,12,2,1,1,19,20,18,18,20,M/AM RLC,526,1,1,1,20,18,17,1,1,1,1,19,18,18,1,1,2.2518E+15,0,0,0,1,0,1,0,0,0,0,0,0,0,0,0,0,0,0,0,0,0,0,0,0,0,0,0,0,1,0,0,0,0,0,0,0,0,0,0,0,0,0,0,0,0,0,0,0,Tom Cleverley,£7.65m ,31,175,Midfielder - Central Midfield,right,Watford FC,25,4,2,1632,17,0,4,944,33,4,4,2353,31,1,1,2227,38,3,0,3098,30,2,6,2319,29,0,3,1958,25,1,3,2008,17,1,1,662,Premier League,19,1,0,1000,7,1,0,506
13/6/2011,Tobias Kempe,92018045,771,6/27/1989,21,0,0,0,0,4300,5600,5600,135,115,622746,184,74,M/AM RLC,1,3,3,3,2,1,1,2,2,2,1,12,13,13,11,12,10,10,11,6,8,13,7,12,13,13,11,13,9,10,11,11,13,13,7,12,10,13,14,12,12,15,11,11,15,12,20,12,13,11,12,10,17,15,14,12,11,12,13,12,11,7,1,1,18,20,20,17,17,M/AM RLC,526,1,1,10,17,17,20,1,1,1,1,15,15,18,1,1,34359738368,0,0,0,0,0,0,0,0,0,0,0,0,0,0,0,0,0,0,0,0,0,0,0,0,0,0,0,0,0,0,0,0,0,0,0,1,0,0,0,0,0,0,0,0,0,0,0,0,,,,,,,,,,,,,,,,,,,,,,,,,,,,,,,,,,,,,,,,,,,,,,,,,,,,
13/6/2011,Thomas Müller,35011448,771,9/13/1989,21,18,7,6,1,7250,8700,8700,172,164,229999992,186,74,AM RLC,3,1,1,2,3,1,1,7,2,3,3,7,10,11,14,13,7,12,9,8,7,12,11,8,12,15,18,12,17,13,15,18,18,16,7,19,10,18,17,16,14,17,13,11,18,14,20,17,11,12,9,16,7,18,4,12,17,18,14,12,17,4,1,1,14,20,19,16,20,AM RLC,506,1,1,15,20,16,19,1,1,1,1,10,14,14,1,1,1573936,0,0,0,0,1,1,0,0,0,0,1,0,0,0,0,0,0,0,0,1,1,0,0,0,0,0,0,0,0,0,0,0,0,0,0,0,0,0,0,0,0,0,0,0,0,0,0,0,Thomas MÃ¼ller,£28.80m ,31,186,Forward - Second Striker,right,Bayern Munich,48,19,19,3942,53,11,20,3913,47,23,17,3571,51,26,14,3575,48,21,18,3579,49,32,12,3820,42,9,17,3004,45,15,18,3125,45,9,16,3251,Bundesliga,50,14,26,3499,9,5,5,775
13/6/2011,Stevan Jovetic,5789007,62002127,11/2/1989,21,14,6,6,2,6500,7850,7600,176,152,50253386,183,79,AM/S LC,2,1,2,1,2,1,2,7,2,3,1,10,13,16,14,16,12,12,13,10,7,16,8,6,17,12,14,11,12,12,16,13,13,14,12,14,7,14,14,15,14,13,12,12,14,14,20,12,11,15,10,16,8,10,15,15,13,16,16,14,16,5,1,1,1,18,12,16,18,AM/S LC,624,1,1,20,18,16,12,1,1,1,1,1,1,1,1,1,134218256,0,0,0,0,1,0,0,0,0,1,0,0,0,0,0,0,0,0,0,0,0,0,0,0,0,0,0,1,0,0,0,0,0,0,0,0,0,0,0,0,0,0,0,0,0,0,0,0,Stevan Jovetic,£22.50m ,30,183,Forward - Centre-Forward,right,AS Monaco,nan,nan,nan,nan,29,14,3,2524,34,13,5,2750,18,6,2,578,26,5,4,1184,28,7,4,1715,29,7,5,1449,21,10,2,1103,10,2,1,493,Serie A,13,2,1,611,7,0,0,189
13/6/2011,Sofiane Choubani,34002649,769,3/29/1990,21,0,0,0,0,1700,3400,3400,140,104,236394,179,69,AM RL,3,2,1,3,1,2,2,3,1,2,2,10,13,12,6,12,11,11,13,6,2,11,8,2,13,6,10,9,8,8,11,9,15,13,5,11,5,9,8,15,13,12,9,12,14,13,20,11,8,13,6,14,8,8,11,13,13,11,14,14,14,6,1,1,14,20,20,18,12,AM RL,505,1,1,1,12,18,20,1,1,1,1,1,14,14,1,1,1.09951E+12,0,0,0,0,0,0,0,0,0,1,0,0,0,0,0,0,0,0,0,0,0,0,0,0,0,0,0,0,0,0,0,0,0,0,0,0,0,0,0,0,1,0,0,0,0,0,0,0,Sofiane Feghouli,£7.20m ,30,177,Forward - Right Winger,right,Galatasaray SK,15,3,0,504,49,6,11,3142,37,6,7,2902,45,7,10,2885,33,6,8,1931,33,5,4,2042,28,4,3,1508,31,7,10,2191,40,13,7,2804,LaLiga,36,7,6,2821,7,0,1,459
13/6/2011,Simone Guerra,43006969,776,8/30/1989,21,0,0,0,0,500,5150,5150,130,108,1613553,178,70,AM RL,1,1,3,1,3,1,1,1,1,3,3,6,10,12,10,10,9,7,11,3,4,14,13,6,10,11,7,13,10,8,11,12,12,12,4,13,5,14,15,13,12,11,7,8,14,13,20,11,9,14,6,14,4,14,10,14,9,8,14,10,7,3,1,1,14,20,20,20,1,AM RL,505,1,1,15,1,20,20,1,1,1,1,1,14,14,1,1,0,0,0,0,0,0,0,0,0,0,0,0,0,0,0,0,0,0,0,0,0,0,0,0,0,0,0,0,0,0,0,0,0,0,0,0,0,0,0,0,0,0,0,0,0,0,0,0,0,Simone Perrotta,£720Th. ,43,178,Midfielder - Attacking Midfield,right,Retired,35,4,2,2692,23,1,0,961,17,2,1,588,nan,nan,nan,nan,nan,nan,nan,nan,nan,nan,nan,nan,nan,nan,nan,nan,nan,nan,nan,nan,nan,nan,nan,nan,Serie A,nan,nan,nan,nan,nan,nan,nan,nan
13/6/2011,Sercan Sararer,35012153,796,11/27/1989,21,0,0,0,0,2200,5354,5750,138,119,901626,180,84,AM/S RL,1,2,2,2,2,1,3,3,2,2,1,5,9,14,12,13,8,11,10,17,4,10,10,6,14,15,10,11,11,8,8,9,15,15,4,10,4,7,10,14,14,15,10,10,16,15,20,10,14,7,8,14,12,10,10,9,12,13,7,11,13,12,1,1,10,20,20,19,14,AM/S RL,515,1,1,19,14,19,20,1,1,1,1,1,10,10,1,1,2.25183E+15,0,0,0,0,0,0,0,0,0,0,0,0,0,0,0,0,0,0,0,0,0,0,0,0,0,0,0,0,0,0,0,0,0,0,0,1,0,0,0,0,0,0,0,0,0,0,0,0,,,,,,,,,,,,,,,,,,,,,,,,,,,,,,,,,,,,,,,,,,,,,,,,,,,,
13/6/2011,Sascha Bigalke,35015007,771,1/8/1990,21,0,0,0,0,3400,4750,4750,128,95,333008,167,62,M/AM RLC,1,3,2,1,2,2,1,1,1,1,3,12,11,13,6,14,12,3,8,6,2,11,9,3,14,13,8,10,8,7,12,7,13,16,5,13,5,8,13,15,15,7,4,10,11,13,20,8,4,9,5,6,4,10,8,12,11,6,12,12,14,16,1,1,18,20,16,20,18,M/AM RLC,526,1,1,14,18,20,16,1,1,1,1,1,18,14,1,1,2.2518E+15,0,0,0,0,0,0,0,0,0,0,0,0,0,0,0,0,0,0,0,0,0,0,0,0,0,0,0,0,0,0,1,0,0,0,0,0,0,0,0,0,0,0,0,0,0,0,0,0,,,,,,,,,,,,,,,,,,,,,,,,,,,,,,,,,,,,,,,,,,,,,,,,,,,,
13/6/2011,Sandro Kaiser,91012814,771,9/21/1989,21,0,0,0,0,4250,5300,5300,126,106,545691,178,69,D/WB/M/AM RL,2,2,3,1,3,2,3,1,3,2,2,6,11,11,5,11,6,4,6,4,9,11,4,10,12,10,11,11,10,10,9,8,13,11,3,11,9,13,13,13,12,10,9,16,13,13,20,10,8,8,6,10,6,16,14,13,12,11,12,11,14,4,16,18,20,18,20,18,1,D/WB/M/AM RL,445,1,1,1,1,16,18,1,14,16,1,1,18,20,16,18,0,0,0,0,0,0,0,0,0,0,0,0,0,0,0,0,0,0,0,0,0,0,0,0,0,0,0,0,0,0,0,0,0,0,0,0,0,0,0,0,0,0,0,0,0,0,0,0,0,Sandro Wieser,£720Th. ,27,185,Midfielder - Defensive Midfield,left,FC Vaduz,18,4,0,1101,24,0,2,1887,16,0,0,1085,14,0,4,1067,20,7,1,1008,26,4,1,2133,6,1,0,423,11,1,0,548,36,4,1,3130,Bundesliga,24,0,1,1554,6,0,0,329
13/6/2011,Ryad Boudebouz,8449112,5,2/19/1990,21,8,0,0,0,5500,6800,6100,160,136,28046756,172,59,AM RL,3,1,1,3,3,2,3,1,3,2,1,13,12,16,9,16,14,5,14,5,1,14,15,4,18,8,11,7,13,12,13,11,14,16,5,15,5,8,9,17,15,12,6,20,16,13,10,14,6,11,8,15,8,10,9,16,13,11,9,12,12,13,1,1,10,20,20,17,12,AM RL,505,1,1,1,12,17,20,1,1,1,8,10,10,10,1,1,2.25238E+15,0,0,0,0,0,0,0,0,0,0,0,0,0,0,0,0,0,0,0,0,0,0,0,0,0,0,0,0,0,0,0,0,0,0,0,1,0,0,0,1,0,0,0,0,0,0,0,0,Ryad Boudebouz,£6.30m ,30,177,Midfielder - Attacking Midfield,left,AS Saint-Étienne,40,8,8,3423,40,6,5,3405,35,5,7,2681,37,4,6,2884,38,5,3,3217,39,2,12,3277,34,11,10,3015,29,3,3,1516,23,1,2,1340,Ligue 1,30,2,4,1911,nan,nan,nan,nan
13/6/2011,Romain Amalfitano,85019201,769,8/27/1989,21,0,0,0,0,2300,3550,3550,135,108,1294334,175,69,AM RL,1,1,2,3,3,1,2,1,1,1,3,9,11,13,8,13,7,8,12,5,4,12,12,4,15,9,9,8,11,11,12,11,13,12,6,12,7,9,10,15,13,12,7,9,13,13,20,12,8,12,8,13,11,7,5,12,12,12,11,14,14,7,8,8,15,20,17,20,14,AM RL,505,1,1,14,14,20,17,1,1,8,1,14,15,15,1,8,2.2518E+15,0,0,0,0,0,0,0,0,0,0,0,0,0,0,0,0,0,0,0,0,0,0,0,0,0,0,0,0,0,0,0,0,0,0,0,0,0,0,0,0,0,0,0,0,0,0,0,0,Morgan Amalfitano,£6.30m ,35,178,Forward - Right Winger,right,Retired,42,5,16,3835,49,2,10,3683,36,1,6,2513,32,4,4,2228,28,3,2,1352,21,2,1,1450,25,1,0,1294,15,0,0,767,nan,nan,nan,nan,Ligue 1,nan,nan,nan,nan,nan,nan,nan,nan
13/6/2011,Rémy Cabella,34008670,769,3/8/1990,21,0,0,5,1,1350,2750,2750,149,110,1565774,171,62,M/AM LC,2,2,1,2,1,1,2,5,2,1,2,10,10,14,8,14,10,6,11,7,1,11,8,2,16,5,10,7,14,14,13,13,14,13,6,13,5,9,12,16,15,8,5,20,8,15,5,12,5,14,5,16,13,8,7,14,14,13,12,15,15,5,1,1,18,20,10,16,20,M/AM LC,524,1,1,10,20,16,10,1,1,1,1,18,16,10,1,1,2.2518E+15,0,0,0,0,0,0,0,0,0,0,0,0,0,0,0,0,0,0,0,0,0,0,0,0,0,0,0,0,0,0,0,0,0,0,0,0,0,0,0,0,0,0,0,0,0,0,0,0,Rémy Cabella,£2.70m ,30,171,Midfielder - Attacking Midfield,right,FK Krasnodar,18,3,0,790,34,6,2,1758,41,8,8,3133,41,14,8,3535,34,1,2,2173,45,6,3,3194,32,6,5,1853,31,8,7,2415,37,10,5,3239,Ligue 1,12,2,1,556,10,6,2,714
13/6/2011,Pizzi,55012829,788,10/6/1989,21,0,0,2,0,3500,6000,6000,149,126,3688992,180,66,AM RL,1,3,2,3,1,1,3,4,2,3,3,12,13,14,12,14,12,6,10,6,6,11,12,9,15,10,11,10,13,10,10,11,14,17,8,14,9,10,11,14,14,10,9,13,13,13,20,10,11,11,6,12,7,11,10,13,14,13,14,14,14,6,1,1,9,20,20,20,13,AM RL,505,1,1,5,13,20,20,1,1,1,1,1,9,1,1,1,0,0,0,0,0,0,0,0,0,0,0,0,0,0,0,0,0,0,0,0,0,0,0,0,0,0,0,0,0,0,0,0,0,0,0,0,0,0,0,0,0,0,0,0,0,0,0,0,0,Pizzi,£4.05m ,31,177,Midfielder - Right Midfield,right,SL Benfica,35,11,3,2599,18,1,1,639,36,8,7,3160,34,4,1,1857,31,4,8,1883,47,8,12,3225,52,13,12,4251,45,6,12,3534,55,15,23,4215,LaLiga,51,30,19,4111,6,2,0,411
13/6/2011,Pedro Botelho,19038083,1651,12/14/1989,21,0,0,0,0,3750,5500,5750,150,116,1719719,188,72,D/WB L,1,2,2,2,1,2,2,3,2,1,1,7,13,14,5,11,8,6,13,12,6,12,10,8,14,8,13,15,13,9,9,9,12,15,10,16,7,12,11,15,14,14,13,20,12,15,7,16,11,11,4,13,7,16,14,10,8,12,5,13,7,15,20,19,15,14,1,20,1,D/WB L,113,1,1,1,1,14,1,1,20,1,1,1,15,1,19,1,32,0,0,0,0,0,1,0,0,0,0,0,0,0,0,0,0,0,0,0,0,0,0,0,0,0,0,0,0,0,0,0,0,0,0,0,0,0,0,0,0,0,0,0,0,0,0,0,0,Pedro Botelho,£1.35m ,30,186,Defender - Left-Back,left,Rio Branco Sport Club (PR),40,4,0,3565,46,3,2,3369,21,2,0,1736,11,1,1,877,8,0,0,440,11,0,0,635,10,0,0,468,9,1,0,627,nan,nan,nan,nan,LaLiga,nan,nan,nan,nan,nan,nan,nan,nan
13/6/2011,Patrick Amrhein,35011334,771,10/20/1989,21,0,0,0,0,2850,4100,4100,99,82,53568,187,87,M/AM RLC,1,2,1,2,1,1,2,2,2,1,1,7,11,13,10,9,9,7,8,2,3,13,9,7,8,8,12,4,6,10,12,9,9,13,3,10,9,7,11,13,10,13,12,20,12,10,7,6,6,10,5,9,8,10,5,18,17,18,18,8,11,13,1,1,18,20,18,20,18,M/AM RLC,526,1,1,1,18,20,18,1,1,1,1,14,18,16,1,1,0,0,0,0,0,0,0,0,0,0,0,0,0,0,0,0,0,0,0,0,0,0,0,0,0,0,0,0,0,0,0,0,0,0,0,0,0,0,0,0,0,0,0,0,0,0,0,0,0,,,,,,,,,,,,,,,,,,,,,,,,,,,,,,,,,,,,,,,,,,,,,,,,,,,,
13/6/2011,Ömer Kanca,91002957,799,12/24/1989,21,0,0,0,0,2700,2500,4000,103,80,12127,177,75,AM/S RL,1,1,1,3,1,2,1,1,1,1,3,7,10,10,11,7,7,7,5,1,1,11,7,8,8,5,9,5,11,11,6,6,10,8,8,9,2,5,9,11,11,11,6,16,11,11,20,4,3,10,10,10,10,10,4,10,12,7,9,8,8,5,1,1,15,18,18,18,12,AM/S RL,625,1,1,20,12,18,18,1,1,1,1,1,15,15,1,1,0,0,0,0,0,0,0,0,0,0,0,0,0,0,0,0,0,0,0,0,0,0,0,0,0,0,0,0,0,0,0,0,0,0,0,0,0,0,0,0,0,0,0,0,0,0,0,0,0,,,,,,,,,,,,,,,,,,,,,,,,,,,,,,,,,,,,,,,,,,,,,,,,,,,,
13/6/2011,Martyn Waghorn,28005574,765,1/23/1990,21,0,0,0,0,3250,5665,5850,129,103,4631053,177,83,AM/S L,3,2,3,2,2,3,3,2,2,3,3,10,10,12,12,12,10,12,10,3,3,11,14,10,10,17,10,9,12,8,10,8,16,11,8,10,8,12,15,12,10,9,9,20,10,13,10,13,11,12,16,8,11,9,7,11,10,8,7,7,6,12,1,1,10,16,1,16,12,AM/S L,623,1,1,20,12,16,1,1,1,1,1,1,10,1,1,1,4.39912E+12,0,0,0,0,0,0,0,0,0,0,0,0,0,0,0,0,0,0,0,0,0,0,0,0,0,0,0,0,0,0,1,0,0,0,0,0,0,0,0,0,0,0,1,0,0,0,0,0,,,,,,,,,,,,,,,,,,,,,,,,,,,,,,,,,,,,,,,,,,,,,,,,,,,,
13/6/2011,Marcel Risse,35017367,771,12/17/1989,21,0,0,2,0,4050,6450,6450,137,133,1578044,183,78,M/AM RL,3,2,1,2,1,2,2,7,3,1,1,10,12,13,11,13,14,9,11,7,8,13,8,9,13,12,13,12,11,11,11,12,12,10,6,12,8,13,14,16,14,10,11,10,14,16,20,11,9,12,3,13,3,13,14,12,12,10,11,14,16,4,1,1,17,20,20,15,1,M/AM RL,525,1,1,12,1,15,20,1,1,1,1,1,15,17,1,1,2.2518E+15,0,0,0,0,0,0,0,0,0,0,0,0,0,0,0,0,0,0,0,0,0,0,0,0,0,0,0,0,0,0,0,0,0,0,0,0,0,0,0,0,0,0,0,0,0,0,0,0,Marcel Risse,£2.03m ,30,183,Midfielder - Right Midfield,right,FC Viktoria KÃ¶ln,27,1,7,1414,14,2,4,1008,25,1,2,823,34,11,4,2473,31,5,4,2421,35,3,7,3143,15,4,5,1314,18,1,3,1284,23,2,7,1771,Bundesliga,7,0,2,183,3,0,0,126
13/6/2011,Marcel Gaus,91014208,771,8/2/1989,21,0,0,0,0,3000,5300,5300,122,100,699928,181,76,AM/S L,2,1,2,2,3,3,1,3,1,2,3,10,12,11,11,14,9,14,7,5,4,9,9,9,12,6,12,3,11,9,8,12,7,10,5,8,6,8,12,14,12,13,12,20,8,13,8,8,6,10,10,8,7,10,5,16,11,5,14,7,14,11,1,1,1,18,1,18,1,AM/S L,623,1,1,20,1,18,1,1,1,1,1,1,1,1,1,1,0,0,0,0,0,0,0,0,0,0,0,0,0,0,0,0,0,0,0,0,0,0,0,0,0,0,0,0,0,0,0,0,0,0,0,0,0,0,0,0,0,0,0,0,0,0,0,0,0,,,,,,,,,,,,,,,,,,,,,,,,,,,,,,,,,,,,,,,,,,,,,,,,,,,,
13/6/2011,Marc Rzatkowski,91003881,771,3/2/1990,21,0,0,0,0,3250,4850,4850,119,103,242481,171,65,DM/M/AM LC,3,3,3,1,1,2,2,5,2,2,3,7,12,15,11,12,10,9,12,5,7,13,8,7,13,12,11,9,10,11,11,9,10,11,7,12,11,12,13,11,14,13,7,20,11,12,5,11,12,9,5,10,4,14,6,20,10,8,12,6,10,5,1,1,20,17,1,17,20,DM/M/AM LC,434,1,1,1,1,17,1,1,1,1,16,20,17,1,1,1,0,0,0,0,0,0,0,0,0,0,0,0,0,0,0,0,0,0,0,0,0,0,0,0,0,0,0,0,0,0,0,0,0,0,0,0,0,0,0,0,0,0,0,0,0,0,0,0,0,,,,,,,,,,,,,,,,,,,,,,,,,,,,,,,,,,,,,,,,,,,,,,,,,,,,
13/6/2011,Marc Albrighton,29010506,765,11/18/1989,21,0,0,8,1,4000,6500,6500,152,128,7853627,175,67,M/AM RL,1,1,2,1,1,2,1,5,1,1,1,12,18,12,10,12,12,5,10,3,6,12,10,6,12,10,11,12,12,11,12,9,14,12,7,13,5,15,18,15,14,14,6,8,16,12,20,16,6,12,7,10,6,11,8,12,18,11,13,16,15,5,1,1,17,20,20,15,4,M/AM RL,525,1,1,5,4,15,20,1,1,1,1,1,14,17,1,1,1.09965E+12,0,1,0,0,0,0,0,0,0,0,0,0,0,0,0,0,0,0,0,0,0,0,0,0,0,0,0,1,0,0,0,0,0,0,0,0,0,0,0,0,1,0,0,0,0,0,0,0,Marc Albrighton,£4.50m ,30,175,Midfielder - Right Midfield,right,Leicester City,36,7,13,2298,33,4,5,2106,14,1,1,726,26,0,4,1416,24,3,4,1467,42,2,7,3006,47,4,9,3522,42,2,7,2968,32,3,4,1936,Premier League,28,0,5,1439,4,0,0,125
13/6/2011,Konstantin Rausch,35013627,771,3/15/1990,21,0,0,7,1,4800,6800,6800,154,136,14224972,182,76,D/WB/M/AM L,3,2,1,2,3,1,3,3,2,3,3,12,14,12,15,9,11,10,13,14,8,13,9,12,10,14,8,15,9,13,9,10,12,8,11,15,8,14,17,14,10,14,11,20,14,17,14,17,13,11,8,9,7,14,4,9,5,11,13,15,5,5,19,18,18,20,1,20,1,D/WB/M/AM L,543,1,1,1,1,20,1,1,19,1,1,1,18,1,18,1,5.49756E+11,0,0,0,0,0,1,0,0,0,1,0,0,0,0,0,0,0,0,0,0,0,0,0,0,0,0,0,0,0,0,0,0,0,0,0,0,0,0,0,1,0,0,0,0,0,0,0,0,Konstantin Rausch,£3.60m ,30,181,Defender - Left-Back,left,Dynamo Moscow,34,5,5,2842,49,2,8,3091,42,4,11,3119,23,2,0,1668,13,2,1,865,33,3,6,2231,31,1,3,2234,29,0,4,2357,16,0,2,1165,Bundesliga,18,1,4,1383,2,0,0,26
13/6/2011,Kieran Gibbs,29003721,765,9/26/1989,21,2,0,15,3,4750,6750,6650,160,126,55077861,178,66,D/M/AM L,2,3,3,2,1,1,2,1,2,2,3,9,12,13,8,12,8,8,10,7,9,12,7,12,13,10,10,12,12,10,10,10,15,12,8,11,9,14,14,16,14,14,9,20,15,16,10,14,8,12,8,12,13,10,5,14,16,12,15,14,17,6,20,15,19,17,10,20,14,D/M/AM L,123,1,1,1,1,17,1,1,20,9,1,14,19,10,15,1,7.03687E+13,1,0,0,0,0,1,0,0,0,0,0,0,0,0,0,0,0,0,0,0,0,0,0,0,0,0,0,0,0,0,0,0,0,0,0,0,0,0,0,0,0,0,0,0,0,0,1,0,Kieran Gibbs,£4.50m ,31,180,Defender - Left-Back,left,West Bromwich Albion,20,0,2,1391,22,2,0,1642,34,1,5,2684,41,1,5,3035,33,1,5,2595,27,1,0,1223,22,0,5,1648,37,0,3,3014,38,4,4,3247,Premier League,15,1,2,1081,2,0,0,135
13/6/2011,Kevin,67018556,796,9/8/1989,21,0,0,0,0,3500,5750,5750,135,120,13454029,177,72,D/WB L,1,1,1,2,3,2,1,6,1,2,2,13,12,10,9,12,10,9,8,13,14,12,8,13,9,16,12,13,11,12,9,12,9,8,12,12,14,13,14,14,14,10,9,20,12,15,6,15,11,14,11,10,4,11,15,19,9,9,12,11,12,11,20,18,15,1,9,20,1,D/WB L,113,1,1,1,1,1,1,1,20,9,1,1,15,1,18,1,0,0,0,0,0,0,0,0,0,0,0,0,0,0,0,0,0,0,0,0,0,0,0,0,0,0,0,0,0,0,0,0,0,0,0,0,0,0,0,0,0,0,0,0,0,0,0,0,0,Kelvin,£1.80m ,27,175,Forward - Right Winger,left,Botafogo de Futebol e Regatas,4,1,0,324,27,2,2,1449,24,5,1,1382,23,1,2,1196,24,2,8,1464,35,2,3,2415,6,0,1,302,22,1,4,902,10,1,0,401,Liga NOS,6,0,0,346,nan,nan,nan,nan
13/6/2011,Kevin Wolze,28011691,771,3/9/1990,21,0,0,0,0,3000,5700,5700,133,114,2399256,175,69,M/AM LC,3,1,1,3,2,3,1,3,2,3,1,10,12,12,10,13,12,8,12,8,11,13,8,12,13,14,12,13,12,8,12,11,13,10,11,12,13,12,13,12,11,8,8,20,12,11,11,13,8,11,7,10,5,12,14,13,12,12,14,7,13,16,14,14,20,18,1,20,16,M/AM LC,414,1,1,1,12,18,1,1,14,1,15,16,20,1,14,1,264,0,0,0,1,0,0,0,0,1,0,0,0,0,0,0,0,0,0,0,0,0,0,0,0,0,0,0,0,0,0,0,0,0,0,0,0,0,0,0,0,0,0,0,0,0,0,0,0,Kevin Foley,£2.70m ,35,183,Defender - Right-Back,right,Retired,36,3,2,2967,18,0,1,1210,28,0,1,2276,17,1,0,1072,8,0,0,442,8,0,1,492,32,0,1,2390,1,0,0,90,nan,nan,nan,nan,Premier League,nan,nan,nan,nan,nan,nan,nan,nan
13/6/2011,Junior Hoilett,28000482,364,6/5/1990,21,0,0,0,0,5000,7500,7250,158,137,12423828,173,70,AM/S RLC,1,2,2,2,3,1,2,5,3,1,1,7,7,14,10,11,7,3,12,5,3,10,10,3,14,8,9,10,9,11,10,7,12,16,4,13,7,11,11,17,14,9,6,11,16,16,20,12,8,10,3,10,5,14,10,19,8,10,14,15,15,14,1,1,14,20,20,15,16,AM/S RLC,516,1,1,17,16,15,20,1,1,1,1,1,12,14,1,1,2.25455E+15,0,0,0,0,0,0,0,0,1,0,0,0,0,0,0,0,0,0,0,0,0,0,0,0,0,0,0,1,0,0,0,0,0,0,0,0,0,0,0,1,0,1,0,0,0,0,0,0,Junior Hoilett,£8.10m ,30,174,Forward - Left Winger,right,Cardiff City,35,8,3,2457,37,7,7,3095,28,3,3,1598,39,4,7,2484,24,0,1,1013,31,6,2,2083,33,2,5,2421,50,11,12,4034,33,3,1,2142,Premier League,45,7,2,2696,8,0,1,557
13/6/2011,Juan Carlos,67063767,796,3/30/1990,21,0,0,1,0,3650,6150,6150,142,123,3945109,178,69,M/AM L,2,1,1,2,3,2,3,1,2,1,3,12,13,13,11,14,9,6,13,6,5,14,12,6,14,13,10,11,11,6,12,8,10,14,7,12,6,10,11,16,13,10,8,20,13,15,9,12,9,12,14,10,6,12,8,12,14,13,10,7,7,19,1,1,18,20,10,20,1,M/AM L,523,1,1,1,1,20,10,1,1,1,1,1,18,8,1,1,1,1,0,0,0,0,0,0,0,0,0,0,0,0,0,0,0,0,0,0,0,0,0,0,0,0,0,0,0,0,0,0,0,0,0,0,0,0,0,0,0,0,0,0,0,0,0,0,0,Juan Cala,£1.80m ,30,186,Defender - Centre-Back,right,Cádiz CF,26,3,0,2049,29,2,0,2386,13,1,1,896,27,3,1,2347,10,0,0,788,23,1,1,2000,32,3,0,2815,33,2,1,2922,30,1,0,2660,LaLiga,27,2,1,2370,7,0,0,585
13/6/2011,Joseph Mills,28005189,765,10/30/1989,21,0,0,0,0,1750,4550,4550,125,98,961317,176,70,D/M/AM L,3,3,3,3,2,3,2,1,2,1,2,10,13,10,8,10,12,9,5,8,9,12,9,11,13,10,11,10,11,11,9,11,12,10,6,10,9,12,12,13,10,12,9,20,13,13,7,12,9,13,8,13,6,10,11,11,12,12,11,11,12,9,20,14,18,18,7,20,1,D/M/AM L,123,1,1,1,1,18,1,1,20,7,1,1,18,1,14,1,1,1,0,0,0,0,0,0,0,0,0,0,0,0,0,0,0,0,0,0,0,0,0,0,0,0,0,0,0,0,0,0,0,0,0,0,0,0,0,0,0,0,0,0,0,0,0,0,0,,,,,,,,,,,,,,,,,,,,,,,,,,,,,,,,,,,,,,,,,,,,,,,,,,,,
13/6/2011,Jô,55042167,1651,9/19/1989,21,0,0,0,0,500,2000,2000,132,110,594018,170,70,AM/S RL,2,1,1,1,2,3,3,4,3,3,2,9,10,12,10,12,8,5,9,5,4,9,10,5,13,10,13,9,9,8,9,9,13,15,6,14,5,8,10,15,14,6,4,10,14,15,20,8,6,9,5,10,9,11,12,1,3,8,14,13,14,6,1,1,9,20,20,17,13,AM/S RL,515,1,1,17,13,17,20,1,1,1,1,1,1,9,1,1,0,0,0,0,0,0,0,0,0,0,0,0,0,0,0,0,0,0,0,0,0,0,0,0,0,0,0,0,0,0,0,0,0,0,0,0,0,0,0,0,0,0,0,0,0,0,0,0,0,Jô,£720Th. ,32,170,Forward - Second Striker,both,NK Krsko,nan,nan,nan,nan,15,0,1,869,1,0,0,12,34,1,7,2510,23,2,2,1637,11,0,0,502,17,2,1,978,nan,nan,nan,nan,nan,nan,nan,nan,Liga NOS,nan,nan,nan,nan,3,0,0,165
13/6/2011,Jefferson Montero,80001392,1654,9/1/1989,21,9,2,0,0,4700,6700,6650,161,134,962913,169,64,AM RL,3,3,1,2,2,1,1,2,3,1,1,11,13,16,10,14,10,6,12,7,5,13,11,6,16,10,11,8,11,7,13,9,13,18,5,13,5,9,10,16,15,8,6,15,14,14,20,12,6,11,9,15,8,12,13,16,10,12,13,12,13,9,1,1,13,20,19,20,11,AM RL,505,1,1,15,11,20,19,1,1,1,1,1,13,13,1,1,5.49756E+11,0,0,0,0,1,0,0,0,0,0,0,0,0,0,0,0,0,0,0,0,0,0,0,0,0,0,0,0,0,0,0,0,0,0,0,0,0,0,0,1,0,0,0,0,0,0,0,0,Jefferson Montero,£2.25m ,31,170,Forward - Left Winger,right,Without Club,30,2,3,1224,33,1,3,2189,43,8,7,2537,29,7,5,1901,34,1,8,1867,25,1,2,1519,15,0,1,523,18,1,3,655,17,1,3,505,LaLiga,18,0,1,568,nan,nan,nan,nan
13/6/2011,Ibai Gómez,67087553,796,11/11/1989,21,0,0,0,0,2500,5300,5300,129,117,1132226,179,71,AM/S RL,1,3,1,3,1,2,2,7,1,2,1,12,12,12,11,10,14,9,12,2,3,9,11,3,12,12,10,13,10,9,10,10,10,13,8,12,2,9,12,14,12,9,9,13,13,13,20,10,7,11,6,6,10,12,12,13,6,11,10,5,8,7,1,1,9,20,17,20,11,AM/S RL,515,1,1,18,11,20,17,1,1,1,1,1,9,1,1,1,4,0,0,1,0,0,0,0,0,0,0,0,0,0,0,0,0,0,0,0,0,0,0,0,0,0,0,0,0,0,0,0,0,0,0,0,0,0,0,0,0,0,0,0,0,0,0,0,0,Ibai Gómez,£900Th. ,30,178,Forward - Right Winger,right,Athletic Bilbao,15,4,0,888,45,12,6,2595,46,5,12,2472,24,8,2,1020,34,2,4,1674,9,0,1,339,35,7,3,2111,38,7,6,2560,34,3,4,2133,LaLiga,20,1,1,899,nan,nan,nan,nan
13/6/2011,Iago Falqué,1510571,796,4/4/1990,21,0,0,0,0,3750,6000,6000,155,128,808272,173,67,AM LC,3,1,3,3,1,3,1,1,3,2,2,15,14,16,13,17,15,6,14,6,4,15,15,6,18,8,12,7,15,7,16,13,10,18,6,13,6,10,8,13,14,10,7,20,11,11,9,11,8,8,10,12,8,9,14,11,12,9,13,13,5,11,1,1,12,20,13,18,20,AM LC,504,1,1,15,20,18,13,1,1,1,1,8,12,7,1,1,2097296,0,0,0,0,1,0,0,1,0,0,0,0,0,0,0,0,0,0,0,0,0,1,0,0,0,0,0,0,0,0,0,0,0,0,0,0,0,0,0,0,0,0,0,0,0,0,0,0,,,,,,,,,,,,,,,,,,,,,,,,,,,,,,,,,,,,,,,,,,,,,,,,,,,,
13/6/2011,Holger Knartz,91012813,771,2/12/1990,21,0,0,0,0,600,4300,4300,111,86,35037,177,70,M/AM RL,3,2,2,2,2,1,2,3,3,3,2,8,11,13,11,13,4,3,7,4,9,10,9,7,13,11,11,2,9,9,8,8,7,17,4,10,9,16,11,11,10,13,8,12,13,12,20,8,9,10,6,10,7,10,7,15,13,15,12,12,9,5,1,1,20,18,20,18,12,M/AM RL,415,1,1,1,12,15,18,1,1,1,1,1,18,20,1,1,0,0,0,0,0,0,0,0,0,0,0,0,0,0,0,0,0,0,0,0,0,0,0,0,0,0,0,0,0,0,0,0,0,0,0,0,0,0,0,0,0,0,0,0,0,0,0,0,0,,,,,,,,,,,,,,,,,,,,,,,,,,,,,,,,,,,,,,,,,,,,,,,,,,,,
13/6/2011,Hervé Bazile,34008821,769,3/18/1990,21,0,0,0,0,2250,3450,3450,135,105,1889777,180,73,AM L,3,1,2,2,2,3,1,1,2,3,3,6,9,13,8,13,11,6,11,5,3,7,12,3,14,7,10,9,11,11,7,8,16,13,5,12,5,8,12,16,14,13,9,20,13,14,5,13,11,10,7,13,7,8,13,14,15,13,12,14,14,9,1,1,10,20,10,20,1,AM L,503,1,1,14,1,20,10,1,1,1,1,1,10,10,1,1,2.2518E+15,0,0,0,0,0,0,0,0,0,0,0,0,0,0,0,0,0,0,0,0,0,0,0,0,0,0,0,0,0,0,0,0,0,0,0,0,0,0,0,0,0,0,0,0,0,0,0,0,,,,,,,,,,,,,,,,,,,,,,,,,,,,,,,,,,,,,,,,,,,,,,,,,,,,
13/6/2011,Guido Marilungo,43000093,776,8/9/1989,21,0,0,7,2,4600,6350,6350,162,127,4275884,176,69,AM/S RL,2,2,1,2,1,3,1,7,3,1,1,10,12,16,13,13,8,12,9,5,4,10,10,6,14,15,9,15,9,8,10,12,17,14,8,15,12,8,15,16,14,8,9,9,13,15,20,11,6,10,11,15,7,12,13,18,12,13,12,13,11,9,1,1,11,18,15,18,13,AM/S RL,625,1,1,20,13,18,15,1,1,1,1,1,11,9,1,1,532480,0,0,0,0,0,0,0,0,0,0,0,0,0,1,0,0,0,0,0,1,0,0,0,0,0,0,0,0,0,0,0,0,0,0,0,0,0,0,0,0,0,0,0,0,0,0,0,0,Guido Marilungo,£3.15m ,31,174,Forward - Centre-Forward,right,SS Monopoli 1966,36,2,6,2087,19,4,2,869,4,0,0,159,33,5,5,1973,9,2,0,810,34,7,6,2642,21,0,4,1013,39,10,3,2493,39,10,2,2958,Serie A,32,3,2,1604,6,0,0,283
13/6/2011,Grégory Sertic,8443655,769,8/5/1989,21,0,0,5,0,4350,5500,5500,145,122,3717350,181,69,M/AM LC,2,1,2,3,3,3,3,4,3,3,2,13,12,13,7,14,14,10,13,5,5,13,12,7,14,7,11,12,13,12,14,11,15,11,8,11,8,12,13,14,14,14,10,12,14,11,20,13,11,12,7,14,6,15,12,14,13,11,14,13,13,6,8,1,20,18,12,16,20,M/AM LC,414,1,1,1,18,14,12,8,1,1,10,20,16,12,1,1,4194336,0,0,0,0,0,1,0,0,0,0,0,0,0,0,0,0,0,0,0,0,0,0,1,0,0,0,0,0,0,0,0,0,0,0,0,0,0,0,0,0,0,0,0,0,0,0,0,0,Grégory Sertic,£1.13m ,31,183,Midfielder - Defensive Midfield,right,Without Club,24,0,2,1099,22,0,1,1008,44,1,5,3112,37,3,11,3061,30,1,1,2341,3,0,0,141,28,1,1,2319,13,0,0,716,17,0,0,1103,Ligue 1,nan,nan,nan,nan,nan,nan,nan,nan
13/6/2011,Gerard Badía,67062976,796,10/18/1989,21,0,0,0,0,1350,3700,3700,110,78,39747,176,72,M/AM L,3,2,3,2,3,2,2,1,1,2,3,15,12,10,7,15,16,5,14,6,4,12,5,5,15,8,7,7,9,10,13,9,10,14,2,10,8,7,7,10,12,7,7,20,7,10,5,11,8,7,3,10,10,10,14,11,6,10,13,10,8,11,1,1,20,17,1,20,1,M/AM L,413,1,1,1,1,17,1,1,1,1,1,1,20,1,1,1,0,0,0,0,0,0,0,0,0,0,0,0,0,0,0,0,0,0,0,0,0,0,0,0,0,0,0,0,0,0,0,0,0,0,0,0,0,0,0,0,0,0,0,0,0,0,0,0,0,Gerard Bordas,£450Th. ,39,177,Forward - Centre-Forward,right,Retired,24,5,0,1969,15,4,0,952,23,3,0,1124,38,9,2,2456,6,1,0,177,nan,nan,nan,nan,nan,nan,nan,nan,nan,nan,nan,nan,nan,nan,nan,nan,LaLiga,nan,nan,nan,nan,nan,nan,nan,nan
13/6/2011,Gareth Bale,5132312,801,7/16/1989,21,27,3,4,0,7250,8750,8000,180,163,114999996,185,81,D/M/AM L,3,3,1,1,2,1,1,5,3,3,3,15,15,16,13,13,16,15,7,12,11,13,11,13,15,5,13,14,15,13,13,11,16,11,6,14,9,14,15,18,12,14,12,20,15,16,11,19,13,12,4,15,11,14,13,15,13,14,14,13,15,2,17,15,20,17,1,20,1,D/M/AM L,433,1,1,1,1,17,1,1,17,1,1,1,20,1,15,1,134219817,1,0,0,1,0,1,0,0,0,0,0,1,0,0,0,0,0,0,0,0,0,0,0,0,0,0,0,1,0,0,0,0,0,0,0,0,0,0,0,0,0,0,0,0,0,0,0,0,Gareth Bale,£36.00m ,31,185,Forward - Right Winger,left,Tottenham Hotspur,41,11,11,3356,42,13,17,3675,44,26,15,3891,44,22,19,3329,48,17,12,4038,31,19,15,2382,27,9,6,1936,39,21,7,2362,42,14,7,2619,Premier League,20,3,2,1260,2,0,1,80
13/6/2011,Gaëtan Sidney,85028019,769,5/13/1990,21,0,0,0,0,1300,2650,2650,125,107,529245,186,77,AM RL,1,1,1,2,2,2,3,2,1,1,2,9,12,13,7,13,8,7,11,6,4,8,8,3,14,11,10,12,10,11,9,9,13,12,6,11,5,9,12,15,13,13,13,5,14,14,20,12,13,11,8,12,7,10,9,12,14,13,13,13,13,6,1,1,15,20,20,17,1,AM RL,505,1,1,1,1,17,20,1,1,1,1,1,15,15,1,1,2.2518E+15,0,0,0,0,0,0,0,0,0,1,0,0,0,0,0,0,0,0,0,0,0,0,0,0,0,0,0,0,0,0,0,0,0,0,0,0,0,0,0,0,0,0,0,0,0,0,0,0,,,,,,,,,,,,,,,,,,,,,,,,,,,,,,,,,,,,,,,,,,,,,,,,,,,,
13/6/2011,Franck Moussa,8156628,757,7/24/1989,21,0,0,0,0,2000,4319,4800,124,96,785447,173,67,M/AM LC,2,3,1,1,1,1,1,1,2,1,2,11,10,10,10,10,11,9,9,5,4,13,11,10,12,10,11,10,10,10,12,10,10,12,8,12,8,10,12,11,11,12,8,11,13,11,20,13,8,13,8,11,7,13,18,12,17,7,14,13,17,4,1,1,20,18,14,18,20,M/AM LC,414,1,1,1,18,18,10,1,1,1,1,20,18,14,1,1,2.25235E+15,0,0,0,0,0,0,1,0,0,0,0,0,0,0,0,0,0,0,0,0,0,0,1,0,0,0,0,0,0,0,1,0,0,0,0,0,0,0,0,1,0,0,0,0,0,0,0,0,,,,,,,,,,,,,,,,,,,,,,,,,,,,,,,,,,,,,,,,,,,,,,,,,,,,
13/6/2011,Fito,67145480,796,10/14/1989,21,0,0,0,0,1750,4250,4250,108,89,125099,161,62,M LC,2,3,2,1,2,2,2,1,2,2,1,10,11,14,9,14,8,3,11,1,11,11,10,9,11,10,10,3,12,8,10,12,7,7,10,9,5,11,13,14,11,9,3,20,11,12,10,10,5,6,8,10,4,10,12,12,10,6,8,9,6,13,1,1,20,1,1,15,20,M LC,404,1,1,1,1,1,1,1,1,1,1,20,15,1,1,1,0,0,0,0,0,0,0,0,0,0,0,0,0,0,0,0,0,0,0,0,0,0,0,0,0,0,0,0,0,0,0,0,0,0,0,0,0,0,0,0,0,0,0,0,0,0,0,0,0,Tito,£1.35m ,35,174,Defender - Right-Back,right,Without Club,12,1,0,959,37,1,1,3251,34,1,2,2763,25,0,1,1973,35,0,2,2951,32,1,3,2610,23,0,3,1876,17,1,0,1322,16,0,0,1182,LaLiga,28,0,0,2177,nan,nan,nan,nan
13/6/2011,Fernando Guerrero,67011225,1654,9/30/1989,21,1,0,0,0,1750,5500,5250,143,110,388415,170,70,AM LC,1,1,1,3,3,3,2,5,2,1,3,6,11,14,7,13,9,9,13,6,6,13,4,8,15,6,7,5,10,11,12,9,9,16,13,10,11,10,13,13,10,11,7,20,9,13,10,8,8,10,4,10,12,10,14,13,6,8,5,5,14,12,1,1,9,20,10,20,20,AM LC,504,1,1,10,20,20,10,1,1,1,1,9,1,1,1,1,16,0,0,0,0,1,0,0,0,0,0,0,0,0,0,0,0,0,0,0,0,0,0,0,0,0,0,0,0,0,0,0,0,0,0,0,0,0,0,0,0,0,0,0,0,0,0,0,0,Fernando Torres,£31.50m ,36,186,Forward - Centre-Forward,right,Retired,44,10,6,3116,49,11,16,3070,64,22,11,4653,41,11,6,2263,36,7,1,1792,44,12,5,2530,45,10,7,2197,64,14,4,3289,21,3,0,1126,Premier League,nan,nan,nan,nan,nan,nan,nan,nan
13/6/2011,Emilio Nsué,1504124,796,9/30/1989,21,0,0,0,0,4750,6600,6600,150,137,12000000,178,75,AM/S RL,3,3,3,2,2,1,3,5,1,2,3,10,12,13,11,13,8,10,12,5,4,12,12,6,14,9,10,14,11,9,13,10,10,16,9,17,9,12,13,15,12,15,9,10,16,16,20,15,12,12,7,14,7,11,9,10,5,14,12,7,7,5,1,1,9,19,19,15,12,AM/S RL,625,1,1,20,12,15,19,1,1,1,1,1,3,9,1,1,134217744,0,0,0,0,1,0,0,0,0,0,0,0,0,0,0,0,0,0,0,0,0,0,0,0,0,0,0,1,0,0,0,0,0,0,0,0,0,0,0,0,0,0,0,0,0,0,0,0,Emilio Nsue,£2.70m ,31,178,Defender - Right-Back,right,APOEL Nicosia,42,6,3,3243,34,4,4,2228,35,2,3,2354,41,4,2,3545,29,0,3,1384,46,3,2,3730,23,1,0,2012,37,7,4,3039,13,3,1,1137,LaLiga,16,1,0,984,6,0,2,570
13/6/2011,Edgar Prib,35014762,771,12/15/1989,21,0,0,0,0,2850,6000,6000,148,123,2370572,181,74,M/AM LC,1,1,2,3,3,2,1,1,3,2,2,11,16,13,7,13,13,9,8,5,9,12,10,15,14,16,11,15,11,9,13,10,14,11,9,12,9,13,17,13,13,15,10,20,15,14,7,15,11,12,14,12,9,15,10,7,12,15,16,15,16,4,14,14,20,19,9,20,20,M/AM LC,414,1,1,6,17,19,9,1,14,1,14,20,20,9,14,1,1.54619E+11,0,0,1,0,0,1,0,0,0,0,0,0,0,0,0,0,0,0,0,0,0,0,0,0,0,0,0,0,0,0,0,0,0,0,1,0,0,1,0,0,0,0,0,0,0,0,0,0,,,,,,,,,,,,,,,,,,,,,,,,,,,,,,,,,,,,,,,,,,,,,,,,,,,,
13/6/2011,Diogo Rosado,55009680,788,2/21/1990,21,0,0,0,0,2250,5250,5250,116,105,345388,185,74,AM L,2,3,1,1,1,3,2,2,2,1,1,14,15,14,13,11,12,9,12,8,8,12,11,7,12,10,11,10,12,9,11,9,10,14,9,14,7,8,9,12,12,13,11,20,13,12,5,11,12,9,7,12,9,10,15,19,13,9,11,1,6,10,1,1,10,20,1,20,10,AM L,503,1,1,1,10,20,1,1,1,1,1,1,10,1,1,1,0,0,0,0,0,0,0,0,0,0,0,0,0,0,0,0,0,0,0,0,0,0,0,0,0,0,0,0,0,0,0,0,0,0,0,0,0,0,0,0,0,0,0,0,0,0,0,0,0,Diogo Rosado,£900Th. ,30,185,Forward - Left Winger,left,Concordia Chiajna,9,0,1,678,19,2,3,1046,17,5,4,1332,13,0,1,391,9,0,1,477,13,0,0,897,nan,nan,nan,nan,17,1,5,1112,6,1,0,478,Liga NOS,3,0,1,252,4,0,2,343
13/6/2011,Dennis Joedecke,92022200,771,11/21/1989,21,0,0,0,0,250,2750,2750,88,55,1015,186,0,M L,1,2,1,3,2,2,2,4,2,1,1,7,12,10,6,9,9,6,4,3,9,12,7,10,7,7,5,4,8,9,10,8,8,4,4,7,6,10,12,13,11,13,11,20,5,8,3,7,4,10,11,7,6,10,8,11,13,6,11,12,8,4,1,1,20,9,1,20,1,M L,403,1,1,1,1,9,1,1,1,1,1,1,20,1,1,1,0,0,0,0,0,0,0,0,0,0,0,0,0,0,0,0,0,0,0,0,0,0,0,0,0,0,0,0,0,0,0,0,0,0,0,0,0,0,0,0,0,0,0,0,0,0,0,0,0,,,,,,,,,,,,,,,,,,,,,,,,,,,,,,,,,,,,,,,,,,,,,,,,,,,,
13/6/2011,Daniel Royer,16018632,755,5/22/1990,21,2,0,5,0,1250,5444,4250,140,121,3002419,177,72,M/AM RLC,2,3,1,3,3,2,2,1,3,1,2,9,13,13,10,13,10,10,11,5,11,11,7,11,14,8,9,13,9,8,11,11,8,15,8,11,12,11,11,13,14,10,11,17,14,13,20,14,12,8,6,4,6,11,5,19,13,9,11,8,9,13,1,11,20,20,20,20,20,M/AM RLC,416,1,1,1,1,20,17,1,1,1,1,20,20,20,11,11,2.74878E+12,0,0,0,0,0,0,0,0,0,0,0,0,0,0,0,0,0,0,0,0,1,0,0,0,0,0,0,0,0,0,0,0,0,0,0,0,0,0,0,1,0,1,0,0,0,0,0,0,Daniel Royer,£720Th. ,30,177,Forward - Left Winger,both,New York Red Bulls,41,5,7,3019,24,2,3,1899,29,3,2,1354,41,7,9,2656,36,7,5,2259,43,3,5,2622,34,15,3,2442,41,16,4,2899,37,14,8,2808,Bundesliga,18,4,2,1297,nan,nan,nan,nan
13/6/2011,Daniel Didavi,92012101,771,2/21/1990,21,0,0,4,0,3250,5600,5900,122,112,1289547,180,77,M LC,3,3,1,3,1,1,2,3,2,1,3,13,14,12,8,13,15,7,12,4,3,14,13,7,14,7,12,7,11,11,16,11,9,14,4,12,8,13,14,12,12,13,11,20,11,11,8,12,10,10,4,10,10,8,9,12,13,14,14,8,8,4,1,1,20,15,1,20,17,M LC,404,1,1,1,1,15,1,1,1,1,1,17,20,1,1,1,256,0,0,0,0,0,0,0,0,1,0,0,0,0,0,0,0,0,0,0,0,0,0,0,0,0,0,0,0,0,0,0,0,0,0,0,0,0,0,0,0,0,0,0,0,0,0,0,0,Daniel Didavi,£2.25m ,30,180,Midfielder - Attacking Midfield,left,VfB Stuttgart,15,0,2,672,27,9,3,1809,5,0,0,145,9,1,2,582,14,5,0,986,34,14,5,2694,22,4,5,1235,33,10,7,2411,23,2,2,1111,Bundesliga,21,6,4,1609,6,1,2,468
13/6/2011,Christian Pasquato,43006605,776,7/20/1989,21,0,0,5,0,2500,5624,5300,151,125,442038,174,68,AM/S LC,3,2,1,2,1,3,2,8,1,3,3,7,8,14,16,14,15,7,13,7,5,15,14,6,13,7,9,8,8,10,13,11,10,13,8,12,10,10,11,15,17,10,10,10,13,15,20,13,7,9,12,9,12,10,8,15,8,11,10,10,11,16,1,1,9,20,12,20,18,AM/S LC,514,1,1,16,18,20,12,1,1,1,1,1,9,1,1,1,0,0,0,0,0,0,0,0,0,0,0,0,0,0,0,0,0,0,0,0,0,0,0,0,0,0,0,0,0,0,0,0,0,0,0,0,0,0,0,0,0,0,0,0,0,0,0,0,0,Cristian Pasquato,£990Th. ,31,173,Forward - Second Striker,right,AS Gubbio 1910,42,9,14,2885,15,1,2,635,18,4,1,574,39,8,5,2703,38,7,7,1544,34,5,4,2256,28,5,8,1876,29,5,6,1400,9,1,0,250,Serie A,13,4,3,1025,5,0,2,407
13/6/2011,Camille Dobelle,85019582,769,7/29/1989,21,0,0,0,0,1000,2000,2000,110,80,70766,174,66,AM L,1,1,3,1,2,3,2,4,2,1,1,9,9,10,5,11,7,4,7,6,1,8,9,2,11,8,12,7,6,8,10,7,13,11,8,7,4,15,15,12,10,10,6,20,12,14,5,10,6,10,8,10,14,10,20,11,20,11,14,14,14,6,1,1,15,20,1,20,1,AM L,503,1,1,1,1,20,1,1,1,1,1,1,15,1,1,1,0,0,0,0,0,0,0,0,0,0,0,0,0,0,0,0,0,0,0,0,0,0,0,0,0,0,0,0,0,0,0,0,0,0,0,0,0,0,0,0,0,0,0,0,0,0,0,0,0,,,,,,,,,,,,,,,,,,,,,,,,,,,,,,,,,,,,,,,,,,,,,,,,,,,,
13/6/2011,Boris Vukcevic,35025623,771,3/16/1990,21,0,0,5,0,4400,6250,6250,135,118,2908221,182,78,M/AM/S LC,3,3,2,1,1,1,2,6,1,3,3,10,11,14,13,14,10,9,8,10,10,11,10,6,12,8,11,9,10,12,14,14,10,9,11,12,8,9,7,14,13,13,12,20,12,14,15,11,7,10,12,10,8,17,9,11,20,8,15,12,15,6,1,1,20,17,1,20,17,M/AM/S LC,424,1,1,18,17,9,1,1,1,1,1,1,20,1,1,1,0,0,0,0,0,0,0,0,0,0,0,0,0,0,0,0,0,0,0,0,0,0,0,0,0,0,0,0,0,0,0,0,0,0,0,0,0,0,0,0,0,0,0,0,0,0,0,0,0,,,,,,,,,,,,,,,,,,,,,,,,,,,,,,,,,,,,,,,,,,,,,,,,,,,,
13/6/2011,Barry Bannan,29010507,793,12/1/1989,21,5,0,10,1,4000,6250,6750,150,119,6474465,170,60,M LC,1,2,1,3,3,1,2,1,3,1,2,11,14,13,10,14,11,6,11,3,4,15,15,8,14,11,11,11,14,10,15,12,13,14,4,13,9,12,12,16,13,14,6,20,14,12,7,12,5,14,5,10,3,15,10,14,12,16,10,10,12,4,1,1,20,14,13,16,20,M LC,404,1,1,1,10,14,11,1,1,1,1,20,16,13,1,1,1.09951E+13,0,0,0,0,0,0,0,0,0,0,0,0,0,0,0,0,0,0,0,0,0,0,1,0,0,0,0,0,0,0,0,0,0,0,0,0,0,0,0,0,0,1,0,1,0,0,0,0,Barry Bannan,£4.50m ,30,169,Midfielder - Central Midfield,left,Sheffield Wednesday,30,4,5,1804,38,4,6,2070,30,0,2,2122,17,1,2,1174,26,0,5,1808,41,3,2,3566,46,1,8,3942,31,1,3,2636,45,4,12,3952,Premier League,46,2,8,3963,8,1,0,720
13/6/2011,Armand Traoré,8442421,41,10/8/1989,21,0,0,0,0,3750,6250,6200,145,123,9807809,185,70,D/WB/M L,1,2,2,2,1,1,1,3,3,3,1,6,13,12,10,11,11,9,14,13,10,13,5,12,12,10,12,12,10,9,9,11,9,10,6,12,11,13,14,18,12,14,10,20,8,17,5,13,8,12,6,11,18,12,12,11,12,13,10,11,15,4,18,20,18,13,1,20,1,D/WB/M L,233,1,1,1,1,13,1,1,18,1,1,1,18,1,20,1,1.10018E+12,0,0,0,0,0,0,0,0,0,0,0,0,0,0,0,0,0,0,0,0,0,0,0,0,0,0,0,1,0,1,0,0,0,0,0,0,0,0,0,0,1,0,0,0,0,0,0,0,Armand Traoré,£2.25m ,31,184,Defender - Left-Back,left,Without Club,12,0,0,684,26,0,3,1716,28,0,0,2206,24,2,1,1299,17,0,0,869,nan,nan,nan,nan,13,0,0,889,23,1,4,1709,1,0,0,90,Premier League,nan,nan,nan,nan,nan,nan,nan,nan
13/6/2011,Anthony Bova,85041526,769,3/7/1990,21,0,0,0,0,1250,2550,2550,135,103,502340,170,64,AM RL,2,2,2,3,2,1,2,2,3,2,2,8,9,12,7,12,8,6,8,7,1,9,10,2,14,7,10,11,11,11,11,10,14,13,7,11,5,8,13,16,14,9,4,5,14,15,20,13,6,12,7,14,6,8,12,13,12,11,13,15,15,6,1,1,10,20,20,17,12,AM RL,505,1,1,14,12,17,20,1,1,1,1,1,10,10,1,1,2.2518E+15,0,0,0,0,1,0,0,0,0,0,0,0,0,0,0,0,0,0,0,0,0,0,0,0,0,0,0,0,0,0,0,0,0,0,0,0,0,0,0,0,0,0,0,0,0,0,0,0,Anthony Ujah,£1.58m ,30,180,Forward - Centre-Forward,right,1.FC Union Berlin,13,13,4,1200,16,2,0,675,31,13,3,2626,37,11,4,2394,35,12,3,2602,52,19,8,3883,24,5,4,2070,12,0,0,253,23,4,0,843,Bundesliga,28,4,4,1181,nan,nan,nan,nan
13/6/2011,André Ayew,8442448,21,12/17/1989,21,32,2,12,4,6050,7500,6750,165,150,13000000,176,72,M/AM LC,1,1,2,2,2,2,3,4,3,3,3,11,13,15,11,14,8,14,12,5,6,13,15,13,15,14,13,15,13,13,13,14,16,13,13,13,12,16,18,16,15,15,9,20,15,16,5,17,13,15,14,16,7,12,13,17,13,12,12,13,14,12,8,8,20,17,10,17,20,M/AM LC,414,1,1,12,12,17,10,1,8,1,1,20,17,10,8,1,2.25195E+15,0,0,0,1,0,1,0,0,0,0,0,0,0,0,0,0,0,0,0,0,0,0,0,0,0,0,0,0,0,0,0,0,0,0,1,0,0,1,0,0,0,0,0,0,0,0,0,0,André Ayew,£13.50m ,30,176,Forward - Left Winger,left,Swansea City,51,13,6,3850,39,16,4,3153,45,12,5,3846,29,8,4,2482,30,11,6,2519,35,12,5,2943,26,6,3,1453,36,6,5,2361,38,5,2,2620,Ligue 1,47,18,7,4116,8,3,1,720
13/6/2011,Abdoul Camara,8449420,769,2/20/1990,21,0,0,1,1,4500,5600,5600,150,124,2999998,177,71,AM L,3,1,1,3,3,3,1,4,1,1,1,10,9,13,8,11,10,6,12,6,1,8,9,2,13,6,7,7,10,8,7,7,17,13,5,11,4,6,9,18,14,11,7,20,14,17,5,11,9,13,6,14,6,8,11,15,14,13,14,14,11,9,1,1,10,20,14,20,1,AM L,503,1,1,13,1,20,14,1,1,1,1,1,10,10,1,1,2.25183E+15,0,0,0,0,0,0,0,0,0,0,0,0,0,0,0,0,0,0,0,0,0,0,0,0,0,0,0,0,0,0,0,0,0,0,0,1,0,0,0,0,0,0,0,0,0,0,0,0,Abdoul Camara,£900Th. ,30,178,Forward - Left Winger,left,Retired,27,1,1,933,27,2,0,1158,35,2,2,2465,18,2,1,483,29,6,2,2225,26,2,1,1840,21,1,3,806,15,2,1,967,nan,nan,nan,nan,Ligue 1,nan,nan,nan,nan,nan,nan,nan,nan
13/6/2011,Abdou Sissoko,85022790,769,3/20/1990,21,0,0,3,0,2500,3750,3750,145,114,2564321,180,68,DM/M LC,3,3,2,2,1,2,3,2,1,3,2,6,9,11,6,11,8,12,11,7,7,12,7,10,13,12,14,12,12,12,12,12,14,11,9,8,10,13,16,15,13,14,11,8,15,12,20,15,11,13,12,14,7,10,8,16,13,12,8,11,11,13,1,1,20,1,1,16,20,DM/M LC,424,1,1,1,1,1,1,1,1,1,18,20,16,1,1,1,0,0,0,0,0,0,0,0,0,0,0,0,0,0,0,0,0,0,0,0,0,0,0,0,0,0,0,0,0,0,0,0,0,0,0,0,0,0,0,0,0,0,0,0,0,0,0,0,0,Abdoul Sissoko,£900Th. ,30,183,Midfielder - Defensive Midfield,left,Al-Kuwait Sports Club,27,0,1,1899,12,1,0,645,39,0,0,3252,34,3,2,2836,13,0,0,856,35,3,6,2681,24,1,0,1722,38,2,0,3127,45,0,0,3855,Serie A,4,0,0,366,nan,nan,nan,nan
13/6/2011,Zoltán Stieber,28000417,773,10/6/1988,22,0,0,1,0,4750,5849,6500,149,130,2958833,175,67,AM/S RLC,3,2,3,1,3,1,3,2,1,1,3,10,15,14,12,13,12,4,7,5,8,11,10,8,13,10,11,9,12,10,13,12,16,16,5,13,7,11,12,16,12,11,6,20,11,15,10,13,7,10,12,10,14,15,12,13,7,13,14,14,14,7,1,1,15,20,15,20,18,AM/S RLC,516,1,1,17,18,20,15,1,1,1,1,1,15,12,1,1,1,1,0,0,0,0,0,0,0,0,0,0,0,0,0,0,0,0,0,0,0,0,0,0,0,0,0,0,0,0,0,0,0,0,0,0,0,0,0,0,0,0,0,0,0,0,0,0,0,Zoltán Stieber,£1.13m ,32,175,Forward - Left Winger,left,Újpest FC,36,10,18,2973,12,0,5,896,17,3,2,1267,36,9,12,2986,28,3,3,1696,8,1,0,257,28,3,5,1989,29,5,6,1955,9,0,0,301,Bundesliga,25,2,6,1931,5,0,0,151
13/6/2011,Zhang Chengdong,23020214,110,2/9/1989,22,1,0,0,0,1500,4950,4500,121,90,21613,184,73,AM/S RL,1,3,3,2,1,1,1,2,1,3,2,8,11,9,10,11,7,9,4,1,1,10,2,4,10,5,4,9,8,8,8,9,14,13,8,11,7,13,13,14,12,9,10,8,13,14,20,8,9,10,11,7,7,10,14,12,13,13,16,16,16,4,1,1,1,17,17,17,7,AM/S RL,625,1,1,20,7,17,17,1,1,1,1,1,1,1,1,1,0,0,0,0,0,0,0,0,0,0,0,0,0,0,0,0,0,0,0,0,0,0,0,0,0,0,0,0,0,0,0,0,0,0,0,0,0,0,0,0,0,0,0,0,0,0,0,0,0,,,,,,,,,,,,,,,,,,,,,,,,,,,,,,,,,,,,,,,,,,,,,,,,,,,,
13/6/2011,Yala Bolasie,83000374,765,5/24/1989,22,0,0,0,0,2100,4850,4850,120,89,431250,179,84,M/AM/S RL,1,2,1,2,3,2,3,2,2,1,1,8,7,12,8,8,8,9,10,1,5,7,10,5,8,9,9,8,7,8,11,6,14,16,6,10,6,13,8,14,16,10,10,6,12,14,20,12,10,9,3,8,11,10,13,16,12,11,9,10,12,5,1,1,18,20,19,20,8,M/AM/S RL,535,1,1,16,8,20,19,1,1,1,1,1,18,18,1,1,2.25184E+15,0,0,0,0,0,1,0,0,0,0,0,0,0,0,0,0,0,0,0,0,0,0,0,0,0,0,0,0,0,0,1,0,0,0,0,1,0,0,0,0,0,0,0,0,0,0,0,0,,,,,,,,,,,,,,,,,,,,,,,,,,,,,,,,,,,,,,,,,,,,,,,,,,,,
13/6/2011,Wilfried Moimbé,34001874,769,10/18/1988,22,0,0,0,0,2450,3800,3800,135,114,611760,173,65,D/WB/M/AM L,3,1,1,3,1,1,1,4,3,3,3,9,12,11,6,11,6,6,12,8,6,9,8,8,11,8,11,13,12,12,12,11,12,8,7,11,10,12,14,16,14,11,6,20,13,15,8,15,7,13,8,15,7,12,14,12,12,12,16,16,16,7,20,18,17,17,12,20,10,D/WB/M/AM L,133,1,1,1,1,17,1,1,20,12,10,10,17,1,18,12,1,1,0,0,0,0,0,0,0,0,0,0,0,0,0,0,0,0,0,0,0,0,0,0,0,0,0,0,0,0,0,0,0,0,0,0,0,0,0,0,0,0,0,0,0,0,0,0,0,,,,,,,,,,,,,,,,,,,,,,,,,,,,,,,,,,,,,,,,,,,,,,,,,,,,
13/6/2011,Wellington,19059012,1651,4/1/1989,22,0,0,0,0,1750,4500,4500,110,90,2311035,179,74,D/WB/M L,1,2,1,2,1,1,2,3,1,3,3,10,11,12,8,10,10,9,10,2,12,14,10,14,13,11,14,10,8,8,9,9,10,10,8,9,10,10,14,13,12,13,8,20,14,13,5,12,9,10,5,4,3,10,9,13,6,8,10,9,6,7,20,18,17,1,1,20,1,D/WB/M L,123,1,1,1,1,1,1,1,20,1,1,1,17,1,18,1,0,0,0,0,0,0,0,0,0,0,0,0,0,0,0,0,0,0,0,0,0,0,0,0,0,0,0,0,0,0,0,0,0,0,0,0,0,0,0,0,0,0,0,0,0,0,0,0,0,Weligton,£1.35m ,41,186,Defender - Centre-Back,left,Retired,35,1,1,3131,20,1,0,1787,49,2,2,4283,17,1,0,1369,35,0,1,3016,30,0,2,2608,1,0,0,90,nan,nan,nan,nan,nan,nan,nan,nan,LaLiga,nan,nan,nan,nan,nan,nan,nan,nan
13/6/2011,Vincent Créhin,85017785,769,1/21/1989,22,0,0,0,0,1250,2550,2550,125,102,23141,169,75,AM L,3,3,3,2,2,1,3,4,2,2,3,7,8,13,11,12,9,6,9,5,1,7,10,3,13,6,11,8,12,12,8,10,13,13,6,13,5,8,11,16,14,11,4,20,15,14,5,13,11,13,6,14,7,5,9,13,11,9,10,15,15,8,1,1,15,20,12,20,13,AM L,503,1,1,13,13,20,12,1,1,1,1,10,15,12,1,1,4.39805E+12,1,0,0,0,1,0,0,0,0,0,0,0,0,0,0,0,0,0,0,0,0,0,0,0,0,0,0,0,0,0,0,0,0,0,0,0,0,0,0,0,0,0,1,0,0,0,0,0,,,,,,,,,,,,,,,,,,,,,,,,,,,,,,,,,,,,,,,,,,,,,,,,,,,,
13/6/2011,Viktor Riske,91004667,771,1/12/1989,22,0,0,0,0,1000,4250,4250,100,85,207345,172,70,DM/M RL,3,1,1,1,3,2,1,3,1,1,3,8,11,12,7,5,4,7,5,5,12,10,4,8,12,15,9,8,12,14,7,10,7,7,10,17,10,19,11,11,13,10,8,6,9,12,20,10,9,8,7,6,10,10,9,12,13,8,11,15,8,11,15,1,20,9,15,20,1,DM/M RL,425,1,1,1,1,9,1,1,1,15,17,1,20,1,1,1,0,0,0,0,0,0,0,0,0,0,0,0,0,0,0,0,0,0,0,0,0,0,0,0,0,0,0,0,0,0,0,0,0,0,0,0,0,0,0,0,0,0,0,0,0,0,0,0,0,,,,,,,,,,,,,,,,,,,,,,,,,,,,,,,,,,,,,,,,,,,,,,,,,,,,
13/6/2011,Tommy Rowe,5109708,765,5/1/1989,22,0,0,0,0,2250,5050,5050,126,101,1077318,181,81,M LC,1,2,3,1,2,3,2,2,2,3,1,10,12,13,10,12,6,8,10,6,9,10,6,10,14,5,12,10,13,11,9,9,10,12,10,13,11,13,14,13,14,12,8,20,18,13,3,14,6,13,3,12,4,12,12,16,12,10,15,14,13,5,14,14,20,14,14,18,20,M LC,404,1,1,1,1,14,9,1,14,1,1,20,18,14,14,1,5.49756E+11,0,0,0,0,0,0,0,0,0,0,0,0,0,0,0,0,0,0,0,0,0,0,0,0,0,0,0,0,0,0,0,0,0,0,0,0,0,0,0,1,0,0,0,0,0,0,0,0,,,,,,,,,,,,,,,,,,,,,,,,,,,,,,,,,,,,,,,,,,,,,,,,,,,,
13/6/2011,Timo Gebhart,35014477,771,4/12/1989,22,0,0,3,1,4750,6650,6650,157,133,22973058,182,78,M/AM RLC,1,3,1,1,2,3,3,6,1,2,2,11,14,16,12,15,12,6,10,8,10,13,14,8,16,16,7,15,14,6,7,7,14,17,9,10,6,3,14,17,18,15,10,6,17,15,20,12,10,8,14,10,15,12,4,17,9,13,8,9,7,15,1,1,17,20,18,16,20,M/AM RLC,526,1,1,15,20,16,18,1,1,1,1,10,15,17,1,1,2.32274E+15,0,0,0,0,0,0,0,0,0,0,0,0,0,0,0,0,0,0,0,0,0,0,0,0,0,0,0,0,0,0,1,0,0,0,1,0,0,0,0,1,0,0,0,0,0,0,1,0,Timo Gebhart,£2.25m ,31,183,Midfielder - Attacking Midfield,right,FC Memmingen,34,6,8,2151,13,0,0,313,19,2,2,1172,7,0,0,206,9,1,1,555,7,0,0,324,21,6,4,1394,12,5,4,793,13,3,5,778,Bundesliga,31,5,2,1273,1,0,0,90
13/6/2011,Thomas Guerbert,85059611,769,4/6/1989,22,0,0,0,0,1450,2950,2950,135,118,1429575,180,75,AM L,2,3,2,3,3,3,1,1,1,2,1,11,12,14,7,14,11,9,13,5,4,10,10,3,14,7,11,13,11,10,11,10,14,13,6,11,6,11,12,16,14,13,10,20,15,14,5,12,12,14,7,10,5,8,12,12,13,15,14,14,14,5,1,1,15,20,1,20,10,AM L,503,1,1,10,10,20,1,1,1,1,1,1,15,1,1,1,1,1,0,0,0,0,0,0,0,0,0,0,0,0,0,0,0,0,0,0,0,0,0,0,0,0,0,0,0,0,0,0,0,0,0,0,0,0,0,0,0,0,0,0,0,0,0,0,0,Thomas Guerbert,£1.35m ,31,172,Midfielder - Attacking Midfield,right,Retired,nan,nan,nan,nan,36,4,5,2150,32,5,8,2489,14,2,2,891,27,1,2,1355,20,0,1,1150,12,1,1,903,nan,nan,nan,nan,nan,nan,nan,nan,Ligue 1,nan,nan,nan,nan,nan,nan,nan,nan
13/6/2011,Stephan Thee,91002961,771,7/26/1988,22,0,0,0,0,2800,4200,4200,99,84,29258,178,75,M/AM RLC,3,1,3,3,3,2,2,1,1,3,2,6,10,10,10,9,3,7,8,9,9,9,4,10,13,6,10,9,11,9,11,13,11,11,12,9,9,10,14,8,11,12,7,14,10,13,20,11,6,10,5,8,11,10,6,13,8,14,13,11,4,13,1,1,20,18,20,16,18,M/AM RLC,416,1,1,1,14,15,18,1,1,1,14,18,16,20,1,1,0,0,0,0,0,0,0,0,0,0,0,0,0,0,0,0,0,0,0,0,0,0,0,0,0,0,0,0,0,0,0,0,0,0,0,0,0,0,0,0,0,0,0,0,0,0,0,0,0,Stefan Thesker,£90Th. ,29,190,Defender - Centre-Back,left,Holstein Kiel,15,0,0,1182,17,1,3,1458,20,1,0,1615,12,0,0,949,20,0,1,1539,19,2,2,1318,30,0,2,2520,23,3,0,2022,17,2,0,629,Bundesliga,30,2,3,2250,1,0,0,23
13/6/2011,Stephan Hain,91002834,771,9/27/1988,22,0,0,0,0,4000,6050,6050,137,121,4265241,178,72,AM/S RLC,1,2,1,2,3,3,2,1,1,3,1,12,11,13,12,12,10,7,8,4,6,12,13,8,12,9,10,13,8,8,9,10,10,10,7,14,5,12,13,14,16,8,8,17,11,13,20,10,8,10,8,9,11,17,10,13,14,7,11,14,16,6,1,1,9,20,18,18,20,AM/S RLC,516,1,1,20,20,18,18,1,1,1,1,9,1,1,1,1,24,0,0,0,1,1,0,0,0,0,0,0,0,0,0,0,0,0,0,0,0,0,0,0,0,0,0,0,0,0,0,0,0,0,0,0,0,0,0,0,0,0,0,0,0,0,0,0,0,Stephan Hain,£1.13m ,32,178,Forward - Centre-Forward,both,SpVgg Unterhaching,27,10,5,1873,14,1,0,395,18,2,0,755,13,0,0,700,12,1,0,520,8,2,0,440,34,35,6,2740,40,20,2,3466,30,14,4,2628,Bundesliga,25,5,1,1326,nan,nan,nan,nan
13/6/2011,Shinji Kagawa,45001639,116,3/17/1989,22,22,5,6,0,7000,7600,7700,171,154,48392162,172,63,AM RLC,3,2,2,3,2,3,2,3,3,3,3,10,9,17,14,18,11,12,13,4,6,13,11,7,17,12,14,9,13,8,8,13,13,15,5,17,6,10,15,18,20,10,7,18,12,13,20,12,6,12,5,11,8,13,9,16,9,12,12,12,14,11,1,1,12,20,17,18,20,AM RLC,506,1,1,14,20,18,17,1,1,1,1,10,12,12,1,1,5.49757E+11,0,0,0,0,1,0,0,0,0,0,1,0,1,0,0,0,0,0,0,0,1,0,0,0,0,0,0,0,0,0,0,0,0,0,0,0,0,0,0,1,0,0,0,0,0,0,0,0,Shinji Kagawa,£19.80m ,31,175,Midfielder - Attacking Midfield,right,Without Club,28,12,2,2125,43,17,14,3282,26,6,6,1701,30,0,4,1992,39,6,10,2681,46,13,13,3122,30,6,8,2046,27,6,7,1776,19,4,8,842,Bundesliga,36,4,2,2180,nan,nan,nan,nan
13/6/2011,Scott Sinclair,5008069,765,3/25/1989,22,0,0,7,1,4750,6350,6350,140,125,5888049,177,69,AM RLC,2,3,2,2,3,3,2,2,3,3,1,6,9,14,14,7,7,8,8,1,3,6,15,4,11,9,8,10,10,7,7,7,14,15,7,9,4,10,9,15,12,12,6,12,14,18,20,12,6,10,3,13,6,8,5,18,10,14,18,15,18,4,1,1,9,20,16,20,15,AM RLC,506,1,1,15,15,20,16,1,1,1,1,1,9,1,1,1,134217729,1,0,0,0,0,0,0,0,0,0,0,0,0,0,0,0,0,0,0,0,0,0,0,0,0,0,0,1,0,0,0,0,0,0,0,0,0,0,0,0,0,0,0,0,0,0,0,0,Scott Sinclair,£7.20m ,31,177,Forward - Left Winger,right,Preston North End,50,27,3,4146,40,8,5,3145,18,2,1,537,11,0,1,531,16,3,0,604,33,6,0,2049,50,25,13,4055,55,18,17,3768,55,17,6,3484,Premier League,25,5,0,1071,10,4,1,610
13/6/2011,Romain Alessandrini,85014215,769,4/3/1989,22,0,0,0,0,2500,3800,3800,135,115,1131871,172,70,AM L,1,3,3,2,1,2,2,1,1,3,1,8,9,13,8,13,8,9,9,7,2,11,11,4,13,10,11,12,12,12,11,11,17,14,6,11,7,8,13,16,14,10,8,20,14,13,10,14,10,14,10,15,7,10,16,13,14,14,15,12,12,5,1,1,15,20,12,20,10,AM L,503,1,1,1,10,20,12,1,1,1,10,10,15,12,1,1,2.2518E+15,0,0,0,0,0,0,0,0,0,0,0,0,0,0,0,0,0,0,0,0,0,0,0,0,0,0,0,0,0,0,0,0,0,0,0,0,0,0,0,0,0,0,0,0,0,0,0,0,,,,,,,,,,,,,,,,,,,,,,,,,,,,,,,,,,,,,,,,,,,,,,,,,,,,
13/6/2011,Rene Mihelic,64000038,795,7/5/1988,22,3,0,23,8,3900,6000,6000,138,115,2948301,177,70,M/AM LC,1,2,1,2,3,1,3,9,2,3,3,13,13,11,10,12,14,10,12,8,12,15,13,6,14,17,12,11,12,13,11,12,16,12,13,12,2,14,16,15,12,13,11,20,12,14,5,12,11,12,8,16,9,13,14,14,18,13,16,15,15,9,1,1,20,20,1,20,20,M/AM LC,414,1,1,7,20,20,1,1,1,1,1,20,17,1,1,1,0,0,0,0,0,0,0,0,0,0,0,0,0,0,0,0,0,0,0,0,0,0,0,0,0,0,0,0,0,0,0,0,0,0,0,0,0,0,0,0,0,0,0,0,0,0,0,0,0,Rene Mihelic,£720Th. ,32,177,Midfielder - Attacking Midfield,right,NK Maribor,18,1,3,995,25,0,5,1605,19,1,0,1052,22,4,5,1447,19,2,5,1040,36,4,5,2571,28,5,2,1990,14,2,4,673,27,1,3,2019,Liga NOS,3,0,1,73,0,0,0,0
13/6/2011,Rafinha,55029683,1651,10/7/1988,22,0,0,0,0,1000,2000,3000,117,85,89157,187,75,AM LC,1,2,2,2,3,3,3,6,2,2,2,6,11,8,12,8,3,4,10,3,7,13,9,11,9,9,11,5,10,9,11,12,10,15,3,12,11,8,11,13,11,8,12,20,17,12,5,6,5,10,13,8,7,10,8,6,9,8,4,10,7,1,1,1,10,20,1,15,20,AM LC,504,1,1,1,20,15,1,1,1,1,1,9,10,1,1,1,0,0,0,0,0,0,0,0,0,0,0,0,0,0,0,0,0,0,0,0,0,0,0,0,0,0,0,0,0,0,0,0,0,0,0,0,0,0,0,0,0,0,0,0,0,0,0,0,0,Rafinha,£1.80m ,27,174,Midfielder - Attacking Midfield,left,Paris Saint-Germain,9,1,0,424,41,8,0,3384,37,10,8,3215,33,4,7,2508,36,2,3,1687,11,2,0,502,28,7,5,1567,18,2,3,1062,8,1,0,348,LaLiga,33,4,2,2344,3,0,1,154
13/6/2011,Pablo Piatti,14004181,1649,3/31/1989,22,1,0,6,0,5600,6569,7100,165,146,36790201,163,58,AM/S RLC,3,1,3,3,3,3,2,2,2,1,1,11,15,15,14,15,12,5,13,2,6,15,14,6,16,9,14,13,13,12,15,14,18,18,8,16,4,13,12,15,16,12,4,20,11,14,8,14,7,11,4,15,11,14,13,16,14,17,13,14,15,9,1,1,10,20,16,19,20,AM/S RLC,516,1,1,18,20,19,16,1,1,1,1,1,10,7,1,1,2.2518E+15,0,0,0,1,0,0,0,0,0,0,1,0,0,0,0,0,0,0,0,0,0,0,0,0,0,0,0,0,0,0,0,0,0,0,0,0,0,0,0,0,0,0,0,0,0,0,0,0,Pablo Piatti,£7.20m ,31,163,Forward - Left Winger,both,Toronto FC,41,10,5,3264,47,6,5,2106,19,1,4,1081,29,7,5,1555,30,7,8,2044,37,2,8,1759,31,10,12,2475,31,2,4,1812,26,2,2,1237,LaLiga,25,4,4,1624,nan,nan,nan,nan
13/6/2011,Oumar Pouye,85010384,41,6/19/1988,22,0,0,0,0,2500,5039,5000,135,112,589623,170,68,AM RL,3,2,3,3,1,2,3,1,2,3,1,8,11,13,12,11,7,5,12,5,2,10,14,2,12,8,10,7,12,11,9,9,14,13,5,13,8,9,13,14,14,10,5,20,14,18,5,13,8,13,8,10,6,7,8,13,12,13,12,15,15,6,1,1,14,20,20,18,1,AM RL,505,1,1,12,1,18,20,1,1,1,1,1,14,14,1,1,1,1,0,0,0,0,0,0,0,0,0,0,0,0,0,0,0,0,0,0,0,0,0,0,0,0,0,0,0,0,0,0,0,0,0,0,0,0,0,0,0,0,0,0,0,0,0,0,0,,,,,,,,,,,,,,,,,,,,,,,,,,,,,,,,,,,,,,,,,,,,,,,,,,,,
13/6/2011,Óscar De Marcos,67065930,796,4/14/1989,22,0,0,1,0,4250,6150,6150,145,125,2128595,180,76,AM RLC,2,1,2,2,1,1,1,5,3,2,3,10,13,13,12,11,10,12,13,4,4,12,12,6,14,12,12,14,13,11,13,12,13,14,9,13,8,12,11,14,13,12,10,20,14,12,15,12,12,11,5,11,4,14,8,15,12,12,12,10,13,7,9,5,10,20,16,20,18,AM RLC,506,1,1,14,18,20,16,1,1,9,1,10,9,1,1,5,0,0,0,0,0,0,0,0,0,0,0,0,0,0,0,0,0,0,0,0,0,0,0,0,0,0,0,0,0,0,0,0,0,0,0,0,0,0,0,0,0,0,0,0,0,0,0,0,0,Óscar de Marcos,£5.40m ,31,182,Defender - Right-Back,right,Athletic Bilbao,15,0,3,565,56,9,11,4776,46,7,5,3989,39,5,2,2162,52,2,5,4416,54,2,5,4484,32,1,4,2588,28,2,5,2293,34,1,3,2650,LaLiga,13,0,2,538,1,0,0,90
13/6/2011,Nivaldo,55014360,12,7/10/1988,22,0,0,1,0,2000,4049,3000,115,90,590254,179,71,D L,1,3,2,2,3,2,3,1,3,3,2,8,11,10,9,11,7,9,10,11,8,10,7,9,10,9,9,8,10,11,12,9,9,7,6,11,8,11,13,11,12,10,9,20,12,13,5,11,9,9,2,6,2,10,13,10,9,7,10,10,13,7,20,15,15,13,13,20,1,D L,103,1,1,1,1,13,1,1,20,13,1,1,15,1,15,1,0,0,0,0,0,0,0,0,0,0,0,0,0,0,0,0,0,0,0,0,0,0,0,0,0,0,0,0,0,0,0,0,0,0,0,0,0,0,0,0,0,0,0,0,0,0,0,0,0,Nivaldo,£450Th. ,32,179,Midfielder - Left Midfield,left,Without Club,nan,nan,nan,nan,14,0,0,1130,15,1,1,1190,29,5,7,2432,29,4,11,2292,10,0,0,494,10,1,1,564,15,1,4,757,22,2,1,1361,Liga NOS,3,0,0,270,nan,nan,nan,nan
13/6/2011,Nikola Gulan,5779088,802,3/23/1989,22,0,0,23,0,2500,5610,4650,125,102,1098627,183,73,D/M LC,1,2,2,1,1,2,2,1,1,2,2,8,12,9,8,10,8,10,7,8,11,12,5,12,11,8,11,10,10,12,10,12,5,13,11,12,12,15,9,12,13,14,14,20,12,11,5,13,13,7,11,4,7,9,13,19,10,10,9,8,11,7,18,1,20,9,1,20,16,D/M LC,424,1,1,1,1,9,1,1,18,1,1,16,20,1,1,1,0,0,0,0,0,0,0,0,0,0,0,0,0,0,0,0,0,0,0,0,0,0,0,0,0,0,0,0,0,0,0,0,0,0,0,0,0,0,0,0,0,0,0,0,0,0,0,0,0,Nikola Gulan,£270Th. ,31,183,Defender - Left-Back,left,BK Häcken,9,0,0,533,1,0,0,10,20,0,1,1638,14,0,0,990,33,0,2,2565,17,0,1,1373,25,0,0,1564,11,0,0,712,26,0,2,2202,Serie A,29,0,1,2153,nan,nan,nan,nan
13/6/2011,Mesut Özil,35002219,771,10/15/1988,22,26,4,16,5,8250,8800,8450,182,166,-1,183,76,AM LC,1,2,1,2,3,2,2,6,3,3,3,14,15,17,10,18,12,5,11,6,4,19,13,5,18,5,17,7,13,14,18,18,6,17,5,19,6,17,8,18,17,11,9,20,10,16,10,11,9,10,4,12,6,10,8,17,5,13,14,11,18,12,1,1,15,20,11,16,20,AM LC,504,1,1,10,20,16,11,1,1,1,1,15,15,10,1,1,18350224,0,0,0,0,1,0,0,1,0,0,0,0,0,0,0,0,0,0,0,1,1,0,0,0,1,0,0,0,0,0,0,0,0,0,0,0,0,0,0,0,0,0,0,0,0,0,0,0,Mesut Özil,£28.80m ,32,180,Midfielder - Attacking Midfield,left,Arsenal FC,54,10,29,3907,52,7,28,3850,52,10,24,3549,42,7,14,3367,32,5,9,2711,45,8,20,3940,44,12,14,3746,35,5,14,2953,35,6,3,2420,LaLiga,23,1,3,1812,nan,nan,nan,nan
13/6/2011,Matty Done,5127843,765,6/22/1988,22,0,0,0,0,1250,4350,4350,100,88,395109,178,65,AM LC,3,1,1,1,1,3,2,1,2,2,1,13,12,13,10,9,8,7,8,10,2,10,7,5,12,4,11,8,11,8,8,6,9,13,1,11,6,9,13,14,10,10,3,20,12,14,5,12,6,6,2,8,5,3,6,12,8,10,8,5,9,5,1,1,15,20,10,20,16,AM LC,504,1,1,1,16,20,10,1,1,1,1,1,15,1,1,1,513,1,0,0,0,0,0,0,0,0,1,0,0,0,0,0,0,0,0,0,0,0,0,0,0,0,0,0,0,0,0,0,0,0,0,0,0,0,0,0,0,0,0,0,0,0,0,0,0,,,,,,,,,,,,,,,,,,,,,,,,,,,,,,,,,,,,,,,,,,,,,,,,,,,,
13/6/2011,Marko Marin,156766,771,3/13/1989,22,16,1,12,1,7100,7000,7000,170,145,30080261,170,63,AM RLC,1,3,1,1,2,1,1,10,2,3,3,14,15,18,8,17,13,8,10,6,4,13,12,5,18,5,9,8,13,10,12,7,12,19,6,14,4,5,7,18,20,6,6,15,13,14,20,11,4,14,12,10,6,12,8,10,9,15,12,7,14,5,1,1,12,20,18,20,16,AM RLC,506,1,1,15,16,20,18,1,1,1,1,8,11,12,1,1,7.09196E+13,1,1,0,0,0,0,0,0,0,0,0,0,0,0,0,0,0,0,0,0,0,0,0,0,0,0,0,0,0,0,1,0,0,0,0,0,0,0,0,1,0,0,0,0,0,0,1,0,Marko Marin,£11.70m ,31,170,Midfielder - Attacking Midfield,right,Al-Ahli Jeddah,44,5,12,3293,22,1,5,1434,19,3,2,621,30,2,7,1530,12,2,0,713,29,2,5,1844,23,4,5,1361,36,8,5,2356,31,7,13,2405,Bundesliga,42,6,13,3336,2,0,0,165
13/6/2011,Mario Diehl,91002765,771,3/28/1989,22,0,0,0,0,100,2250,2250,120,63,1483,178,71,M/AM L,2,2,1,1,1,1,3,3,3,3,1,7,12,12,7,11,7,2,7,8,7,10,3,4,10,8,7,9,4,9,6,7,7,9,10,7,6,7,10,12,10,8,8,20,6,12,8,5,2,10,13,8,9,10,12,9,12,16,15,18,13,7,1,1,18,20,1,20,1,M/AM L,523,1,1,1,1,20,1,1,1,1,1,1,18,1,1,1,0,0,0,0,0,0,0,0,0,0,0,0,0,0,0,0,0,0,0,0,0,0,0,0,0,0,0,0,0,0,0,0,0,0,0,0,0,0,0,0,0,0,0,0,0,0,0,0,0,,,,,,,,,,,,,,,,,,,,,,,,,,,,,,,,,,,,,,,,,,,,,,,,,,,,
13/6/2011,Marco Reus,91013383,771,5/31/1989,22,0,0,2,0,5500,7400,7400,158,148,17999999,180,67,M/AM RL,2,1,2,2,1,2,1,1,2,2,2,10,9,15,16,14,10,5,13,6,6,11,9,8,14,11,9,10,14,9,13,14,14,13,6,15,6,10,15,18,17,13,8,14,14,16,20,14,6,15,6,15,5,16,3,9,16,17,12,15,11,5,1,1,16,20,20,18,14,M/AM RL,525,1,1,14,14,18,20,1,1,1,1,1,15,16,1,1,5.49757E+11,0,0,1,0,1,0,0,0,0,1,0,0,0,0,0,0,0,0,0,0,1,0,0,0,0,0,0,0,0,0,0,0,0,0,0,0,0,0,0,1,0,0,0,0,0,0,0,0,Marco Reus,£18.00m ,31,180,Midfielder - Attacking Midfield,right,Borussia Dortmund,37,12,10,3325,37,21,14,3316,49,19,16,3734,44,23,23,3494,29,11,6,2256,43,23,8,3282,24,13,8,1703,15,7,1,1163,36,21,13,3053,Bundesliga,26,12,7,2120,8,2,0,334
13/6/2011,Marco Matias,55009695,788,5/10/1989,22,0,0,2,0,1500,4500,4500,108,88,23627,177,67,AM RL,1,1,3,2,1,3,3,1,2,1,3,8,10,13,10,8,5,4,11,3,5,11,1,4,11,4,11,9,7,9,12,9,10,13,4,4,5,10,14,13,11,10,5,8,14,13,20,9,8,9,8,10,16,10,5,12,13,8,11,9,12,7,1,1,1,20,20,15,10,AM RL,505,1,1,1,10,15,20,1,1,1,1,1,1,1,1,1,0,0,0,0,0,0,0,0,0,0,0,0,0,0,0,0,0,0,0,0,0,0,0,0,0,0,0,0,0,0,0,0,0,0,0,0,0,0,0,0,0,0,0,0,0,0,0,0,0,Marco Motta,£1.98m ,34,186,Defender - Right-Back,right,Persija Jakarta,32,0,2,2114,13,0,1,1018,22,1,2,1726,16,0,1,1073,9,0,0,500,12,0,2,862,15,0,1,1199,31,3,1,2498,8,0,0,645,Serie A,2,0,1,180,nan,nan,nan,nan
13/6/2011,Lukas Schmitz,35021353,771,10/13/1988,22,0,0,0,0,4600,6400,6800,132,127,8906782,184,80,D/M/AM LC,2,3,3,2,3,2,3,1,1,3,3,13,16,9,10,8,12,9,13,15,9,10,11,11,8,14,8,15,9,16,12,10,14,6,11,13,7,18,16,13,10,15,12,8,13,16,20,17,13,15,6,9,4,17,6,13,12,6,15,14,17,5,17,15,20,18,1,20,15,D/M/AM LC,434,1,1,1,1,18,1,1,17,1,1,15,20,1,15,1,1.11669E+12,0,0,0,1,0,0,0,0,0,0,0,0,0,0,0,0,0,0,0,0,0,0,0,0,0,0,0,0,0,0,0,0,0,0,1,0,0,0,0,0,1,0,0,0,0,0,0,0,Lukas Schmitz,£2.25m ,32,183,Defender - Left-Back,left,VVV-Venlo,37,0,4,2743,27,0,4,1994,23,0,1,1762,6,0,0,364,23,1,3,1971,28,1,4,2454,34,0,5,3001,13,1,3,925,33,2,4,2955,Bundesliga,38,1,2,3232,5,0,0,441
13/6/2011,Leocísio Sami,55011410,23,12/18/1988,22,0,0,0,0,1250,5000,4500,132,111,690498,184,78,AM RL,2,1,1,2,1,3,3,3,1,1,2,10,11,11,12,11,11,12,12,7,8,9,12,8,11,14,10,15,11,10,8,9,14,12,7,13,8,10,14,14,12,13,12,10,14,13,20,14,14,11,8,11,7,11,13,14,14,13,14,14,14,6,1,1,9,20,20,17,10,AM RL,505,1,1,14,10,17,20,1,1,1,1,1,1,9,1,1,0,0,0,0,0,0,0,0,0,0,0,0,0,0,0,0,0,0,0,0,0,0,0,0,0,0,0,0,0,0,0,0,0,0,0,0,0,0,0,0,0,0,0,0,0,0,0,0,0,,,,,,,,,,,,,,,,,,,,,,,,,,,,,,,,,,,,,,,,,,,,,,,,,,,,
13/6/2011,Lee Tomlin,5133423,765,1/12/1989,22,0,0,0,0,3000,5600,5600,140,113,3731922,181,74,M/AM/S RLC,2,1,3,2,1,2,1,1,1,1,1,10,10,14,12,14,12,6,11,3,2,13,11,6,14,15,9,13,13,10,13,11,12,16,3,12,5,10,11,11,9,12,10,10,12,14,20,9,11,10,12,11,5,13,12,14,9,10,13,7,8,10,1,1,16,20,18,20,20,M/AM/S RLC,536,1,1,16,20,20,18,1,1,1,1,14,16,16,1,1,721408,0,0,0,0,0,0,0,0,0,1,0,0,0,0,0,0,1,1,0,1,0,0,0,0,0,0,0,0,0,0,0,0,0,0,0,0,0,0,0,0,0,0,0,0,0,0,0,0,,,,,,,,,,,,,,,,,,,,,,,,,,,,,,,,,,,,,,,,,,,,,,,,,,,,
13/6/2011,Kevin Monnet-Paquet,8440065,769,8/19/1988,22,0,0,6,0,4600,5750,5750,140,128,4931388,183,73,AM RL,2,2,2,2,1,3,3,1,1,1,2,10,11,14,10,13,10,7,11,6,5,11,12,4,14,8,12,11,13,13,9,10,11,13,6,14,9,12,14,14,13,13,10,8,14,17,20,14,12,12,8,14,6,8,12,14,16,8,14,14,14,8,1,1,13,20,20,17,14,AM RL,505,1,1,14,14,17,20,1,1,1,1,10,13,13,1,1,2.2518E+15,0,0,0,0,0,0,0,0,0,0,0,0,0,0,0,0,0,0,0,0,0,0,0,0,0,0,0,0,0,0,0,0,0,0,0,0,0,0,0,0,0,0,0,0,0,0,0,0,Kévin Monnet-Paquet,£2.25m ,32,184,Forward - Left Winger,right,AS Saint-Étienne,39,0,3,2484,40,7,2,3392,41,6,7,3175,38,4,4,2969,43,5,1,2538,43,5,2,3020,48,5,4,3355,31,2,2,1835,26,2,1,1695,Ligue 1,0,0,0,0,5,0,0,151
13/6/2011,Kevin Großkreutz,35021340,771,7/19/1988,22,3,0,1,1,5600,7150,7150,144,137,38183426,186,72,M/AM RL,3,1,1,1,3,3,3,7,1,3,1,7,9,12,14,11,6,12,9,11,12,11,9,13,11,16,15,19,13,12,10,14,12,11,9,14,11,19,19,13,10,14,12,11,13,15,20,19,12,15,12,13,5,18,11,13,20,14,12,5,6,15,13,14,17,20,18,20,14,M/AM RL,525,1,1,13,14,20,18,1,13,12,12,14,17,16,14,13,2.74878E+12,0,0,0,1,0,0,0,0,0,0,0,0,0,0,0,0,0,0,0,0,0,0,0,0,0,0,0,0,0,0,0,0,0,0,0,0,0,0,0,1,0,1,0,0,0,0,0,0,Kevin Großkreutz,£7.20m ,32,186,Defender - Right-Back,right,Without Club,43,9,7,3306,43,8,10,3258,44,2,7,2676,50,3,6,4357,25,0,4,1650,15,0,0,1350,17,1,0,1115,28,3,3,2260,36,0,3,3054,Bundesliga,15,1,1,1075,nan,nan,nan,nan
13/6/2011,Kévin Diaz,8434079,769,8/18/1988,22,0,0,0,0,3450,5250,5250,138,117,237449,174,65,M/AM L,3,1,3,1,1,3,2,4,1,1,3,11,10,13,7,13,12,6,14,8,3,12,12,5,15,10,11,9,11,11,13,11,14,13,6,13,7,9,12,17,14,11,7,20,12,15,5,13,7,13,10,15,9,7,12,14,14,13,12,11,11,8,1,1,18,20,10,20,14,M/AM L,523,1,1,1,14,20,10,1,1,1,1,14,18,10,1,1,2.25237E+15,0,0,0,0,0,0,0,0,0,0,0,0,0,0,0,0,0,0,0,0,0,0,0,0,0,0,0,0,0,0,0,0,0,0,1,0,0,0,0,1,0,0,0,0,0,0,0,0,,,,,,,,,,,,,,,,,,,,,,,,,,,,,,,,,,,,,,,,,,,,,,,,,,,,
13/6/2011,Karim Aďt Fana,8442298,34,2/25/1989,22,0,0,0,0,4700,5939,5900,160,132,3650298,175,65,AM RL,1,1,3,3,3,3,2,4,1,3,3,9,11,16,12,14,8,6,11,5,2,12,10,3,16,7,13,8,12,12,13,12,14,14,5,14,5,9,12,17,16,12,7,20,14,14,8,14,7,13,7,16,11,8,13,16,13,11,15,15,15,7,1,1,12,20,18,20,10,AM RL,505,1,1,14,10,20,18,1,1,1,1,1,12,12,1,1,2.2518E+15,0,0,0,0,0,0,0,0,0,0,0,0,0,0,0,0,0,0,0,0,0,0,0,0,0,0,0,0,0,0,0,0,0,0,0,0,0,0,0,0,0,0,0,0,0,0,0,0,Karim Aït-Fana,£1.80m ,31,175,Forward - Left Winger,right,Without Club,25,0,4,1518,15,2,2,779,10,1,2,356,4,1,1,110,nan,nan,nan,nan,nan,nan,nan,nan,23,0,1,1073,3,0,0,91,nan,nan,nan,nan,Ligue 1,nan,nan,nan,nan,nan,nan,nan,nan
13/6/2011,Jordi Alba,67052513,796,3/21/1989,22,0,0,3,0,5100,6900,6900,161,142,9455578,170,69,D/WB/M/AM L,3,1,2,2,2,1,2,1,1,2,3,13,14,14,11,15,11,6,10,9,10,15,10,11,15,14,13,13,12,12,13,12,12,14,8,15,11,14,15,16,15,8,6,20,12,15,9,13,8,13,12,9,9,10,13,19,16,9,14,13,10,9,17,18,20,17,10,20,1,D/WB/M/AM L,443,1,1,1,1,17,8,1,17,3,1,1,20,10,18,6,1.37439E+11,1,0,0,0,0,0,0,0,0,0,0,0,0,0,0,0,0,0,0,0,0,0,0,0,0,0,0,0,0,0,0,0,0,0,0,0,0,1,0,0,0,0,0,0,0,0,0,0,Jordi Alba,£9.00m ,31,170,Defender - Left-Back,left,FC Barcelona,34,2,0,1793,50,3,6,3972,44,5,5,3759,26,0,2,2050,44,2,7,3793,45,1,9,3771,39,1,6,2971,48,3,11,4000,54,3,17,4510,LaLiga,36,2,9,2819,4,0,2,342
13/6/2011,Jonathan Parr,767662,786,10/21/1988,22,2,0,18,0,3500,6000,5000,140,118,1207500,182,75,D/M/AM L,3,2,1,1,3,3,3,1,1,2,1,11,12,12,12,12,7,10,12,4,13,10,6,13,12,9,12,12,13,13,11,8,12,9,5,12,10,13,16,13,13,12,9,10,13,14,20,16,10,12,1,9,10,12,11,13,11,10,11,12,7,4,20,15,18,17,10,20,1,D/M/AM L,123,1,1,14,1,17,1,1,20,9,1,1,18,10,15,1,0,0,0,0,0,0,0,0,0,0,0,0,0,0,0,0,0,0,0,0,0,0,0,0,0,0,0,0,0,0,0,0,0,0,0,0,0,0,0,0,0,0,0,0,0,0,0,0,0,Jonathan Pereira,£2.25m ,33,167,Forward - Centre-Forward,right,Without Club,19,3,0,850,31,4,7,1456,27,7,5,1480,34,4,8,1703,25,7,5,1221,36,9,6,2549,15,2,1,669,34,6,2,2003,31,2,3,1159,LaLiga,17,1,0,717,nan,nan,nan,nan
13/6/2011,Jérémy Pied,8440220,769,2/23/1989,22,0,0,5,0,4400,5550,5550,145,123,2349302,173,69,AM RL,2,3,2,1,1,2,1,1,3,1,1,13,13,14,9,14,11,8,12,6,2,12,9,4,14,7,13,10,12,12,14,14,15,12,7,12,6,12,12,15,14,11,6,8,13,13,20,11,8,14,7,14,7,8,17,13,15,14,15,15,15,5,1,1,15,20,20,17,10,AM RL,505,1,1,1,10,17,20,1,1,1,1,10,15,15,1,1,2.25235E+15,0,0,0,0,0,0,0,0,0,0,0,0,0,0,0,0,0,0,0,0,0,0,0,0,0,0,0,0,0,0,0,0,0,0,0,0,0,0,0,1,0,0,0,0,0,0,0,0,Jérémy Pied,£1.58m ,31,173,Defender - Right-Back,right,LOSC Lille,36,3,4,1192,19,1,3,498,31,0,7,1817,26,2,1,1377,43,4,9,3019,35,0,3,3085,6,0,0,277,6,0,1,500,13,0,2,616,Ligue 1,9,0,0,731,3,0,0,176
13/6/2011,Jeffrey Sarpong,856984,784,8/3/1988,22,0,0,0,0,4250,5700,5700,147,125,2674271,176,65,AM RLC,3,1,2,1,3,1,3,6,2,3,2,13,13,14,12,15,14,9,14,3,5,13,9,5,14,11,11,10,9,8,12,10,10,12,7,13,4,9,10,14,15,7,7,14,11,14,20,13,13,8,8,8,7,13,15,9,14,6,13,14,5,16,1,1,15,20,16,18,20,AM RLC,506,1,1,8,20,18,16,1,1,1,1,15,15,12,1,1,2.2518E+15,0,0,0,0,0,0,0,0,0,1,0,0,0,0,0,0,0,0,0,0,0,0,0,0,0,0,0,0,0,0,0,0,0,0,0,0,0,0,0,0,0,0,0,0,0,0,0,0,Jeffrey Sarpong,£900Th. ,32,176,Forward - Left Winger,right,Without Club,19,2,1,483,14,1,1,566,14,1,0,612,32,2,4,2454,36,3,6,2349,13,0,1,676,25,5,5,2031,20,1,5,1275,22,0,1,1111,LaLiga,nan,nan,nan,nan,nan,nan,nan,nan
13/6/2011,James McClean,52014383,789,4/22/1989,22,0,0,0,0,2000,4994,4750,136,111,805000,174,72,M/AM L,2,3,2,1,1,2,2,1,3,2,1,11,10,14,11,13,10,11,10,7,6,9,11,6,14,14,12,13,10,10,11,11,14,15,6,14,14,10,12,13,13,10,7,20,14,14,11,8,9,12,12,14,6,6,11,13,10,16,13,12,11,12,1,1,20,18,12,20,10,M/AM L,413,1,1,10,10,18,12,1,1,1,1,10,20,12,1,1,1024,0,0,0,0,0,0,0,0,0,0,1,0,0,0,0,0,0,0,0,0,0,0,0,0,0,0,0,0,0,0,0,0,0,0,0,0,0,0,0,0,0,0,0,0,0,0,0,0,James McClean,£3.60m ,31,180,Midfielder - Left Midfield,left,Stoke City,21,7,0,1724,38,6,7,3183,41,5,4,2706,49,4,5,2901,37,6,7,2924,42,2,4,2985,36,2,3,1616,34,1,0,1675,45,3,7,3131,Premier League,37,7,9,3078,6,1,1,434
13/6/2011,Jack Collison,5131754,801,10/2/1988,22,8,0,7,2,4000,6500,6500,162,135,5313306,183,83,M RLC,2,1,1,3,1,3,1,7,1,1,1,8,11,14,11,15,7,6,11,3,12,14,10,13,14,15,10,13,11,13,13,12,17,8,14,13,14,15,17,13,9,14,12,13,16,13,20,15,14,14,8,14,6,15,13,12,15,16,13,12,12,3,1,1,20,1,17,17,20,M RLC,406,1,1,1,1,1,1,1,1,1,1,20,17,17,1,1,32,0,0,0,0,0,1,0,0,0,0,0,0,0,0,0,0,0,0,0,0,0,0,0,0,0,0,0,0,0,0,0,0,0,0,0,0,0,0,0,0,0,0,0,0,0,0,0,0,Jack Robinson, ,27,180,Defender - Left-Back,left,Sheffield United,12,0,1,999,8,0,0,690,28,3,2,2438,36,0,3,3000,31,0,2,2736,1,0,0,90,7,0,0,480,34,2,1,2913,40,2,2,3405,Premier League,28,0,1,2188,4,0,1,341
13/6/2011,Ivan Perisic,34012563,761,2/2/1989,22,3,0,8,3,5250,6800,6800,157,139,13805938,187,79,AM LC,2,1,1,1,2,3,3,4,3,1,1,11,13,12,17,15,14,17,12,5,5,13,14,6,14,7,16,14,15,12,12,14,14,13,6,17,8,7,9,14,10,11,16,16,15,14,20,11,11,11,7,15,6,17,9,14,10,14,7,14,8,6,1,1,15,20,14,19,20,AM LC,504,1,1,14,20,19,14,1,1,1,12,15,15,14,1,1,1056,0,0,0,0,0,1,0,0,0,0,1,0,0,0,0,0,0,0,0,0,0,0,0,0,0,0,0,0,0,0,0,0,0,0,0,0,0,0,0,0,0,0,0,0,0,0,0,0,Ivan Perisic,£6.30m ,31,187,Forward - Left Winger,both,Inter Milan,46,22,10,3787,41,9,6,1525,34,5,2,1400,38,11,7,2586,35,7,9,2380,41,10,6,2915,42,11,10,3042,39,11,11,3489,45,9,8,3631,Bundesliga,35,8,10,1756,6,0,2,397
13/6/2011,Innocent Emeghara,98001614,798,5/27/1989,22,1,0,8,5,4500,6500,5750,135,119,5000000,170,68,S RL,2,3,2,1,3,3,1,2,3,1,1,3,6,11,11,7,5,7,9,3,6,9,13,8,8,12,8,14,13,7,6,7,13,14,7,10,4,12,15,18,14,12,8,8,13,17,20,14,12,10,5,8,3,12,12,13,7,9,12,11,12,13,1,1,1,15,15,15,1,S RL,605,1,1,20,1,15,15,1,1,1,1,1,1,1,1,1,2.2518E+15,0,0,0,0,0,0,0,0,0,0,0,0,0,0,0,0,0,0,0,0,0,0,0,0,0,0,0,0,0,0,0,0,0,0,0,0,0,0,0,0,0,0,0,0,0,0,0,0,Innocent Emeghara,£2.03m ,31,170,Forward - Centre-Forward,right,FC Winterthur,39,10,11,2660,38,12,3,2099,18,7,2,1381,30,4,7,1583,15,6,0,1052,7,0,0,183,nan,nan,nan,nan,28,9,4,2117,18,5,2,1281,Ligue 1,32,7,0,1798,2,0,0,27
13/6/2011,Hugo Vieira,55021889,788,7/25/1988,22,0,0,0,0,3000,5500,5500,137,112,3194821,172,70,AM/S RL,1,3,3,3,2,1,2,4,1,2,3,9,11,11,11,11,9,5,9,4,6,9,10,6,12,11,12,15,8,10,8,9,13,14,11,13,7,8,13,15,13,6,6,10,10,14,20,8,7,11,7,12,8,14,12,16,8,11,10,13,13,6,1,1,9,20,20,20,7,AM/S RL,515,1,1,17,7,20,20,1,1,1,1,1,9,1,1,1,0,0,0,0,0,0,0,0,0,0,0,0,0,0,0,0,0,0,0,0,0,0,0,0,0,0,0,0,0,0,0,0,0,0,0,0,0,0,0,0,0,0,0,0,0,0,0,0,0,Hugo Vieira,£1.62m ,32,178,Forward - Centre-Forward,right,Without Club,28,11,0,1582,33,7,3,2653,18,8,0,1258,20,3,2,1324,22,3,2,1356,35,20,10,2458,54,26,2,3327,44,21,5,2709,nan,nan,nan,nan,Liga NOS,13,2,1,486,nan,nan,nan,nan
13/6/2011,Heldon,55014369,12,11/14/1988,22,2,1,2,1,750,5115,4500,135,93,727145,174,68,AM RL,1,1,2,2,1,3,1,1,2,2,2,9,10,11,9,10,7,4,6,4,4,7,9,4,10,8,10,11,8,8,6,8,13,14,8,12,6,6,9,13,11,5,6,12,13,13,20,7,5,11,7,14,10,10,13,17,12,12,14,14,13,6,1,1,9,20,20,17,7,AM RL,505,1,1,7,7,17,20,1,1,1,1,1,1,9,1,1,0,0,0,0,0,0,0,0,0,0,0,0,0,0,0,0,0,0,0,0,0,0,0,0,0,0,0,0,0,0,0,0,0,0,0,0,0,0,0,0,0,0,0,0,0,0,0,0,0,Héldon,£720Th. ,31,174,Forward - Left Winger,right,FC Shabab Al-Ahli Dubai,19,1,1,748,37,4,3,1710,32,5,0,2034,31,11,5,2215,18,1,1,680,27,5,4,1828,33,2,6,2313,37,6,11,2581,32,12,12,2497,Liga NOS,28,8,7,2287,1,0,0,90
13/6/2011,Hal Robson-Kanu,4002231,801,5/21/1989,22,3,0,4,2,2450,5450,5200,129,107,1059398,171,74,AM/S RL,2,1,2,3,2,3,2,4,3,1,2,10,10,12,10,9,8,10,8,3,5,8,12,7,13,6,8,9,8,10,10,11,17,14,4,12,7,10,12,14,9,13,11,20,18,14,10,12,14,10,2,7,3,9,10,15,15,15,15,16,13,4,1,1,15,20,19,20,1,AM/S RL,515,1,1,18,1,20,19,1,1,1,1,1,15,15,1,1,0,0,0,0,0,0,0,0,0,0,0,0,0,0,0,0,0,0,0,0,0,0,0,0,0,0,0,0,0,0,0,0,0,0,0,0,0,0,0,0,0,0,0,0,0,0,0,0,0,,,,,,,,,,,,,,,,,,,,,,,,,,,,,,,,,,,,,,,,,,,,,,,,,,,,
13/6/2011,Guido Koçer,35011615,799,9/15/1988,22,0,0,1,0,2800,4450,5000,112,97,655583,175,78,M/AM RL,1,3,1,3,1,2,2,3,1,1,3,9,10,12,12,11,9,8,10,5,7,9,9,7,12,8,10,12,9,9,11,10,10,8,7,12,9,10,11,13,13,8,7,20,10,12,7,9,10,8,5,8,6,4,13,11,2,20,18,4,4,20,1,1,16,20,18,20,13,M/AM RL,525,1,1,15,13,20,18,1,1,1,1,11,16,15,1,1,0,0,0,0,0,0,0,0,0,0,0,0,0,0,0,0,0,0,0,0,0,0,0,0,0,0,0,0,0,0,0,0,0,0,0,0,0,0,0,0,0,0,0,0,0,0,0,0,0,,,,,,,,,,,,,,,,,,,,,,,,,,,,,,,,,,,,,,,,,,,,,,,,,,,,
13/6/2011,Giles Barnes,5006222,765,8/5/1988,22,0,0,0,0,3250,5300,5300,133,106,346354,183,83,M/AM RL,3,2,3,1,1,1,3,3,3,1,1,5,12,14,11,13,12,9,13,7,10,10,15,10,11,10,8,10,11,9,11,10,15,14,3,11,8,8,11,13,13,10,10,14,7,12,20,8,9,7,3,11,17,10,10,17,5,8,5,4,6,14,1,1,20,20,20,15,14,M/AM RL,415,1,1,11,14,14,20,1,1,1,1,8,15,20,1,1,7.04074E+13,0,0,0,0,0,0,0,0,0,0,0,0,0,0,0,0,1,0,0,0,0,0,0,0,0,0,0,0,0,0,0,0,1,0,0,1,0,0,0,0,0,0,0,0,0,0,1,0,,,,,,,,,,,,,,,,,,,,,,,,,,,,,,,,,,,,,,,,,,,,,,,,,,,,
13/6/2011,Giacomo Bonaventura,43006720,776,5/13/1989,22,0,0,0,0,3750,6400,6400,157,129,3202669,181,75,M/AM RLC,3,2,3,1,2,2,1,8,2,2,1,11,13,14,11,14,11,9,12,7,7,14,11,10,15,9,9,12,12,12,13,12,17,14,11,13,11,12,11,15,14,8,9,10,13,14,20,13,9,15,7,15,4,15,12,16,11,6,11,10,3,5,1,1,20,19,19,19,20,M/AM RLC,416,1,1,1,19,17,16,1,1,1,12,20,19,19,1,1,144,0,0,0,0,1,0,0,1,0,0,0,0,0,0,0,0,0,0,0,0,0,0,0,0,0,0,0,0,0,0,0,0,0,0,0,0,0,0,0,0,0,0,0,0,0,0,0,0,Giacomo Bonaventura,£2.70m ,31,180,Midfielder - Central Midfield,right,ACF Fiorentina,33,9,5,1952,30,2,1,1835,36,8,4,2702,31,5,4,2520,36,7,5,2843,39,7,11,3310,22,5,5,1874,47,9,4,3557,10,3,0,797,Serie A,32,4,6,1530,5,0,1,388
13/6/2011,Gaëtan Charbonnier,85015491,769,12/27/1988,22,0,0,0,0,2400,3700,3700,135,113,390278,188,80,AM RLC,3,2,1,2,2,2,3,1,2,2,2,5,11,12,11,13,7,14,10,6,6,11,13,3,14,11,13,13,12,12,11,10,12,12,6,14,7,11,11,14,12,16,14,12,14,9,20,13,16,13,11,13,6,8,13,14,9,12,13,13,13,8,1,1,14,20,20,18,15,AM RLC,506,1,1,14,15,18,20,1,1,1,1,10,14,14,1,1,524288,0,0,0,0,0,0,0,0,0,0,0,0,0,0,0,0,0,0,0,1,0,0,0,0,0,0,0,0,0,0,0,0,0,0,0,0,0,0,0,0,0,0,0,0,0,0,0,0,,,,,,,,,,,,,,,,,,,,,,,,,,,,,,,,,,,,,,,,,,,,,,,,,,,,
13/6/2011,Gabriel Obertan,8442347,769,2/26/1989,22,0,0,11,1,4650,5750,6500,160,130,28013306,186,79,AM RL,2,1,1,3,1,2,1,1,3,1,3,9,9,14,9,14,6,6,12,4,2,9,10,1,14,5,7,6,8,7,9,5,10,18,4,11,3,8,7,17,14,12,11,13,12,16,20,9,10,8,8,8,8,7,14,16,14,7,10,15,15,6,1,1,10,20,20,17,8,AM RL,505,1,1,14,8,17,20,1,1,1,1,5,10,10,1,1,34359738368,0,0,0,0,0,0,0,0,0,0,0,0,0,0,0,0,0,0,0,0,0,0,0,0,0,0,0,0,0,0,0,0,0,0,0,1,0,0,0,0,0,0,0,0,0,0,0,0,Gabriel Obertan,£2.70m ,31,186,Midfielder - Attacking Midfield,right,Büyüksehir Belediye Erzurumspor,28,7,6,1970,27,2,4,1761,26,4,4,1433,7,0,1,289,18,1,2,1085,6,0,1,350,21,2,3,1128,36,4,9,2881,33,2,8,2901,Premier League,32,3,3,2334,4,0,1,318
13/6/2011,Franck Tabanou,85050974,769,1/30/1989,22,0,0,12,0,4900,6100,6100,160,136,4753348,178,70,M/AM L,1,2,3,2,1,2,3,2,1,1,1,13,14,15,8,15,13,10,12,10,7,13,8,7,15,9,12,13,12,11,13,11,13,13,6,13,10,11,15,17,14,12,9,20,14,15,5,14,11,12,9,15,8,10,6,16,13,14,11,13,13,10,15,15,17,20,1,20,8,M/AM L,523,1,1,1,1,20,1,8,15,1,1,1,17,1,15,1,2.25235E+15,0,0,0,0,0,0,0,0,0,0,0,0,0,0,0,0,0,0,0,0,0,0,0,0,0,0,0,0,0,0,0,0,0,0,0,0,0,0,0,1,0,0,0,0,0,0,0,0,Franck Tabanou,£6.75m ,31,178,Defender - Left-Back,left,Without Club,35,4,7,2788,34,3,6,2649,37,5,5,2996,39,4,5,2419,43,2,5,3681,17,0,0,1107,8,0,0,547,15,0,2,1046,4,0,0,420,Ligue 1,nan,nan,nan,nan,nan,nan,nan,nan
13/6/2011,Floyd Ayité,34001871,50,12/15/1988,22,12,2,0,0,4200,5900,5300,140,118,510671,174,68,M/AM RL,3,2,3,3,3,3,3,2,3,3,2,9,9,13,7,13,10,5,12,6,5,11,11,8,15,8,12,12,11,11,13,8,13,13,6,10,9,8,13,17,13,11,7,8,15,14,20,14,8,12,8,14,7,15,14,13,13,10,13,14,14,7,1,1,17,20,20,15,14,M/AM RL,525,1,1,8,10,15,20,1,1,1,10,14,15,17,1,1,268500996,0,0,1,0,0,0,0,0,0,0,0,0,0,0,0,0,1,0,0,0,0,0,0,0,0,0,0,0,1,0,0,0,0,0,0,0,0,0,0,0,0,0,0,0,0,0,0,0,,,,,,,,,,,,,,,,,,,,,,,,,,,,,,,,,,,,,,,,,,,,,,,,,,,,
13/6/2011,Florin Berenguer-Bohrer,34001556,769,4/1/1989,22,0,0,0,0,2250,3400,3400,130,103,767007,182,70,AM RL,2,2,3,3,3,2,1,4,2,1,2,10,11,13,6,11,9,6,8,7,4,9,8,3,13,9,9,11,12,12,9,12,10,12,6,11,6,8,13,12,13,13,8,10,12,15,20,13,6,13,9,10,7,8,12,7,18,6,19,6,6,15,1,1,15,20,20,18,1,AM RL,505,1,1,1,1,18,20,1,1,1,1,1,15,15,1,1,0,0,0,0,0,0,0,0,0,0,0,0,0,0,0,0,0,0,0,0,0,0,0,0,0,0,0,0,0,0,0,0,0,0,0,0,0,0,0,0,0,0,0,0,0,0,0,0,0,Florin Bérenguer,£450Th. ,31,182,Midfielder - Attacking Midfield,right,Melbourne City FC,23,2,4,1601,20,1,0,1073,38,4,5,2908,28,6,6,1965,32,6,1,2286,6,1,0,307,26,0,3,1663,29,5,5,2314,20,0,3,1488,Ligue 1,19,3,1,1426,nan,nan,nan,nan
13/6/2011,Florian Jégu,85084366,769,5/12/1989,22,0,0,0,0,1300,2100,2100,105,84,13163,176,68,M/AM RL,1,2,3,1,1,3,3,1,3,1,3,4,6,10,12,10,7,6,8,5,1,7,13,2,12,11,9,10,12,7,7,9,10,12,5,10,4,5,10,13,12,11,7,10,14,13,20,7,7,14,8,7,7,10,9,14,7,6,14,11,13,6,1,1,16,20,16,20,1,M/AM RL,525,1,1,13,1,20,16,1,1,1,1,1,16,16,1,1,0,0,0,0,0,0,0,0,0,0,0,0,0,0,0,0,0,0,0,0,0,0,0,0,0,0,0,0,0,0,0,0,0,0,0,0,0,0,0,0,0,0,0,0,0,0,0,0,0,Florian Julien, ,27,175,Defender - Right-Back,right,Unknown,nan,nan,nan,nan,0,0,0,0,2,0,1,96,2,0,0,10,nan,nan,nan,nan,nan,nan,nan,nan,nan,nan,nan,nan,nan,nan,nan,nan,nan,nan,nan,nan,Ligue 1,nan,nan,nan,nan,nan,nan,nan,nan
13/6/2011,Feliz,55029390,788,4/9/1989,22,0,0,0,0,750,3000,3000,114,70,82141,165,60,AM RL,1,2,2,2,1,1,2,2,3,1,2,6,8,10,10,12,8,3,8,8,3,8,2,4,9,8,9,9,2,6,7,7,10,10,11,5,2,13,13,12,12,12,5,8,12,12,20,9,2,7,11,8,4,10,13,15,13,9,13,6,8,14,1,1,9,20,20,15,1,AM RL,505,1,1,5,1,15,20,1,1,1,1,1,1,9,1,1,0,0,0,0,0,0,0,0,0,0,0,0,0,0,0,0,0,0,0,0,0,0,0,0,0,0,0,0,0,0,0,0,0,0,0,0,0,0,0,0,0,0,0,0,0,0,0,0,0,,,,,,,,,,,,,,,,,,,,,,,,,,,,,,,,,,,,,,,,,,,,,,,,,,,,
13/6/2011,Emmanuel Imorou,34009192,7,9/16/1988,22,5,0,0,0,3250,5450,5000,135,110,3159703,181,69,D/WB/M L,1,2,3,2,2,1,1,2,2,2,3,8,14,9,6,11,8,10,10,12,11,10,6,10,11,7,12,10,12,12,9,9,12,8,6,9,8,10,12,16,13,13,10,20,12,15,8,13,10,13,7,14,8,12,11,14,12,10,11,15,15,7,20,18,16,12,10,20,1,D/WB/M L,123,1,1,1,1,12,10,1,20,10,1,1,16,10,18,10,1,1,0,0,0,0,0,0,0,0,0,0,0,0,0,0,0,0,0,0,0,0,0,0,0,0,0,0,0,0,0,0,0,0,0,0,0,0,0,0,0,0,0,0,0,0,0,0,0,Emmanuel Imorou,£900Th. ,32,181,Defender - Left-Back,left,Thonon Ã‰vian Grand GenÃ¨ve FC,29,0,2,1567,5,0,0,270,31,0,0,2483,33,1,1,2871,32,0,1,2770,15,1,1,1202,10,0,0,790,16,0,2,1292,16,0,1,1119,Liga NOS,1,0,0,90,nan,nan,nan,nan
13/6/2011,Elliott Bennett,28006433,765,12/18/1988,22,0,0,0,0,3350,5550,5900,136,111,3670991,178,73,M/AM RLC,3,3,3,1,1,2,3,3,2,1,1,14,14,11,7,12,13,5,13,3,8,12,9,8,11,7,9,7,10,11,13,10,14,9,5,13,11,13,12,15,9,8,9,10,14,14,20,14,8,15,5,12,2,16,5,12,13,11,14,13,16,1,9,9,19,20,20,19,19,M/AM RLC,526,1,1,1,19,19,20,1,1,9,1,19,15,19,1,9,0,0,0,0,0,0,0,0,0,0,0,0,0,0,0,0,0,0,0,0,0,0,0,0,0,0,0,0,0,0,0,0,0,0,0,0,0,0,0,0,0,0,0,0,0,0,0,0,0,Elliott Bennett,£2.70m ,31,179,Defender - Right-Back,right,Blackburn Rovers,53,8,20,4571,37,1,7,2295,29,2,3,1284,6,1,3,442,21,0,1,1315,42,2,5,3091,31,4,2,2153,47,2,7,3962,42,1,5,3611,Premier League,42,0,4,2829,1,0,0,11
13/6/2011,Dominique Malonga,8440232,769,1/8/1989,22,0,0,0,0,3000,5750,6250,148,128,2484367,183,80,AM/S LC,3,2,3,1,2,2,1,8,1,3,3,8,11,12,16,11,14,15,16,6,6,9,12,7,13,9,13,9,15,11,12,12,12,12,6,14,8,8,7,14,12,14,12,7,15,14,20,12,15,12,7,14,6,8,16,16,13,10,12,11,12,8,1,1,1,18,10,16,18,AM/S LC,624,1,1,20,18,16,10,1,1,1,1,1,1,1,1,1,0,0,0,0,0,0,0,0,0,0,0,0,0,0,0,0,0,0,0,0,0,0,0,0,0,0,0,0,0,0,0,0,0,0,0,0,0,0,0,0,0,0,0,0,0,0,0,0,0,Dominique Malonga,£630Th. ,31,185,Forward - Centre-Forward,right,Lokomotiv Plovdiv,23,2,2,777,13,0,0,712,37,9,1,2473,29,5,1,1183,31,16,5,2326,39,9,3,2196,9,1,3,132,13,7,0,609,39,14,3,2639,Serie A,nan,nan,nan,nan,nan,nan,nan,nan
13/6/2011,Dominik Rohracker,35018730,771,1/9/1989,22,0,0,0,0,2500,4300,4300,111,86,30959,172,61,M/AM RL,2,3,3,2,3,1,1,1,2,1,2,7,10,11,10,10,9,5,10,3,9,8,2,11,10,13,6,7,8,11,7,8,11,13,4,9,7,13,15,13,13,7,3,13,16,10,20,10,5,10,5,10,8,18,19,10,17,13,9,14,8,13,15,9,20,18,15,20,1,M/AM RL,415,1,1,14,1,18,14,1,15,13,1,1,20,15,9,7,0,0,0,0,0,0,0,0,0,0,0,0,0,0,0,0,0,0,0,0,0,0,0,0,0,0,0,0,0,0,0,0,0,0,0,0,0,0,0,0,0,0,0,0,0,0,0,0,0,Dominik Kohr,£180Th. ,26,183,Midfielder - Central Midfield,right,Eintracht Frankfurt,19,9,2,1159,23,6,2,1636,33,2,0,2337,18,0,1,935,27,1,1,1698,39,0,5,3158,28,2,2,2140,32,2,2,2072,25,2,5,1450,Bundesliga,40,1,5,2294,2,0,0,127
13/6/2011,Diego Perotti,14005006,1649,7/26/1988,22,1,0,0,0,6050,7250,7250,170,150,48000000,179,70,M/AM RL,3,3,2,2,2,3,3,7,2,3,3,14,15,16,13,14,12,8,13,5,4,14,11,4,15,9,13,9,11,13,15,13,13,16,13,16,4,7,11,16,15,12,8,14,9,16,20,10,9,11,8,13,11,13,17,13,14,12,15,14,12,7,1,1,16,20,15,20,10,M/AM RL,525,1,1,11,10,20,15,1,1,1,1,1,16,10,1,1,7.04031E+13,0,0,0,0,0,0,0,0,0,0,0,0,0,0,0,0,0,0,0,0,0,0,0,0,0,0,0,0,0,0,0,0,0,0,0,1,0,0,0,0,0,0,0,0,0,0,1,0,Diego Perotti,£8.10m ,32,179,Forward - Left Winger,right,Fenerbahce SK,48,4,12,3331,19,0,3,1156,20,1,1,965,20,5,2,986,28,4,6,2393,34,4,7,2571,45,10,10,2362,35,8,5,2364,15,5,1,811,LaLiga,26,6,4,1131,nan,nan,nan,nan
13/6/2011,Dejan Skolnik,64004509,761,1/1/1989,22,0,0,4,0,3250,5750,5850,140,117,1814844,175,65,M L,2,3,3,2,2,1,2,8,2,1,3,12,12,10,10,14,11,9,10,6,11,14,8,10,14,12,15,13,12,12,11,12,18,12,12,9,12,13,17,10,10,10,10,20,12,11,8,13,11,12,7,12,12,14,14,16,15,14,19,20,14,7,5,7,20,14,1,20,12,M L,403,1,1,1,12,14,1,1,5,1,1,12,20,1,7,1,17179869185,1,0,0,0,0,0,0,0,0,0,0,0,0,0,0,0,0,0,0,0,0,0,0,0,0,0,0,0,0,0,0,0,0,0,1,0,0,0,0,0,0,0,0,0,0,0,0,0,Dejan Skolnik,£990Th. ,31,175,Midfielder - Left Midfield,left,SV Kaindorf/Sulm,31,2,3,2404,27,3,1,1757,3,0,0,198,nan,nan,nan,nan,12,1,0,793,31,3,1,2281,3,0,0,138,22,0,0,1759,1,0,0,44,Liga NOS,nan,nan,nan,nan,nan,nan,nan,nan
13/6/2011,Daniel Toribio,67022041,796,10/5/1988,22,0,0,0,0,2500,5000,5000,128,104,1862465,172,71,DM/M LC,1,3,2,1,1,3,2,5,3,3,1,8,9,9,6,11,12,10,8,8,10,13,10,12,11,9,12,12,10,10,12,12,13,8,9,12,10,10,12,12,13,10,8,20,12,12,11,12,13,12,7,10,8,10,10,12,12,11,12,9,11,7,12,14,18,1,1,17,18,DM/M LC,314,1,1,1,1,1,1,1,12,1,20,18,17,1,14,1,0,0,0,0,0,0,0,0,0,0,0,0,0,0,0,0,0,0,0,0,0,0,0,0,0,0,0,0,0,0,0,0,0,0,0,0,0,0,0,0,0,0,0,0,0,0,0,0,0,,,,,,,,,,,,,,,,,,,,,,,,,,,,,,,,,,,,,,,,,,,,,,,,,,,,
13/6/2011,Daniel Caligiuri,91003264,771,1/15/1989,22,0,0,0,0,3750,6000,6000,132,128,3726123,182,79,AM RL,3,1,2,1,1,3,2,5,3,1,1,10,14,14,11,10,8,8,9,13,8,13,7,9,9,13,12,11,8,11,10,8,9,9,8,13,14,12,14,14,14,16,9,10,12,15,20,15,13,5,8,8,8,13,5,5,11,13,15,10,7,17,1,1,9,20,20,18,9,AM RL,505,1,1,1,9,18,20,1,1,1,1,7,9,5,1,1,7.09185E+13,0,0,0,0,1,0,0,0,0,0,0,0,0,0,0,0,0,0,0,0,0,0,0,0,0,0,0,0,0,0,0,0,0,0,0,0,0,0,0,1,0,0,0,0,0,0,1,0,Daniel Caligiuri,£2.25m ,32,182,Midfielder - Right Midfield,right,FC Augsburg,26,0,2,1288,28,7,6,1933,33,8,3,2831,27,1,3,1236,45,10,9,2718,40,3,7,2437,41,6,6,2969,37,6,11,3187,40,7,5,3516,Bundesliga,30,4,5,2466,5,2,1,421
13/6/2011,Daniel Brosinski,35008235,771,7/17/1988,22,0,0,4,1,3000,5450,5450,121,109,98824,178,65,M/AM RL,1,1,3,2,2,2,2,1,2,3,2,10,12,13,8,10,13,7,10,8,5,12,11,8,11,6,10,12,8,8,9,10,12,8,8,9,7,13,15,13,13,10,7,20,11,13,15,12,7,9,6,12,8,10,10,12,11,8,12,14,10,8,1,8,16,20,18,20,1,M/AM RL,525,1,1,1,1,20,18,1,1,1,1,1,15,16,8,8,134217729,1,0,0,0,0,0,0,0,0,0,0,0,0,0,0,0,0,0,0,0,0,0,0,0,0,0,0,1,0,0,0,0,0,0,0,0,0,0,0,0,0,0,0,0,0,0,0,0,Daniel Brinkmann,£450Th. ,34,193,Midfielder - Central Midfield,right,Retired,25,0,4,1524,17,2,2,977,4,1,0,95,5,2,0,307,35,0,1,1821,7,0,0,630,15,0,0,800,26,3,5,1648,32,7,4,2264,Bundesliga,16,1,1,937,nan,nan,nan,nan
13/6/2011,Crivellaro,2111397,1651,2/18/1989,22,0,0,0,0,500,5400,5400,116,108,432574,184,77,AM RLC,1,3,1,3,2,2,2,4,2,3,3,10,14,14,14,14,10,10,14,2,7,11,10,11,12,10,10,5,6,7,13,13,9,13,6,12,6,6,10,14,11,13,14,8,14,13,20,6,5,11,7,10,12,10,5,10,9,13,7,14,7,11,1,1,9,20,17,17,20,AM RLC,506,1,1,13,20,17,17,1,1,1,1,9,1,1,1,1,0,0,0,0,0,0,0,0,0,0,0,0,0,0,0,0,0,0,0,0,0,0,0,0,0,0,0,0,0,0,0,0,0,0,0,0,0,0,0,0,0,0,0,0,0,0,0,0,0,,,,,,,,,,,,,,,,,,,,,,,,,,,,,,,,,,,,,,,,,,,,,,,,,,,,
13/6/2011,Cristian Lobato,67131458,796,3/7/1989,22,0,0,0,0,3000,5000,5000,125,103,1267463,174,66,WB/M/AM RL,3,1,2,3,1,2,2,3,3,1,1,9,11,12,5,11,8,7,12,4,8,12,8,7,8,14,12,9,6,9,9,12,11,7,6,11,7,10,14,12,10,11,6,12,8,12,20,12,7,10,7,10,4,10,9,12,8,13,8,11,12,11,13,16,19,20,18,20,1,WB/M/AM RL,535,1,1,1,1,20,18,1,13,9,1,1,19,17,16,13,0,0,0,0,0,0,0,0,0,0,0,0,0,0,0,0,0,0,0,0,0,0,0,0,0,0,0,0,0,0,0,0,0,0,0,0,0,0,0,0,0,0,0,0,0,0,0,0,0,Cristian Llama,£720Th. ,34,179,Midfielder - Left Midfield,left,Gimnasia y Esgrima de Mendoza,17,2,4,661,18,0,2,519,6,0,0,194,15,0,4,814,16,5,2,895,11,1,0,694,15,0,1,767,8,1,0,606,15,0,1,601,Serie A,19,2,0,1080,nan,nan,nan,nan
13/6/2011,Chris Löwe,35022877,771,4/16/1989,22,0,0,0,0,2500,5750,6250,134,115,1445778,171,68,D/M/AM L,1,3,3,3,1,3,3,5,2,2,1,13,15,13,11,12,12,7,13,10,8,13,6,9,12,13,11,12,10,9,11,12,12,11,5,11,8,15,13,15,14,11,6,20,14,13,7,10,10,9,8,8,5,13,11,13,13,9,12,14,15,8,19,15,20,18,1,20,1,D/M/AM L,433,1,1,1,1,18,1,1,19,1,1,1,20,1,15,1,0,0,0,0,0,0,0,0,0,0,0,0,0,0,0,0,0,0,0,0,0,0,0,0,0,0,0,0,0,0,0,0,0,0,0,0,0,0,0,0,0,0,0,0,0,0,0,0,0,Chris Löwe,£900Th. ,31,173,Defender - Left-Back,left,SG Dynamo Dresden,36,4,13,3131,16,0,0,1297,17,0,2,1513,33,1,4,2971,34,2,5,2994,25,1,6,2255,45,2,3,3918,25,0,0,1702,31,0,2,2159,Bundesliga,22,1,3,1603,6,0,0,464
13/6/2011,Carlos Vela,51000001,379,3/1/1989,22,35,9,8,0,5150,7000,6750,165,133,4994175,179,72,AM/S LC,3,3,3,1,2,3,1,4,2,1,1,11,12,15,15,15,10,8,12,1,4,12,13,6,15,10,11,10,16,10,14,11,11,17,4,13,5,9,10,17,16,15,7,20,10,14,7,14,8,12,6,14,9,12,16,19,8,15,9,14,13,7,1,1,10,17,1,17,17,AM/S LC,624,1,1,20,17,17,1,1,1,1,1,1,10,1,1,1,2098192,0,0,0,0,1,0,0,0,0,0,1,0,0,0,0,0,0,0,0,0,0,1,0,0,0,0,0,0,0,0,0,0,0,0,0,0,0,0,0,0,0,0,0,0,0,0,0,0,Carlos Vela,£5.40m ,31,177,Forward - Right Winger,left,Los Angeles FC,23,6,2,885,37,12,7,2594,37,14,11,2728,52,21,13,4195,32,10,4,2173,36,5,4,2805,39,10,4,2830,48,16,12,3289,36,38,12,3176,LaLiga,5,4,0,418,nan,nan,nan,nan
13/6/2011,Carlitos,55012418,788,9/24/1988,22,0,0,0,0,1250,3500,3500,98,85,281500,182,70,AM RL,3,3,2,1,2,1,2,4,3,3,3,10,11,12,8,10,5,5,8,5,8,8,1,6,12,8,8,10,8,8,7,8,14,14,9,11,6,8,10,12,12,8,8,9,11,12,20,8,7,10,8,10,10,11,11,14,15,10,12,13,13,7,1,1,9,20,20,15,7,AM RL,505,1,1,7,7,15,20,1,1,1,1,1,1,9,1,1,0,0,0,0,0,0,0,0,0,0,0,0,0,0,0,0,0,0,0,0,0,0,0,0,0,0,0,0,0,0,0,0,0,0,0,0,0,0,0,0,0,0,0,0,0,0,0,0,0,Carlitos,£270Th. ,38,176,Midfielder - Left Midfield,right,Retired,9,0,0,382,5,0,0,201,25,2,2,1927,33,4,1,2396,37,6,14,3026,35,4,7,3016,33,5,10,2640,12,4,2,886,8,0,1,345,Bundesliga,nan,nan,nan,nan,nan,nan,nan,nan
13/6/2011,Caner Metin,34000918,769,10/11/1988,22,0,0,0,0,950,1950,3900,100,78,34384,179,75,M RL,1,1,2,1,3,1,3,1,3,2,1,11,13,9,9,13,9,10,13,7,5,11,7,7,13,14,9,4,12,7,9,8,8,12,8,9,5,7,9,13,11,11,8,5,10,12,20,5,11,9,6,10,5,10,11,11,14,6,9,2,7,8,1,1,20,9,15,20,1,M RL,405,1,1,1,1,9,1,1,1,1,1,1,20,15,1,1,0,0,0,0,0,0,0,0,0,0,0,0,0,0,0,0,0,0,0,0,0,0,0,0,0,0,0,0,0,0,0,0,0,0,0,0,0,0,0,0,0,0,0,0,0,0,0,0,0,,,,,,,,,,,,,,,,,,,,,,,,,,,,,,,,,,,,,,,,,,,,,,,,,,,,
13/6/2011,Bruno César,2114054,1651,11/3/1988,22,0,0,0,0,3750,7000,6800,144,136,11999999,177,73,AM LC,2,2,3,1,2,1,1,3,3,3,2,14,15,14,15,13,15,11,17,4,6,14,14,6,15,6,11,10,13,13,14,13,10,14,6,14,9,14,13,13,12,12,7,20,11,13,8,13,12,10,10,12,10,10,11,13,7,11,13,14,13,8,1,1,8,20,14,17,20,AM LC,504,1,1,12,20,17,14,1,1,1,1,8,1,1,1,1,2.19902E+13,0,0,0,1,0,0,0,0,1,0,1,0,0,0,0,0,0,0,0,0,0,0,0,0,0,0,0,0,0,0,0,0,0,0,0,0,0,0,0,0,0,0,1,0,1,0,0,0,Bruno César,£6.75m ,31,178,Midfielder - Attacking Midfield,left,FC Penafiel,1,0,0,56,44,13,7,2786,32,7,5,2047,15,4,1,870,19,3,1,718,29,5,4,1885,42,6,8,2773,33,2,0,1361,18,2,0,581,Liga NOS,9,0,0,271,2,0,0,27
13/6/2011,André Carvalhas,55004192,788,3/7/1989,22,0,0,0,0,1500,3500,3500,95,85,10304,166,63,AM RL,1,1,3,2,3,3,2,2,2,2,3,9,11,13,12,11,11,5,9,6,5,9,8,6,12,11,10,10,7,7,7,6,7,14,10,10,6,6,10,12,11,7,5,16,12,11,20,9,6,8,7,10,11,11,9,12,15,19,14,13,14,5,1,1,1,20,20,20,10,AM RL,505,1,1,10,10,20,20,1,1,1,1,1,1,1,1,1,0,0,0,0,0,0,0,0,0,0,0,0,0,0,0,0,0,0,0,0,0,0,0,0,0,0,0,0,0,0,0,0,0,0,0,0,0,0,0,0,0,0,0,0,0,0,0,0,0,,,,,,,,,,,,,,,,,,,,,,,,,,,,,,,,,,,,,,,,,,,,,,,,,,,,
13/6/2011,Amara Baby,85040310,769,2/23/1989,22,0,0,0,0,2600,5264,3900,145,117,984487,183,68,DM/M/AM LC,3,2,3,2,3,1,1,1,1,3,3,8,9,13,8,11,9,9,11,6,3,11,10,6,15,9,12,10,12,12,13,11,14,13,7,13,11,13,12,16,12,13,11,20,12,14,8,14,9,13,7,15,7,10,9,11,13,9,15,11,19,16,1,1,20,16,1,18,20,DM/M/AM LC,434,1,1,1,12,16,1,1,1,1,16,20,18,1,1,1,4,0,0,1,0,0,0,0,0,0,0,0,0,0,0,0,0,0,0,0,0,0,0,0,0,0,0,0,0,0,0,0,0,0,0,0,0,0,0,0,0,0,0,0,0,0,0,0,0,,,,,,,,,,,,,,,,,,,,,,,,,,,,,,,,,,,,,,,,,,,,,,,,,,,,
13/6/2011,Alexis Sánchez,75000261,1652,12/19/1988,22,41,14,4,1,7250,8400,8400,184,169,161361023,168,69,AM/S RLC,1,3,2,1,2,2,1,6,2,2,1,10,14,19,12,16,8,12,14,7,6,14,12,12,16,15,16,18,14,8,15,8,16,17,7,14,4,9,16,19,16,15,6,7,17,16,20,16,14,13,9,14,6,14,11,19,15,15,16,11,14,4,1,1,10,20,20,15,19,AM/S RLC,516,1,1,19,19,15,20,1,1,1,1,1,1,10,1,1,7.04031E+13,0,0,0,0,1,0,0,0,0,0,0,0,0,0,0,0,0,0,0,0,0,0,0,0,0,0,0,0,0,0,0,0,0,0,0,1,0,0,0,0,0,0,0,0,0,0,1,0,Alexis Sánchez,£27.00m ,31,168,Forward - Centre-Forward,right,Inter Milan,33,12,11,2517,41,14,7,2640,46,11,14,2619,54,21,16,3418,52,25,12,4326,41,17,11,3289,51,30,18,4229,40,11,9,3252,27,2,4,1240,LaLiga,32,4,10,1392,5,0,2,165
13/6/2011,Yoann Tribeau,152607,769,2/26/1988,23,0,0,0,0,1750,3500,3500,125,107,65035,180,72,AM RL,1,3,3,3,3,3,3,7,1,1,3,7,12,13,7,11,7,9,11,5,2,11,9,3,13,13,8,8,11,11,11,9,15,13,5,12,4,7,10,15,13,12,10,10,14,13,20,14,9,13,13,13,8,8,12,14,11,11,12,9,9,7,1,1,12,20,20,16,10,AM RL,505,1,1,10,10,16,20,1,1,1,1,10,12,12,1,1,2.2518E+15,0,0,0,0,0,0,0,0,0,0,0,0,0,0,0,0,0,0,0,0,1,0,0,0,0,0,0,0,0,0,0,0,0,0,0,0,0,0,0,0,0,0,0,0,0,0,0,0,,,,,,,,,,,,,,,,,,,,,,,,,,,,,,,,,,,,,,,,,,,,,,,,,,,,
13/6/2011,Xavier Annunziata,67024746,796,8/31/1987,23,0,0,0,0,3800,5800,5800,136,114,2283702,179,66,AM LC,2,3,3,3,3,2,1,5,3,1,2,10,13,14,10,13,9,8,9,4,5,13,10,5,14,13,11,9,11,11,11,11,10,12,8,12,7,13,13,15,13,10,9,5,15,13,20,13,13,14,7,14,6,5,18,9,6,15,7,6,5,12,1,1,9,20,10,20,15,AM LC,504,1,1,10,15,20,10,1,1,1,1,5,9,1,1,1,128,0,0,0,0,0,0,0,1,0,0,0,0,0,0,0,0,0,0,0,0,0,0,0,0,0,0,0,0,0,0,0,0,0,0,0,0,0,0,0,0,0,0,0,0,0,0,0,0,Xavier Annunziata,£360Th. ,33,177,Forward - Left Winger,nan,Without Club,32,12,0,2581,9,1,0,368,22,0,2,684,33,1,0,1896,11,1,0,610,nan,nan,nan,nan,32,4,1,2290,24,3,0,1852,nan,nan,nan,nan,LaLiga,nan,nan,nan,nan,nan,nan,nan,nan
13/6/2011,Vincent Scotté,34011775,769,7/1/1987,23,0,0,0,0,2050,3150,3150,115,95,92011,180,70,M/AM L,1,2,3,2,3,3,2,1,1,1,2,8,11,12,8,12,7,6,8,6,2,7,8,3,12,7,9,9,11,11,9,10,16,12,5,11,5,8,11,16,13,13,9,20,13,13,5,12,9,13,7,14,8,6,10,14,11,10,14,14,14,7,1,1,16,20,1,20,1,M/AM L,523,1,1,14,1,20,1,1,1,1,1,1,16,1,1,1,1,1,0,0,0,0,0,0,0,0,0,0,0,0,0,0,0,0,0,0,0,0,0,0,0,0,0,0,0,0,0,0,0,0,0,0,0,0,0,0,0,0,0,0,0,0,0,0,0,,,,,,,,,,,,,,,,,,,,,,,,,,,,,,,,,,,,,,,,,,,,,,,,,,,,
13/6/2011,Umut Koçin,35007444,799,6/2/1988,23,0,0,2,0,2500,250,5000,120,100,279716,180,70,WB/M L,3,2,3,1,3,2,2,6,2,2,1,9,12,14,8,14,13,5,12,10,6,10,13,7,14,9,8,12,10,9,11,9,13,12,5,13,8,11,12,13,14,11,10,20,12,14,5,10,9,10,5,8,10,10,17,7,6,7,11,12,13,19,15,18,20,15,1,20,1,WB/M L,423,1,1,1,1,15,1,1,15,1,1,1,20,1,18,1,3.51844E+13,1,0,0,0,0,0,0,0,1,1,0,0,0,0,0,0,0,0,0,0,0,0,0,0,0,0,0,0,0,0,0,0,0,0,0,0,0,0,0,0,0,0,0,0,0,1,0,0,,,,,,,,,,,,,,,,,,,,,,,,,,,,,,,,,,,,,,,,,,,,,,,,,,,,
13/6/2011,Toni Pfeffing,91015340,771,10/25/1987,23,0,0,0,0,100,3050,3050,75,61,1730,175,75,AM/S RLC,2,3,2,3,2,1,2,1,2,3,2,6,8,11,7,9,6,6,5,3,6,8,1,4,8,7,6,2,11,7,4,7,8,10,6,9,4,8,10,11,10,10,7,17,9,10,20,5,2,9,5,10,17,8,4,10,11,11,7,11,13,7,1,1,13,20,20,16,18,AM/S RLC,516,1,1,17,18,16,20,1,1,1,1,13,12,12,1,1,0,0,0,0,0,0,0,0,0,0,0,0,0,0,0,0,0,0,0,0,0,0,0,0,0,0,0,0,0,0,0,0,0,0,0,0,0,0,0,0,0,0,0,0,0,0,0,0,0,,,,,,,,,,,,,,,,,,,,,,,,,,,,,,,,,,,,,,,,,,,,,,,,,,,,
13/6/2011,Tiago Terroso,55008432,788,1/13/1988,23,0,0,0,0,1250,4500,4500,121,106,679484,178,78,M/AM LC,3,1,2,3,2,2,2,3,3,2,2,13,13,13,10,13,12,9,11,8,10,13,13,11,13,10,13,10,12,11,13,12,12,11,9,12,13,13,13,12,12,12,10,20,12,13,5,11,10,12,7,10,7,12,16,12,15,11,13,14,14,6,1,1,17,20,1,17,20,M/AM LC,524,1,1,1,20,5,1,1,1,1,1,16,17,1,1,1,0,0,0,0,0,0,0,0,0,0,0,0,0,0,0,0,0,0,0,0,0,0,0,0,0,0,0,0,0,0,0,0,0,0,0,0,0,0,0,0,0,0,0,0,0,0,0,0,0,Tiago Terroso,£900Th. ,32,178,Midfielder - Defensive Midfield,left,AD Esposende,36,4,0,2988,18,0,0,1101,18,0,0,1267,19,1,1,996,1,0,0,22,nan,nan,nan,nan,nan,nan,nan,nan,nan,nan,nan,nan,nan,nan,nan,nan,Liga NOS,nan,nan,nan,nan,nan,nan,nan,nan
13/6/2011,Tayfun Pektürk,91003611,771,5/13/1988,23,0,0,0,0,1650,5100,5100,118,110,146724,177,74,AM/S RL,1,1,1,2,3,2,1,7,3,1,3,7,8,11,9,10,10,5,8,2,3,8,9,6,11,9,9,13,9,5,7,7,8,12,7,10,5,6,7,14,13,7,7,15,10,14,20,9,7,6,6,9,6,12,6,13,9,6,7,12,8,17,1,1,14,20,18,20,12,AM/S RL,515,1,1,18,12,20,18,1,1,1,1,1,14,14,1,1,0,0,0,0,0,0,0,0,0,0,0,0,0,0,0,0,0,0,0,0,0,0,0,0,0,0,0,0,0,0,0,0,0,0,0,0,0,0,0,0,0,0,0,0,0,0,0,0,0,,,,,,,,,,,,,,,,,,,,,,,,,,,,,,,,,,,,,,,,,,,,,,,,,,,,
13/6/2011,Steeven Langil,34012768,769,3/4/1988,23,0,0,2,0,4350,5450,5450,140,121,2358160,178,67,AM RL,1,2,1,3,2,3,3,4,3,2,2,10,7,13,11,13,8,7,12,5,2,8,10,3,14,7,12,8,11,10,9,8,13,13,5,14,5,8,11,18,15,12,9,8,12,16,20,14,8,12,7,14,9,10,5,16,10,11,7,11,11,12,1,1,12,20,15,20,10,AM RL,505,1,1,13,10,20,15,1,1,1,1,10,12,12,1,1,2.2562E+15,0,0,0,0,0,0,0,0,0,0,0,0,0,0,0,0,0,0,0,0,0,0,0,0,0,0,0,0,0,0,0,0,0,0,0,0,0,0,0,0,0,0,1,0,0,0,0,0,,,,,,,,,,,,,,,,,,,,,,,,,,,,,,,,,,,,,,,,,,,,,,,,,,,,
13/6/2011,Sidney Sam,35006408,771,1/31/1988,23,0,0,7,1,5000,7000,7000,158,142,11690515,174,72,AM RL,2,1,1,1,3,3,1,1,2,2,2,9,13,16,17,16,10,5,17,7,5,12,14,6,15,11,9,10,13,9,8,8,12,18,5,10,5,6,12,18,18,9,7,20,13,16,7,13,8,10,6,13,6,12,10,14,11,13,14,13,11,8,1,1,14,20,20,16,14,AM RL,505,1,1,15,14,16,20,1,1,1,1,8,13,14,1,1,5.49756E+11,1,1,0,0,0,0,0,0,1,0,0,1,0,0,0,0,0,0,0,0,0,0,0,0,0,0,0,0,0,0,0,0,0,0,0,0,0,0,0,1,0,0,0,0,0,0,0,0,Sidney Sam,£5.85m ,32,174,Forward - Right Winger,left,Antalyaspor,40,12,8,2870,25,6,4,2045,28,5,5,1177,31,13,9,2026,16,0,1,762,8,1,0,318,23,4,3,1669,24,0,1,1726,19,2,3,1147,Bundesliga,23,6,8,1544,3,1,0,123
13/6/2011,Samir Nasri,8428584,769,6/26/1987,23,22,2,6,0,7500,8000,8450,175,164,115459996,177,75,M/AM RLC,2,2,3,1,3,2,3,5,3,2,3,12,12,17,15,17,15,5,13,2,6,15,12,9,17,12,14,12,15,12,15,15,16,17,10,16,8,13,13,15,18,18,8,15,15,14,20,15,9,13,6,14,12,14,14,16,14,14,13,14,11,10,1,1,17,20,18,18,20,M/AM RLC,526,1,1,1,20,18,18,1,1,1,10,17,16,16,1,1,5.54051E+11,0,0,0,0,0,0,0,0,0,0,1,0,0,0,0,0,0,0,0,1,0,0,0,0,0,0,0,0,0,0,0,0,1,0,0,0,0,0,0,1,0,0,0,0,0,0,0,0,Samir Nasri,£22.50m ,33,177,Midfielder - Attacking Midfield,right,Without Club,46,15,5,3416,46,6,9,3280,38,5,9,2472,46,11,12,3277,33,3,7,2100,13,2,3,619,31,3,3,2415,8,2,1,720,6,0,2,303,Premier League,9,2,0,594,nan,nan,nan,nan
13/6/2011,Roland Lamah,8168308,757,12/31/1987,23,5,0,7,2,5050,6250,5600,140,125,2757499,180,71,AM RL,1,3,2,1,3,2,2,2,2,3,3,11,13,14,7,9,9,11,11,11,5,11,13,4,14,8,12,12,12,11,12,8,12,13,5,13,7,10,12,16,14,13,10,20,14,15,8,13,11,12,8,14,7,10,14,14,13,13,11,15,15,6,10,10,15,20,18,20,8,AM RL,505,1,1,12,8,20,18,1,10,1,1,1,15,15,10,1,2.2518E+15,0,0,0,0,0,0,0,0,0,0,0,0,0,0,0,0,0,0,0,0,0,0,0,0,0,0,0,0,0,0,0,0,0,0,0,0,0,0,0,0,0,0,0,0,0,0,0,0,Roland Lamah,£1.80m ,32,180,Forward - Left Winger,left,Without Club,27,3,7,1865,38,3,3,2544,24,2,2,1105,18,3,4,954,26,8,6,2044,45,8,15,3203,37,11,4,2569,32,9,5,2002,28,1,5,1783,LaLiga,nan,nan,nan,nan,nan,nan,nan,nan
13/6/2011,Robert Snodgrass,5207947,793,9/7/1987,23,4,1,2,0,4500,6250,6250,143,125,7679175,182,81,M/AM RL,3,2,1,1,3,2,1,6,2,1,3,14,14,14,13,12,13,9,13,2,8,14,12,11,14,12,11,14,12,12,12,14,15,14,9,14,12,12,14,12,14,12,10,20,13,10,8,15,14,15,7,12,8,15,14,16,12,10,11,13,15,5,1,1,18,20,20,18,13,M/AM RL,525,1,1,13,13,18,20,1,1,1,1,1,18,18,1,1,1.81591E+13,0,0,0,0,0,0,0,0,0,0,1,1,0,0,0,0,0,0,0,0,1,0,0,0,0,0,0,0,0,0,0,0,0,0,1,0,0,0,0,1,0,0,0,0,1,0,0,0,,,,,,,,,,,,,,,,,,,,,,,,,,,,,,,,,,,,,,,,,,,,,,,,,,,,
13/6/2011,Ricardo Alvarez,14009787,1649,4/12/1988,23,0,0,0,0,4100,5850,6400,160,128,25643224,188,73,M/AM LC,1,1,1,2,1,1,2,1,1,1,1,11,12,16,12,12,12,10,16,5,6,14,11,8,16,9,9,10,10,10,13,13,12,17,7,13,10,11,11,14,15,12,12,20,13,13,11,13,11,12,11,12,15,14,10,15,12,13,15,11,8,10,1,1,17,20,14,20,17,M/AM LC,524,1,1,7,15,20,14,1,1,1,1,17,10,9,1,1,5.62984E+14,0,0,0,0,0,0,0,0,1,0,0,0,0,0,0,0,0,0,0,0,0,0,0,0,0,0,0,0,0,0,0,0,0,0,0,1,0,0,0,0,0,0,0,0,0,0,0,0,Ricardo Álvarez,£10.35m ,32,188,Midfielder - Attacking Midfield,left,Club Atlético Vélez Sarsfield,38,5,7,1855,29,3,6,1532,30,7,3,1556,31,4,8,2230,17,1,0,725,13,1,1,809,23,3,1,1097,15,1,1,419,14,0,2,606,Serie A,7,2,1,309,nan,nan,nan,nan
13/6/2011,Renato Augusto,320569,1651,2/8/1988,23,3,0,3,0,6750,7400,7400,163,153,13277423,186,91,AM RLC,3,3,2,2,1,1,3,3,1,1,2,10,12,17,11,17,11,6,13,5,8,14,12,9,17,13,14,9,11,9,16,10,10,16,10,12,8,9,14,16,15,8,12,15,8,16,20,13,12,11,3,12,15,15,16,13,13,14,14,12,15,8,1,1,15,20,18,15,20,AM RLC,506,1,1,12,20,15,18,1,1,1,1,14,14,15,1,1,1207959556,0,0,1,0,0,0,0,0,0,0,0,0,0,0,0,0,0,0,0,0,0,0,0,0,0,0,0,1,0,0,1,0,0,0,0,0,0,0,0,0,0,0,0,0,0,0,0,0,Renato Augusto,£9.00m ,32,186,Midfielder - Central Midfield,right,Beijing Sinobo Guoan,35,8,11,2807,23,0,3,1666,32,2,2,1730,30,1,8,2093,40,5,9,3391,27,6,3,2136,30,4,6,2608,33,10,16,2996,38,16,13,3377,Bundesliga,13,2,4,724,nan,nan,nan,nan
13/6/2011,Rachid Bouallal,35020966,34,11/9/1987,23,0,0,0,0,1000,3550,3550,95,76,233187,182,83,AM RL,1,3,2,2,1,3,3,3,2,3,2,9,9,11,7,9,8,7,7,6,5,9,7,7,11,13,8,7,6,6,11,6,10,12,5,8,6,8,7,11,11,8,11,20,7,12,15,8,8,8,14,6,8,9,14,12,15,13,6,8,6,14,1,5,13,20,20,17,10,AM RL,505,1,1,15,10,17,20,1,1,1,1,7,10,13,3,5,0,0,0,0,0,0,0,0,0,0,0,0,0,0,0,0,0,0,0,0,0,0,0,0,0,0,0,0,0,0,0,0,0,0,0,0,0,0,0,0,0,0,0,0,0,0,0,0,0,,,,,,,,,,,,,,,,,,,,,,,,,,,,,,,,,,,,,,,,,,,,,,,,,,,,
13/6/2011,Quentin Othon,8434175,769,3/27/1988,23,0,0,1,0,4100,5150,5150,140,115,3422333,163,66,D/WB/M/AM L,2,2,3,3,1,1,1,1,2,3,3,13,13,10,6,11,12,5,12,10,7,12,8,12,11,8,13,11,12,12,12,12,17,8,10,9,12,13,15,15,13,7,2,20,13,14,5,13,7,13,8,14,9,12,7,14,15,14,16,15,15,6,16,16,18,20,1,20,10,D/WB/M/AM L,543,1,1,1,1,20,1,1,16,1,14,10,18,1,16,1,1,1,0,0,0,0,0,0,0,0,0,0,0,0,0,0,0,0,0,0,0,0,0,0,0,0,0,0,0,0,0,0,0,0,0,0,0,0,0,0,0,0,0,0,0,0,0,0,0,,,,,,,,,,,,,,,,,,,,,,,,,,,,,,,,,,,,,,,,,,,,,,,,,,,,
13/6/2011,Pedro,1510305,796,7/28/1987,23,13,2,1,0,7250,8000,8000,168,161,38649346,169,64,M/AM RL,3,1,3,3,1,1,1,9,1,1,3,11,14,15,15,13,9,9,13,5,5,14,11,8,14,8,14,14,15,13,14,14,16,17,8,16,6,17,16,16,15,9,6,18,14,15,20,13,7,14,9,16,7,15,5,13,16,15,17,12,17,5,1,1,17,20,20,18,11,M/AM RL,525,1,1,10,11,18,20,1,1,1,1,1,15,17,1,1,1.45136E+14,0,0,0,1,0,0,0,0,0,0,1,0,0,0,0,0,0,0,0,0,0,0,0,0,0,0,0,0,0,0,0,0,0,0,0,0,0,0,0,0,0,0,1,0,0,0,0,1,Pedro,£25.20m ,33,167,Forward - Right Winger,both,AS Roma,53,22,13,3588,48,13,6,2774,45,10,11,3413,54,19,13,3320,50,11,9,2199,43,9,3,2781,43,13,12,2723,48,7,5,2509,52,13,5,3099,LaLiga,23,2,3,1273,5,2,1,400
13/6/2011,Pedro Mosquera,67011240,796,4/21/1988,23,0,0,0,0,3700,5750,5750,140,117,2219728,183,75,AM LC,2,1,3,1,3,2,1,1,2,1,1,14,14,16,8,14,13,6,13,6,5,15,10,4,17,8,12,13,7,12,15,15,10,17,5,11,10,9,6,12,13,10,7,20,9,14,10,11,9,10,6,13,14,12,9,18,13,14,11,7,7,9,1,1,10,20,1,15,20,AM LC,504,1,1,1,20,15,1,1,1,1,1,9,10,1,1,1,144,0,0,0,0,1,0,0,1,0,0,0,0,0,0,0,0,0,0,0,0,0,0,0,0,0,0,0,0,0,0,0,0,0,0,0,0,0,0,0,0,0,0,0,0,0,0,0,0,Pedro Mosquera,£630Th. ,32,184,Midfielder - Central Midfield,left,SD Huesca,21,0,3,849,20,3,1,1656,38,3,2,3114,26,0,0,1592,27,1,2,2310,40,0,2,3507,27,3,0,1861,25,0,2,1504,17,0,1,1108,LaLiga,40,0,1,3409,6,0,0,540
13/6/2011,Pablo Barrera,5664900,379,6/21/1987,23,36,4,8,0,5500,6800,6750,151,132,9200000,175,65,AM RL,2,3,2,2,3,1,1,10,2,1,2,8,11,14,11,12,7,6,10,8,10,13,10,8,13,7,14,12,11,11,11,12,14,14,10,14,10,11,11,16,15,11,7,10,16,15,20,14,7,13,8,12,9,12,5,14,13,12,13,13,12,11,1,1,10,20,20,15,1,AM RL,505,1,1,1,1,15,20,1,1,1,1,1,1,10,1,1,0,0,0,0,0,0,0,0,0,0,0,0,0,0,0,0,0,0,0,0,0,0,0,0,0,0,0,0,0,0,0,0,0,0,0,0,0,0,0,0,0,0,0,0,0,0,0,0,0,Pablo Barrera,£2.25m ,33,175,Forward - Right Winger,right,Atlético de San Luis,24,0,3,1567,22,1,0,1111,28,2,8,2010,18,1,0,1082,39,4,1,2270,33,1,3,1678,34,8,6,2747,26,0,6,1808,40,5,7,3144,LaLiga,26,2,7,1511,13,1,2,948
13/6/2011,Olcay Turhan,91014201,799,1/30/1988,23,0,0,0,0,100,2450,2450,84,59,1498,179,72,M/AM LC,3,3,3,3,1,1,3,3,1,3,2,4,7,10,7,8,7,8,12,1,8,10,8,6,8,7,9,5,9,6,9,8,10,15,8,11,9,8,9,12,9,12,7,20,12,12,8,5,2,10,10,10,3,10,11,7,10,6,10,5,14,14,1,1,18,20,1,15,20,M/AM LC,524,1,1,1,20,1,1,1,1,1,12,18,15,1,1,1,0,0,0,0,0,0,0,0,0,0,0,0,0,0,0,0,0,0,0,0,0,0,0,0,0,0,0,0,0,0,0,0,0,0,0,0,0,0,0,0,0,0,0,0,0,0,0,0,0,Olcay Sahan,£1.13m ,33,179,Forward - Right Winger,right,Yeni Malatyaspor,40,7,8,3189,30,1,4,2224,37,11,6,3036,36,8,9,2877,48,9,11,3498,41,5,6,2456,37,3,10,2689,31,5,6,2020,21,2,5,974,Bundesliga,30,1,3,1722,2,0,0,89
13/6/2011,Nikita Rukavytsya,15001996,1435,6/22/1987,23,7,0,13,1,3700,5500,5750,134,122,3300103,183,74,AM/S L,1,3,2,1,1,3,3,3,1,3,2,6,8,13,9,12,12,7,13,6,4,9,5,5,13,10,9,8,10,10,8,9,17,13,7,11,10,9,12,17,15,14,12,20,15,17,6,15,11,10,8,10,7,10,10,15,14,10,15,10,10,1,1,1,9,20,14,20,10,AM/S L,513,1,1,18,10,20,14,1,1,1,1,1,9,1,1,1,1.75923E+13,0,0,0,0,0,0,0,0,0,1,0,0,0,0,0,0,0,0,0,0,0,0,0,1,0,0,0,1,0,0,0,0,0,0,0,0,0,0,0,0,0,0,0,0,1,0,0,0,Nikita Rukavytsya,£1.58m ,33,185,Forward - Centre-Forward,left,Maccabi Haifa,32,4,13,2290,26,2,4,1468,10,0,0,520,22,2,0,763,28,4,4,2048,29,14,2,2335,25,6,1,1621,36,13,2,2719,37,9,2,2620,Bundesliga,42,23,6,3291,6,8,4,451
13/6/2011,Nicolás Gaitán,14005523,1649,2/23/1988,23,6,0,0,0,5500,7000,7150,163,143,12156865,172,68,AM RLC,1,3,3,2,3,1,2,1,2,2,2,14,16,16,14,16,12,6,15,4,9,15,12,7,17,10,14,11,12,11,15,12,17,17,5,15,7,10,11,16,17,9,6,20,13,16,6,12,9,11,6,12,10,16,11,14,16,15,14,15,17,7,1,1,8,20,20,20,17,AM RLC,506,1,1,10,17,20,20,1,1,1,1,1,8,8,1,1,2.25238E+15,0,0,0,0,0,0,0,0,0,0,0,1,0,0,0,0,0,0,0,0,0,0,0,0,0,0,0,0,0,0,0,0,0,0,0,1,0,0,0,1,0,0,0,0,0,0,0,0,Nico Gaitán,£13.50m ,32,174,Midfielder - Attacking Midfield,left,SC Braga,48,9,10,3513,44,4,17,2987,44,5,13,2782,43,8,12,3428,37,4,16,2956,37,11,20,3116,36,4,5,1706,43,2,9,3135,28,4,11,2104,Liga NOS,4,0,0,50,0,0,0,0
13/6/2011,Nicolai Müller,35009581,771,9/25/1987,23,0,0,0,0,3750,6350,6350,140,127,3550600,175,63,AM RL,3,1,2,3,3,3,1,4,1,2,3,11,11,16,13,14,8,5,10,5,5,12,9,7,13,15,11,13,11,9,11,10,15,13,5,13,7,11,15,16,16,13,7,9,14,14,20,13,8,12,7,9,11,15,8,14,14,9,13,16,15,5,1,1,14,20,19,20,14,AM RL,505,1,1,14,14,20,19,1,1,1,1,6,14,8,1,1,5.49756E+11,0,0,0,0,0,0,0,0,0,0,0,0,1,0,0,0,0,0,0,0,0,0,0,0,0,0,0,0,0,0,0,0,0,0,0,0,0,0,0,1,0,0,0,0,0,0,0,0,Nicolai Müller,£2.70m ,33,173,Forward - Right Winger,right,Western Sydney Wanderers,35,7,7,3166,27,5,5,1712,36,9,6,2688,28,10,4,2182,29,2,4,2218,29,9,5,2161,27,5,7,2035,3,1,0,116,26,5,0,1268,Bundesliga,19,5,3,1505,nan,nan,nan,nan
13/6/2011,Nathan Dyer,5125009,765,11/29/1987,23,0,0,0,0,4200,6250,6250,145,124,4831214,166,64,M/AM RL,2,1,3,2,1,1,1,8,1,3,3,2,11,15,8,7,2,2,7,6,5,8,6,4,11,6,7,9,8,9,9,8,10,14,4,13,5,9,15,18,9,9,2,8,11,18,20,11,9,13,3,13,4,10,12,16,10,12,10,11,14,18,1,1,16,20,20,18,1,M/AM RL,525,1,1,10,1,18,20,1,1,1,1,1,14,16,1,1,3.29853E+12,0,1,0,0,0,1,0,0,0,0,0,0,0,0,0,0,0,0,0,0,0,0,0,0,0,0,0,0,0,0,0,0,0,0,0,0,0,0,0,0,1,1,0,0,0,0,0,0,Nathan Dyer,£4.05m ,32,165,Forward - Right Winger,right,Without Club,52,2,10,4004,36,6,2,2476,44,6,5,2859,37,6,2,2295,37,5,3,2261,17,3,1,568,12,0,3,505,31,3,0,1728,24,3,2,1493,Premier League,12,1,2,685,nan,nan,nan,nan
13/6/2011,Moustapha,12004613,24,6/9/1988,23,0,0,0,0,500,3500,3500,135,90,13509,180,76,AM RL,1,1,1,1,1,2,3,1,3,1,3,12,12,14,11,11,8,8,9,6,5,9,8,5,11,10,10,10,8,8,9,10,12,14,8,13,6,8,9,12,12,11,9,11,15,12,20,10,11,11,9,12,9,12,13,13,13,12,15,11,11,7,1,1,13,20,20,17,7,AM RL,505,1,1,1,7,17,20,1,1,1,1,1,10,13,1,1,0,0,0,0,0,0,0,0,0,0,0,0,0,0,0,0,0,0,0,0,0,0,0,0,0,0,0,0,0,0,0,0,0,0,0,0,0,0,0,0,0,0,0,0,0,0,0,0,0,Moustapha Sall,£720Th. ,34,193,Defender - Centre-Back,right,Without Club,21,0,0,1883,2,0,0,103,30,0,0,2629,37,1,1,3324,33,2,0,2939,38,6,0,3187,13,0,1,1096,11,0,0,965,nan,nan,nan,nan,Ligue 1,24,4,0,2160,nan,nan,nan,nan
13/6/2011,Moussa Dembélé,8161845,757,7/17/1987,23,33,5,1,0,6000,7100,7000,155,139,12328679,177,64,AM/S LC,2,1,2,3,3,2,2,7,1,2,3,8,12,15,11,16,9,12,8,7,4,11,12,7,16,12,12,15,12,10,12,9,14,15,7,14,5,12,14,13,14,15,11,20,11,14,14,14,15,12,8,13,13,11,18,11,16,11,14,12,10,2,1,1,1,19,14,17,19,AM/S LC,624,1,1,20,19,17,14,1,1,1,1,1,1,1,1,1,1.75922E+13,0,0,0,0,0,0,0,0,0,0,0,0,0,0,0,0,0,0,0,0,1,0,0,0,0,0,0,0,0,0,0,0,0,0,0,0,0,0,0,0,0,0,0,0,1,0,0,0,Mousa Dembélé,£11.70m ,33,185,Midfielder - Central Midfield,left,Guangzhou R&F,28,5,4,2225,45,2,4,3487,44,2,5,3148,42,2,2,2916,40,1,1,2018,35,4,1,2511,39,1,2,2502,39,0,0,2578,39,1,5,2847,Premier League,10,0,0,773,nan,nan,nan,nan
13/6/2011,Moses Lamidi,35014947,771,1/5/1988,23,0,0,0,0,2850,5450,5450,125,109,655592,177,71,AM/S RL,1,3,2,2,3,2,3,4,3,1,2,8,12,13,11,12,6,5,9,6,4,12,9,5,13,7,8,9,7,7,8,7,12,12,5,11,4,11,12,16,16,9,7,9,8,15,20,10,9,9,9,8,12,10,15,13,7,10,12,11,10,9,1,1,12,16,16,15,5,AM/S RL,625,1,1,20,5,15,16,1,1,1,1,1,8,12,1,1,0,0,0,0,0,0,0,0,0,0,0,0,0,0,0,0,0,0,0,0,0,0,0,0,0,0,0,0,0,0,0,0,0,0,0,0,0,0,0,0,0,0,0,0,0,0,0,0,0,,,,,,,,,,,,,,,,,,,,,,,,,,,,,,,,,,,,,,,,,,,,,,,,,,,,
13/6/2011,Modibo Maďga,8633054,31,9/3/1987,23,25,3,5,0,5550,6850,6150,150,137,9307386,185,76,AM/S L,3,1,2,2,3,3,1,5,3,2,2,12,11,14,14,14,11,16,13,5,6,12,14,4,15,12,13,13,13,10,11,12,16,13,8,15,9,12,12,14,13,15,13,20,14,13,8,14,15,13,10,14,7,8,12,18,5,13,5,14,14,14,1,1,12,17,12,17,10,AM/S L,623,1,1,20,10,17,12,1,1,1,1,1,12,12,1,1,262656,0,0,0,0,0,0,0,0,0,1,0,0,0,0,0,0,0,0,1,0,0,0,0,0,0,0,0,0,0,0,0,0,0,0,0,0,0,0,0,0,0,0,0,0,0,0,0,0,Modibo Maïga,£4.50m ,33,185,Forward - Centre-Forward,left,Without Club,39,16,3,3258,25,9,2,1792,20,4,2,678,27,3,3,1581,27,9,2,2000,37,12,5,2416,23,9,2,1984,19,10,2,1447,6,2,0,343,Ligue 1,nan,nan,nan,nan,nan,nan,nan,nan
13/6/2011,Milad Salem,91001077,106,3/3/1988,23,3,0,0,0,1500,3750,3750,95,75,28714,177,68,AM RL,3,2,2,2,2,3,2,1,2,3,2,6,11,11,6,9,6,4,9,5,4,10,8,8,9,15,12,9,10,8,8,7,10,11,1,7,8,9,12,12,11,12,6,9,13,12,20,8,2,9,6,10,8,10,7,11,4,8,6,11,14,14,1,1,15,20,20,15,1,AM RL,505,1,1,1,1,15,20,1,1,1,1,1,14,15,1,1,0,0,0,0,0,0,0,0,0,0,0,0,0,0,0,0,0,0,0,0,0,0,0,0,0,0,0,0,0,0,0,0,0,0,0,0,0,0,0,0,0,0,0,0,0,0,0,0,0,,,,,,,,,,,,,,,,,,,,,,,,,,,,,,,,,,,,,,,,,,,,,,,,,,,,
13/6/2011,Mikel Balenziaga,67029321,796,2/29/1988,23,0,0,1,0,4250,5750,5750,134,119,2049098,179,64,D/WB/M L,1,2,3,1,3,1,1,1,3,3,3,13,14,12,5,11,12,12,11,10,10,11,9,11,13,13,10,13,11,8,11,11,9,13,9,13,9,13,10,14,12,12,12,20,14,14,10,15,15,11,10,9,4,9,10,11,9,10,8,9,9,10,20,18,17,14,9,20,1,D/WB/M L,123,1,1,1,1,14,1,1,20,9,1,1,17,1,18,1,33,1,0,0,0,0,1,0,0,0,0,0,0,0,0,0,0,0,0,0,0,0,0,0,0,0,0,0,0,0,0,0,0,0,0,0,0,0,0,0,0,0,0,0,0,0,0,0,0,,,,,,,,,,,,,,,,,,,,,,,,,,,,,,,,,,,,,,,,,,,,,,,,,,,,
13/6/2011,Michael Pereira,67122190,769,12/8/1987,23,0,0,0,0,4500,6100,6350,150,134,3551209,180,69,M/AM RL,3,2,1,3,3,1,3,1,3,1,1,11,13,14,13,11,10,11,15,6,5,12,9,7,13,10,11,12,11,10,12,10,10,14,6,13,6,11,13,14,13,12,13,20,16,15,15,15,14,12,7,13,5,15,9,13,5,9,7,15,7,10,1,12,17,20,16,20,13,M/AM RL,525,1,1,1,13,20,16,1,1,1,1,1,17,13,12,11,5.49756E+11,0,0,0,0,0,0,0,0,0,1,0,0,0,0,0,0,0,0,0,0,0,0,0,0,0,0,0,0,0,0,0,0,0,0,0,0,0,0,0,1,0,0,0,0,0,0,0,0,Michaël Pereira,£3.15m ,32,180,Forward - Right Winger,left,CFR Cluj,39,6,6,2570,31,2,4,2381,27,1,1,1535,22,0,0,1066,37,1,4,2709,35,4,5,2394,31,6,2,2512,27,4,1,1771,29,1,2,1390,LaLiga,18,2,3,887,9,1,1,409
13/6/2011,Medhi Namli,85071206,34,6/23/1987,23,0,0,0,0,2200,4950,4450,115,99,297818,187,56,AM RL,2,1,2,3,2,1,1,4,2,2,1,10,10,13,8,11,13,11,9,8,3,9,12,3,13,7,9,8,12,12,11,11,10,12,5,11,4,8,12,15,14,14,13,20,11,12,6,10,7,10,7,14,8,10,12,10,5,7,8,11,18,2,1,1,15,20,15,20,1,AM RL,505,1,1,10,1,20,15,1,1,1,1,1,15,15,1,1,1,1,0,0,0,0,0,0,0,0,0,0,0,0,0,0,0,0,0,0,0,0,0,0,0,0,0,0,0,0,0,0,0,0,0,0,0,0,0,0,0,0,0,0,0,0,0,0,0,,,,,,,,,,,,,,,,,,,,,,,,,,,,,,,,,,,,,,,,,,,,,,,,,,,,
13/6/2011,Max Gradel,29001331,24,11/30/1987,23,1,0,0,0,3000,6000,6000,138,120,3429533,181,70,M/AM/S RL,2,1,1,3,1,3,1,1,2,2,1,8,9,13,13,12,12,4,14,3,5,11,10,8,15,16,8,9,7,7,7,6,19,14,5,13,7,11,13,16,14,9,6,7,12,17,20,15,10,7,12,15,4,11,16,18,13,8,10,8,5,9,1,1,20,20,20,19,1,M/AM/S RL,425,1,1,17,1,19,20,1,1,1,1,1,17,20,1,1,7.09529E+13,0,0,0,0,0,0,0,0,0,1,0,0,0,0,0,0,0,1,0,0,0,0,0,0,0,0,0,0,0,0,0,0,0,0,0,1,0,0,0,1,0,0,0,0,0,0,1,0,Max Gradel,£2.70m ,32,175,Forward - Left Winger,right,Sivasspor,44,18,7,3520,35,7,3,2165,26,3,2,1622,20,5,5,1087,40,17,5,2999,15,1,5,989,13,1,0,333,35,11,4,2897,39,13,10,3481,Ligue 1,22,4,2,1701,5,2,0,421
13/6/2011,Marvin Emnes,860744,784,5/27/1988,23,0,0,3,0,3750,6300,5800,140,118,3163932,180,66,AM/S RLC,3,3,3,1,3,1,1,2,2,3,1,9,11,12,10,10,8,5,10,7,3,10,6,7,12,6,12,12,12,11,7,9,15,9,6,15,7,10,14,15,14,8,10,12,15,14,20,14,8,12,6,6,10,10,9,13,12,10,14,14,13,8,1,1,1,19,19,18,18,AM/S RLC,626,1,1,20,18,18,19,1,1,1,1,1,1,1,1,1,0,0,0,0,0,0,0,0,0,0,0,0,0,0,0,0,0,0,0,0,0,0,0,0,0,0,0,0,0,0,0,0,0,0,0,0,0,0,0,0,0,0,0,0,0,0,0,0,0,,,,,,,,,,,,,,,,,,,,,,,,,,,,,,,,,,,,,,,,,,,,,,,,,,,,
13/6/2011,Martinho,19032956,1651,4/15/1988,23,0,0,0,0,2000,5550,5750,133,115,971580,181,73,M/AM LC,2,1,2,2,1,2,1,1,3,3,2,11,11,15,10,13,10,8,10,11,8,14,10,7,13,8,11,8,8,10,12,8,14,11,8,11,13,9,11,15,14,11,13,20,10,14,8,14,11,12,6,10,12,12,8,15,8,10,7,9,10,7,10,13,20,18,1,20,16,M/AM LC,414,1,1,1,14,18,1,1,10,1,1,16,20,1,13,1,0,0,0,0,0,0,0,0,0,0,0,0,0,0,0,0,0,0,0,0,0,0,0,0,0,0,0,0,0,0,0,0,0,0,0,0,0,0,0,0,0,0,0,0,0,0,0,0,0,Marinho,£1.17m ,37,166,Forward - Right Winger,left,Retired,30,2,1,1883,34,7,2,2162,41,4,5,2818,32,1,2,1461,17,4,1,990,21,3,0,899,44,4,5,3411,33,6,3,2079,23,1,2,629,Liga NOS,nan,nan,nan,nan,nan,nan,nan,nan
13/6/2011,Martin Olsson,8117260,797,5/17/1988,23,3,2,18,0,4000,6500,7250,165,138,13428261,171,81,D/WB/M/AM L,1,2,1,3,2,1,1,3,2,1,3,8,10,11,13,10,5,8,12,7,12,11,5,13,15,10,13,12,12,12,12,10,14,14,6,14,12,18,18,17,14,10,6,20,20,17,6,17,12,12,8,15,4,14,15,17,12,14,15,4,14,14,18,20,18,18,1,20,1,D/WB/M/AM L,243,1,1,1,1,18,1,1,18,1,1,1,18,1,20,1,34502344961,1,0,0,0,0,0,0,0,1,0,0,0,0,0,0,0,0,0,0,0,0,0,0,1,0,0,0,1,0,0,0,0,0,0,0,1,0,0,0,0,0,0,0,0,0,0,0,0,Martin Olsson,£4.05m ,32,178,Defender - Left-Back,left,Helsingborgs IF,32,2,1,2559,31,0,5,2554,33,0,2,2831,37,1,1,3265,45,1,6,4002,28,1,2,2119,35,3,0,2716,43,0,1,3676,17,0,1,1104,Premier League,21,0,5,1746,nan,nan,nan,nan
13/6/2011,Markel Susaeta,1509699,796,12/14/1987,23,0,0,3,0,4500,6700,6700,146,139,6307867,179,68,AM RLC,3,3,1,1,3,2,2,3,2,2,2,12,13,15,12,12,14,9,13,6,5,13,11,4,15,13,13,12,12,12,14,14,14,16,12,14,9,11,11,16,14,12,9,11,11,13,20,14,12,8,5,13,9,13,12,17,16,14,13,13,8,15,1,1,14,20,20,17,16,AM RLC,506,1,1,12,16,17,20,1,1,1,1,5,14,14,1,1,7.03687E+13,0,0,1,0,0,0,0,0,0,0,0,0,0,0,0,0,0,0,0,0,0,0,0,0,0,0,0,0,0,0,0,0,0,0,0,0,0,0,0,0,0,0,0,0,0,0,1,0,Markel Susaeta,£5.85m ,32,179,Forward - Right Winger,right,Without Club,31,1,4,1658,63,13,15,4913,46,11,9,3812,43,7,12,3300,48,3,9,2840,47,5,11,3409,36,1,3,1473,48,3,7,3133,32,1,4,1797,LaLiga,10,2,1,692,nan,nan,nan,nan
13/6/2011,Marek Hamsik,7564092,794,7/27/1987,23,46,8,0,0,7250,8000,8000,178,162,31430357,183,73,M/AM LC,3,3,1,2,3,2,2,4,1,3,2,13,13,14,16,13,12,15,13,9,8,16,16,8,17,11,14,12,18,13,17,16,13,15,16,18,13,15,10,15,15,13,12,11,15,14,20,15,12,10,6,16,5,14,17,16,18,10,13,8,8,8,1,1,20,18,10,17,20,M/AM LC,414,1,1,1,18,17,10,1,1,1,14,20,11,10,1,1,5.4989E+11,0,0,0,0,1,1,0,0,0,0,0,0,0,0,0,0,0,0,0,0,0,0,0,0,0,0,0,1,0,0,0,0,0,0,0,0,0,0,0,1,0,0,0,0,0,0,0,0,Marek Hamsik,£22.50m ,33,183,Midfielder - Central Midfield,both,Dalian Professional,49,13,9,3868,50,12,9,3826,44,11,20,3501,41,7,9,2792,54,13,16,3517,46,8,7,3707,49,15,9,3914,49,7,3,3162,50,4,4,4047,Serie A,14,2,1,1253,nan,nan,nan,nan
13/6/2011,Marcelo,8832853,1651,5/12/1988,23,6,1,0,0,7500,8150,8150,177,162,-1,174,75,D/WB/M L,3,2,2,1,3,2,3,10,1,3,2,12,16,16,12,17,11,8,13,12,9,16,12,14,17,17,12,14,11,10,16,13,13,17,10,17,11,14,13,18,17,12,8,20,15,16,13,15,10,14,16,14,5,12,11,16,12,15,8,7,9,9,19,20,16,13,1,20,1,D/WB/M L,233,1,1,1,1,13,1,1,19,1,1,1,16,1,20,1,1.37439E+11,1,0,0,0,0,1,0,0,0,0,0,0,0,0,0,0,0,0,0,0,0,0,0,0,0,0,0,0,0,0,0,0,0,0,0,0,0,1,0,0,0,0,0,0,0,0,0,0,Marcelo,£22.50m ,32,174,Defender - Left-Back,left,Real Madrid,50,5,10,4239,44,3,10,3540,19,1,1,1386,39,2,8,2998,53,4,10,4168,41,2,4,3383,47,3,13,3878,44,5,11,3671,34,3,6,2858,LaLiga,23,2,7,1884,3,0,1,270
13/6/2011,Marcelo Estigarribia,79000598,1655,9/21/1987,23,17,1,9,0,4700,6250,5900,148,131,3999999,181,70,M/AM L,3,3,2,3,2,3,3,4,2,3,2,13,15,12,8,13,14,8,12,10,6,12,12,6,13,13,12,11,10,10,11,10,13,13,7,12,6,10,14,17,13,13,9,20,14,16,8,15,11,10,13,16,7,12,6,13,13,13,14,11,10,7,5,5,18,20,1,20,14,M/AM L,523,1,1,1,10,20,1,1,5,1,10,14,18,1,5,1,2.2518E+15,0,0,0,0,0,0,0,0,0,0,0,0,0,0,0,0,0,0,0,0,0,0,0,0,0,0,0,1,0,0,0,0,0,0,0,0,0,0,0,0,0,0,0,0,0,0,0,0,Marcelo Estigarribia,£2.25m ,33,181,Midfielder - Left Midfield,left,Club Deportivo Maldonado,31,0,2,2363,18,1,1,1072,35,2,3,2549,29,1,3,1747,10,1,0,707,20,0,1,908,9,1,0,486,28,3,0,1802,36,2,1,2788,Serie A,32,0,1,2541,nan,nan,nan,nan
13/6/2011,Luís Carlos,19019169,1651,6/15/1987,23,0,0,0,0,1250,5300,5300,120,105,712754,169,63,AM/S L,2,3,3,2,3,2,2,4,3,3,3,11,11,13,11,11,8,7,10,7,6,8,10,8,12,10,12,10,11,11,9,9,12,13,7,15,7,10,12,14,14,9,6,20,12,14,7,12,9,10,8,10,7,12,12,12,14,10,12,12,12,7,1,1,9,20,14,20,10,AM/S L,513,1,1,17,10,20,14,1,1,1,1,1,9,1,1,1,0,0,0,0,0,0,0,0,0,0,0,0,0,0,0,0,0,0,0,0,0,0,0,0,0,0,0,0,0,0,0,0,0,0,0,0,0,0,0,0,0,0,0,0,0,0,0,0,0,Luís Carlos,£900Th. ,33,170,Forward - Left Winger,right,Doxa Katokopias,38,12,0,2604,28,4,3,1816,33,6,3,2415,35,5,4,2484,37,8,6,2959,22,0,2,776,17,3,3,935,30,7,3,2225,27,8,0,2169,Liga NOS,19,2,0,1232,4,0,0,199
13/6/2011,Luigi Vitale,43000414,776,10/5/1987,23,0,0,0,0,3000,6100,6100,140,122,601806,180,71,WB/M L,1,1,2,2,2,2,2,8,3,1,1,12,13,12,10,13,9,10,12,14,7,14,7,9,11,11,12,13,12,10,10,14,12,8,10,12,11,11,14,13,14,12,12,20,14,14,7,14,12,14,6,12,10,10,11,17,15,11,16,8,7,19,1,20,19,1,1,20,1,WB/M L,213,1,1,1,1,1,1,1,1,1,1,1,19,1,20,1,0,0,0,0,0,0,0,0,0,0,0,0,0,0,0,0,0,0,0,0,0,0,0,0,0,0,0,0,0,0,0,0,0,0,0,0,0,0,0,0,0,0,0,0,0,0,0,0,0,Luigi Vitale,£720Th. ,33,180,Defender - Left-Back,left,Hellas Verona,10,1,0,554,1,0,0,90,41,10,7,3227,20,4,3,1674,38,0,1,2999,32,1,8,2606,40,2,9,3570,35,2,7,2959,32,2,4,2854,Serie A,11,0,1,562,nan,nan,nan,nan
13/6/2011,Louis Ngwat-Mahop,35007949,11,9/16/1987,23,0,0,0,0,2750,5000,5500,120,110,696281,183,84,AM/S RL,1,1,1,3,3,1,2,5,1,2,1,9,9,11,13,11,6,13,15,5,6,11,6,8,12,6,9,11,8,10,11,10,8,8,5,13,5,11,12,13,11,12,13,8,14,14,20,13,12,9,5,5,10,12,9,14,8,9,8,8,9,12,1,1,1,18,18,17,10,AM/S RL,625,1,1,20,10,17,18,1,1,1,1,1,1,1,1,1,0,0,0,0,0,0,0,0,0,0,0,0,0,0,0,0,0,0,0,0,0,0,0,0,0,0,0,0,0,0,0,0,0,0,0,0,0,0,0,0,0,0,0,0,0,0,0,0,0,,,,,,,,,,,,,,,,,,,,,,,,,,,,,,,,,,,,,,,,,,,,,,,,,,,,
13/6/2011,Lionel Messi,7458500,1649,6/24/1987,23,50,13,7,6,9750,9750,9750,199,195,165166248,170,67,AM/S RLC,2,2,3,2,1,3,1,9,1,3,1,11,14,20,19,17,14,9,16,5,6,17,18,7,20,7,17,13,16,16,17,17,19,20,12,16,6,11,12,18,20,16,5,20,15,16,12,15,8,17,6,18,11,15,17,19,16,19,16,15,14,6,1,1,15,20,19,17,20,AM/S RLC,516,1,1,20,20,17,19,1,1,1,1,9,15,15,1,1,2.32217E+15,0,0,0,1,0,0,0,1,0,0,1,0,1,0,0,0,0,0,0,1,1,0,0,0,0,0,0,0,0,0,0,0,0,0,0,0,0,0,0,0,0,0,0,0,0,0,1,0,Lionel Messi,£90.00m ,33,170,Forward - Right Winger,left,FC Barcelona,55,53,24,4579,60,73,33,5221,50,60,16,4070,46,41,14,3742,57,58,30,5060,49,41,24,4229,52,54,18,4452,54,45,18,4468,50,51,20,4023,LaLiga,44,31,27,3810,6,2,3,540
13/6/2011,Karim El-Hany,85087983,769,1/12/1988,23,0,0,0,0,2250,4679,3450,125,104,2442195,170,60,M/AM LC,1,3,3,1,3,1,2,2,1,1,1,8,9,13,8,13,8,7,11,6,3,11,8,3,13,8,10,11,12,9,12,10,17,14,6,12,7,11,13,16,14,10,5,20,13,15,5,11,6,12,8,13,8,8,13,13,12,13,14,14,14,6,1,1,18,20,1,20,16,M/AM LC,524,1,1,1,16,20,1,1,1,1,1,16,18,1,1,1,2.2518E+15,0,0,0,0,0,0,0,0,0,0,0,0,0,0,0,0,0,0,0,0,0,0,0,0,0,0,0,0,0,0,0,0,0,0,0,0,0,0,0,0,0,0,0,0,0,0,0,0,Karim El Hany,£180Th. ,32,170,Midfielder - Defensive Midfield,right,Mouloudia d'Oujda,27,0,0,1249,3,1,0,76,6,0,0,445,11,1,0,554,10,1,0,448,23,0,1,1691,nan,nan,nan,nan,23,0,4,1854,29,0,7,2569,Ligue 1,28,1,3,2314,nan,nan,nan,nan
13/6/2011,Julian Schauerte,91002163,771,4/2/1988,23,0,0,0,0,2750,4600,4600,110,92,318880,177,70,M/AM LC,2,1,1,1,3,1,3,6,2,2,3,10,12,11,6,12,8,5,9,7,9,8,9,4,12,14,8,8,6,8,7,7,10,13,14,10,6,9,12,12,10,4,7,17,13,13,20,10,6,10,13,11,6,15,6,5,9,9,12,14,12,9,1,12,20,17,14,20,15,M/AM LC,414,1,1,1,1,17,1,1,1,1,1,15,20,14,12,1,0,0,0,0,0,0,0,0,0,0,0,0,0,0,0,0,0,0,0,0,0,0,0,0,0,0,0,0,0,0,0,0,0,0,0,0,0,0,0,0,0,0,0,0,0,0,0,0,0,Julian Schuster,£2.70m ,35,189,Midfielder - Defensive Midfield,right,Retired,28,3,4,2358,23,1,5,1898,36,1,6,3168,31,4,1,2322,24,1,0,1816,15,4,1,598,14,0,0,891,20,1,0,1490,nan,nan,nan,nan,Bundesliga,nan,nan,nan,nan,nan,nan,nan,nan
13/6/2011,Juan Mata,67011232,796,4/28/1988,23,11,4,25,8,7000,8000,8000,170,160,76929671,170,63,M/AM LC,3,3,2,3,1,2,2,1,2,1,2,13,14,17,16,17,11,9,12,7,5,16,12,7,17,10,13,11,14,9,16,13,15,17,6,18,7,14,11,16,18,9,6,20,13,16,11,13,7,13,10,16,7,12,12,17,9,16,13,13,12,7,1,3,16,20,9,19,20,M/AM LC,524,1,1,15,20,19,9,1,1,1,1,5,16,5,3,1,4.39805E+12,0,0,0,1,1,0,0,1,0,0,0,0,0,0,0,0,0,0,0,0,0,0,0,0,0,0,0,0,0,0,0,0,0,0,0,0,0,0,0,0,0,0,1,0,0,0,0,0,Juan Mata,£34.20m ,32,170,Midfielder - Attacking Midfield,left,Manchester United,43,9,18,3306,54,12,20,4138,64,19,35,4914,32,7,8,2347,35,10,4,2442,54,10,11,4115,42,10,6,2739,40,3,7,2677,32,6,4,1779,Premier League,37,3,7,1939,4,2,2,316
13/6/2011,Josip Ilicic,29041284,795,1/29/1988,23,10,0,5,0,4500,6550,6850,160,141,5421139,190,79,M/AM LC,1,3,1,2,3,2,1,8,2,3,3,12,13,12,14,12,12,9,17,5,6,15,12,6,16,15,14,11,14,15,14,14,15,15,12,15,12,12,15,13,14,13,15,20,12,13,11,13,13,15,7,13,7,11,14,15,14,14,16,15,15,7,1,1,18,20,10,16,20,M/AM LC,524,1,1,10,20,16,10,1,1,1,1,18,15,5,1,1,0,0,0,0,0,0,0,0,0,0,0,0,0,0,0,0,0,0,0,0,0,0,0,0,0,0,0,0,0,0,0,0,0,0,0,0,0,0,0,0,0,0,0,0,0,0,0,0,0,Josip Ilicic,£7.20m ,32,190,Forward - Second Striker,left,Atalanta BC,50,12,13,3761,36,6,6,2455,32,11,2,2498,31,6,4,1760,34,10,4,1966,37,15,5,2276,36,6,5,2099,41,15,10,2561,36,13,9,2532,Serie A,34,21,9,2233,3,0,1,175
13/6/2011,Jonathan Biabiany,43002297,769,4/28/1988,23,0,0,6,1,5000,5600,6200,145,124,1230407,175,70,AM RL,1,2,3,3,1,2,1,3,2,1,3,15,11,14,10,9,3,7,8,2,3,12,9,4,13,12,11,11,10,7,4,8,15,13,4,13,6,8,14,18,16,10,6,10,12,17,20,13,12,8,11,14,13,13,13,16,12,13,14,13,12,6,1,1,10,20,20,16,14,AM RL,505,1,1,14,14,16,20,1,1,1,1,1,10,10,1,1,2.3222E+15,0,0,0,0,0,0,0,0,0,0,0,0,0,0,0,0,0,0,0,0,1,0,0,0,0,0,0,0,0,0,0,0,0,0,0,1,0,0,0,0,0,0,0,0,0,0,1,0,Jonathan Biabiany,£7.20m ,32,177,Forward - Right Winger,right,San Fernando CD,37,2,8,1963,38,6,9,2509,34,2,7,2743,38,7,7,2903,1,0,0,73,24,1,2,1188,4,0,0,149,16,0,1,1048,19,0,0,1089,Serie A,12,0,0,638,2,0,0,180
13/6/2011,John Jairo Mosquera,8835391,1653,1/15/1988,23,0,0,8,4,3950,4859,5400,126,108,1279107,192,82,S RL,3,3,3,2,1,3,3,1,2,3,2,10,7,12,12,11,10,12,8,3,3,9,8,5,12,13,11,12,10,11,7,11,12,12,6,13,7,9,10,13,11,13,16,10,11,13,20,12,13,7,12,10,12,10,13,10,14,12,10,11,14,11,1,1,1,15,15,15,1,S RL,605,1,1,20,1,15,15,1,1,1,1,1,1,1,1,1,0,0,0,0,0,0,0,0,0,0,0,0,0,0,0,0,0,0,0,0,0,0,0,0,0,0,0,0,0,0,0,0,0,0,0,0,0,0,0,0,0,0,0,0,0,0,0,0,0,,,,,,,,,,,,,,,,,,,,,,,,,,,,,,,,,,,,,,,,,,,,,,,,,,,,
13/6/2011,Joăo Rodrigues,55023256,788,12/21/1987,23,0,0,0,0,750,4000,4000,95,80,13192,175,74,S L,2,1,2,1,2,3,2,5,1,1,1,10,12,9,10,12,8,12,4,2,1,11,4,6,11,8,9,5,12,5,6,6,10,10,2,10,5,10,11,12,12,12,6,7,14,12,20,6,2,10,9,10,10,8,14,12,10,15,14,13,13,5,1,1,1,15,13,15,10,S L,603,1,1,20,10,15,13,1,1,1,1,1,1,1,1,1,16,0,0,0,0,1,0,0,0,0,0,0,0,0,0,0,0,0,0,0,0,0,0,0,0,0,0,0,0,0,0,0,0,0,0,0,0,0,0,0,0,0,0,0,0,0,0,0,0,,,,,,,,,,,,,,,,,,,,,,,,,,,,,,,,,,,,,,,,,,,,,,,,,,,,
13/6/2011,Jirčs Kembo-Ekoko,8440894,769,1/8/1988,23,0,0,13,2,4450,5600,5600,150,125,3372512,178,78,AM RL,1,1,2,2,2,2,2,2,3,2,3,12,11,15,8,12,13,10,12,5,3,8,11,2,15,8,13,9,12,12,9,9,14,14,5,14,5,7,11,16,14,13,9,8,14,15,20,14,13,12,8,13,6,7,7,15,13,13,8,14,14,12,1,1,10,20,20,16,1,AM RL,505,1,1,14,1,16,20,1,1,1,1,1,10,10,1,1,2.28698E+15,0,0,0,0,0,0,0,0,0,0,0,0,0,0,0,0,0,0,0,0,0,0,0,0,0,0,0,0,0,0,0,0,0,0,0,0,0,0,0,0,0,0,0,0,0,1,0,0,Jirès Kembo Ekoko,£3.60m ,32,178,Forward - Left Winger,right,Without Club,26,4,4,1486,42,13,4,2448,30,9,7,2262,33,7,1,2204,28,16,7,1893,31,10,7,2438,24,2,4,1954,25,4,3,1649,2,0,0,14,Ligue 1,nan,nan,nan,nan,nan,nan,nan,nan
13/6/2011,Jim O'Brien,5209579,789,9/28/1987,23,0,0,6,0,2750,5550,4850,133,105,972192,183,74,M/AM RLC,1,1,2,1,2,3,2,1,3,2,1,12,11,13,9,11,2,9,9,4,2,11,7,7,12,10,8,9,8,9,10,9,14,11,5,12,7,12,14,17,13,10,9,11,12,12,20,10,12,11,8,14,7,15,12,10,12,13,15,14,13,3,1,1,18,20,20,17,15,M/AM RLC,526,1,1,1,15,17,20,1,1,1,1,1,17,18,1,1,2.2518E+15,0,0,0,0,0,0,0,0,0,0,0,0,0,0,0,0,0,0,0,0,1,0,0,0,0,0,0,1,0,0,0,0,0,0,0,0,0,0,0,0,0,0,0,0,0,0,0,0,,,,,,,,,,,,,,,,,,,,,,,,,,,,,,,,,,,,,,,,,,,,,,,,,,,,
13/6/2011,Jens Hegeler,92001113,771,1/21/1988,23,0,0,4,0,4700,6450,6200,146,129,3382784,193,85,DM/M/AM RLC,1,1,2,3,1,3,1,4,1,3,3,4,12,12,9,11,7,14,9,6,13,12,8,14,11,12,13,12,11,14,11,14,14,8,9,11,14,14,15,13,10,14,16,9,13,13,20,15,14,16,4,13,4,15,6,12,13,12,14,15,18,2,1,1,20,18,19,15,20,DM/M/AM RLC,436,1,1,1,14,14,18,1,1,1,18,20,15,19,1,1,0,0,0,0,0,0,0,0,0,0,0,0,0,0,0,0,0,0,0,0,0,0,0,0,0,0,0,0,0,0,0,0,0,0,0,0,0,0,0,0,0,0,0,0,0,0,0,0,0,Jens Hegeler,£1.80m ,32,193,Midfielder - Central Midfield,right,Career break,38,3,5,2745,35,1,2,2033,37,5,0,1534,26,1,3,878,27,1,1,1572,21,0,0,749,21,0,0,1162,7,1,0,478,0,0,0,0,Bundesliga,nan,nan,nan,nan,nan,nan,nan,nan
13/6/2011,Jeffren,1510572,796,1/20/1988,23,0,0,2,0,5250,6800,6800,150,138,7890221,173,71,AM RL,2,1,1,2,3,2,1,4,2,2,1,13,13,14,10,13,13,7,10,7,8,13,16,8,14,7,12,8,12,9,12,9,12,12,7,14,7,12,13,16,14,8,6,20,9,15,14,12,9,12,3,10,14,12,14,13,15,10,13,7,12,8,9,13,14,20,18,20,9,AM RL,505,1,1,10,9,20,18,1,1,9,1,1,14,14,1,13,2.35739E+15,0,0,0,0,0,0,0,0,0,0,0,0,0,0,0,0,0,0,0,0,0,0,0,0,0,0,0,0,0,0,0,0,0,0,0,1,0,0,0,0,0,0,0,0,0,1,1,0,Jeffren,£4.50m ,32,176,Midfielder - Attacking Midfield,left,Slaven Belupo Koprivnica,13,1,1,369,18,3,1,657,21,2,0,968,11,0,1,458,36,3,2,1699,18,3,2,1148,31,2,0,1636,36,6,5,2613,25,1,1,1608,Liga NOS,12,1,2,724,2,0,0,77
13/6/2011,Jan Hochscheidt,35011443,771,10/4/1987,23,0,0,0,0,4400,5750,5750,129,115,637612,179,80,DM/M/AM LC,3,1,3,1,1,3,1,1,2,1,1,14,14,11,10,11,11,7,10,8,10,12,7,10,12,12,11,12,10,12,8,13,11,9,10,11,11,14,12,12,12,13,10,16,12,10,20,14,10,13,10,8,7,14,14,11,14,10,13,8,10,4,1,1,20,18,14,20,18,DM/M/AM LC,434,1,1,1,16,18,11,1,1,1,16,18,20,14,1,1,1040,0,0,0,0,1,0,0,0,0,0,1,0,0,0,0,0,0,0,0,0,0,0,0,0,0,0,0,0,0,0,0,0,0,0,0,0,0,0,0,0,0,0,0,0,0,0,0,0,,,,,,,,,,,,,,,,,,,,,,,,,,,,,,,,,,,,,,,,,,,,,,,,,,,,
13/6/2011,Idir Ouali,18005881,5,5/21/1988,23,0,0,0,0,3850,4859,4850,135,108,615615,176,65,AM RL,2,1,1,1,3,2,3,8,2,2,2,6,7,12,7,11,8,12,10,5,2,11,10,3,12,7,11,13,11,11,10,8,10,14,6,12,7,10,14,16,13,12,9,8,13,15,20,14,7,12,7,13,7,10,11,8,11,6,8,15,6,5,1,1,15,20,20,17,12,AM RL,505,1,1,12,12,17,20,1,1,1,1,1,15,15,1,1,0,0,0,0,0,0,0,0,0,0,0,0,0,0,0,0,0,0,0,0,0,0,0,0,0,0,0,0,0,0,0,0,0,0,0,0,0,0,0,0,0,0,0,0,0,0,0,0,0,,,,,,,,,,,,,,,,,,,,,,,,,,,,,,,,,,,,,,,,,,,,,,,,,,,,
13/6/2011,Ibrahima Traoré,35015030,22,4/21/1988,23,4,0,0,0,3150,6350,6300,148,127,6018913,172,62,M/AM L,1,3,2,1,1,1,2,1,2,3,1,12,13,14,10,12,9,6,8,6,5,12,9,7,13,12,10,15,9,10,10,9,10,14,7,13,6,13,15,17,17,7,6,20,11,15,10,13,6,8,8,10,5,10,19,8,11,6,8,7,10,5,1,1,18,20,10,20,14,M/AM L,523,1,1,1,14,20,10,1,1,1,1,1,18,10,1,1,7.03689E+13,1,0,0,0,0,0,0,0,0,0,0,0,0,0,0,0,0,0,0,0,1,0,0,0,0,0,0,1,0,0,0,0,0,0,0,0,0,0,0,0,0,0,0,0,0,0,1,0,Ibrahima Traoré,£1.13m ,32,171,Forward - Right Winger,left,Borussia Mönchengladbach,17,1,5,844,14,2,1,340,49,4,12,3455,36,2,9,2304,35,5,4,1458,31,4,4,1930,22,1,4,1382,9,0,1,362,17,0,3,590,Bundesliga,7,0,1,148,3,1,0,35
13/6/2011,Hilal Soudani,12002680,5,11/25/1987,23,1,0,0,0,2000,6000,5750,140,115,1578044,178,75,AM/S L,2,3,3,2,3,1,3,1,2,3,2,7,8,13,13,12,9,13,12,6,4,9,11,5,12,15,15,14,12,10,9,13,12,12,10,14,4,7,13,14,14,13,15,20,15,14,6,13,13,12,8,12,6,6,12,15,14,9,12,11,9,6,1,1,8,16,1,16,10,AM/S L,623,1,1,20,10,16,1,1,1,1,1,1,8,1,1,1,0,0,0,0,0,0,0,0,0,0,0,0,0,0,0,0,0,0,0,0,0,0,0,0,0,0,0,0,0,0,0,0,0,0,0,0,0,0,0,0,0,0,0,0,0,0,0,0,0,,,,,,,,,,,,,,,,,,,,,,,,,,,,,,,,,,,,,,,,,,,,,,,,,,,,
13/6/2011,Giorgos Tzavellas,36004439,772,11/26/1987,23,5,0,0,0,4000,6500,6100,130,125,2847380,183,81,D/WB/M L,1,2,2,1,1,3,2,6,3,3,3,14,15,10,11,12,14,12,11,12,11,13,10,12,11,15,12,15,10,12,14,12,14,8,11,10,12,14,15,13,11,14,12,20,16,14,5,14,15,14,12,12,4,14,14,15,12,14,14,11,8,4,20,17,18,10,9,20,14,D/WB/M L,123,1,1,5,5,10,1,14,20,9,7,8,18,1,17,1,0,0,0,0,0,0,0,0,0,0,0,0,0,0,0,0,0,0,0,0,0,0,0,0,0,0,0,0,0,0,0,0,0,0,0,0,0,0,0,0,0,0,0,0,0,0,0,0,0,,,,,,,,,,,,,,,,,,,,,,,,,,,,,,,,,,,,,,,,,,,,,,,,,,,,
13/6/2011,Fonseca,55013905,788,8/23/1987,23,0,0,0,0,500,1500,1500,115,93,21715,180,74,S L,3,2,2,2,3,1,2,3,1,3,2,9,11,12,13,8,9,11,10,4,3,9,9,4,10,5,12,5,13,11,8,7,9,9,13,10,9,9,14,13,12,13,8,10,9,12,20,9,4,10,8,10,6,10,12,15,8,8,12,15,10,12,1,1,7,15,13,15,13,S L,603,1,1,20,13,15,13,1,1,1,1,1,1,7,1,1,0,0,0,0,0,0,0,0,0,0,0,0,0,0,0,0,0,0,0,0,0,0,0,0,0,0,0,0,0,0,0,0,0,0,0,0,0,0,0,0,0,0,0,0,0,0,0,0,0,,,,,,,,,,,,,,,,,,,,,,,,,,,,,,,,,,,,,,,,,,,,,,,,,,,,
13/6/2011,Felix Bastians,5006686,771,5/9/1988,23,0,0,9,0,5050,6650,6650,150,132,2693559,188,84,D LC,3,3,1,2,2,1,1,4,3,3,2,8,12,10,10,11,7,12,8,6,13,12,9,14,11,13,10,12,13,12,11,8,14,12,8,10,12,14,15,14,13,13,12,20,14,14,16,14,12,12,8,10,7,13,12,13,11,10,14,13,8,8,20,15,15,15,9,20,16,D LC,104,1,1,1,1,15,1,16,20,9,1,1,15,1,15,1,536870912,0,0,0,0,0,0,0,0,0,0,0,0,0,0,0,0,0,0,0,0,0,0,0,0,0,0,0,0,0,1,0,0,0,0,0,0,0,0,0,0,0,0,0,0,0,0,0,0,Felix Bastians,£1.58m ,32,188,Defender - Centre-Back,left,Tianjin Teda,31,0,9,2790,32,0,3,2586,14,0,0,941,13,0,0,1099,15,0,0,1350,35,2,2,3029,31,3,2,2793,49,5,1,4243,16,0,0,1352,Bundesliga,14,1,1,1147,nan,nan,nan,nan
13/6/2011,Fábio Coentrăo,8877532,788,3/11/1988,23,16,1,6,5,7500,7600,7600,172,158,-1,179,72,D/WB/M/AM L,2,2,1,1,2,1,1,3,1,2,2,14,16,15,11,16,13,10,12,12,9,16,12,14,16,15,14,16,12,14,14,13,16,15,10,15,11,13,15,14,13,12,10,20,14,16,8,15,11,16,11,13,8,16,7,17,17,12,12,10,9,11,16,19,18,20,13,20,10,D/WB/M/AM L,543,1,1,1,1,20,13,1,16,8,1,10,18,11,19,9,1,1,0,0,0,0,0,0,0,0,0,0,0,0,0,0,0,0,0,0,0,0,0,0,0,0,0,0,0,0,0,0,0,0,0,0,0,0,0,0,0,0,0,0,0,0,0,0,0,Fábio Coentrão,£21.60m ,32,179,Defender - Left-Back,left,Rio Ave FC,45,5,6,3992,33,0,5,2252,30,1,1,2448,20,0,2,1510,17,0,2,998,19,3,2,1408,6,0,1,297,44,1,4,3585,23,0,5,1970,LaLiga,nan,nan,nan,nan,1,0,0,45
13/6/2011,Fabian Johnson,8726381,390,12/11/1987,23,0,0,0,0,3800,5950,5950,137,119,2761578,183,70,D/M RL,1,3,3,2,3,2,2,1,1,3,1,9,11,12,6,12,10,6,9,13,9,10,7,10,13,7,8,7,8,11,9,9,9,10,5,14,9,14,16,17,16,10,10,20,13,15,15,14,8,10,7,10,12,18,10,11,17,10,9,12,19,8,20,14,17,10,18,20,1,D/M RL,115,1,1,1,1,8,10,1,20,18,1,1,15,17,14,9,11,1,1,0,1,0,0,0,0,0,0,0,0,0,0,0,0,0,0,0,0,0,0,0,0,0,0,0,0,0,0,0,0,0,0,0,0,0,0,0,0,0,0,0,0,0,0,0,0,Fabian Johnson,£3.15m ,32,183,Forward - Left Winger,right,Without Club,7,0,0,256,33,3,8,2554,33,3,3,2856,28,0,5,2187,34,1,8,1911,34,8,6,2809,35,4,4,2038,12,1,0,479,18,1,1,1008,Bundesliga,7,0,0,298,nan,nan,nan,nan
13/6/2011,Eugen Schiffmann,35025420,771,1/5/1988,23,0,0,0,0,100,2500,2500,101,55,1490,176,0,M L,2,2,1,1,3,2,3,1,3,1,2,9,11,12,6,9,7,1,7,1,6,10,9,8,10,14,9,3,9,8,3,9,8,4,5,10,3,9,11,13,9,9,6,20,9,11,7,6,3,10,6,5,4,10,3,18,12,14,8,19,13,14,8,12,20,12,8,20,5,M L,403,1,1,1,5,12,7,1,8,1,5,5,20,8,12,1,0,0,0,0,0,0,0,0,0,0,0,0,0,0,0,0,0,0,0,0,0,0,0,0,0,0,0,0,0,0,0,0,0,0,0,0,0,0,0,0,0,0,0,0,0,0,0,0,0,,,,,,,,,,,,,,,,,,,,,,,,,,,,,,,,,,,,,,,,,,,,,,,,,,,,
13/6/2011,Esteban Granero,7458313,796,7/2/1987,23,0,0,8,2,5750,7350,7350,159,147,-1,180,75,M/AM RLC,2,3,3,1,2,3,3,1,2,3,3,16,15,15,12,17,13,10,14,7,6,16,13,8,16,10,12,13,15,11,17,13,15,16,10,13,10,12,13,13,15,10,9,13,12,13,20,13,10,12,12,13,7,13,13,14,14,16,13,16,15,7,1,1,18,20,15,16,20,M/AM RLC,526,1,1,1,20,16,15,1,1,1,8,18,13,12,1,1,1.75922E+13,0,0,1,0,1,0,0,1,0,0,0,0,0,0,0,0,0,0,0,0,0,0,0,0,0,0,0,0,0,0,0,0,0,0,0,0,0,0,0,0,0,0,0,0,1,0,0,0,Esteban Granero,£6.30m ,33,180,Midfielder - Central Midfield,right,Marbella FC,32,2,4,1271,28,0,2,1000,27,1,1,1886,8,0,1,367,39,1,2,2791,15,0,0,872,22,0,1,736,31,2,3,1752,30,3,1,2137,LaLiga,27,1,3,1651,2,0,0,178
13/6/2011,Elliot Grandin,8430997,769,10/17/1987,23,0,0,3,1,4650,5950,6450,149,127,8041360,178,67,M/AM RLC,1,3,3,2,3,2,3,3,1,2,3,12,14,13,11,14,10,7,11,5,6,15,12,8,14,5,12,9,12,12,14,14,12,14,5,14,11,11,13,15,14,14,9,5,14,15,20,12,9,15,5,14,7,17,12,16,11,8,6,10,10,12,1,1,20,20,20,15,20,M/AM RLC,416,1,1,1,15,15,20,1,1,1,1,20,1,10,1,1,34376515584,0,0,0,0,0,0,0,0,0,0,0,0,0,0,0,0,0,0,0,0,0,0,0,0,1,0,0,0,0,0,0,0,0,0,0,1,0,0,0,0,0,0,0,0,0,0,0,0,Elliot Grandin,£1.35m ,33,178,Forward - Right Winger,right,Without Club,27,1,4,1825,20,2,2,1091,13,3,2,616,8,1,0,357,5,1,0,113,0,0,0,0,13,3,2,728,1,0,0,90,nan,nan,nan,nan,Ligue 1,6,0,0,375,nan,nan,nan,nan
13/6/2011,Diego,38003456,1651,3/9/1988,23,0,0,0,0,500,2750,2750,115,100,94654,175,72,M/AM L,2,3,2,1,2,2,3,1,1,1,2,11,13,14,9,14,12,3,8,5,3,8,11,4,17,14,10,7,8,11,7,12,14,20,8,14,7,4,11,15,13,6,10,20,8,14,5,14,6,15,5,15,15,7,15,12,11,6,10,15,16,8,1,1,18,20,10,20,1,M/AM L,523,1,1,14,1,20,10,1,1,1,1,1,18,10,1,1,0,0,0,0,0,0,0,0,0,0,0,0,0,0,0,0,0,0,0,0,0,0,0,0,0,0,0,0,0,0,0,0,0,0,0,0,0,0,0,0,0,0,0,0,0,0,0,0,0,Diego,£9.00m ,35,173,Midfielder - Attacking Midfield,right,Clube de Regatas do Flamengo,35,6,12,2991,43,6,14,3197,37,13,8,3330,37,7,4,2324,30,5,7,1912,63,9,7,4205,38,13,5,3092,33,6,7,2656,25,2,2,1371,LaLiga,25,1,2,918,nan,nan,nan,nan
13/6/2011,Diego Capel,7458330,796,2/16/1988,23,2,0,23,5,5900,6850,7000,155,140,30000001,173,67,AM L,1,3,2,1,2,3,2,4,1,2,1,13,14,14,10,14,9,5,10,6,6,13,12,5,14,13,13,11,10,13,10,8,15,13,8,17,8,8,12,16,15,11,6,20,12,16,7,15,10,10,12,12,8,12,8,12,13,14,11,6,7,8,1,8,13,20,12,20,7,AM L,503,1,1,7,7,20,12,1,1,1,1,1,13,5,8,1,1.09965E+12,0,0,0,0,0,0,0,0,0,0,0,0,0,0,0,0,1,0,0,0,0,0,0,0,0,0,0,1,0,0,0,0,0,0,0,0,0,0,0,0,1,0,0,0,0,0,0,0,Diego Capel,£7.47m ,32,173,Forward - Left Winger,left,Without Club,38,1,3,2231,49,7,11,3699,36,5,9,2702,31,3,7,1820,27,1,3,702,21,0,0,705,25,2,4,1016,nan,nan,nan,nan,15,0,0,417,Liga NOS,3,1,0,40,nan,nan,nan,nan
13/6/2011,Diego Buonanotte,962978,1649,4/19/1988,23,0,0,14,1,4950,6500,6500,160,135,8876500,161,60,AM RLC,1,1,2,1,3,2,2,1,3,2,1,13,13,16,13,14,14,1,13,1,7,13,15,7,16,10,11,13,13,11,14,11,17,17,4,14,7,13,13,16,16,5,5,20,13,16,5,12,5,9,12,15,12,11,11,15,15,11,15,11,6,16,1,1,9,20,16,17,20,AM RLC,506,1,1,15,20,17,16,1,1,1,1,9,1,1,1,1,2.2518E+15,0,0,0,0,0,0,0,0,0,0,0,0,0,0,0,0,0,1,0,0,0,0,0,0,0,0,0,0,0,0,0,0,0,0,0,0,0,0,0,0,0,0,0,0,0,0,0,0,Diego Buonanotte,£2.25m ,32,161,Midfielder - Attacking Midfield,left,CD Universidad Católica,26,2,2,1216,14,1,0,454,32,5,7,1463,25,0,1,1092,26,2,2,1478,37,11,1,1898,43,16,11,3488,26,7,2,2284,25,2,0,1094,LaLiga,8,0,2,304,nan,nan,nan,nan
13/6/2011,Daniel Heinze,35014610,771,10/17/1987,23,0,0,0,0,700,3900,3900,95,78,24501,178,70,AM/S RL,1,2,1,3,3,2,1,1,2,3,1,6,9,11,13,9,4,5,15,6,5,10,5,5,11,15,10,12,7,9,8,11,9,11,9,10,5,11,11,12,10,9,10,9,11,10,20,9,7,9,7,16,3,12,6,11,10,14,13,13,12,5,1,1,14,20,20,16,14,AM/S RL,515,1,1,18,14,16,20,1,1,1,1,11,13,14,1,1,256,0,0,0,0,0,0,0,0,1,0,0,0,0,0,0,0,0,0,0,0,0,0,0,0,0,0,0,0,0,0,0,0,0,0,0,0,0,0,0,0,0,0,0,0,0,0,0,0,Gabriel Heinze,£1.35m ,42,179,Defender - Centre-Back,left,Retired,41,4,1,3644,32,0,0,2652,36,1,0,3047,31,2,1,2669,nan,nan,nan,nan,nan,nan,nan,nan,nan,nan,nan,nan,nan,nan,nan,nan,nan,nan,nan,nan,Serie A,nan,nan,nan,nan,nan,nan,nan,nan
13/6/2011,Daniel Halfar,35000060,771,1/7/1988,23,0,0,3,2,4900,6300,6350,139,126,2130784,173,64,M/AM RL,2,1,3,1,1,3,1,3,1,2,1,15,13,14,8,13,16,6,11,4,8,12,14,7,13,11,11,13,11,11,12,13,16,12,7,14,8,12,13,14,15,13,6,20,12,14,10,12,10,9,7,7,6,15,9,15,12,11,14,14,16,4,1,1,18,20,16,20,12,M/AM RL,525,1,1,8,12,20,16,1,1,1,1,1,18,15,1,1,7.0373E+13,0,0,0,0,0,0,0,0,0,0,0,0,0,0,0,0,0,0,0,0,0,0,0,0,0,0,0,0,0,0,0,0,1,0,0,0,0,0,0,0,0,0,0,0,0,0,1,0,Daniel Haas,£450Th. ,37,187,Goalkeeper,right,Retired,10,13,2,900,2,1,1,210,35,48,8,3180,36,50,11,3240,29,44,5,2565,21,33,5,1890,8,19,1,720,0,0,0,0,2,6,0,180,Bundesliga,0,0,0,0,nan,nan,nan,nan
13/6/2011,Clemens Walch,16003074,755,7/10/1987,23,0,0,0,0,2500,5700,5800,130,116,343729,180,74,AM RL,2,2,1,1,1,2,2,6,3,3,1,5,12,14,7,11,5,6,6,6,5,12,6,6,12,7,12,12,8,11,10,11,10,11,7,13,10,14,13,16,13,11,9,20,13,16,5,12,11,11,8,10,8,11,12,12,8,7,15,14,13,9,1,1,9,20,20,17,13,AM RL,505,1,1,10,13,17,20,1,1,1,1,1,1,9,1,1,0,0,0,0,0,0,0,0,0,0,0,0,0,0,0,0,0,0,0,0,0,0,0,0,0,0,0,0,0,0,0,0,0,0,0,0,0,0,0,0,0,0,0,0,0,0,0,0,0,Clemens Walch,£540Th. ,33,181,Midfielder - Right Midfield,both,SPG Silz/Mötz,22,0,1,1189,10,0,0,315,32,5,4,2104,29,6,6,2002,30,5,1,1943,22,2,3,1207,26,6,6,1594,23,3,2,1050,11,4,2,641,Bundesliga,17,2,1,781,nan,nan,nan,nan
13/6/2011,Chris Malonga,8442730,49,7/11/1987,23,5,1,0,0,4850,5400,5400,138,120,2502629,183,75,M/AM LC,2,2,2,2,3,2,1,1,3,3,2,10,13,13,8,13,10,11,13,8,5,12,10,5,15,8,11,9,11,9,12,10,14,15,6,13,7,11,12,15,14,13,10,20,8,14,8,11,12,10,8,14,15,8,9,14,13,11,13,15,15,6,8,8,17,20,1,20,15,M/AM LC,524,1,1,12,15,20,1,1,8,1,1,10,17,1,8,1,257,1,0,0,0,0,0,0,0,1,0,0,0,0,0,0,0,0,0,0,0,0,0,0,0,0,0,0,0,0,0,0,0,0,0,0,0,0,0,0,0,0,0,0,0,0,0,0,0,Chris Mavinga,£1.13m ,29,183,Defender - Centre-Back,left,Toronto FC,13,0,0,991,22,0,0,1654,31,0,1,2684,15,0,2,1190,11,0,1,848,23,0,1,1834,34,0,2,2699,19,0,0,1307,33,0,1,2753,Ligue 1,18,0,0,1425,nan,nan,nan,nan
13/6/2011,Bruno Gallo,19045496,1651,5/7/1988,23,0,0,0,0,1500,5350,5350,125,107,662088,182,75,D/WB/M LC,3,3,2,3,1,3,3,1,2,3,3,11,12,12,10,12,11,9,11,10,10,11,12,12,12,11,12,11,12,11,12,13,13,11,10,12,11,11,12,12,12,12,11,20,13,12,6,12,12,10,8,10,8,12,12,13,6,13,14,14,14,6,17,17,20,7,1,20,15,D/WB/M LC,434,1,1,1,1,7,1,1,17,1,1,15,20,1,17,1,0,0,0,0,0,0,0,0,0,0,0,0,0,0,0,0,0,0,0,0,0,0,0,0,0,0,0,0,0,0,0,0,0,0,0,0,0,0,0,0,0,0,0,0,0,0,0,0,0,Bruno Gallo,£720Th. ,32,182,Midfielder - Central Midfield,left,Without Club,13,0,2,844,20,0,1,1373,19,0,0,715,nan,nan,nan,nan,47,8,2,3524,6,0,0,272,1,0,0,19,20,4,0,1799,46,4,2,3763,Liga NOS,nan,nan,nan,nan,nan,nan,nan,nan
13/6/2011,Billy Clarke,5121496,789,12/13/1987,23,0,0,7,0,2550,5084,5250,131,113,1107643,171,65,AM/S RL,1,2,1,2,1,3,2,3,2,1,3,7,12,15,12,11,2,7,13,3,3,12,8,3,10,4,11,9,11,11,13,13,13,8,5,13,12,9,13,16,14,10,6,20,9,12,6,10,7,5,5,10,6,4,13,16,12,6,13,11,13,4,1,1,9,20,20,20,10,AM/S RL,515,1,1,20,10,20,20,1,1,1,1,1,9,1,1,1,7.09185E+13,0,0,0,1,0,0,0,0,0,0,0,0,0,0,0,0,0,0,0,0,0,0,0,0,0,0,0,0,0,0,0,0,0,0,0,0,0,0,0,1,0,0,0,0,0,0,1,0,,,,,,,,,,,,,,,,,,,,,,,,,,,,,,,,,,,,,,,,,,,,,,,,,,,,
13/6/2011,Aykut Öztürk,91004237,799,11/7/1987,23,0,0,0,0,2500,4750,4500,110,95,103299,182,82,M/AM/S RL,2,3,3,2,1,2,2,2,1,3,1,8,11,13,7,11,8,7,8,5,6,10,9,7,13,12,10,14,12,9,11,9,10,13,7,13,6,10,11,11,14,11,10,5,10,13,20,8,10,9,9,10,6,18,7,16,5,11,13,11,12,10,1,1,20,18,20,15,1,M/AM/S RL,425,1,1,17,1,15,18,1,1,1,1,1,15,20,1,1,0,0,0,0,0,0,0,0,0,0,0,0,0,0,0,0,0,0,0,0,0,0,0,0,0,0,0,0,0,0,0,0,0,0,0,0,0,0,0,0,0,0,0,0,0,0,0,0,0,,,,,,,,,,,,,,,,,,,,,,,,,,,,,,,,,,,,,,,,,,,,,,,,,,,,
13/6/2011,Arne Feick,35008234,771,4/1/1988,23,0,0,0,0,4300,5500,5650,128,110,3540049,177,74,D/AM L,1,2,1,2,3,2,1,5,1,3,2,7,11,12,8,13,8,12,12,7,11,12,7,10,12,12,10,13,11,11,11,12,10,9,11,12,11,13,14,14,13,11,10,20,11,13,7,12,10,10,6,7,11,16,8,12,8,8,9,9,9,7,20,13,15,20,9,20,1,D/AM L,113,1,1,13,1,20,1,1,20,9,1,1,15,1,13,1,0,0,0,0,0,0,0,0,0,0,0,0,0,0,0,0,0,0,0,0,0,0,0,0,0,0,0,0,0,0,0,0,0,0,0,0,0,0,0,0,0,0,0,0,0,0,0,0,0,,,,,,,,,,,,,,,,,,,,,,,,,,,,,,,,,,,,,,,,,,,,,,,,,,,,
13/6/2011,Armiche,67058211,796,6/12/1988,23,0,0,0,0,3150,4950,4950,123,103,3351886,176,70,M/AM RL,2,2,3,3,2,3,2,1,1,1,1,6,10,15,7,12,6,4,10,4,2,12,7,4,15,5,12,7,7,7,11,7,14,14,6,12,4,10,10,16,14,8,7,5,13,16,20,9,6,10,7,10,8,12,8,15,10,10,13,12,12,10,1,1,19,20,20,15,5,M/AM RL,525,1,1,5,5,15,20,1,1,1,1,1,14,19,1,1,1.09991E+12,0,1,0,0,0,0,0,0,0,0,0,0,0,0,0,0,0,0,0,0,0,0,0,0,0,0,0,1,1,0,0,0,0,0,0,0,0,0,0,0,1,0,0,0,0,0,0,0,,,,,,,,,,,,,,,,,,,,,,,,,,,,,,,,,,,,,,,,,,,,,,,,,,,,
13/6/2011,Anthony Mounier,8440218,769,9/27/1987,23,0,0,4,0,4800,6050,6050,150,135,4516389,174,65,M/AM L,3,3,2,3,2,3,1,2,3,2,2,13,14,14,7,13,10,11,11,8,3,13,9,4,15,8,12,12,11,12,14,11,15,14,8,13,8,13,13,18,13,12,7,20,15,15,5,15,7,15,8,14,6,7,5,14,16,14,14,14,14,6,1,1,17,20,1,20,10,M/AM L,523,1,1,10,10,20,1,1,1,1,1,10,17,1,1,1,1.09951E+12,1,0,0,0,0,0,0,0,0,0,0,0,0,0,0,0,0,0,0,0,0,0,0,0,0,0,0,0,0,0,0,0,0,0,0,0,0,0,0,0,1,0,0,0,0,0,0,0,Anthony Mounier,£5.40m ,33,174,Forward - Left Winger,left,Apollon Smyrnis,39,4,11,3334,35,11,3,2852,36,2,7,2097,34,3,5,2026,38,9,8,3226,33,4,2,2205,13,2,0,540,23,5,1,1179,12,0,0,464,Ligue 1,14,4,1,897,2,0,0,41
13/6/2011,Angel Di María,14000219,1649,2/14/1988,23,14,2,13,3,7500,8250,8000,171,159,-1,180,70,M/AM RL,2,2,3,1,3,3,2,10,1,1,2,15,16,17,12,15,15,11,15,8,5,14,15,7,17,9,13,12,14,10,15,12,13,18,8,15,7,13,12,15,16,10,11,20,14,17,9,13,11,12,7,11,8,12,14,14,15,16,14,8,13,9,1,9,18,20,17,20,10,M/AM RL,525,1,1,8,10,20,17,1,1,1,1,1,18,13,9,1,4.96498E+12,1,0,0,0,0,0,0,0,0,0,0,0,0,0,0,0,0,0,0,0,0,0,0,0,0,0,0,0,0,0,0,0,0,0,1,0,0,0,0,1,0,0,1,0,0,0,0,0,Ángel Di María,£27.00m ,32,180,Forward - Right Winger,left,Paris Saint-Germain,53,9,26,3569,32,7,17,1910,52,9,17,3190,52,11,25,3758,33,4,12,2017,47,15,25,3402,43,14,15,3091,45,21,12,3119,45,19,17,3498,LaLiga,41,12,23,3250,5,1,2,423
13/6/2011,Andrea Catellani,43001305,776,5/26/1988,23,0,0,0,0,1750,5000,5000,140,100,2605139,180,77,AM/S L,1,1,1,1,1,1,1,1,1,1,1,3,8,13,13,10,4,8,6,2,2,9,9,4,11,8,7,8,7,11,5,8,6,12,7,11,9,8,10,14,13,7,7,10,14,14,20,12,8,10,5,10,7,10,10,14,11,12,13,10,15,14,1,1,9,20,1,20,14,AM/S L,513,1,1,20,14,20,1,1,1,1,1,1,9,1,1,1,0,0,0,0,0,0,0,0,0,0,0,0,0,0,0,0,0,0,0,0,0,0,0,0,0,0,0,0,0,0,0,0,0,0,0,0,0,0,0,0,0,0,0,0,0,0,0,0,0,Andrea Catellani,£810Th. ,32,179,Forward - Centre-Forward,both,Retired,35,4,3,2451,24,2,2,785,34,6,7,2073,24,1,1,1297,40,19,5,3365,43,4,6,2645,35,9,2,2348,nan,nan,nan,nan,nan,nan,nan,nan,Serie A,nan,nan,nan,nan,nan,nan,nan,nan
13/6/2011,Alexander Buch,91000570,771,5/12/1988,23,0,0,0,0,1700,3950,3950,94,79,28234,172,69,M/AM RL,1,3,3,1,3,2,1,1,1,1,1,9,12,10,8,11,7,5,12,2,7,8,8,4,9,6,11,4,10,11,9,8,7,15,6,8,6,8,9,12,12,10,4,20,12,11,12,5,2,10,4,10,12,10,10,8,16,8,8,16,14,12,1,1,20,18,16,20,1,M/AM RL,415,1,1,1,1,18,12,1,1,1,1,1,20,16,1,1,0,0,0,0,0,0,0,0,0,0,0,0,0,0,0,0,0,0,0,0,0,0,0,0,0,0,0,0,0,0,0,0,0,0,0,0,0,0,0,0,0,0,0,0,0,0,0,0,0,Alexander Bugera,£450Th. ,42,180,Defender - Left-Back,left,Retired,17,0,2,1341,25,1,0,2244,13,0,0,1033,25,0,6,1991,23,1,1,1993,nan,nan,nan,nan,nan,nan,nan,nan,nan,nan,nan,nan,nan,nan,nan,nan,Bundesliga,nan,nan,nan,nan,nan,nan,nan,nan
13/6/2011,Alessio Cerci,7984079,776,7/23/1987,23,0,0,6,1,5750,7200,6700,146,136,8596273,180,78,AM RL,3,2,1,1,1,2,2,6,1,1,3,12,13,15,11,12,5,8,10,4,6,13,11,6,13,11,11,11,10,8,10,12,16,14,8,13,5,9,8,15,14,12,8,20,12,16,13,13,12,12,10,10,7,12,8,18,18,13,15,17,13,8,1,1,13,20,20,16,5,AM RL,505,1,1,10,5,16,20,1,1,1,1,1,11,13,1,1,6.0143E+11,0,0,0,0,0,0,0,0,0,0,0,0,0,1,0,0,0,0,0,0,0,0,0,0,0,0,0,1,0,0,0,0,0,0,1,1,0,0,0,1,0,0,0,0,0,0,0,0,Alessio Cerci,£5.85m ,33,180,Forward - Right Winger,left,SS Arezzo,27,8,4,1689,26,8,1,1690,35,8,12,2740,38,13,11,3042,27,2,7,1085,26,4,2,1384,2,0,0,43,25,3,4,1712,16,5,3,718,Serie A,10,0,1,330,2,0,0,105
13/6/2011,Alejandro Gómez,955978,1649,2/15/1988,23,0,0,20,5,4500,5000,6600,150,136,8104515,165,65,AM RL,2,2,2,1,3,1,2,5,3,2,2,14,14,18,10,14,10,3,16,5,4,13,13,3,16,12,11,14,10,10,11,7,15,16,8,16,4,10,12,16,17,13,4,8,10,15,20,14,11,11,4,11,8,15,13,12,15,16,12,13,15,14,1,1,10,20,19,20,14,AM RL,505,1,1,14,14,20,19,1,1,1,1,1,10,10,1,1,7.03687E+13,0,0,0,0,0,0,0,0,0,0,0,0,0,0,0,0,0,0,0,0,0,0,0,0,0,0,0,0,0,0,0,0,0,0,0,0,0,0,0,0,0,0,0,0,0,0,1,0,Alejandro Gálvez,£180Th. ,31,190,Defender - Centre-Back,right,Qatar SC,34,3,0,2947,31,3,0,2664,30,0,0,2422,30,2,1,2575,22,1,1,1726,24,1,0,1481,25,0,0,1823,25,1,0,2224,18,1,0,1426,LaLiga,20,0,0,1800,3,0,0,204
13/6/2011,Ahmet Kulabas,35021017,799,10/8/1987,23,0,0,0,0,1000,3700,4000,100,80,133104,177,81,AM/S RL,1,1,1,3,2,3,2,7,1,1,1,9,12,12,10,12,8,11,9,6,5,3,8,8,9,6,9,9,12,12,10,9,11,12,12,10,5,11,13,12,12,12,7,5,10,12,20,9,2,10,10,4,9,10,13,18,8,13,14,11,7,5,1,1,12,20,18,20,1,AM/S RL,515,1,1,18,1,20,18,1,1,1,1,1,12,10,1,1,0,0,0,0,0,0,0,0,0,0,0,0,0,0,0,0,0,0,0,0,0,0,0,0,0,0,0,0,0,0,0,0,0,0,0,0,0,0,0,0,0,0,0,0,0,0,0,0,0,,,,,,,,,,,,,,,,,,,,,,,,,,,,,,,,,,,,,,,,,,,,,,,,,,,,
13/6/2011,Adrián,67011224,796,5/25/1988,23,0,0,0,0,4000,5900,5900,131,124,3231257,184,75,M LC,2,3,3,3,1,3,3,4,2,3,2,13,13,13,11,14,12,9,13,10,7,13,11,7,13,7,11,12,13,11,13,11,10,13,11,11,9,10,10,14,14,9,11,20,14,14,11,14,9,11,6,11,11,11,12,13,10,11,14,12,7,11,1,1,20,15,1,17,20,M LC,404,1,1,1,12,15,1,1,1,1,7,20,17,1,1,1,1.41837E+14,0,0,0,0,0,1,0,0,0,0,0,0,0,0,0,0,0,0,0,0,0,0,0,0,0,0,0,0,0,0,0,0,0,0,0,0,0,0,0,0,1,0,0,0,0,0,0,1,Adrián, ,33,190,Goalkeeper,right,Liverpool FC,9,6,4,810,11,12,5,990,32,46,11,2869,26,42,7,2340,42,54,10,3781,36,44,10,3300,19,36,6,1710,22,31,8,1980,5,8,2,450,LaLiga,18,24,3,1563,5,11,2,450
13/6/2011,Adil Chihi,8727174,34,2/21/1988,23,1,0,0,0,3750,5669,6250,145,126,5160029,183,78,AM L,1,2,2,2,1,1,3,2,2,1,3,7,12,15,10,14,9,8,11,8,5,14,10,5,16,8,10,8,8,9,14,7,9,14,6,13,6,7,6,16,17,14,11,20,6,15,8,11,11,7,5,8,4,12,15,8,5,6,8,13,5,14,1,1,9,20,13,20,8,AM L,503,1,1,15,8,20,13,1,1,1,1,6,9,4,1,1,7.03913E+13,1,0,0,0,0,0,0,0,0,0,0,0,0,0,0,0,0,0,0,0,0,0,0,0,0,0,0,0,0,0,1,0,1,0,1,0,0,0,0,0,0,0,0,0,0,0,1,0,Adil Chihi,£1.13m ,32,183,Forward - Right Winger,left,Without Club,14,1,2,766,13,2,0,934,23,5,2,1311,3,0,0,121,1,0,0,30,6,0,0,381,9,0,3,544,nan,nan,nan,nan,nan,nan,nan,nan,Bundesliga,8,5,1,381,nan,nan,nan,nan
13/6/2011,Adam Johnson,5118412,765,7/14/1987,23,6,2,19,4,5700,7350,7250,165,149,19284517,176,62,M/AM RL,2,3,3,1,3,2,2,1,1,2,3,15,15,17,13,13,11,6,13,6,4,13,8,8,12,6,12,8,14,12,12,11,13,15,5,15,3,12,12,17,18,13,7,20,12,15,11,14,9,13,5,8,8,13,6,15,12,15,14,10,11,5,1,1,18,20,19,20,5,M/AM RL,525,1,1,1,1,20,19,1,1,1,1,5,18,18,1,1,2.32217E+15,1,0,0,0,0,1,0,0,0,0,0,0,0,0,0,0,0,0,0,0,0,0,0,0,0,0,0,0,0,0,0,0,0,0,0,0,0,0,0,0,0,0,0,0,0,0,1,0,Adam Johnson,£9.45m ,33,182,Forward - Right Winger,left,Career break,43,6,9,2394,38,7,8,1597,40,5,9,3277,45,10,10,3115,37,5,3,2456,20,2,5,1231,nan,nan,nan,nan,nan,nan,nan,nan,nan,nan,nan,nan,Premier League,nan,nan,nan,nan,nan,nan,nan,nan
13/6/2011,Adam Hammill,5006838,765,1/25/1988,23,0,0,1,0,3350,5850,5850,145,119,1725000,181,74,M/AM RL,1,2,3,1,3,1,1,1,3,3,3,13,14,14,9,12,11,8,11,4,7,13,8,4,14,7,12,7,11,8,15,9,15,15,5,13,11,7,12,12,10,12,8,15,12,15,20,12,7,11,6,14,7,5,14,18,12,14,10,9,6,7,1,1,20,20,20,20,14,M/AM RL,415,1,1,12,14,16,20,1,1,1,1,1,20,19,1,1,34360786944,0,0,0,0,0,0,0,0,0,0,0,0,0,0,0,0,0,0,0,0,1,0,0,0,0,0,0,0,0,0,0,0,0,0,0,1,0,0,0,0,0,0,0,0,0,0,0,0,Adam Hammill,£900Th. ,32,180,Forward - Right Winger,left,Derry City,37,8,7,2953,27,1,1,1700,20,2,1,776,49,5,12,3717,22,0,3,844,35,9,9,2997,40,3,4,2454,42,1,3,2913,28,5,4,1798,Premier League,17,0,1,952,1,0,1,120
13/6/2011,Valter Birsa,7581802,795,8/7/1986,24,47,3,11,5,5200,7205,6400,140,131,5755177,184,79,AM LC,1,3,1,2,1,1,3,5,3,3,3,14,13,13,11,14,15,7,14,5,6,14,14,5,14,7,12,11,13,12,14,11,13,14,7,11,9,13,12,13,13,14,10,20,14,11,15,13,13,13,7,17,6,8,11,15,12,12,14,16,16,6,1,1,14,20,14,20,16,AM LC,504,1,1,10,16,20,14,1,1,1,1,10,14,14,1,1,1073742080,0,0,0,0,0,0,0,0,1,0,0,0,0,0,0,0,0,0,0,0,0,0,0,0,0,0,0,0,0,0,1,0,0,0,0,0,0,0,0,0,0,0,0,0,0,0,0,0,Valter Birsa,£2.25m ,34,184,Midfielder - Attacking Midfield,left,Cagliari Calcio,42,6,2,2778,12,2,0,485,18,2,4,656,21,2,2,1101,36,0,1,2359,36,6,7,2471,37,7,9,2881,36,3,7,2639,31,2,2,1534,Serie A,15,0,0,475,nan,nan,nan,nan
13/6/2011,Urby Emanuelson,856963,784,6/16/1986,24,14,0,6,1,6500,7000,7000,147,140,4931388,176,68,M/AM L,1,2,2,2,3,3,2,4,2,1,3,13,13,14,10,15,12,7,11,9,11,14,14,9,17,12,13,13,12,11,14,13,12,16,7,15,12,13,13,15,16,13,8,20,16,15,8,12,9,12,7,10,5,15,11,13,15,13,14,14,15,5,12,14,20,16,7,20,12,M/AM L,413,1,1,1,10,16,5,6,12,1,8,12,20,7,14,1,33,1,0,0,0,0,1,0,0,0,0,0,0,0,0,0,0,0,0,0,0,0,0,0,0,0,0,0,0,0,0,0,0,0,0,0,0,0,0,0,0,0,0,0,0,0,0,0,0,Urby Emanuelson,£6.75m ,34,176,Midfielder - Central Midfield,left,FC Utrecht,43,3,1,3069,42,2,6,2363,33,3,5,1962,33,0,3,2278,11,0,3,461,11,0,1,619,1,0,0,16,38,0,4,2608,27,4,3,1838,Serie A,18,0,4,814,1,0,0,20
13/6/2011,Thomas Bertels,91017074,771,11/5/1986,24,0,0,0,0,2000,5000,5000,115,95,794130,193,82,D/AM/S L,1,3,2,3,1,3,2,2,2,3,2,7,10,10,8,10,5,11,3,2,7,12,4,10,5,7,10,5,10,8,10,12,10,9,2,7,8,7,11,12,12,12,14,20,13,11,7,7,3,10,12,6,10,10,13,7,8,16,17,18,14,8,20,13,1,18,12,20,1,D/AM/S L,123,1,1,17,1,18,12,1,20,10,1,1,1,1,13,9,0,0,0,0,0,0,0,0,0,0,0,0,0,0,0,0,0,0,0,0,0,0,0,0,0,0,0,0,0,0,0,0,0,0,0,0,0,0,0,0,0,0,0,0,0,0,0,0,0,,,,,,,,,,,,,,,,,,,,,,,,,,,,,,,,,,,,,,,,,,,,,,,,,,,,
13/6/2011,Stéphen Vincent,918855,769,9/2/1986,24,0,0,0,0,2350,3550,3550,125,108,458682,174,71,M/AM RL,2,1,2,2,3,2,3,2,1,1,1,12,11,13,7,13,11,6,7,5,1,7,10,3,13,5,9,7,10,11,10,9,13,13,5,12,4,8,11,16,13,11,7,12,12,14,20,12,10,14,5,15,6,10,14,13,11,11,14,14,14,6,8,8,18,20,20,16,1,M/AM RL,525,1,1,10,1,16,20,1,8,1,1,1,16,18,8,1,2.2518E+15,0,0,0,0,0,0,0,0,0,0,0,0,0,0,0,0,0,0,0,0,0,0,0,0,0,0,0,0,0,0,0,0,0,0,0,0,0,0,0,0,0,0,0,0,0,0,0,0,,,,,,,,,,,,,,,,,,,,,,,,,,,,,,,,,,,,,,,,,,,,,,,,,,,,
13/6/2011,Stephan Schröck,8718375,141,8/21/1986,24,3,1,0,0,4100,6250,6250,134,125,5482878,168,60,D/WB/M/AM RL,2,2,2,1,2,2,2,2,2,3,1,7,9,14,8,11,5,4,9,16,8,10,8,13,13,14,10,17,10,9,12,8,15,15,8,11,8,9,16,15,17,9,5,11,13,15,20,14,11,14,13,14,13,17,7,8,19,10,11,12,12,10,16,20,19,19,20,17,6,D/WB/M/AM RL,245,1,1,6,6,17,19,1,4,16,1,1,12,19,8,20,7.09529E+13,0,0,0,0,0,0,0,0,0,0,0,0,0,0,1,0,0,0,0,0,0,0,0,0,0,0,0,0,0,0,0,0,0,0,0,1,0,0,0,1,0,0,0,0,0,0,1,0,,,,,,,,,,,,,,,,,,,,,,,,,,,,,,,,,,,,,,,,,,,,,,,,,,,,
13/6/2011,Sören Halfar,8723499,771,1/2/1987,24,0,0,4,0,3000,4950,4950,115,99,678099,174,74,D/WB/M L,1,1,1,2,1,1,3,4,2,2,2,6,9,13,6,12,9,9,5,5,10,7,9,10,8,13,9,9,11,9,10,13,8,8,6,10,11,13,11,16,12,13,6,20,10,13,5,9,7,13,12,10,14,10,8,16,5,14,7,7,14,15,20,19,18,15,8,20,1,D/WB/M L,123,1,1,1,1,15,1,1,20,8,1,1,18,1,19,1,0,0,0,0,0,0,0,0,0,0,0,0,0,0,0,0,0,0,0,0,0,0,0,0,0,0,0,0,0,0,0,0,0,0,0,0,0,0,0,0,0,0,0,0,0,0,0,0,0,,,,,,,,,,,,,,,,,,,,,,,,,,,,,,,,,,,,,,,,,,,,,,,,,,,,
13/6/2011,Sedat Yücel,35022965,799,1/28/1987,24,0,0,0,0,750,3600,3600,100,82,12298,177,72,D/M L,3,2,2,3,1,1,2,1,3,3,2,12,9,10,7,11,15,9,16,5,7,8,16,10,10,5,5,11,7,11,7,7,10,9,5,10,10,12,14,11,11,15,8,20,13,10,7,14,16,15,3,7,3,11,3,7,12,14,12,7,18,6,20,15,20,7,13,20,1,D/M L,113,1,1,1,1,7,1,1,20,13,1,1,20,1,15,1,0,0,0,0,0,0,0,0,0,0,0,0,0,0,0,0,0,0,0,0,0,0,0,0,0,0,0,0,0,0,0,0,0,0,0,0,0,0,0,0,0,0,0,0,0,0,0,0,0,,,,,,,,,,,,,,,,,,,,,,,,,,,,,,,,,,,,,,,,,,,,,,,,,,,,
13/6/2011,Sebastian Schuppan,8726820,771,7/18/1986,24,0,0,0,0,2750,4650,4650,100,93,119459,187,81,M/AM L,2,1,1,1,2,2,2,1,2,3,1,9,10,11,10,10,12,9,10,9,10,10,9,10,11,13,9,12,10,12,12,12,11,10,9,13,11,13,13,11,11,9,10,20,10,13,7,9,8,10,9,8,5,12,7,12,13,10,11,10,8,10,10,10,20,16,1,20,1,M/AM L,413,1,1,1,1,16,1,1,10,1,1,1,20,1,10,1,0,0,0,0,0,0,0,0,0,0,0,0,0,0,0,0,0,0,0,0,0,0,0,0,0,0,0,0,0,0,0,0,0,0,0,0,0,0,0,0,0,0,0,0,0,0,0,0,0,,,,,,,,,,,,,,,,,,,,,,,,,,,,,,,,,,,,,,,,,,,,,,,,,,,,
13/6/2011,Sebastian Giovinco,1400720,776,1/26/1987,24,4,0,30,4,6250,7450,7300,160,146,16002448,165,60,AM LC,2,2,2,1,2,1,2,4,3,1,1,15,15,17,12,15,15,2,14,8,4,14,16,4,17,9,13,12,10,12,14,13,15,17,11,14,6,11,10,16,18,8,2,12,13,16,20,14,4,12,3,10,4,11,15,17,14,14,14,14,14,9,1,1,13,20,14,19,20,AM LC,504,1,1,13,20,19,14,1,1,1,1,9,13,8,1,1,5.84116E+11,0,0,0,0,0,0,0,1,0,0,0,0,0,0,0,0,0,0,0,0,0,0,0,0,0,0,0,0,0,0,0,0,0,0,0,1,0,0,0,1,0,0,0,0,0,0,0,0,Sebastian Giovinco,£11.25m ,33,164,Forward - Second Striker,right,Al-Hilal Riyadh,32,7,6,2454,38,16,13,3200,42,11,7,2702,30,3,6,1011,46,25,15,3214,37,22,16,3172,32,20,7,2580,38,18,14,3212,25,6,6,1718,Serie A,33,7,8,2386,2,0,1,180
13/6/2011,Sascha Pfeffer,35005940,771,10/19/1986,24,0,0,0,0,2750,4250,4250,100,85,61895,176,72,AM RLC,3,3,2,3,2,3,1,3,2,1,1,9,11,11,7,9,9,7,7,7,6,10,8,7,10,10,9,8,8,10,10,9,10,9,8,8,8,11,11,13,11,7,7,16,8,12,20,9,7,10,5,10,14,14,10,14,14,11,10,15,13,8,1,1,15,20,17,15,20,AM RLC,506,1,1,12,20,15,17,1,1,1,1,14,14,15,1,1,0,0,0,0,0,0,0,0,0,0,0,0,0,0,0,0,0,0,0,0,0,0,0,0,0,0,0,0,0,0,0,0,0,0,0,0,0,0,0,0,0,0,0,0,0,0,0,0,0,,,,,,,,,,,,,,,,,,,,,,,,,,,,,,,,,,,,,,,,,,,,,,,,,,,,
13/6/2011,Sascha Dum,8718370,771,7/3/1986,24,0,0,3,0,4900,5500,5500,117,110,687544,188,83,WB/M/AM L,3,3,3,1,3,3,2,6,2,1,1,12,11,10,8,11,12,6,9,10,8,9,9,10,11,10,8,13,10,8,10,9,13,11,8,12,10,10,12,16,11,12,13,20,12,15,9,13,13,7,9,11,8,12,10,11,16,12,11,14,16,2,15,18,20,18,1,20,1,WB/M/AM L,433,1,1,1,1,18,1,1,15,1,1,1,20,1,18,1,1,1,0,0,0,0,0,0,0,0,0,0,0,0,0,0,0,0,0,0,0,0,0,0,0,0,0,0,0,0,0,0,0,0,0,0,0,0,0,0,0,0,0,0,0,0,0,0,0,,,,,,,,,,,,,,,,,,,,,,,,,,,,,,,,,,,,,,,,,,,,,,,,,,,,
13/6/2011,Ryan Babel,856957,784,12/19/1986,24,39,5,5,2,7500,7250,7250,157,145,24510110,185,79,AM/S LC,2,3,3,1,2,1,2,5,2,3,3,9,13,16,15,12,7,8,15,5,5,14,13,6,15,4,10,9,11,8,10,9,4,15,7,15,7,6,7,17,15,16,12,9,16,18,20,13,15,7,5,14,4,15,14,14,11,5,7,10,9,15,1,1,9,20,14,18,20,AM/S LC,514,1,1,16,20,18,14,1,1,1,1,9,1,1,1,1,5.68009E+11,1,0,0,0,0,0,0,0,0,1,0,0,0,0,0,0,0,0,0,0,0,0,0,0,0,0,0,0,0,0,1,0,0,0,1,0,0,0,0,1,0,0,0,0,0,0,0,0,Ryan Babel,£4.05m ,33,185,Forward - Left Winger,right,Galatasaray SK,34,3,2,2189,35,5,3,2731,22,5,7,1305,30,5,7,2479,29,9,5,2480,8,1,2,367,37,13,5,2818,45,15,7,3721,35,11,5,2801,Bundesliga,29,6,2,2380,9,1,2,499
13/6/2011,Royston Drenthe,863698,784,4/8/1987,24,1,0,21,1,6100,7150,6500,153,138,-1,168,67,WB/M/AM L,2,1,2,1,1,2,1,1,3,1,3,12,12,14,7,14,14,6,12,11,8,13,10,12,13,16,12,15,6,11,11,10,13,13,6,14,10,13,16,19,14,12,5,20,18,16,8,16,10,13,12,13,7,11,9,15,7,9,3,11,14,17,14,16,20,18,1,20,1,WB/M/AM L,433,1,1,1,1,18,1,1,14,1,1,1,20,1,16,1,1.37439E+11,1,0,0,0,0,1,0,0,0,0,0,0,0,0,0,0,0,0,0,0,0,0,0,0,0,0,0,0,0,0,0,0,0,0,0,0,0,1,0,0,0,0,0,0,0,0,0,0,Royston Drenthe,£3.60m ,33,167,Midfielder - Left Midfield,left,Kozakken Boys,19,4,1,1407,28,5,7,1550,6,3,0,540,24,2,1,1467,26,4,1,1601,18,0,2,1434,nan,nan,nan,nan,nan,nan,nan,nan,32,5,6,2338,Premier League,10,3,2,551,0,0,0,0
13/6/2011,Ross McCormack,5204783,793,8/18/1986,24,7,1,13,4,3500,6000,6000,140,114,4513322,176,75,AM/S RL,1,2,2,1,2,2,1,2,1,1,2,14,12,13,12,14,14,8,13,2,5,11,12,7,13,8,12,11,14,8,10,10,14,12,5,11,11,12,13,12,11,11,8,13,8,12,20,12,10,10,6,13,12,13,16,15,10,13,8,9,11,10,1,1,12,17,15,17,10,AM/S RL,625,1,1,20,10,17,15,1,1,1,1,1,12,11,1,1,8192,0,0,0,0,0,0,0,0,0,0,0,0,0,1,0,0,0,0,0,0,0,0,0,0,0,0,0,0,0,0,0,0,0,0,0,0,0,0,0,0,0,0,0,0,0,0,0,0,,,,,,,,,,,,,,,,,,,,,,,,,,,,,,,,,,,,,,,,,,,,,,,,,,,,
13/6/2011,Razak Boukari,8431043,50,4/25/1987,24,0,0,0,0,4800,6650,6000,145,133,7890221,182,70,AM RL,2,3,1,3,2,1,3,1,3,2,3,8,12,15,9,13,11,12,12,6,3,11,12,3,15,8,12,10,12,12,12,11,14,14,6,13,5,9,10,16,14,13,12,12,13,15,20,12,11,12,8,13,9,10,10,15,13,11,13,14,14,7,1,1,12,20,17,20,1,AM RL,505,1,1,12,1,20,17,1,1,1,1,1,12,12,1,1,2.25623E+15,0,0,0,0,0,0,0,0,0,0,0,0,0,0,0,0,0,0,0,0,0,0,0,0,0,0,0,0,0,0,0,0,0,0,0,1,0,0,0,0,0,0,1,0,0,0,0,0,Razak Boukari,£3.15m ,33,187,Forward - Right Winger,right,LB ChÃ¢teauroux,40,8,1,3181,30,6,2,1438,6,0,1,280,10,0,0,181,nan,nan,nan,nan,1,0,0,31,25,7,0,1775,24,1,0,809,20,4,1,1121,Ligue 1,1,0,0,44,3,0,0,49
13/6/2011,Ralf Schneider,35005154,771,8/25/1986,24,0,0,0,0,500,2950,2950,75,59,10870,180,65,AM L,3,2,1,1,2,3,2,2,1,2,1,7,11,5,1,9,5,4,4,7,1,4,4,5,11,5,5,4,11,6,5,5,9,12,11,6,2,5,9,11,11,10,7,20,12,11,9,9,2,10,10,10,9,7,7,13,12,8,18,18,13,5,1,1,9,20,10,20,10,AM L,503,1,1,1,10,20,10,1,1,1,1,1,9,1,1,1,0,0,0,0,0,0,0,0,0,0,0,0,0,0,0,0,0,0,0,0,0,0,0,0,0,0,0,0,0,0,0,0,0,0,0,0,0,0,0,0,0,0,0,0,0,0,0,0,0,,,,,,,,,,,,,,,,,,,,,,,,,,,,,,,,,,,,,,,,,,,,,,,,,,,,
13/6/2011,Patrick Kaesberg,35004512,771,10/8/1986,24,0,0,0,0,1250,2250,2250,130,70,2860,181,71,D L,1,1,1,1,3,3,1,3,1,2,1,6,11,7,4,8,7,11,1,3,9,11,7,10,7,16,10,13,8,7,8,11,10,7,10,7,10,11,11,11,11,11,8,20,7,11,6,11,10,10,9,10,3,10,11,20,12,11,10,11,10,1,20,7,15,1,8,20,1,D L,103,1,1,1,1,1,1,1,20,8,1,1,15,1,7,1,0,0,0,0,0,0,0,0,0,0,0,0,0,0,0,0,0,0,0,0,0,0,0,0,0,0,0,0,0,0,0,0,0,0,0,0,0,0,0,0,0,0,0,0,0,0,0,0,0,Patrick Mayer,£450Th. ,32,180,Forward - Centre-Forward,right,Retired,30,19,6,2573,6,1,4,404,9,2,1,308,23,9,1,1237,14,3,1,343,9,0,0,427,12,2,2,648,13,4,1,542,nan,nan,nan,nan,Bundesliga,nan,nan,nan,nan,nan,nan,nan,nan
13/6/2011,Patrick Ebert,8725761,771,3/17/1987,24,0,0,13,1,4500,6300,6300,135,126,3898902,176,76,M/AM RL,3,3,2,1,2,2,3,5,2,1,3,11,14,12,7,12,13,6,12,9,4,13,12,9,13,14,7,12,9,9,10,7,14,14,9,11,8,7,16,16,17,12,7,15,15,13,20,14,10,7,10,10,4,12,6,12,16,10,6,14,15,15,1,1,20,20,20,16,1,M/AM RL,415,1,1,1,1,16,20,1,1,1,1,1,16,20,1,1,34359738370,0,1,0,0,0,0,0,0,0,0,0,0,0,0,0,0,0,0,0,0,0,0,0,0,0,0,0,0,0,0,0,0,0,0,0,1,0,0,0,0,0,0,0,0,0,0,0,0,Patrick Ebert,£1.80m ,33,175,Midfielder - Attacking Midfield,right,AO Xanthi,12,1,3,787,32,2,5,2256,23,6,7,1799,22,3,5,1511,18,0,4,1281,10,1,0,650,28,5,4,2035,5,0,1,216,29,3,2,2047,Bundesliga,22,2,2,1654,nan,nan,nan,nan
13/6/2011,Paolo De Ceglie,1400714,776,9/17/1986,24,0,0,19,0,5750,6650,6650,148,133,12611309,184,75,D/WB/M L,1,2,3,1,1,3,2,2,1,3,2,11,14,12,10,14,6,12,12,15,10,13,8,13,14,14,13,12,12,13,12,13,10,13,4,13,12,14,14,15,14,13,11,20,15,15,6,14,13,15,10,12,11,14,12,12,10,9,12,14,16,6,18,20,18,13,1,20,1,D/WB/M L,233,1,1,1,1,13,1,1,18,1,1,1,18,1,20,1,0,0,0,0,0,0,0,0,0,0,0,0,0,0,0,0,0,0,0,0,0,0,0,0,0,0,0,0,0,0,0,0,0,0,0,0,0,0,0,0,0,0,0,0,0,0,0,0,0,Paolo De Ceglie,£4.95m ,34,184,Defender - Left-Back,left,Miami Beach CF,15,0,2,1117,23,1,2,1587,18,0,1,1115,18,1,0,1059,14,3,0,947,12,0,0,459,nan,nan,nan,nan,11,2,2,541,nan,nan,nan,nan,Serie A,nan,nan,nan,nan,nan,nan,nan,nan
13/6/2011,Paco Montańés,1510493,796,10/8/1986,24,0,0,2,0,3800,5800,5800,130,118,1164917,172,70,AM RL,1,2,1,3,2,1,2,8,3,1,1,11,13,12,8,13,9,3,9,5,9,10,9,8,11,9,9,6,9,11,9,11,11,9,6,13,4,13,15,14,10,9,5,9,17,14,20,13,6,10,7,10,5,10,7,2,16,9,12,9,10,19,1,1,10,20,20,20,1,AM RL,505,1,1,1,1,20,20,1,1,1,1,1,10,10,1,1,0,0,0,0,0,0,0,0,0,0,0,0,0,0,0,0,0,0,0,0,0,0,0,0,0,0,0,0,0,0,0,0,0,0,0,0,0,0,0,0,0,0,0,0,0,0,0,0,0,,,,,,,,,,,,,,,,,,,,,,,,,,,,,,,,,,,,,,,,,,,,,,,,,,,,
13/6/2011,Olcay Sahan,35006596,799,5/26/1987,24,0,0,0,0,2750,6200,6200,133,124,3571926,177,70,M/AM RL,2,3,2,2,1,2,1,1,2,2,3,9,12,16,8,14,9,8,9,6,6,12,9,7,14,9,9,8,11,10,13,11,10,15,8,14,6,9,15,15,15,11,9,12,12,12,20,14,9,7,6,11,8,12,8,15,10,13,20,12,2,9,1,1,16,20,20,19,14,M/AM RL,525,1,1,8,14,19,20,1,1,1,1,10,15,16,1,1,0,0,0,0,0,0,0,0,0,0,0,0,0,0,0,0,0,0,0,0,0,0,0,0,0,0,0,0,0,0,0,0,0,0,0,0,0,0,0,0,0,0,0,0,0,0,0,0,0,Olcay Sahan,£1.13m ,33,179,Forward - Right Winger,right,Yeni Malatyaspor,40,7,8,3189,30,1,4,2224,37,11,6,3036,36,8,9,2877,48,9,11,3498,41,5,6,2456,37,3,10,2689,31,5,6,2020,21,2,5,974,Bundesliga,30,1,3,1722,2,0,0,89
13/6/2011,Nuno Pinto,55001184,788,8/6/1986,24,0,0,0,0,1500,5250,5250,113,108,1776299,175,72,D/M L,3,2,3,3,2,1,1,3,1,3,1,12,12,11,9,12,11,9,11,10,11,11,11,11,11,12,11,12,12,11,10,11,14,10,9,13,10,11,13,14,14,9,10,20,13,14,5,10,10,10,9,10,9,12,16,12,15,12,13,14,14,5,20,8,20,9,9,20,10,D/M L,113,1,1,1,1,9,1,1,20,9,1,10,20,1,8,1,0,0,0,0,0,0,0,0,0,0,0,0,0,0,0,0,0,0,0,0,0,0,0,0,0,0,0,0,0,0,0,0,0,0,0,0,0,0,0,0,0,0,0,0,0,0,0,0,0,Nuno Pinto,£990Th. ,34,173,Defender - Left-Back,left,Without Club,20,1,2,1613,26,0,2,2251,21,0,2,1606,30,0,5,2670,8,0,2,280,32,0,5,2770,37,0,9,3249,33,1,6,2811,13,0,3,955,Liga NOS,15,0,1,1173,nan,nan,nan,nan
13/6/2011,Nolito,67017094,796,10/15/1986,24,0,0,0,0,5000,6700,6800,145,136,10922483,175,73,AM RL,3,3,3,2,1,2,3,4,2,3,2,13,12,16,13,13,10,6,11,6,4,12,12,6,14,8,12,11,13,12,12,11,10,14,8,14,6,10,12,15,15,8,7,13,12,13,20,13,8,9,6,9,7,12,12,14,12,10,10,7,10,12,1,1,10,20,16,20,12,AM RL,505,1,1,7,12,20,16,1,1,1,1,1,10,10,1,1,2.25235E+15,0,0,0,0,0,0,0,0,0,0,0,1,0,0,0,0,0,0,0,0,0,0,0,0,0,0,0,0,0,0,0,0,0,0,0,0,0,0,0,1,0,0,0,0,0,0,0,0,Nolito,£7.20m ,34,175,Forward - Left Winger,right,Celta de Vigo,43,14,1,3095,48,15,12,2648,32,4,2,2122,37,14,2,2442,37,13,14,3061,29,12,7,2452,30,6,5,1349,42,5,7,2128,17,5,3,963,Liga NOS,27,7,4,1534,6,0,1,453
13/6/2011,Nicolas Farina,8440189,769,8/9/1986,24,0,0,0,0,3300,5050,5050,125,113,3108207,168,62,AM RL,2,1,2,2,1,1,1,3,1,2,3,7,11,14,11,11,7,9,11,5,3,10,13,3,14,6,12,7,12,12,11,11,13,13,5,13,7,9,13,17,14,10,3,5,9,15,20,6,6,14,6,14,12,8,9,13,15,12,10,14,14,6,1,1,14,20,20,17,1,AM RL,505,1,1,12,1,17,20,1,1,1,1,1,14,14,1,1,2,0,1,0,0,0,0,0,0,0,0,0,0,0,0,0,0,0,0,0,0,0,0,0,0,0,0,0,0,0,0,0,0,0,0,0,0,0,0,0,0,0,0,0,0,0,0,0,0,Nicolas Farina,£360Th. ,34,168,Forward - Right Winger,right,Without Club,35,6,2,1999,18,0,1,437,23,2,3,1371,3,0,0,189,9,10,1,736,8,0,0,559,nan,nan,nan,nan,21,2,1,1750,nan,nan,nan,nan,Ligue 1,nan,nan,nan,nan,nan,nan,nan,nan
13/6/2011,Nani,736009,788,11/17/1986,24,45,9,10,1,7500,8000,8050,170,163,44096142,175,66,M/AM RL,2,2,3,2,3,1,3,9,3,3,1,12,15,17,12,17,13,6,15,4,6,13,15,7,17,11,11,8,12,13,13,12,14,20,5,15,8,12,14,16,16,14,7,16,15,16,20,14,12,12,9,13,7,10,15,16,13,16,13,6,8,12,1,1,17,20,20,18,11,M/AM RL,525,1,1,5,11,18,20,1,1,1,1,8,15,17,1,1,2.32275E+15,0,0,0,0,0,0,0,0,1,0,0,0,0,0,0,0,0,0,0,0,0,0,0,0,0,0,0,0,0,0,0,0,0,0,0,1,0,0,0,1,0,0,0,0,0,0,1,0,Nani,£32.85m ,33,177,Forward - Left Winger,both,Orlando City SC,49,10,20,3674,40,10,15,2855,21,3,6,1337,13,1,0,740,38,12,8,3264,47,12,13,3732,26,5,8,1930,25,3,3,660,61,21,13,4736,Premier League,20,7,5,1585,nan,nan,nan,nan
13/6/2011,Mohamed M'Changama,85077781,919586,6/9/1987,24,3,0,0,0,2150,4900,3250,115,98,194200,187,79,AM/S L,3,3,3,3,2,2,3,1,3,3,3,4,8,10,11,12,7,11,12,5,5,8,10,2,10,8,11,12,13,9,9,10,13,11,6,13,5,8,12,11,10,15,12,8,14,14,20,12,13,12,8,14,6,7,8,11,12,14,13,15,15,6,1,1,10,20,1,20,1,AM/S L,513,1,1,16,1,20,1,1,1,1,1,1,10,1,1,1,1041,1,0,0,0,1,0,0,0,0,0,1,0,0,0,0,0,0,0,0,0,0,0,0,0,0,0,0,0,0,0,0,0,0,0,0,0,0,0,0,0,0,0,0,0,0,0,0,0,,,,,,,,,,,,,,,,,,,,,,,,,,,,,,,,,,,,,,,,,,,,,,,,,,,,
13/6/2011,Mirko Boland,35006805,771,4/23/1987,24,0,0,0,0,4000,5600,5600,125,112,1393772,174,68,M L,2,1,2,1,1,1,3,1,2,1,3,11,12,12,10,11,11,6,9,9,10,12,10,9,11,11,12,11,10,11,13,11,9,8,8,11,11,12,12,14,12,9,7,20,11,13,16,9,7,12,5,10,4,10,4,14,7,6,7,14,19,9,1,1,20,9,13,20,14,M L,403,1,1,1,1,9,1,1,1,1,12,14,20,13,1,1,0,0,0,0,0,0,0,0,0,0,0,0,0,0,0,0,0,0,0,0,0,0,0,0,0,0,0,0,0,0,0,0,0,0,0,0,0,0,0,0,0,0,0,0,0,0,0,0,0,,,,,,,,,,,,,,,,,,,,,,,,,,,,,,,,,,,,,,,,,,,,,,,,,,,,
13/6/2011,Milos Obradovic,5760091,802,3/30/1987,24,0,0,0,0,1700,4500,4500,112,100,428821,182,74,D/M L,3,2,2,1,2,1,3,1,1,1,3,12,13,15,12,10,12,11,14,10,10,9,11,10,15,12,10,11,9,10,10,10,11,10,11,10,10,9,11,12,12,10,10,20,11,12,5,10,10,12,9,10,9,8,12,14,12,13,13,14,13,4,20,15,20,9,8,20,1,D/M L,113,1,1,1,1,9,1,1,20,8,1,1,20,1,15,1,0,0,0,0,0,0,0,0,0,0,0,0,0,0,0,0,0,0,0,0,0,0,0,0,0,0,0,0,0,0,0,0,0,0,0,0,0,0,0,0,0,0,0,0,0,0,0,0,0,Milos Obradovic,£180Th. ,33,182,Defender - Left-Back,left,Without Club,0,0,0,0,8,0,1,587,7,1,1,213,15,1,0,1068,16,0,2,1355,12,0,4,1006,17,0,0,1284,nan,nan,nan,nan,nan,nan,nan,nan,Liga NOS,nan,nan,nan,nan,nan,nan,nan,nan
13/6/2011,Mike Frantz,35004501,771,10/14/1986,24,0,0,0,0,4400,6250,6000,137,125,3540645,180,77,M/AM RL,2,3,3,3,3,3,3,1,2,1,3,8,12,13,8,12,8,9,10,13,8,11,8,10,12,8,11,10,11,11,11,11,10,8,10,14,9,13,14,14,11,13,9,16,15,13,20,13,13,14,5,12,14,13,11,16,5,20,8,7,11,12,1,1,19,20,16,20,12,M/AM RL,525,1,1,1,12,20,16,1,1,1,1,1,19,15,1,1,0,0,0,0,0,0,0,0,0,0,0,0,0,0,0,0,0,0,0,0,0,0,0,0,0,0,0,0,0,0,0,0,0,0,0,0,0,0,0,0,0,0,0,0,0,0,0,0,0,Mike Frantz,£1.35m ,34,182,Midfielder - Central Midfield,right,Hannover 96,16,2,1,905,19,3,5,1070,28,1,1,1629,32,1,1,2197,27,4,1,1293,33,6,8,2525,30,0,2,2502,20,0,1,1487,34,3,2,2523,Bundesliga,20,0,1,496,6,0,0,366
13/6/2011,Miguel De las Cuevas,1507647,796,6/19/1986,24,0,0,0,0,4900,7150,7150,150,143,12167863,167,65,AM RLC,1,1,2,2,3,2,2,3,2,1,2,16,16,15,14,14,13,11,13,8,5,16,14,9,15,7,13,14,11,15,13,13,10,16,12,15,13,14,15,14,16,13,7,6,10,14,20,13,11,13,4,14,10,17,8,9,10,9,15,14,12,8,1,1,14,20,16,15,20,AM RLC,506,1,1,7,20,15,16,1,1,1,1,5,13,14,1,1,8.79953E+13,0,0,1,0,0,0,0,0,0,0,0,0,0,0,0,0,0,0,0,0,0,0,0,0,0,0,0,0,0,0,0,0,0,0,0,1,0,0,0,0,0,0,0,0,1,0,1,0,Miguel de las Cuevas,£4.50m ,34,175,Forward - Right Winger,right,Córdoba CF,38,6,3,2574,36,3,6,2924,30,2,2,1745,26,0,0,1761,34,5,1,2549,22,2,5,1287,30,0,2,1932,18,1,0,503,35,10,2,2483,LaLiga,26,7,0,2048,1,0,0,81
13/6/2011,Michael Parensen,8724477,771,6/24/1986,24,0,0,0,0,4050,5250,5250,112,105,1279107,180,80,WB/M L,2,2,2,3,1,2,2,4,1,1,1,11,13,9,7,12,9,7,8,13,11,10,4,10,10,6,13,11,9,10,8,12,7,7,7,7,12,13,13,13,11,13,10,20,11,15,5,12,11,10,6,10,10,10,10,11,8,6,7,11,10,6,15,18,20,15,8,20,3,WB/M L,423,1,1,1,3,15,1,3,15,3,1,1,20,3,18,8,0,0,0,0,0,0,0,0,0,0,0,0,0,0,0,0,0,0,0,0,0,0,0,0,0,0,0,0,0,0,0,0,0,0,0,0,0,0,0,0,0,0,0,0,0,0,0,0,0,Michael Rensing,£2.25m ,36,190,Goalkeeper,right,Without Club,17,29,6,1530,33,73,6,2970,5,9,1,480,5,5,2,413,25,39,6,2280,34,47,8,3060,36,45,12,3240,8,8,2,750,33,63,5,2970,Bundesliga,0,0,0,0,nan,nan,nan,nan
13/6/2011,Mauro Zárate,961289,1649,3/18/1987,24,0,0,5,2,7000,6750,7450,161,148,15660859,176,76,AM/S RLC,1,1,2,3,2,3,1,3,1,1,1,12,14,17,13,15,15,6,15,3,4,13,15,6,17,14,10,15,12,11,13,11,16,17,11,14,6,4,12,16,15,11,6,12,14,16,20,15,10,14,14,15,11,12,15,17,13,13,9,11,14,15,1,1,1,16,16,16,15,AM/S RLC,626,1,1,20,15,16,16,1,1,1,1,1,1,1,1,1,8.79621E+13,0,0,0,0,0,0,0,0,0,0,0,0,0,0,0,0,0,1,0,0,0,0,0,0,0,0,0,1,0,0,1,0,0,0,0,0,0,0,0,0,0,0,0,0,1,0,1,0,Mauro Zárate,£8.55m ,33,175,Forward - Centre-Forward,right,Club Atlético Boca Juniors,36,9,9,2583,31,3,3,1437,10,3,3,491,32,18,6,2565,12,2,1,527,38,8,4,2111,12,4,2,482,27,14,2,2097,44,11,11,2691,Serie A,13,2,2,497,nan,nan,nan,nan
13/6/2011,Marquitos,7458311,796,3/21/1987,24,0,0,0,0,4200,6100,6100,140,125,2387494,174,67,M/AM L,1,3,2,1,1,1,3,1,3,2,1,12,13,13,13,12,13,8,13,8,6,13,11,8,16,9,13,12,12,12,13,13,10,14,10,16,9,11,10,13,15,13,8,20,12,15,5,12,8,13,8,8,7,14,13,10,13,11,11,8,6,18,1,1,16,20,12,20,13,M/AM L,523,1,1,8,13,20,12,1,1,1,1,1,16,8,1,1,1.75922E+13,0,0,0,0,1,0,0,0,1,0,0,0,0,0,0,0,0,0,0,0,0,0,0,0,0,0,0,0,0,0,0,0,0,0,0,0,0,0,0,0,0,0,0,0,1,0,0,0,Marquinho,£4.05m ,34,182,Midfielder - Attacking Midfield,left,Figueirense Futebol Clube,38,5,9,2921,15,3,1,969,30,4,2,1471,28,2,1,1573,27,10,7,2221,53,5,3,2842,5,0,0,98,nan,nan,nan,nan,7,0,0,323,Serie A,15,0,2,1178,nan,nan,nan,nan
13/6/2011,Marcel de Jong,863261,364,10/15/1986,24,17,1,13,1,4350,5624,6250,130,125,3038778,174,73,D/WB/M L,1,1,1,1,1,2,1,5,1,1,1,11,13,13,8,11,14,11,14,12,12,14,8,13,12,11,13,14,13,12,12,14,10,10,10,14,13,14,14,12,12,11,8,20,14,11,12,12,11,15,11,10,8,12,5,3,9,9,13,19,5,17,20,17,18,14,7,20,10,D/WB/M L,123,1,1,1,5,14,1,8,20,7,10,10,18,1,17,1,4.40492E+13,0,0,0,0,0,0,0,0,1,0,0,0,0,0,0,0,0,0,0,0,0,0,0,0,0,0,0,0,0,0,0,0,0,0,0,0,1,0,0,0,0,0,0,1,0,1,0,0,Marcel de Jong,£1.35m ,34,174,Defender - Left-Back,left,Pacific FC,27,3,1,1969,14,1,0,1066,21,1,1,1360,9,0,1,276,16,1,1,987,16,2,1,1186,22,0,1,1520,22,0,3,1663,2,0,0,50,Bundesliga,7,0,0,442,nan,nan,nan,nan
13/6/2011,Luis Suárez,78000335,1657,1/24/1987,24,42,17,4,2,7250,8300,8300,178,163,73606631,181,81,AM/S RL,1,2,3,3,1,3,1,5,3,2,1,10,14,15,15,16,14,12,13,9,5,15,13,5,17,11,15,13,14,14,15,12,18,15,10,15,6,14,15,15,15,15,12,13,14,15,20,15,12,14,8,13,5,11,13,16,13,15,10,4,8,7,1,1,1,17,17,17,14,AM/S RL,625,1,1,20,14,17,17,1,1,1,1,1,1,1,1,1,65568,0,0,0,0,0,1,0,0,0,0,0,0,0,0,0,0,1,0,0,0,0,0,0,0,0,0,0,0,0,0,0,0,0,0,0,0,0,0,0,0,0,0,0,0,0,0,0,0,Luis Suárez,£26.10m ,33,182,Forward - Centre-Forward,right,Atlético Madrid,37,16,16,3213,39,17,10,3254,44,30,13,3720,37,31,19,3249,43,25,23,3532,53,59,24,4766,51,36,19,4302,51,31,20,4447,49,23,15,4132,Premier League,36,21,12,2658,6,4,1,382
13/6/2011,Luís Leal,55014715,40,5/29/1987,24,0,0,0,0,1250,5000,4500,125,109,46687,176,75,AM/S RL,2,1,2,1,1,3,1,3,3,2,2,9,10,12,12,10,7,9,9,6,5,10,11,8,11,10,11,10,9,8,9,9,12,13,6,12,6,9,10,13,11,13,9,13,15,13,20,10,12,9,6,9,7,13,13,11,12,11,14,14,14,5,1,1,9,20,17,20,10,AM/S RL,515,1,1,20,10,20,17,1,1,1,1,1,9,1,1,1,0,0,0,0,0,0,0,0,0,0,0,0,0,0,0,0,0,0,0,0,0,0,0,0,0,0,0,0,0,0,0,0,0,0,0,0,0,0,0,0,0,0,0,0,0,0,0,0,0,Luís Leal,£720Th. ,33,176,Forward - Right Winger,right,Club Tijuana,29,8,1,1958,19,2,1,675,35,10,4,2698,34,17,2,2686,24,6,3,1595,33,6,8,2625,21,5,3,1377,24,9,1,2029,21,4,1,1280,Liga NOS,15,5,0,1109,7,0,0,330
13/6/2011,Luca Antonelli,1408492,776,2/11/1987,24,2,0,0,0,4750,6600,6600,147,135,3816544,184,79,D/WB L,1,1,3,3,3,2,3,4,2,2,2,4,14,13,10,11,4,12,8,5,12,12,10,14,13,10,13,10,11,12,10,10,13,11,8,14,13,14,16,16,13,9,11,20,13,16,6,16,14,14,9,14,7,11,9,11,12,11,14,12,11,7,20,16,15,13,7,20,10,D/WB L,113,1,1,1,1,13,1,1,20,7,1,10,15,1,16,1,0,0,0,0,0,0,0,0,0,0,0,0,0,0,0,0,0,0,0,0,0,0,0,0,0,0,0,0,0,0,0,0,0,0,0,0,0,0,0,0,0,0,0,0,0,0,0,0,0,Luca Antonelli,£4.50m ,33,184,Defender - Left-Back,left,Without Club,23,1,2,1687,13,0,0,806,34,1,4,2884,31,3,3,2668,32,4,2,2788,32,3,3,2695,9,0,0,417,13,1,1,584,13,0,1,759,Serie A,14,2,1,928,0,0,0,0
13/6/2011,Lorenzo Davids,859350,784,9/4/1986,24,0,0,0,0,5000,5900,6100,137,122,1000000,180,69,DM/M LC,1,1,2,2,1,1,1,1,3,1,2,10,9,12,6,14,7,11,7,10,14,13,10,13,15,15,14,13,11,11,13,12,14,13,10,16,14,13,16,11,11,12,11,20,14,11,10,15,12,14,6,15,11,12,12,15,13,14,17,2,10,7,11,13,20,12,9,17,20,DM/M LC,424,1,1,1,8,12,6,10,11,1,17,20,17,9,13,5,0,0,0,0,0,0,0,0,0,0,0,0,0,0,0,0,0,0,0,0,0,0,0,0,0,0,0,0,0,0,0,0,0,0,0,0,0,0,0,0,0,0,0,0,0,0,0,0,0,Lorenzo Davids,£900Th. ,34,180,Midfielder - Defensive Midfield,left,SV Nijmegen,30,2,3,2238,23,0,0,1760,10,0,0,684,7,0,0,185,nan,nan,nan,nan,nan,nan,nan,nan,nan,nan,nan,nan,1,0,0,90,8,0,0,750,Bundesliga,nan,nan,nan,nan,nan,nan,nan,nan
13/6/2011,Lee Martin,5123097,765,2/9/1987,24,0,0,0,0,2650,5000,5250,123,101,1553974,178,65,AM RL,1,3,3,1,3,1,2,5,3,1,1,12,12,15,7,12,9,4,8,2,4,11,10,4,13,9,8,9,12,10,8,5,13,15,4,12,5,10,14,14,12,8,9,8,15,14,20,13,5,6,4,9,11,6,14,12,15,8,13,11,14,3,1,1,15,20,19,20,12,AM RL,505,1,1,10,12,20,19,1,1,1,1,10,15,12,1,1,2.2518E+15,0,0,0,0,0,0,0,0,0,0,0,0,0,0,0,0,0,0,0,0,0,0,0,0,0,0,0,0,0,0,0,0,0,0,0,0,0,0,0,0,0,0,0,0,0,0,0,0,,,,,,,,,,,,,,,,,,,,,,,,,,,,,,,,,,,,,,,,,,,,,,,,,,,,
13/6/2011,Leandro Greco,7984090,776,7/19/1986,24,0,0,0,0,4400,6000,6000,135,124,1315710,177,73,M/AM LC,1,1,1,1,1,1,1,1,1,1,1,2,11,14,9,14,4,8,11,1,8,14,4,9,15,8,14,9,12,14,14,12,12,13,7,13,13,14,15,13,14,11,8,8,11,14,20,12,13,11,11,12,18,11,12,18,10,10,15,15,12,9,1,1,20,18,12,18,20,M/AM LC,414,1,1,1,18,18,12,1,1,1,13,20,15,12,1,1,320,0,0,0,0,0,0,1,0,1,0,0,0,0,0,0,0,0,0,0,0,0,0,0,0,0,0,0,0,0,0,0,0,0,0,0,0,0,0,0,0,0,0,0,0,0,0,0,0,Leandro Greco,£2.25m ,34,184,Midfielder - Central Midfield,left,FC Südtirol,19,1,2,983,21,0,2,975,38,1,4,2145,32,4,2,2408,28,0,2,1767,28,1,1,2033,11,0,0,574,18,0,1,1200,27,2,1,2039,Serie A,13,0,0,702,7,0,1,480
13/6/2011,Kevin Kratz,35008898,771,1/21/1987,24,0,0,0,0,4600,5850,5850,132,117,1680633,173,73,DM/M RLC,2,1,1,3,1,3,2,1,1,3,3,12,12,10,7,12,10,6,12,7,10,13,8,11,12,15,13,15,12,11,12,13,13,13,8,11,12,15,14,10,11,12,6,20,13,11,16,14,14,12,6,7,11,14,8,11,10,12,16,19,14,19,1,1,19,13,19,18,15,DM/M RLC,316,1,1,1,1,13,12,1,1,1,20,15,18,19,1,1,0,0,0,0,0,0,0,0,0,0,0,0,0,0,0,0,0,0,0,0,0,0,0,0,0,0,0,0,0,0,0,0,0,0,0,0,0,0,0,0,0,0,0,0,0,0,0,0,0,,,,,,,,,,,,,,,,,,,,,,,,,,,,,,,,,,,,,,,,,,,,,,,,,,,,
13/6/2011,Kévin Constant,8435076,22,5/10/1987,24,12,2,0,0,5000,6500,6900,150,138,5863496,184,78,M/AM LC,2,3,3,1,3,1,2,4,1,3,3,14,11,14,11,14,13,9,15,6,8,12,14,6,16,11,14,11,12,14,13,12,10,13,7,14,9,11,12,15,14,14,10,20,15,14,10,16,14,13,11,15,7,14,14,15,12,10,9,13,13,12,1,1,18,20,1,16,20,M/AM LC,524,1,1,1,20,16,1,1,1,1,13,18,15,1,1,1,4194308,0,0,1,0,0,0,0,0,0,0,0,0,0,0,0,0,0,0,0,0,0,0,1,0,0,0,0,0,0,0,0,0,0,0,0,0,0,0,0,0,0,0,0,0,0,0,0,0,Kévin Constant,£4.50m ,33,184,Midfielder - Central Midfield,left,Retired,36,2,5,2486,23,1,1,1472,31,0,2,2289,26,0,1,1973,22,2,1,1691,18,0,2,1257,13,2,1,903,17,0,2,1340,3,0,0,262,Serie A,nan,nan,nan,nan,nan,nan,nan,nan
13/6/2011,Julian Palmiéri,34000583,769,12/7/1986,24,0,0,0,0,2550,3900,3900,135,119,468946,170,66,M/AM L,1,1,2,3,1,3,2,1,3,3,1,12,12,12,6,12,9,5,7,8,6,12,8,11,14,10,10,12,13,13,13,12,14,12,10,10,9,12,12,15,13,9,5,20,15,14,10,15,6,15,10,14,6,15,11,12,14,14,16,13,13,9,15,15,17,20,12,20,1,M/AM L,523,1,1,1,1,20,10,1,15,12,12,1,17,10,15,12,1.37439E+11,1,0,0,0,0,0,0,0,0,0,0,0,0,0,0,0,0,1,0,0,0,0,0,0,0,0,0,0,0,0,0,0,0,0,0,0,0,1,0,0,0,0,0,0,0,0,0,0,,,,,,,,,,,,,,,,,,,,,,,,,,,,,,,,,,,,,,,,,,,,,,,,,,,,
13/6/2011,Juanmi Callejón,67011230,796,2/11/1987,24,0,0,0,0,3800,5800,5800,131,118,1415093,179,70,M/AM RLC,2,1,3,1,2,2,3,1,1,2,2,15,16,10,11,14,15,8,14,8,4,15,13,6,16,9,10,9,12,11,15,10,8,16,7,13,11,10,10,12,15,10,9,10,13,12,20,11,9,12,9,13,3,12,6,10,6,13,15,7,14,11,1,3,17,20,17,20,16,M/AM RLC,526,1,1,14,16,20,17,1,1,1,1,5,17,15,3,1,4.39805E+12,0,0,0,0,0,0,0,0,0,0,0,0,0,0,0,0,0,0,0,0,0,0,0,0,0,0,0,0,0,0,0,0,0,0,0,0,0,0,0,0,0,0,1,0,0,0,0,0,,,,,,,,,,,,,,,,,,,,,,,,,,,,,,,,,,,,,,,,,,,,,,,,,,,,
13/6/2011,Juan Albín,5513030,1657,7/17/1986,24,0,0,14,7,5750,6850,6700,151,134,3945109,179,77,AM LC,2,3,3,2,2,3,1,4,2,3,1,15,14,15,12,14,16,9,14,5,4,14,15,4,16,7,14,7,11,9,17,13,11,16,6,15,7,13,8,15,17,8,8,20,13,16,4,11,10,8,8,12,5,14,15,13,8,11,12,11,12,8,1,1,5,20,10,18,20,AM LC,504,1,1,15,20,18,10,1,1,1,1,1,5,1,1,1,1.76437E+13,0,0,0,0,1,0,0,0,0,0,0,0,0,0,0,0,0,0,0,0,0,0,0,0,0,0,0,0,0,0,0,0,0,0,1,1,0,0,0,0,0,0,0,0,1,0,0,0,Juan Albín,£1.80m ,34,179,Midfielder - Attacking Midfield,left,Defensor Sporting Club,27,2,3,1491,8,1,0,286,21,2,2,943,28,10,5,2100,42,11,3,2583,34,11,5,2574,16,0,2,846,12,0,0,501,32,7,5,2665,LaLiga,12,2,0,427,nan,nan,nan,nan
13/6/2011,José Callejón,67011213,796,2/11/1987,24,0,0,4,1,5000,7250,7250,157,146,-1,179,73,AM/S RL,3,3,3,1,1,3,2,4,1,2,2,10,13,15,13,11,9,10,11,8,5,12,13,6,15,9,12,14,13,13,12,12,10,16,9,15,8,12,15,15,14,12,10,12,13,14,20,13,13,13,7,10,10,12,7,13,6,14,8,6,10,7,1,1,13,18,18,17,14,AM/S RL,625,1,1,20,14,17,18,1,1,1,1,1,13,13,1,1,8.79609E+12,0,0,0,0,1,0,0,0,0,0,0,0,0,1,0,0,0,0,0,0,0,0,0,0,0,0,0,0,0,0,0,0,0,0,0,0,0,0,0,0,0,0,0,1,0,0,0,0,José Callejón,£7.20m ,33,178,Forward - Right Winger,right,ACF Fiorentina,38,6,10,2982,36,13,2,1333,41,7,5,2037,52,20,11,4055,59,12,7,4337,47,13,7,3389,49,17,15,4146,50,12,13,4163,47,4,15,3708,LaLiga,45,4,10,3001,2,0,0,78
13/6/2011,Jonathan Pereira,7458328,796,5/12/1987,24,0,0,1,0,4500,6550,6550,152,130,6963489,166,61,AM/S LC,2,3,3,1,3,2,2,6,2,3,1,7,12,16,13,14,8,5,6,6,4,13,12,6,17,8,11,8,12,10,14,11,13,17,4,15,4,13,12,16,15,5,4,14,13,16,20,11,4,11,5,14,8,15,15,15,12,13,14,15,12,6,1,1,9,17,12,17,17,AM/S LC,624,1,1,20,17,17,12,1,1,1,1,1,9,5,1,1,5.49756E+11,0,0,0,0,1,0,0,0,0,0,0,0,0,0,0,0,0,0,0,0,0,0,0,0,0,0,0,0,0,0,0,0,0,0,0,0,0,0,0,1,0,0,0,0,0,0,0,0,Jonathan Pereira,£2.25m ,33,167,Forward - Centre-Forward,right,Without Club,19,3,0,850,31,4,7,1456,27,7,5,1480,34,4,8,1703,25,7,5,1221,36,9,6,2549,15,2,1,669,34,6,2,2003,31,2,3,1159,LaLiga,17,1,0,717,nan,nan,nan,nan
13/6/2011,Johannes van den Bergh,35006589,771,11/21/1986,24,0,0,0,0,4700,5850,5850,128,117,1661079,182,75,D/WB/M L,2,3,3,1,3,1,3,3,3,2,1,10,11,11,5,10,8,8,7,12,12,9,10,13,10,13,12,14,11,11,11,12,14,9,11,11,13,15,14,14,13,11,10,20,13,14,6,14,11,14,8,4,11,14,9,12,10,9,14,11,11,7,20,19,18,15,14,20,1,D/WB/M L,123,1,1,1,1,15,1,1,20,14,1,1,18,1,19,12,1.40737E+14,0,0,0,0,0,0,0,0,0,0,0,0,0,0,0,0,0,0,0,0,0,0,0,0,0,0,0,0,0,0,0,0,0,0,0,0,0,0,0,0,0,0,0,0,0,0,0,1,,,,,,,,,,,,,,,,,,,,,,,,,,,,,,,,,,,,,,,,,,,,,,,,,,,,
13/6/2011,Jérémy Ménez,8430773,769,5/7/1987,24,6,0,9,2,6050,7500,6750,165,150,33509036,181,77,AM RLC,2,1,2,1,1,1,2,1,3,2,2,10,13,17,10,15,12,12,12,5,3,14,11,3,17,10,12,11,13,10,14,12,14,16,7,15,7,7,9,16,17,14,10,15,15,15,20,14,13,11,10,14,6,8,14,17,14,12,11,11,11,12,1,1,12,20,20,16,18,AM RLC,506,1,1,10,18,16,20,1,1,1,1,10,12,12,1,1,2.3222E+15,0,0,0,0,0,0,0,0,0,0,0,0,0,0,0,0,0,0,0,0,0,0,0,0,0,0,0,0,0,0,1,0,0,0,0,1,0,0,0,0,0,0,0,0,0,0,1,0,Jérémy Ménez,£16.20m ,33,182,Forward - Right Winger,right,Reggina 1914,43,4,5,2416,42,9,22,3504,42,8,12,2867,26,2,3,1032,34,16,4,2788,12,4,0,413,31,3,3,1731,25,5,5,1205,6,0,0,175,Ligue 1,19,5,4,1454,4,2,0,352
13/6/2011,Jean-Philippe Sabo,8428587,769,2/26/1987,24,0,0,0,0,3350,5100,5100,130,114,3137167,175,71,D/WB/M L,3,2,2,3,2,1,3,1,3,1,1,8,13,11,6,12,7,7,14,11,9,11,9,11,12,10,11,12,12,11,12,11,15,9,7,11,10,13,12,16,13,12,7,20,15,14,5,16,10,12,10,14,6,10,12,13,14,12,13,14,14,6,20,16,16,12,9,20,1,D/WB/M L,123,1,1,1,1,12,1,1,20,9,1,1,16,1,16,1,1,1,0,0,0,0,0,0,0,0,0,0,0,0,0,0,0,0,0,0,0,0,0,0,0,0,0,0,0,0,0,0,0,0,0,0,0,0,0,0,0,0,0,0,0,0,0,0,0,Jean-Philippe Sabo,£360Th. ,33,174,Defender - Left-Back,left,Retired,0,0,0,0,9,0,0,313,nan,nan,nan,nan,29,2,0,2365,28,3,4,2140,12,0,2,593,nan,nan,nan,nan,nan,nan,nan,nan,nan,nan,nan,nan,Ligue 1,nan,nan,nan,nan,nan,nan,nan,nan
13/6/2011,Jamie O'Hara,5113930,765,9/25/1986,24,0,0,7,0,4800,6400,6650,155,136,8050000,181,78,M LC,3,2,3,2,3,1,3,4,3,3,3,14,13,11,10,14,15,8,15,5,10,15,11,11,13,11,13,14,15,14,14,14,16,14,7,11,9,15,15,14,12,11,8,20,14,12,12,15,10,12,8,14,7,11,9,13,12,15,15,9,14,5,12,12,20,10,5,15,20,M LC,404,1,1,1,10,10,1,1,12,1,10,20,15,5,12,3,16384,0,0,0,0,0,0,0,0,0,0,0,0,0,0,1,0,0,0,0,0,0,0,0,0,0,0,0,0,0,0,0,0,0,0,0,0,0,0,0,0,0,0,0,0,0,0,0,0,Jamie O'Hara,£4.50m ,34,180,Midfielder - Central Midfield,left,Retired,14,3,1,1117,21,3,3,1730,21,0,4,1404,12,3,1,941,28,2,6,2442,39,1,3,2895,3,0,0,92,nan,nan,nan,nan,1,0,0,20,Premier League,0,0,0,0,nan,nan,nan,nan
13/6/2011,Ivo Ilicevic,8726196,761,11/14/1986,24,2,1,11,5,4900,6750,6750,153,141,57920353,174,65,AM RLC,2,3,3,1,2,3,1,1,2,2,3,10,13,15,13,16,10,8,17,6,5,12,14,5,15,7,9,14,13,8,8,8,6,17,5,9,5,6,11,17,18,8,7,18,10,16,20,12,7,7,15,14,14,13,13,15,9,13,8,5,7,14,1,1,14,20,18,20,16,AM RLC,506,1,1,10,16,20,18,1,1,1,1,1,14,13,1,1,5.5083E+11,1,1,0,0,0,0,0,0,1,0,0,0,0,0,0,0,0,0,0,0,0,0,0,0,0,0,0,0,0,0,1,0,0,0,0,0,0,0,0,1,0,0,0,0,0,0,0,0,Ivo Ilicevic,£4.05m ,33,174,Forward - Left Winger,right,Without Club,24,5,7,1980,24,4,1,1583,10,1,0,395,20,4,0,1154,14,1,1,1219,32,4,4,2272,32,7,5,1936,17,6,3,882,5,0,0,119,Bundesliga,nan,nan,nan,nan,nan,nan,nan,nan
13/6/2011,Itay Shechter,7868835,775,2/22/1987,24,8,2,16,5,5000,7250,7250,151,135,15063110,179,74,S RL,3,3,3,3,1,2,2,3,3,2,2,9,12,15,16,11,5,7,8,10,8,11,15,8,14,9,11,10,13,14,12,10,15,10,14,13,12,8,12,16,12,11,11,13,13,14,20,12,12,12,6,13,11,10,10,14,8,15,14,12,9,12,1,1,1,15,15,15,1,S RL,605,1,1,20,1,15,15,1,1,1,1,1,1,1,1,1,7.03689E+13,0,0,0,0,0,0,0,0,0,0,0,0,0,0,0,0,0,0,0,0,0,0,0,0,0,0,0,1,0,0,0,0,0,0,0,0,0,0,0,0,0,0,0,0,0,0,1,0,Itay Shechter,£1.80m ,33,178,Forward - Centre-Forward,both,Maccabi Tel Aviv,21,6,1,1429,26,4,0,1620,19,1,1,678,32,8,1,2067,30,5,0,1495,26,3,5,1958,47,19,9,3542,37,9,10,2527,40,8,10,2594,Bundesliga,37,6,1,1675,7,2,0,263
13/6/2011,Hulk,2105510,1651,7/25/1986,24,3,0,0,0,6450,7154,7950,175,159,35224606,182,75,AM/S RL,3,2,1,2,3,2,3,9,3,1,2,12,14,15,15,13,16,7,17,9,6,12,15,8,14,13,13,15,12,11,10,11,16,17,10,15,8,9,9,17,15,16,8,20,19,16,4,16,18,12,10,13,6,11,16,16,15,12,14,10,7,10,1,1,1,20,20,20,10,AM/S RL,515,1,1,17,10,20,20,1,1,1,1,1,1,1,1,1,3.58544E+13,0,0,0,0,0,0,0,0,0,1,0,0,0,0,0,0,0,0,0,0,0,0,0,0,0,0,0,0,0,0,0,0,0,0,1,1,1,0,0,1,0,0,0,0,0,1,0,0,Hulk,£30.60m ,34,180,Forward - Right Winger,left,Shanghai SIPG,53,35,27,4402,39,21,14,3162,33,13,7,2753,34,21,13,2847,45,21,15,3757,47,27,26,4074,44,30,25,3958,35,17,17,3081,37,17,10,3161,Liga NOS,14,7,1,1093,nan,nan,nan,nan
13/6/2011,Hélder Barbosa,744575,788,5/25/1987,24,0,0,3,0,3500,5850,5850,138,123,2792125,172,67,AM L,1,2,2,1,2,3,3,1,3,3,1,14,15,16,10,14,10,5,12,5,4,11,12,5,15,14,13,13,8,8,17,9,16,16,10,15,8,9,14,15,14,8,6,20,13,15,4,9,7,10,7,10,10,7,13,15,15,14,14,12,10,7,1,1,1,20,5,20,10,AM L,503,1,1,10,10,20,5,1,1,1,1,1,1,1,1,1,7.04208E+13,1,0,0,1,0,0,0,0,0,1,0,0,0,0,0,0,0,0,0,0,0,0,0,0,0,0,0,0,0,1,0,0,0,0,1,1,0,0,0,0,0,0,0,0,0,0,1,0,Hélder Barbosa,£3.60m ,33,172,Forward - Left Winger,left,Hatayspor,29,4,5,1064,44,12,2,3101,30,2,0,1587,31,1,0,1180,34,6,12,2690,34,9,5,2544,14,0,2,671,25,2,1,1483,41,5,5,2928,Liga NOS,29,3,1,862,4,1,0,183
13/6/2011,Hatem Ben Arfa,919707,769,3/7/1987,24,8,2,4,0,5900,6569,7000,170,146,28516283,178,65,AM RLC,2,1,2,3,3,2,2,3,1,2,2,12,12,16,9,16,13,7,13,6,2,14,14,3,18,8,13,9,13,10,15,10,14,17,6,14,5,8,9,17,15,14,9,20,14,15,15,13,8,10,8,14,8,8,6,17,11,6,7,12,12,16,1,1,10,20,16,16,20,AM RLC,506,1,1,1,20,16,16,1,1,1,1,10,8,8,1,1,35433481220,0,0,1,0,0,0,0,0,0,0,1,0,0,0,0,0,0,0,0,0,0,0,0,0,0,0,0,0,0,0,1,0,0,0,0,1,0,0,0,0,0,0,0,0,0,0,0,0,Hatem Ben Arfa,£12.15m ,33,179,Midfielder - Attacking Midfield,left,FC Girondins Bordeaux,6,1,1,274,30,6,6,1879,22,4,3,1591,30,3,7,1450,10,1,1,564,37,18,7,3100,32,4,7,1136,nan,nan,nan,nan,41,9,6,3230,Premier League,5,0,0,158,2,0,1,149
13/6/2011,Grégory Gendrey,18054719,917498,10/7/1986,24,1,0,0,0,1500,3689,2050,94,82,8981,181,0,M/AM L,2,3,2,1,1,1,2,3,2,3,2,11,13,8,6,9,9,4,5,4,7,8,9,10,13,3,10,4,13,11,11,8,8,17,8,11,9,10,11,13,10,8,8,10,9,11,20,7,4,10,13,9,5,10,5,13,13,14,13,6,13,13,1,1,16,20,1,20,12,M/AM L,523,1,1,1,12,20,1,1,1,1,1,12,16,1,1,1,0,0,0,0,0,0,0,0,0,0,0,0,0,0,0,0,0,0,0,0,0,0,0,0,0,0,0,0,0,0,0,0,0,0,0,0,0,0,0,0,0,0,0,0,0,0,0,0,0,,,,,,,,,,,,,,,,,,,,,,,,,,,,,,,,,,,,,,,,,,,,,,,,,,,,
13/6/2011,Graham Dorrans,5207960,793,5/5/1987,24,5,0,6,0,5000,7000,6600,148,137,6702114,181,73,M/AM RLC,3,3,3,2,1,3,2,5,2,2,2,11,12,14,12,13,13,9,13,6,10,14,11,9,14,9,12,11,13,12,14,15,16,13,12,15,12,14,15,14,13,13,8,12,14,14,20,14,10,13,8,10,5,14,17,13,14,13,15,11,13,3,1,2,20,20,15,15,20,M/AM RLC,416,1,1,10,20,15,15,1,1,1,14,20,15,15,1,2,2.2606E+15,0,0,0,0,0,0,0,0,0,0,0,0,0,0,0,0,0,0,0,1,0,0,1,0,0,0,0,0,0,0,0,0,0,0,0,0,0,0,0,0,0,0,0,1,0,0,0,0,Graham Dorrans,£2.25m ,33,177,Midfielder - Central Midfield,right,Dundee FC,25,1,3,1778,37,4,3,2061,28,1,3,1940,17,2,0,1405,40,4,4,2794,27,0,3,1726,24,6,1,1925,20,5,4,1628,3,0,0,88,Premier League,23,1,5,2007,3,1,1,270
13/6/2011,Gonçalo Abreu,55009275,788,6/25/1986,24,0,0,0,0,1000,4500,4500,118,104,265157,190,81,AM RL,1,2,2,2,2,2,1,3,1,1,3,11,11,12,10,11,10,11,11,8,6,10,10,8,11,11,10,11,10,9,9,9,14,12,10,12,8,9,10,12,12,12,12,20,14,12,7,12,14,10,7,10,10,12,8,12,15,13,12,13,13,6,1,7,10,20,15,20,10,AM RL,505,1,1,10,10,20,15,1,1,1,1,1,10,1,7,1,0,0,0,0,0,0,0,0,0,0,0,0,0,0,0,0,0,0,0,0,0,0,0,0,0,0,0,0,0,0,0,0,0,0,0,0,0,0,0,0,0,0,0,0,0,0,0,0,0,Gonçalo Abreu,£405Th. ,34,190,Forward - Right Winger,right,Retired,24,4,0,1593,10,0,0,547,22,3,0,1631,1,0,0,24,41,5,5,3171,41,5,5,2481,42,9,7,3142,24,4,4,1666,10,0,1,325,Liga NOS,nan,nan,nan,nan,nan,nan,nan,nan
13/6/2011,Gervinho,8168166,24,5/27/1987,24,25,6,4,1,6450,7950,7150,175,159,127673584,179,68,AM RL,3,1,3,2,3,2,1,9,1,2,1,9,13,17,15,14,11,7,12,5,3,12,12,3,17,10,13,10,15,12,14,13,15,18,9,16,6,11,12,18,16,13,8,12,13,16,20,14,9,14,10,15,8,8,12,17,13,13,10,14,14,8,1,1,10,20,20,17,13,AM RL,505,1,1,14,13,17,20,1,1,1,1,1,10,10,1,1,2.25183E+15,0,0,0,0,1,0,0,0,0,0,1,0,0,0,0,0,0,0,0,0,1,0,0,0,0,0,0,0,0,0,0,0,0,0,0,1,0,0,0,0,0,0,0,0,0,0,0,0,Gervinho,£12.60m ,33,179,Forward - Left Winger,right,Parma Calcio 1913,50,18,11,3749,37,4,7,2323,26,7,5,1565,37,12,12,3010,34,7,6,2617,35,10,7,2636,4,1,1,257,7,0,3,598,30,11,3,2310,Premier League,32,9,4,2357,4,0,0,339
13/6/2011,Gabby Agbonlahor,5123498,765,10/13/1986,24,3,0,16,4,6050,7100,7100,155,146,16048831,180,79,AM/S RL,1,1,3,3,1,2,2,3,1,2,1,2,10,10,12,9,3,13,6,1,4,11,7,3,9,14,10,13,11,10,8,10,12,7,6,11,5,11,12,18,9,11,9,8,16,19,20,14,16,14,9,16,8,13,14,12,19,12,14,13,13,9,1,1,1,18,18,18,1,AM/S RL,625,1,1,20,1,18,18,1,1,1,1,1,1,1,1,1,134488080,0,0,0,0,1,0,0,0,0,0,0,0,0,1,0,0,0,0,1,0,0,0,0,0,0,0,0,1,0,0,0,0,0,0,0,0,0,0,0,0,0,0,0,0,0,0,0,0,Gabriel Agbonlahor,£10.80m ,34,183,Forward - Centre-Forward,right,Retired,32,5,2,1988,36,6,7,2968,34,12,6,2638,31,4,8,2513,36,6,1,2823,18,1,2,1195,17,1,2,763,6,1,1,284,nan,nan,nan,nan,Premier League,nan,nan,nan,nan,nan,nan,nan,nan
13/6/2011,Florian Müller,8718058,771,12/30/1986,24,0,0,0,0,2500,5250,5250,117,105,138167,180,69,D/WB/M RL,2,3,1,3,3,1,1,1,1,3,3,7,10,13,6,11,4,4,8,8,8,10,7,10,12,7,11,9,10,11,9,11,7,8,7,11,8,10,12,13,11,10,8,15,12,13,20,14,7,12,7,10,7,12,12,11,12,16,10,8,16,7,18,19,20,15,20,15,1,D/WB/M RL,435,1,1,1,1,12,15,1,1,18,1,1,15,20,1,19,0,0,0,0,0,0,0,0,0,0,0,0,0,0,0,0,0,0,0,0,0,0,0,0,0,0,0,0,0,0,0,0,0,0,0,0,0,0,0,0,0,0,0,0,0,0,0,0,0,,,,,,,,,,,,,,,,,,,,,,,,,,,,,,,,,,,,,,,,,,,,,,,,,,,,
13/6/2011,Faton Toski,35007441,771,2/17/1987,24,0,0,0,0,4250,5750,5750,129,115,2239965,185,78,M L,1,3,2,3,2,3,3,8,1,1,1,14,11,14,11,13,12,9,12,9,8,13,15,10,12,12,10,12,11,12,10,10,10,10,8,10,11,12,12,12,14,12,11,20,13,14,8,13,13,11,9,10,7,12,12,15,9,13,7,13,8,16,1,15,20,9,1,20,1,M L,403,1,1,1,1,9,1,1,1,1,1,1,20,1,15,1,0,0,0,0,0,0,0,0,0,0,0,0,0,0,0,0,0,0,0,0,0,0,0,0,0,0,0,0,0,0,0,0,0,0,0,0,0,0,0,0,0,0,0,0,0,0,0,0,0,,,,,,,,,,,,,,,,,,,,,,,,,,,,,,,,,,,,,,,,,,,,,,,,,,,,
13/6/2011,Fatih Duran,35009352,799,2/28/1987,24,0,0,0,0,750,4150,4150,90,83,27227,171,70,M/AM L,3,3,3,1,3,2,2,1,1,3,1,7,9,9,12,6,8,4,11,8,8,9,3,8,8,10,11,9,11,9,9,12,11,8,9,9,6,11,14,12,12,12,2,20,17,12,10,11,4,8,9,10,10,10,5,9,13,18,15,12,5,13,11,1,20,17,1,20,1,M/AM L,413,1,1,15,1,17,1,1,11,1,1,1,20,1,1,1,0,0,0,0,0,0,0,0,0,0,0,0,0,0,0,0,0,0,0,0,0,0,0,0,0,0,0,0,0,0,0,0,0,0,0,0,0,0,0,0,0,0,0,0,0,0,0,0,0,,,,,,,,,,,,,,,,,,,,,,,,,,,,,,,,,,,,,,,,,,,,,,,,,,,,
13/6/2011,Fabrice Begeorgi,8428579,769,4/20/1987,24,0,0,0,0,4100,5100,5100,130,113,3288252,177,70,D/WB/M/AM L,3,2,3,3,2,1,1,3,3,1,2,14,11,13,8,13,11,7,12,9,3,11,12,4,13,9,9,9,12,12,11,12,15,11,7,14,7,10,13,15,14,12,8,20,13,14,5,13,9,11,9,15,8,8,10,14,12,11,14,14,14,5,20,16,16,18,12,20,1,D/WB/M/AM L,133,1,1,10,1,18,12,1,20,2,1,1,16,12,16,1,0,0,0,0,0,0,0,0,0,0,0,0,0,0,0,0,0,0,0,0,0,0,0,0,0,0,0,0,0,0,0,0,0,0,0,0,0,0,0,0,0,0,0,0,0,0,0,0,0,Fabrice Begeorgi,£360Th. ,33,177,Defender - Left-Back,right,ES Fosséenne,37,0,2,2634,3,0,0,246,10,0,0,293,16,0,0,1138,25,0,0,2081,11,1,0,862,19,2,0,1674,nan,nan,nan,nan,11,0,0,769,Ligue 1,nan,nan,nan,nan,nan,nan,nan,nan
13/6/2011,Erik Jendrisek,7563339,794,10/26/1986,24,26,3,0,0,4950,6500,6000,137,125,1380789,176,74,AM/S L,2,3,1,2,2,3,1,6,2,1,1,4,12,13,10,13,7,10,9,2,6,12,7,8,14,5,12,9,8,10,8,9,11,10,9,14,7,10,18,17,15,13,8,20,13,15,7,17,11,14,2,14,2,13,12,15,13,13,14,13,12,6,1,1,1,16,1,16,14,AM/S L,623,1,1,20,14,16,1,1,1,1,1,1,1,1,1,1,17180409872,0,0,0,0,1,0,0,0,0,0,0,0,0,0,1,0,0,0,0,1,0,0,0,0,0,0,0,0,0,0,0,0,0,0,1,0,0,0,0,0,0,0,0,0,0,0,0,0,Erik Jendrisek,£900Th. ,34,176,Forward - Centre-Forward,left,Volos NPS,13,0,1,484,20,2,4,768,12,0,2,571,32,2,3,2055,35,10,2,2598,38,14,2,3042,34,1,1,2150,33,12,0,2475,25,8,1,1968,Bundesliga,25,4,0,1572,2,0,0,20
13/6/2011,Eljero Elia,859944,784,2/13/1987,24,22,2,7,1,7550,7250,7700,166,153,20307499,176,75,AM RL,2,2,3,1,3,2,2,6,3,1,3,10,12,18,13,18,8,5,12,7,5,11,10,6,17,8,9,7,13,6,15,14,5,19,4,8,5,5,16,18,17,16,7,8,12,18,20,13,11,7,5,12,14,14,10,16,7,9,6,13,10,15,1,1,14,20,15,20,10,AM RL,505,1,1,14,10,20,15,1,1,1,1,1,14,12,1,1,5.84116E+11,1,1,0,0,0,0,0,0,0,0,0,0,0,0,1,0,0,0,0,0,0,0,0,0,0,0,0,0,0,0,0,0,0,0,0,1,0,0,0,1,0,0,0,0,0,0,0,0,Eljero Elia,£4.50m ,33,176,Forward - Left Winger,right,FC Utrecht,25,2,3,1736,10,0,1,359,25,1,3,1798,33,4,4,2019,27,2,1,1561,41,10,6,3184,32,10,8,2350,32,8,5,2176,24,1,1,1254,Serie A,30,3,2,1677,4,0,0,54
13/6/2011,Edu Oriol,67006859,796,11/5/1986,24,0,0,0,0,3700,6200,6200,132,122,2957369,177,72,M/AM RL,2,3,3,2,2,3,3,1,1,2,1,8,13,12,7,10,6,6,10,5,9,11,8,11,12,9,10,12,11,12,11,10,10,11,6,13,9,13,13,15,14,7,9,11,14,14,20,13,10,8,8,10,5,11,16,11,14,8,15,11,7,8,11,15,16,20,20,18,10,M/AM RL,525,1,1,12,10,18,20,1,1,11,1,1,16,16,1,15,0,0,0,0,0,0,0,0,0,0,0,0,0,0,0,0,0,0,0,0,0,0,0,0,0,0,0,0,0,0,0,0,0,0,0,0,0,0,0,0,0,0,0,0,0,0,0,0,0,Edu Oriol,£900Th. ,33,177,Forward - Left Winger,both,Atlético Sanluqueño,31,6,0,2048,22,2,0,1090,23,0,1,992,25,5,0,1114,24,2,0,1635,13,0,2,852,5,0,0,256,nan,nan,nan,nan,34,6,0,2725,LaLiga,13,0,0,1021,2,0,0,180
13/6/2011,Dominik Müller,91017498,771,4/19/1987,24,0,0,0,0,500,3400,3400,80,68,127206,190,0,M L,2,3,1,3,1,2,1,1,3,3,2,7,9,10,3,11,8,7,9,5,8,6,3,6,10,8,10,9,10,10,9,8,10,4,5,6,5,12,14,13,11,13,14,20,12,11,2,12,5,8,8,10,12,10,9,11,5,11,16,15,11,8,15,9,20,9,1,20,1,M L,403,1,1,1,1,9,1,1,15,1,1,1,20,1,9,1,0,0,0,0,0,0,0,0,0,0,0,0,0,0,0,0,0,0,0,0,0,0,0,0,0,0,0,0,0,0,0,0,0,0,0,0,0,0,0,0,0,0,0,0,0,0,0,0,0,,,,,,,,,,,,,,,,,,,,,,,,,,,,,,,,,,,,,,,,,,,,,,,,,,,,
13/6/2011,Djalma,55008689,6,5/30/1987,24,10,0,0,0,3250,6450,6350,141,129,3505569,175,76,AM RL,2,1,2,1,1,1,2,2,3,1,3,11,12,14,12,11,9,7,9,7,7,10,10,8,12,10,10,10,11,10,10,11,13,16,10,13,8,9,9,14,13,11,7,15,12,14,20,11,9,11,7,10,6,10,14,14,14,13,14,15,15,5,1,1,5,20,20,20,10,AM RL,505,1,1,5,10,20,20,1,1,1,1,5,5,5,1,1,0,0,0,0,0,0,0,0,0,0,0,0,0,0,0,0,0,0,0,0,0,0,0,0,0,0,0,0,0,0,0,0,0,0,0,0,0,0,0,0,0,0,0,0,0,0,0,0,0,Djalma,£3.15m ,33,176,Forward - Right Winger,right,SC Farense,33,5,6,2476,19,3,3,946,24,5,10,1777,30,7,5,2298,32,4,3,1952,28,7,8,2323,44,5,5,3212,32,7,3,1998,31,4,5,2501,Liga NOS,28,7,4,1437,nan,nan,nan,nan
13/6/2011,Dimitri Payet,8442349,769,3/29/1987,24,3,0,12,4,5800,7150,6450,165,143,17753000,174,70,AM RL,1,2,1,3,1,3,2,9,2,2,3,12,11,15,12,14,14,7,14,6,3,12,12,4,16,8,12,9,13,11,13,12,15,14,6,13,6,11,13,16,15,12,7,16,14,14,20,13,11,12,8,16,9,8,11,16,12,10,9,14,14,13,1,1,13,20,20,18,14,AM RL,505,1,1,12,14,18,20,1,1,1,1,10,13,13,1,1,2.26998E+15,0,0,0,0,0,0,0,0,0,0,0,0,0,0,0,0,0,0,0,0,0,0,0,0,0,0,0,0,0,0,0,0,0,0,0,1,0,0,0,1,0,0,0,0,1,0,0,0,Dimitri Payet,£7.65m ,33,175,Forward - Left Winger,right,Olympique Marseille,34,13,6,2613,43,6,8,2301,52,13,23,4206,45,8,8,3063,38,7,21,3203,38,12,15,3223,39,8,11,3153,47,10,23,3536,38,6,8,2461,Ligue 1,27,12,6,2400,6,1,1,424
13/6/2011,Davide Lanzafame,1414503,776,2/9/1987,24,0,0,7,1,4000,6200,6200,140,124,1618130,180,75,M/AM/S RL,1,2,1,3,3,2,3,6,1,2,1,12,13,13,12,12,12,12,4,7,7,12,11,10,14,11,11,12,10,8,9,11,8,11,9,12,8,13,13,13,12,10,11,10,16,15,20,13,11,8,5,12,3,12,6,12,8,14,12,7,10,5,1,1,16,20,20,18,8,M/AM/S RL,535,1,1,16,8,18,20,1,1,1,1,1,16,16,1,1,0,0,0,0,0,0,0,0,0,0,0,0,0,0,0,0,0,0,0,0,0,0,0,0,0,0,0,0,0,0,0,0,0,0,0,0,0,0,0,0,0,0,0,0,0,0,0,0,0,Davide Lanzafame,£900Th. ,33,180,Forward - Centre-Forward,right,Adana Demirspor,22,0,0,805,13,2,0,505,28,7,6,1744,nan,nan,nan,nan,25,1,3,1589,35,1,5,1993,27,12,6,2313,41,22,15,3660,34,17,8,2614,Serie A,35,15,3,2656,5,0,0,70
13/6/2011,Dani Benítez,7458304,796,4/7/1987,24,0,0,0,0,3000,6500,6500,160,133,2140468,181,69,M/AM L,2,3,1,2,1,2,2,5,2,2,2,12,14,14,10,14,16,7,14,5,7,15,7,5,15,13,12,12,11,10,12,11,12,15,7,15,10,9,12,16,14,12,10,20,15,15,6,14,10,11,12,12,4,12,5,16,10,12,12,5,10,7,1,1,20,20,1,20,1,M/AM L,413,1,1,1,1,20,1,1,1,1,1,1,20,1,1,1,3.63526E+13,1,0,0,0,0,0,0,0,0,0,0,1,0,0,0,0,0,0,0,0,0,0,0,0,0,0,0,0,0,0,0,0,0,0,0,0,1,0,0,0,1,0,0,0,0,1,0,0,Dani Benítez,£2.25m ,33,182,Forward - Left Winger,left,UD Poblense,41,12,0,3531,32,0,4,2512,11,1,3,897,10,0,1,454,nan,nan,nan,nan,nan,nan,nan,nan,24,6,0,1617,26,3,6,1851,7,0,0,440,LaLiga,1,0,0,80,1,0,0,78
13/6/2011,Constant Djakpa,53000035,24,10/17/1986,24,2,0,15,5,3750,6400,6200,134,124,2409681,177,71,D/WB/M/AM L,2,3,2,1,3,2,2,1,1,2,2,12,14,14,8,12,13,8,14,7,8,12,13,10,15,14,7,10,11,8,11,11,12,13,10,16,8,13,14,16,13,11,10,20,12,14,9,12,12,11,6,14,7,8,15,15,11,12,13,15,10,3,18,20,19,18,1,20,1,D/WB/M/AM L,243,1,1,1,1,18,1,1,18,1,1,1,19,1,20,1,768,0,0,0,0,0,0,0,0,1,1,0,0,0,0,0,0,0,0,0,0,0,0,0,0,0,0,0,0,0,0,0,0,0,0,0,0,0,0,0,0,0,0,0,0,0,0,0,0,,,,,,,,,,,,,,,,,,,,,,,,,,,,,,,,,,,,,,,,,,,,,,,,,,,,
13/6/2011,Chinedu Ede,8728342,771,2/5/1987,24,0,0,5,0,3750,5550,5550,123,111,1393417,179,78,M/AM L,1,2,2,3,1,1,1,1,3,2,3,7,10,13,7,11,7,6,5,6,5,10,11,5,12,8,7,8,11,9,10,10,11,14,6,10,4,8,15,14,17,8,8,20,13,15,16,10,10,10,5,9,13,10,12,10,12,12,11,15,15,5,1,1,17,20,1,20,1,M/AM L,523,1,1,15,1,20,1,1,1,1,1,1,17,1,1,1,134225921,1,0,0,0,0,0,0,0,0,0,0,0,0,1,0,0,0,0,0,0,0,0,0,0,0,0,0,1,0,0,0,0,0,0,0,0,0,0,0,0,0,0,0,0,0,0,0,0,,,,,,,,,,,,,,,,,,,,,,,,,,,,,,,,,,,,,,,,,,,,,,,,,,,,
13/6/2011,Chhunly Pagenburg,8728473,771,11/10/1986,24,0,0,0,0,1800,4700,4700,114,94,252533,177,74,AM/S RL,1,1,2,2,3,2,2,3,3,2,1,6,10,12,9,10,4,4,4,2,1,9,8,3,11,7,8,8,5,5,6,5,7,11,5,11,2,7,8,15,14,6,5,6,10,15,20,8,5,2,5,10,7,11,7,5,18,7,5,11,15,12,1,1,13,20,20,16,14,AM/S RL,515,1,1,16,14,16,20,1,1,1,1,10,11,13,1,1,0,0,0,0,0,0,0,0,0,0,0,0,0,0,0,0,0,0,0,0,0,0,0,0,0,0,0,0,0,0,0,0,0,0,0,0,0,0,0,0,0,0,0,0,0,0,0,0,0,,,,,,,,,,,,,,,,,,,,,,,,,,,,,,,,,,,,,,,,,,,,,,,,,,,,
13/6/2011,Bradley Johnson,5133341,765,4/28/1987,24,0,0,0,0,4000,6000,6250,137,120,4528915,178,69,M LC,1,3,2,2,3,2,3,2,3,1,2,11,14,12,13,12,13,16,17,6,10,13,13,10,11,14,12,11,13,14,11,12,11,12,8,12,14,16,16,13,12,13,15,20,13,13,7,16,13,11,14,12,8,13,10,15,10,12,13,8,10,9,7,7,20,12,7,17,20,M LC,404,1,1,1,1,12,1,1,7,1,1,20,17,7,7,1,131840,0,0,0,0,0,0,0,0,1,1,0,0,0,0,0,0,0,1,0,0,0,0,0,0,0,0,0,0,0,0,0,0,0,0,0,0,0,0,0,0,0,0,0,0,0,0,0,0,Bradley Johnson,£1.80m ,33,178,Midfielder - Central Midfield,right,Blackburn Rovers,49,6,4,3982,30,2,6,2207,40,1,3,3497,36,3,1,2798,45,15,2,3887,38,5,2,3007,38,3,2,3268,35,4,5,2530,34,2,4,2607,Premier League,36,3,2,2458,8,3,0,720
13/6/2011,Bilal Çubukçu,8728340,799,5/16/1987,24,0,0,2,0,4450,5600,5700,129,114,997605,176,70,M LC,1,3,2,2,3,2,3,1,3,2,3,12,11,12,6,11,15,9,13,6,7,12,10,7,13,11,11,11,10,10,13,12,11,13,6,12,8,11,10,13,12,12,8,16,12,13,20,14,12,11,14,10,4,11,5,9,5,5,9,6,6,1,1,1,20,15,1,16,20,M LC,404,1,1,1,15,15,1,1,1,1,14,20,16,1,1,1,0,0,0,0,0,0,0,0,0,0,0,0,0,0,0,0,0,0,0,0,0,0,0,0,0,0,0,0,0,0,0,0,0,0,0,0,0,0,0,0,0,0,0,0,0,0,0,0,0,,,,,,,,,,,,,,,,,,,,,,,,,,,,,,,,,,,,,,,,,,,,,,,,,,,,
13/6/2011,Benjamin Boltze,8720215,771,6/24/1986,24,0,0,0,0,750,4000,4000,95,80,25230,176,70,M/AM RL,2,2,2,1,3,1,3,2,2,1,1,12,13,12,9,10,13,8,6,4,3,9,7,5,10,9,7,9,7,8,11,9,12,11,6,10,5,8,9,11,10,11,9,20,11,11,16,9,7,7,5,9,6,16,11,13,7,11,13,14,15,8,1,1,18,20,20,17,14,M/AM RL,525,1,1,14,14,17,20,1,1,1,1,11,16,18,1,1,5.49756E+11,1,1,0,0,0,0,0,0,0,0,0,0,0,0,0,0,0,0,0,0,0,0,0,0,0,0,0,0,0,0,0,0,0,0,0,0,0,0,0,1,0,0,0,0,0,0,0,0,Benjamin Morel,£135Th. ,33,181,Forward - Right Winger,left,USON Mondeville,8,0,0,238,15,2,0,730,6,0,0,182,nan,nan,nan,nan,38,7,3,2489,22,2,2,1584,14,3,1,1065,nan,nan,nan,nan,nan,nan,nan,nan,Ligue 1,nan,nan,nan,nan,nan,nan,nan,nan
13/6/2011,Ashkan Dejagah,894133,771,7/5/1986,24,0,0,20,4,4750,6500,6500,141,134,6020258,181,80,AM RL,2,2,1,1,3,3,3,1,3,3,2,12,13,14,12,17,11,11,14,6,6,13,12,6,15,16,7,15,8,7,7,6,16,17,8,13,5,4,15,16,16,15,13,16,10,14,20,13,11,10,13,11,8,15,10,12,7,15,10,7,8,17,1,1,14,20,20,16,14,AM RL,505,1,1,14,14,16,20,1,1,1,1,5,12,14,1,1,7.04042E+13,0,1,0,0,0,0,0,0,0,1,0,0,0,0,0,0,0,0,0,0,0,0,0,0,0,0,0,0,0,0,1,0,0,0,0,1,0,0,0,0,0,0,0,0,0,0,1,0,Ashkan Dejagah,£4.50m ,34,181,Forward - Right Winger,right,Tractor FC,23,3,1,1072,27,3,10,2044,26,0,4,1500,25,6,2,1536,23,5,0,1670,15,2,0,1327,4,0,0,142,1,0,0,14,25,6,4,2092,Bundesliga,8,0,0,511,nan,nan,nan,nan
13/6/2011,Arda Turan,8476193,799,1/30/1987,24,44,11,2,0,6750,7750,7500,171,150,24000000,176,72,AM RLC,2,3,2,3,3,1,3,7,2,3,2,14,14,17,12,15,13,13,12,6,6,15,13,12,18,13,15,13,17,12,17,16,12,17,12,13,9,12,13,13,13,14,8,13,9,12,20,10,11,13,10,16,10,15,7,16,13,14,12,12,9,13,3,10,12,20,15,19,20,AM RLC,506,1,1,12,20,19,15,1,3,3,3,10,12,10,10,10,1.42824E+11,0,0,0,0,0,0,0,0,0,0,0,0,0,0,0,0,0,0,0,0,0,0,0,0,1,0,0,0,0,0,1,0,1,0,0,0,0,1,0,0,0,0,0,0,0,0,0,0,Arda Turan,£13.95m ,33,177,Forward - Left Winger,right,Galatasaray SK,19,6,3,1393,45,5,12,3036,41,5,8,2915,46,9,6,2991,46,3,6,3384,25,2,4,1200,30,13,7,1847,11,2,1,623,16,0,3,793,LaLiga,12,0,0,297,7,0,0,300
13/6/2011,Anton Putsila,7485429,758,6/10/1987,24,21,4,11,1,5250,7260,6500,147,132,5425632,180,74,M/AM LC,3,3,3,1,2,1,3,4,3,3,3,14,12,16,12,14,14,8,10,10,7,14,13,11,16,15,10,14,11,10,14,8,14,14,11,12,10,13,13,14,15,12,12,20,15,14,10,14,11,8,7,14,4,15,8,11,11,14,16,11,14,11,1,1,20,20,14,16,20,M/AM LC,414,1,1,13,20,16,14,1,1,1,10,20,16,13,1,1,2.63883E+13,0,0,1,0,0,0,0,0,0,0,0,0,0,0,0,0,0,0,0,0,1,0,0,0,0,0,0,0,0,0,0,0,0,0,0,0,0,0,0,0,0,0,0,1,1,0,0,0,Anton Putsila,£2.03m ,33,180,Midfielder - Attacking Midfield,right,Altay SK,31,2,5,2260,19,0,1,1297,13,0,0,962,26,2,2,2052,20,4,1,1599,21,2,2,1333,19,1,0,1047,25,4,6,1933,22,0,5,1507,Bundesliga,32,5,4,2695,2,0,0,180
13/6/2011,Andrew Taylor,5113373,765,8/1/1986,24,0,0,13,0,3250,5750,5750,127,115,2749549,178,69,D/WB L,1,1,3,2,3,2,3,7,3,3,1,11,11,7,5,8,9,13,9,14,13,11,9,14,11,19,13,15,8,9,10,9,12,6,11,13,12,17,18,13,13,14,8,20,13,12,9,16,13,9,14,11,13,13,17,5,19,5,10,12,6,10,19,20,15,11,1,20,12,D/WB L,223,1,1,1,1,11,1,1,19,1,13,12,15,1,20,1,32,0,0,0,0,0,1,0,0,0,0,0,0,0,0,0,0,0,0,0,0,0,0,0,0,0,0,0,0,0,0,0,0,0,0,0,0,0,0,0,0,0,0,0,0,0,0,0,0,,,,,,,,,,,,,,,,,,,,,,,,,,,,,,,,,,,,,,,,,,,,,,,,,,,,
13/6/2011,Andrew Surman,5109929,765,8/20/1986,24,0,0,4,1,3400,5750,5850,140,124,3672321,178,73,D/M LC,1,2,1,3,1,3,2,2,3,2,3,10,12,11,11,13,13,10,13,4,10,14,12,11,13,9,12,8,12,10,13,11,11,12,14,11,13,13,14,12,11,13,10,20,14,12,13,12,10,11,5,13,6,11,14,14,13,12,13,14,12,7,17,14,20,10,14,20,15,D/M LC,424,1,1,1,1,10,1,1,17,1,1,15,20,14,14,1,5.49756E+11,0,0,0,0,0,0,0,0,0,0,1,0,0,0,0,0,0,0,0,0,0,0,0,0,0,0,0,0,0,0,0,0,0,0,0,0,0,0,0,1,0,0,0,0,0,0,0,0,Andrew Surman,£2.25m ,34,178,Midfielder - Central Midfield,left,Without Club,22,3,4,1513,31,5,4,2455,7,0,1,516,39,0,3,2829,43,3,4,3750,38,0,3,3420,23,0,2,1892,28,2,5,2119,20,0,1,1618,Premier League,9,0,0,593,nan,nan,nan,nan
13/6/2011,Alexandre Cuvillier,34011429,769,6/17/1986,24,0,0,0,0,4400,5500,5500,135,123,1376636,182,69,AM L,1,3,1,3,2,3,1,1,2,2,1,12,13,15,8,14,13,9,11,7,3,12,10,3,14,11,10,12,10,11,13,11,14,13,7,13,8,14,16,15,14,13,10,20,14,14,5,13,9,12,8,15,7,6,8,16,12,12,8,13,11,11,1,1,15,20,1,20,1,AM L,503,1,1,12,1,20,1,1,1,1,1,1,15,1,1,1,17179869441,1,0,0,0,0,0,0,0,1,0,0,0,0,0,0,0,0,0,0,0,0,0,0,0,0,0,0,0,0,0,0,0,0,0,1,0,0,0,0,0,0,0,0,0,0,0,0,0,Alexandre Cuvillier,£900Th. ,34,182,Midfielder - Left Midfield,left,Without Club,28,2,1,1817,20,0,1,1150,34,7,3,2140,36,3,7,2795,17,1,0,1016,18,1,2,1174,nan,nan,nan,nan,3,0,0,97,nan,nan,nan,nan,Ligue 1,nan,nan,nan,nan,nan,nan,nan,nan
13/6/2011,Alexandre Bonnet,8447585,769,10/17/1986,24,0,0,4,1,4400,5550,5550,140,124,1395335,173,63,M/AM RL,2,1,1,2,3,3,3,1,1,1,1,13,13,13,7,13,11,5,12,6,2,12,10,4,15,6,10,9,13,13,13,12,15,12,6,11,7,11,12,16,13,9,6,20,13,15,10,14,6,13,6,14,7,8,7,15,12,12,14,14,12,10,1,1,18,20,16,20,14,M/AM RL,525,1,1,1,14,20,16,1,1,1,1,14,18,16,1,1,256,0,0,0,0,0,0,0,0,1,0,0,0,0,0,0,0,0,0,0,0,0,0,0,0,0,0,0,0,0,0,0,0,0,0,0,0,0,0,0,0,0,0,0,0,0,0,0,0,Alexandre Alphonse,£900Th. ,38,174,Forward - Centre-Forward,right,Retired,30,13,8,2125,29,5,3,2216,nan,nan,nan,nan,21,6,2,1545,27,6,0,1988,31,4,2,1474,31,6,5,2281,18,4,7,1294,27,11,4,1534,Ligue 1,nan,nan,nan,nan,nan,nan,nan,nan
13/6/2011,Alexander Baumjohann,8718228,771,1/23/1987,24,0,0,2,0,4850,6600,6700,146,134,2048083,178,73,AM RLC,2,2,3,3,3,2,3,4,3,2,1,13,12,15,7,17,10,9,14,8,4,16,13,6,17,6,12,6,10,7,17,9,5,16,4,8,5,5,6,16,17,9,7,17,13,14,20,11,7,5,8,14,12,12,8,16,8,15,7,12,12,6,1,1,15,20,20,15,18,AM RLC,506,1,1,8,18,15,20,1,1,1,1,10,10,15,1,1,5.50846E+11,0,0,1,0,0,0,0,1,0,0,0,0,0,0,0,0,0,0,0,0,0,0,0,0,1,0,0,0,0,0,1,0,0,0,0,0,0,0,0,1,0,0,0,0,0,0,0,0,Alexander Baumjohann,£1.13m ,33,178,Midfielder - Attacking Midfield,right,Sydney FC,17,0,3,969,17,0,5,705,28,6,11,2230,11,0,4,663,1,0,0,10,27,1,2,476,5,1,3,346,3,0,1,66,23,4,4,1641,Bundesliga,29,1,6,1973,nan,nan,nan,nan
13/6/2011,Aaron Lennon,5109664,765,4/16/1987,24,19,0,5,0,6300,7700,7550,158,150,47089082,169,67,M/AM RL,3,2,3,3,3,3,2,7,2,3,3,9,13,15,12,14,7,7,7,5,7,14,9,7,15,5,13,9,9,9,14,10,11,15,4,13,7,13,14,18,16,16,5,14,15,17,20,13,8,10,6,15,5,14,5,15,14,11,13,10,14,4,1,1,20,20,20,15,13,M/AM RL,415,1,1,8,13,15,20,1,1,1,1,10,15,20,1,1,2,0,1,0,0,0,0,0,0,0,0,0,0,0,0,0,0,0,0,0,0,0,0,0,0,0,0,0,0,0,0,0,0,0,0,0,0,0,0,0,0,0,0,0,0,0,0,0,0,Aaron Lennon,£14.40m ,33,165,Forward - Right Winger,right,Kayserispor,47,3,8,3350,32,4,8,2141,46,4,9,3679,33,1,5,2642,31,2,3,1810,31,6,2,2086,13,1,1,667,33,0,4,2113,22,1,1,1563,Premier League,19,0,1,734,3,0,0,112
13/6/2011,Aaron Hunt,894135,771,9/4/1986,24,2,0,13,3,5500,6800,6800,150,138,22926307,183,73,AM RLC,3,3,3,2,1,2,1,9,3,2,3,10,14,13,16,15,10,7,14,6,5,15,12,7,16,6,12,7,11,7,16,16,5,17,6,17,8,9,11,12,15,10,10,20,7,14,10,12,9,7,15,11,17,17,3,16,10,14,4,7,9,18,1,1,14,20,19,18,20,AM RLC,506,1,1,15,20,18,19,1,1,1,1,14,14,1,1,1,6.01296E+11,0,0,0,0,0,0,0,0,0,0,0,0,0,0,1,0,0,0,0,0,1,0,0,0,0,0,0,0,0,0,0,0,0,0,1,1,0,0,0,1,0,0,0,0,0,0,0,0,Aaron Hunt,£4.50m ,34,183,Midfielder - Attacking Midfield,left,Hamburger SV,38,3,4,2493,19,3,4,1671,29,11,4,2433,32,7,9,2796,22,4,1,822,23,1,3,1739,26,4,2,1575,30,3,2,2246,24,5,4,1676,Bundesliga,24,8,2,1725,5,1,1,344
13/6/2011,Yannick Djaló,744161,788,5/5/1986,25,1,0,14,1,4750,6600,6600,149,132,6105582,171,68,AM/S RL,1,2,3,2,2,1,1,2,2,3,2,11,12,14,11,12,9,6,11,7,7,10,10,7,14,10,10,11,7,9,9,8,14,16,10,15,8,9,12,16,14,10,7,10,16,15,20,12,11,10,6,13,6,12,13,16,15,14,13,14,14,6,1,1,1,20,20,17,10,AM/S RL,515,1,1,16,10,17,20,1,1,1,1,1,1,1,1,1,34360270860,0,0,1,1,0,0,0,0,0,0,0,0,0,1,0,0,0,0,0,1,0,0,0,0,0,0,0,0,0,0,0,0,0,0,0,1,0,0,0,0,0,0,0,0,0,0,0,0,Yannick Djaló,£4.05m ,34,171,Forward - Left Winger,right,Retired,33,9,2,2276,10,0,1,470,20,1,0,1033,18,3,1,1134,10,1,0,771,34,16,7,2378,nan,nan,nan,nan,19,4,0,955,nan,nan,nan,nan,Liga NOS,nan,nan,nan,nan,nan,nan,nan,nan
13/6/2011,Virgile Reset,7822441,769,8/3/1985,25,0,0,0,0,4100,5150,5150,125,115,2393489,175,65,AM/S L,1,3,3,2,2,3,2,1,3,1,3,10,12,14,9,12,9,6,9,5,2,12,10,4,14,8,11,8,11,10,12,11,13,13,7,13,6,10,13,12,14,12,7,8,14,16,20,13,7,12,8,14,8,8,13,14,12,12,15,14,14,7,1,1,15,20,14,20,1,AM/S L,513,1,1,16,1,20,14,1,1,1,1,1,15,14,1,1,2.2518E+15,0,0,0,0,0,0,0,0,0,0,0,0,0,0,0,0,0,0,0,0,0,0,0,0,0,0,0,0,0,0,0,0,0,0,0,0,0,0,0,0,0,0,0,0,0,0,0,0,,,,,,,,,,,,,,,,,,,,,,,,,,,,,,,,,,,,,,,,,,,,,,,,,,,,
13/6/2011,Vincent Bessat,8431098,769,11/8/1985,25,0,0,0,0,4100,5200,5200,125,116,2443811,178,73,M/AM L,1,3,3,1,2,3,1,6,1,1,3,13,12,11,7,11,11,6,14,5,6,11,9,7,13,11,11,12,12,12,11,10,14,11,7,12,7,11,14,15,14,11,8,20,14,14,8,13,11,12,11,14,8,10,13,12,12,9,12,12,10,10,10,10,18,20,1,20,12,M/AM L,523,1,1,1,1,20,1,1,10,1,10,12,18,1,10,1,1,1,0,0,0,0,0,0,0,0,0,0,0,0,0,0,0,0,0,0,0,0,0,0,0,0,0,0,0,0,0,0,0,0,0,0,0,0,0,0,0,0,0,0,0,0,0,0,0,,,,,,,,,,,,,,,,,,,,,,,,,,,,,,,,,,,,,,,,,,,,,,,,,,,,
13/6/2011,Ümit Korkmaz,16002799,755,9/17/1985,25,10,0,0,0,4250,6850,6350,134,127,3111095,174,72,M/AM RL,3,1,1,3,3,2,1,1,2,3,3,11,10,15,8,11,5,4,10,9,3,11,12,7,15,13,7,12,10,9,13,10,18,17,8,15,5,8,14,18,15,12,7,11,9,15,20,13,9,9,4,12,16,10,15,18,15,14,20,18,16,3,1,1,18,20,16,20,12,M/AM RL,525,1,1,1,10,20,16,1,1,1,1,12,18,14,1,1,7.15032E+13,1,0,0,0,0,0,0,0,0,0,0,0,0,0,0,0,0,0,0,0,0,0,0,0,0,0,0,0,0,1,0,0,0,0,0,1,0,0,0,0,1,0,0,0,0,0,1,0,,,,,,,,,,,,,,,,,,,,,,,,,,,,,,,,,,,,,,,,,,,,,,,,,,,,
13/6/2011,Tobias Werner,8720186,771,7/19/1985,25,0,0,0,0,3900,6000,6000,122,117,3042612,177,67,M/AM/S L,1,2,2,3,2,3,3,2,3,1,1,13,12,13,8,12,11,12,12,10,5,12,8,8,11,12,10,15,10,9,11,9,13,8,10,15,6,13,15,14,14,9,11,20,13,14,8,12,10,13,9,12,10,14,7,12,14,11,11,10,7,13,1,1,17,20,1,20,1,M/AM/S L,533,1,1,18,1,20,1,1,1,1,1,1,17,1,1,1,2.19916E+12,1,0,0,0,0,0,0,0,0,0,0,0,0,0,0,0,0,0,0,0,0,0,0,0,0,0,0,1,0,0,0,0,0,0,0,0,0,0,0,0,0,1,0,0,0,0,0,0,Tobias Werner,£900Th. ,35,174,Forward - Left Winger,left,Retired,24,5,3,1626,25,1,3,1411,33,5,8,2455,34,11,9,2312,32,8,5,2724,19,1,3,1050,7,0,0,324,28,2,5,1284,16,0,3,1284,Bundesliga,nan,nan,nan,nan,nan,nan,nan,nan
13/6/2011,Tobias Weis,8707889,771,7/30/1985,25,1,0,0,0,4750,6700,6700,143,136,5177769,170,68,M/AM RLC,2,3,1,2,1,3,2,1,1,3,2,11,12,13,5,12,8,6,6,8,18,13,10,12,14,19,11,20,7,10,12,9,18,13,10,14,8,14,18,17,18,15,5,15,12,13,20,16,8,9,15,10,13,17,4,13,10,10,11,12,8,14,1,1,20,18,20,18,19,M/AM RLC,416,1,1,12,14,14,18,1,1,1,14,19,18,20,1,1,16875650,0,1,0,0,0,0,0,1,0,0,0,0,0,0,0,1,1,0,0,0,0,0,0,0,1,0,0,0,0,0,0,0,0,0,0,0,0,0,0,0,0,0,0,0,0,0,0,0,Tobias Weis,£1.35m ,35,170,Midfielder - Central Midfield,both,Retired,20,0,0,1298,16,0,1,1206,22,2,4,1649,5,0,0,100,13,2,0,860,6,0,0,156,nan,nan,nan,nan,0,0,0,0,nan,nan,nan,nan,Bundesliga,nan,nan,nan,nan,nan,nan,nan,nan
13/6/2011,Timo Röttger,8718887,771,7/12/1985,25,0,0,0,0,2950,4850,4850,100,97,599718,176,76,AM/S RL,2,1,3,3,2,1,2,2,2,2,1,4,11,12,10,9,4,4,7,5,4,9,8,5,9,12,10,12,10,9,12,11,12,7,9,13,7,11,14,13,9,6,8,14,12,12,20,10,8,9,5,9,14,15,8,13,6,12,13,11,9,7,1,1,15,20,20,17,1,AM/S RL,515,1,1,16,1,17,20,1,1,1,1,1,13,15,1,1,134225920,0,0,0,0,0,0,0,0,0,0,0,0,0,1,0,0,0,0,0,0,0,0,0,0,0,0,0,1,0,0,0,0,0,0,0,0,0,0,0,0,0,0,0,0,0,0,0,0,,,,,,,,,,,,,,,,,,,,,,,,,,,,,,,,,,,,,,,,,,,,,,,,,,,,
13/6/2011,Tiago Targino,8875666,788,6/6/1986,25,0,0,6,1,3500,5750,6150,144,123,2166179,180,74,AM RL,1,3,1,3,3,2,3,2,3,3,3,13,12,14,10,12,10,7,9,7,5,10,10,4,14,7,7,9,8,9,8,10,14,15,7,15,7,8,12,16,15,7,8,17,14,15,20,7,6,9,6,13,8,13,5,15,14,15,13,15,14,8,1,1,5,20,20,15,14,AM RL,505,1,1,14,14,15,20,1,1,1,1,1,5,5,1,1,7.04031E+13,1,1,0,0,0,0,0,0,0,0,0,0,0,0,0,0,0,0,0,0,0,0,0,0,0,0,0,0,0,0,0,0,0,0,0,1,0,0,0,0,0,0,0,0,0,0,1,0,Tiago Targino,£1.53m ,34,180,Forward - Right Winger,right,Comércio e Indústria,21,3,2,1016,31,2,0,1936,33,4,1,1949,14,1,0,468,nan,nan,nan,nan,nan,nan,nan,nan,nan,nan,nan,nan,8,3,3,576,2,0,0,108,Liga NOS,nan,nan,nan,nan,nan,nan,nan,nan
13/6/2011,Tarmo Kink,7681332,766,10/6/1985,25,50,4,5,0,5150,5940,5400,130,108,3219726,183,74,AM RL,1,2,1,1,1,2,3,1,1,1,2,9,8,14,11,10,12,5,18,2,3,10,12,7,13,8,9,4,12,7,11,7,11,10,5,14,5,6,9,14,14,7,11,20,18,13,12,11,6,10,7,9,3,6,13,8,10,8,14,7,12,3,1,1,9,20,20,19,1,AM RL,505,1,1,15,1,19,20,1,1,1,1,1,1,9,1,1,7.09185E+13,0,0,0,0,0,0,0,0,0,1,0,0,0,0,0,0,0,0,0,0,0,0,0,0,0,0,0,0,0,0,0,0,0,0,0,0,0,0,0,1,0,0,0,0,0,0,1,0,,,,,,,,,,,,,,,,,,,,,,,,,,,,,,,,,,,,,,,,,,,,,,,,,,,,
13/6/2011,Sylvain Marveaux,914905,769,4/15/1986,25,0,0,11,4,4600,5750,6400,145,128,12192411,172,66,AM LC,3,2,1,3,2,1,1,1,3,3,1,13,14,14,11,14,14,7,12,9,2,14,10,4,15,7,12,9,12,12,15,11,14,13,7,13,5,12,10,15,15,12,6,20,9,14,10,12,7,12,7,16,15,12,11,16,14,14,8,14,14,11,8,8,15,20,1,20,17,AM LC,504,1,1,10,17,20,1,1,8,1,10,13,15,1,8,1,1,1,0,0,0,0,0,0,0,0,0,0,0,0,0,0,0,0,0,0,0,0,0,0,0,0,0,0,0,0,0,0,0,0,0,0,0,0,0,0,0,0,0,0,0,0,0,0,0,Sylvain Marveaux,£2.70m ,34,172,Midfielder - Attacking Midfield,left,FC Lorient,10,1,3,696,11,2,3,542,37,2,6,2037,12,0,0,475,33,3,6,2063,4,0,0,277,27,5,6,2164,28,7,5,2139,9,5,0,531,Premier League,21,4,1,956,4,0,0,83
13/6/2011,Stiven Rivic,8718324,761,8/9/1985,25,0,0,0,0,3500,6000,6000,138,120,1638467,181,79,AM RL,3,1,2,1,3,3,2,2,1,1,1,11,13,13,12,12,10,7,11,8,7,12,11,9,13,8,11,11,12,11,13,11,14,12,8,13,7,12,12,14,12,12,9,12,8,13,20,10,10,10,8,8,13,14,12,14,12,9,13,12,12,10,1,1,15,20,15,20,13,AM RL,505,1,1,13,13,20,15,1,1,1,1,1,15,15,1,1,0,0,0,0,0,0,0,0,0,0,0,0,0,0,0,0,0,0,0,0,0,0,0,0,0,0,0,0,0,0,0,0,0,0,0,0,0,0,0,0,0,0,0,0,0,0,0,0,0,,,,,,,,,,,,,,,,,,,,,,,,,,,,,,,,,,,,,,,,,,,,,,,,,,,,
13/6/2011,Sisi,7459916,796,4/22/1986,25,0,0,12,1,4250,6050,6050,143,124,633243,168,60,M/AM RL,1,1,1,1,2,3,1,5,3,1,1,11,12,15,8,11,12,4,10,6,6,12,10,5,15,10,8,13,12,12,13,14,15,15,7,15,7,12,13,16,16,7,5,5,15,15,20,14,6,14,8,14,13,14,12,15,16,13,16,15,14,6,1,1,16,20,20,15,10,M/AM RL,525,1,1,5,10,15,20,1,1,1,1,1,10,16,1,1,1.15105E+12,0,1,0,0,0,0,0,0,0,0,0,0,0,0,0,0,0,0,0,0,0,0,0,0,0,0,0,0,0,0,0,0,0,0,1,1,0,0,0,0,1,0,0,0,0,0,0,0,,,,,,,,,,,,,,,,,,,,,,,,,,,,,,,,,,,,,,,,,,,,,,,,,,,,
13/6/2011,Simon Vukcevic,5753466,62002127,1/29/1986,25,27,2,3,1,5250,8200,7150,160,143,6049138,179,78,AM LC,2,2,3,2,3,2,3,4,1,2,1,16,17,16,15,16,16,13,19,11,8,14,14,8,17,12,14,13,9,11,15,12,13,15,10,13,9,6,12,13,11,16,11,20,14,12,10,15,17,11,10,16,12,13,10,18,10,18,10,10,7,15,1,1,10,20,14,17,20,AM LC,504,1,1,5,20,17,14,1,1,1,1,8,10,1,1,1,7.10227E+13,0,0,1,0,0,0,0,0,0,0,0,0,0,0,0,0,0,0,0,0,0,0,0,0,0,0,0,0,0,0,1,0,0,0,0,1,1,0,0,1,0,0,0,0,0,0,1,0,Simon Vukcevic,£2.25m ,34,180,Forward - Right Winger,left,Retired,39,5,4,2149,11,2,2,684,14,0,0,607,18,0,3,888,29,2,5,2145,15,1,0,874,12,0,0,249,nan,nan,nan,nan,nan,nan,nan,nan,Premier League,nan,nan,nan,nan,nan,nan,nan,nan
13/6/2011,Senad Lulic,69002026,759,1/18/1986,25,8,0,0,0,4000,6500,6000,127,127,6059147,183,75,M/AM L,3,2,1,3,2,3,1,2,3,1,1,14,15,14,12,14,10,10,13,10,10,12,13,10,14,12,12,9,12,11,13,10,13,13,6,13,7,7,7,12,13,13,13,20,11,13,12,11,8,11,8,12,10,10,10,12,8,11,8,8,12,12,1,1,17,20,1,20,1,M/AM L,523,1,1,1,1,20,1,1,1,1,1,1,17,1,1,1,0,0,0,0,0,0,0,0,0,0,0,0,0,0,0,0,0,0,0,0,0,0,0,0,0,0,0,0,0,0,0,0,0,0,0,0,0,0,0,0,0,0,0,0,0,0,0,0,0,Senad Lulic,£6.75m ,34,183,Midfielder - Left Midfield,right,SS Lazio,44,9,9,3350,38,4,6,2868,50,3,8,3929,37,7,3,2934,29,4,9,2154,39,3,5,2924,35,3,9,2838,50,5,7,3294,46,4,1,3657,Serie A,27,1,2,1909,nan,nan,nan,nan
13/6/2011,Sebastian Heidinger,8728401,771,1/11/1986,25,0,0,0,0,2500,4850,4850,107,95,135976,174,70,M/AM RL,3,1,1,3,2,2,2,1,2,2,1,7,10,10,9,10,7,6,9,6,6,10,10,6,11,8,8,11,9,8,8,9,10,8,5,10,6,12,13,13,12,11,9,16,11,13,20,12,9,11,7,8,7,10,5,15,13,12,12,13,15,13,1,13,19,20,20,19,1,M/AM RL,525,1,1,1,1,17,20,1,1,1,1,1,19,14,13,13,0,0,0,0,0,0,0,0,0,0,0,0,0,0,0,0,0,0,0,0,0,0,0,0,0,0,0,0,0,0,0,0,0,0,0,0,0,0,0,0,0,0,0,0,0,0,0,0,0,,,,,,,,,,,,,,,,,,,,,,,,,,,,,,,,,,,,,,,,,,,,,,,,,,,,
13/6/2011,Sebastián Dubarbier,14001303,1649,2/19/1986,25,0,0,0,0,4400,5500,5500,140,122,3072126,179,74,AM L,3,2,3,2,1,1,3,8,1,1,1,11,13,13,8,13,11,6,11,8,4,11,11,4,13,10,11,10,11,11,11,10,15,14,6,13,5,7,12,16,14,12,8,20,12,15,10,12,11,13,10,12,8,14,9,14,13,14,12,12,11,6,1,1,15,20,12,20,1,AM L,503,1,1,13,1,20,12,1,1,1,1,1,15,12,1,1,134217728,0,0,0,0,0,0,0,0,0,0,0,0,0,0,0,0,0,0,0,0,0,0,0,0,0,0,0,1,0,0,0,0,0,0,0,0,0,0,0,0,0,0,0,0,0,0,0,0,Sebastián Dubarbier,£540Th. ,34,177,Defender - Left-Back,left,Without Club,23,1,0,1181,21,1,0,1338,39,3,3,3016,28,1,0,2329,33,0,1,2858,32,0,6,2731,21,2,6,1689,19,0,2,1176,1,0,0,90,Ligue 1,8,0,0,307,nan,nan,nan,nan
13/6/2011,Saúl,67000817,796,5/24/1986,25,0,0,0,0,3700,5550,5550,121,113,903796,178,78,S L,1,1,1,2,2,1,1,4,3,3,3,5,7,13,13,8,8,11,14,5,5,7,13,5,12,10,12,11,13,11,12,12,12,13,9,13,8,8,8,15,11,13,9,20,12,13,8,11,15,10,10,11,5,12,10,15,5,11,8,12,8,15,1,1,1,15,1,15,1,S L,603,1,1,20,1,15,1,1,1,1,1,1,1,1,1,1,512,0,0,0,0,0,0,0,0,0,1,0,0,0,0,0,0,0,0,0,0,0,0,0,0,0,0,0,0,0,0,0,0,0,0,0,0,0,0,0,0,0,0,0,0,0,0,0,0,Raúl,£4.50m ,43,178,Forward - Second Striker,both,Retired,51,19,10,4451,47,21,11,4139,22,9,0,1980,22,2,0,1812,32,9,3,2621,nan,nan,nan,nan,nan,nan,nan,nan,nan,nan,nan,nan,nan,nan,nan,nan,Bundesliga,nan,nan,nan,nan,nan,nan,nan,nan
13/6/2011,Salomon Kalou,859510,24,8/5/1985,25,39,12,0,0,7000,8000,7600,165,147,19368782,186,79,AM/S RL,3,2,3,1,1,1,3,2,3,2,1,7,12,13,11,14,9,13,10,4,8,10,16,7,10,7,16,13,11,14,13,8,16,13,8,15,12,11,12,16,17,13,12,12,16,15,20,15,12,7,6,14,5,13,15,17,10,12,14,15,17,12,1,1,10,20,18,20,12,AM/S RL,515,1,1,16,12,20,18,1,1,1,1,1,10,10,1,1,4.43254E+12,0,0,0,1,0,0,0,0,0,0,0,0,0,0,0,0,0,0,0,0,0,0,0,0,0,0,0,1,0,0,0,0,0,0,0,1,0,0,0,0,0,0,1,0,0,0,0,0,Salomon Kalou,£5.40m ,35,184,Forward - Left Winger,right,Botafogo de Futebol e Regatas,42,13,7,2178,26,5,3,1476,37,16,6,2900,40,18,5,3285,31,6,2,2099,37,17,2,2972,31,8,5,2490,36,12,3,2535,33,8,4,2573,Premier League,20,3,0,1074,nan,nan,nan,nan
13/6/2011,Ronny,8830378,1651,5/11/1986,25,0,0,0,0,4150,3500,5650,140,120,9056953,175,74,D L,1,2,2,2,1,3,3,1,3,3,2,12,13,14,9,14,15,11,15,12,10,14,13,11,15,10,11,10,13,11,14,10,11,11,9,14,10,11,12,15,13,14,11,20,15,14,3,15,14,12,9,13,8,10,11,10,12,14,14,14,14,4,20,12,15,1,1,20,1,D L,103,1,1,1,1,1,1,1,20,1,1,1,15,1,12,1,3.51844E+13,0,0,0,0,0,0,0,1,1,0,0,0,0,0,0,0,0,0,0,0,0,0,0,0,0,0,0,0,0,0,0,0,0,0,0,0,0,0,0,0,0,0,0,0,0,1,0,0,Ronny,£720Th. ,34,175,Midfielder - Attacking Midfield,left,1.FC Novi Pazar 95,23,2,5,1248,16,0,2,580,34,18,14,2631,28,4,4,1174,21,4,3,1066,3,0,0,209,nan,nan,nan,nan,nan,nan,nan,nan,nan,nan,nan,nan,Bundesliga,nan,nan,nan,nan,1,0,0,67
13/6/2011,Rodri,67006192,796,3/7/1986,25,0,0,0,0,2250,4750,4750,126,102,409016,175,70,M RLC,1,3,1,2,1,3,1,1,1,1,1,7,12,11,8,12,7,8,9,7,3,10,8,6,12,7,12,17,8,8,10,10,10,9,6,12,13,14,15,13,12,9,6,10,11,15,20,13,9,8,4,12,7,16,8,11,11,5,13,12,14,7,1,1,20,15,20,17,18,M RLC,406,1,1,10,15,9,10,1,1,1,10,18,17,20,1,1,0,0,0,0,0,0,0,0,0,0,0,0,0,0,0,0,0,0,0,0,0,0,0,0,0,0,0,0,0,0,0,0,0,0,0,0,0,0,0,0,0,0,0,0,0,0,0,0,0,Rodrigo,£6.30m ,29,182,Forward - Centre-Forward,left,Leeds United,24,3,1,928,38,16,4,1874,39,11,5,2140,42,18,8,2666,32,4,5,2161,38,7,3,2175,21,7,5,1588,44,19,7,2994,51,15,10,3775,Liga NOS,34,7,11,2506,7,1,0,410
13/6/2011,Robert Zillner,35005032,771,8/4/1985,25,0,0,0,0,1650,5750,5750,122,115,1767267,183,74,M/AM L,2,1,3,1,3,1,1,5,2,2,1,11,13,13,7,11,14,8,12,11,8,12,11,11,13,12,12,10,10,12,11,13,14,14,10,13,14,15,11,13,13,10,11,20,15,13,8,13,8,11,8,11,12,13,14,13,10,14,12,11,12,6,1,10,20,18,14,20,11,M/AM L,413,1,1,1,11,18,12,1,1,1,1,1,20,14,10,1,0,0,0,0,0,0,0,0,0,0,0,0,0,0,0,0,0,0,0,0,0,0,0,0,0,0,0,0,0,0,0,0,0,0,0,0,0,0,0,0,0,0,0,0,0,0,0,0,0,Ron-Robert Zieler,£7.20m ,31,188,Goalkeeper,right,1. FC Köln,30,26,9,2662,49,61,11,4440,49,85,11,4440,36,63,7,3240,36,59,7,3240,36,64,6,3240,13,23,1,1173,37,42,12,3360,37,74,7,3330,Bundesliga,32,47,7,2880,0,0,0,0
13/6/2011,Robert Koch,35014703,771,2/26/1986,25,0,0,0,0,3000,5000,5000,103,100,301001,182,78,M/AM/S RL,1,3,2,2,1,3,2,2,2,1,3,11,12,12,13,10,11,6,9,3,4,12,8,4,11,6,10,12,13,9,10,10,10,14,7,11,6,12,11,11,9,9,11,20,12,10,15,11,9,12,5,10,5,18,8,12,14,13,10,15,13,11,1,1,17,20,18,20,1,M/AM/S RL,535,1,1,20,1,20,18,1,1,1,1,1,17,15,1,1,0,0,0,0,0,0,0,0,0,0,0,0,0,0,0,0,0,0,0,0,0,0,0,0,0,0,0,0,0,0,0,0,0,0,0,0,0,0,0,0,0,0,0,0,0,0,0,0,0,Roberto,£4.50m ,34,192,Goalkeeper,right,Real Valladolid CF,41,46,15,3666,40,64,10,3600,33,51,5,2970,40,27,25,3600,41,39,18,3690,36,32,16,3197,6,14,0,517,34,51,6,3060,6,9,1,570,LaLiga,19,40,3,1655,6,10,0,540
13/6/2011,Ramon Núńez,980475,376,11/14/1985,25,44,5,9,1,3000,5500,5500,125,110,441897,171,72,AM RLC,2,2,2,3,1,1,1,1,2,2,1,12,11,14,11,13,13,8,12,2,8,11,6,9,12,7,10,8,12,12,13,11,10,13,7,12,8,8,12,13,13,10,4,12,13,13,20,12,9,12,5,10,11,12,12,13,12,10,10,11,13,10,1,1,9,20,15,15,20,AM RLC,506,1,1,15,20,15,15,1,1,1,1,9,1,1,1,1,5.49756E+11,0,0,0,0,0,1,0,1,0,0,0,1,0,0,0,0,0,0,0,0,0,0,0,0,0,0,0,0,0,0,0,0,0,0,0,0,0,0,0,1,0,0,0,0,0,0,0,0,,,,,,,,,,,,,,,,,,,,,,,,,,,,,,,,,,,,,,,,,,,,,,,,,,,,
13/6/2011,Paulo Machado,744562,788,3/31/1986,25,0,0,9,3,4900,6209,6150,155,138,4399164,174,74,M RLC,1,3,3,3,3,1,3,4,1,1,2,13,13,12,10,15,15,8,15,10,8,14,12,10,15,11,13,14,13,13,14,12,17,11,11,12,12,16,14,15,12,12,7,10,14,13,20,13,12,13,11,14,6,15,11,14,13,13,13,13,13,3,1,1,20,14,15,15,20,M RLC,406,1,1,1,14,10,10,1,1,1,10,20,15,15,1,1,4194880,0,0,0,0,0,0,1,0,0,1,0,0,0,0,0,0,0,0,0,0,0,0,1,0,0,0,0,0,0,0,0,0,0,0,0,0,0,0,0,0,0,0,0,0,0,0,0,0,Paulo Machado,£4.05m ,34,174,Midfielder - Central Midfield,right,Leixões SC,33,4,5,2453,25,3,0,1491,42,3,6,3075,25,3,0,1173,44,4,8,3202,44,2,10,3294,33,1,3,1835,27,5,4,1780,20,2,4,1754,Ligue 1,9,1,1,641,3,0,0,150
13/6/2011,Oscar Wendt,8105594,797,10/24/1985,25,16,0,14,1,4750,6500,6150,136,133,3664942,181,83,D/M L,3,2,3,3,1,1,3,10,1,3,1,14,15,13,6,13,13,8,10,5,13,14,5,14,12,8,12,9,13,12,12,14,12,8,4,14,12,14,16,14,13,10,9,20,14,13,12,15,12,13,5,12,5,14,12,15,14,13,14,14,13,5,20,15,16,1,12,20,1,D/M L,113,1,1,1,1,1,1,1,20,12,1,1,16,9,15,8,33,1,0,0,0,0,1,0,0,0,0,0,0,0,0,0,0,0,0,0,0,0,0,0,0,0,0,0,0,0,0,0,0,0,0,0,0,0,0,0,0,0,0,0,0,0,0,0,0,Oscar Wendt,£1.80m ,35,181,Defender - Left-Back,left,Borussia Mönchengladbach,41,1,7,3613,16,1,0,617,28,1,5,2443,18,3,1,1470,36,2,1,3140,39,3,3,3442,43,3,3,3693,31,1,1,2730,34,1,2,2878,Bundesliga,31,2,4,2166,5,0,0,273
13/6/2011,Nildo,19135019,1651,5/1/1986,25,0,0,0,0,250,3750,3750,120,107,405131,175,62,AM RL,1,1,1,2,1,1,3,6,1,3,3,10,12,11,10,11,10,8,12,10,11,10,12,12,12,10,11,13,11,8,9,10,8,12,8,14,9,11,13,14,13,10,8,20,12,13,8,12,11,9,8,10,8,11,11,13,10,13,4,11,8,6,7,7,12,20,15,20,1,AM RL,505,1,1,1,1,20,15,1,7,1,1,1,12,1,7,1,1,1,0,0,0,0,0,0,0,0,0,0,0,0,0,0,0,0,0,0,0,0,0,0,0,0,0,0,0,0,0,0,0,0,0,0,0,0,0,0,0,0,0,0,0,0,0,0,0,Nivaldo,£450Th. ,32,179,Midfielder - Left Midfield,left,Without Club,nan,nan,nan,nan,14,0,0,1130,15,1,1,1190,29,5,7,2432,29,4,11,2292,10,0,0,494,10,1,1,564,15,1,4,757,22,2,1,1361,Liga NOS,3,0,0,270,nan,nan,nan,nan
13/6/2011,Nicolás Bertolo,963529,1649,1/2/1986,25,2,0,0,0,4000,6000,6500,144,137,5861347,180,75,M/AM RL,1,3,3,2,3,2,3,7,3,3,2,12,12,16,13,15,11,9,10,8,6,14,12,8,15,10,13,12,13,8,13,13,12,17,10,16,6,9,10,13,14,10,10,14,11,16,20,10,10,9,8,14,7,14,14,12,11,12,11,11,14,13,1,1,18,20,19,20,14,M/AM RL,525,1,1,10,14,20,19,1,1,1,1,12,18,16,1,1,2.2518E+15,0,0,0,0,0,0,0,0,0,0,0,0,0,0,0,0,0,0,0,0,0,0,0,0,0,0,0,1,0,0,1,0,0,0,0,0,0,0,0,0,0,0,0,0,0,0,0,0,Nicolás Bertolo,£2.52m ,34,180,Forward - Left Winger,right,Club Atlético Banfield,37,5,2,2315,30,4,3,1615,28,2,2,1342,4,1,1,186,38,6,7,2859,11,0,2,529,25,7,4,2076,23,3,5,1888,14,2,1,829,Serie A,20,1,2,1345,nan,nan,nan,nan
13/6/2011,Morgaro Gomis,8605614,41,7/14/1985,25,2,0,0,0,3250,6300,5650,126,116,3057702,171,75,M LC,2,2,2,1,3,3,2,1,2,2,3,4,10,13,3,14,6,7,7,6,12,12,9,11,10,16,13,13,13,14,12,12,14,9,5,11,12,13,15,13,11,14,7,20,16,13,8,16,14,16,12,13,6,9,16,12,15,12,15,14,10,5,7,7,20,10,11,15,20,M LC,404,1,1,1,10,1,1,1,7,1,10,20,15,11,7,1,20971520,0,0,0,0,0,0,0,0,0,0,0,0,0,0,0,0,0,0,0,0,0,0,1,0,1,0,0,0,0,0,0,0,0,0,0,0,0,0,0,0,0,0,0,0,0,0,0,0,,,,,,,,,,,,,,,,,,,,,,,,,,,,,,,,,,,,,,,,,,,,,,,,,,,,
13/6/2011,Miguel Ángel Nieto,67044565,796,1/12/1986,25,0,0,0,0,4000,5750,5750,138,120,1290774,184,77,AM RL,1,2,1,1,1,3,2,6,1,2,2,11,14,15,12,11,10,7,9,5,4,13,11,6,14,10,10,12,9,11,12,9,10,14,10,15,6,10,9,15,12,11,10,8,12,15,20,12,11,10,5,13,16,10,13,13,15,14,2,5,3,9,1,1,15,20,20,15,12,AM RL,505,1,1,1,12,15,20,1,1,1,1,1,13,15,1,1,1.10166E+12,0,1,0,0,0,0,0,0,0,0,0,0,0,0,0,0,0,0,0,0,0,0,0,0,0,0,0,0,0,0,0,1,0,0,0,0,0,0,0,0,1,0,0,0,0,0,0,0,Miguel Ángel Moyá,£1.80m ,36,189,Goalkeeper,right,Real Sociedad,6,4,3,473,36,48,9,3240,34,47,9,2981,26,40,7,2309,36,25,19,3173,6,5,3,540,18,17,8,1579,16,23,9,1395,13,13,3,1170,LaLiga,14,16,4,1260,0,0,0,0
13/6/2011,Michel Simplício,2108457,1651,3/26/1986,25,0,0,0,0,1000,5250,5250,125,105,87675,180,75,AM/S RL,3,1,3,1,2,3,2,4,1,1,1,8,10,12,9,12,8,10,8,7,8,10,8,12,13,14,11,9,9,10,12,8,12,12,12,10,8,7,12,13,13,9,9,10,15,14,20,13,9,10,5,10,13,9,8,11,15,5,10,3,11,13,1,8,9,20,20,20,13,AM/S RL,515,1,1,18,13,20,20,1,1,1,1,1,9,6,1,8,0,0,0,0,0,0,0,0,0,0,0,0,0,0,0,0,0,0,0,0,0,0,0,0,0,0,0,0,0,0,0,0,0,0,0,0,0,0,0,0,0,0,0,0,0,0,0,0,0,,,,,,,,,,,,,,,,,,,,,,,,,,,,,,,,,,,,,,,,,,,,,,,,,,,,
13/6/2011,Mauricio Saucedo,86000468,1650,8/14/1985,25,7,0,3,1,2250,5399,5000,127,120,1075540,187,68,M/AM LC,2,1,2,1,1,3,2,1,3,3,3,10,12,12,12,14,10,13,14,9,8,11,10,14,12,12,12,11,12,12,12,12,10,11,15,14,12,8,13,12,12,12,13,20,12,11,13,12,12,10,5,10,12,10,3,20,13,8,8,14,8,12,1,1,17,20,1,20,17,M/AM LC,524,1,1,1,17,20,1,1,1,1,1,1,17,1,1,1,0,0,0,0,0,0,0,0,0,0,0,0,0,0,0,0,0,0,0,0,0,0,0,0,0,0,0,0,0,0,0,0,0,0,0,0,0,0,0,0,0,0,0,0,0,0,0,0,0,Mauricio Saucedo,- ,35,185,Midfielder - Attacking Midfield,left,Club Real Santa Cruz,4,0,0,299,1,0,0,24,1,0,0,10,3,0,0,222,6,0,0,195,2,0,0,75,nan,nan,nan,nan,nan,nan,nan,nan,nan,nan,nan,nan,Liga NOS,7,2,0,276,nan,nan,nan,nan
13/6/2011,Matt Jarvis,5113564,765,5/22/1986,25,1,0,0,0,4500,6800,6700,145,140,6370965,173,70,M/AM RL,1,2,3,2,2,1,3,1,2,2,2,12,13,14,11,11,7,3,6,1,4,11,4,7,12,4,11,8,9,7,11,10,16,13,5,13,7,12,14,17,13,11,4,12,13,15,20,14,7,12,2,12,7,6,4,15,14,10,16,16,18,2,1,1,18,20,17,20,1,M/AM RL,525,1,1,1,1,20,17,1,1,1,1,1,18,16,1,1,134217728,0,0,0,0,0,0,0,0,0,0,0,0,0,0,0,0,0,0,0,0,0,0,0,0,0,0,0,1,0,0,0,0,0,0,0,0,0,0,0,0,0,0,0,0,0,0,0,0,Matt Jarvis,£7.20m ,34,173,Forward - Left Winger,nan,Woking FC,41,5,9,3340,39,8,6,2839,36,2,2,2864,35,4,4,2219,14,0,1,630,29,2,3,1638,4,0,0,299,1,0,0,20,10,0,2,779,Premier League,2,1,0,65,3,0,0,56
13/6/2011,Martyn Woolford,5109422,765,10/13/1985,25,0,0,0,0,2800,5250,5250,125,105,1299500,183,74,AM LC,3,1,3,3,3,3,1,1,3,1,1,8,11,12,11,12,9,13,10,3,3,14,9,8,11,5,9,7,9,9,12,7,14,16,4,13,9,12,14,15,12,10,12,20,8,13,11,7,6,9,3,12,5,13,12,19,13,11,12,11,13,2,1,1,10,20,14,20,18,AM LC,504,1,1,14,18,20,14,1,1,1,1,1,10,10,1,1,5.49756E+11,0,0,0,0,0,0,0,0,1,0,0,0,0,0,0,0,0,0,0,0,0,0,0,0,0,0,0,0,0,0,0,0,0,0,0,0,0,0,0,1,0,0,0,0,0,0,0,0,,,,,,,,,,,,,,,,,,,,,,,,,,,,,,,,,,,,,,,,,,,,,,,,,,,,
13/6/2011,Marcell Jansen,8718369,771,11/4/1985,25,36,3,4,1,6700,7150,7150,149,142,59783916,190,84,D/WB/M/AM L,1,1,2,1,2,2,3,4,3,1,3,10,16,12,14,12,10,8,13,15,8,13,11,17,10,15,8,17,10,12,14,14,17,7,11,17,7,17,18,12,9,18,15,20,6,18,9,11,16,11,8,10,17,10,5,13,14,11,16,15,13,9,18,19,20,17,1,20,1,D/WB/M/AM L,443,1,1,1,1,17,1,1,18,1,1,1,20,1,19,1,1.23709E+12,0,0,0,0,0,1,0,0,0,0,0,0,0,0,0,0,0,0,0,0,1,0,0,0,0,0,0,1,0,0,0,0,0,0,0,0,0,1,0,0,1,0,0,0,0,0,0,0,Marcell Jansen,£5.40m ,34,191,Defender - Left-Back,left,Hamburger SV III,17,2,0,1093,31,5,1,2354,29,1,3,2578,27,1,4,2253,16,2,3,1175,nan,nan,nan,nan,nan,nan,nan,nan,4,0,0,106,10,8,4,347,Bundesliga,20,14,5,1152,2,0,0,26
13/6/2011,Marc Schnatterer,8721351,771,11/18/1985,25,0,0,0,0,3750,5500,5500,117,110,773562,180,73,M/AM LC,1,3,2,3,3,2,1,6,1,1,2,12,12,12,12,12,12,9,13,7,4,12,10,8,12,8,12,11,13,12,14,14,13,13,8,14,13,13,13,11,13,12,10,8,8,11,20,11,10,14,4,11,5,15,8,11,10,11,12,13,8,9,1,1,20,18,14,20,16,M/AM LC,414,1,1,1,16,18,14,1,1,1,1,15,20,12,1,1,4294967424,0,0,0,0,0,0,0,1,0,0,0,0,0,0,0,0,0,0,0,0,0,0,0,0,0,0,0,0,0,0,0,0,1,0,0,0,0,0,0,0,0,0,0,0,0,0,0,0,,,,,,,,,,,,,,,,,,,,,,,,,,,,,,,,,,,,,,,,,,,,,,,,,,,,
13/6/2011,Luka Modric,653054,761,9/9/1985,25,44,7,11,1,7500,9000,8250,178,170,53152775,171,66,M/AM RLC,1,2,1,1,1,1,2,9,2,2,3,13,12,16,7,17,13,7,8,11,7,17,15,9,17,12,15,13,14,15,17,18,15,15,17,14,7,18,18,15,16,16,4,15,16,14,20,18,9,13,6,17,6,14,12,17,14,17,16,15,15,3,1,1,20,20,16,18,20,M/AM RLC,416,1,1,1,20,18,16,1,1,1,1,20,15,12,1,1,5.51903E+11,1,0,0,0,0,0,0,0,0,0,0,1,0,0,1,0,1,0,0,0,0,0,0,0,0,0,0,0,0,0,0,1,0,0,0,0,0,0,0,1,0,0,0,0,0,0,0,0,Luka Modric,£35.10m ,35,172,Midfielder - Central Midfield,both,Real Madrid,43,4,3,3540,41,5,7,3548,53,4,8,3284,51,2,9,4061,25,1,5,2007,44,3,4,3530,41,1,5,3304,43,2,8,3339,46,4,8,3571,Premier League,40,5,8,2631,7,2,0,430
13/6/2011,Ludovic Gamboa,8442312,769,1/14/1986,25,0,0,0,0,1350,2700,2700,115,107,39345,177,71,AM L,1,1,3,1,1,1,2,2,2,2,3,12,11,11,11,11,11,7,13,5,4,9,10,4,11,14,10,13,12,12,8,8,17,14,7,13,8,11,15,11,12,13,8,20,11,15,10,14,13,13,14,14,15,6,6,12,12,15,14,11,11,6,1,1,15,20,10,20,10,AM L,503,1,1,12,10,20,10,1,1,1,1,10,15,10,1,1,34359738369,1,0,0,0,0,0,0,0,0,0,0,0,0,0,0,0,0,0,0,0,0,0,0,0,0,0,0,0,0,0,0,0,0,0,0,1,0,0,0,0,0,0,0,0,0,0,0,0,,,,,,,,,,,,,,,,,,,,,,,,,,,,,,,,,,,,,,,,,,,,,,,,,,,,
13/6/2011,Ludovic Baal,8441947,769,5/24/1986,25,0,0,0,0,4400,5500,5500,136,122,978979,176,72,D/WB/M/AM L,1,2,3,1,3,2,2,5,1,1,1,10,13,11,6,11,11,11,10,11,11,12,10,11,13,11,13,13,10,9,12,10,12,11,7,10,11,13,15,15,13,12,9,20,15,14,5,16,12,12,11,14,6,12,12,14,14,12,13,15,15,9,17,17,18,20,1,20,12,D/WB/M/AM L,543,1,1,1,1,20,1,1,17,1,12,12,18,1,17,1,1,1,0,0,0,0,0,0,0,0,0,0,0,0,0,0,0,0,0,0,0,0,0,0,0,0,0,0,0,0,0,0,0,0,0,0,0,0,0,0,0,0,0,0,0,0,0,0,0,,,,,,,,,,,,,,,,,,,,,,,,,,,,,,,,,,,,,,,,,,,,,,,,,,,,
13/6/2011,Leon Jessen,942116,764,6/11/1986,25,4,0,7,0,2500,6000,6250,138,125,4957368,182,75,D/WB/M L,1,2,3,3,2,1,3,1,1,1,2,15,15,12,5,13,14,11,10,8,13,13,8,14,13,15,11,12,7,13,11,12,14,8,9,7,14,15,16,13,10,12,11,20,14,13,10,14,11,11,9,13,8,16,8,13,17,12,15,12,9,13,20,17,16,4,2,20,4,D/WB/M L,123,1,1,1,4,1,1,1,20,2,1,1,16,1,17,1,32,0,0,0,0,0,1,0,0,0,0,0,0,0,0,0,0,0,0,0,0,0,0,0,0,0,0,0,0,0,0,0,0,0,0,0,0,0,0,0,0,0,0,0,0,0,0,0,0,,,,,,,,,,,,,,,,,,,,,,,,,,,,,,,,,,,,,,,,,,,,,,,,,,,,
13/6/2011,Juliano,19004486,1651,2/14/1986,25,0,0,0,0,2500,5500,5500,128,110,1203474,173,73,M/AM LC,3,3,3,3,1,1,3,7,1,1,1,13,13,13,11,13,13,8,11,12,7,13,13,6,13,7,10,12,12,11,12,13,16,9,8,11,9,11,12,13,11,10,7,20,11,13,8,13,10,10,5,11,11,9,12,10,19,12,12,12,16,5,1,1,17,20,10,18,20,M/AM LC,524,1,1,13,20,18,10,1,1,1,1,17,16,5,1,1,17733517312,0,0,0,0,0,0,0,0,0,0,0,0,0,0,0,0,0,0,0,0,0,0,0,0,1,0,0,0,0,1,0,0,0,0,1,0,0,0,0,0,0,0,0,0,0,0,0,0,Julian Korb,£180Th. ,28,177,Defender - Right-Back,right,Without Club,29,2,1,2540,28,1,4,2317,33,2,3,2959,25,0,0,2216,31,0,1,2671,24,2,3,1856,21,1,1,1322,29,1,2,2431,12,0,0,1007,Bundesliga,27,1,4,2111,nan,nan,nan,nan
13/6/2011,Jonathan Pitroipa,8718230,9,4/12/1986,25,29,2,0,0,2400,7205,6600,136,131,6903944,176,60,AM RL,3,3,2,3,3,3,3,7,3,1,2,6,7,16,7,16,5,10,6,5,6,7,8,6,13,10,7,5,6,8,7,6,8,18,5,12,6,9,14,19,18,4,9,15,10,19,20,12,4,13,3,12,9,12,10,14,4,8,7,10,15,14,1,1,14,20,18,20,14,AM RL,505,1,1,14,14,20,18,1,1,1,1,1,14,12,1,1,7.037E+13,1,1,0,0,0,0,0,0,0,0,0,0,0,0,0,0,0,0,0,0,0,0,0,0,0,0,0,1,0,0,1,0,0,0,0,0,0,0,0,0,0,0,0,0,0,0,1,0,Jonathan Pitroipa,£5.40m ,34,176,Forward - Right Winger,right,Paris FC,28,2,8,1966,50,11,13,3944,36,8,7,3177,26,0,4,1668,26,9,11,2182,36,8,14,3080,12,6,2,857,10,0,0,470,32,3,1,2527,Ligue 1,27,2,2,1776,8,0,0,556
13/6/2011,Johannes Rahn,8718118,771,1/16/1986,25,0,0,0,0,3350,4700,4700,100,94,725469,190,84,AM/S RL,3,3,2,1,3,2,3,4,1,1,1,9,11,12,12,9,9,14,10,5,6,11,12,6,10,8,11,10,11,9,10,10,10,8,9,11,7,11,11,10,9,15,15,4,12,11,20,15,14,12,5,11,5,15,6,11,13,13,10,15,17,15,1,1,14,19,19,17,14,AM/S RL,625,1,1,20,14,17,19,1,1,1,1,1,14,14,1,1,0,0,0,0,0,0,0,0,0,0,0,0,0,0,0,0,0,0,0,0,0,0,0,0,0,0,0,0,0,0,0,0,0,0,0,0,0,0,0,0,0,0,0,0,0,0,0,0,0,,,,,,,,,,,,,,,,,,,,,,,,,,,,,,,,,,,,,,,,,,,,,,,,,,,,
13/6/2011,Joăo Pedro,55002036,788,5/4/1986,25,0,0,0,0,1000,5000,5000,115,98,87432,174,72,AM RL,2,3,1,3,1,1,2,1,1,2,2,10,11,12,10,12,9,6,9,6,7,9,11,6,13,9,10,10,10,9,9,9,14,13,9,12,8,8,11,12,11,10,8,11,13,13,20,9,9,10,8,10,8,10,7,16,15,13,11,11,13,7,1,1,9,20,20,15,1,AM RL,505,1,1,8,1,15,20,1,1,1,1,1,1,9,1,1,0,0,0,0,0,0,0,0,0,0,0,0,0,0,0,0,0,0,0,0,0,0,0,0,0,0,0,0,0,0,0,0,0,0,0,0,0,0,0,0,0,0,0,0,0,0,0,0,0,João Pedro,£90Th. ,40,174,Defender - Left-Back,left,Retired,2,0,0,112,5,0,1,405,7,0,0,625,43,2,2,3767,3,0,0,270,2,0,0,210,nan,nan,nan,nan,nan,nan,nan,nan,nan,nan,nan,nan,Liga NOS,nan,nan,nan,nan,nan,nan,nan,nan
13/6/2011,Javi Márquez,1509534,796,5/11/1986,25,0,0,0,0,4750,7000,7000,150,140,6908252,174,71,DM/M LC,1,3,2,2,1,1,3,4,1,2,1,11,12,12,9,14,12,9,13,9,10,14,9,12,14,12,14,12,14,14,14,15,12,12,9,14,13,15,17,14,13,11,8,20,12,14,8,14,12,12,9,9,9,13,7,12,14,12,15,9,6,14,1,1,20,14,1,17,20,DM/M LC,424,1,1,1,14,13,1,1,1,1,17,20,17,1,1,1,0,0,0,0,0,0,0,0,0,0,0,0,0,0,0,0,0,0,0,0,0,0,0,0,0,0,0,0,0,0,0,0,0,0,0,0,0,0,0,0,0,0,0,0,0,0,0,0,0,Javi Márquez,£5.40m ,34,179,Midfielder - Central Midfield,left,Without Club,33,2,1,2470,9,0,0,594,26,3,2,1597,30,2,1,2157,26,0,0,1487,21,0,1,1443,39,6,6,2998,13,0,0,572,25,1,3,1508,LaLiga,11,2,0,796,nan,nan,nan,nan
13/6/2011,Jan Rosenthal,8728478,771,4/7/1986,25,0,0,17,2,5000,6550,6550,143,132,5242296,185,75,M/AM RLC,1,1,2,2,1,2,1,5,1,2,3,10,11,12,13,12,10,10,13,10,7,13,10,11,14,12,13,15,8,8,11,10,17,12,12,14,10,13,15,13,12,14,13,14,12,15,20,14,14,9,5,9,13,17,8,15,14,7,15,14,11,6,1,7,18,20,20,18,18,M/AM RLC,526,1,1,1,18,18,20,1,1,1,11,15,15,18,7,7,512,0,0,0,0,0,0,0,0,0,1,0,0,0,0,0,0,0,0,0,0,0,0,0,0,0,0,0,0,0,0,0,0,0,0,0,0,0,0,0,0,0,0,0,0,0,0,0,0,Jan Rosenthal,£2.70m ,34,186,Forward - Second Striker,right,Retired,23,5,0,1660,21,2,1,1349,24,5,5,1765,24,2,2,1119,9,1,1,315,25,0,5,1529,19,0,0,856,12,0,0,439,nan,nan,nan,nan,Bundesliga,2,0,0,118,nan,nan,nan,nan
13/6/2011,James Milner,5106363,765,1/4/1986,25,19,0,46,9,6400,7500,7500,160,150,114999996,176,70,M/AM RLC,1,1,3,2,1,1,1,6,3,1,3,13,14,12,12,14,15,9,13,12,9,14,12,12,12,12,15,14,14,15,14,15,17,14,14,13,10,18,19,13,15,13,8,12,18,12,20,18,11,16,4,15,4,14,12,15,15,16,18,12,14,1,10,3,20,18,18,17,20,M/AM RLC,416,1,1,8,10,17,18,1,3,10,1,20,15,15,2,3,7.09185E+13,1,1,0,0,0,0,0,1,0,0,0,0,0,0,0,0,0,0,0,0,0,0,0,0,0,0,0,0,0,0,0,0,0,0,0,0,0,0,0,1,0,0,0,0,0,0,1,0,James Milner,£18.90m ,34,175,Midfielder - Central Midfield,right,Liverpool FC,42,3,8,2688,37,3,5,2198,36,4,8,2421,44,2,15,2323,45,8,9,2704,45,7,14,3862,40,7,4,3437,47,1,11,2787,45,7,7,2836,Premier League,37,4,4,1708,7,0,0,305
13/6/2011,Ivanildo,744557,23,1/9/1986,25,0,0,8,0,2250,5250,5250,115,107,1319005,175,71,AM L,2,1,3,2,2,3,2,1,2,3,1,11,12,14,12,12,13,9,11,5,5,10,11,5,13,10,9,10,7,9,9,9,11,14,10,11,6,7,9,14,11,9,10,20,11,13,8,11,9,8,8,11,8,12,13,11,13,12,13,16,16,3,1,1,9,20,1,20,10,AM L,503,1,1,10,10,20,1,1,1,1,1,1,9,1,1,1,52076479233,1,0,0,0,0,0,0,0,1,1,0,0,0,0,0,0,0,0,0,0,0,0,0,0,0,0,0,0,0,1,0,0,0,0,1,1,0,0,0,0,0,0,0,0,0,0,0,0,Ivanildo,£720Th. ,34,176,Forward - Right Winger,left,Retired,22,3,2,1643,7,1,1,304,15,2,0,864,25,1,3,1769,18,2,1,1191,23,1,2,1599,nan,nan,nan,nan,nan,nan,nan,nan,nan,nan,nan,nan,Liga NOS,nan,nan,nan,nan,nan,nan,nan,nan
13/6/2011,Ibrahim Afellay,857024,784,4/2/1986,25,36,3,0,0,7000,7500,7500,170,150,4495748,180,76,AM RLC,3,3,1,1,2,3,1,4,1,2,1,14,14,18,11,14,12,5,14,12,8,14,12,5,17,10,13,14,11,12,15,12,14,15,15,15,10,14,14,15,14,11,10,15,13,14,20,13,8,13,5,11,10,13,12,15,12,13,15,16,10,4,1,1,14,20,18,17,20,AM RLC,506,1,1,12,20,17,18,1,1,1,1,14,14,14,1,1,5.84116E+11,0,0,0,0,0,0,0,0,0,0,0,0,0,0,0,0,0,0,0,0,0,0,0,0,0,0,0,0,0,0,0,0,0,0,0,1,0,0,0,1,0,0,0,0,0,0,0,0,Ibrahim Afellay,£9.00m ,34,181,Midfielder - Left Midfield,right,Without Club,54,10,5,3044,5,0,0,125,15,4,2,922,2,0,0,24,29,6,4,1803,36,3,3,2571,14,0,0,529,8,1,0,315,nan,nan,nan,nan,LaLiga,4,0,1,164,nan,nan,nan,nan
13/6/2011,Hugo Rodallega,8835582,1653,7/25/1985,25,40,8,22,18,5750,7700,7000,155,140,15479911,181,72,AM/S RL,2,1,2,2,1,2,1,3,1,1,3,14,7,13,13,11,12,14,11,6,4,12,15,6,13,12,13,12,13,13,15,11,12,12,13,14,6,11,14,14,13,13,12,12,14,14,20,14,13,11,7,13,10,12,12,18,9,13,14,16,13,12,1,1,1,17,17,17,2,AM/S RL,625,1,1,20,2,17,17,1,1,1,1,1,1,1,1,1,524864,0,0,0,0,0,0,1,0,0,1,0,0,0,0,0,0,0,0,0,1,0,0,0,0,0,0,0,0,0,0,0,0,0,0,0,0,0,0,0,0,0,0,0,0,0,0,0,0,Hugo Rodallega,£4.05m ,35,181,Forward - Centre-Forward,right,Denizlispor,37,9,2,3094,24,2,7,1337,33,3,3,1783,17,6,2,853,38,11,9,2834,37,21,1,3199,32,10,3,2443,28,13,1,936,37,16,3,2909,Premier League,32,6,1,2762,5,1,0,432
13/6/2011,Henry Giménez,78002298,1657,3/13/1986,25,2,0,0,0,2750,6000,6650,140,131,4174165,176,69,AM/S RLC,2,1,1,3,1,1,3,3,1,3,2,13,13,14,11,12,11,11,11,11,8,12,14,8,16,12,11,9,11,8,12,13,14,15,12,14,8,10,12,15,15,8,8,20,15,13,12,14,10,12,13,11,8,12,12,8,10,12,15,14,13,6,1,1,1,18,15,15,18,AM/S RLC,626,1,1,20,18,15,15,1,1,1,1,1,1,1,1,1,5.49756E+11,0,0,0,0,0,0,0,0,0,0,0,0,0,0,0,0,0,0,0,0,0,0,0,0,0,0,0,0,0,0,0,0,0,0,0,0,0,0,0,1,0,0,0,0,0,0,0,0,Henry Giménez,£720Th. ,34,176,Forward - Centre-Forward,left,Rivera Hinterland,29,4,1,1104,18,1,3,600,17,1,2,1221,7,1,0,337,21,2,2,1346,5,0,0,186,24,2,2,1588,20,3,1,1447,14,0,0,893,Serie A,nan,nan,nan,nan,nan,nan,nan,nan
13/6/2011,Heinrich Schmidtgal,8719267,119,11/20/1985,25,4,0,0,0,3300,5800,5800,127,117,1767267,174,75,D/WB/M L,3,2,1,3,2,3,1,3,3,2,1,12,12,13,11,13,13,8,11,4,12,12,9,12,12,12,11,13,11,11,12,12,10,12,8,12,12,12,13,13,13,11,7,20,12,13,7,13,11,11,3,11,8,9,10,13,10,11,10,12,15,5,20,18,18,15,12,20,12,D/WB/M L,123,1,1,1,12,15,1,1,20,12,1,1,18,1,18,1,1,1,0,0,0,0,0,0,0,0,0,0,0,0,0,0,0,0,0,0,0,0,0,0,0,0,0,0,0,0,0,0,0,0,0,0,0,0,0,0,0,0,0,0,0,0,0,0,0,,,,,,,,,,,,,,,,,,,,,,,,,,,,,,,,,,,,,,,,,,,,,,,,,,,,
13/6/2011,Guilherme Siqueira,320772,776,4/28/1986,25,0,0,0,0,4500,4000,6000,140,129,2819599,184,76,D/WB/M L,2,3,2,1,2,1,2,1,1,1,3,14,14,12,10,14,10,4,7,8,12,13,3,12,14,10,12,7,11,10,13,9,13,13,10,15,12,12,13,15,15,12,8,20,14,14,10,14,11,14,11,14,8,10,15,14,16,10,14,14,10,4,19,20,18,15,1,20,1,D/WB/M L,233,1,1,1,1,15,1,1,19,1,1,1,18,1,20,1,134217760,0,0,0,0,0,1,0,0,0,0,0,0,0,0,0,0,0,0,0,0,0,0,0,0,0,0,0,1,0,0,0,0,0,0,0,0,0,0,0,0,0,0,0,0,0,0,0,0,Guilherme Siqueira,£4.50m ,34,182,Defender - Left-Back,left,Retired,35,0,0,2855,37,7,1,3181,36,6,3,3017,33,1,1,2751,37,1,3,2995,22,0,0,1772,11,0,1,632,nan,nan,nan,nan,nan,nan,nan,nan,LaLiga,nan,nan,nan,nan,nan,nan,nan,nan
13/6/2011,Grégory Bettiol,8428565,769,3/30/1986,25,0,0,0,0,3350,5050,5050,120,113,1630659,180,79,AM/S L,2,2,2,2,2,2,2,6,2,1,2,5,7,11,10,12,12,13,13,5,4,11,13,3,11,10,12,14,12,12,9,11,13,8,7,13,8,12,13,12,11,14,11,10,10,14,20,13,14,12,9,14,11,6,11,12,13,13,14,14,14,6,1,1,1,16,1,16,12,AM/S L,623,1,1,20,12,16,1,1,1,1,1,1,1,1,1,1,16,0,0,0,0,1,0,0,0,0,0,0,0,0,0,0,0,0,0,0,0,0,0,0,0,0,0,0,0,0,0,0,0,0,0,0,0,0,0,0,0,0,0,0,0,0,0,0,0,Grégory Sertic,£1.13m ,31,183,Midfielder - Defensive Midfield,right,Without Club,24,0,2,1099,22,0,1,1008,44,1,5,3112,37,3,11,3061,30,1,1,2341,3,0,0,141,28,1,1,2319,13,0,0,716,17,0,0,1103,Ligue 1,nan,nan,nan,nan,nan,nan,nan,nan
13/6/2011,Gili Vermut,7861328,775,8/5/1985,25,14,0,12,1,4500,7150,7150,142,133,1923925,175,68,AM/S RLC,2,2,2,2,1,3,1,5,3,3,3,12,14,16,12,12,6,4,6,1,8,16,10,5,17,7,15,7,12,12,18,14,14,13,11,14,8,12,13,12,14,10,8,12,10,13,20,12,8,12,3,13,3,14,8,14,14,14,17,19,13,4,1,1,13,20,20,15,15,AM/S RLC,516,1,1,16,15,15,20,1,1,1,1,8,13,13,1,1,7.09529E+13,0,0,0,0,0,0,0,0,0,0,0,0,0,0,0,0,0,0,0,1,0,0,0,0,1,0,0,0,0,0,0,0,0,0,0,1,0,0,0,1,0,0,0,0,0,0,1,0,Gil Vermouth,£1.35m ,35,173,Midfielder - Right Midfield,right,Without Club,46,5,0,3860,20,2,4,1456,14,1,5,1060,38,8,0,2974,24,3,1,2002,39,2,3,2211,36,7,3,2783,31,1,4,1911,32,2,7,2011,Bundesliga,23,0,2,792,nan,nan,nan,nan
13/6/2011,George Boyd,5113080,793,10/2/1985,25,0,0,0,0,3700,5600,6000,130,118,6766844,186,79,M/AM LC,3,1,1,3,2,2,2,6,2,3,1,11,12,15,12,14,10,8,12,1,3,13,12,9,14,7,12,4,12,9,15,14,14,15,8,12,10,10,13,11,12,14,11,20,13,10,14,12,11,10,6,12,3,13,11,14,16,15,15,9,6,3,1,1,17,20,14,20,20,M/AM LC,524,1,1,12,20,20,14,1,1,1,1,9,17,12,1,1,8.85493E+13,0,0,0,0,0,0,0,0,0,0,0,0,0,0,0,0,0,0,0,0,0,0,0,0,0,0,0,0,0,0,0,0,1,0,0,1,0,0,0,1,0,0,0,0,1,0,1,0,,,,,,,,,,,,,,,,,,,,,,,,,,,,,,,,,,,,,,,,,,,,,,,,,,,,
13/6/2011,Gaétan Krebs,919983,769,11/18/1985,25,0,0,0,0,2950,5250,5800,132,116,706100,165,63,M/AM RL,2,1,3,1,2,2,3,1,2,3,3,11,13,13,8,13,12,5,11,4,2,13,10,4,13,5,9,10,12,9,13,9,12,12,9,11,4,12,9,14,15,9,6,14,8,14,20,11,8,10,5,8,14,12,13,15,9,10,7,8,8,12,1,1,18,20,16,20,14,M/AM RL,525,1,1,5,14,20,16,1,1,1,1,6,18,15,1,1,7.03687E+13,0,0,0,0,0,0,0,0,0,0,0,0,0,0,0,0,0,0,0,0,0,0,0,0,0,0,0,0,0,0,0,0,0,0,0,0,0,0,0,0,0,0,0,0,0,0,1,0,,,,,,,,,,,,,,,,,,,,,,,,,,,,,,,,,,,,,,,,,,,,,,,,,,,,
13/6/2011,Frédéric Sammaritano,8428645,769,3/23/1986,25,0,0,0,0,4400,5500,5500,136,122,3640948,162,61,M/AM LC,2,2,2,2,2,1,3,4,2,3,1,13,12,14,8,14,13,5,11,5,1,12,12,3,15,11,12,9,13,13,13,11,17,15,6,13,5,9,11,16,16,7,3,15,13,13,20,11,5,14,11,15,8,8,9,14,13,14,14,13,10,6,1,1,16,20,12,16,20,M/AM LC,524,1,1,12,20,16,12,1,1,1,1,14,16,12,1,1,2.25183E+15,0,0,0,0,0,0,0,1,0,0,0,0,0,0,0,0,0,0,0,0,0,0,0,0,0,0,0,0,0,0,0,0,0,0,0,1,0,0,0,0,0,0,0,0,0,0,0,0,Frédéric Sammaritano,£1.35m ,34,162,Midfielder - Attacking Midfield,right,Dijon FCO,39,6,6,2026,33,5,1,1904,24,1,0,953,39,6,5,2729,17,4,1,1213,39,7,10,3122,31,4,4,1969,27,1,4,1551,15,0,0,559,Ligue 1,13,2,2,806,7,0,0,223
13/6/2011,Francesco Volpe,7987866,776,3/3/1986,25,0,0,0,0,250,5050,4900,112,91,108838,180,71,AM/S RL,1,1,1,1,1,1,1,1,1,1,1,4,12,10,9,7,6,7,8,4,3,8,9,5,10,6,8,10,8,9,5,8,9,11,11,9,8,10,11,13,11,9,9,7,19,13,20,11,9,11,9,7,3,18,10,16,10,9,9,13,12,13,1,1,9,20,20,20,10,AM/S RL,515,1,1,17,10,20,20,1,1,1,1,1,9,1,1,1,0,0,0,0,0,0,0,0,0,0,0,0,0,0,0,0,0,0,0,0,0,0,0,0,0,0,0,0,0,0,0,0,0,0,0,0,0,0,0,0,0,0,0,0,0,0,0,0,0,Francesco Urso,£68Th. ,26,175,Midfielder - Defensive Midfield,right,US Catanzaro,nan,nan,nan,nan,19,1,0,1392,nan,nan,nan,nan,1,0,0,90,19,2,0,1542,28,0,0,1712,24,1,2,1884,21,1,2,1681,6,0,0,116,Serie A,13,1,2,524,2,0,0,99
13/6/2011,Fabián Orellana,8835313,1652,1/27/1986,25,17,2,0,0,4300,6500,6500,149,133,1780287,170,68,AM/S RL,3,2,2,3,2,3,2,3,2,2,1,13,13,15,10,13,12,5,8,4,4,13,14,5,15,8,10,8,10,11,13,12,14,16,8,16,9,14,12,16,16,8,5,10,14,15,20,11,9,15,14,15,4,7,10,12,13,14,15,13,9,5,1,1,9,20,20,18,14,AM/S RL,515,1,1,20,14,18,20,1,1,1,1,1,1,9,1,1,1.77296E+13,0,0,0,0,1,0,0,0,0,0,0,0,0,1,0,0,0,0,0,0,0,0,0,0,0,0,0,0,0,0,0,0,0,0,0,0,0,1,0,0,0,0,0,0,1,0,0,0,,,,,,,,,,,,,,,,,,,,,,,,,,,,,,,,,,,,,,,,,,,,,,,,,,,,
13/6/2011,Enzo Pérez,958414,1649,2/22/1986,25,3,0,0,0,4500,7050,6700,143,134,6903944,177,73,AM RLC,3,3,2,3,2,2,2,1,3,3,1,14,15,16,13,14,11,9,11,10,10,15,11,10,17,9,14,12,14,14,14,15,14,14,8,14,10,14,14,13,13,11,10,6,13,14,20,14,11,14,7,13,5,14,9,12,13,12,11,13,16,7,1,1,10,20,20,16,15,AM RLC,506,1,1,1,15,16,20,1,1,1,1,10,7,10,1,1,1.37439E+11,0,1,0,0,0,0,0,0,0,0,0,0,1,0,0,0,0,0,0,0,0,0,0,0,0,0,0,0,0,0,0,0,0,0,0,0,0,1,0,0,0,0,0,0,0,0,0,0,Enzo Pérez,£2.70m ,34,179,Midfielder - Defensive Midfield,right,Club Atlético River Plate,40,5,10,3244,18,0,0,1069,47,4,7,3477,47,5,8,3726,34,1,4,2703,30,0,1,1925,34,2,1,2679,31,0,0,2199,41,1,2,3158,Liga NOS,23,0,1,1958,nan,nan,nan,nan
13/6/2011,Emiliano Armenteros,956674,1649,1/18/1986,25,0,0,0,0,4400,6000,6500,144,131,664851,178,75,M/AM L,1,1,3,2,3,1,2,2,3,3,2,15,16,14,15,12,15,6,11,5,5,13,9,9,15,9,11,9,11,10,13,12,11,13,4,15,8,12,11,16,12,15,7,20,14,14,6,14,13,11,6,9,9,11,14,14,12,7,15,14,12,5,1,12,18,20,1,20,13,M/AM L,523,1,1,13,13,20,1,1,1,1,1,1,18,1,12,1,1.09951E+12,0,0,0,0,0,0,0,0,0,0,0,0,0,0,0,0,0,0,0,0,0,0,0,0,0,0,0,0,0,0,0,0,0,0,0,0,0,0,0,0,1,0,0,0,0,0,0,0,Emiliano Armenteros,£2.52m ,34,178,Forward - Left Winger,left,Without Club,38,20,0,3236,29,2,2,1676,31,3,5,2647,31,5,3,2429,31,9,4,2451,27,4,3,2164,20,0,1,1198,27,1,0,779,18,1,0,605,LaLiga,nan,nan,nan,nan,nan,nan,nan,nan
13/6/2011,Emanuele Giaccherini,7990445,776,8/5/1985,25,0,0,0,0,4600,7100,7100,149,138,3899267,160,67,M/AM RLC,1,1,1,1,1,1,1,1,1,1,1,12,13,15,14,8,8,10,12,5,5,13,12,9,14,16,12,15,14,10,12,11,16,17,9,14,9,14,13,16,16,15,3,15,18,14,20,16,6,16,12,13,3,18,8,18,16,10,14,11,5,11,1,1,17,20,20,19,16,M/AM RLC,526,1,1,14,16,19,20,1,1,1,1,1,17,17,1,1,4.43241E+12,0,0,0,0,1,0,0,0,0,0,0,0,0,0,0,0,0,0,0,0,0,0,0,0,0,0,0,0,0,0,0,0,0,0,0,1,0,0,0,0,0,0,1,0,0,0,0,0,Emanuele Giaccherini,£4.23m ,35,167,Midfielder - Left Midfield,right,Chievo Verona,36,7,4,2908,27,3,3,1616,25,3,4,1273,32,5,4,1967,11,0,1,477,28,7,0,2185,19,2,0,386,18,3,1,1027,28,3,2,2186,Serie A,24,5,4,1541,nan,nan,nan,nan
13/6/2011,Éderson,317312,1651,1/13/1986,25,1,0,0,0,5450,7150,6050,145,135,1942217,181,74,M/AM LC,1,3,3,1,1,1,1,4,1,3,2,12,13,15,9,15,14,11,14,7,5,13,13,5,17,9,13,11,12,12,14,11,12,15,6,12,7,9,12,14,14,14,10,14,11,13,20,13,12,11,9,14,13,10,13,15,14,10,16,15,15,7,1,1,18,20,13,16,20,M/AM LC,524,1,1,10,20,16,13,1,1,1,7,18,16,13,1,1,1280,0,0,0,0,0,0,0,0,1,0,1,0,0,0,0,0,0,0,0,0,0,0,0,0,0,0,0,0,0,0,0,0,0,0,0,0,0,0,0,0,0,0,0,0,0,0,0,0,Ederson,£4.50m ,34,181,Midfielder - Attacking Midfield,right,Retired,8,2,0,428,25,2,0,1037,23,3,3,854,22,1,1,963,13,4,1,407,8,1,0,308,5,0,0,218,0,0,0,0,nan,nan,nan,nan,Ligue 1,nan,nan,nan,nan,nan,nan,nan,nan
13/6/2011,Diogo Cunha,726052,788,2/10/1986,25,0,0,0,0,750,2000,2000,105,90,44742,172,62,M/AM RL,1,2,3,3,2,2,3,1,3,3,2,9,11,13,12,10,6,8,8,8,8,10,8,10,7,6,10,2,12,10,8,7,8,12,8,11,9,6,12,13,13,13,8,8,8,12,20,13,5,10,11,10,11,10,12,12,6,14,9,8,13,6,1,1,17,20,20,15,12,M/AM RL,525,1,1,7,12,15,20,1,1,1,1,6,10,17,1,1,0,0,0,0,0,0,0,0,0,0,0,0,0,0,0,0,0,0,0,0,0,0,0,0,0,0,0,0,0,0,0,0,0,0,0,0,0,0,0,0,0,0,0,0,0,0,0,0,0,Diogo Cunha,£900Th. ,34,170,Midfielder - Attacking Midfield,right,LusitÃ¢nia FC Lourosa,30,3,0,1992,29,1,1,2179,45,9,1,3446,40,6,2,2442,18,1,2,1216,38,2,8,2573,40,3,5,2280,26,0,3,1368,3,0,2,300,Liga NOS,3,0,0,211,nan,nan,nan,nan
13/6/2011,Dean Moxey,5112949,765,1/14/1986,25,0,0,0,0,2500,5000,5000,110,98,1552500,181,70,D/WB/M/AM L,1,3,3,3,3,1,3,4,1,3,2,11,14,10,9,8,11,9,9,17,6,9,13,12,12,11,12,11,12,9,8,11,8,9,10,12,6,11,12,11,10,12,9,20,14,15,5,12,11,12,11,12,10,17,3,12,10,14,16,14,14,5,20,19,18,16,8,20,8,D/WB/M/AM L,133,1,1,10,1,16,1,5,20,8,1,8,18,1,19,1,1.12604E+15,0,0,0,0,0,0,0,0,0,0,0,0,0,0,0,0,0,0,0,0,0,1,0,0,0,0,0,0,0,0,0,0,0,0,0,0,0,1,0,0,0,0,0,0,0,0,0,0,,,,,,,,,,,,,,,,,,,,,,,,,,,,,,,,,,,,,,,,,,,,,,,,,,,,
13/6/2011,David Silva,7458280,796,1/8/1986,25,48,11,9,7,7750,8250,8400,175,168,114999996,170,67,AM RLC,1,2,3,1,2,1,1,2,2,3,2,15,16,18,13,19,12,8,12,7,5,18,13,8,19,10,13,11,17,15,19,17,15,19,10,18,8,14,11,16,18,10,5,20,11,13,11,14,7,15,9,13,13,13,13,16,13,15,11,12,13,7,1,1,15,20,15,19,20,AM RLC,506,1,1,9,20,19,15,1,1,1,4,15,13,10,1,1,2.25182E+15,0,0,0,0,1,0,0,1,0,0,0,0,0,0,0,0,0,0,0,0,0,0,0,0,0,0,0,0,0,0,0,0,0,0,1,0,0,0,0,0,0,0,0,0,0,0,0,0,David Silva,£45.00m ,34,170,Midfielder - Attacking Midfield,left,Real Sociedad,53,6,14,3817,49,8,21,3876,41,5,13,3203,40,8,16,3043,42,12,14,3282,36,4,12,2793,45,8,11,3646,40,10,14,3198,50,10,14,3727,Premier League,40,6,11,2602,6,0,0,429
13/6/2011,Danijel Gataric,8725261,771,5/18/1986,25,0,0,0,0,2250,4450,4450,95,89,48704,181,75,D/M/AM RL,2,2,2,3,2,1,2,4,1,2,3,9,12,12,8,10,8,6,9,5,6,12,10,6,12,7,11,7,8,8,11,8,13,13,9,12,6,7,7,13,12,10,11,13,10,12,20,9,10,10,9,10,5,13,5,12,9,10,10,12,12,11,20,9,20,16,20,16,8,D/M/AM RL,125,1,1,5,8,13,16,1,10,20,2,6,16,20,1,9,1048706,0,1,0,0,0,0,0,1,0,0,0,0,0,0,0,0,0,0,0,0,1,0,0,0,0,0,0,0,0,0,0,0,0,0,0,0,0,0,0,0,0,0,0,0,0,0,0,0,,,,,,,,,,,,,,,,,,,,,,,,,,,,,,,,,,,,,,,,,,,,,,,,,,,,
13/6/2011,Daniel Osvaldo,962383,776,1/12/1986,25,0,0,12,2,5500,6900,7500,160,152,31560891,185,78,AM/S RL,3,3,2,1,2,3,3,3,1,2,3,9,13,14,15,12,11,14,13,7,9,13,13,9,15,14,14,18,14,14,12,13,12,13,16,14,8,14,16,13,12,15,13,12,13,14,20,15,15,12,12,13,13,13,12,16,8,11,10,9,11,10,1,1,5,16,15,16,10,AM/S RL,625,1,1,20,10,16,15,1,1,1,1,1,5,1,1,1,4.43241E+12,0,0,0,0,0,0,0,0,0,0,0,0,0,0,0,0,0,0,0,0,0,0,0,1,0,0,0,0,0,0,0,0,0,0,0,1,0,0,0,0,0,0,1,0,0,0,0,0,Daniel Osvaldo,£13.50m ,34,182,Forward - Centre-Forward,right,Without Club,25,13,3,1775,26,11,5,2092,31,17,2,2385,31,6,1,1542,34,13,7,1983,17,1,2,788,nan,nan,nan,nan,nan,nan,nan,nan,nan,nan,nan,nan,Serie A,2,0,0,60,nan,nan,nan,nan
13/6/2011,Damien Tibéri,34007722,769,8/23/1985,25,0,0,0,0,2500,3800,3800,128,115,1687664,181,70,M/AM L,3,2,2,3,1,2,3,1,1,2,2,14,14,12,7,12,13,8,12,10,7,12,8,8,12,7,11,9,13,13,13,12,14,11,8,11,10,13,15,14,12,13,9,20,14,11,5,15,11,14,7,13,9,12,6,13,15,12,14,14,14,8,15,15,18,20,1,20,10,M/AM L,523,1,1,1,10,20,1,1,15,1,10,10,18,1,15,1,1,1,0,0,0,0,0,0,0,0,0,0,0,0,0,0,0,0,0,0,0,0,0,0,0,0,0,0,0,0,0,0,0,0,0,0,0,0,0,0,0,0,0,0,0,0,0,0,0,Damien Tibéri,£630Th. ,35,181,Midfielder - Left Midfield,left,AS Sainte-Maxime,29,1,0,2107,31,0,1,1853,5,0,0,49,13,1,1,748,26,1,0,2257,nan,nan,nan,nan,1,0,0,15,2,0,0,163,nan,nan,nan,nan,Ligue 1,nan,nan,nan,nan,nan,nan,nan,nan
13/6/2011,Cristian Rodríguez,5512956,1657,9/30/1985,25,36,3,11,4,5500,7600,7000,148,140,4482210,175,72,AM L,3,3,3,2,3,2,1,9,1,1,1,14,14,14,12,14,13,13,13,8,7,13,15,9,15,13,14,15,13,12,15,11,13,13,14,16,10,10,15,14,14,14,9,20,12,14,4,13,13,13,8,14,11,13,13,14,13,13,12,9,9,6,1,1,13,20,10,20,12,AM L,503,1,1,10,12,20,10,1,1,1,1,7,13,1,1,1,2.25455E+15,0,0,0,0,0,0,0,0,0,0,0,0,0,0,0,0,0,0,0,0,0,0,0,0,0,0,0,0,0,0,0,1,0,0,0,0,0,0,0,1,0,1,0,0,0,0,0,0,Cristian Rodríguez,£4.50m ,35,177,Midfielder - Central Midfield,left,CA Peñarol,28,2,8,1068,17,2,2,800,48,3,1,2168,39,1,2,1039,30,4,2,1539,13,0,0,816,44,16,9,3279,29,15,5,2446,32,8,1,1883,Liga NOS,13,1,2,586,nan,nan,nan,nan
13/6/2011,Clément Tainmont,34006434,769,2/3/1986,25,0,0,0,0,1300,2650,2650,115,106,32915,185,72,AM L,3,2,2,1,2,1,3,1,3,3,1,12,12,11,9,13,8,14,11,7,5,10,8,5,13,9,10,12,11,11,10,11,16,11,6,11,9,8,14,14,13,14,12,20,14,13,5,11,11,12,9,13,6,8,15,12,13,15,14,14,14,6,10,10,15,20,1,20,1,AM L,503,1,1,12,1,20,1,1,10,1,1,1,15,1,10,1,1,1,0,0,0,0,0,0,0,0,0,0,0,0,0,0,0,0,0,0,0,0,0,0,0,0,0,0,0,0,0,0,0,0,0,0,0,0,0,0,0,0,0,0,0,0,0,0,0,,,,,,,,,,,,,,,,,,,,,,,,,,,,,,,,,,,,,,,,,,,,,,,,,,,,
13/6/2011,Chu-Young Park,5708178,135,7/10/1985,25,53,17,10,1,6050,7500,6750,155,150,6999999,182,75,AM/S LC,3,3,1,2,1,1,1,2,2,1,1,8,9,13,11,16,14,15,12,5,5,14,12,4,16,9,14,13,11,12,14,14,15,14,12,15,9,14,16,17,15,14,12,10,12,13,20,15,13,13,9,16,9,12,14,16,13,14,17,17,16,5,1,1,12,18,10,16,18,AM/S LC,624,1,1,20,18,16,10,1,1,1,1,1,12,10,1,1,1056784,0,0,0,0,1,0,0,0,0,0,0,0,0,1,0,0,0,0,0,0,1,0,0,0,0,0,0,0,0,0,0,0,0,0,0,0,0,0,0,0,0,0,0,0,0,0,0,0,Chu-young Park,£3.60m ,35,182,Forward - Centre-Forward,right,FC Seoul,35,12,1,3024,10,3,0,596,25,4,1,1066,3,0,0,100,31,10,2,2255,49,11,9,2796,39,10,3,1769,22,4,1,1049,36,12,7,2876,Premier League,26,7,2,1826,nan,nan,nan,nan
13/6/2011,Christian Gentner,8707887,771,8/14/1985,25,5,0,11,1,5400,6850,6850,153,142,23084248,189,81,M/AM RLC,1,3,3,1,2,3,2,2,1,1,2,10,16,13,7,14,9,12,7,10,11,13,8,9,14,14,9,12,7,10,15,15,9,9,11,13,10,16,17,15,10,12,14,20,17,15,17,17,11,11,8,12,4,17,10,8,12,14,12,13,16,12,1,1,20,16,16,19,20,M/AM RLC,416,1,1,1,16,16,15,1,1,1,14,20,19,16,1,1,0,0,0,0,0,0,0,0,0,0,0,0,0,0,0,0,0,0,0,0,0,0,0,0,0,0,0,0,0,0,0,0,0,0,0,0,0,0,0,0,0,0,0,0,0,0,0,0,0,Christian Gentner,£4.50m ,35,189,Midfielder - Central Midfield,right,1.FC Union Berlin,42,8,3,2906,32,5,3,1735,52,9,8,4563,33,5,5,2970,34,5,4,3031,32,5,5,2816,36,7,4,3112,29,3,2,2595,32,1,5,2231,Bundesliga,34,4,3,2628,4,0,0,198
13/6/2011,Christian Fuchs,5603918,755,4/7/1986,25,41,1,10,3,5900,6569,7300,153,146,4204871,186,82,D/M/AM L,3,1,1,2,3,2,2,9,2,1,2,13,18,11,6,14,18,9,15,17,8,15,6,9,13,10,9,11,12,10,14,16,14,11,13,15,8,15,17,15,13,12,12,20,14,17,8,16,13,12,5,12,7,13,15,16,6,15,17,15,14,3,20,15,18,16,9,20,1,D/M/AM L,123,1,1,1,1,16,1,1,20,9,1,1,18,1,15,1,9.96432E+12,0,0,0,1,0,0,0,0,0,0,0,1,0,0,0,0,0,0,0,0,0,0,0,0,0,0,0,0,0,0,0,0,0,0,0,0,1,0,0,0,1,0,0,1,0,0,0,0,Christian Fuchs,£5.85m ,34,187,Defender - Left-Back,left,Leicester City,33,0,8,2702,44,4,14,3991,37,1,5,2805,25,0,6,1397,30,3,5,2148,34,0,5,2920,48,2,5,4081,29,0,2,2337,8,1,1,656,Bundesliga,17,0,0,1243,4,0,0,280
13/6/2011,Christian Essig,8727510,771,1/24/1986,25,0,0,0,0,2750,4400,4400,100,88,57344,180,76,M/AM/S L,2,3,2,1,1,2,2,1,1,3,1,8,9,10,9,10,7,5,9,10,8,9,7,7,10,7,9,7,7,9,10,9,8,11,8,10,7,9,8,13,12,10,10,20,10,12,15,9,9,8,5,9,9,13,13,11,9,12,6,12,6,6,1,1,20,20,13,20,1,M/AM/S L,423,1,1,17,1,20,11,1,1,1,1,1,20,13,1,1,0,0,0,0,0,0,0,0,0,0,0,0,0,0,0,0,0,0,0,0,0,0,0,0,0,0,0,0,0,0,0,0,0,0,0,0,0,0,0,0,0,0,0,0,0,0,0,0,0,Christian Eigler,£1.13m ,36,185,Forward - Right Winger,right,SV Unterreichenbach,36,8,4,2418,25,1,2,1360,28,6,3,2336,24,2,1,1330,nan,nan,nan,nan,nan,nan,nan,nan,nan,nan,nan,nan,nan,nan,nan,nan,nan,nan,nan,nan,Bundesliga,nan,nan,nan,nan,nan,nan,nan,nan
13/6/2011,Chris Eagles,5112070,765,11/19/1985,25,0,0,0,0,4100,6050,6050,145,124,5232500,183,67,M/AM RLC,1,3,3,3,3,2,2,2,2,2,1,13,13,15,13,14,13,7,11,2,7,13,9,5,14,8,10,10,11,11,13,8,13,14,4,14,5,9,11,15,14,14,7,11,12,14,20,12,6,9,14,6,4,12,9,14,14,11,15,14,15,4,1,1,17,20,20,19,17,M/AM RLC,526,1,1,1,17,19,20,1,1,1,1,10,15,17,1,1,1.0308E+11,0,1,0,0,0,0,0,0,1,0,0,0,0,0,0,0,0,0,0,0,1,0,0,0,0,0,0,0,0,0,0,0,0,0,0,1,1,0,0,0,0,0,0,0,0,0,0,0,Chris Eagles,£4.95m ,34,183,Forward - Right Winger,right,Without Club,48,15,12,3699,41,6,8,2732,47,12,13,3769,18,1,4,1288,22,3,0,990,5,0,0,129,30,4,2,1775,9,0,4,498,nan,nan,nan,nan,Premier League,18,0,3,674,nan,nan,nan,nan
13/6/2011,Charly Charrier,8441932,769,5/27/1986,25,0,0,0,0,1100,2200,2200,110,88,40473,181,79,M/AM L,3,2,3,3,3,2,3,1,3,2,2,13,11,11,8,11,12,8,9,5,3,10,10,3,13,4,11,11,11,11,11,9,10,11,5,11,5,8,12,14,13,13,10,20,12,11,5,11,13,14,13,10,6,10,9,10,19,7,8,14,10,5,1,1,16,20,1,20,14,M/AM L,523,1,1,1,14,20,1,1,1,1,1,14,16,1,1,1,0,0,0,0,0,0,0,0,0,0,0,0,0,0,0,0,0,0,0,0,0,0,0,0,0,0,0,0,0,0,0,0,0,0,0,0,0,0,0,0,0,0,0,0,0,0,0,0,0,,,,,,,,,,,,,,,,,,,,,,,,,,,,,,,,,,,,,,,,,,,,,,,,,,,,
13/6/2011,Charles N'Zogbia,8430843,769,5/28/1986,25,2,1,16,0,6000,6400,7000,162,142,23327749,171,70,AM RLC,3,2,2,3,3,2,3,5,3,2,2,12,13,15,12,12,13,6,13,1,9,12,8,11,12,10,11,11,13,9,11,11,14,14,5,11,8,10,12,16,12,12,6,20,12,16,10,11,11,11,5,11,3,12,15,14,7,14,5,15,13,11,15,1,9,20,20,20,17,AM RLC,506,1,1,1,17,20,20,1,15,1,1,1,9,1,1,1,5.84116E+11,0,0,1,0,0,0,0,0,0,0,0,0,0,0,0,0,0,0,0,0,0,0,0,0,0,0,0,0,0,0,0,0,0,0,0,1,0,0,0,1,0,0,0,0,0,0,0,0,Charles N'Zogbia,£8.10m ,34,171,Forward - Right Winger,left,Retired,38,10,11,2927,32,2,6,2154,28,3,8,1490,nan,nan,nan,nan,32,0,3,1702,2,0,0,41,nan,nan,nan,nan,nan,nan,nan,nan,nan,nan,nan,nan,Premier League,nan,nan,nan,nan,nan,nan,nan,nan
13/6/2011,Carsten Weis,8728195,771,1/18/1986,25,0,0,0,0,500,3000,3000,83,60,6450,178,76,AM RLC,1,1,1,3,1,1,3,1,2,3,2,8,10,4,2,9,8,4,6,1,8,9,8,8,9,11,9,9,6,8,9,9,10,9,12,10,2,5,5,12,10,10,5,15,6,11,20,10,3,10,13,10,8,10,11,12,14,12,14,15,16,13,1,1,15,20,17,15,20,AM RLC,506,1,1,1,20,15,17,1,1,1,1,15,15,15,1,1,0,0,0,0,0,0,0,0,0,0,0,0,0,0,0,0,0,0,0,0,0,0,0,0,0,0,0,0,0,0,0,0,0,0,0,0,0,0,0,0,0,0,0,0,0,0,0,0,0,,,,,,,,,,,,,,,,,,,,,,,,,,,,,,,,,,,,,,,,,,,,,,,,,,,,
13/6/2011,Carlos Calvo,1509236,796,9/18/1985,25,0,0,0,0,3500,5900,5900,138,119,736139,175,71,M/AM RL,2,3,2,3,3,1,3,3,3,3,3,8,11,12,10,11,12,4,12,5,4,12,8,5,13,11,9,10,9,13,12,11,10,14,5,15,12,12,13,15,14,8,6,14,9,14,20,12,9,10,5,10,5,13,12,14,10,8,15,15,11,5,1,1,17,20,20,20,1,M/AM RL,525,1,1,10,1,20,20,1,1,1,1,1,17,17,1,1,525312,0,0,0,0,0,0,0,0,0,0,1,0,0,0,0,0,0,0,0,1,0,0,0,0,0,0,0,0,0,0,0,0,0,0,0,0,0,0,0,0,0,0,0,0,0,0,0,0,Carlos Carmona,£1.80m ,33,178,Midfielder - Defensive Midfield,right,CSD Colo Colo,32,0,3,2606,29,1,0,2045,23,2,2,1705,33,2,0,2636,34,0,0,2898,9,0,0,558,35,2,1,2996,29,1,3,2421,2,0,0,177,Serie A,10,0,0,655,nan,nan,nan,nan
13/6/2011,Bryan Ruíz,18003360,366,8/21/1985,25,35,9,0,0,6500,7500,8000,163,158,23638537,185,78,AM RL,1,3,1,3,2,1,1,8,2,1,1,12,14,16,14,16,12,13,12,7,6,15,15,5,18,10,13,15,14,11,15,12,14,19,11,15,7,10,12,15,15,10,13,20,14,15,10,12,12,16,10,10,13,10,8,13,14,14,14,17,15,1,1,1,14,20,20,17,12,AM RL,505,1,1,15,12,17,20,1,1,1,1,1,14,14,1,1,0,0,0,0,0,0,0,0,0,0,0,0,0,0,0,0,0,0,0,0,0,0,0,0,0,0,0,0,0,0,0,0,0,0,0,0,0,0,0,0,0,0,0,0,0,0,0,0,0,Bryan Ruíz,£9.00m ,35,188,Midfielder - Attacking Midfield,left,LD Alajuelense,40,10,11,3268,38,7,9,2409,31,5,9,2544,28,6,7,2055,32,5,4,2189,46,13,15,3611,42,3,8,2707,47,2,5,2241,nan,nan,nan,nan,Premier League,nan,nan,nan,nan,8,2,1,562
13/6/2011,Benoît Trémoulinas,8428512,769,12/28/1985,25,0,0,0,0,6100,6300,6300,160,140,11145138,173,64,D/WB/M L,2,1,2,3,3,1,3,6,2,3,1,13,15,13,6,13,13,8,11,12,9,13,9,13,14,10,13,12,13,13,13,12,14,11,7,13,12,16,15,16,14,11,6,20,16,15,10,17,7,13,7,15,7,8,17,16,15,13,13,14,14,8,20,18,16,12,10,20,1,D/WB/M L,123,1,1,1,1,12,1,1,20,10,1,1,16,1,18,10,33,1,0,0,0,0,1,0,0,0,0,0,0,0,0,0,0,0,0,0,0,0,0,0,0,0,0,0,0,0,0,0,0,0,0,0,0,0,0,0,0,0,0,0,0,0,0,0,0,Benoît Trémoulinas,£7.20m ,34,173,Defender - Left-Back,left,Retired,34,0,5,2897,40,3,4,3658,45,2,10,3847,26,0,6,2320,33,0,7,2682,37,1,3,3264,nan,nan,nan,nan,nan,nan,nan,nan,nan,nan,nan,nan,Ligue 1,nan,nan,nan,nan,nan,nan,nan,nan
13/6/2011,Bastian Heidenfelder,35020896,771,1/8/1986,25,0,0,0,0,2750,4500,4500,105,90,94723,174,80,S RL,3,3,3,3,1,3,3,2,1,3,1,6,10,10,11,10,7,8,7,4,4,9,6,5,10,9,10,9,9,10,9,11,10,8,8,9,9,11,11,12,9,11,8,15,7,10,20,13,13,9,6,9,6,7,6,6,6,10,15,20,7,11,1,1,1,15,15,15,1,S RL,605,1,1,20,1,15,15,1,1,1,1,1,1,1,1,1,0,0,0,0,0,0,0,0,0,0,0,0,0,0,0,0,0,0,0,0,0,0,0,0,0,0,0,0,0,0,0,0,0,0,0,0,0,0,0,0,0,0,0,0,0,0,0,0,0,,,,,,,,,,,,,,,,,,,,,,,,,,,,,,,,,,,,,,,,,,,,,,,,,,,,
13/6/2011,Barreto,7987008,1651,7/12/1985,25,0,0,0,0,4000,7040,6400,135,128,3942330,171,72,S RL,2,3,2,2,2,1,2,4,2,2,3,5,9,15,14,14,14,4,12,9,7,13,12,5,15,12,9,8,13,7,12,10,18,17,6,14,8,12,13,16,17,9,8,8,10,15,20,14,6,12,4,15,14,11,16,18,13,17,12,14,10,6,1,1,1,15,15,15,1,S RL,605,1,1,20,1,15,15,1,1,1,1,1,1,1,1,1,16,0,0,0,0,1,0,0,0,0,0,0,0,0,0,0,0,0,0,0,0,0,0,0,0,0,0,0,0,0,0,0,0,0,0,0,0,0,0,0,0,0,0,0,0,0,0,0,0,Barreto,£2.25m ,35,171,Forward - Second Striker,right,Without Club,13,4,1,988,9,1,0,346,20,3,2,1214,11,0,1,508,6,1,0,280,5,0,0,217,nan,nan,nan,nan,nan,nan,nan,nan,nan,nan,nan,nan,Serie A,5,0,0,72,nan,nan,nan,nan
13/6/2011,Babacar Gueye,8431107,41,3/2/1986,25,25,7,0,0,3750,5400,5500,120,108,662471,186,78,AM/S RL,2,3,1,2,2,1,3,3,2,3,2,6,9,11,9,13,8,12,10,6,3,7,12,3,13,7,11,11,9,11,9,8,11,14,8,13,5,12,14,13,13,14,12,20,13,14,8,14,14,10,7,13,7,5,9,15,13,8,10,13,13,10,1,1,10,20,15,20,14,AM/S RL,515,1,1,20,14,20,15,1,1,1,1,1,10,1,1,1,1048576,0,0,0,0,0,0,0,0,0,0,0,0,0,0,0,0,0,0,0,0,1,0,0,0,0,0,0,0,0,0,0,0,0,0,0,0,0,0,0,0,0,0,0,0,0,0,0,0,,,,,,,,,,,,,,,,,,,,,,,,,,,,,,,,,,,,,,,,,,,,,,,,,,,,
13/6/2011,Ayoze,1501582,796,11/22/1985,25,0,0,0,0,3900,6050,6050,129,121,4331467,172,65,M/AM RL,1,3,1,3,3,1,2,4,1,3,1,12,12,12,12,11,13,9,14,5,7,12,14,7,12,14,13,15,11,13,10,11,16,11,14,14,10,12,14,14,14,6,7,20,10,15,5,14,10,14,13,14,15,13,10,13,17,10,12,11,8,13,1,5,19,20,15,20,1,M/AM RL,525,1,1,5,1,20,15,1,1,1,1,1,19,5,5,1,1.11683E+12,0,0,0,0,0,0,0,0,1,0,0,0,0,0,0,0,0,0,0,0,0,0,0,0,0,0,0,1,0,0,0,0,0,0,1,0,0,0,0,0,1,0,0,0,0,0,0,0,Ayoze,£810Th. ,34,172,Defender - Left-Back,left,Indy Eleven,14,1,0,609,17,0,0,827,14,0,1,1147,17,1,2,1523,31,1,4,2773,35,1,3,3033,30,5,5,2583,30,4,8,2676,33,3,5,2843,LaLiga,10,1,3,694,nan,nan,nan,nan
13/6/2011,Ashley Young,5113149,765,7/9/1985,25,15,2,10,0,6400,7700,7750,165,152,78273183,175,65,AM RLC,1,1,2,3,1,1,1,4,1,1,3,16,15,14,14,16,12,6,11,3,3,13,12,4,14,7,14,8,13,12,12,10,13,14,5,15,7,11,13,18,15,12,7,10,15,16,20,14,6,14,5,15,5,13,16,12,8,12,13,7,14,4,1,1,14,20,18,20,19,AM RLC,506,1,1,15,19,20,18,1,1,1,1,1,14,14,1,1,7.09185E+13,1,0,0,0,0,0,0,0,0,0,1,1,0,0,0,0,0,0,0,0,0,0,0,0,0,0,0,0,0,0,0,0,0,0,0,0,0,0,0,1,0,0,0,0,0,0,1,0,Ashley Young,£24.30m ,35,175,Midfielder - Left Midfield,both,Inter Milan,40,9,13,3538,33,8,12,2222,23,0,5,1471,30,3,5,1489,30,2,6,2256,27,1,3,1627,23,0,1,1469,39,2,7,3156,41,2,3,3509,Premier League,43,5,6,3005,3,0,1,152
13/6/2011,Amadou Sidibé,8633053,31,2/19/1986,25,8,0,0,0,2550,5800,5100,120,116,8052449,173,72,D/WB L,3,2,2,3,3,1,2,4,2,3,3,8,12,13,6,12,7,7,9,12,8,11,7,14,12,10,13,12,11,10,9,10,10,12,7,11,9,12,15,16,16,12,6,20,14,15,5,15,12,11,10,13,8,8,7,12,13,8,11,14,14,7,20,17,15,10,10,20,1,D/WB L,113,1,1,1,1,10,1,1,20,10,1,1,15,1,17,1,1,1,0,0,0,0,0,0,0,0,0,0,0,0,0,0,0,0,0,0,0,0,0,0,0,0,0,0,0,0,0,0,0,0,0,0,0,0,0,0,0,0,0,0,0,0,0,0,0,Amadou Sidibé,£810Th. ,34,173,Defender - Left-Back,left,Retired,10,0,1,803,13,0,0,834,16,0,0,1330,nan,nan,nan,nan,nan,nan,nan,nan,nan,nan,nan,nan,nan,nan,nan,nan,nan,nan,nan,nan,nan,nan,nan,nan,Ligue 1,nan,nan,nan,nan,nan,nan,nan,nan
13/6/2011,Alexis Lafon,919620,769,1/26/1986,25,0,0,0,0,1200,2400,2400,120,97,27986,182,75,AM L,3,2,2,1,3,1,2,1,1,1,1,13,11,11,7,11,7,9,7,5,3,8,8,3,12,12,8,8,10,12,11,11,13,11,6,11,6,8,12,12,12,12,11,20,17,17,5,12,12,13,10,10,8,10,10,13,10,11,8,6,8,14,1,1,15,20,12,20,1,AM L,503,1,1,1,1,20,12,1,1,1,1,1,15,12,1,1,1,1,0,0,0,0,0,0,0,0,0,0,0,0,0,0,0,0,0,0,0,0,0,0,0,0,0,0,0,0,0,0,0,0,0,0,0,0,0,0,0,0,0,0,0,0,0,0,0,Alexis Ruano,£2.25m ,35,183,Defender - Centre-Back,right,Without Club,31,2,1,2632,14,2,0,1165,28,3,0,2426,31,0,0,2614,33,1,1,2823,28,2,0,2464,28,2,2,2085,30,1,0,2393,10,0,0,806,LaLiga,20,0,0,1554,nan,nan,nan,nan
13/6/2011,Akihiro Ienaga,777264,116,6/13/1986,25,2,0,9,1,4000,5759,6000,140,128,778680,170,65,M/AM L,3,3,1,1,1,1,2,1,3,3,3,10,14,14,12,14,10,6,10,6,7,11,10,7,14,11,14,9,14,13,11,12,9,13,15,12,8,8,13,15,13,7,9,20,11,13,11,12,9,10,5,10,11,12,8,8,16,9,14,12,12,12,1,1,20,18,12,20,13,M/AM L,413,1,1,9,10,18,12,1,1,1,11,13,20,11,1,1,0,0,0,0,0,0,0,0,0,0,0,0,0,0,0,0,0,0,0,0,0,0,0,0,0,0,0,0,0,0,0,0,0,0,0,0,0,0,0,0,0,0,0,0,0,0,0,0,0,Akihiro Ienaga,£900Th. ,34,173,Midfielder - Attacking Midfield,left,Kawasaki Frontale,14,2,1,464,43,7,2,2136,17,1,1,1103,49,6,9,3795,36,11,5,2971,31,13,5,2581,35,5,10,2444,41,7,9,3482,37,1,4,3028,LaLiga,24,6,4,1648,nan,nan,nan,nan
13/6/2011,Adrián Ramos,8829000,1653,1/22/1986,25,19,2,11,3,5750,7000,7000,148,141,13309989,185,72,S L,1,3,1,1,2,3,3,3,1,1,1,5,7,14,8,10,5,14,6,6,6,9,13,7,13,15,11,17,9,10,9,11,15,12,7,15,10,7,17,16,15,11,16,14,17,18,20,15,12,12,8,13,9,12,12,16,8,11,12,12,16,11,1,1,1,15,14,15,1,S L,603,1,1,20,1,15,14,1,1,1,1,1,1,1,1,1,2.25235E+15,0,0,0,0,1,0,0,0,0,0,1,0,0,0,0,0,0,0,0,1,0,0,0,0,0,0,0,0,0,0,0,0,0,0,0,0,0,0,0,1,0,0,0,0,0,0,0,0,Adrián Ramos,£4.05m ,34,185,Forward - Centre-Forward,right,CD América de Cali,35,17,10,3049,37,10,8,2739,33,11,9,2570,34,16,6,2740,29,6,2,955,39,10,6,1503,25,7,2,1799,26,4,0,1822,39,6,3,2248,Bundesliga,16,3,1,984,nan,nan,nan,nan
13/6/2011,Abraham,67024406,796,2/22/1986,25,0,0,0,0,3300,5800,5800,123,116,2325096,175,71,D/WB/M L,2,3,3,2,3,3,1,1,1,2,3,9,12,11,8,11,7,8,9,11,12,14,10,11,13,9,11,13,12,13,12,10,10,8,9,14,12,13,13,14,12,9,8,20,14,13,8,13,10,11,8,9,7,12,18,14,13,14,8,11,7,12,18,20,17,14,1,20,12,D/WB/M L,233,1,1,1,1,14,1,1,18,1,1,12,17,1,20,1,0,0,0,0,0,0,0,0,0,0,0,0,0,0,0,0,0,0,0,0,0,0,0,0,0,0,0,0,0,0,0,0,0,0,0,0,0,0,0,0,0,0,0,0,0,0,0,0,0,,,,,,,,,,,,,,,,,,,,,,,,,,,,,,,,,,,,,,,,,,,,,,,,,,,,
