GameDate,Name,UID,NationID,Born,Age,IntCaps,IntGoals,U21Caps,U21Goals,WorldReputation,HomeReputation,CurrentReputation,PA,CA,Price,Height,Weight,PositionsString,GK.AerialAbility,GK.CommandOfArea,GK.Communication,GK.Eccentricity,GK.Handling,GK.Kicking,GK.OneOnOnes,GK.Reflexes,GK.RushingOut,GK.TendencyToPunch,GK.Throwing,Tech.Corners,Tech.Crossing,Tech.Dribbling,Tech.Finishing,Tech.FirstTouch,Tech.Freekicks,Tech.Heading,Tech.LongShots,Tech.Longthrows,Tech.Marking,Tech.Passing,Tech.PenaltyTaking,Tech.Tackling,Tech.Technique,Mental.Aggression,Mental.Anticipation,Mental.Bravery,Mental.Composure,Mental.Concentration,Mental.Vision,Mental.Decisions,Mental.Determination,Mental.Flair,Mental.Leadership,Mental.OffTheBall,Mental.Positioning,Mental.Teamwork,Mental.Workrate,Phy.Acceleration,Phy.Agility,Phy.Balance,Phy.Jumping,Phy.LeftFoot,Phy.NaturalFitness,Phy.Pace,Phy.RightFoot,Phy.Stamina,Phy.Strength,Hidden.Consistency,Hidden.Dirtiness,Hidden.ImportantMatches,Hidden.InjuryProness,Hidden.Versatility,Personality.Adaptability,Personality.Ambition,Personality.Loyalty,Personality.Pressure,Personality.Professional,Personality.Sportsmanship,Personality.Temperament,Personality.Controversy,Positions.Defender,Positions.WingBack,Positions.Midfielder,Positions.AttackingMidfielder,Positions.Right,Positions.Left,Positions.Centre,Positions.PositionsDesc,Positions.PositionsDescVal,Positions.Goalkeeper,Positions.Sweeper,Positions.Striker,Positions.AttackingMidCentral,Positions.AttackingMidLeft,Positions.AttackingMidRight,Positions.DefenderCentral,Positions.DefenderLeft,Positions.DefenderRight,Positions.DefensiveMidfielder,Positions.MidfielderCentral,Positions.MidfielderLeft,Positions.MidfielderRight,Positions.WingBackLeft,Positions.WingBackRight,PPMVal,PPM0,PPM1,PPM2,PPM3,PPM4,PPM5,PPM6,PPM7,PPM8,PPM9,PPM10,PPM11,PPM12,PPM13,PPM14,PPM15,PPM16,PPM17,PPM18,PPM19,PPM20,PPM21,PPM22,PPM23,PPM24,PPM25,PPM26,PPM27,PPM28,PPM29,PPM30,PPM31,PPM32,PPM33,PPM34,PPM35,PPM36,PPM37,PPM38,PPM39,PPM40,PPM41,PPM42,PPM43,PPM44,PPM45,PPM46,PPM47,name,Market Value,age,height,position,foot,current club,10/11 games,10/11 goals/conceded,10/11 assists/clean,10/11 minutes,11/12 games,11/12 goals/conceded,11/12 assists/clean,11/12 minutes,12/13 games,12/13 goals/conceded,12/13 assists/clean,12/13 minutes,13/14 games,13/14 goals/conceded,13/14 assists/clean,13/14 minutes,14/15 games,14/15 goals/conceded,14/15 assists/clean,14/15 minutes,15/16 games,15/16 goals/conceded,15/16 assists/clean,15/16 minutes,16/17 games,16/17 goals/conceded,16/17 assists/clean,16/17 minutes,17/18 games,17/18 goals/conceded,17/18 assists/clean,17/18 minutes,18/19 games,18/19 goals/conceded,18/19 assists/clean,18/19 minutes,current league,19/20 games,19/20 goals/conceded,19/20 assists/clean,19/20 minutes,20/21 games,20/21 goals/conceded,20/21 assists/clean,20/21 minutes
19/6/2011,Zé Eduardo,19070329,1651,8/16/1991,19,0,0,7,0,2505,5350,5011,144,105,196378,186,80,DM/M/AM C,1,3,1,1,1,3,2,3,2,2,1,1,9,12,10,10,4,12,9,4,12,11,11,13,12,12,11,15,11,11,9,11,11,5,11,11,11,12,12,14,13,13,13,6,15,14,20,14,13,11,11,11,12,15,3,16,5,9,10,11,7,15,1,1,20,16,11,1,20,DM/M/AM C,431,1,1,1,16,1,7,1,1,1,19,20,1,11,1,1,34,0,1,0,0,0,1,0,0,0,0,0,0,0,0,0,0,0,0,0,0,0,0,0,0,0,0,0,0,0,0,0,0,0,0,0,0,0,0,0,0,0,0,0,0,0,0,0,0,Zé Eduardo,£450Th. ,29.0,186.0,Midfielder - Defensive Midfield,right,Sandefjord Fotball,14.0,0.0,0.0,1140.0,20.0,0.0,0.0,1328.0,35.0,4.0,3.0,2778.0,41.0,3.0,5.0,3331.0,14.0,1.0,1.0,735.0,16.0,0.0,1.0,1104.0,nan,nan,nan,nan,27.0,4.0,1.0,2019.0,30.0,0.0,1.0,2455.0,Serie A,4.0,1.0,0.0,166.0,nan,nan,nan,nan
19/6/2011,Zdravko Kuzmanovic,5727648,802,9/22/1987,23,38,4,0,0,6500,7150,7050,159,141,3481159,186,72,DM/M C,3,1,2,2,3,1,2,4,3,2,1,9,14,8,13,14,13,12,15,10,9,16,15,11,14,9,14,12,17,17,14,16,9,8,13,10,12,18,12,8,8,17,14,13,16,13,20,15,14,14,12,11,3,12,16,15,8,15,12,5,14,9,1,1,20,8,12,10,20,DM/M C,421,1,1,1,8,1,1,1,1,1,18,20,10,12,1,1,35184376283136,0,0,0,0,0,0,0,0,0,0,0,0,0,0,0,0,0,0,0,0,0,0,1,0,0,0,0,0,0,0,0,0,0,0,0,0,0,0,0,0,0,0,0,0,0,1,0,0,Zdravko Kuzmanovic,£8.10m ,33.0,186.0,Midfielder - Central Midfield,right,Retired,47.0,11.0,6.0,3689.0,29.0,6.0,3.0,2001.0,31.0,0.0,4.0,2023.0,16.0,0.0,0.0,924.0,25.0,1.0,5.0,1482.0,34.0,0.0,0.0,2286.0,4.0,0.0,0.0,216.0,8.0,0.0,1.0,482.0,17.0,2.0,1.0,841.0,Bundesliga,5.0,0.0,1.0,158.0,nan,nan,nan,nan
19/6/2011,Yunus Malli,91017783,771,2/24/1992,19,0,0,0,0,2500,5250,5250,146,105,424054,179,70,M/AM RC,3,3,3,3,2,2,1,4,2,1,2,9,10,13,8,13,14,4,12,2,6,12,13,4,15,9,12,6,7,11,14,11,6,13,6,14,4,9,8,14,17,7,3,10,11,15,20,13,4,8,7,7,8,10,13,1,3,14,13,6,6,6,1,1,18,20,16,10,20,M/AM RC,523,1,1,1,20,10,16,1,1,1,10,18,10,15,1,1,0,0,0,0,0,0,0,0,0,0,0,0,0,0,0,0,0,0,0,0,0,0,0,0,0,0,0,0,0,0,0,0,0,0,0,0,0,0,0,0,0,0,0,0,0,0,0,0,0,Yunus Malli,£720Th. ,28.0,179.0,Midfielder - Attacking Midfield,right,VfL Wolfsburg,30.0,7.0,9.0,2412.0,22.0,5.0,3.0,1305.0,23.0,3.0,2.0,1390.0,29.0,5.0,5.0,1676.0,34.0,6.0,4.0,2416.0,36.0,11.0,5.0,2946.0,43.0,9.0,9.0,3377.0,37.0,6.0,5.0,2704.0,23.0,1.0,2.0,773.0,Bundesliga,15.0,0.0,1.0,726.0,1.0,0.0,0.0,58.0
19/6/2011,Yuki Ohtsu,45015203,116,3/24/1990,21,0,0,1,0,2000,5150,5000,113,101,126482,180,73,M/AM C,1,2,1,2,3,1,3,2,1,3,2,10,8,14,14,13,9,8,10,8,14,13,10,9,11,13,14,8,14,8,12,7,10,13,8,14,8,10,11,12,10,7,9,11,16,12,20,7,7,10,7,7,9,10,7,13,17,7,12,8,10,13,1,1,20,17,1,1,20,M/AM C,411,1,1,12,17,1,1,1,1,1,1,20,1,1,1,1,0,0,0,0,0,0,0,0,0,0,0,0,0,0,0,0,0,0,0,0,0,0,0,0,0,0,0,0,0,0,0,0,0,0,0,0,0,0,0,0,0,0,0,0,0,0,0,0,0,Yuki Otsu,£360Th. ,30.0,180.0,Midfielder - Attacking Midfield,right,Yokohama F. Marinos,11.0,0.0,2.0,797.0,13.0,0.0,5.0,697.0,27.0,7.0,3.0,1309.0,22.0,4.0,3.0,1631.0,37.0,3.0,4.0,1562.0,26.0,3.0,4.0,916.0,23.0,1.0,0.0,880.0,36.0,3.0,4.0,2269.0,32.0,3.0,1.0,1265.0,Bundesliga,12.0,0.0,0.0,336.0,nan,nan,nan,nan
19/6/2011,Youssuf Mulumbu,8440126,53,1/25/1987,24,12,0,0,0,5900,7500,7400,157,144,2742073,177,69,DM/M C,3,3,1,1,2,3,2,5,2,3,1,3,7,12,9,14,5,10,9,7,12,14,4,14,14,13,16,16,13,12,13,13,17,9,14,13,16,16,18,13,13,13,9,12,17,12,20,18,15,17,8,14,6,13,15,14,15,14,13,13,11,7,8,8,20,1,8,1,20,DM/M C,311,1,1,1,1,1,1,3,1,8,20,20,1,5,1,8,557120,0,0,0,0,0,0,1,0,0,0,0,0,0,0,0,1,0,0,0,1,0,0,0,0,0,0,0,0,0,0,0,0,0,0,0,0,0,0,0,0,0,0,0,0,0,0,0,0,Youssouf Mulumbu,£3.15m ,33.0,177.0,Midfielder - Defensive Midfield,right,Kilmarnock FC,34.0,6.0,1.0,2862.0,36.0,1.0,4.0,2900.0,30.0,2.0,2.0,2620.0,38.0,2.0,2.0,3169.0,22.0,0.0,0.0,1191.0,10.0,0.0,0.0,600.0,16.0,0.0,1.0,846.0,20.0,1.0,4.0,1602.0,15.0,1.0,2.0,1120.0,Premier League,nan,nan,nan,nan,3.0,0.0,0.0,19.0
19/6/2011,Younousse Sankharé,34011678,769,9/10/1989,21,0,0,16,2,4250,5354,5350,150,119,1548788,184,76,DM/M C,1,2,2,1,2,1,2,6,1,3,3,10,10,13,7,13,12,13,10,6,8,14,9,9,15,12,13,12,11,11,13,11,12,13,10,11,10,11,12,15,13,15,13,20,15,13,5,16,15,13,12,14,5,12,13,15,15,7,11,11,13,11,8,8,20,14,1,12,20,DM/M C,421,1,1,1,14,12,1,5,8,1,17,20,12,1,8,1,34359739040,0,0,0,0,0,1,0,1,0,1,0,0,0,0,0,0,0,0,0,0,0,0,0,0,0,0,0,0,0,0,0,0,0,0,0,1,0,0,0,0,0,0,0,0,0,0,0,0,Younousse Sankharé,£1.80m ,31.0,184.0,Midfielder - Central Midfield,left,CSKA Sofia,27.0,6.0,0.0,2305.0,38.0,5.0,0.0,3140.0,20.0,0.0,2.0,1552.0,40.0,3.0,4.0,3372.0,41.0,0.0,5.0,3325.0,36.0,6.0,2.0,3251.0,41.0,7.0,4.0,3259.0,33.0,10.0,1.0,2234.0,33.0,4.0,5.0,2353.0,Ligue 1,nan,nan,nan,nan,12.0,2.0,2.0,780.0
19/6/2011,Yohan Cabaye,919628,769,1/14/1986,25,4,0,16,3,6650,7400,6913,160,148,4796050,175,72,DM/M C,1,3,2,1,2,1,2,4,1,3,1,14,14,13,10,14,15,9,16,7,8,17,15,12,14,12,15,14,14,14,14,14,16,9,14,10,13,16,15,14,14,13,8,10,15,12,20,16,12,15,12,14,8,8,14,17,13,15,11,12,12,10,1,1,20,12,1,1,20,DM/M C,311,1,1,1,12,1,1,1,1,1,20,20,1,1,1,1,8813272891648,0,0,0,0,0,0,0,0,1,0,0,0,0,0,0,0,0,0,0,0,0,0,0,0,0,0,0,0,0,0,0,0,0,0,1,0,0,0,0,0,0,0,0,1,0,0,0,0,Yohan Cabaye,£14.85m ,34.0,173.0,Midfielder - Central Midfield,right,Without Club,50.0,5.0,11.0,3975.0,38.0,5.0,9.0,3254.0,35.0,6.0,2.0,2689.0,41.0,8.0,6.0,2577.0,36.0,2.0,1.0,1634.0,40.0,6.0,2.0,3178.0,35.0,4.0,3.0,2339.0,34.0,0.0,1.0,2577.0,12.0,1.0,2.0,1070.0,Premier League,21.0,1.0,1.0,1173.0,nan,nan,nan,nan
19/6/2011,Yoann Gourcuff,919541,769,7/11/1986,24,28,4,19,4,6150,6850,6850,165,152,3950941,185,79,M/AM C,2,2,1,2,3,2,3,6,3,3,3,14,14,14,9,17,14,13,14,5,7,16,14,7,17,12,12,11,13,12,15,12,15,13,8,11,12,15,15,13,14,14,12,14,13,14,20,17,14,10,12,17,10,10,12,16,14,7,17,13,13,5,1,1,18,20,12,12,20,M/AM C,521,1,1,1,20,12,12,1,1,1,12,18,12,12,1,1,140737493614848,0,0,0,0,0,0,0,0,1,0,0,0,0,0,1,0,0,0,0,0,1,0,1,0,0,0,0,0,0,0,0,0,0,0,0,0,0,0,0,0,0,0,0,0,0,0,0,1,Yoann Gourcuff,£9.90m ,34.0,185.0,Midfielder - Attacking Midfield,right,Career break,36.0,4.0,6.0,2494.0,23.0,2.0,2.0,1412.0,23.0,4.0,8.0,1605.0,30.0,6.0,9.0,1917.0,19.0,3.0,5.0,807.0,12.0,2.0,0.0,619.0,28.0,4.0,3.0,2365.0,13.0,1.0,1.0,638.0,8.0,0.0,0.0,126.0,Ligue 1,nan,nan,nan,nan,nan,nan,nan,nan
19/6/2011,Yoann Bigné,12112,769,8/23/1977,33,0,0,11,0,4090,5137,5137,135,113,49757,168,65,DM C,3,1,1,1,1,1,1,5,2,3,1,9,11,10,6,12,13,6,10,7,8,13,11,9,12,11,13,13,13,13,12,13,13,8,13,8,12,16,14,12,13,10,5,20,12,11,15,12,10,14,11,14,12,8,6,12,14,14,15,16,16,7,8,8,15,1,12,1,15,DM C,301,1,1,1,1,1,1,1,1,8,20,15,1,12,1,8,0,0,0,0,0,0,0,0,0,0,0,0,0,0,0,0,0,0,0,0,0,0,0,0,0,0,0,0,0,0,0,0,0,0,0,0,0,0,0,0,0,0,0,0,0,0,0,0,0,Yoann Bigné,£360Th. ,43.0,168.0,Midfielder - Central Midfield,both,Retired,10.0,0.0,0.0,529.0,1.0,0.0,0.0,29.0,nan,nan,nan,nan,nan,nan,nan,nan,nan,nan,nan,nan,nan,nan,nan,nan,nan,nan,nan,nan,nan,nan,nan,nan,nan,nan,nan,nan,Ligue 1,nan,nan,nan,nan,nan,nan,nan,nan
19/6/2011,Yaya Touré,533344,24,5/13/1983,28,55,7,0,0,7750,8250,8350,172,167,18181818,191,90,DM/M C,3,3,2,1,1,2,3,4,3,1,3,10,10,13,13,12,12,15,15,9,14,16,11,14,14,12,14,16,14,14,15,13,15,13,11,13,15,17,18,13,13,18,15,11,15,16,20,17,18,16,12,13,8,15,17,12,6,15,18,12,12,12,13,1,20,14,1,1,20,DM/M C,421,1,1,1,14,1,1,13,1,1,18,20,1,1,1,1,2260595906708004,0,0,1,0,0,1,0,0,0,1,0,0,0,0,0,0,0,0,0,0,0,0,0,0,0,0,0,0,0,0,0,0,0,0,0,0,0,0,0,0,0,0,0,1,0,0,0,0,Yaya Touré,£32.85m ,37.0,188.0,Midfielder - Central Midfield,right,Without Club,50.0,10.0,7.0,4218.0,42.0,9.0,11.0,3523.0,42.0,9.0,7.0,3729.0,49.0,24.0,12.0,3942.0,38.0,12.0,1.0,3053.0,47.0,8.0,7.0,3528.0,31.0,7.0,3.0,2501.0,17.0,0.0,2.0,883.0,19.0,2.0,3.0,1316.0,Premier League,nan,nan,nan,nan,nan,nan,nan,nan
19/6/2011,Yann Jouffre,920075,769,7/23/1984,26,0,0,0,0,4500,5683,5683,135,126,408977,175,65,M/AM RC,1,1,3,3,1,3,3,4,1,2,3,14,13,12,8,15,11,8,12,6,6,14,15,10,15,11,12,12,12,12,13,12,15,11,9,11,10,12,13,14,13,12,7,20,10,13,12,11,8,13,11,15,13,12,8,14,14,14,10,13,13,7,1,1,17,20,20,14,18,M/AM RC,523,1,1,1,18,14,20,1,1,1,12,17,14,15,1,1,0,0,0,0,0,0,0,0,0,0,0,0,0,0,0,0,0,0,0,0,0,0,0,0,0,0,0,0,0,0,0,0,0,0,0,0,0,0,0,0,0,0,0,0,0,0,0,0,0,Yann Jouffre,£2.25m ,36.0,175.0,Midfielder - Right Midfield,left,Retired,13.0,1.0,0.0,472.0,33.0,3.0,7.0,2348.0,35.0,4.0,6.0,2611.0,31.0,6.0,8.0,2348.0,18.0,0.0,1.0,1098.0,30.0,2.0,5.0,2011.0,20.0,4.0,2.0,1248.0,5.0,0.0,0.0,335.0,nan,nan,nan,nan,Ligue 1,nan,nan,nan,nan,nan,nan,nan,nan
19/6/2011,Yacine Brahimi,34002647,769,2/8/1990,21,0,0,5,1,4350,5450,5450,160,121,276095,175,65,AM RLC,2,1,1,1,3,2,1,5,2,1,1,12,12,15,7,16,13,5,10,5,1,13,12,2,16,6,10,7,13,11,14,10,13,16,7,13,5,7,10,16,15,12,7,10,15,13,20,14,7,13,6,14,6,8,8,16,14,11,12,14,14,8,1,1,15,20,18,18,20,AM RLC,506,1,1,1,20,18,18,1,1,1,1,15,12,12,1,1,2251834174472192,0,0,0,0,0,0,0,0,0,0,0,0,0,0,0,0,0,0,0,0,1,0,0,0,0,0,0,0,0,0,0,0,0,0,0,1,0,0,0,0,0,0,0,0,0,0,0,0,Yacine Brahimi,£2.70m ,30.0,175.0,Forward - Left Winger,right,Al-Rayyan SC,26.0,6.0,3.0,1509.0,28.0,3.0,2.0,1130.0,28.0,0.0,2.0,1916.0,36.0,3.0,3.0,2858.0,42.0,13.0,10.0,2835.0,44.0,9.0,10.0,3245.0,31.0,7.0,4.0,1927.0,49.0,12.0,10.0,3914.0,49.0,13.0,9.0,3429.0,Ligue 1,23.0,15.0,5.0,2040.0,3.0,1.0,1.0,270.0
19/6/2011,Xavi,4200583,796,1/25/1980,31,101,9,31,9,9000,9200,9200,184,182,12648221,170,69,M C,3,3,3,2,1,3,3,6,1,2,2,18,15,17,12,20,17,6,14,5,12,20,14,9,19,8,19,10,19,19,20,19,16,17,17,18,15,18,17,11,16,13,6,9,14,13,20,17,8,19,5,16,7,9,5,14,20,18,18,18,15,3,1,1,20,14,5,1,20,M C,401,1,1,1,14,1,1,1,1,1,13,20,1,5,1,1,281492162347200,0,0,0,0,0,0,1,1,0,0,0,0,0,0,0,0,0,0,0,1,1,0,1,0,0,0,0,0,0,0,0,0,0,0,1,0,0,0,0,0,0,0,0,0,0,0,0,0,Xavi,£31.50m ,40.0,169.0,Midfielder - Central Midfield,right,Retired,50.0,5.0,15.0,4027.0,51.0,14.0,15.0,3744.0,48.0,7.0,13.0,3665.0,47.0,4.0,6.0,3597.0,44.0,2.0,9.0,2187.0,18.0,3.0,1.0,1650.0,26.0,10.0,12.0,2356.0,28.0,6.0,9.0,2376.0,18.0,5.0,6.0,1409.0,LaLiga,nan,nan,nan,nan,nan,nan,nan,nan
19/6/2011,Xavi Torres,1508014,796,11/21/1986,24,0,0,0,0,4000,6500,6500,142,130,261167,182,78,DM/M C,1,3,2,2,3,1,2,6,1,2,1,10,8,8,8,13,12,13,12,8,14,14,10,14,12,13,13,14,12,13,12,13,13,6,12,9,14,15,16,13,11,13,12,8,15,13,20,15,12,14,10,10,5,10,15,13,15,14,15,16,13,7,14,1,17,1,1,5,17,DM/M C,311,1,1,1,1,1,1,14,5,1,20,17,1,1,1,1,4294967296,0,0,0,0,0,0,0,0,0,0,0,0,0,0,0,0,0,0,0,0,0,0,0,0,0,0,0,0,0,0,0,0,1,0,0,0,0,0,0,0,0,0,0,0,0,0,0,0,Xavi Torres,£2.70m ,33.0,182.0,Midfielder - Central Midfield,right,CD Lugo,38.0,0.0,3.0,3262.0,37.0,5.0,1.0,2848.0,37.0,0.0,2.0,2925.0,17.0,1.0,0.0,1187.0,28.0,2.0,2.0,2200.0,14.0,0.0,0.0,814.0,19.0,0.0,0.0,1038.0,24.0,4.0,0.0,1888.0,29.0,6.0,1.0,1711.0,LaLiga,nan,nan,nan,nan,5.0,1.0,0.0,363.0
19/6/2011,Xabi Alonso,811316,796,11/25/1981,29,76,9,9,0,8050,8550,8550,172,171,0,183,77,DM/M C,3,3,1,3,3,1,1,4,3,2,1,13,15,12,11,16,14,12,18,9,10,18,13,12,17,12,17,14,15,18,17,17,18,12,14,11,19,18,15,10,11,14,11,15,13,12,20,17,12,16,11,16,9,5,16,19,15,14,16,14,15,9,1,1,19,8,1,1,19,DM/M C,311,1,9,1,8,1,1,1,1,1,20,19,1,1,1,1,140738566816000,0,0,0,0,0,0,0,0,1,0,0,0,0,0,0,0,0,0,0,1,0,0,1,0,0,0,0,0,0,0,1,0,0,0,0,0,0,0,0,0,0,0,0,0,0,0,0,1,Xabi Alonso,£31.50m ,38.0,183.0,Midfielder - Defensive Midfield,right,Retired,52.0,1.0,6.0,4243.0,52.0,2.0,9.0,4507.0,47.0,0.0,8.0,3792.0,42.0,0.0,3.0,3153.0,42.0,4.0,5.0,3393.0,39.0,2.0,3.0,3091.0,38.0,3.0,4.0,2826.0,nan,nan,nan,nan,nan,nan,nan,nan,LaLiga,nan,nan,nan,nan,nan,nan,nan,nan
19/6/2011,Wires,19026407,1651,12/30/1982,28,0,0,0,0,2017,4679,5000,107,104,117569,178,74,DM C,1,1,1,3,3,1,3,2,2,2,1,9,9,9,9,11,11,12,10,11,12,9,11,13,11,11,12,10,13,11,9,11,14,8,10,11,12,13,12,11,12,13,12,7,12,12,20,13,13,10,11,10,9,12,13,9,13,15,12,11,11,8,13,13,15,1,13,1,15,DM C,301,1,1,1,1,1,1,1,1,13,20,15,1,10,1,13,0,0,0,0,0,0,0,0,0,0,0,0,0,0,0,0,0,0,0,0,0,0,0,0,0,0,0,0,0,0,0,0,0,0,0,0,0,0,0,0,0,0,0,0,0,0,0,0,0,Wíres,£900Th. ,37.0,176.0,Defender - Right-Back,right,AAD Vitória das Tabocas (PE),30.0,0.0,1.0,2553.0,21.0,1.0,0.0,1787.0,35.0,0.0,0.0,2710.0,nan,nan,nan,nan,nan,nan,nan,nan,2.0,0.0,0.0,180.0,nan,nan,nan,nan,nan,nan,nan,nan,nan,nan,nan,nan,Liga NOS,nan,nan,nan,nan,nan,nan,nan,nan
19/6/2011,Wilson Palacios,5397626,376,7/29/1984,26,71,5,0,0,6000,6500,7250,155,144,4363636,178,75,M C,2,2,2,3,2,2,3,1,3,1,3,8,7,11,8,13,11,15,10,8,12,10,13,16,12,14,13,15,12,12,10,9,14,13,9,11,15,17,17,16,13,12,11,15,12,16,20,18,17,11,6,16,5,14,13,12,16,14,16,12,15,10,1,1,20,13,12,1,20,M C,401,1,1,1,13,1,12,1,1,1,13,20,1,12,1,1,2336462209028,0,0,1,0,0,0,0,0,0,0,0,0,0,0,0,0,0,0,0,0,0,0,0,0,0,0,0,0,0,0,0,0,0,0,0,0,0,1,0,0,0,1,0,0,0,0,0,0,Wilson Palacios,£4.95m ,36.0,181.0,Midfielder - Defensive Midfield,right,Retired,31.0,0.0,0.0,1853.0,28.0,0.0,1.0,1460.0,5.0,0.0,0.0,109.0,21.0,0.0,0.0,933.0,0.0,0.0,0.0,0.0,18.0,0.0,0.0,1241.0,nan,nan,nan,nan,nan,nan,nan,nan,nan,nan,nan,nan,Premier League,nan,nan,nan,nan,nan,nan,nan,nan
19/6/2011,William Kvist,929712,764,2/24/1985,26,20,0,5,0,5900,7250,6900,140,136,2160023,184,80,M RC,1,3,3,2,2,2,3,1,1,3,2,13,12,8,5,14,8,6,7,17,14,14,5,14,11,14,14,15,15,15,8,16,15,4,15,8,15,17,17,11,14,12,11,9,17,16,20,17,15,17,3,17,2,20,17,14,17,15,16,18,16,4,14,10,20,13,16,12,20,M RC,403,1,1,1,13,1,1,10,11,14,12,20,12,16,8,10,121634880,0,0,0,0,0,0,1,0,0,0,0,0,0,0,0,0,0,0,0,0,0,0,1,0,1,1,1,0,0,0,0,0,0,0,0,0,0,0,0,0,0,0,0,0,0,0,0,0,William Kvist,£6.75m ,35.0,184.0,Midfielder - Defensive Midfield,right,Retired,45.0,1.0,4.0,3590.0,37.0,0.0,2.0,3217.0,35.0,0.0,2.0,2853.0,22.0,0.0,0.0,1704.0,26.0,0.0,1.0,1582.0,38.0,2.0,1.0,2805.0,47.0,0.0,2.0,3999.0,45.0,1.0,2.0,3118.0,32.0,0.0,2.0,1439.0,Bundesliga,nan,nan,nan,nan,nan,nan,nan,nan
19/6/2011,Wesley,19040469,1651,6/24/1987,23,2,0,0,0,5600,7000,7050,156,140,3503470,179,63,DM/M RC,3,1,2,3,1,3,3,3,1,1,1,12,14,13,9,15,7,8,10,10,13,15,11,12,15,17,10,15,8,10,10,8,15,14,10,13,9,14,18,17,16,8,9,14,14,15,20,17,7,12,7,11,12,17,14,13,13,12,11,8,12,5,14,12,20,15,15,1,20,DM/M RC,423,1,1,10,15,1,10,1,1,14,18,20,1,15,1,12,1074790484,0,0,1,0,1,0,1,0,0,0,0,0,0,0,0,0,0,0,0,0,1,0,0,0,0,0,0,0,0,0,1,0,0,0,0,0,0,0,0,0,0,0,0,0,0,0,0,0,Wesley,£4.05m ,33.0,179.0,Midfielder - Central Midfield,right,Avaí Futebol Clube (SC),25.0,1.0,3.0,1945.0,10.0,1.0,1.0,461.0,34.0,7.0,9.0,2823.0,26.0,2.0,2.0,2089.0,27.0,1.0,2.0,1530.0,30.0,1.0,1.0,1915.0,12.0,0.0,0.0,714.0,17.0,0.0,1.0,919.0,33.0,0.0,1.0,2859.0,Bundesliga,1.0,0.0,0.0,13.0,nan,nan,nan,nan
19/6/2011,Wesley Sneijder,856882,784,6/9/1984,27,75,21,1,0,8500,8650,8650,177,172,13822413,170,67,M/AM C,1,3,3,1,2,1,1,4,1,3,1,16,16,14,12,17,18,7,18,5,8,18,13,11,17,15,16,13,13,14,19,16,18,17,14,14,13,16,15,14,16,12,6,15,14,12,20,17,11,15,15,17,14,17,16,19,15,17,16,11,7,12,1,1,16,20,11,14,20,M/AM C,521,1,1,1,20,14,11,1,1,1,7,16,11,9,1,1,1073873792,0,0,0,0,0,0,0,1,1,1,0,0,0,0,0,0,0,1,0,0,0,0,0,0,0,0,0,0,0,0,1,0,0,0,0,0,0,0,0,0,0,0,0,0,0,0,0,0,Wesley Sneijder,£28.80m ,36.0,170.0,Midfielder - Attacking Midfield,both,Retired,39.0,7.0,11.0,3141.0,28.0,5.0,6.0,1955.0,24.0,6.0,4.0,1601.0,42.0,17.0,9.0,3381.0,44.0,14.0,7.0,3643.0,40.0,5.0,10.0,3197.0,33.0,5.0,17.0,2359.0,24.0,10.0,6.0,1950.0,11.0,6.0,1.0,832.0,Serie A,nan,nan,nan,nan,nan,nan,nan,nan
19/6/2011,Walter Gargano,78000812,1657,7/23/1984,26,31,0,0,0,6000,7200,7050,148,142,1460795,168,65,DM/M C,2,2,2,3,1,2,3,1,3,2,1,10,12,11,8,13,10,5,13,7,14,12,6,13,13,18,14,17,12,14,10,13,14,6,13,12,14,16,17,17,16,14,5,8,18,13,20,19,13,13,11,13,8,5,15,10,14,13,14,10,12,5,1,1,18,1,1,1,18,DM/M C,311,1,1,1,1,1,1,1,1,1,20,18,1,1,1,1,4227072,0,0,0,0,0,0,0,0,0,0,0,0,0,0,0,1,0,0,0,0,0,0,1,0,0,0,0,0,0,0,0,0,0,0,0,0,0,0,0,0,0,0,0,0,0,0,0,0,Walter Gargano,£8.10m ,36.0,168.0,Midfielder - Defensive Midfield,right,CA Peñarol,46.0,0.0,4.0,3527.0,43.0,2.0,3.0,3457.0,37.0,0.0,2.0,2785.0,23.0,1.0,1.0,1688.0,36.0,0.0,2.0,2466.0,43.0,0.0,3.0,3568.0,51.0,0.0,5.0,3870.0,12.0,1.0,2.0,1008.0,33.0,1.0,2.0,2518.0,Serie A,11.0,0.0,1.0,685.0,nan,nan,nan,nan
19/6/2011,Vladimir Weiss,4001874,794,11/30/1989,21,18,1,7,0,5300,6800,6800,169,131,1475550,176,69,M/AM RLC,1,3,2,3,2,3,1,2,2,2,1,13,14,15,12,15,13,3,12,3,3,13,9,5,15,9,15,10,11,11,15,10,15,15,7,15,5,11,11,16,15,16,6,4,13,15,20,14,9,12,8,13,7,13,15,14,9,14,14,9,15,7,1,1,17,20,20,17,15,M/AM RLC,526,1,1,7,15,14,20,1,1,1,1,15,17,15,1,1,70420552220674,0,1,0,0,0,0,0,0,0,0,0,0,0,0,0,0,0,0,0,0,0,0,0,0,0,0,0,0,1,0,0,0,0,0,1,1,0,0,0,0,0,0,0,0,0,0,1,0,Vladimir Weiss,£3.15m ,30.0,173.0,Forward - Left Winger,right,Slovan Bratislava,35.0,5.0,15.0,1858.0,33.0,4.0,5.0,2146.0,23.0,5.0,5.0,1492.0,39.0,11.0,10.0,2585.0,31.0,10.0,7.0,2060.0,24.0,10.0,5.0,1882.0,21.0,10.0,4.0,1821.0,7.0,5.0,1.0,500.0,20.0,8.0,2.0,1431.0,LaLiga,8.0,1.0,0.0,292.0,6.0,0.0,2.0,188.0
19/6/2011,Vítor,741748,788,1/7/1984,27,0,0,0,0,1126,5000,5000,113,108,140261,169,69,M/AM C,2,3,1,2,2,3,2,1,2,1,2,13,13,12,10,11,14,7,10,7,10,13,14,10,11,12,10,12,13,13,14,12,13,11,13,10,9,13,15,14,13,13,8,7,9,14,20,10,7,13,7,12,11,12,10,11,16,13,14,14,14,8,1,1,17,20,11,14,20,M/AM C,521,1,1,1,20,14,11,1,1,1,1,17,1,1,1,1,4194432,0,0,0,0,0,0,0,1,0,0,0,0,0,0,0,0,0,0,0,0,0,0,1,0,0,0,0,0,0,0,0,0,0,0,0,0,0,0,0,0,0,0,0,0,0,0,0,0
19/6/2011,Vítor Gomes,55003648,788,12/25/1987,23,0,0,1,0,2500,5750,5750,130,115,646344,184,80,M C,1,1,2,1,3,1,2,8,3,2,3,12,13,12,10,14,12,11,13,10,10,12,13,10,13,13,13,13,12,13,13,13,14,13,13,12,13,13,14,11,11,14,14,8,14,11,20,13,14,14,9,12,7,14,12,13,15,12,13,11,11,8,1,1,20,10,1,1,20,M C,401,1,1,1,10,1,1,1,1,1,10,20,1,1,1,1,0,0,0,0,0,0,0,0,0,0,0,0,0,0,0,0,0,0,0,0,0,0,0,0,0,0,0,0,0,0,0,0,0,0,0,0,0,0,0,0,0,0,0,0,0,0,0,0,0,Vítor Gomes,£1.35m ,32.0,182.0,Midfielder - Central Midfield,right,Omonia Nicosia,18.0,0.0,0.0,1073.0,28.0,2.0,1.0,2163.0,28.0,0.0,1.0,1800.0,27.0,1.0,1.0,2159.0,33.0,3.0,1.0,2520.0,33.0,3.0,4.0,2764.0,31.0,0.0,3.0,2440.0,33.0,5.0,3.0,2533.0,38.0,4.0,4.0,2974.0,Liga NOS,19.0,1.0,1.0,1583.0,11.0,0.0,1.0,835.0
19/6/2011,Vinícius,316102,1651,5/16/1986,25,0,0,0,0,2058,4904,5450,122,109,62373,186,68,M C,1,2,1,2,3,1,3,1,1,3,3,10,10,10,9,9,9,12,12,10,10,10,12,10,11,14,12,13,12,13,10,11,14,7,11,14,12,15,17,11,13,14,13,8,16,11,20,15,14,13,8,12,7,14,14,11,14,10,13,13,13,8,1,1,20,5,10,7,20,M C,401,1,1,1,5,1,1,1,1,1,13,20,7,10,1,1,0,0,0,0,0,0,0,0,0,0,0,0,0,0,0,0,0,0,0,0,0,0,0,0,0,0,0,0,0,0,0,0,0,0,0,0,0,0,0,0,0,0,0,0,0,0,0,0,0,Vinicius,£720Th. ,34.0,186.0,Midfielder - Central Midfield,both,Nea Salamina Famagusta,18.0,0.0,0.0,1357.0,9.0,0.0,1.0,269.0,33.0,3.0,0.0,2781.0,40.0,5.0,0.0,3174.0,26.0,2.0,0.0,2054.0,38.0,5.0,0.0,3095.0,41.0,7.0,3.0,3355.0,19.0,0.0,0.0,1423.0,14.0,0.0,2.0,1098.0,Liga NOS,19.0,0.0,0.0,1431.0,3.0,0.0,0.0,270.0
19/6/2011,Vincenzo Grella,3801677,1435,10/5/1979,31,46,0,0,0,5500,6710,6950,145,122,464149,183,79,DM/M C,3,1,1,3,1,2,2,6,3,3,3,8,9,8,6,12,6,12,7,6,14,14,9,13,10,20,15,18,11,16,13,14,16,4,14,7,18,18,16,10,10,12,10,11,12,10,20,12,15,16,20,12,20,8,16,16,11,12,14,7,12,7,1,1,20,1,1,1,20,DM/M C,311,1,1,1,1,1,1,1,1,1,20,20,1,1,1,1,137439019072,0,0,0,0,0,0,1,0,0,0,0,0,0,0,0,0,1,0,0,0,0,0,0,0,0,0,0,0,0,0,0,0,0,0,0,0,0,1,0,0,0,0,0,0,0,0,0,0,Vince Grella,£450Th. ,41.0,183.0,Midfielder - Central Midfield,both,Retired,7.0,0.0,0.0,394.0,4.0,0.0,0.0,251.0,1.0,0.0,0.0,22.0,nan,nan,nan,nan,nan,nan,nan,nan,nan,nan,nan,nan,nan,nan,nan,nan,nan,nan,nan,nan,nan,nan,nan,nan,Premier League,nan,nan,nan,nan,nan,nan,nan,nan
19/6/2011,Vincent Nogueira,8440962,769,1/16/1988,23,0,0,1,0,4700,5877,5877,149,130,456119,170,60,DM/M/AM RC,3,2,2,1,3,2,3,1,2,2,1,11,12,13,8,14,11,6,14,8,8,13,7,7,14,7,13,12,13,13,13,13,13,12,8,12,12,14,15,15,14,11,5,10,8,13,20,15,6,13,7,15,15,15,8,13,15,15,15,15,15,5,8,8,20,16,16,10,20,DM/M/AM RC,433,1,1,1,1,10,16,1,1,8,18,20,10,16,1,8,0,0,0,0,0,0,0,0,0,0,0,0,0,0,0,0,0,0,0,0,0,0,0,0,0,0,0,0,0,0,0,0,0,0,0,0,0,0,0,0,0,0,0,0,0,0,0,0,0,Vincent Nogueira,£1.80m ,32.0,170.0,Midfielder - Central Midfield,right,Retired,26.0,1.0,1.0,758.0,31.0,2.0,1.0,2315.0,32.0,2.0,3.0,2511.0,50.0,3.0,5.0,4056.0,31.0,5.0,2.0,2444.0,9.0,2.0,0.0,757.0,27.0,1.0,4.0,1854.0,7.0,0.0,0.0,400.0,2.0,0.0,0.0,47.0,Ligue 1,5.0,0.0,0.0,431.0,nan,nan,nan,nan
19/6/2011,Vincent Kompany,8152558,757,4/10/1986,25,39,1,0,0,7000,8250,8250,175,164,18181818,191,91,D/DM C,1,2,1,1,1,3,1,6,3,3,3,5,5,9,7,14,12,18,10,12,16,12,10,17,13,14,15,18,16,15,12,14,17,11,16,9,17,14,15,15,15,16,16,10,12,13,20,15,16,17,8,15,10,14,15,18,16,18,16,17,16,15,20,1,15,1,12,1,20,D/DM C,111,1,1,1,1,1,1,20,1,12,17,15,1,1,1,1,0,0,0,0,0,0,0,0,0,0,0,0,0,0,0,0,0,0,0,0,0,0,0,0,0,0,0,0,0,0,0,0,0,0,0,0,0,0,0,0,0,0,0,0,0,0,0,0,0,Vincent Kompany,£31.50m ,34.0,190.0,Defender - Centre-Back,right,Retired,50.0,0.0,2.0,4279.0,42.0,3.0,2.0,3608.0,37.0,1.0,0.0,3179.0,37.0,5.0,1.0,3129.0,33.0,0.0,0.0,2753.0,22.0,2.0,0.0,1661.0,15.0,3.0,0.0,1167.0,21.0,2.0,1.0,1756.0,26.0,1.0,1.0,1782.0,Premier League,18.0,1.0,1.0,1484.0,nan,nan,nan,nan
19/6/2011,Vicente Iborra,67010183,796,1/16/1988,23,0,0,0,0,4100,6500,6250,145,127,592119,190,76,DM/M C,2,2,2,3,1,3,1,4,3,3,3,9,10,11,8,13,8,14,9,6,8,14,12,12,14,13,13,14,13,14,14,13,12,14,10,11,14,15,14,12,10,15,14,9,14,13,20,15,14,14,12,14,8,9,14,15,14,10,14,15,10,6,1,1,20,14,1,1,20,DM/M C,421,1,1,8,14,1,1,1,1,1,18,20,1,1,1,1,524320,0,0,0,0,0,1,0,0,0,0,0,0,0,0,0,0,0,0,0,1,0,0,0,0,0,0,0,0,0,0,0,0,0,0,0,0,0,0,0,0,0,0,0,0,0,0,0,0,Vicente Iborra,£2.25m ,32.0,190.0,Midfielder - Central Midfield,right,Villarreal CF,16.0,0.0,0.0,1261.0,38.0,1.0,1.0,2752.0,49.0,7.0,2.0,4275.0,40.0,4.0,4.0,2994.0,41.0,9.0,2.0,3001.0,47.0,9.0,3.0,2840.0,44.0,8.0,4.0,2373.0,27.0,4.0,2.0,2154.0,36.0,5.0,2.0,2420.0,LaLiga,37.0,1.0,3.0,2808.0,8.0,0.0,0.0,493.0
19/6/2011,Vedran Corluka,126527,761,3/31/1986,25,36,1,0,0,6250,7810,7200,155,142,9071504,192,89,D RC,2,2,3,2,1,1,1,2,1,2,3,3,11,12,9,13,5,15,5,15,13,11,6,15,15,14,17,13,18,12,10,12,17,5,12,10,12,15,14,12,13,16,15,13,14,11,20,14,16,15,4,16,11,12,13,14,15,13,16,17,15,8,20,14,15,1,20,10,16,D RC,103,1,12,1,1,1,1,16,10,20,12,15,1,1,1,14,143881404456,0,0,0,1,0,1,0,0,0,0,0,0,0,0,0,0,0,0,0,0,0,0,0,0,0,0,0,0,0,0,0,1,1,0,0,0,0,1,0,0,0,0,0,0,0,0,0,0,Vedran Corluka,£6.75m ,34.0,192.0,Defender - Centre-Back,right,Lokomotiv Moscow,24.0,0.0,1.0,1933.0,16.0,0.0,2.0,1302.0,28.0,1.0,2.0,2493.0,28.0,1.0,1.0,2520.0,32.0,2.0,1.0,2921.0,29.0,3.0,0.0,2540.0,21.0,0.0,2.0,1688.0,8.0,0.0,0.0,662.0,30.0,1.0,1.0,2619.0,Premier League,34.0,0.0,0.0,2965.0,13.0,1.0,1.0,1071.0
19/6/2011,Valon Behrami,5724445,798,4/19/1985,26,30,2,4,0,5900,7500,7200,150,140,1587915,186,78,M RC,1,1,1,1,1,1,1,1,1,1,1,4,9,12,9,13,3,8,10,8,12,13,5,15,14,16,14,18,11,12,10,8,18,10,8,14,13,18,19,15,14,14,11,10,14,14,20,18,15,14,16,15,17,14,15,15,10,10,16,8,15,4,11,14,20,12,18,1,20,M RC,403,1,1,1,1,1,12,1,1,11,10,20,1,18,1,14,1374527946760,0,0,0,1,0,0,0,0,0,0,0,0,0,0,0,0,0,0,0,0,0,0,1,0,0,0,0,1,0,0,0,0,0,0,0,0,0,0,1,0,1,0,0,0,0,0,0,0,Valon Behrami,£7.20m ,35.0,184.0,Midfielder - Defensive Midfield,right,Genoa CFC,25.0,2.0,4.0,1889.0,33.0,0.0,1.0,2692.0,37.0,0.0,0.0,2967.0,33.0,0.0,0.0,2210.0,23.0,0.0,0.0,2034.0,22.0,0.0,1.0,1370.0,27.0,0.0,0.0,2036.0,20.0,1.0,1.0,1409.0,19.0,1.0,0.0,1368.0,Serie A,23.0,0.0,0.0,1559.0,4.0,0.0,0.0,112.0
19/6/2011,Vadim Demidov,53010227,786,10/10/1986,24,1,0,13,2,4700,6500,6500,148,136,645204,185,73,D/DM/M C,2,3,1,2,2,3,2,5,1,1,1,4,8,10,8,14,5,14,10,5,14,11,8,16,13,14,16,17,13,13,11,13,15,5,16,10,15,14,13,13,11,12,14,10,15,13,20,13,14,14,12,18,8,16,15,17,12,15,15,12,8,18,20,1,17,1,1,1,20,D/DM/M C,121,1,1,1,1,1,1,20,1,1,18,17,1,1,1,1,137438953476,0,0,1,0,0,0,0,0,0,0,0,0,0,0,0,0,0,0,0,0,0,0,0,0,0,0,0,0,0,0,0,0,0,0,0,0,0,1,0,0,0,0,0,0,0,0,0,0,Vadim Demidov,£3.15m ,34.0,186.0,Defender - Centre-Back,right,Retired,25.0,1.0,1.0,2173.0,27.0,0.0,1.0,2194.0,19.0,0.0,0.0,1504.0,8.0,0.0,0.0,641.0,26.0,1.0,0.0,2070.0,26.0,1.0,1.0,2291.0,3.0,0.0,0.0,270.0,28.0,1.0,0.0,2397.0,15.0,0.0,2.0,1303.0,LaLiga,nan,nan,nan,nan,nan,nan,nan,nan
19/6/2011,Toni Kroos,156772,771,1/4/1990,21,18,0,10,2,6600,7950,7950,175,149,7855047,182,74,M/AM LC,1,1,3,1,1,2,3,6,2,1,2,16,18,13,14,19,15,6,17,6,6,18,14,10,17,7,13,8,15,9,17,16,8,11,9,8,11,15,8,11,13,8,9,17,12,13,20,12,10,10,3,14,6,15,16,12,16,9,13,15,18,4,1,1,20,19,14,16,20,M/AM LC,414,1,1,1,19,16,14,1,1,1,10,20,14,13,1,1,4512395724589056,0,0,0,0,0,0,0,0,0,0,0,1,0,0,0,0,0,0,0,0,0,0,1,0,0,0,0,0,0,0,0,0,0,0,0,0,0,0,0,0,0,0,0,1,0,0,0,0,Toni Kroos,£20.70m ,30.0,183.0,Midfielder - Central Midfield,right,Real Madrid,37.0,2.0,8.0,2409.0,51.0,7.0,19.0,4095.0,37.0,9.0,8.0,2857.0,51.0,4.0,9.0,3931.0,55.0,2.0,14.0,4600.0,44.0,1.0,13.0,3741.0,48.0,4.0,16.0,4170.0,43.0,5.0,10.0,3570.0,43.0,1.0,6.0,3431.0,Bundesliga,45.0,6.0,9.0,3569.0,5.0,0.0,0.0,323.0
19/6/2011,Tongo Doumbia,85040297,769,8/6/1989,21,0,0,0,0,4400,5597,5571,150,124,452696,192,80,DM/M C,1,3,1,3,3,2,2,9,1,2,3,5,8,10,6,12,7,13,12,6,11,13,7,9,12,14,13,14,10,13,12,11,15,8,7,9,12,15,18,14,13,17,16,8,15,13,20,15,17,12,14,13,7,14,15,14,12,12,10,14,14,7,10,1,20,12,1,1,20,DM/M C,421,1,10,1,12,1,1,10,1,1,16,20,1,1,1,1,0,0,0,0,0,0,0,0,0,0,0,0,0,0,0,0,0,0,0,0,0,0,0,0,0,0,0,0,0,0,0,0,0,0,0,0,0,0,0,0,0,0,0,0,0,0,0,0,0,Tongo Doumbia,£1.80m ,31.0,191.0,Midfielder - Defensive Midfield,right,Ajman Club,20.0,0.0,0.0,1007.0,34.0,2.0,1.0,2376.0,35.0,2.0,3.0,2533.0,36.0,4.0,2.0,3004.0,26.0,3.0,2.0,2179.0,28.0,1.0,2.0,2170.0,12.0,0.0,0.0,668.0,32.0,1.0,1.0,2578.0,14.0,1.0,1.0,1042.0,Ligue 1,4.0,0.0,0.0,301.0,nan,nan,nan,nan
19/6/2011,Tomas Rosicky,130701,763,10/4/1980,30,80,20,2,0,6000,7755,6900,165,141,791147,179,71,M/AM RLC,2,3,3,1,1,3,1,3,3,1,1,15,13,12,11,16,14,7,13,7,9,15,12,10,17,10,13,11,14,13,15,14,14,15,12,15,12,15,13,12,13,12,8,15,8,13,20,12,9,11,7,14,19,14,15,18,16,14,17,14,18,4,1,1,18,20,16,17,20,M/AM RLC,526,1,1,1,20,17,16,1,1,1,1,18,16,15,1,1,141287245236352,0,0,0,0,0,0,0,1,0,0,0,1,0,0,1,0,0,0,0,0,1,0,0,0,0,0,0,0,0,0,0,0,0,0,0,0,0,0,0,1,0,0,0,0,0,0,0,1,Tomas Kosicky,£180Th. ,34.0,197.0,Goalkeeper,right,Debreceni VSC,0.0,0.0,0.0,0.0,3.0,3.0,2.0,203.0,6.0,6.0,2.0,540.0,42.0,56.0,11.0,3810.0,28.0,32.0,10.0,2486.0,5.0,5.0,1.0,450.0,7.0,14.0,1.0,630.0,15.0,21.0,6.0,1350.0,13.0,14.0,4.0,1098.0,Serie A,20.0,27.0,7.0,1772.0,0.0,0.0,0.0,0.0
19/6/2011,Tomás Rincón,86000589,1658,1/13/1988,23,38,0,6,0,5500,6600,6400,135,124,741109,175,71,DM/M C,1,1,2,2,1,3,1,5,2,1,1,5,9,10,5,12,5,9,8,15,19,11,7,17,12,19,8,18,9,14,7,7,18,5,11,8,9,17,19,14,15,16,11,10,13,13,20,17,13,10,10,8,11,14,12,10,14,15,17,10,8,6,14,10,18,1,14,1,18,DM/M C,311,1,1,1,1,1,1,1,1,14,20,18,1,10,1,10,138512728128,0,0,0,0,0,0,1,0,0,0,0,0,0,0,0,1,0,0,0,0,0,0,0,0,0,0,0,0,0,0,1,0,0,0,0,0,0,1,0,0,0,0,0,0,0,0,0,0,Tomás Rincón,£3.60m ,32.0,177.0,Midfielder - Defensive Midfield,right,Torino FC,21.0,0.0,0.0,1268.0,29.0,0.0,1.0,2202.0,20.0,0.0,0.0,933.0,26.0,0.0,0.0,1775.0,31.0,0.0,2.0,2521.0,34.0,3.0,4.0,3050.0,36.0,0.0,4.0,2093.0,38.0,1.0,0.0,3110.0,37.0,4.0,0.0,2994.0,Bundesliga,39.0,1.0,4.0,3107.0,4.0,0.0,1.0,349.0
19/6/2011,Tom Huddlestone,5113183,765,12/28/1986,24,3,0,33,3,5500,7017,7400,165,148,2638047,192,98,DM/M C,3,1,1,2,1,1,1,4,3,3,2,13,11,12,9,16,13,12,13,5,11,18,12,13,17,14,12,14,15,14,16,15,12,8,13,14,15,16,16,9,8,12,15,14,16,9,20,15,18,14,14,9,5,15,6,16,16,17,11,11,10,8,14,4,20,1,8,8,20,DM/M C,311,1,10,1,1,1,1,14,8,8,20,20,8,8,4,4,9070971454336,0,0,0,0,0,0,0,1,1,1,0,0,0,0,0,0,0,0,0,1,0,0,0,0,0,0,0,0,0,0,0,0,0,0,0,0,0,0,1,0,0,0,0,1,0,0,0,0,Tom Huddlestone,£5.40m ,33.0,188.0,Midfielder - Defensive Midfield,right,Without Club,21.0,2.0,2.0,1729.0,4.0,0.0,1.0,181.0,30.0,0.0,6.0,1783.0,40.0,3.0,7.0,3535.0,35.0,0.0,2.0,2830.0,47.0,2.0,5.0,3068.0,39.0,2.0,1.0,2559.0,47.0,2.0,0.0,4196.0,31.0,0.0,1.0,2330.0,Premier League,12.0,1.0,0.0,1020.0,nan,nan,nan,nan
19/6/2011,Tom Cleverley,28000906,765,8/12/1989,21,0,0,16,0,4850,7100,7100,160,136,3081614,175,67,M/AM RLC,2,2,2,2,2,2,2,2,2,2,2,11,15,13,13,14,6,9,14,9,9,14,4,10,14,13,13,13,14,10,10,10,18,12,9,14,9,15,15,14,11,12,8,13,15,14,20,14,11,14,10,10,9,16,7,11,14,16,16,12,12,2,1,1,19,20,18,18,20,M/AM RLC,526,1,1,1,20,18,17,1,1,1,1,19,18,18,1,1,2251800082120744,0,0,0,1,0,1,0,0,0,0,0,0,0,0,0,0,0,0,0,0,0,0,0,0,0,0,0,0,1,0,0,0,0,0,0,0,0,0,0,0,0,0,0,0,0,0,0,0,Tom Cleverley,£7.65m ,31.0,175.0,Midfielder - Central Midfield,right,Watford FC,25.0,4.0,2.0,1632.0,17.0,0.0,4.0,944.0,33.0,4.0,4.0,2353.0,31.0,1.0,1.0,2227.0,38.0,3.0,0.0,3098.0,30.0,2.0,6.0,2319.0,29.0,0.0,3.0,1958.0,25.0,1.0,3.0,2008.0,17.0,1.0,1.0,662.0,Premier League,19.0,1.0,0.0,1000.0,7.0,1.0,0.0,506.0
19/6/2011,Tolgay Arslan,91003495,799,8/16/1990,20,0,0,1,0,3650,6000,6000,144,120,1711244,179,76,AM C,2,2,2,2,2,2,2,3,3,1,3,8,10,15,13,13,11,7,12,5,6,13,11,6,14,11,11,13,13,13,13,11,8,8,10,11,4,11,13,12,13,11,8,16,13,12,20,13,9,7,14,10,7,10,9,16,13,7,8,4,7,7,1,1,15,20,10,10,20,AM C,501,1,1,12,20,10,10,1,1,1,1,15,1,1,1,1,0,0,0,0,0,0,0,0,0,0,0,0,0,0,0,0,0,0,0,0,0,0,0,0,0,0,0,0,0,0,0,0,0,0,0,0,0,0,0,0,0,0,0,0,0,0,0,0,0,Tolgay Arslan,£1.35m ,30.0,180.0,Midfielder - Central Midfield,both,Udinese Calcio,35.0,6.0,5.0,2427.0,9.0,1.0,0.0,442.0,26.0,0.0,1.0,1664.0,37.0,1.0,3.0,2834.0,37.0,2.0,2.0,2309.0,7.0,0.0,1.0,222.0,44.0,0.0,8.0,2540.0,43.0,0.0,3.0,2590.0,28.0,1.0,0.0,1669.0,Bundesliga,21.0,2.0,1.0,1034.0,4.0,0.0,0.0,247.0
19/6/2011,Tolga Cigerci,91107170,771,3/23/1992,19,0,0,0,0,4250,5850,5850,175,117,2818169,185,75,M/AM C,2,1,1,3,3,3,2,2,3,2,3,11,12,13,12,13,11,11,10,6,12,13,10,12,13,10,12,9,12,11,12,13,11,10,2,11,12,13,12,12,13,10,12,9,13,13,20,12,11,10,10,10,9,10,3,10,10,10,10,11,10,5,1,1,20,17,1,1,20,M/AM C,411,1,1,1,17,1,1,1,1,1,15,20,1,1,1,1,0,0,0,0,0,0,0,0,0,0,0,0,0,0,0,0,0,0,0,0,0,0,0,0,0,0,0,0,0,0,0,0,0,0,0,0,0,0,0,0,0,0,0,0,0,0,0,0,0,Tolga Cigerci,£720Th. ,28.0,185.0,Midfielder - Central Midfield,right,Fenerbahce SK,22.0,3.0,3.0,1579.0,17.0,3.0,1.0,1160.0,19.0,1.0,0.0,1274.0,20.0,1.0,3.0,1577.0,2.0,0.0,0.0,76.0,21.0,0.0,2.0,1221.0,25.0,0.0,0.0,1922.0,24.0,6.0,0.0,1605.0,2.0,0.0,0.0,90.0,Bundesliga,33.0,2.0,4.0,2093.0,3.0,0.0,0.0,174.0
19/6/2011,Tobias Weis,8707889,771,7/30/1985,25,1,0,0,0,4750,6700,6700,143,136,498886,170,68,M/AM RLC,1,3,2,2,2,1,1,5,2,1,2,11,12,13,5,12,8,6,6,8,18,13,10,12,14,19,11,20,7,10,12,9,18,13,10,14,8,14,18,17,18,15,5,15,12,13,20,16,8,9,15,10,13,17,13,13,10,10,11,12,8,5,1,1,20,18,20,18,19,M/AM RLC,416,1,1,12,14,14,18,1,1,1,14,19,18,20,1,1,16875650,0,1,0,0,0,0,0,1,0,0,0,0,0,0,0,1,1,0,0,0,0,0,0,0,1,0,0,0,0,0,0,0,0,0,0,0,0,0,0,0,0,0,0,0,0,0,0,0,Tobias Weis,£1.35m ,35.0,170.0,Midfielder - Central Midfield,both,Retired,20.0,0.0,0.0,1298.0,16.0,0.0,1.0,1206.0,22.0,2.0,4.0,1649.0,5.0,0.0,0.0,100.0,13.0,2.0,0.0,860.0,6.0,0.0,0.0,156.0,nan,nan,nan,nan,0.0,0.0,0.0,0.0,nan,nan,nan,nan,Bundesliga,nan,nan,nan,nan,nan,nan,nan,nan
19/6/2011,Tobias Rathgeb,885103,771,5/3/1982,29,0,0,1,0,3250,5650,5150,130,112,183560,173,65,D/DM/M LC,2,1,3,3,3,1,1,5,3,1,3,16,14,11,12,11,17,5,9,8,13,14,17,14,13,13,12,14,12,12,9,10,11,8,16,11,14,13,17,12,12,11,11,20,11,10,5,9,8,14,12,11,7,15,9,11,15,13,15,13,15,8,19,14,19,1,1,19,19,D/DM/M LC,334,1,1,1,1,1,1,1,19,1,20,19,12,1,14,1,0,0,0,0,0,0,0,0,0,0,0,0,0,0,0,0,0,0,0,0,0,0,0,0,0,0,0,0,0,0,0,0,0,0,0,0,0,0,0,0,0,0,0,0,0,0,0,0,0
19/6/2011,Timmy Simons,3339,757,12/11/1976,34,83,4,0,0,6000,7370,6700,138,134,428752,186,79,DM/M C,1,2,3,3,3,1,1,7,1,2,1,9,9,8,7,12,10,15,10,12,15,11,16,16,12,12,15,13,14,14,12,15,18,10,18,10,16,16,15,11,11,14,14,10,15,10,20,13,13,16,6,17,2,15,16,12,15,16,18,16,15,1,14,7,16,1,12,1,16,DM/M C,311,1,1,1,1,1,1,14,1,12,20,16,1,1,1,7,0,0,0,0,0,0,0,0,0,0,0,0,0,0,0,0,0,0,0,0,0,0,0,0,0,0,0,0,0,0,0,0,0,0,0,0,0,0,0,0,0,0,0,0,0,0,0,0,0,Timmy Simons,£1.58m ,43.0,186.0,Midfielder - Defensive Midfield,right,Retired,38.0,5.0,1.0,3450.0,37.0,4.0,3.0,3312.0,35.0,5.0,0.0,3150.0,42.0,7.0,0.0,3722.0,62.0,7.0,2.0,5362.0,49.0,2.0,2.0,4244.0,41.0,0.0,3.0,3465.0,9.0,0.0,0.0,417.0,nan,nan,nan,nan,Bundesliga,nan,nan,nan,nan,nan,nan,nan,nan
19/6/2011,Tim Cahill,108267,1435,12/6/1979,31,53,24,0,0,7150,8250,7750,162,152,2759221,178,69,M/AM C,3,2,1,1,2,3,3,10,3,3,2,5,12,12,14,14,11,19,12,5,13,14,15,13,14,18,18,19,15,16,9,14,17,10,16,16,16,16,18,11,16,15,15,10,18,13,20,17,15,13,14,17,12,13,13,15,17,15,15,13,13,12,1,1,18,20,12,1,20,M/AM C,521,1,1,13,20,1,1,1,1,1,7,18,1,12,1,1,65576,0,0,0,1,0,1,0,0,0,0,0,0,0,0,0,0,1,0,0,0,0,0,0,0,0,0,0,0,0,0,0,0,0,0,0,0,0,0,0,0,0,0,0,0,0,0,0,0,Tim Cahill,£4.50m ,40.0,178.0,Midfielder - Attacking Midfield,right,Retired,28.0,9.0,4.0,2084.0,55.0,4.0,7.0,4150.0,29.0,12.0,5.0,2453.0,28.0,3.0,2.0,1751.0,35.0,12.0,6.0,3083.0,17.0,4.0,0.0,1371.0,21.0,11.0,1.0,1394.0,16.0,0.0,0.0,157.0,11.0,2.0,1.0,518.0,Premier League,nan,nan,nan,nan,nan,nan,nan,nan
19/6/2011,Tim Borowski,6000749,771,5/2/1980,31,33,2,15,0,6350,6600,6600,150,137,1586655,194,84,M/AM C,3,3,2,1,2,1,1,1,1,1,3,11,15,8,16,13,11,14,15,7,8,15,14,8,13,11,17,12,17,15,15,16,15,9,12,9,10,14,7,8,8,14,16,17,9,15,20,12,14,13,11,16,14,16,12,17,14,14,14,13,11,6,1,1,20,16,9,14,20,M/AM C,411,1,1,1,16,10,9,1,1,1,14,20,14,9,1,1,8796093023008,0,0,0,0,0,1,0,0,1,1,0,0,0,0,0,0,0,0,0,0,0,0,0,0,0,0,0,0,0,0,0,0,0,0,0,0,0,0,0,0,0,0,0,1,0,0,0,0,Tim Borowski,£900Th. ,40.0,194.0,Midfielder - Central Midfield,both,Retired,17.0,1.0,0.0,1083.0,2.0,0.0,0.0,106.0,nan,nan,nan,nan,nan,nan,nan,nan,nan,nan,nan,nan,nan,nan,nan,nan,nan,nan,nan,nan,nan,nan,nan,nan,nan,nan,nan,nan,Bundesliga,nan,nan,nan,nan,nan,nan,nan,nan
19/6/2011,Tiberio Guarente,7990140,776,11/1/1985,25,0,0,3,0,4900,6800,6500,152,136,4743083,182,74,DM/M C,1,2,1,1,2,1,1,4,2,3,1,12,14,10,8,14,13,6,13,10,12,14,11,13,14,15,15,14,10,11,14,14,16,13,14,12,12,15,13,13,12,14,10,20,6,14,12,13,13,12,13,15,18,9,13,15,14,13,14,13,10,16,1,1,20,8,1,1,20,DM/M C,421,1,1,1,8,1,1,1,1,1,19,20,1,1,1,1,68719476864,0,0,0,0,0,0,0,1,0,0,0,0,0,0,0,0,0,0,0,0,0,0,0,0,0,0,0,0,0,0,0,0,0,0,0,0,1,0,0,0,0,0,0,0,0,0,0,0,Tiberio Guarente,£2.70m ,34.0,182.0,Midfielder - Central Midfield,left,Retired,10.0,0.0,1.0,522.0,3.0,0.0,0.0,32.0,23.0,2.0,1.0,1263.0,24.0,0.0,2.0,1415.0,1.0,0.0,0.0,7.0,nan,nan,nan,nan,nan,nan,nan,nan,nan,nan,nan,nan,nan,nan,nan,nan,LaLiga,nan,nan,nan,nan,nan,nan,nan,nan
19/6/2011,Tiago,115504,788,5/2/1981,30,55,3,0,0,6350,7550,7000,152,138,22988589,183,75,M C,3,1,1,2,2,1,2,1,3,2,3,14,12,12,11,16,13,12,14,11,10,17,12,12,16,8,12,9,12,11,17,14,12,9,5,12,13,11,11,11,12,14,10,12,13,13,20,16,11,12,13,13,9,10,7,12,14,6,14,13,12,6,1,1,20,13,13,11,20,M C,401,1,1,1,13,1,1,1,1,1,11,20,11,13,1,1,4315939072,0,0,0,0,0,0,0,0,1,0,0,0,0,0,0,0,0,0,0,0,0,0,1,0,1,0,0,0,0,0,0,0,1,0,0,0,0,0,0,0,0,0,0,0,0,0,0,0,Tiago,£6.30m ,39.0,183.0,Midfielder - Central Midfield,right,Retired,39.0,5.0,2.0,2932.0,32.0,0.0,0.0,2137.0,30.0,2.0,1.0,1882.0,33.0,2.0,1.0,2713.0,37.0,5.0,6.0,3072.0,19.0,1.0,2.0,1473.0,15.0,1.0,1.0,555.0,nan,nan,nan,nan,nan,nan,nan,nan,LaLiga,nan,nan,nan,nan,nan,nan,nan,nan
19/6/2011,Tiago Terroso,55008432,788,1/13/1988,23,0,0,0,0,1250,4500,4500,121,106,107428,178,78,M/AM LC,2,2,2,2,2,2,2,2,2,3,3,13,13,13,10,13,12,9,11,8,10,13,13,11,13,10,13,10,12,11,13,12,12,11,9,12,13,13,13,12,12,12,10,20,12,13,5,11,10,12,7,10,7,12,16,12,15,11,13,14,14,6,1,1,17,20,1,17,20,M/AM LC,524,1,1,1,20,5,1,1,1,1,1,16,17,1,1,1,0,0,0,0,0,0,0,0,0,0,0,0,0,0,0,0,0,0,0,0,0,0,0,0,0,0,0,0,0,0,0,0,0,0,0,0,0,0,0,0,0,0,0,0,0,0,0,0,0,Tiago Terroso,£900Th. ,32.0,178.0,Midfielder - Defensive Midfield,left,AD Esposende,36.0,4.0,0.0,2988.0,18.0,0.0,0.0,1101.0,18.0,0.0,0.0,1267.0,19.0,1.0,1.0,996.0,1.0,0.0,0.0,22.0,nan,nan,nan,nan,nan,nan,nan,nan,nan,nan,nan,nan,nan,nan,nan,nan,Liga NOS,nan,nan,nan,nan,nan,nan,nan,nan
19/6/2011,Thorben Marx,879059,771,6/1/1981,30,0,0,14,0,4200,6250,5850,130,117,519230,182,79,DM/M C,1,1,2,1,2,3,1,7,2,1,3,11,14,8,6,12,8,9,11,13,13,11,11,14,11,17,15,14,9,17,7,9,13,5,12,7,16,18,15,11,9,12,12,8,18,15,20,16,13,12,12,12,6,14,6,11,13,11,14,14,12,5,1,12,19,12,14,1,19,DM/M C,311,1,1,1,1,1,12,1,1,1,20,19,1,14,1,12,768,0,0,0,0,0,0,0,0,1,1,0,0,0,0,0,0,0,0,0,0,0,0,0,0,0,0,0,0,0,0,0,0,0,0,0,0,0,0,0,0,0,0,0,0,0,0,0,0
19/6/2011,Thomas Kahlenberg,927939,764,3/20/1983,28,36,4,26,10,6100,6500,5300,147,136,293570,183,72,M/AM LC,1,2,3,2,3,2,3,7,3,3,2,14,13,13,10,14,15,7,14,6,5,16,15,5,16,10,13,12,14,13,16,15,13,12,9,11,7,12,12,12,11,14,11,16,10,12,20,13,10,14,6,15,13,12,14,14,16,15,17,15,14,5,1,1,18,20,12,16,20,M/AM LC,524,1,1,5,20,16,12,1,1,1,5,18,16,12,1,1,4195456,0,0,0,0,0,0,0,1,0,0,1,0,0,0,0,0,0,0,0,0,0,0,1,0,0,0,0,0,0,0,0,0,0,0,0,0,0,0,0,0,0,0,0,0,0,0,0,0,Thomas Kahlenberg,£2.03m ,37.0,183.0,Midfielder - Central Midfield,right,Retired,17.0,1.0,0.0,875.0,19.0,2.0,5.0,1197.0,13.0,0.0,1.0,526.0,24.0,2.0,7.0,1973.0,24.0,2.0,4.0,2053.0,18.0,2.0,3.0,1224.0,2.0,0.0,0.0,92.0,nan,nan,nan,nan,nan,nan,nan,nan,Ligue 1,nan,nan,nan,nan,nan,nan,nan,nan
19/6/2011,Thomas Hitzlsperger,130970,771,4/5/1982,29,52,6,20,3,6850,6950,6950,142,133,4753458,181,75,M C,3,1,3,1,3,2,3,6,1,3,2,13,15,8,10,14,11,7,18,16,8,16,12,8,14,6,13,8,16,18,15,16,11,6,13,7,11,18,12,8,7,11,10,20,19,12,10,19,15,11,5,17,6,13,17,12,16,11,20,17,19,2,8,10,20,10,1,12,20,M C,401,1,1,1,10,1,1,1,8,1,14,20,12,1,10,1,43980469306112,0,0,0,0,0,0,0,0,1,1,0,0,0,0,0,0,0,0,0,0,0,0,1,0,0,0,0,0,0,0,0,0,0,0,0,0,0,0,0,0,0,0,0,1,0,1,0,0,Thomas Hitzlsperger,£1.13m ,38.0,184.0,Midfielder - Central Midfield,left,Retired,15.0,3.0,7.0,1278.0,6.0,0.0,0.0,272.0,14.0,0.0,0.0,811.0,nan,nan,nan,nan,nan,nan,nan,nan,nan,nan,nan,nan,nan,nan,nan,nan,nan,nan,nan,nan,nan,nan,nan,nan,Bundesliga,nan,nan,nan,nan,nan,nan,nan,nan
19/6/2011,Thierry Doubaï,69003609,24,7/1/1988,22,1,0,0,0,4520,5619,6027,147,124,838222,179,74,DM/M C,2,1,3,2,1,3,1,1,3,3,1,8,9,11,6,13,10,7,9,9,12,16,10,13,13,11,13,12,12,11,10,13,7,12,10,10,13,14,12,14,9,11,10,11,14,14,20,16,14,10,8,10,12,10,9,14,1,15,15,16,12,13,1,1,18,1,1,1,18,DM/M C,311,1,1,1,1,1,1,1,1,1,20,18,1,1,1,1,0,0,0,0,0,0,0,0,0,0,0,0,0,0,0,0,0,0,0,0,0,0,0,0,0,0,0,0,0,0,0,0,0,0,0,0,0,0,0,0,0,0,0,0,0,0,0,0,0,Thierry Doubai,£1.35m ,32.0,179.0,Midfielder - Defensive Midfield,right,AFAD Djékanou,50.0,1.0,6.0,4174.0,17.0,1.0,0.0,1051.0,14.0,2.0,1.0,1035.0,17.0,0.0,0.0,775.0,30.0,1.0,0.0,2146.0,21.0,1.0,0.0,1631.0,nan,nan,nan,nan,nan,nan,nan,nan,nan,nan,nan,nan,Serie A,nan,nan,nan,nan,nan,nan,nan,nan
19/6/2011,Thiago Motta,6701095,776,8/28/1982,28,2,1,0,0,7000,7650,7650,154,150,4709998,188,77,DM/M C,1,3,1,1,2,2,1,3,3,2,2,13,13,12,12,15,12,14,15,10,11,16,13,14,15,14,14,14,16,12,15,15,13,13,13,15,15,14,13,11,11,18,14,20,7,12,10,14,16,12,17,14,17,11,16,16,13,15,12,8,8,11,12,1,20,9,1,1,20,DM/M C,421,1,1,1,9,1,1,12,1,1,19,20,1,1,1,1,140876001050880,0,0,0,0,0,0,0,0,1,0,0,0,0,0,0,0,0,0,0,0,0,0,0,0,0,0,0,0,0,0,1,0,0,0,0,0,0,1,0,0,0,0,0,0,0,0,0,1,Thiago Motta,£12.60m ,38.0,187.0,Midfielder - Defensive Midfield,left,Retired,29.0,5.0,3.0,2178.0,30.0,5.0,1.0,2611.0,15.0,1.0,2.0,1163.0,47.0,6.0,6.0,3719.0,38.0,0.0,4.0,3050.0,45.0,1.0,2.0,3354.0,42.0,1.0,2.0,3107.0,28.0,1.0,2.0,1702.0,nan,nan,nan,nan,Serie A,nan,nan,nan,nan,nan,nan,nan,nan
19/6/2011,Tchô,2107518,1651,4/21/1987,24,0,0,8,3,2500,6150,6150,140,123,364393,174,70,M/AM RC,1,1,2,2,2,1,3,1,3,3,2,10,12,16,10,12,10,7,10,7,5,12,8,6,12,12,12,12,11,11,12,11,12,14,9,13,5,11,12,14,13,8,13,16,11,14,20,11,8,12,12,11,13,10,13,11,12,13,14,12,14,10,1,1,16,20,15,1,20,M/AM RC,523,1,1,11,20,1,15,1,1,1,1,16,1,12,1,1,160,0,0,0,0,0,1,0,1,0,0,0,0,0,0,0,0,0,0,0,0,0,0,0,0,0,0,0,0,0,0,0,0,0,0,0,0,0,0,0,0,0,0,0,0,0,0,0,0,Tchô,- ,33.0,175.0,Midfielder - Attacking Midfield,right,Ipatinga Futebol Clube,27.0,7.0,1.0,1482.0,9.0,1.0,0.0,252.0,20.0,4.0,5.0,1072.0,20.0,3.0,1.0,1114.0,2.0,0.0,0.0,26.0,nan,nan,nan,nan,nan,nan,nan,nan,nan,nan,nan,nan,nan,nan,nan,nan,Liga NOS,nan,nan,nan,nan,nan,nan,nan,nan
19/6/2011,Sven Bender,35007386,771,4/27/1989,22,1,0,0,0,5778,7418,7400,157,145,3043723,185,72,DM/M C,1,2,3,2,1,3,2,7,3,2,1,8,9,8,6,13,9,13,9,13,18,13,9,18,12,14,18,18,14,17,7,15,15,7,13,8,16,19,16,12,13,15,12,11,11,12,20,18,12,17,8,11,13,8,12,13,15,12,18,13,16,4,1,1,18,1,1,1,18,DM/M C,311,1,1,1,1,1,1,1,1,1,20,18,1,1,1,1,137489285184,0,0,0,0,0,0,1,0,0,0,0,0,0,0,0,0,0,0,0,0,0,0,0,0,1,1,0,0,0,0,0,0,0,0,0,0,0,1,0,0,0,0,0,0,0,0,0,0,Sven Bender,£12.60m ,31.0,186.0,Defender - Centre-Back,right,Bayer 04 Leverkusen,39.0,1.0,1.0,2923.0,32.0,1.0,5.0,2105.0,33.0,1.0,0.0,2190.0,27.0,1.0,1.0,1938.0,32.0,0.0,0.0,1900.0,35.0,0.0,2.0,2259.0,8.0,0.0,1.0,404.0,34.0,2.0,0.0,2812.0,32.0,0.0,1.0,2435.0,Bundesliga,47.0,4.0,2.0,3881.0,6.0,0.0,1.0,499.0
19/6/2011,Sulley Muntari,837261,21,8/27/1984,26,59,17,0,0,7000,7200,7100,155,136,1055372,179,76,DM/M C,2,3,3,1,2,2,1,9,2,3,3,12,13,11,12,14,12,8,15,8,14,13,14,17,13,18,13,17,10,11,12,10,12,12,13,16,14,16,15,13,12,17,8,20,14,13,9,17,16,10,19,11,12,16,17,14,14,5,14,7,7,15,11,11,20,12,1,13,20,DM/M C,421,1,1,1,12,10,1,1,11,1,16,20,13,1,11,1,149671087440384,0,0,0,0,0,0,0,0,0,1,0,0,0,0,0,0,0,0,0,0,0,0,0,0,0,0,1,0,0,0,0,0,0,0,0,0,0,1,0,0,0,0,0,1,0,0,0,1,Sulley Muntari,£4.95m ,36.0,179.0,Midfielder - Central Midfield,left,Without Club,22.0,1.0,3.0,956.0,18.0,3.0,3.0,1373.0,19.0,2.0,0.0,1192.0,34.0,6.0,3.0,2206.0,17.0,2.0,0.0,1037.0,29.0,3.0,2.0,2140.0,9.0,1.0,0.0,531.0,8.0,0.0,0.0,408.0,2.0,0.0,1.0,70.0,Serie A,nan,nan,nan,nan,nan,nan,nan,nan
19/6/2011,Stuart Holden,72000199,390,8/1/1985,25,17,2,7,1,6000,6750,6750,150,138,2201382,180,73,M C,1,1,1,1,1,9,1,1,1,1,1,15,13,11,11,13,15,9,13,4,11,14,11,12,13,13,12,15,12,11,14,11,14,12,10,13,13,14,15,12,12,14,10,16,15,12,20,16,13,10,3,13,14,13,17,14,12,12,13,12,14,9,1,1,20,11,11,11,20,M C,401,1,1,1,11,11,11,1,1,1,5,20,11,11,1,1,141734446080,0,0,0,0,0,0,0,0,0,0,1,0,0,0,0,0,0,0,0,1,0,0,0,0,0,0,0,0,0,0,0,0,1,0,0,0,0,1,0,0,0,0,0,0,0,0,0,0,Stuart Holden,£4.95m ,35.0,178.0,Midfielder - Central Midfield,both,Retired,30.0,2.0,2.0,2515.0,3.0,0.0,0.0,258.0,10.0,0.0,0.0,466.0,1.0,0.0,0.0,23.0,nan,nan,nan,nan,nan,nan,nan,nan,nan,nan,nan,nan,nan,nan,nan,nan,nan,nan,nan,nan,Premier League,nan,nan,nan,nan,nan,nan,nan,nan
19/6/2011,Stiliyan Petrov,116362,760,7/5/1979,31,101,8,0,0,6250,7755,7250,150,141,1107960,180,77,DM/M C,1,2,3,1,3,3,2,4,1,3,3,11,11,12,12,14,12,12,11,5,14,16,11,15,13,14,16,14,14,16,15,15,17,5,15,9,16,16,15,11,10,11,11,10,18,9,20,11,14,18,13,15,7,12,15,14,13,15,14,10,15,16,1,1,20,10,1,1,20,DM/M C,311,1,1,1,10,1,1,1,1,1,20,20,1,1,1,1,67108928,0,0,0,0,0,0,1,0,0,0,0,0,0,0,0,0,0,0,0,0,0,0,0,0,0,0,1,0,0,0,0,0,0,0,0,0,0,0,0,0,0,0,0,0,0,0,0,0
19/6/2011,Stijn Schaars,856452,784,1/11/1984,27,15,0,15,1,5500,6900,6650,137,133,510265,177,77,DM/M LC,1,3,3,3,2,1,1,1,1,3,3,11,13,13,6,13,13,10,12,12,12,15,12,13,13,11,15,14,15,14,15,14,15,12,17,11,15,14,10,11,14,13,9,20,15,10,8,12,12,11,11,13,14,10,15,16,14,16,17,14,12,5,1,10,20,5,1,16,20,DM/M LC,424,1,1,1,5,1,1,1,1,1,18,20,16,1,10,1,0,0,0,0,0,0,0,0,0,0,0,0,0,0,0,0,0,0,0,0,0,0,0,0,0,0,0,0,0,0,0,0,0,0,0,0,0,0,0,0,0,0,0,0,0,0,0,0,0,Stijn Schaars,£6.30m ,36.0,178.0,Midfielder - Defensive Midfield,left,Retired,39.0,1.0,7.0,3492.0,50.0,5.0,9.0,4076.0,16.0,0.0,3.0,982.0,38.0,0.0,6.0,3022.0,8.0,1.0,0.0,523.0,16.0,0.0,0.0,646.0,24.0,2.0,2.0,1948.0,29.0,3.0,3.0,2580.0,10.0,0.0,0.0,590.0,Liga NOS,nan,nan,nan,nan,nan,nan,nan,nan
19/6/2011,Steven Reid,107553,789,3/10/1981,30,23,2,0,0,5000,6500,6500,145,131,535567,186,88,D/DM/M RC,1,1,2,3,3,2,3,2,2,2,1,7,10,11,8,12,7,14,9,11,13,11,6,14,12,16,12,16,12,13,10,12,20,8,14,12,15,14,17,12,13,12,14,11,15,12,20,16,17,13,12,14,15,17,14,14,15,15,19,13,15,1,20,9,17,1,20,10,17,D/DM/M RC,123,1,1,1,1,1,1,10,9,20,17,17,10,12,1,9,137439019008,0,0,0,0,0,0,0,0,0,0,0,0,0,0,0,0,1,0,0,0,0,0,0,0,0,0,0,0,0,0,0,0,0,0,0,0,0,1,0,0,0,0,0,0,0,0,0,0,Steven Reid,£1.35m ,39.0,185.0,Defender - Right-Back,right,Retired,30.0,2.0,7.0,1879.0,22.0,1.0,2.0,1770.0,13.0,0.0,0.0,977.0,17.0,0.0,1.0,1428.0,8.0,0.0,0.0,129.0,nan,nan,nan,nan,nan,nan,nan,nan,nan,nan,nan,nan,nan,nan,nan,nan,Premier League,nan,nan,nan,nan,nan,nan,nan,nan
19/6/2011,Steven N'Zonzi,34011354,769,12/15/1988,22,0,0,6,0,5500,5950,6750,155,132,1449678,190,75,DM/M C,1,2,1,3,1,2,1,3,1,1,2,4,7,8,6,15,10,10,8,6,14,14,8,12,15,14,15,15,18,12,13,11,12,14,11,10,16,10,10,15,10,14,17,10,18,13,20,16,16,13,10,15,4,10,16,16,8,18,8,12,8,12,1,1,17,8,1,1,17,DM/M C,311,1,1,1,8,1,1,1,1,1,20,17,1,1,1,1,274878431296,0,0,0,0,0,0,1,0,0,0,0,0,0,0,0,0,0,0,0,1,0,0,0,0,0,0,0,0,0,0,0,0,0,0,0,0,0,0,1,0,0,0,0,0,0,0,0,0,Steven Nzonzi,£4.05m ,31.0,196.0,Midfielder - Defensive Midfield,right,Stade Rennais FC,26.0,1.0,0.0,1658.0,34.0,2.0,5.0,2972.0,38.0,1.0,1.0,3409.0,40.0,2.0,2.0,3356.0,42.0,4.0,1.0,3690.0,46.0,4.0,2.0,3228.0,46.0,3.0,3.0,4086.0,44.0,1.0,2.0,3693.0,39.0,1.0,2.0,3275.0,Premier League,22.0,0.0,1.0,1849.0,8.0,1.0,0.0,720.0
19/6/2011,Steven Gerrard,108658,765,5/30/1980,31,89,19,4,1,8650,8800,8800,185,171,4701319,186,79,M/AM RC,2,3,2,2,1,2,1,1,2,2,2,12,16,14,16,15,13,11,18,3,11,17,17,16,15,16,16,17,15,15,15,16,18,14,15,15,13,14,12,14,14,16,14,13,14,14,20,14,16,14,14,17,14,20,10,20,19,18,16,5,14,13,12,12,18,20,17,12,20,M/AM RC,523,1,1,8,20,12,17,1,1,12,13,18,12,17,1,12,8796093023136,0,0,0,0,0,1,0,1,1,1,0,0,0,0,0,0,0,0,0,0,0,0,0,0,0,0,0,0,0,0,0,0,0,0,0,0,0,0,0,0,0,0,0,1,0,0,0,0,Steven Gerrard,£13.95m ,40.0,183.0,Midfielder - Central Midfield,right,Retired,24.0,8.0,6.0,2007.0,28.0,8.0,5.0,2036.0,46.0,11.0,11.0,3925.0,39.0,14.0,16.0,3366.0,56.0,15.0,5.0,4554.0,24.0,3.0,11.0,1715.0,nan,nan,nan,nan,nan,nan,nan,nan,nan,nan,nan,nan,Premier League,nan,nan,nan,nan,nan,nan,nan,nan
19/6/2011,Steven Defour,8163457,757,4/15/1988,23,29,1,0,0,6400,6750,6750,155,135,4263203,174,69,DM/M C,3,2,3,2,3,2,3,2,2,3,1,15,13,11,8,14,12,6,11,5,6,16,15,8,14,18,13,16,13,17,17,15,18,14,19,10,14,19,19,12,12,9,7,10,18,13,20,18,10,17,7,14,14,10,12,18,13,12,15,8,12,15,1,1,19,14,11,10,19,DM/M C,311,1,1,10,14,10,11,1,1,1,20,19,10,11,1,1,17956928,0,0,0,0,0,0,1,0,0,0,0,0,0,0,0,0,0,1,0,0,1,0,0,0,1,0,0,0,0,0,0,0,0,0,0,0,0,0,0,0,0,0,0,0,0,0,0,0,Steven Defour,£9.90m ,32.0,175.0,Midfielder - Central Midfield,right,KV Mechelen,32.0,3.0,10.0,2623.0,38.0,2.0,2.0,1789.0,40.0,4.0,2.0,2179.0,36.0,1.0,4.0,2508.0,39.0,7.0,9.0,3003.0,42.0,3.0,10.0,3616.0,28.0,3.0,5.0,1632.0,25.0,1.0,1.0,2009.0,9.0,0.0,0.0,681.0,Liga NOS,12.0,0.0,1.0,736.0,0.0,0.0,0.0,0.0
19/6/2011,Steve Sidwell,5101869,765,12/14/1982,28,0,0,5,0,5200,6500,6500,142,136,1342558,178,70,M C,2,3,1,2,2,2,3,5,2,2,2,5,10,11,8,14,10,8,10,5,12,14,8,14,12,15,14,15,13,15,14,13,17,7,14,15,13,16,16,10,13,13,11,12,19,12,20,17,13,13,13,14,8,11,10,18,6,13,10,10,10,8,1,1,20,13,1,1,20,M C,401,1,1,1,13,1,1,1,1,1,10,20,1,1,1,1,2147549576,0,0,0,1,0,0,0,1,1,0,0,0,0,0,0,0,1,0,0,0,0,0,0,0,0,0,0,0,0,0,0,1,0,0,0,0,0,0,0,0,0,0,0,0,0,0,0,0,Steve Sidwell,£2.25m ,37.0,183.0,Midfielder - Central Midfield,right,Retired,22.0,2.0,4.0,1627.0,28.0,3.0,2.0,1655.0,31.0,4.0,2.0,2374.0,41.0,8.0,2.0,3407.0,16.0,0.0,0.0,642.0,23.0,1.0,1.0,915.0,37.0,1.0,0.0,2649.0,0.0,0.0,0.0,0.0,nan,nan,nan,nan,Premier League,nan,nan,nan,nan,nan,nan,nan,nan
19/6/2011,Stephen Ireland,5127709,789,8/22/1986,24,6,4,1,0,4800,6000,5500,155,140,2866881,173,65,M/AM C,1,1,2,2,2,3,1,1,3,3,1,10,11,12,14,15,10,5,12,6,8,14,10,13,14,10,16,8,16,14,16,15,5,12,7,17,5,9,17,14,13,16,6,11,12,12,20,17,9,15,11,12,11,14,16,4,10,6,8,14,16,15,1,1,18,20,14,10,20,M/AM C,521,1,1,1,20,10,14,1,1,1,1,18,1,10,1,1,1048712,0,0,0,1,0,0,0,1,0,0,0,0,0,0,0,0,0,0,0,0,1,0,0,0,0,0,0,0,0,0,0,0,0,0,0,0,0,0,0,0,0,0,0,0,0,0,0,0,Stephen Ireland,£4.95m ,34.0,173.0,Midfielder - Attacking Midfield,right,Retired,15.0,0.0,0.0,720.0,28.0,1.0,3.0,1950.0,17.0,0.0,4.0,1063.0,29.0,3.0,3.0,1677.0,20.0,3.0,4.0,1097.0,18.0,0.0,2.0,697.0,nan,nan,nan,nan,6.0,0.0,1.0,245.0,nan,nan,nan,nan,Premier League,nan,nan,nan,nan,nan,nan,nan,nan
19/6/2011,Stéphane Dalmat,3501527,769,2/16/1979,32,0,0,21,1,5000,6200,6200,150,138,485712,180,76,M C,3,2,2,2,3,1,1,3,1,1,2,14,14,14,8,15,14,11,12,8,11,15,10,9,15,9,13,11,13,13,14,11,13,14,12,13,10,9,12,15,13,13,10,14,13,12,20,14,13,13,9,15,8,10,12,15,13,10,9,15,15,12,5,5,20,14,10,12,20,M C,401,1,1,1,14,12,10,1,1,5,12,20,12,10,1,5,8831526502784,0,0,0,0,0,0,0,1,1,0,0,0,0,0,0,0,0,0,0,0,0,0,0,0,0,0,0,0,0,0,1,0,0,0,0,1,0,0,0,0,0,0,0,1,0,0,0,0,StÃ©phane Dalmat,£810Th. ,41.0,183.0,Midfielder - Central Midfield,right,Retired,34.0,2.0,1.0,2555.0,11.0,0.0,6.0,432.0,nan,nan,nan,nan,nan,nan,nan,nan,nan,nan,nan,nan,nan,nan,nan,nan,nan,nan,nan,nan,nan,nan,nan,nan,nan,nan,nan,nan,Ligue 1,nan,nan,nan,nan,nan,nan,nan,nan
19/6/2011,Sténio,55038353,12,5/6/1988,23,0,0,0,0,1020,4500,3500,104,93,33212,182,85,DM/M C,2,2,3,2,1,2,2,6,1,3,2,9,6,11,8,13,9,9,12,2,11,12,9,11,13,13,12,4,11,9,10,12,8,4,3,12,13,12,13,13,10,11,11,8,4,10,20,8,4,10,11,10,10,10,5,18,8,13,15,18,5,9,1,1,20,7,7,1,20,DM/M C,421,1,1,1,7,1,1,1,1,1,18,20,1,7,1,1,0,0,0,0,0,0,0,0,0,0,0,0,0,0,0,0,0,0,0,0,0,0,0,0,0,0,0,0,0,0,0,0,0,0,0,0,0,0,0,0,0,0,0,0,0,0,0,0,0,Stenio,£720Th. ,32.0,179.0,Midfielder - Central Midfield,right,UD Santarém,4.0,0.0,0.0,227.0,25.0,0.0,0.0,1620.0,33.0,3.0,1.0,2657.0,33.0,2.0,0.0,2206.0,34.0,6.0,1.0,2911.0,32.0,2.0,0.0,2384.0,30.0,1.0,0.0,2323.0,11.0,2.0,1.0,754.0,nan,nan,nan,nan,Liga NOS,nan,nan,nan,nan,nan,nan,nan,nan
19/6/2011,Stefano Morrone,704146,776,10/26/1978,32,0,0,9,0,4550,6750,6750,140,135,734391,178,71,DM/M C,1,1,3,1,2,1,2,7,3,1,1,13,10,4,8,10,6,13,12,9,14,13,7,16,13,17,15,16,17,16,13,16,16,6,18,15,15,17,18,10,13,12,11,8,15,11,20,16,14,14,9,15,6,15,9,12,10,11,12,10,16,7,1,1,20,1,1,14,20,DM/M C,421,1,1,1,1,1,1,1,1,1,19,20,14,1,1,1,1081344,0,0,0,0,0,0,0,0,0,0,0,0,0,0,0,1,0,0,0,0,1,0,0,0,0,0,0,0,0,0,0,0,0,0,0,0,0,0,0,0,0,0,0,0,0,0,0,0,Stefano Morrone,£720Th. ,42.0,178.0,Midfielder - Central Midfield,right,Retired,36.0,1.0,0.0,2727.0,31.0,1.0,1.0,2182.0,3.0,0.0,0.0,86.0,35.0,3.0,2.0,2491.0,28.0,4.0,1.0,2263.0,nan,nan,nan,nan,nan,nan,nan,nan,nan,nan,nan,nan,nan,nan,nan,nan,Serie A,nan,nan,nan,nan,nan,nan,nan,nan
19/6/2011,Stefano Mauri,6100283,776,1/8/1980,31,11,0,0,0,5950,7350,7350,150,147,807979,184,77,AM LC,1,3,3,1,3,1,2,8,2,2,1,13,15,15,12,15,11,14,14,7,8,16,11,11,15,10,14,11,14,12,16,15,13,13,10,17,9,15,12,12,13,13,11,20,13,12,12,13,14,12,12,13,12,15,7,13,12,12,10,11,15,11,1,1,15,20,14,18,20,AM LC,504,1,1,1,20,18,14,1,1,1,1,15,15,13,1,1,549755813896,0,0,0,1,0,0,0,0,0,0,0,0,0,0,0,0,0,0,0,0,0,0,0,0,0,0,0,0,0,0,0,0,0,0,0,0,0,0,0,1,0,0,0,0,0,0,0,0,Stefano Mauri,£2.70m ,40.0,184.0,Midfielder - Attacking Midfield,left,Retired,30.0,6.0,9.0,2279.0,19.0,5.0,3.0,1421.0,36.0,4.0,7.0,2548.0,12.0,4.0,2.0,691.0,31.0,9.0,2.0,1954.0,19.0,1.0,1.0,731.0,12.0,1.0,0.0,743.0,nan,nan,nan,nan,nan,nan,nan,nan,Serie A,nan,nan,nan,nan,nan,nan,nan,nan
19/6/2011,Souza,19060675,1651,2/11/1989,22,0,0,5,0,3250,6400,6650,150,133,1169499,186,77,M C,3,2,1,2,3,2,2,3,2,2,1,12,12,14,11,14,10,8,13,6,11,13,12,11,14,11,13,11,13,13,11,13,13,14,11,13,12,10,12,11,13,14,13,13,13,11,20,13,13,12,8,12,7,12,12,13,10,12,12,5,12,11,1,1,20,10,1,1,20,M C,401,1,1,1,10,1,1,1,1,1,15,20,1,1,1,1,0,0,0,0,0,0,0,0,0,0,0,0,0,0,0,0,0,0,0,0,0,0,0,0,0,0,0,0,0,0,0,0,0,0,0,0,0,0,0,0,0,0,0,0,0,0,0,0,0
19/6/2011,Sören Bertram,91018461,771,6/5/1991,20,0,0,0,0,2250,5700,5700,135,114,1316822,183,70,M/AM RC,1,2,1,1,1,2,3,5,1,3,3,11,12,12,9,13,10,7,12,10,9,12,10,8,12,11,12,15,9,10,13,10,10,13,8,14,9,12,14,13,13,10,11,20,8,13,11,9,9,11,7,4,5,10,5,1,7,11,13,14,5,8,1,1,20,20,20,12,17,M/AM RC,413,1,1,1,1,1,20,1,1,1,14,17,12,20,1,1,0,0,0,0,0,0,0,0,0,0,0,0,0,0,0,0,0,0,0,0,0,0,0,0,0,0,0,0,0,0,0,0,0,0,0,0,0,0,0,0,0,0,0,0,0,0,0,0,0,Sören Bertram,£360Th. ,29.0,185.0,Forward - Left Winger,left,1.FC Magdeburg,19.0,2.0,0.0,790.0,25.0,6.0,6.0,2187.0,16.0,3.0,1.0,960.0,37.0,12.0,6.0,2925.0,30.0,3.0,11.0,2175.0,35.0,10.0,8.0,2983.0,8.0,0.0,0.0,217.0,25.0,7.0,1.0,1247.0,21.0,1.0,2.0,924.0,Bundesliga,35.0,10.0,4.0,2790.0,6.0,0.0,0.0,299.0
19/6/2011,Sofian Chahed,892144,51,4/18/1983,28,2,0,0,0,4150,6300,6300,130,126,331745,178,73,D/WB/DM/M RC,3,3,1,1,3,1,2,1,2,3,1,6,10,9,8,12,8,11,8,12,14,10,15,14,11,12,11,13,11,12,8,10,12,5,8,12,10,16,15,12,13,10,11,15,13,14,20,17,12,13,10,11,7,14,12,12,15,10,15,10,15,5,20,19,17,12,20,12,15,D/WB/DM/M RC,133,1,1,1,1,1,12,10,12,20,16,15,1,17,11,19,1073741824,0,0,0,0,0,0,0,0,0,0,0,0,0,0,0,0,0,0,0,0,0,0,0,0,0,0,0,0,0,0,1,0,0,0,0,0,0,0,0,0,0,0,0,0,0,0,0,0
19/6/2011,Simone Vergassola,12544,776,1/24/1976,35,0,0,0,0,3250,6000,6000,140,120,81845,174,70,DM/M C,2,3,3,3,3,1,11,9,2,1,3,10,12,10,10,12,11,12,12,12,11,16,10,12,16,17,13,13,14,10,15,15,16,8,17,10,14,15,15,10,10,11,9,5,14,10,20,12,11,17,8,12,9,11,15,15,13,12,15,14,9,3,1,1,18,1,1,1,18,DM/M C,311,1,1,1,1,1,1,1,1,1,20,18,1,1,1,1,64,0,0,0,0,0,0,1,0,0,0,0,0,0,0,0,0,0,0,0,0,0,0,0,0,0,0,0,0,0,0,0,0,0,0,0,0,0,0,0,0,0,0,0,0,0,0,0,0,Simone Vergassola,£180Th. ,44.0,174.0,Midfielder - Defensive Midfield,right,Retired,29.0,2.0,3.0,2318.0,31.0,0.0,2.0,2288.0,32.0,2.0,3.0,2763.0,27.0,1.0,4.0,1913.0,nan,nan,nan,nan,nan,nan,nan,nan,nan,nan,nan,nan,nan,nan,nan,nan,nan,nan,nan,nan,Serie A,nan,nan,nan,nan,nan,nan,nan,nan
19/6/2011,Simone Perrotta,702327,776,9/17/1977,33,48,2,6,1,6100,6750,7000,148,139,253652,178,72,M/AM LC,1,1,1,1,1,1,1,1,1,1,1,9,13,11,11,10,8,11,12,5,13,13,10,14,13,15,15,16,11,16,12,14,16,12,14,17,15,20,20,12,13,11,9,10,15,12,20,13,12,14,15,13,12,15,12,14,15,13,17,14,14,7,14,12,18,20,14,16,20,M/AM LC,524,1,1,1,20,12,13,1,1,14,15,18,16,12,1,12,566936731728,0,0,0,0,1,0,1,0,0,0,0,0,0,0,0,0,0,0,0,0,1,0,0,0,0,0,0,0,0,0,0,0,0,0,1,0,0,0,0,1,0,0,0,0,0,0,0,0,Simone Perrotta,£720Th. ,43.0,178.0,Midfielder - Attacking Midfield,right,Retired,35.0,4.0,2.0,2692.0,23.0,1.0,0.0,961.0,17.0,2.0,1.0,588.0,nan,nan,nan,nan,nan,nan,nan,nan,nan,nan,nan,nan,nan,nan,nan,nan,nan,nan,nan,nan,nan,nan,nan,nan,Serie A,nan,nan,nan,nan,nan,nan,nan,nan
19/6/2011,Simone Padoin,836918,776,3/18/1984,27,0,0,7,0,5300,6500,6750,143,135,764277,179,73,M/AM RLC,1,2,1,3,2,3,2,3,3,2,3,8,14,11,8,13,8,10,12,12,11,14,8,13,13,13,13,13,8,14,13,12,17,10,11,9,13,15,16,14,13,13,11,12,15,14,20,17,11,15,10,13,6,18,6,14,17,14,18,15,14,5,11,14,20,18,16,20,17,M/AM RLC,416,1,1,1,13,18,16,1,11,8,14,17,20,16,14,10,140737488388096,0,0,0,0,0,0,0,0,0,0,0,0,0,0,0,1,0,0,0,0,0,0,0,0,0,0,0,0,0,0,0,0,0,0,0,0,0,0,0,0,0,0,0,0,0,0,0,1,Simone Padoin,£4.05m ,36.0,177.0,Midfielder - Left Midfield,right,Retired,36.0,3.0,1.0,3049.0,27.0,1.0,1.0,2100.0,26.0,0.0,1.0,1168.0,25.0,1.0,0.0,950.0,34.0,0.0,4.0,1774.0,14.0,1.0,0.0,648.0,32.0,1.0,2.0,2262.0,37.0,1.0,0.0,3117.0,32.0,0.0,1.0,2016.0,Serie A,31.0,0.0,3.0,2436.0,1.0,0.0,0.0,9.0
19/6/2011,Simon Rolfes,884487,771,1/21/1982,29,22,1,1,0,6800,7500,7500,152,150,2427029,191,83,DM/M C,3,2,1,3,3,1,3,8,1,1,1,10,12,8,15,15,10,14,13,11,11,16,16,13,14,9,17,10,15,18,12,17,15,7,11,14,15,18,16,9,13,11,15,20,18,13,9,18,12,16,6,15,7,15,11,15,17,16,18,20,18,5,1,1,18,1,1,12,18,DM/M C,311,1,1,1,1,1,1,1,1,1,20,18,12,1,1,1,292091330632,0,0,0,1,0,0,1,0,0,0,0,0,0,0,0,0,0,0,0,0,0,0,0,0,0,1,0,0,0,0,0,0,0,0,1,0,0,0,1,0,0,0,0,0,0,0,0,0,Simon Rolfes,£3.60m ,38.0,191.0,Midfielder - Defensive Midfield,left,Retired,37.0,6.0,3.0,2414.0,40.0,3.0,6.0,2591.0,40.0,4.0,2.0,3031.0,43.0,7.0,5.0,3231.0,33.0,1.0,1.0,1856.0,nan,nan,nan,nan,nan,nan,nan,nan,nan,nan,nan,nan,nan,nan,nan,nan,Bundesliga,nan,nan,nan,nan,nan,nan,nan,nan
19/6/2011,Simon Lappin,5200012,793,1/25/1983,28,0,0,10,0,2750,5000,5350,109,107,379729,181,75,M LC,2,1,1,3,1,2,3,4,1,2,3,13,13,9,7,11,13,7,11,3,11,11,8,12,11,12,11,11,11,11,12,12,12,7,6,12,11,13,13,11,11,13,9,20,13,11,7,13,12,12,3,12,5,11,9,14,14,7,12,8,10,2,15,15,20,5,7,20,15,M LC,404,1,1,1,1,5,1,1,15,1,10,15,20,7,15,1,35184908959744,0,0,0,0,0,0,0,0,0,0,0,0,0,0,0,0,0,0,0,0,0,0,0,0,0,0,0,0,0,1,0,0,0,0,0,0,0,0,0,0,0,0,0,0,0,1,0,0,Simon Lappin,£675Th. ,37.0,180.0,Midfielder - Central Midfield,left,Wroxham FC,30.0,0.0,3.0,1967.0,13.0,0.0,0.0,955.0,5.0,1.0,0.0,411.0,12.0,0.0,3.0,891.0,31.0,1.0,1.0,2142.0,27.0,3.0,2.0,1651.0,7.0,0.0,0.0,582.0,nan,nan,nan,nan,nan,nan,nan,nan,Premier League,nan,nan,nan,nan,nan,nan,nan,nan
19/6/2011,Shaun Derry,2003927,765,12/6/1977,33,0,0,0,0,3396,6242,6242,125,124,437104,183,82,M C,1,1,3,2,3,1,2,1,3,1,3,11,7,10,5,12,8,12,8,3,14,12,12,17,9,16,15,18,13,15,11,15,15,9,19,9,15,18,18,10,11,14,13,9,13,10,20,14,15,15,16,14,11,10,7,13,13,13,16,8,15,13,1,1,20,1,1,4,20,M C,401,1,1,1,1,1,1,1,1,1,15,20,4,1,1,1,137439150080,0,0,0,0,0,0,0,0,0,0,0,0,0,0,0,0,1,1,0,0,0,0,0,0,0,0,0,0,0,0,0,0,0,0,0,0,0,1,0,0,0,0,0,0,0,0,0,0,Shaun Derry,£450Th. ,42.0,177.0,Midfielder - Defensive Midfield,right,Retired,47.0,0.0,0.0,4104.0,32.0,1.0,0.0,2419.0,19.0,0.0,0.0,1167.0,8.0,0.0,0.0,527.0,nan,nan,nan,nan,nan,nan,nan,nan,nan,nan,nan,nan,nan,nan,nan,nan,nan,nan,nan,nan,Premier League,nan,nan,nan,nan,nan,nan,nan,nan
19/6/2011,Seydou Keita,3503860,31,1/16/1980,31,55,16,0,0,7000,7650,7700,160,153,1311765,183,73,M LC,2,1,1,2,1,3,2,4,3,2,3,10,12,11,12,14,13,15,14,7,12,15,10,14,14,12,15,14,13,15,14,15,12,11,13,15,15,17,15,13,13,15,12,20,13,14,9,18,15,14,8,12,7,9,11,14,15,14,17,14,16,6,5,10,20,13,1,18,20,M LC,404,1,1,1,12,13,1,5,4,1,14,20,18,1,10,1,352,0,0,0,0,0,1,1,0,1,0,0,0,0,0,0,0,0,0,0,0,0,0,0,0,0,0,0,0,0,0,0,0,0,0,0,0,0,0,0,0,0,0,0,0,0,0,0,0,Seydou Keita,£7.20m ,40.0,183.0,Midfielder - Central Midfield,left,Retired,56.0,6.0,5.0,2694.0,55.0,8.0,6.0,3276.0,28.0,6.0,4.0,2229.0,18.0,1.0,0.0,1352.0,36.0,3.0,1.0,2513.0,27.0,1.0,2.0,1946.0,12.0,3.0,2.0,1007.0,nan,nan,nan,nan,nan,nan,nan,nan,LaLiga,nan,nan,nan,nan,nan,nan,nan,nan
19/6/2011,Sergio Tejera,29000484,796,5/28/1990,21,0,0,0,0,4000,6150,6150,151,127,658924,183,76,M/AM C,3,2,3,1,2,1,1,1,1,1,2,16,15,12,10,16,15,7,13,6,5,16,11,9,16,10,12,10,14,10,17,13,12,16,8,13,10,13,12,12,13,11,11,20,9,11,7,14,11,10,13,9,15,10,12,17,10,13,15,14,18,5,1,1,20,16,5,12,20,M/AM C,411,1,1,1,16,8,1,1,1,1,6,20,12,5,1,1,128,0,0,0,0,0,0,0,1,0,0,0,0,0,0,0,0,0,0,0,0,0,0,0,0,0,0,0,0,0,0,0,0,0,0,0,0,0,0,0,0,0,0,0,0,0,0,0,0,Sergio Tejera,£900Th. ,30.0,180.0,Midfielder - Central Midfield,left,Real Oviedo,28.0,1.0,3.0,1683.0,18.0,0.0,1.0,848.0,13.0,1.0,0.0,419.0,13.0,0.0,3.0,520.0,12.0,1.0,0.0,687.0,37.0,0.0,3.0,2835.0,38.0,6.0,5.0,3293.0,26.0,0.0,2.0,1992.0,35.0,4.0,3.0,2865.0,LaLiga,35.0,2.0,2.0,2977.0,8.0,1.0,0.0,654.0
19/6/2011,Sérgio Pinto,6000562,771,10/16/1980,30,0,0,0,0,4850,6750,6750,138,138,1148843,176,72,DM/M RC,1,2,3,2,2,2,2,1,3,3,1,14,15,12,7,13,13,6,16,8,11,14,15,12,13,18,12,17,11,9,13,10,14,12,14,11,11,15,17,15,14,11,9,11,14,12,20,16,10,15,17,13,6,17,13,13,13,12,15,4,6,11,13,14,20,15,17,1,20,DM/M RC,423,1,1,5,14,1,15,1,1,13,19,20,1,17,1,14,4393472,0,0,0,0,0,0,0,0,0,1,0,1,0,0,0,0,1,1,0,0,0,0,1,0,0,0,0,0,0,0,0,0,0,0,0,0,0,0,0,0,0,0,0,0,0,0,0,0
19/6/2011,Sergio Canales,67053076,796,2/16/1991,20,0,0,0,0,5600,7000,7000,166,142,0,176,70,AM C,1,3,3,3,3,3,3,3,1,1,2,15,14,16,12,18,14,8,13,9,4,17,13,7,18,7,12,8,14,11,19,13,11,18,8,12,6,13,10,14,17,10,8,20,11,12,11,11,7,8,6,15,6,10,12,14,9,12,13,15,13,7,1,1,15,20,10,14,20,AM C,501,1,1,8,20,14,10,1,1,1,1,15,12,9,1,1,17592188141712,0,0,0,0,1,0,0,1,0,0,0,0,0,0,0,0,0,0,0,0,0,1,0,0,0,0,0,0,0,0,0,0,0,0,0,0,0,0,0,0,0,0,0,0,1,0,0,0,Sergio Canales,£4.50m ,29.0,180.0,Midfielder - Attacking Midfield,left,Real Betis Balompié,15.0,0.0,1.0,518.0,16.0,1.0,2.0,775.0,15.0,2.0,2.0,636.0,45.0,4.0,4.0,2408.0,43.0,5.0,6.0,2965.0,18.0,1.0,0.0,987.0,37.0,0.0,4.0,1248.0,45.0,5.0,11.0,2659.0,46.0,9.0,3.0,3812.0,LaLiga,37.0,6.0,6.0,3257.0,7.0,1.0,2.0,599.0
19/6/2011,Sergio Busquets,1510566,796,7/16/1988,22,30,0,3,1,7500,8500,8500,172,167,7375960,189,73,DM/M C,2,3,2,2,2,2,1,4,1,3,3,9,12,13,9,17,9,13,11,8,16,15,10,14,13,14,18,13,18,14,14,17,12,8,9,12,19,18,17,13,13,15,14,10,14,14,20,17,13,13,16,15,8,13,11,13,13,14,13,6,7,8,13,1,18,10,1,1,18,DM/M C,311,1,1,1,10,1,1,13,1,1,20,18,1,1,1,1,196672,0,0,0,0,0,0,1,0,0,0,0,0,0,0,0,0,1,1,0,0,0,0,0,0,0,0,0,0,0,0,0,0,0,0,0,0,0,0,0,0,0,0,0,0,0,0,0,0,Sergio Busquets,£31.50m ,32.0,189.0,Midfielder - Defensive Midfield,right,FC Barcelona,46.0,1.0,6.0,3814.0,52.0,2.0,3.0,4067.0,45.0,1.0,2.0,3453.0,48.0,3.0,2.0,4074.0,47.0,1.0,3.0,3592.0,53.0,0.0,6.0,4422.0,48.0,0.0,3.0,3928.0,50.0,1.0,4.0,4164.0,54.0,0.0,2.0,4333.0,LaLiga,43.0,2.0,2.0,3265.0,6.0,0.0,0.0,444.0
19/6/2011,Sergio Almirón,6300119,1649,11/7/1980,30,0,0,0,0,1600,6300,6500,150,130,740593,180,76,M C,2,3,1,3,3,3,1,4,2,3,3,12,12,12,9,15,15,6,17,9,9,16,13,11,14,11,11,12,11,12,16,13,16,11,11,12,14,12,15,12,12,12,9,9,10,12,20,13,11,13,11,13,6,14,15,15,14,12,11,13,16,6,1,1,20,13,13,1,20,M C,401,1,1,1,12,1,13,1,1,1,14,20,1,10,1,1,35184372089600,0,0,0,0,0,0,0,0,1,1,0,0,0,0,0,0,0,0,0,0,0,0,0,0,0,0,0,0,0,0,0,0,0,0,0,0,0,0,0,0,0,0,0,0,0,1,0,0,Sergio Almirón,£1.62m ,39.0,180.0,Midfielder - Central Midfield,right,Retired,25.0,0.0,4.0,1841.0,32.0,4.0,0.0,2617.0,33.0,4.0,0.0,2241.0,13.0,1.0,0.0,874.0,8.0,0.0,0.0,521.0,9.0,3.0,0.0,573.0,nan,nan,nan,nan,3.0,0.0,0.0,21.0,nan,nan,nan,nan,Serie A,nan,nan,nan,nan,nan,nan,nan,nan
19/6/2011,Sejad Salihovic,8708032,759,10/8/1984,26,23,3,3,1,6107,7158,7008,141,135,1036783,182,82,M/AM C,1,1,1,2,2,3,1,3,2,2,1,17,18,13,12,16,19,6,15,10,9,17,14,10,16,15,12,14,10,7,17,14,12,16,11,9,9,6,12,11,15,17,11,20,6,15,7,12,13,11,13,14,8,16,12,7,11,14,7,8,10,14,1,1,20,16,1,14,20,M/AM C,411,1,1,1,16,1,1,1,1,1,12,20,14,1,1,1,8899172240384,0,0,0,0,0,0,0,0,0,0,1,1,0,0,0,0,0,0,0,0,0,0,0,0,0,0,0,0,0,0,0,0,0,0,0,1,1,0,0,0,0,0,0,1,0,0,0,0,Sejad Salihovic,£5.85m ,36.0,182.0,Midfielder - Central Midfield,left,Retired,30.0,5.0,9.0,2391.0,27.0,11.0,4.0,2077.0,23.0,7.0,7.0,1488.0,30.0,11.0,6.0,2013.0,28.0,4.0,8.0,1699.0,13.0,3.0,1.0,1151.0,13.0,0.0,2.0,558.0,10.0,1.0,1.0,366.0,nan,nan,nan,nan,Bundesliga,nan,nan,nan,nan,nan,nan,nan,nan
19/6/2011,Sébastien Roudet,3503022,769,6/16/1981,30,0,0,2,0,4500,5600,5600,135,124,462411,174,72,M/AM LC,1,2,2,3,2,1,1,4,1,1,1,12,14,13,8,14,13,9,12,6,5,14,12,7,14,10,13,13,14,13,13,11,13,11,9,12,10,16,15,13,13,12,7,20,12,11,8,15,12,12,10,14,9,10,12,13,15,13,16,14,14,7,8,8,18,20,12,20,18,M/AM LC,524,1,1,1,18,20,12,1,8,1,10,18,16,12,8,1,1048576,0,0,0,0,0,0,0,0,0,0,0,0,0,0,0,0,0,0,0,0,1,0,0,0,0,0,0,0,0,0,0,0,0,0,0,0,0,0,0,0,0,0,0,0,0,0,0,0,SÃ©bastien Roudet,£1.58m ,39.0,174.0,Midfielder - Attacking Midfield,left,FC DÃ©olois,34.0,4.0,5.0,2673.0,27.0,1.0,2.0,1438.0,33.0,4.0,5.0,2454.0,30.0,0.0,5.0,2345.0,26.0,2.0,3.0,2215.0,11.0,0.0,6.0,789.0,31.0,3.0,2.0,2669.0,30.0,8.0,7.0,2440.0,26.0,4.0,3.0,1771.0,Ligue 1,nan,nan,nan,nan,nan,nan,nan,nan
19/6/2011,Sebastian Schindzielorz,3600750,771,1/21/1979,32,0,0,16,1,2747,4994,4994,130,99,19628,182,74,DM/M C,2,3,3,2,2,1,3,1,2,1,1,9,9,7,7,12,9,10,9,11,13,9,9,14,9,15,14,15,12,13,10,15,14,7,15,6,13,16,12,8,10,11,8,20,16,9,15,10,10,14,10,13,12,10,5,10,12,13,12,13,9,4,5,1,18,5,1,1,18,DM/M C,311,1,1,1,5,1,1,5,1,1,20,18,1,1,1,1,100663296,0,0,0,0,0,0,0,0,0,0,0,0,0,0,0,0,0,0,0,0,0,0,0,0,0,1,1,0,0,0,0,0,0,0,0,0,0,0,0,0,0,0,0,0,0,0,0,0,Sebastian Schindzielorz,£180Th. ,41.0,180.0,Midfielder - Defensive Midfield,both,Retired,22.0,0.0,1.0,1879.0,22.0,0.0,1.0,1740.0,18.0,1.0,0.0,1397.0,nan,nan,nan,nan,nan,nan,nan,nan,nan,nan,nan,nan,nan,nan,nan,nan,nan,nan,nan,nan,nan,nan,nan,nan,Bundesliga,nan,nan,nan,nan,nan,nan,nan,nan
19/6/2011,Sebastian Rudy,29022542,771,2/28/1990,21,0,0,12,2,6000,6750,6750,144,130,1247466,179,73,DM/M C,3,1,2,1,2,2,3,5,2,1,1,13,14,12,10,16,10,7,11,6,9,16,11,13,15,6,14,6,11,9,15,15,9,12,5,10,10,18,13,12,15,7,7,12,8,14,20,11,6,10,4,8,9,14,14,12,14,8,4,17,19,5,1,1,20,15,13,14,20,DM/M C,421,1,1,1,15,1,1,1,1,1,17,20,14,13,1,1,8813293863040,0,0,0,0,0,0,0,1,0,0,0,0,0,0,0,0,0,0,0,0,0,0,1,0,1,0,0,0,0,0,0,0,0,0,1,0,0,0,0,0,0,0,0,1,0,0,0,0,Sebastian Rudy,£4.95m ,30.0,180.0,Midfielder - Defensive Midfield,right,TSG 1899 Hoffenheim,38.0,2.0,7.0,2870.0,29.0,0.0,2.0,2457.0,26.0,0.0,2.0,1932.0,30.0,2.0,6.0,2511.0,33.0,4.0,7.0,2596.0,25.0,2.0,1.0,1874.0,34.0,3.0,10.0,2998.0,35.0,1.0,5.0,2133.0,28.0,0.0,0.0,1853.0,Bundesliga,35.0,1.0,4.0,2993.0,5.0,0.0,2.0,450.0
19/6/2011,Sebastian Larsson,615722,797,6/6/1985,26,22,0,12,0,5250,7000,6500,142,134,3863636,178,70,M/AM RC,1,1,3,2,2,1,2,6,1,2,2,12,15,12,11,12,16,12,14,8,10,13,8,12,13,9,12,12,13,12,10,12,14,12,11,11,9,12,14,13,12,9,8,12,15,14,20,14,11,12,2,12,5,10,13,14,17,12,13,15,15,5,15,15,20,19,20,14,19,M/AM RC,413,1,1,1,1,1,19,1,1,15,10,19,14,20,1,15,68719476992,0,0,0,0,0,0,0,0,1,0,0,0,0,0,0,0,0,0,0,0,0,0,0,0,0,0,0,0,0,0,0,0,0,0,0,0,1,0,0,0,0,0,0,0,0,0,0,0,Sebastian Larsson,£6.75m ,35.0,178.0,Midfielder - Central Midfield,right,AIK,41.0,5.0,9.0,3333.0,39.0,8.0,5.0,3396.0,41.0,1.0,7.0,3193.0,41.0,2.0,4.0,3006.0,40.0,3.0,3.0,3375.0,20.0,0.0,3.0,726.0,25.0,1.0,2.0,1824.0,55.0,4.0,10.0,4328.0,30.0,6.0,7.0,2390.0,Premier League,33.0,8.0,10.0,2812.0,nan,nan,nan,nan
19/6/2011,Sebastian Kehl,3601047,771,2/13/1980,31,31,3,11,0,6350,6950,6950,155,141,942015,188,80,DM/M C,2,1,1,2,3,3,2,10,1,2,2,6,9,8,7,11,5,13,9,13,16,11,10,18,11,18,17,17,15,17,10,17,18,8,17,8,18,19,12,10,12,16,14,20,8,12,13,15,16,18,14,17,18,8,14,17,15,16,20,7,8,12,8,1,18,1,1,1,18,DM/M C,311,1,1,1,1,1,1,8,1,1,20,18,1,1,1,1,1073872896,0,0,0,0,0,0,0,0,0,0,0,0,0,0,0,0,0,1,0,0,0,0,0,0,0,0,0,0,0,0,1,0,0,0,0,0,0,0,0,0,0,0,0,0,0,0,0,0,Sebastian Kehl,£2.25m ,40.0,187.0,Midfielder - Defensive Midfield,left,Retired,11.0,0.0,2.0,655.0,39.0,3.0,4.0,2972.0,34.0,0.0,2.0,2188.0,27.0,2.0,2.0,1961.0,32.0,1.0,2.0,2466.0,nan,nan,nan,nan,nan,nan,nan,nan,nan,nan,nan,nan,nan,nan,nan,nan,Bundesliga,nan,nan,nan,nan,nan,nan,nan,nan
19/6/2011,Sebastian Eriksson,8109541,797,1/31/1989,22,5,0,16,0,2280,5500,5500,137,110,72802,185,74,M C,2,2,2,2,2,3,2,1,3,3,2,11,9,9,9,10,8,10,8,5,12,11,5,15,11,16,10,16,11,11,12,11,13,8,14,9,15,15,16,14,11,11,11,20,10,12,7,15,15,12,9,13,7,12,12,11,17,11,16,12,16,3,7,5,20,15,1,14,20,M C,401,1,1,1,15,1,1,1,7,1,14,20,14,1,5,1,131200,0,0,0,0,0,0,0,1,0,0,0,0,0,0,0,0,0,1,0,0,0,0,0,0,0,0,0,0,0,0,0,0,0,0,0,0,0,0,0,0,0,0,0,0,0,0,0,0,Sebastian Eriksson,£1.08m ,31.0,184.0,Midfielder - Defensive Midfield,left,IFK Göteborg,16.0,3.0,1.0,1108.0,1.0,0.0,0.0,1.0,15.0,1.0,0.0,773.0,25.0,1.0,0.0,1509.0,27.0,2.0,2.0,1801.0,35.0,0.0,4.0,2887.0,39.0,3.0,3.0,3177.0,15.0,0.0,0.0,1331.0,22.0,3.0,0.0,1858.0,Serie A,1.0,0.0,0.0,10.0,nan,nan,nan,nan
19/6/2011,Sebastián Eguren,5513036,1657,1/8/1981,30,42,6,20,0,5550,5900,6750,144,131,1067346,186,84,DM/M C,3,1,2,1,1,3,3,6,3,2,1,9,11,8,12,14,14,16,14,9,14,11,10,13,11,19,13,17,14,14,12,12,8,5,18,13,14,17,16,12,12,13,13,5,12,12,20,16,16,13,14,17,5,8,15,9,14,17,11,4,5,14,9,1,20,10,5,5,20,DM/M C,421,1,5,1,10,1,1,9,1,1,19,20,5,5,1,1,139586568192,0,0,0,0,0,0,0,0,0,0,0,0,0,0,0,0,0,1,0,0,0,0,0,0,0,0,0,0,0,0,0,1,0,0,0,0,0,1,0,0,0,0,0,0,0,0,0,0,Sebastián Eguren,£2.25m ,39.0,186.0,Midfielder - Defensive Midfield,right,Retired,32.0,1.0,0.0,2413.0,21.0,2.0,0.0,1172.0,15.0,2.0,1.0,555.0,5.0,0.0,0.0,241.0,11.0,0.0,0.0,628.0,15.0,0.0,1.0,713.0,nan,nan,nan,nan,nan,nan,nan,nan,nan,nan,nan,nan,LaLiga,nan,nan,nan,nan,nan,nan,nan,nan
19/6/2011,Scott Parker,103424,765,10/13/1980,30,6,0,12,0,5852,7403,7503,154,154,6624051,176,75,DM/M C,1,1,3,2,3,3,1,4,3,1,2,9,10,15,12,15,12,13,13,3,14,15,14,16,12,16,13,18,17,16,11,14,18,12,12,14,15,18,18,12,13,12,10,10,18,12,20,18,15,18,9,18,12,7,14,12,12,18,17,15,15,4,1,1,20,14,4,1,20,DM/M C,421,1,1,1,14,1,1,1,1,1,18,20,1,4,1,1,2336462209088,0,0,0,0,0,0,1,0,0,0,0,0,0,0,0,0,0,0,0,0,0,0,0,0,0,0,0,0,0,0,0,0,0,0,0,0,0,1,0,0,0,1,0,0,0,0,0,0,Scott Parker,£9.90m ,40.0,180.0,Midfielder - Central Midfield,right,Retired,40.0,7.0,4.0,3443.0,38.0,1.0,2.0,3265.0,31.0,1.0,4.0,2242.0,32.0,2.0,1.0,2597.0,41.0,3.0,3.0,3371.0,25.0,1.0,2.0,1770.0,31.0,0.0,2.0,1301.0,nan,nan,nan,nan,nan,nan,nan,nan,Premier League,nan,nan,nan,nan,nan,nan,nan,nan
19/6/2011,Sascha Riether,890204,771,3/23/1983,28,2,0,20,0,5250,6950,6950,142,139,1723459,174,71,D/DM/M RC,2,1,2,2,3,2,2,6,1,1,2,6,8,9,6,11,7,10,5,14,14,10,12,15,11,12,16,13,8,16,8,10,18,3,14,12,14,19,18,18,15,13,8,8,17,15,20,17,9,17,10,14,11,17,6,13,17,11,16,15,12,4,20,15,17,1,20,5,17,D/DM/M RC,123,1,1,1,1,1,1,10,5,20,19,17,1,12,5,15,0,0,0,0,0,0,0,0,0,0,0,0,0,0,0,0,0,0,0,0,0,0,0,0,0,0,0,0,0,0,0,0,0,0,0,0,0,0,0,0,0,0,0,0,0,0,0,0,0,Sascha Riether,£2.25m ,37.0,174.0,Defender - Right-Back,right,Retired,31.0,2.0,3.0,2606.0,35.0,0.0,0.0,3134.0,39.0,1.0,6.0,3363.0,33.0,0.0,4.0,2858.0,21.0,0.0,1.0,1493.0,20.0,0.0,2.0,1481.0,9.0,0.0,0.0,582.0,0.0,0.0,0.0,0.0,1.0,0.0,0.0,1.0,Bundesliga,nan,nan,nan,nan,nan,nan,nan,nan
19/6/2011,Saphir Taïder,85041832,769,2/29/1992,19,0,0,0,0,3238,4923,4915,147,108,389439,180,73,M RC,1,1,3,2,3,2,2,1,3,2,1,8,8,13,8,13,13,6,12,5,7,12,11,5,15,8,12,11,12,12,13,9,14,12,7,11,9,13,14,14,14,13,9,8,14,11,20,14,11,13,8,14,7,8,12,15,14,13,13,15,15,7,1,1,20,1,15,10,20,M RC,403,1,1,1,1,1,1,1,1,1,14,20,10,15,1,1,1073741824,0,0,0,0,0,0,0,0,0,0,0,0,0,0,0,0,0,0,0,0,0,0,0,0,0,0,0,0,0,0,1,0,0,0,0,0,0,0,0,0,0,0,0,0,0,0,0,0,Saphir Taider,£2.70m ,28.0,180.0,Midfielder - Central Midfield,right,Al-Ain,26.0,1.0,0.0,1682.0,19.0,2.0,1.0,1362.0,35.0,5.0,2.0,2967.0,26.0,2.0,2.0,1140.0,28.0,4.0,3.0,1773.0,29.0,0.0,0.0,2111.0,25.0,4.0,0.0,1992.0,45.0,7.0,9.0,3423.0,37.0,10.0,9.0,3033.0,Serie A,14.0,5.0,5.0,1158.0,1.0,1.0,0.0,90.0
19/6/2011,Santi Cazorla,7456688,796,12/13/1984,26,24,2,7,0,6900,7900,7900,161,158,8932934,168,66,M/AM RLC,3,3,2,1,1,3,3,3,2,1,1,13,12,17,12,16,16,5,15,7,4,16,13,8,18,10,13,12,15,12,16,13,15,17,12,15,6,13,11,17,18,11,5,17,13,12,20,12,6,11,9,14,8,15,14,14,16,15,14,14,12,7,1,1,18,20,20,19,18,M/AM RLC,526,1,1,6,18,19,20,1,1,1,1,15,17,18,1,1,404,0,0,1,0,1,0,0,1,1,0,0,0,0,0,0,0,0,0,0,0,0,0,0,0,0,0,0,0,0,0,0,0,0,0,0,0,0,0,0,0,0,0,0,0,0,0,0,0,Santi Cazorla,£18.00m ,35.0,168.0,Midfielder - Central Midfield,both,Al-Sadd SC,54.0,8.0,13.0,4039.0,42.0,9.0,8.0,3466.0,49.0,12.0,14.0,4251.0,46.0,7.0,9.0,3630.0,53.0,8.0,15.0,4305.0,23.0,0.0,5.0,1965.0,11.0,2.0,3.0,856.0,nan,nan,nan,nan,46.0,7.0,11.0,3117.0,LaLiga,45.0,17.0,13.0,3265.0,4.0,3.0,3.0,360.0
19/6/2011,Sandro,19042321,1651,3/15/1989,22,7,0,13,2,6000,7800,7400,173,146,2755070,187,82,DM/M C,2,2,2,2,3,2,2,7,1,3,3,9,10,11,10,12,8,14,8,7,15,12,6,15,13,14,16,17,14,14,11,15,15,12,13,12,16,17,17,14,16,16,14,8,15,14,20,15,15,15,11,13,3,12,14,13,13,15,11,10,13,6,1,1,20,1,14,1,20,DM/M C,311,1,1,1,1,1,1,1,1,1,20,20,1,14,1,1,0,0,0,0,0,0,0,0,0,0,0,0,0,0,0,0,0,0,0,0,0,0,0,0,0,0,0,0,0,0,0,0,0,0,0,0,0,0,0,0,0,0,0,0,0,0,0,0,0,Sandro,£10.35m ,31.0,187.0,Midfielder - Defensive Midfield,right,Goiás Esporte Clube,26.0,1.0,1.0,1566.0,27.0,0.0,1.0,1649.0,27.0,1.0,2.0,2141.0,27.0,1.0,0.0,1629.0,18.0,1.0,0.0,1298.0,24.0,0.0,0.0,1190.0,20.0,3.0,0.0,1227.0,18.0,1.0,0.0,1328.0,26.0,0.0,1.0,1316.0,Premier League,8.0,0.0,0.0,590.0,nan,nan,nan,nan
19/6/2011,Samir Nasri,8428584,769,6/26/1987,23,22,2,6,0,7500,8000,8450,175,164,18254545,177,75,M/AM RLC,3,3,2,1,2,3,1,7,2,1,2,12,12,17,15,17,15,5,13,2,6,15,12,9,17,12,14,12,15,12,15,15,16,17,10,16,8,13,13,15,18,18,8,15,15,14,20,15,9,13,6,14,12,14,14,16,14,14,13,14,11,10,1,1,17,20,18,18,20,M/AM RLC,526,1,1,1,20,18,18,1,1,1,10,17,16,16,1,1,554051306496,0,0,0,0,0,0,0,0,0,0,1,0,0,0,0,0,0,0,0,1,0,0,0,0,0,0,0,0,0,0,0,0,1,0,0,0,0,0,0,1,0,0,0,0,0,0,0,0,Samir Nasri,£22.50m ,33.0,177.0,Midfielder - Attacking Midfield,right,Without Club,46.0,15.0,5.0,3416.0,46.0,6.0,9.0,3280.0,38.0,5.0,9.0,2472.0,46.0,11.0,12.0,3277.0,33.0,3.0,7.0,2100.0,13.0,2.0,3.0,619.0,31.0,3.0,3.0,2415.0,8.0,2.0,1.0,720.0,6.0,0.0,2.0,303.0,Premier League,9.0,2.0,0.0,594.0,nan,nan,nan,nan
19/6/2011,Sami Khedira,8723858,771,4/4/1987,24,20,1,14,5,7000,8200,7700,162,154,0,189,85,DM/M C,3,1,2,2,1,3,2,6,3,2,3,6,10,9,14,12,8,15,11,12,15,12,9,14,11,13,17,16,18,18,13,17,17,6,14,16,17,20,19,9,8,14,16,12,18,15,20,19,16,12,10,15,14,16,14,18,9,15,18,16,18,3,1,1,20,14,10,10,20,DM/M C,421,1,1,1,14,8,8,1,1,1,19,20,10,10,1,1,2147484256,0,0,0,0,0,1,1,0,0,1,0,0,0,0,0,0,0,0,0,0,0,0,0,0,0,0,0,0,0,0,0,1,0,0,0,0,0,0,0,0,0,0,0,0,0,0,0,0,Sami Khedira,£18.00m ,33.0,189.0,Midfielder - Central Midfield,right,Juventus FC,40.0,0.0,3.0,3076.0,42.0,4.0,3.0,2974.0,44.0,4.0,6.0,3249.0,18.0,1.0,1.0,1376.0,17.0,0.0,0.0,621.0,25.0,5.0,3.0,1952.0,46.0,5.0,3.0,3836.0,39.0,9.0,6.0,2877.0,17.0,2.0,0.0,977.0,LaLiga,18.0,0.0,1.0,978.0,nan,nan,nan,nan
19/6/2011,Salva Sevilla,1501062,796,3/18/1984,27,0,0,0,0,4250,6600,6600,140,132,888013,178,70,AM RC,1,2,2,1,2,1,1,3,3,2,2,14,12,13,10,15,13,7,12,5,7,16,12,6,17,7,13,9,14,13,17,15,14,16,12,16,8,14,11,13,14,12,10,8,15,13,20,13,12,12,8,13,5,13,11,13,12,12,14,12,13,6,1,1,15,20,16,12,20,AM RC,503,1,1,1,20,12,16,1,1,1,1,15,1,1,1,1,4194688,0,0,0,0,0,0,0,1,1,0,0,0,0,0,0,0,0,0,0,0,0,0,1,0,0,0,0,0,0,0,0,0,0,0,0,0,0,0,0,0,0,0,0,0,0,0,0,0,Salva Sevilla,£1.80m ,36.0,178.0,Midfielder - Central Midfield,right,RCD Mallorca,38.0,3.0,3.0,3025.0,26.0,2.0,2.0,1448.0,19.0,2.0,2.0,1225.0,34.0,5.0,5.0,2151.0,30.0,0.0,5.0,1488.0,19.0,1.0,1.0,706.0,7.0,0.0,0.0,348.0,37.0,4.0,0.0,2678.0,42.0,4.0,9.0,3664.0,LaLiga,36.0,5.0,4.0,2636.0,7.0,1.0,0.0,511.0
19/6/2011,Ryan Giggs,2018995,801,11/29/1973,37,64,12,1,0,7500,8500,8000,180,160,204179,180,69,M/AM LC,2,3,2,2,2,3,2,6,1,1,3,14,15,17,11,17,16,8,8,6,9,17,15,12,16,10,15,12,16,15,17,14,18,17,16,16,12,17,14,13,17,18,10,20,11,13,10,12,12,12,5,13,9,8,10,12,20,16,20,16,18,8,8,5,20,18,10,17,20,M/AM LC,414,1,1,6,18,17,10,1,8,1,8,20,16,5,5,1,51539626112,0,0,0,0,0,0,0,1,0,0,0,1,0,0,1,0,0,0,0,0,0,0,0,0,0,0,0,0,0,0,0,0,0,0,1,1,0,0,0,0,0,0,0,0,0,0,0,0,Ryan Giggs,£900Th. ,46.0,179.0,Midfielder - Left Midfield,left,Retired,38.0,4.0,14.0,2501.0,33.0,4.0,10.0,2079.0,32.0,5.0,6.0,1788.0,22.0,0.0,3.0,1272.0,nan,nan,nan,nan,nan,nan,nan,nan,nan,nan,nan,nan,nan,nan,nan,nan,nan,nan,nan,nan,Premier League,nan,nan,nan,nan,nan,nan,nan,nan
19/6/2011,Rui Sampaio,743487,788,5/29/1987,24,0,0,0,0,3000,5500,5500,127,110,189723,186,75,M/AM C,3,1,1,1,1,2,2,5,1,2,1,12,12,12,12,12,11,13,11,10,10,11,10,11,12,13,12,12,14,12,12,12,14,9,11,12,12,15,12,11,12,13,12,8,12,11,20,11,13,14,8,10,6,14,13,12,13,13,13,13,14,6,1,1,20,20,1,13,20,M/AM C,411,1,1,10,20,13,1,1,1,1,4,20,7,1,1,1,0,0,0,0,0,0,0,0,0,0,0,0,0,0,0,0,0,0,0,0,0,0,0,0,0,0,0,0,0,0,0,0,0,0,0,0,0,0,0,0,0,0,0,0,0,0,0,0,0,Rui Sampaio,£540Th. ,33.0,186.0,Midfielder - Central Midfield,right,SC Beira-Mar,35.0,1.0,0.0,2885.0,9.0,1.0,0.0,339.0,15.0,1.0,0.0,1178.0,12.0,1.0,0.0,965.0,33.0,2.0,0.0,2461.0,8.0,0.0,0.0,524.0,17.0,1.0,0.0,1400.0,14.0,0.0,0.0,547.0,1.0,0.0,0.0,90.0,Serie A,2.0,0.0,0.0,210.0,nan,nan,nan,nan
19/6/2011,Rudy Haddad,912228,769,2/5/1985,26,0,0,2,0,4511,5669,5647,136,125,386433,180,78,M/AM C,2,1,1,2,3,3,3,2,2,1,2,12,13,13,7,15,14,6,11,5,5,14,10,5,15,7,12,9,13,12,15,13,12,12,10,12,7,13,12,13,14,13,9,12,12,12,20,14,11,14,7,14,5,8,14,14,12,13,13,13,11,8,1,1,16,20,12,12,20,M/AM C,521,1,1,1,20,12,12,1,1,1,1,16,12,12,1,1,4194432,0,0,0,0,0,0,0,1,0,0,0,0,0,0,0,0,0,0,0,0,0,0,1,0,0,0,0,0,0,0,0,0,0,0,0,0,0,0,0,0,0,0,0,0,0,0,0,0,Rudy Haddad,£720Th. ,35.0,180.0,Midfielder - Attacking Midfield,right,Without Club,36.0,4.0,11.0,3069.0,13.0,0.0,0.0,621.0,22.0,2.0,2.0,1384.0,4.0,0.0,0.0,18.0,nan,nan,nan,nan,27.0,3.0,0.0,1763.0,24.0,3.0,3.0,1814.0,25.0,0.0,0.0,1841.0,nan,nan,nan,nan,Ligue 1,nan,nan,nan,nan,nan,nan,nan,nan
19/6/2011,Rüdiger Ziehl,6001924,771,10/26/1977,33,0,0,0,0,750,4250,4250,110,85,11733,184,79,DM/M C,1,1,2,3,3,2,1,1,2,3,2,6,8,7,7,7,6,11,13,6,12,11,6,12,6,13,10,13,13,14,6,13,13,7,16,8,11,15,16,9,9,8,11,5,13,9,20,13,12,14,12,15,8,13,5,10,14,11,10,15,14,14,14,13,16,1,14,1,16,DM/M C,311,1,1,1,1,1,1,12,1,14,20,16,1,1,1,13,768,0,0,0,0,0,0,0,0,1,1,0,0,0,0,0,0,0,0,0,0,0,0,0,0,0,0,0,0,0,0,0,0,0,0,0,0,0,0,0,0,0,0,0,0,0,0,0,0
19/6/2011,Ruben Pinto,55022438,788,4/24/1992,19,0,0,0,0,1568,4307,4307,150,90,206514,181,69,M/AM RC,3,3,1,3,1,3,2,9,1,1,1,10,11,11,9,11,9,7,9,6,7,11,10,6,11,9,12,10,12,12,12,12,10,12,10,12,9,10,11,11,11,9,9,8,12,11,20,8,8,13,7,11,14,12,9,19,13,14,15,7,12,19,1,1,20,17,17,13,20,M/AM RC,413,1,1,1,17,13,17,1,1,1,8,20,5,10,1,1,0,0,0,0,0,0,0,0,0,0,0,0,0,0,0,0,0,0,0,0,0,0,0,0,0,0,0,0,0,0,0,0,0,0,0,0,0,0,0,0,0,0,0,0,0,0,0,0,0,Rúben Pinto,£450Th. ,28.0,183.0,Midfielder - Defensive Midfield,right,MOL Fehérvár FC,nan,nan,nan,nan,0.0,0.0,0.0,0.0,5.0,0.0,0.0,233.0,34.0,4.0,4.0,2814.0,36.0,7.0,2.0,3118.0,46.0,3.0,2.0,3481.0,29.0,2.0,1.0,2301.0,30.0,4.0,1.0,2309.0,43.0,5.0,1.0,3461.0,Liga NOS,15.0,1.0,2.0,1188.0,0.0,0.0,0.0,0.0
19/6/2011,Rubén Pérez,67037324,796,4/26/1989,22,0,0,0,0,4550,6550,6550,164,132,238098,178,72,DM/M C,2,3,2,3,1,2,3,5,2,2,2,11,12,13,11,14,13,7,12,11,12,14,11,12,14,14,11,14,14,14,13,14,15,13,13,15,12,15,14,13,11,11,8,10,12,13,20,14,12,15,12,8,7,13,13,14,13,14,15,11,13,7,1,1,20,13,1,1,20,DM/M C,421,1,1,1,13,1,1,1,1,1,16,20,1,1,1,1,256,0,0,0,0,0,0,0,0,1,0,0,0,0,0,0,0,0,0,0,0,0,0,0,0,0,0,0,0,0,0,0,0,0,0,0,0,0,0,0,0,0,0,0,0,0,0,0,0,Rubén Pérez,£2.52m ,31.0,178.0,Midfielder - Defensive Midfield,right,CD Leganés,37.0,0.0,2.0,3168.0,10.0,0.0,0.0,722.0,30.0,1.0,0.0,2058.0,32.0,0.0,0.0,2721.0,22.0,0.0,0.0,1300.0,32.0,0.0,2.0,2509.0,32.0,0.0,1.0,2495.0,36.0,0.0,0.0,2895.0,32.0,0.0,0.0,2561.0,LaLiga,28.0,1.0,1.0,2376.0,8.0,0.0,0.0,720.0
19/6/2011,Ruben Micael,744496,788,8/19/1986,24,2,2,0,0,3500,6650,6650,143,133,1559332,175,73,AM C,1,1,3,3,1,3,1,1,3,3,2,13,13,12,11,14,13,8,13,7,9,14,13,9,14,12,13,13,14,13,15,14,14,14,12,15,9,13,13,12,13,8,6,12,14,11,20,10,7,14,7,13,9,12,12,13,15,15,16,16,16,5,1,1,15,20,10,10,20,AM C,501,1,1,1,20,10,10,1,1,1,5,15,5,5,1,1,0,0,0,0,0,0,0,0,0,0,0,0,0,0,0,0,0,0,0,0,0,0,0,0,0,0,0,0,0,0,0,0,0,0,0,0,0,0,0,0,0,0,0,0,0,0,0,0,0,Rúben Micael,£4.50m ,34.0,176.0,Midfielder - Defensive Midfield,right,CD Nacional,36.0,4.0,7.0,1872.0,34.0,0.0,1.0,2215.0,30.0,7.0,4.0,1698.0,27.0,1.0,3.0,2051.0,41.0,8.0,5.0,2846.0,28.0,3.0,4.0,2266.0,19.0,1.0,2.0,1290.0,13.0,1.0,1.0,969.0,30.0,0.0,4.0,1953.0,LaLiga,24.0,0.0,1.0,1941.0,5.0,0.0,0.0,412.0
19/6/2011,Rúben Amorim,8872115,788,1/27/1985,26,1,0,10,0,3500,6450,6500,138,129,3162055,178,72,DM/M RC,2,1,2,2,1,2,2,3,3,2,1,11,11,11,9,13,11,12,12,13,14,14,11,14,14,12,12,13,14,14,13,15,14,7,13,11,13,17,15,12,14,13,13,8,11,12,20,13,12,15,7,11,10,13,12,12,13,13,14,14,15,6,15,7,20,4,15,1,20,DM/M RC,423,1,1,1,4,1,1,1,1,15,17,20,1,11,1,7,4294967360,0,0,0,0,0,0,1,0,0,0,0,0,0,0,0,0,0,0,0,0,0,0,0,0,0,0,0,0,0,0,0,0,1,0,0,0,0,0,0,0,0,0,0,0,0,0,0,0,Rúben Amorim,£3.78m ,35.0,178.0,Midfielder - Central Midfield,right,Retired,18.0,0.0,0.0,1063.0,24.0,0.0,2.0,1213.0,36.0,5.0,3.0,2654.0,37.0,0.0,6.0,1929.0,14.0,0.0,0.0,517.0,3.0,0.0,0.0,222.0,nan,nan,nan,nan,nan,nan,nan,nan,nan,nan,nan,nan,Liga NOS,nan,nan,nan,nan,nan,nan,nan,nan
19/6/2011,Ross Barkley,28058224,765,12/5/1993,17,0,0,0,0,3000,5750,5750,163,109,3549579,189,77,M C,2,3,1,2,2,2,1,7,3,1,3,4,7,10,8,11,3,11,12,1,10,12,4,10,12,17,9,10,11,9,12,9,14,5,9,11,8,10,13,12,10,10,11,14,13,12,20,15,12,15,3,14,6,8,7,15,15,12,14,11,9,9,1,1,20,13,14,13,20,M C,401,1,1,1,13,10,12,1,1,1,13,20,13,14,1,1,277025915072,0,0,0,0,0,0,1,1,0,0,0,0,0,0,0,0,0,0,0,1,0,0,0,0,0,0,0,0,0,0,0,1,0,0,0,0,0,0,1,0,0,0,0,0,0,0,0,0,Ross Barkley,£4.05m ,26.0,185.0,Midfielder - Central Midfield,right,Aston Villa,3.0,1.0,0.0,270.0,23.0,3.0,5.0,1644.0,37.0,7.0,1.0,2658.0,38.0,7.0,3.0,2617.0,36.0,2.0,3.0,2481.0,48.0,12.0,11.0,3914.0,39.0,6.0,9.0,3150.0,5.0,0.0,0.0,271.0,48.0,5.0,6.0,2725.0,Premier League,31.0,5.0,5.0,1700.0,6.0,3.0,0.0,400.0
19/6/2011,Roman Neustädter,91002404,771,2/18/1988,23,0,0,2,1,3750,6300,6300,137,116,264449,190,83,D/DM/M C,1,3,3,3,2,3,3,4,2,3,3,5,8,11,6,7,5,13,6,14,16,8,5,17,9,15,13,17,7,10,10,7,13,5,12,8,15,16,18,8,13,14,17,10,11,14,20,18,15,11,5,11,5,14,13,1,11,9,11,11,10,8,16,1,18,1,1,1,18,D/DM/M C,331,1,1,1,1,1,1,16,1,1,20,18,1,1,1,1,0,0,0,0,0,0,0,0,0,0,0,0,0,0,0,0,0,0,0,0,0,0,0,0,0,0,0,0,0,0,0,0,0,0,0,0,0,0,0,0,0,0,0,0,0,0,0,0,0,Roman Neustädter,£3.15m ,32.0,188.0,Midfielder - Defensive Midfield,right,Dynamo Moscow,28.0,1.0,1.0,2058.0,38.0,0.0,2.0,3429.0,41.0,4.0,2.0,3503.0,44.0,2.0,5.0,3553.0,38.0,2.0,0.0,3192.0,38.0,0.0,1.0,3034.0,33.0,0.0,1.0,2019.0,44.0,5.0,0.0,3884.0,31.0,2.0,0.0,2685.0,Bundesliga,21.0,0.0,1.0,1742.0,2.0,0.0,0.0,102.0
19/6/2011,Romain Pitau,3501348,769,8/8/1977,33,0,0,0,0,2100,6100,6100,140,136,277206,178,73,DM C,2,1,2,2,1,1,2,2,1,2,3,13,10,8,8,12,11,10,13,7,10,15,7,14,12,12,16,14,14,14,12,13,14,7,14,7,15,18,16,13,11,13,9,6,15,14,20,18,13,15,12,14,5,8,12,14,14,15,15,14,12,8,1,1,15,1,1,1,15,DM C,301,1,1,1,1,1,1,1,1,1,20,15,1,1,1,1,0,0,0,0,0,0,0,0,0,0,0,0,0,0,0,0,0,0,0,0,0,0,0,0,0,0,0,0,0,0,0,0,0,0,0,0,0,0,0,0,0,0,0,0,0,0,0,0,0,Romain Pitau,£540Th. ,43.0,178.0,Midfielder - Defensive Midfield,right,Retired,34.0,0.0,2.0,2438.0,16.0,0.0,1.0,707.0,21.0,0.0,2.0,1170.0,nan,nan,nan,nan,nan,nan,nan,nan,nan,nan,nan,nan,nan,nan,nan,nan,nan,nan,nan,nan,nan,nan,nan,nan,Ligue 1,nan,nan,nan,nan,nan,nan,nan,nan
19/6/2011,Rodney Strasser,43037061,43,3/30/1990,21,3,0,0,0,1500,5264,5400,141,117,96929,178,80,DM/M RC,2,3,2,3,1,2,2,3,2,3,1,4,6,7,8,9,5,12,9,15,14,11,8,14,11,17,12,14,13,12,12,12,16,4,6,9,15,14,14,13,13,15,10,7,15,14,20,13,15,13,16,7,8,12,17,14,15,12,14,15,16,4,1,1,20,1,15,12,20,DM/M RC,423,1,1,1,1,1,1,1,1,1,17,20,12,15,1,1,0,0,0,0,0,0,0,0,0,0,0,0,0,0,0,0,0,0,0,0,0,0,0,0,0,0,0,0,0,0,0,0,0,0,0,0,0,0,0,0,0,0,0,0,0,0,0,0,0,Rodney Strasser,£1.80m ,30.0,181.0,Midfielder - Defensive Midfield,right,Turun Palloseura,8.0,1.0,0.0,463.0,15.0,1.0,0.0,970.0,4.0,0.0,0.0,166.0,22.0,0.0,0.0,1684.0,2.0,0.0,0.0,61.0,28.0,1.0,1.0,2259.0,13.0,0.0,0.0,911.0,nan,nan,nan,nan,14.0,0.0,1.0,1106.0,Serie A,9.0,0.0,0.0,515.0,nan,nan,nan,nan
19/6/2011,Roberto Trashorras,6701099,796,2/28/1981,30,0,0,0,0,4400,6400,6400,128,128,1154926,177,70,AM C,3,3,2,2,1,3,3,2,2,1,1,14,13,14,12,16,16,10,14,7,3,17,16,4,17,10,13,7,9,11,18,14,12,18,14,13,7,9,7,12,10,10,7,14,11,10,20,13,8,10,6,10,12,12,5,16,6,12,10,9,12,12,1,1,15,20,10,14,20,AM C,501,1,1,1,20,14,10,1,1,1,1,15,7,5,1,1,4194688,0,0,0,0,0,0,0,1,1,0,0,0,0,0,0,0,0,0,0,0,0,0,1,0,0,0,0,0,0,0,0,0,0,0,0,0,0,0,0,0,0,0,0,0,0,0,0,0,Roberto Trashorras,£1.62m ,39.0,177.0,Midfielder - Central Midfield,right,Retired,38.0,5.0,0.0,2619.0,30.0,2.0,2.0,1755.0,37.0,1.0,5.0,2859.0,38.0,1.0,8.0,3256.0,33.0,1.0,4.0,2887.0,39.0,2.0,9.0,3323.0,35.0,1.0,1.0,2781.0,7.0,0.0,0.0,458.0,nan,nan,nan,nan,LaLiga,nan,nan,nan,nan,nan,nan,nan,nan
19/6/2011,Roberto Sousa,316726,1651,1/18/1985,26,0,0,18,0,3000,5750,5900,126,118,382880,177,76,DM/M C,3,2,1,2,3,1,2,1,1,3,2,10,10,10,10,14,10,12,10,12,15,14,10,13,12,13,14,8,13,15,12,5,15,11,12,6,15,15,16,12,13,13,10,5,12,12,20,16,12,11,12,13,12,12,14,14,14,14,15,14,14,6,1,1,16,1,1,1,16,DM/M C,311,1,1,1,1,1,1,1,1,1,20,16,1,1,1,1,32832,0,0,0,0,0,0,1,0,0,0,0,0,0,0,0,1,0,0,0,0,0,0,0,0,0,0,0,0,0,0,0,0,0,0,0,0,0,0,0,0,0,0,0,0,0,0,0,0,Roberto Sousa,£900Th. ,35.0,177.0,Midfielder - Defensive Midfield,right,Retired,30.0,0.0,0.0,2295.0,35.0,2.0,3.0,3102.0,3.0,0.0,0.0,218.0,nan,nan,nan,nan,17.0,0.0,1.0,1417.0,nan,nan,nan,nan,nan,nan,nan,nan,nan,nan,nan,nan,nan,nan,nan,nan,Liga NOS,nan,nan,nan,nan,nan,nan,nan,nan
19/6/2011,Roberto Guana,3801715,776,1/21/1981,30,0,0,1,0,3750,6250,6250,133,125,384266,178,72,DM/M C,1,2,2,3,2,2,3,2,3,3,3,7,10,9,9,12,13,14,10,8,14,13,11,11,14,14,12,14,15,13,15,17,12,15,7,14,12,14,15,12,13,14,11,5,12,10,20,15,14,17,9,12,8,14,14,15,15,18,14,16,16,1,1,1,20,1,1,1,20,DM/M C,421,1,1,1,1,1,1,1,1,1,19,20,1,1,1,1,0,0,0,0,0,0,0,0,0,0,0,0,0,0,0,0,0,0,0,0,0,0,0,0,0,0,0,0,0,0,0,0,0,0,0,0,0,0,0,0,0,0,0,0,0,0,0,0,0,Roberto Guana,£720Th. ,39.0,178.0,Midfielder - Central Midfield,right,Retired,21.0,0.0,1.0,1450.0,33.0,1.0,0.0,2593.0,24.0,0.0,2.0,1740.0,8.0,0.0,0.0,598.0,8.0,0.0,0.0,614.0,nan,nan,nan,nan,nan,nan,nan,nan,nan,nan,nan,nan,nan,nan,nan,nan,Serie A,nan,nan,nan,nan,nan,nan,nan,nan
19/6/2011,Roberto Firmino,19068857,1651,10/2/1991,19,0,0,0,0,4150,6050,6450,168,130,5809513,180,76,M/AM C,3,2,1,3,1,1,2,6,2,1,1,9,12,16,15,17,8,13,10,5,6,14,9,7,17,8,14,9,12,10,15,11,12,17,5,14,6,11,13,13,17,8,9,14,12,13,20,10,6,11,2,7,10,10,7,12,7,10,13,8,11,7,1,1,18,20,1,1,20,M/AM C,521,1,1,1,20,1,1,1,1,1,1,18,1,1,1,1,70403373401088,0,0,0,0,0,0,0,0,0,0,1,0,0,0,0,0,0,0,0,0,1,0,0,0,0,0,0,0,1,0,0,0,0,0,0,1,0,0,0,0,0,0,0,0,0,0,1,0,Roberto Firmino,£6.30m ,29.0,181.0,Forward - Centre-Forward,right,Liverpool FC,11.0,3.0,0.0,467.0,33.0,7.0,4.0,2490.0,36.0,7.0,4.0,2710.0,37.0,22.0,16.0,3297.0,36.0,10.0,12.0,3201.0,49.0,11.0,11.0,3326.0,41.0,12.0,11.0,3463.0,54.0,27.0,17.0,4188.0,48.0,16.0,8.0,3406.0,Bundesliga,52.0,12.0,13.0,3921.0,8.0,1.0,2.0,638.0
19/6/2011,Robert Tesche,35006190,771,5/27/1987,24,0,0,0,0,4500,5750,6250,140,115,105191,180,73,DM/M RC,2,3,2,2,1,1,3,5,1,2,1,10,11,13,10,14,10,10,13,7,11,12,10,14,14,13,14,5,14,13,11,14,10,4,12,14,14,15,15,14,14,14,9,5,17,14,20,12,4,10,8,10,5,10,14,9,5,7,12,9,14,12,1,11,20,11,16,1,20,DM/M RC,423,1,1,1,10,1,11,1,1,1,18,20,1,16,1,11,0,0,0,0,0,0,0,0,0,0,0,0,0,0,0,0,0,0,0,0,0,0,0,0,0,0,0,0,0,0,0,0,0,0,0,0,0,0,0,0,0,0,0,0,0,0,0,0,0,Robert Tesche,£1.13m ,33.0,182.0,Midfielder - Central Midfield,right,VfL Bochum,12.0,0.0,0.0,537.0,26.0,2.0,1.0,1245.0,18.0,0.0,1.0,1112.0,21.0,2.0,1.0,1330.0,37.0,4.0,5.0,2903.0,25.0,1.0,1.0,1615.0,26.0,0.0,0.0,1852.0,19.0,2.0,0.0,1188.0,31.0,3.0,2.0,2440.0,Bundesliga,26.0,1.0,1.0,1891.0,6.0,0.0,0.0,451.0
19/6/2011,Robert Gucher,28018443,755,2/20/1991,20,0,0,0,0,2047,4746,4545,148,105,187155,183,80,DM/M C,3,3,3,1,1,3,2,1,1,1,1,7,7,10,6,12,10,8,11,1,12,13,9,11,12,11,12,12,10,9,14,9,10,8,8,11,11,14,14,11,13,11,9,5,14,12,20,14,14,9,12,10,10,10,15,4,13,11,9,11,8,12,1,1,20,1,8,1,20,DM/M C,311,1,1,1,1,1,1,1,1,1,20,20,1,8,1,1,0,0,0,0,0,0,0,0,0,0,0,0,0,0,0,0,0,0,0,0,0,0,0,0,0,0,0,0,0,0,0,0,0,0,0,0,0,0,0,0,0,0,0,0,0,0,0,0,0,Robert Tesche,£1.13m ,33.0,182.0,Midfielder - Central Midfield,right,VfL Bochum,12.0,0.0,0.0,537.0,26.0,2.0,1.0,1245.0,18.0,0.0,1.0,1112.0,21.0,2.0,1.0,1330.0,37.0,4.0,5.0,2903.0,25.0,1.0,1.0,1615.0,26.0,0.0,0.0,1852.0,19.0,2.0,0.0,1188.0,31.0,3.0,2.0,2440.0,Bundesliga,26.0,1.0,1.0,1891.0,6.0,0.0,0.0,451.0
19/6/2011,Rio Mavuba,918875,769,4/8/1984,27,6,0,19,1,6750,6659,6650,150,148,1913881,172,70,DM/M C,3,3,1,1,1,1,1,4,2,3,2,7,12,11,5,13,7,6,9,9,12,14,9,15,13,11,16,14,15,15,12,14,16,7,17,8,15,18,17,15,15,12,6,10,16,14,20,19,12,16,11,15,5,10,12,16,14,13,15,17,17,5,1,1,16,10,1,1,16,DM/M C,311,1,1,1,10,1,1,1,1,1,20,16,1,1,1,1,2148008192,0,0,0,0,0,0,0,0,1,0,0,0,0,0,0,0,0,0,0,1,0,0,0,0,0,0,0,0,0,0,0,1,0,0,0,0,0,0,0,0,0,0,0,0,0,0,0,0,Rio Mavuba,£8.10m ,36.0,172.0,Midfielder - Defensive Midfield,right,FCE Merignac-Arlac,54.0,1.0,5.0,4510.0,48.0,1.0,2.0,4169.0,26.0,0.0,0.0,2142.0,36.0,1.0,2.0,3020.0,40.0,1.0,0.0,3421.0,37.0,0.0,0.0,2913.0,20.0,0.0,0.0,1251.0,14.0,0.0,0.0,1164.0,nan,nan,nan,nan,Ligue 1,nan,nan,nan,nan,nan,nan,nan,nan
19/6/2011,Rinaldo Cruzado,5290503,1656,9/21/1984,26,23,0,0,0,4500,6252,6252,155,132,513543,180,77,M/AM LC,2,1,3,3,1,3,2,1,1,3,3,16,13,12,8,15,16,13,16,15,14,17,17,13,17,13,12,12,12,13,15,14,9,11,12,13,13,15,14,12,14,15,14,20,13,12,6,13,15,14,8,14,7,10,12,12,10,9,12,10,13,8,1,1,20,20,1,18,20,M/AM LC,414,1,1,1,20,14,1,1,1,1,1,20,18,1,1,1,175921860444416,0,0,0,0,0,0,0,0,1,0,0,0,0,0,0,0,0,0,0,0,0,0,0,0,0,0,0,0,0,0,0,0,0,0,0,0,0,0,0,0,0,0,0,0,0,1,0,1,Rinaldo Cruzado,£900Th. ,36.0,180.0,Midfielder - Defensive Midfield,left,Club Alianza Lima,13.0,4.0,1.0,1148.0,22.0,0.0,2.0,1244.0,22.0,3.0,3.0,1306.0,25.0,2.0,3.0,1298.0,41.0,6.0,10.0,3230.0,11.0,4.0,0.0,711.0,28.0,2.0,2.0,1955.0,45.0,6.0,4.0,3785.0,33.0,1.0,4.0,2140.0,Serie A,10.0,0.0,1.0,460.0,nan,nan,nan,nan
19/6/2011,Richard,19074791,1651,3/20/1989,22,0,0,0,0,896,4769,4476,118,106,7361,177,68,AM C,1,1,2,3,1,2,2,1,2,2,1,12,13,12,13,13,11,7,14,6,8,11,12,11,12,12,13,14,12,11,11,11,13,13,10,14,10,10,13,12,13,11,10,20,12,13,5,11,12,11,8,12,10,12,13,14,12,13,13,11,11,8,10,12,15,20,1,14,20,AM C,501,1,1,5,20,10,1,1,10,1,10,15,14,1,12,1,2251799813685248,0,0,0,0,0,0,0,0,0,0,0,0,0,0,0,0,0,0,0,0,0,0,0,0,0,0,0,0,0,0,0,0,0,0,0,0,0,0,0,0,0,0,0,0,0,0,0,0,Richard,£900Th. ,31.0,177.0,Midfielder - Central Midfield,left,Without Club,37.0,6.0,0.0,2392.0,37.0,0.0,2.0,2842.0,30.0,13.0,0.0,2558.0,35.0,8.0,2.0,2941.0,44.0,3.0,1.0,3438.0,43.0,13.0,0.0,3325.0,31.0,7.0,1.0,2692.0,41.0,7.0,5.0,3054.0,27.0,5.0,2.0,1950.0,Liga NOS,36.0,3.0,0.0,2907.0,nan,nan,nan,nan
19/6/2011,Richard Boateng,13107264,21,7/10/1992,18,0,0,0,0,2267,4759,4534,130,95,128899,162,62,M C,2,1,3,1,3,3,2,7,3,1,3,10,6,7,9,14,10,4,13,5,14,14,10,11,14,9,9,7,8,8,11,11,10,12,11,12,9,8,12,14,13,14,3,5,14,13,20,11,5,9,17,10,7,10,12,17,12,14,8,12,13,12,1,1,20,1,1,1,20,M C,401,1,1,1,1,1,1,1,1,1,1,20,1,1,1,1,0,0,0,0,0,0,0,0,0,0,0,0,0,0,0,0,0,0,0,0,0,0,0,0,0,0,0,0,0,0,0,0,0,0,0,0,0,0,0,0,0,0,0,0,0,0,0,0,0,Richard Boateng,- ,28.0,180.0,Midfielder - Central Midfield,right,AD Alcorcón,nan,nan,nan,nan,0.0,0.0,0.0,0.0,37.0,1.0,1.0,2537.0,32.0,2.0,0.0,2463.0,34.0,5.0,2.0,2507.0,25.0,6.0,0.0,1640.0,10.0,2.0,0.0,830.0,31.0,14.0,0.0,2458.0,26.0,0.0,0.0,1405.0,LaLiga,36.0,5.0,5.0,2764.0,4.0,0.0,0.0,325.0
19/6/2011,Riccardo Montolivo,7982726,776,1/18/1985,26,24,0,20,3,6650,7750,7350,156,147,1685854,181,74,DM/M C,1,1,1,1,1,1,1,1,1,1,1,12,14,15,9,18,10,5,13,13,7,18,15,8,18,12,15,11,15,16,15,13,14,15,11,13,9,16,15,13,16,11,11,10,15,13,20,15,11,15,10,12,7,12,11,14,13,14,14,15,15,5,1,1,20,15,1,8,20,DM/M C,421,1,1,1,15,8,1,1,1,1,17,20,8,1,1,1,17626545783936,0,0,0,0,0,0,0,1,0,0,1,0,0,0,0,0,0,0,0,0,0,0,0,0,0,0,0,0,0,0,0,0,0,0,0,1,0,0,0,0,0,0,0,0,1,0,0,0,Riccardo Montolivo,£11.70m ,35.0,181.0,Midfielder - Defensive Midfield,right,Retired,29.0,2.0,3.0,2528.0,33.0,4.0,3.0,2872.0,39.0,4.0,4.0,3362.0,37.0,3.0,7.0,3063.0,12.0,0.0,0.0,810.0,35.0,0.0,2.0,2936.0,10.0,0.0,0.0,847.0,26.0,3.0,2.0,1665.0,0.0,0.0,0.0,0.0,Serie A,nan,nan,nan,nan,nan,nan,nan,nan
19/6/2011,Ricardo,67009529,796,2/8/1983,28,0,0,0,0,3750,5850,5900,130,118,136247,185,68,M C,3,1,2,2,3,1,3,2,1,2,1,13,12,11,7,15,14,4,12,7,7,16,11,8,15,9,13,8,13,12,15,14,11,10,11,10,11,13,11,10,10,13,10,12,9,11,20,13,10,11,8,9,10,12,13,12,12,10,16,14,14,5,1,1,20,11,8,1,20,M C,401,1,1,1,11,1,1,1,1,1,14,20,1,8,1,1,71827584,0,0,0,0,0,0,0,1,0,0,0,0,0,0,0,0,0,0,0,1,0,0,1,0,0,0,1,0,0,0,0,0,0,0,0,0,0,0,0,0,0,0,0,0,0,0,0,0,Ricardo,£270Th. ,48.0,187.0,Goalkeeper,left,Retired,38.0,46.0,14.0,3420.0,0.0,0.0,0.0,0.0,1.0,1.0,0.0,15.0,nan,nan,nan,nan,nan,nan,nan,nan,nan,nan,nan,nan,nan,nan,nan,nan,nan,nan,nan,nan,nan,nan,nan,nan,LaLiga,nan,nan,nan,nan,nan,nan,nan,nan
19/6/2011,Ricardo Alvarez,14009787,1649,4/12/1988,23,0,0,0,0,4100,5850,6400,160,128,4054265,188,73,M/AM LC,1,2,2,3,1,2,1,4,3,2,3,11,12,16,12,12,12,10,16,5,6,14,11,8,16,9,9,10,10,10,13,13,12,17,7,13,10,11,11,14,15,12,12,20,13,13,11,13,11,12,11,12,15,14,10,15,12,13,15,11,8,10,1,1,17,20,14,20,17,M/AM LC,524,1,1,7,15,20,14,1,1,1,1,17,10,9,1,1,562984313159936,0,0,0,0,0,0,0,0,1,0,0,0,0,0,0,0,0,0,0,0,0,0,0,0,0,0,0,0,0,0,0,0,0,0,0,1,0,0,0,0,0,0,0,0,0,0,0,0,Ricardo Álvarez,£10.35m ,32.0,188.0,Midfielder - Attacking Midfield,left,Club Atlético Vélez Sarsfield,38.0,5.0,7.0,1855.0,29.0,3.0,6.0,1532.0,30.0,7.0,3.0,1556.0,31.0,4.0,8.0,2230.0,17.0,1.0,0.0,725.0,13.0,1.0,1.0,809.0,23.0,3.0,1.0,1097.0,15.0,1.0,1.0,419.0,14.0,0.0,2.0,606.0,Serie A,7.0,2.0,1.0,309.0,nan,nan,nan,nan
19/6/2011,Rene Mihelic,64000038,795,7/5/1988,22,3,0,23,8,3900,6000,6000,138,115,466135,177,70,M/AM LC,3,1,2,3,1,1,2,1,2,2,3,13,13,11,10,12,14,10,12,8,12,15,13,6,14,17,12,11,12,13,11,12,16,12,13,12,2,14,16,15,12,13,11,20,12,14,5,12,11,12,8,16,9,13,14,14,18,13,16,15,15,9,1,1,20,20,1,20,20,M/AM LC,414,1,1,7,20,20,1,1,1,1,1,20,17,1,1,1,0,0,0,0,0,0,0,0,0,0,0,0,0,0,0,0,0,0,0,0,0,0,0,0,0,0,0,0,0,0,0,0,0,0,0,0,0,0,0,0,0,0,0,0,0,0,0,0,0,Rene Mihelic,£720Th. ,32.0,177.0,Midfielder - Attacking Midfield,right,NK Maribor,18.0,1.0,3.0,995.0,25.0,0.0,5.0,1605.0,19.0,1.0,0.0,1052.0,22.0,4.0,5.0,1447.0,19.0,2.0,5.0,1040.0,36.0,4.0,5.0,2571.0,28.0,5.0,2.0,1990.0,14.0,2.0,4.0,673.0,27.0,1.0,3.0,2019.0,Liga NOS,3.0,0.0,1.0,73.0,0.0,0.0,0.0,0.0
19/6/2011,Rene Krhin,64001295,795,5/21/1990,21,4,0,3,0,4000,5800,5650,149,120,265673,189,78,DM/M C,1,1,1,1,1,1,1,1,1,1,1,8,8,10,6,13,8,12,11,5,11,14,11,13,13,13,11,12,11,13,12,11,15,10,10,10,13,14,14,11,11,12,13,10,14,11,20,14,13,12,13,11,14,12,15,12,15,13,17,16,14,5,8,1,18,5,8,1,18,DM/M C,311,1,1,1,5,1,1,1,1,8,20,18,1,1,1,1,4294967488,0,0,0,0,0,0,1,1,0,0,0,0,0,0,0,0,0,0,0,0,0,0,0,0,0,0,0,0,0,0,0,0,1,0,0,0,0,0,0,0,0,0,0,0,0,0,0,0,Rene Krhin,£1.08m ,30.0,189.0,Midfielder - Central Midfield,right,Without Club,9.0,0.0,0.0,587.0,9.0,1.0,0.0,513.0,23.0,0.0,0.0,1476.0,28.0,0.0,0.0,2146.0,19.0,0.0,0.0,1328.0,25.0,0.0,0.0,1520.0,12.0,0.0,0.0,937.0,19.0,1.0,0.0,1328.0,21.0,1.0,0.0,1272.0,Serie A,10.0,0.0,0.0,341.0,nan,nan,nan,nan
19/6/2011,Renaud Cohade,8426944,769,9/29/1984,26,0,0,0,0,4600,5750,5750,135,128,418050,180,74,DM/M C,1,2,3,2,1,3,2,6,1,2,2,12,8,9,7,11,13,11,14,6,11,13,16,13,11,13,16,14,13,13,12,13,16,7,12,7,13,15,16,10,12,14,10,10,13,14,20,16,13,14,10,15,9,5,13,12,13,13,13,13,11,11,8,8,20,1,12,1,20,DM/M C,421,1,1,1,1,1,1,1,1,8,16,20,1,12,1,8,256,0,0,0,0,0,0,0,0,1,0,0,0,0,0,0,0,0,0,0,0,0,0,0,0,0,0,0,0,0,0,0,0,0,0,0,0,0,0,0,0,0,0,0,0,0,0,0,0,Renaud Cohade,£2.70m ,36.0,181.0,Midfielder - Central Midfield,right,Without Club,32.0,1.0,7.0,2556.0,40.0,7.0,5.0,3322.0,47.0,4.0,12.0,3266.0,39.0,2.0,1.0,2556.0,27.0,1.0,0.0,1584.0,26.0,0.0,4.0,1718.0,36.0,1.0,4.0,3043.0,41.0,1.0,3.0,3540.0,41.0,1.0,6.0,3472.0,Ligue 1,12.0,1.0,0.0,765.0,nan,nan,nan,nan
19/6/2011,Renan,8832886,1651,3/29/1985,26,0,0,0,0,2529,6250,6000,131,120,280881,181,74,DM/M C,3,3,3,1,1,3,3,2,3,1,3,4,7,7,6,12,4,12,10,4,14,12,10,14,11,15,13,16,12,13,10,13,17,4,15,8,15,16,15,11,12,14,11,7,16,10,20,15,15,14,13,16,3,10,11,14,11,15,13,12,11,9,10,1,18,1,1,1,18,DM/M C,311,1,5,1,1,1,1,10,1,1,20,18,1,1,1,1,8589967424,0,0,0,0,0,0,1,0,0,0,0,0,0,0,0,1,0,0,0,0,0,0,0,0,0,0,0,0,0,0,0,0,0,1,0,0,0,0,0,0,0,0,0,0,0,0,0,0
19/6/2011,Rémy Cabella,34008670,769,3/8/1990,21,0,0,5,1,1350,2750,2750,154,110,38337,171,62,M/AM LC,1,1,3,3,3,1,3,8,1,3,3,10,10,14,8,14,10,6,11,7,1,11,8,2,16,5,10,7,14,14,13,13,14,13,6,13,5,9,12,16,15,8,5,20,8,15,5,12,5,14,5,16,13,8,12,14,14,13,12,15,15,5,1,1,18,20,10,16,20,M/AM LC,524,1,1,10,20,16,10,1,1,1,1,18,16,10,1,1,2251799813685248,0,0,0,0,0,0,0,0,0,0,0,0,0,0,0,0,0,0,0,0,0,0,0,0,0,0,0,0,0,0,0,0,0,0,0,0,0,0,0,0,0,0,0,0,0,0,0,0,Rémy Cabella,£2.70m ,30.0,171.0,Midfielder - Attacking Midfield,right,FK Krasnodar,18.0,3.0,0.0,790.0,34.0,6.0,2.0,1758.0,41.0,8.0,8.0,3133.0,41.0,14.0,8.0,3535.0,34.0,1.0,2.0,2173.0,45.0,6.0,3.0,3194.0,32.0,6.0,5.0,1853.0,31.0,8.0,7.0,2415.0,37.0,10.0,5.0,3239.0,Ligue 1,12.0,2.0,1.0,556.0,10.0,6.0,2.0,714.0
19/6/2011,Recio,67138565,796,1/11/1991,20,0,0,1,0,3750,5900,5900,142,120,1242458,184,75,DM/M C,3,3,1,2,1,2,2,5,3,2,2,7,10,9,9,12,9,12,9,9,12,14,4,14,12,13,15,13,13,13,13,13,12,7,9,10,13,13,12,12,12,10,9,7,12,13,20,14,12,10,7,12,7,12,12,15,11,12,11,11,13,8,1,1,20,1,1,1,20,DM/M C,421,1,1,1,1,1,1,1,1,1,18,20,1,1,1,1,96,0,0,0,0,0,1,1,0,0,0,0,0,0,0,0,0,0,0,0,0,0,0,0,0,0,0,0,0,0,0,0,0,0,0,0,0,0,0,0,0,0,0,0,0,0,0,0,0,Recio,£1.80m ,29.0,183.0,Midfielder - Central Midfield,right,SD Eibar,25.0,2.0,2.0,1778.0,8.0,0.0,0.0,318.0,22.0,2.0,0.0,1616.0,32.0,2.0,0.0,2473.0,36.0,3.0,3.0,1932.0,34.0,0.0,5.0,2840.0,18.0,3.0,2.0,1358.0,23.0,2.0,2.0,1932.0,22.0,0.0,0.0,1647.0,LaLiga,26.0,0.0,0.0,1601.0,4.0,0.0,0.0,175.0
19/6/2011,Raúl Meireles,734369,788,3/17/1983,28,46,8,26,1,6750,7200,7300,163,150,4727273,179,65,M C,3,3,3,3,2,1,2,8,1,2,3,14,14,11,13,14,14,12,16,11,13,15,12,13,14,10,15,9,15,16,15,13,15,13,12,14,15,14,15,12,14,12,12,12,14,12,20,12,12,12,10,14,10,14,15,15,12,13,12,12,11,9,5,1,20,14,11,5,20,M C,401,1,1,1,14,1,1,5,1,1,13,20,5,11,1,1,140737492549896,0,0,0,1,0,0,0,0,1,0,0,0,0,0,0,0,0,0,0,0,0,0,1,0,0,0,0,0,0,0,0,0,0,0,0,0,0,0,0,0,0,0,0,0,0,0,0,1,Raúl Meireles,£13.50m ,37.0,179.0,Midfielder - Central Midfield,both,Retired,42.0,5.0,5.0,3249.0,48.0,6.0,7.0,3229.0,36.0,3.0,2.0,2806.0,24.0,2.0,4.0,1755.0,27.0,2.0,4.0,1663.0,21.0,1.0,2.0,1001.0,nan,nan,nan,nan,nan,nan,nan,nan,nan,nan,nan,nan,Premier League,nan,nan,nan,nan,nan,nan,nan,nan
19/6/2011,Raúl García,1502117,796,7/11/1986,24,0,0,1,0,4750,6750,6750,149,137,572181,183,81,M C,2,3,2,1,1,2,1,3,2,1,3,15,12,11,12,15,13,13,15,10,12,13,13,12,13,14,13,15,13,13,12,14,14,13,12,11,13,14,14,11,12,14,12,12,16,13,20,14,14,13,14,12,11,13,15,16,15,10,14,15,13,9,1,1,20,15,1,1,20,M C,401,1,1,4,15,1,1,1,1,1,15,20,1,1,1,1,2147484160,0,0,0,0,0,0,0,0,0,1,0,0,0,0,0,0,0,0,0,0,0,0,0,0,0,0,0,0,0,0,0,1,0,0,0,0,0,0,0,0,0,0,0,0,0,0,0,0,Raúl García,£4.50m ,34.0,184.0,Forward - Centre-Forward,right,Athletic Bilbao,41.0,1.0,6.0,2214.0,37.0,11.0,7.0,2643.0,47.0,9.0,4.0,2360.0,53.0,17.0,6.0,3111.0,47.0,10.0,3.0,2763.0,42.0,11.0,9.0,3211.0,46.0,14.0,9.0,3738.0,48.0,14.0,8.0,3564.0,34.0,9.0,4.0,2466.0,LaLiga,42.0,15.0,2.0,3494.0,6.0,0.0,0.0,523.0
19/6/2011,Raúl Baena,1510564,796,3/2/1989,22,0,0,0,0,4400,6900,6900,145,140,822582,180,73,DM/M/AM C,3,1,2,3,2,3,1,7,1,1,3,9,9,11,8,14,10,10,12,6,12,14,11,13,13,9,13,14,14,15,12,14,11,10,11,12,14,15,16,14,13,12,10,12,11,13,20,14,12,13,7,10,12,12,12,7,5,12,9,5,8,18,1,1,19,16,1,1,19,DM/M/AM C,321,1,1,1,16,1,1,1,1,1,20,19,1,1,1,1,0,0,0,0,0,0,0,0,0,0,0,0,0,0,0,0,0,0,0,0,0,0,0,0,0,0,0,0,0,0,0,0,0,0,0,0,0,0,0,0,0,0,0,0,0,0,0,0,0,Raúl Baena,£2.16m ,31.0,181.0,Midfielder - Defensive Midfield,right,Without Club,18.0,0.0,0.0,1373.0,35.0,1.0,2.0,2325.0,20.0,1.0,1.0,1090.0,23.0,0.0,0.0,1475.0,30.0,2.0,0.0,2525.0,26.0,1.0,1.0,2023.0,19.0,1.0,0.0,1139.0,23.0,0.0,1.0,1284.0,24.0,1.0,1.0,1627.0,LaLiga,19.0,0.0,0.0,1100.0,nan,nan,nan,nan
19/6/2011,Ramires,2114490,1651,3/24/1987,24,25,2,0,0,6500,8150,7850,168,156,36363636,178,67,M RC,2,3,3,1,3,3,1,1,1,1,2,10,11,13,11,13,7,12,13,10,13,14,12,14,13,13,13,15,14,15,13,14,16,12,13,16,14,16,18,17,15,10,10,9,16,16,20,18,11,18,10,13,9,16,13,14,16,15,18,15,16,8,11,11,20,12,17,5,20,M RC,403,1,1,1,12,1,1,1,1,11,14,20,5,17,1,11,2147524720,0,0,0,0,1,1,1,0,0,0,0,0,0,1,0,1,0,0,0,0,0,0,0,0,0,0,0,0,0,0,0,1,0,0,0,0,0,0,0,0,0,0,0,0,0,0,0,0,Ramires,£27.00m ,33.0,179.0,Midfielder - Central Midfield,right,Sociedade Esportiva Palmeiras,41.0,2.0,0.0,2968.0,47.0,12.0,7.0,3861.0,62.0,9.0,8.0,4739.0,46.0,4.0,5.0,3746.0,34.0,4.0,4.0,1757.0,59.0,8.0,8.0,4246.0,34.0,12.0,4.0,3033.0,1.0,0.0,2.0,84.0,6.0,0.0,0.0,159.0,Premier League,30.0,1.0,0.0,1277.0,nan,nan,nan,nan
19/6/2011,Rafael van der Vaart,850015,784,2/11/1983,28,90,17,0,0,7500,8000,7950,163,160,8333794,176,74,M/AM RC,1,3,1,2,1,2,1,8,2,2,2,17,15,14,14,16,17,6,19,4,5,17,18,8,17,11,16,13,16,13,16,16,15,16,15,18,11,14,15,13,14,12,7,20,9,11,13,15,10,14,10,14,14,10,16,18,6,17,12,10,12,16,1,1,18,20,15,12,20,M/AM RC,523,1,1,9,20,12,15,1,1,1,1,18,7,15,1,1,569083166984,0,0,0,1,0,0,0,0,1,0,0,0,0,0,0,0,0,0,0,0,0,0,0,0,0,0,0,0,0,0,0,1,0,0,1,0,0,0,0,1,0,0,0,0,0,0,0,0,Rafael van der Vaart,£22.05m ,37.0,176.0,Midfielder - Attacking Midfield,left,Retired,36.0,15.0,10.0,2719.0,39.0,13.0,8.0,2787.0,29.0,5.0,10.0,2374.0,32.0,8.0,10.0,2572.0,27.0,5.0,3.0,1906.0,9.0,0.0,1.0,298.0,18.0,2.0,2.0,826.0,8.0,3.0,3.0,501.0,6.0,1.0,0.0,235.0,Premier League,nan,nan,nan,nan,nan,nan,nan,nan
19/6/2011,Rafael Miranda,8827957,1651,8/11/1984,26,0,0,0,0,3000,6400,6000,126,120,429632,176,62,DM C,1,1,2,3,3,3,2,2,3,2,2,7,7,9,6,12,7,10,10,9,12,12,10,13,11,12,14,13,17,15,12,15,12,6,15,10,15,16,13,10,11,12,13,15,11,8,20,12,11,16,8,12,15,9,12,13,13,6,14,14,5,3,10,1,15,1,1,1,15,DM C,301,1,1,1,1,1,1,10,1,1,20,15,1,1,1,1,32768,0,0,0,0,0,0,0,0,0,0,0,0,0,0,0,1,0,0,0,0,0,0,0,0,0,0,0,0,0,0,0,0,0,0,0,0,0,0,0,0,0,0,0,0,0,0,0,0,Rafael Miranda,£1.17m ,36.0,179.0,Midfielder - Defensive Midfield,right,Retired,37.0,0.0,2.0,2853.0,36.0,1.0,3.0,3144.0,65.0,4.0,3.0,5511.0,32.0,1.0,1.0,2684.0,26.0,2.0,2.0,1946.0,nan,nan,nan,nan,22.0,2.0,1.0,1807.0,33.0,0.0,0.0,2087.0,nan,nan,nan,nan,Liga NOS,nan,nan,nan,nan,nan,nan,nan,nan
19/6/2011,Rafael Leão,28065671,1651,4/6/1993,18,0,0,0,0,1251,2750,2750,127,63,37091,176,64,DM C,1,2,1,2,2,3,3,6,1,2,3,8,6,7,10,12,3,8,8,3,10,12,8,12,12,5,8,9,12,5,9,7,6,5,11,4,8,9,9,9,8,8,5,10,12,8,20,6,2,10,3,10,7,8,13,7,8,5,5,10,14,2,1,1,15,1,1,1,15,DM C,301,1,1,8,1,1,1,1,1,1,20,15,1,1,1,1,0,0,0,0,0,0,0,0,0,0,0,0,0,0,0,0,0,0,0,0,0,0,0,0,0,0,0,0,0,0,0,0,0,0,0,0,0,0,0,0,0,0,0,0,0,0,0,0,0
19/6/2011,Rafaël Dias,34007437,788,1/29/1991,20,0,0,0,0,2350,4769,4750,145,106,220686,174,69,M/AM C,3,2,3,3,2,3,3,6,1,2,1,14,12,11,7,13,14,7,13,5,3,11,14,6,13,9,12,11,13,13,13,11,13,13,7,9,8,12,12,15,14,12,7,5,14,13,20,15,9,13,9,10,8,10,7,13,14,13,14,15,15,6,1,1,18,20,12,1,20,M/AM C,521,1,1,10,20,1,12,1,1,1,14,18,1,12,1,1,0,0,0,0,0,0,0,0,0,0,0,0,0,0,0,0,0,0,0,0,0,0,0,0,0,0,0,0,0,0,0,0,0,0,0,0,0,0,0,0,0,0,0,0,0,0,0,0,0,Rafaël Dias,£270Th. ,29.0,180.0,Midfielder - Central Midfield,right,FC Besançon,4.0,0.0,0.0,23.0,4.0,0.0,0.0,51.0,17.0,1.0,3.0,884.0,23.0,2.0,2.0,1378.0,12.0,1.0,0.0,635.0,25.0,3.0,0.0,1738.0,nan,nan,nan,nan,27.0,2.0,2.0,1784.0,nan,nan,nan,nan,Ligue 1,nan,nan,nan,nan,nan,nan,nan,nan
19/6/2011,Radosav Petrovic,5765125,802,3/8/1989,22,18,1,3,0,4900,7000,6250,154,132,886215,193,83,DM/M C,3,2,2,2,3,1,1,5,3,3,2,10,10,12,12,12,12,13,16,10,12,16,17,15,12,12,10,14,12,14,14,10,14,10,15,10,13,12,15,10,13,11,16,10,14,11,20,13,13,12,9,11,7,9,11,13,18,11,10,13,12,7,1,1,16,1,1,1,16,DM/M C,311,1,1,1,1,1,1,1,1,1,20,16,1,1,1,1,17867063952128,0,0,0,0,0,0,0,0,1,1,0,0,0,0,0,0,0,0,0,0,0,0,0,0,0,0,0,0,0,0,0,0,0,0,0,0,0,0,1,0,0,0,0,0,1,0,0,0,Radosav Petrovic,£1.80m ,31.0,193.0,Midfielder - Defensive Midfield,right,UD Almería,41.0,9.0,7.0,2787.0,24.0,0.0,0.0,1439.0,29.0,3.0,3.0,2146.0,22.0,2.0,3.0,1478.0,33.0,5.0,0.0,2451.0,12.0,1.0,0.0,1013.0,16.0,0.0,0.0,1308.0,13.0,0.0,0.0,728.0,23.0,0.0,0.0,998.0,Premier League,28.0,1.0,0.0,1820.0,4.0,0.0,0.0,133.0
19/6/2011,Radja Nainggolan,8169332,757,5/4/1988,23,1,0,10,1,5000,6461,7250,166,143,2516699,175,65,DM/M/AM C,2,2,3,2,2,2,3,2,1,2,3,8,10,12,12,12,11,9,14,10,13,14,10,16,14,18,15,18,13,15,11,14,20,11,14,13,13,16,15,13,14,15,7,9,15,13,20,17,16,16,15,15,9,20,16,14,16,16,17,15,12,14,1,1,20,18,14,14,20,DM/M/AM C,431,1,1,1,18,13,13,1,1,1,16,20,14,14,1,1,279172907008,0,0,0,0,0,0,0,0,0,0,0,0,0,0,0,1,0,0,0,0,0,0,0,0,0,0,0,0,0,0,0,0,1,0,0,0,0,0,1,0,0,0,0,0,0,0,0,0,Radja Nainggolan,£11.70m ,32.0,176.0,Midfielder - Attacking Midfield,right,Inter Milan,38.0,2.0,2.0,2981.0,39.0,1.0,2.0,3364.0,35.0,2.0,2.0,3064.0,38.0,4.0,3.0,3282.0,46.0,5.0,6.0,3714.0,42.0,6.0,2.0,3525.0,53.0,14.0,6.0,4229.0,42.0,6.0,11.0,3580.0,36.0,7.0,3.0,2443.0,Serie A,29.0,6.0,7.0,2279.0,2.0,0.0,0.0,26.0
19/6/2011,Prince Segbefia,12012410,50,3/11/1991,20,0,0,0,0,2450,4904,4900,133,109,98884,176,70,DM/M C,3,3,2,3,3,2,3,5,3,1,2,6,10,11,6,12,7,9,12,6,7,10,8,14,11,11,13,15,11,11,13,10,10,11,7,9,11,13,15,15,14,12,8,5,13,13,20,14,11,13,11,10,8,8,12,14,10,8,17,2,16,7,7,7,17,8,7,1,17,DM/M C,311,1,1,1,8,1,1,1,1,7,20,17,1,1,1,7,34359738496,0,0,0,0,0,0,0,1,0,0,0,0,0,0,0,0,0,0,0,0,0,0,0,0,0,0,0,0,0,0,0,0,0,0,0,1,0,0,0,0,0,0,0,0,0,0,0,0,Prince Segbefia,£630Th. ,29.0,179.0,Midfielder - Central Midfield,right,Tuzlaspor,4.0,0.0,0.0,307.0,19.0,0.0,0.0,1348.0,23.0,0.0,0.0,1176.0,24.0,3.0,1.0,1777.0,14.0,1.0,0.0,877.0,24.0,5.0,0.0,2136.0,32.0,4.0,0.0,2483.0,14.0,0.0,1.0,790.0,32.0,3.0,1.0,2561.0,Ligue 1,2.0,0.0,0.0,74.0,7.0,0.0,0.0,418.0
19/6/2011,Pierre de Wit,8728369,771,9/26/1987,23,0,0,0,0,2360,6150,6150,137,123,508237,172,72,DM/M/AM C,1,1,3,2,1,3,1,2,3,1,2,13,14,12,11,14,12,6,12,4,4,15,12,7,15,11,14,13,9,12,13,12,14,13,9,12,4,12,12,13,13,8,7,16,12,13,20,12,9,12,6,11,15,14,11,15,12,12,15,13,11,8,1,1,20,17,13,13,20,DM/M/AM C,431,1,1,1,17,13,13,1,1,1,18,20,13,13,1,1,3072,0,0,0,0,0,0,0,0,0,0,1,1,0,0,0,0,0,0,0,0,0,0,0,0,0,0,0,0,0,0,0,0,0,0,0,0,0,0,0,0,0,0,0,0,0,0,0,0,Pierre De Wit,£1.35m ,33.0,171.0,Midfielder - Central Midfield,both,Retired,17.0,0.0,2.0,952.0,28.0,3.0,1.0,1981.0,8.0,0.0,0.0,587.0,39.0,4.0,11.0,3364.0,14.0,0.0,0.0,714.0,2.0,0.0,0.0,92.0,nan,nan,nan,nan,nan,nan,nan,nan,nan,nan,nan,nan,Bundesliga,nan,nan,nan,nan,nan,nan,nan,nan
19/6/2011,Piermario Morosini,7990133,776,7/5/1986,24,0,0,22,0,2281,5250,5250,115,105,185441,182,75,DM/M C,1,1,1,1,1,1,1,1,1,1,1,6,7,11,7,8,3,8,9,4,11,14,5,10,12,11,12,10,10,12,12,13,14,8,9,11,13,16,16,11,10,12,10,8,12,13,20,14,12,10,7,11,7,11,9,13,13,13,20,10,14,12,1,8,20,1,14,1,20,DM/M C,421,1,1,1,1,1,1,1,1,1,18,20,1,14,1,8,140737488355328,0,0,0,0,0,0,0,0,0,0,0,0,0,0,0,0,0,0,0,0,0,0,0,0,0,0,0,0,0,0,0,0,0,0,0,0,0,0,0,0,0,0,0,0,0,0,0,1
19/6/2011,Philipp Kreuels,35005602,771,1/11/1985,26,0,0,0,0,1326,3824,2428,90,85,4023,181,73,M/AM RC,3,2,1,2,2,2,2,1,2,2,2,7,9,10,11,12,5,5,9,6,6,10,8,7,9,14,12,5,12,9,11,7,10,10,8,12,8,15,11,12,11,11,8,5,13,11,20,7,7,10,7,10,11,10,13,12,14,14,14,13,13,7,1,1,18,20,20,1,15,M/AM RC,523,1,1,15,15,1,20,1,1,1,1,15,1,18,1,1,0,0,0,0,0,0,0,0,0,0,0,0,0,0,0,0,0,0,0,0,0,0,0,0,0,0,0,0,0,0,0,0,0,0,0,0,0,0,0,0,0,0,0,0,0,0,0,0,0
19/6/2011,Philipp Bargfrede,92012217,771,3/3/1989,22,0,0,4,1,4500,6600,6600,155,129,805283,174,71,DM/M RC,2,3,3,2,2,3,1,5,1,1,2,11,13,12,7,11,8,10,9,11,14,9,11,14,13,14,17,14,12,15,8,8,13,7,11,8,16,18,17,15,15,14,8,12,12,12,20,16,10,13,7,9,11,15,8,10,12,8,14,12,13,7,1,1,20,10,15,8,20,DM/M RC,423,1,1,1,10,5,5,1,1,1,18,20,8,15,1,1,0,0,0,0,0,0,0,0,0,0,0,0,0,0,0,0,0,0,0,0,0,0,0,0,0,0,0,0,0,0,0,0,0,0,0,0,0,0,0,0,0,0,0,0,0,0,0,0,0,Philipp Bargfrede,£3.15m ,31.0,174.0,Midfielder - Defensive Midfield,right,SV Werder Bremen II,38.0,0.0,2.0,2676.0,24.0,0.0,1.0,1944.0,14.0,0.0,1.0,644.0,20.0,3.0,0.0,1579.0,16.0,1.0,0.0,1253.0,17.0,0.0,1.0,1455.0,11.0,1.0,1.0,449.0,30.0,2.0,1.0,2048.0,17.0,1.0,0.0,1238.0,Bundesliga,17.0,0.0,1.0,716.0,nan,nan,nan,nan
19/6/2011,Phil Neville,2005034,765,1/21/1977,34,59,0,7,0,5500,6500,7000,155,140,1200041,181,77,D/DM/M RLC,3,1,2,1,1,3,1,4,2,3,1,8,9,8,4,12,5,13,6,15,16,13,11,16,9,15,14,16,14,17,8,14,16,4,19,9,16,18,17,10,13,15,10,10,16,10,20,16,12,14,12,15,2,18,2,13,18,15,20,16,15,3,20,12,17,1,20,16,17,D/DM/M RLC,126,1,1,1,1,1,1,10,16,20,18,17,8,12,12,12,1236950581312,0,0,0,0,0,0,1,0,0,0,0,0,0,0,0,0,0,0,0,0,0,0,0,0,0,0,0,0,0,0,0,0,0,0,0,0,0,1,0,0,1,0,0,0,0,0,0,0,Phil Neville,£1.35m ,43.0,180.0,Defender - Right-Back,right,Retired,36.0,1.0,1.0,3173.0,36.0,1.0,0.0,2783.0,25.0,0.0,1.0,2075.0,nan,nan,nan,nan,nan,nan,nan,nan,nan,nan,nan,nan,nan,nan,nan,nan,nan,nan,nan,nan,nan,nan,nan,nan,Premier League,nan,nan,nan,nan,nan,nan,nan,nan
19/6/2011,Phil Jones,28027433,765,2/21/1992,19,0,0,9,0,5500,7400,7400,170,145,14653081,181,71,D/DM C,1,2,1,2,2,3,1,1,2,1,2,2,5,8,5,14,6,13,4,10,15,12,8,16,10,15,15,16,14,13,11,14,18,14,15,9,14,13,13,14,12,11,13,12,18,14,20,15,17,15,10,18,6,14,18,18,8,18,18,14,16,8,20,1,15,1,14,1,20,D/DM C,111,1,1,1,1,1,1,20,1,14,18,15,1,1,1,1,143073950564388,0,0,1,0,0,1,0,0,0,0,0,0,0,0,0,0,0,0,0,0,0,0,0,0,0,0,0,0,0,0,0,0,0,0,0,0,0,1,0,0,0,1,0,0,0,0,0,1,Phil Jones,£16.20m ,28.0,185.0,Defender - Centre-Back,right,Manchester United,29.0,0.0,0.0,2339.0,42.0,2.0,4.0,3076.0,24.0,0.0,2.0,1788.0,39.0,3.0,2.0,3099.0,25.0,0.0,2.0,2074.0,18.0,0.0,0.0,1045.0,26.0,0.0,0.0,2222.0,25.0,0.0,0.0,2152.0,24.0,0.0,1.0,1713.0,Premier League,8.0,1.0,0.0,562.0,nan,nan,nan,nan
19/6/2011,Peter Whittingham,5112581,765,9/8/1984,26,0,0,17,3,3909,6265,6250,132,126,895559,178,64,M RLC,1,2,3,2,1,1,3,4,1,2,1,15,14,12,12,15,14,9,14,3,8,16,13,8,17,5,13,7,15,13,17,15,10,15,7,14,9,11,10,11,13,14,9,20,16,11,7,14,8,13,7,10,9,14,12,12,14,11,13,13,18,5,9,12,20,15,15,20,18,M RLC,406,1,1,1,8,15,10,1,9,1,5,18,20,15,12,1,2048,0,0,0,0,0,0,0,0,0,0,0,1,0,0,0,0,0,0,0,0,0,0,0,0,0,0,0,0,0,0,0,0,0,0,0,0,0,0,0,0,0,0,0,0,0,0,0,0
19/6/2011,Peter Perchtold,8708325,771,9/2/1984,26,0,0,0,0,1250,5250,5250,115,107,82918,189,80,DM/M RC,2,1,3,1,3,1,3,2,3,2,2,9,10,10,10,11,11,8,11,8,8,12,9,12,11,11,12,14,9,11,11,13,12,9,14,8,10,12,12,11,11,12,13,10,12,11,20,12,11,11,4,10,10,16,10,11,10,11,12,12,10,12,1,1,20,13,15,1,20,DM/M RC,423,1,1,10,13,1,12,1,1,1,19,20,1,15,1,1,268435456,0,0,0,0,0,0,0,0,0,0,0,0,0,0,0,0,0,0,0,0,0,0,0,0,0,0,0,0,1,0,0,0,0,0,0,0,0,0,0,0,0,0,0,0,0,0,0,0
19/6/2011,Perparim Hetemaj,8505627,768,12/12/1986,24,6,0,0,0,3750,5894,6550,145,131,449216,176,71,M RC,3,1,2,3,3,1,1,8,3,1,2,10,11,13,8,11,11,7,13,10,11,12,9,12,14,19,16,18,10,12,13,10,15,12,8,14,7,12,16,13,14,13,9,12,15,13,20,16,14,14,12,9,9,13,13,16,14,12,15,12,10,8,1,1,20,15,17,12,20,M RC,403,1,1,3,15,7,10,1,1,1,10,20,12,17,1,1,0,0,0,0,0,0,0,0,0,0,0,0,0,0,0,0,0,0,0,0,0,0,0,0,0,0,0,0,0,0,0,0,0,0,0,0,0,0,0,0,0,0,0,0,0,0,0,0,0,Perparim Hetemaj,£1.62m ,33.0,179.0,Midfielder - Central Midfield,right,Benevento Calcio,31.0,2.0,3.0,2560.0,35.0,0.0,2.0,2147.0,30.0,0.0,2.0,2382.0,34.0,0.0,4.0,2685.0,33.0,0.0,1.0,2723.0,29.0,1.0,0.0,2379.0,24.0,0.0,1.0,1966.0,32.0,3.0,4.0,2493.0,31.0,2.0,1.0,2250.0,Serie A,33.0,0.0,1.0,2349.0,4.0,0.0,0.0,99.0
19/6/2011,Per Ciljan Skjelbred,762025,786,6/16/1987,24,16,0,12,1,6000,7000,6700,147,134,5983952,177,62,M/AM C,3,2,3,2,2,3,3,3,2,3,1,10,12,13,5,15,7,4,6,8,12,16,10,11,15,18,9,14,8,12,12,10,18,14,7,15,9,17,18,16,15,8,7,15,14,14,20,17,6,13,6,18,11,8,12,16,14,14,18,15,14,2,1,1,18,20,14,11,20,M/AM C,521,1,1,1,20,11,14,1,1,1,1,18,10,13,1,1,4312793152,0,0,0,0,0,0,1,0,0,0,0,0,0,0,0,0,0,0,0,0,1,0,0,0,1,0,0,0,0,0,0,0,1,0,0,0,0,0,0,0,0,0,0,0,0,0,0,0,Per Ciljan Skjelbred,£1.35m ,33.0,175.0,Midfielder - Central Midfield,right,Rosenborg BK,27.0,1.0,2.0,2197.0,12.0,1.0,1.0,682.0,19.0,0.0,0.0,1260.0,28.0,2.0,7.0,2118.0,26.0,0.0,2.0,2239.0,36.0,0.0,2.0,3167.0,31.0,0.0,0.0,2587.0,33.0,0.0,0.0,2494.0,17.0,0.0,1.0,1098.0,Bundesliga,32.0,1.0,0.0,2253.0,3.0,0.0,0.0,270.0
19/6/2011,Peer Kluge,6000738,771,11/22/1980,30,0,0,0,0,4252,6203,6203,135,134,2491593,179,68,DM/M C,2,2,1,3,2,3,2,1,2,1,1,10,12,8,6,12,5,7,6,8,15,13,8,17,13,11,16,14,12,18,9,12,11,3,10,7,17,20,18,11,14,10,8,16,16,11,20,17,8,13,7,13,10,15,9,13,14,12,15,14,9,6,9,8,19,12,10,10,19,DM/M C,311,1,1,1,12,1,1,1,1,9,20,19,10,10,1,8,8640266304,0,0,0,0,0,0,1,0,0,0,0,0,0,0,0,0,0,0,0,0,0,0,0,0,1,1,0,0,0,0,0,0,0,1,0,0,0,0,0,0,0,0,0,0,0,0,0,0
19/6/2011,Pedro Mendes,4102520,788,2/26/1979,32,12,0,1,0,5000,6500,6500,135,125,254369,173,77,DM/M C,2,2,1,3,1,1,1,2,3,1,3,13,13,9,8,14,13,8,14,7,11,14,13,13,15,11,16,13,15,16,15,15,15,10,14,10,16,16,13,10,12,12,9,6,13,10,20,13,11,14,7,12,10,9,15,14,13,14,18,16,16,3,1,1,16,5,5,1,16,DM/M C,311,1,1,1,5,1,1,1,1,1,20,16,1,5,1,1,8796097757184,0,0,0,0,0,0,0,0,0,0,0,0,0,0,1,0,0,0,0,1,0,0,1,0,0,0,0,0,0,0,0,0,0,0,0,0,0,0,0,0,0,0,0,1,0,0,0,0,Pedro Mendes,£180Th. ,30.0,186.0,Defender - Centre-Back,right,Montpellier HSC,16.0,0.0,0.0,1300.0,24.0,0.0,0.0,1525.0,34.0,1.0,2.0,2919.0,16.0,0.0,1.0,1164.0,24.0,0.0,0.0,1728.0,24.0,0.0,0.0,2017.0,20.0,0.0,0.0,1757.0,39.0,1.0,1.0,3290.0,32.0,1.0,1.0,2743.0,LaLiga,18.0,1.0,0.0,1534.0,6.0,0.0,0.0,535.0
19/6/2011,Paulo Machado,744562,788,3/31/1986,25,0,0,9,3,4900,6243,6190,155,138,606164,174,74,M RLC,1,2,1,1,1,1,1,3,1,1,1,13,13,12,10,15,15,8,15,10,8,14,12,10,15,11,13,14,13,13,14,12,17,11,11,12,12,16,14,15,12,12,7,10,14,13,20,13,12,13,11,14,6,15,11,14,13,13,13,13,13,3,1,1,20,14,15,15,20,M RLC,406,1,1,1,14,10,10,1,1,1,10,20,15,15,1,1,4194880,0,0,0,0,0,0,1,0,0,1,0,0,0,0,0,0,0,0,0,0,0,0,1,0,0,0,0,0,0,0,0,0,0,0,0,0,0,0,0,0,0,0,0,0,0,0,0,0,Paulo Machado,£4.05m ,34.0,174.0,Midfielder - Central Midfield,right,Leixões SC,33.0,4.0,5.0,2453.0,25.0,3.0,0.0,1491.0,42.0,3.0,6.0,3075.0,25.0,3.0,0.0,1173.0,44.0,4.0,8.0,3202.0,44.0,2.0,10.0,3294.0,33.0,1.0,3.0,1835.0,27.0,5.0,4.0,1780.0,20.0,2.0,4.0,1754.0,Ligue 1,9.0,1.0,1.0,641.0,3.0,0.0,0.0,150.0
19/6/2011,Paul Scharner,134590,755,3/11/1980,31,30,0,12,0,5500,7370,7350,144,134,563711,191,82,DM/M C,2,2,2,3,2,3,1,8,2,2,2,4,7,10,9,13,5,15,6,7,13,12,5,15,11,15,12,16,12,13,12,12,16,9,15,12,15,13,17,11,12,14,16,15,15,11,20,15,16,13,14,15,2,15,13,17,8,15,6,13,9,14,15,1,20,1,8,1,20,DM/M C,311,1,1,5,1,1,1,15,1,8,20,20,1,1,1,1,139586502656,0,0,0,0,0,0,0,0,0,0,0,0,0,0,0,0,1,0,0,0,0,0,0,0,0,0,0,0,0,0,0,1,0,0,0,0,0,1,0,0,0,0,0,0,0,0,0,0,Paul Scharner,£1.80m ,40.0,191.0,Defender - Centre-Back,right,Retired,35.0,4.0,1.0,2853.0,30.0,3.0,2.0,1618.0,24.0,1.0,1.0,1846.0,nan,nan,nan,nan,nan,nan,nan,nan,nan,nan,nan,nan,nan,nan,nan,nan,nan,nan,nan,nan,nan,nan,nan,nan,Premier League,nan,nan,nan,nan,nan,nan,nan,nan
19/6/2011,Paul Lasne,8440938,769,1/16/1989,22,0,0,0,0,2400,3650,3650,130,110,309911,186,79,DM/M C,3,2,3,1,1,3,2,4,2,2,1,7,10,9,6,12,11,12,11,8,9,13,6,12,12,13,12,13,12,12,12,12,14,7,10,9,10,14,16,12,13,14,13,20,14,11,5,16,13,13,13,13,5,12,8,13,14,13,15,15,15,5,10,10,20,12,1,12,20,DM/M C,421,1,1,1,12,1,1,8,10,1,16,20,12,1,10,1,0,0,0,0,0,0,0,0,0,0,0,0,0,0,0,0,0,0,0,0,0,0,0,0,0,0,0,0,0,0,0,0,0,0,0,0,0,0,0,0,0,0,0,0,0,0,0,0,0,Paul Lasne,£630Th. ,31.0,186.0,Midfielder - Defensive Midfield,left,Stade Brest 29,34.0,1.0,0.0,2033.0,30.0,0.0,1.0,1542.0,29.0,1.0,1.0,1709.0,37.0,3.0,4.0,3039.0,33.0,2.0,1.0,1913.0,9.0,0.0,0.0,516.0,27.0,3.0,3.0,1741.0,42.0,1.0,2.0,3463.0,37.0,2.0,0.0,1942.0,Ligue 1,20.0,2.0,1.0,1319.0,3.0,0.0,0.0,112.0
19/6/2011,Paul Codrea,135879,790,4/4/1981,30,36,1,9,0,4000,6325,5750,128,115,197593,174,69,M C,2,2,1,3,1,3,3,1,1,3,1,17,10,10,8,15,17,5,16,2,10,15,18,8,14,18,8,12,8,10,15,13,5,15,8,10,11,15,15,11,13,12,8,10,10,10,20,11,11,10,20,7,15,4,18,10,10,1,12,10,3,12,1,1,20,1,1,1,20,M C,401,1,1,1,1,1,1,1,1,1,15,20,1,1,1,1,8796097347584,0,0,0,0,0,0,0,0,0,0,0,0,0,0,0,0,0,1,0,0,0,0,1,0,0,0,0,0,0,0,0,0,0,0,0,0,0,0,0,0,0,0,0,1,0,0,0,0,Paul Codrea,£180Th. ,39.0,174.0,Midfielder - Central Midfield,right,Retired,12.0,0.0,1.0,764.0,3.0,0.0,0.0,123.0,11.0,0.0,0.0,688.0,nan,nan,nan,nan,nan,nan,nan,nan,nan,nan,nan,nan,nan,nan,nan,nan,nan,nan,nan,nan,nan,nan,nan,nan,Serie A,nan,nan,nan,nan,nan,nan,nan,nan
19/6/2011,Patxi Puñal,4203327,796,9/6/1975,35,0,0,0,0,4500,6600,6600,139,134,212672,179,73,DM/M C,1,3,1,3,3,2,1,4,1,2,3,15,15,8,9,13,12,10,13,7,10,14,17,17,11,19,16,18,9,13,10,12,15,7,18,9,15,18,17,12,10,17,10,10,15,11,20,13,14,17,20,13,4,5,16,13,20,14,15,13,13,9,8,1,19,6,7,5,19,DM/M C,311,1,1,1,6,1,1,8,1,1,20,19,5,7,1,1,64,0,0,0,0,0,0,1,0,0,0,0,0,0,0,0,0,0,0,0,0,0,0,0,0,0,0,0,0,0,0,0,0,0,0,0,0,0,0,0,0,0,0,0,0,0,0,0,0,Patxi Puñal,£630Th. ,45.0,179.0,Midfielder - Defensive Midfield,right,Retired,33.0,0.0,4.0,2828.0,38.0,0.0,3.0,3254.0,24.0,1.0,1.0,1495.0,29.0,1.0,2.0,1805.0,nan,nan,nan,nan,nan,nan,nan,nan,nan,nan,nan,nan,nan,nan,nan,nan,nan,nan,nan,nan,LaLiga,nan,nan,nan,nan,nan,nan,nan,nan
19/6/2011,Pateiro,728044,788,5/31/1980,31,0,0,0,0,1783,5245,5595,114,111,408463,178,72,M/AM LC,3,2,1,1,1,1,1,1,3,3,2,14,15,15,11,14,13,8,11,8,10,13,13,8,14,10,13,10,13,11,14,13,8,12,9,12,10,12,12,12,12,12,11,20,10,12,5,13,12,12,8,10,8,11,13,8,12,10,13,14,13,4,1,1,20,16,10,16,20,M/AM LC,414,1,1,1,15,16,10,1,1,1,1,20,15,1,1,1,1099511629825,1,0,0,0,0,0,0,0,0,0,0,1,0,0,0,0,0,0,0,0,0,0,0,0,0,0,0,0,0,0,0,0,0,0,0,0,0,0,0,0,1,0,0,0,0,0,0,0
19/6/2011,Pasquale De Vita,43081378,776,3/3/1994,17,0,0,0,0,219,3259,3259,130,69,38313,182,78,DM/M C,2,1,1,1,1,1,3,1,2,1,2,6,8,4,9,13,9,6,9,5,5,13,9,13,13,12,7,2,7,11,10,7,8,4,7,7,10,8,12,13,12,11,7,8,11,12,20,8,4,10,10,10,5,10,7,13,5,13,6,19,6,19,1,1,20,1,1,1,20,DM/M C,311,1,1,1,1,1,1,1,1,1,20,20,1,1,1,1,0,0,0,0,0,0,0,0,0,0,0,0,0,0,0,0,0,0,0,0,0,0,0,0,0,0,0,0,0,0,0,0,0,0,0,0,0,0,0,0,0,0,0,0,0,0,0,0,0
19/6/2011,Pape Diop,8440901,41,3/19/1986,25,1,0,0,0,4264,6271,6271,133,127,454545,180,73,DM C,2,1,3,2,3,1,1,2,2,2,3,10,11,8,11,10,6,13,12,10,12,11,8,14,9,18,14,18,5,15,9,10,15,8,8,8,12,16,19,15,15,15,11,7,17,14,20,17,14,12,16,13,11,8,14,12,13,10,16,7,4,8,1,1,15,1,1,1,15,DM C,301,1,1,1,1,1,1,1,1,1,20,15,1,1,1,1,32,0,0,0,0,0,1,0,0,0,0,0,0,0,0,0,0,0,0,0,0,0,0,0,0,0,0,0,0,0,0,0,0,0,0,0,0,0,0,0,0,0,0,0,0,0,0,0,0,Pape Diop,£2.70m ,34.0,180.0,Midfielder - Defensive Midfield,right,SD Eibar,20.0,0.0,2.0,1149.0,36.0,1.0,4.0,3046.0,41.0,1.0,0.0,3280.0,36.0,4.0,1.0,2772.0,19.0,0.0,1.0,1544.0,32.0,3.0,1.0,2652.0,19.0,0.0,0.0,981.0,22.0,0.0,0.0,1351.0,29.0,1.0,1.0,2401.0,LaLiga,30.0,1.0,0.0,2256.0,4.0,0.0,1.0,340.0
19/6/2011,Paolo Sammarco,830543,776,3/17/1983,28,0,0,9,0,2700,6250,6250,126,121,94095,181,76,M RC,1,1,1,1,1,1,1,1,1,1,1,6,10,10,8,13,8,10,15,4,10,13,9,13,14,12,13,14,10,9,12,11,15,10,10,16,16,18,19,13,12,12,11,5,12,14,20,15,13,9,8,15,12,15,10,12,11,13,13,14,15,9,1,1,20,1,15,1,20,M RC,403,1,1,1,1,1,1,1,1,1,1,20,1,15,1,1,0,0,0,0,0,0,0,0,0,0,0,0,0,0,0,0,0,0,0,0,0,0,0,0,0,0,0,0,0,0,0,0,0,0,0,0,0,0,0,0,0,0,0,0,0,0,0,0,0,Paolo Sammarco,£1.71m ,37.0,181.0,Midfielder - Central Midfield,right,FC Arzignano Valchiampo,17.0,1.0,0.0,1012.0,32.0,4.0,2.0,1855.0,28.0,1.0,3.0,2097.0,32.0,0.0,4.0,2255.0,22.0,1.0,0.0,1400.0,28.0,4.0,2.0,2321.0,44.0,1.0,4.0,3457.0,22.0,1.0,0.0,1438.0,9.0,1.0,0.0,575.0,Serie A,18.0,0.0,0.0,1222.0,5.0,0.0,0.0,427.0
19/6/2011,Pál Dárdai,3600734,773,3/16/1976,35,61,5,0,0,4350,6160,6500,135,112,26090,179,80,DM/M C,1,1,2,1,1,3,2,2,1,3,3,3,8,7,8,9,5,10,13,7,13,12,11,15,8,16,15,14,16,18,8,10,18,5,14,8,16,19,16,10,7,10,11,20,10,10,10,13,13,16,6,15,7,12,20,3,19,10,20,15,15,5,1,1,19,1,1,10,19,DM/M C,311,1,1,1,1,1,1,1,1,1,20,19,10,1,1,1,576,0,0,0,0,0,0,1,0,0,1,0,0,0,0,0,0,0,0,0,0,0,0,0,0,0,0,0,0,0,0,0,0,0,0,0,0,0,0,0,0,0,0,0,0,0,0,0,0
19/6/2011,Pajtim Kasami,28027647,798,6/2/1992,19,0,0,10,1,3500,5500,6250,160,120,1510795,187,70,M/AM RC,1,1,1,1,1,1,1,1,1,1,1,10,14,13,14,12,5,9,13,3,9,13,11,14,8,7,13,14,12,10,11,9,10,17,8,11,9,13,11,15,13,14,12,20,12,14,8,11,13,10,12,10,17,6,14,5,11,6,10,5,11,8,1,1,20,20,17,13,20,M/AM RC,413,1,1,8,20,13,17,1,1,1,14,20,13,17,1,1,0,0,0,0,0,0,0,0,0,0,0,0,0,0,0,0,0,0,0,0,0,0,0,0,0,0,0,0,0,0,0,0,0,0,0,0,0,0,0,0,0,0,0,0,0,0,0,0,0,Pajtim Kasami,£2.25m ,28.0,188.0,Midfielder - Right Midfield,left,FC Basel 1893,23.0,0.0,3.0,866.0,24.0,3.0,2.0,1216.0,24.0,2.0,2.0,1665.0,35.0,3.0,1.0,2321.0,36.0,5.0,6.0,2440.0,30.0,4.0,3.0,2213.0,27.0,2.0,2.0,1974.0,26.0,6.0,4.0,2225.0,38.0,11.0,8.0,3068.0,Premier League,39.0,15.0,4.0,3234.0,nan,nan,nan,nan
19/6/2011,Pablo Zabaleta,951034,1649,1/16/1985,26,14,0,43,5,6050,6884,7250,155,153,18181818,177,76,D/WB/M RLC,1,3,2,2,2,2,2,2,2,1,1,8,13,11,10,12,7,10,10,10,13,12,11,14,12,17,14,17,15,14,10,12,17,4,10,11,14,19,19,15,14,13,9,11,15,14,20,16,12,13,8,14,13,20,18,16,18,18,17,15,14,6,20,18,18,14,20,15,18,D/WB/M RLC,126,1,1,1,1,1,14,1,15,20,14,18,1,18,12,18,0,0,0,0,0,0,0,0,0,0,0,0,0,0,0,0,0,0,0,0,0,0,0,0,0,0,0,0,0,0,0,0,0,0,0,0,0,0,0,0,0,0,0,0,0,0,0,0,0,Pablo Zabaleta,£13.05m ,35.0,176.0,Defender - Right-Back,right,Retired,45.0,1.0,5.0,3199.0,31.0,1.0,1.0,2311.0,42.0,3.0,2.0,3582.0,48.0,1.0,8.0,3957.0,36.0,2.0,4.0,3148.0,22.0,0.0,1.0,1657.0,32.0,2.0,2.0,2055.0,39.0,0.0,1.0,3366.0,27.0,0.0,1.0,2181.0,Premier League,13.0,0.0,0.0,859.0,nan,nan,nan,nan
19/6/2011,Pablo Sarabia,67045428,796,5/11/1992,19,0,0,0,0,4070,6080,6080,164,124,5895804,177,72,M/AM LC,2,2,2,1,2,2,1,7,3,2,1,13,15,16,11,15,12,8,10,5,4,15,12,6,17,10,11,9,12,8,15,11,4,16,8,14,5,11,9,15,16,9,7,20,12,13,8,11,8,10,9,15,10,9,11,14,12,7,9,7,6,5,1,1,16,20,13,20,18,M/AM LC,524,1,1,10,18,20,13,1,1,1,1,15,16,9,1,1,2192,0,0,0,0,1,0,0,1,0,0,0,1,0,0,0,0,0,0,0,0,0,0,0,0,0,0,0,0,0,0,0,0,0,0,0,0,0,0,0,0,0,0,0,0,0,0,0,0,Pablo Sarabia,£2.25m ,28.0,174.0,Forward - Right Winger,left,Paris Saint-Germain,34.0,12.0,4.0,2628.0,20.0,0.0,1.0,983.0,16.0,2.0,0.0,629.0,36.0,2.0,6.0,2141.0,41.0,4.0,7.0,2927.0,32.0,7.0,6.0,2553.0,46.0,11.0,12.0,2809.0,53.0,9.0,9.0,3753.0,52.0,23.0,17.0,3729.0,LaLiga,40.0,14.0,8.0,2409.0,9.0,1.0,4.0,464.0
19/6/2011,Pablo Ledesma,958174,1649,2/4/1984,27,3,0,0,0,4000,6450,6200,128,124,913123,178,73,M RC,1,1,1,1,1,1,1,1,1,1,1,10,13,12,8,13,10,13,14,8,12,14,13,13,14,14,12,10,14,10,14,14,12,10,11,12,15,14,14,11,13,13,9,5,9,12,20,14,14,9,9,12,14,15,11,14,14,11,16,16,15,11,1,1,20,12,18,1,20,M RC,403,1,1,1,1,1,12,1,1,1,14,20,1,18,1,1,272,0,0,0,0,1,0,0,0,1,0,0,0,0,0,0,0,0,0,0,0,0,0,0,0,0,0,0,0,0,0,0,0,0,0,0,0,0,0,0,0,0,0,0,0,0,0,0,0,Pablo Ledesma,£1.26m ,36.0,178.0,Midfielder - Central Midfield,right,Without Club,32.0,2.0,1.0,2251.0,29.0,4.0,2.0,1682.0,19.0,1.0,2.0,1204.0,28.0,0.0,1.0,2112.0,28.0,2.0,1.0,2138.0,14.0,3.0,1.0,1129.0,22.0,1.0,1.0,1863.0,19.0,1.0,2.0,1354.0,11.0,1.0,0.0,775.0,Serie A,20.0,0.0,0.0,1800.0,nan,nan,nan,nan
19/6/2011,Pablo Hervías,67115983,796,3/8/1993,18,0,0,0,0,1750,4150,4150,119,90,235491,167,66,M/AM RC,3,2,3,3,3,1,2,3,3,3,2,12,12,12,9,8,10,7,11,2,1,11,10,4,14,8,9,8,9,10,12,11,12,14,9,12,3,10,4,14,10,9,6,10,12,13,20,11,10,11,6,9,9,13,8,14,6,9,6,11,10,7,1,1,16,20,20,13,18,M/AM RC,523,1,1,4,18,13,20,1,1,1,4,16,13,14,1,1,4,0,0,1,0,0,0,0,0,0,0,0,0,0,0,0,0,0,0,0,0,0,0,0,0,0,0,0,0,0,0,0,0,0,0,0,0,0,0,0,0,0,0,0,0,0,0,0,0
19/6/2011,Pablo Ceppelini,78034945,1657,9/11/1991,19,0,0,0,0,2296,5077,5042,141,112,732886,176,70,M/AM RC,2,3,2,3,1,2,1,5,2,3,3,15,14,14,12,16,14,4,12,11,7,15,14,6,15,12,13,9,12,8,12,12,10,12,6,15,9,12,12,12,16,7,7,10,17,10,20,13,8,12,8,12,2,13,14,10,15,14,15,14,8,10,1,1,16,20,16,12,20,M/AM RC,523,1,1,8,20,12,16,1,1,1,1,16,8,12,1,1,0,0,0,0,0,0,0,0,0,0,0,0,0,0,0,0,0,0,0,0,0,0,0,0,0,0,0,0,0,0,0,0,0,0,0,0,0,0,0,0,0,0,0,0,0,0,0,0,0,Pablo Ceppelini,£1.35m ,29.0,178.0,Midfielder - Attacking Midfield,right,CD Cruz Azul,18.0,1.0,4.0,1217.0,18.0,5.0,0.0,1101.0,18.0,2.0,1.0,1131.0,3.0,0.0,0.0,94.0,29.0,5.0,2.0,1988.0,9.0,0.0,2.0,370.0,55.0,12.0,11.0,4938.0,34.0,6.0,6.0,2348.0,46.0,9.0,9.0,2797.0,Serie A,7.0,1.0,0.0,278.0,0.0,0.0,0.0,0.0
19/6/2011,Pablo Barrientos,955648,1649,1/17/1985,26,0,0,15,6,4000,6100,6200,140,124,645917,175,66,M/AM RLC,1,2,3,2,1,2,3,6,2,1,3,14,15,16,11,15,9,7,11,6,5,15,12,5,16,14,13,17,9,9,14,15,10,15,12,15,7,11,9,14,15,10,7,20,12,15,7,10,10,10,19,12,13,12,12,14,10,14,14,9,9,15,1,1,19,20,15,20,16,M/AM RLC,526,1,1,1,16,20,15,1,1,1,1,15,19,14,1,1,34359738368,0,0,0,0,0,0,0,0,0,0,0,0,0,0,0,0,0,0,0,0,0,0,0,0,0,0,0,0,0,0,0,0,0,0,0,1,0,0,0,0,0,0,0,0,0,0,0,0,Pablo Barrientos,£3.60m ,35.0,176.0,Forward - Right Winger,left,Without Club,21.0,2.0,3.0,1137.0,26.0,4.0,5.0,1753.0,35.0,5.0,5.0,2922.0,31.0,5.0,5.0,2346.0,41.0,3.0,5.0,2033.0,17.0,3.0,1.0,747.0,41.0,8.0,5.0,2843.0,43.0,6.0,8.0,3019.0,33.0,2.0,6.0,1900.0,Serie A,nan,nan,nan,nan,nan,nan,nan,nan
19/6/2011,Owen Hargreaves,6001646,765,1/20/1981,30,42,0,3,0,6000,6750,7000,170,150,773378,180,74,DM/M C,2,1,1,3,1,2,1,6,3,1,1,12,17,10,8,13,16,8,13,10,14,13,18,16,14,17,17,16,14,15,10,14,19,5,13,9,15,17,18,13,13,12,11,13,5,12,20,14,14,18,9,19,20,16,18,16,15,20,19,16,18,4,14,14,18,6,14,8,18,DM/M C,311,1,1,1,6,1,1,1,6,14,20,18,8,14,6,14,64,0,0,0,0,0,0,1,0,0,0,0,0,0,0,0,0,0,0,0,0,0,0,0,0,0,0,0,0,0,0,0,0,0,0,0,0,0,0,0,0,0,0,0,0,0,0,0,0
19/6/2011,Olivier Sorlin,914907,769,4/9/1979,32,0,0,23,9,4650,5850,5850,140,130,215976,182,77,M C,3,2,2,3,2,2,1,6,3,2,3,15,13,11,7,13,11,9,13,7,9,14,13,11,13,9,13,12,13,13,13,14,15,8,11,7,13,13,15,11,11,14,11,15,15,12,20,15,14,12,9,12,9,14,14,14,13,13,13,13,13,10,1,1,20,14,13,13,20,M C,401,1,1,1,14,13,13,1,1,1,14,20,13,13,1,1,35184372088832,0,0,0,0,0,0,0,0,0,0,0,0,0,0,0,0,0,0,0,0,0,0,0,0,0,0,0,0,0,0,0,0,0,0,0,0,0,0,0,0,0,0,0,0,0,1,0,0,Olivier Sorlin,£630Th. ,41.0,182.0,Midfielder - Defensive Midfield,right,Cluses-Scionzier FC,37.0,1.0,5.0,3194.0,35.0,2.0,3.0,2987.0,42.0,0.0,2.0,3740.0,40.0,0.0,1.0,3564.0,33.0,1.0,1.0,2721.0,37.0,0.0,0.0,3039.0,nan,nan,nan,nan,nan,nan,nan,nan,nan,nan,nan,nan,Ligue 1,nan,nan,nan,nan,nan,nan,nan,nan
19/6/2011,Oliver Kirch,890518,771,8/21/1982,28,0,0,0,0,3500,5850,6100,130,122,418096,181,74,WB/DM/M/AM RC,1,1,2,1,1,2,3,6,1,2,3,8,10,13,5,12,6,13,11,9,14,13,7,14,12,13,13,13,12,12,9,10,12,11,6,7,14,14,15,13,15,9,11,5,12,13,20,12,13,12,7,11,15,14,12,13,12,10,13,13,11,6,15,18,17,17,18,1,17,WB/DM/M/AM RC,343,1,1,1,1,1,17,1,1,15,20,17,1,17,1,18,0,0,0,0,0,0,0,0,0,0,0,0,0,0,0,0,0,0,0,0,0,0,0,0,0,0,0,0,0,0,0,0,0,0,0,0,0,0,0,0,0,0,0,0,0,0,0,0,0,Oliver Kirch,£900Th. ,38.0,182.0,Midfielder - Defensive Midfield,right,Retired,33.0,0.0,2.0,2466.0,26.0,1.0,1.0,1864.0,10.0,0.0,0.0,632.0,14.0,1.0,0.0,906.0,12.0,0.0,1.0,810.0,7.0,0.0,0.0,496.0,nan,nan,nan,nan,nan,nan,nan,nan,nan,nan,nan,nan,Bundesliga,nan,nan,nan,nan,nan,nan,nan,nan
19/6/2011,Olberdam,319781,1651,2/6/1985,26,0,0,0,0,2525,6000,5800,122,116,340085,182,77,DM/M C,2,1,3,1,2,1,3,2,3,2,1,10,9,9,11,12,10,14,10,10,12,14,10,13,13,13,14,15,14,14,12,14,12,8,12,10,13,15,16,11,11,14,12,20,12,11,7,14,14,15,8,12,7,10,12,12,11,12,13,11,12,8,1,1,18,1,1,1,18,DM/M C,311,1,1,1,1,1,1,1,1,1,20,18,1,1,1,1,256,0,0,0,0,0,0,0,0,1,0,0,0,0,0,0,0,0,0,0,0,0,0,0,0,0,0,0,0,0,0,0,0,0,0,0,0,0,0,0,0,0,0,0,0,0,0,0,0,Olberdam,£630Th. ,35.0,180.0,Midfielder - Central Midfield,left,Without Club,12.0,0.0,0.0,731.0,22.0,3.0,3.0,1314.0,8.0,0.0,0.0,229.0,nan,nan,nan,nan,4.0,1.0,0.0,329.0,nan,nan,nan,nan,nan,nan,nan,nan,nan,nan,nan,nan,nan,nan,nan,nan,Liga NOS,nan,nan,nan,nan,nan,nan,nan,nan
19/6/2011,Nuri Sahin,8728250,799,9/5/1988,22,26,1,16,5,6500,7000,7600,169,152,0,180,72,DM/M C,3,2,1,3,2,2,1,6,1,2,3,16,17,12,8,18,15,7,13,10,10,18,12,12,17,12,16,10,15,16,19,19,14,13,14,10,13,15,12,10,13,12,10,20,14,12,10,14,11,16,8,12,8,9,12,18,14,13,17,10,10,8,1,1,20,14,10,12,20,DM/M C,421,1,1,1,14,9,9,1,1,1,18,20,12,10,1,1,140737509851264,0,0,0,0,0,0,0,1,0,0,0,0,0,0,0,0,0,0,0,1,0,0,1,0,1,0,0,0,0,0,0,0,0,0,0,0,0,0,0,0,0,0,0,0,0,0,0,1,Nuri Sahin,£16.20m ,32.0,180.0,Midfielder - Defensive Midfield,left,Antalyaspor,40.0,8.0,13.0,3500.0,10.0,1.0,1.0,641.0,30.0,6.0,6.0,1743.0,48.0,2.0,3.0,4091.0,9.0,1.0,1.0,724.0,12.0,0.0,2.0,650.0,9.0,1.0,1.0,459.0,25.0,2.0,3.0,1809.0,23.0,1.0,1.0,1742.0,LaLiga,17.0,0.0,4.0,1351.0,6.0,0.0,0.0,383.0
19/6/2011,Nuno Piloto,735796,788,3/19/1982,29,0,0,0,0,2250,5500,5500,112,108,131114,177,73,M C,3,1,1,3,2,2,1,3,1,1,1,10,11,10,8,11,10,11,12,10,10,12,12,12,12,11,11,12,17,14,11,13,11,9,12,10,13,17,15,11,12,11,11,5,13,11,20,12,11,17,7,11,7,14,10,11,16,12,16,18,18,3,10,7,20,10,12,5,20,M C,401,1,1,1,10,1,5,1,1,10,5,20,5,12,1,7,1048640,0,0,0,0,0,0,1,0,0,0,0,0,0,0,0,0,0,0,0,0,1,0,0,0,0,0,0,0,0,0,0,0,0,0,0,0,0,0,0,0,0,0,0,0,0,0,0,0,Nuno Piloto,£900Th. ,38.0,177.0,Midfielder - Central Midfield,right,Without Club,22.0,2.0,1.0,1860.0,11.0,0.0,0.0,801.0,16.0,1.0,0.0,1048.0,10.0,0.0,0.0,666.0,27.0,0.0,2.0,2219.0,21.0,1.0,0.0,1383.0,33.0,0.0,0.0,2182.0,nan,nan,nan,nan,nan,nan,nan,nan,Liga NOS,nan,nan,nan,nan,nan,nan,nan,nan
19/6/2011,Nikola Gulan,5779088,802,3/23/1989,22,0,0,23,0,2500,5610,4656,125,102,148327,183,73,D/M LC,1,1,2,1,1,2,2,1,2,2,2,8,12,9,8,10,8,10,7,8,11,12,5,12,11,8,11,10,10,12,10,12,9,13,11,12,12,15,9,12,13,14,14,20,12,11,5,14,14,7,11,4,7,9,9,16,11,11,13,14,4,2,18,1,20,9,1,20,16,D/M LC,424,1,1,1,1,9,1,1,18,1,1,16,20,1,1,1,0,0,0,0,0,0,0,0,0,0,0,0,0,0,0,0,0,0,0,0,0,0,0,0,0,0,0,0,0,0,0,0,0,0,0,0,0,0,0,0,0,0,0,0,0,0,0,0,0,Nikola Gulan,£270Th. ,31.0,183.0,Defender - Left-Back,left,BK Häcken,9.0,0.0,0.0,533.0,1.0,0.0,0.0,10.0,20.0,0.0,1.0,1638.0,14.0,0.0,0.0,990.0,33.0,0.0,2.0,2565.0,17.0,0.0,1.0,1373.0,25.0,0.0,0.0,1564.0,11.0,0.0,0.0,712.0,26.0,0.0,2.0,2202.0,Serie A,29.0,0.0,1.0,2153.0,nan,nan,nan,nan
19/6/2011,Niko Kranjcar,652912,761,8/13/1984,26,64,15,9,4,6350,8195,7250,157,149,2780211,185,82,M/AM LC,1,3,2,3,3,2,1,9,2,2,2,14,12,15,10,16,15,8,14,9,12,15,15,11,16,12,14,13,15,15,14,15,13,14,11,13,8,14,12,15,12,17,13,10,13,12,20,14,15,14,6,13,9,11,14,16,11,12,17,17,16,10,1,1,16,20,10,18,20,M/AM LC,524,1,1,10,20,18,10,1,1,1,1,16,15,10,1,1,2340327680639104,0,0,0,0,0,0,0,1,0,0,0,0,0,0,0,0,0,0,0,0,1,0,0,0,0,0,0,0,0,0,0,0,0,0,1,0,0,0,0,1,0,0,0,0,1,0,1,0,Niko Kranjcar,£6.75m ,36.0,186.0,Midfielder - Attacking Midfield,both,Retired,21.0,2.0,1.0,652.0,18.0,1.0,1.0,1047.0,21.0,4.0,2.0,1185.0,33.0,2.0,3.0,2121.0,22.0,2.0,1.0,1113.0,8.0,1.0,1.0,413.0,15.0,3.0,3.0,765.0,11.0,0.0,3.0,647.0,nan,nan,nan,nan,Premier League,nan,nan,nan,nan,nan,nan,nan,nan
19/6/2011,Nigel Reo-Coker,5113680,765,5/14/1984,27,0,0,23,1,5000,6650,7000,147,138,1584975,175,77,DM/M C,3,2,3,1,1,2,3,2,3,3,1,5,11,9,9,9,5,12,8,6,13,9,6,16,11,18,12,18,12,15,11,13,13,3,16,10,14,18,19,16,14,16,9,8,18,14,20,18,15,12,15,16,8,15,8,15,10,10,15,14,7,14,14,1,20,1,14,1,20,DM/M C,421,1,1,1,1,1,1,1,1,14,18,20,1,12,1,1,274877907008,0,0,0,0,0,0,1,0,0,0,0,0,0,0,0,0,0,0,0,0,0,0,0,0,0,0,0,0,0,0,0,0,0,0,0,0,0,0,1,0,0,0,0,0,0,0,0,0,Nigel Reo-Coker,£4.50m ,36.0,175.0,Midfielder - Defensive Midfield,right,Retired,36.0,0.0,1.0,2635.0,42.0,4.0,0.0,3715.0,46.0,1.0,3.0,3935.0,23.0,0.0,2.0,1676.0,40.0,0.0,3.0,2827.0,nan,nan,nan,nan,3.0,0.0,0.0,169.0,0.0,0.0,0.0,0.0,nan,nan,nan,nan,Premier League,nan,nan,nan,nan,nan,nan,nan,nan
19/6/2011,Nigel de Jong,856589,784,11/30/1984,26,54,1,0,0,7400,8250,8000,165,160,18181818,174,72,DM/M C,2,1,1,3,1,2,2,6,1,1,1,5,8,10,6,14,7,13,5,12,17,12,10,18,14,19,14,18,15,14,12,13,18,10,13,9,16,19,19,16,15,15,8,12,15,13,20,18,17,15,16,14,10,16,17,14,14,12,16,7,9,10,14,14,18,1,14,10,18,DM/M C,311,1,1,1,1,1,1,1,10,14,20,18,10,10,10,14,137438986304,0,0,0,0,0,0,1,0,0,0,0,0,0,0,0,1,0,0,0,0,0,0,0,0,0,0,0,0,0,0,0,0,0,0,0,0,0,1,0,0,0,0,0,0,0,0,0,0,Nigel de Jong,£11.70m ,35.0,174.0,Midfielder - Defensive Midfield,right,Al-Shahania SC,41.0,1.0,0.0,3332.0,36.0,1.0,0.0,2163.0,18.0,1.0,0.0,1433.0,44.0,2.0,3.0,3766.0,30.0,4.0,0.0,2685.0,27.0,0.0,0.0,2323.0,24.0,1.0,0.0,1620.0,12.0,0.0,0.0,832.0,21.0,4.0,0.0,1865.0,Premier League,22.0,0.0,1.0,1934.0,nan,nan,nan,nan
19/6/2011,Nicolas Seube,3504553,769,8/11/1979,31,0,0,0,0,4750,5950,5950,134,132,453353,180,72,DM/M C,1,2,3,2,1,1,2,10,2,3,2,12,14,9,6,9,8,13,13,7,12,11,8,14,12,14,14,15,14,13,11,12,14,8,16,11,13,16,16,12,12,14,10,12,15,15,20,15,12,15,12,14,5,15,7,12,14,14,14,14,14,5,13,12,18,1,12,12,18,DM/M C,311,1,1,1,1,1,1,13,12,12,20,18,10,8,12,12,768,0,0,0,0,0,0,0,0,1,1,0,0,0,0,0,0,0,0,0,0,0,0,0,0,0,0,0,0,0,0,0,0,0,0,0,0,0,0,0,0,0,0,0,0,0,0,0,0,Nicolas Seube,£1.13m ,41.0,180.0,Midfielder - Defensive Midfield,right,Retired,31.0,1.0,0.0,2615.0,39.0,1.0,1.0,3234.0,37.0,0.0,1.0,3058.0,31.0,0.0,0.0,2224.0,27.0,1.0,3.0,2099.0,34.0,0.0,1.0,2258.0,21.0,0.0,0.0,1050.0,nan,nan,nan,nan,nan,nan,nan,nan,Ligue 1,nan,nan,nan,nan,nan,nan,nan,nan
19/6/2011,Nico Pulzetti,7980251,776,2/13/1984,27,0,0,0,0,3000,6100,6100,134,122,299713,176,68,M C,3,2,3,1,3,3,1,1,1,2,3,10,12,12,11,10,10,10,11,3,6,14,12,10,11,11,14,12,12,12,11,12,10,14,13,12,13,12,12,15,14,14,10,8,15,14,20,14,15,16,15,16,5,10,12,19,15,2,19,17,15,3,1,1,20,14,5,5,20,M C,401,1,1,1,14,5,5,1,1,1,1,20,1,1,1,1,274877906948,0,0,1,0,0,0,0,0,0,0,0,0,0,0,0,0,0,0,0,0,0,0,0,0,0,0,0,0,0,0,0,0,0,0,0,0,0,0,1,0,0,0,0,0,0,0,0,0,Nico Pulzetti,£1.35m ,36.0,176.0,Midfielder - Central Midfield,right,Calcio Montebelluna 1909,25.0,2.0,0.0,1316.0,27.0,0.0,2.0,1780.0,8.0,0.0,0.0,290.0,42.0,8.0,5.0,3212.0,9.0,1.0,0.0,364.0,19.0,1.0,0.0,1489.0,31.0,3.0,1.0,1805.0,30.0,4.0,3.0,2214.0,30.0,2.0,0.0,2292.0,Serie A,nan,nan,nan,nan,3.0,0.0,0.0,253.0
19/6/2011,Néstor Susaeta,7450721,796,12/11/1984,26,0,0,0,0,3016,5466,5466,129,112,46726,178,73,M RC,3,2,3,3,1,1,2,1,3,2,3,14,15,14,6,10,15,6,13,10,6,12,14,8,13,6,12,14,13,11,11,12,13,13,8,12,5,10,10,14,14,9,8,8,13,15,20,10,9,10,5,5,7,15,16,10,17,10,18,18,16,5,1,1,20,15,20,10,18,M RC,403,1,1,10,15,10,15,1,1,1,5,18,7,20,1,1,34376515584,0,0,0,0,0,0,0,0,0,0,0,0,0,0,0,0,0,0,0,0,0,0,0,0,1,0,0,0,0,0,0,0,0,0,0,1,0,0,0,0,0,0,0,0,0,0,0,0,Néstor Susaeta,£270Th. ,35.0,178.0,Forward - Right Winger,right,CF Rayo Majadahonda,16.0,3.0,0.0,684.0,9.0,0.0,0.0,361.0,24.0,1.0,1.0,1098.0,35.0,9.0,0.0,2765.0,39.0,8.0,4.0,3216.0,40.0,9.0,14.0,3431.0,40.0,1.0,11.0,3024.0,30.0,1.0,4.0,2057.0,37.0,2.0,7.0,2423.0,LaLiga,28.0,3.0,1.0,1419.0,2.0,0.0,0.0,80.0
19/6/2011,Ness Zamir,42008801,775,10/31/1990,20,0,0,10,1,1600,3960,3600,116,72,15335,178,69,AM LC,1,3,3,2,1,3,3,5,2,3,2,7,9,10,9,9,8,2,7,2,4,11,8,7,13,12,9,2,8,6,10,8,8,17,4,9,2,6,10,12,12,11,9,9,12,12,20,7,2,10,13,10,6,10,11,10,7,13,12,11,14,5,1,1,15,20,13,18,20,AM LC,504,1,1,8,20,18,13,1,1,1,1,15,15,10,1,1,0,0,0,0,0,0,0,0,0,0,0,0,0,0,0,0,0,0,0,0,0,0,0,0,0,0,0,0,0,0,0,0,0,0,0,0,0,0,0,0,0,0,0,0,0,0,0,0,0
19/6/2011,Nenad Milijas,5746845,802,4/30/1983,28,23,4,17,3,5000,6900,6000,140,136,710886,188,85,M LC,1,2,2,2,1,3,2,5,2,1,1,14,15,10,14,15,15,10,18,10,11,15,16,10,15,13,11,14,11,10,16,14,11,14,11,10,10,15,13,12,13,10,13,20,10,11,14,13,13,13,10,12,5,11,14,14,12,13,15,15,11,4,1,1,20,13,1,16,20,M LC,404,1,1,1,13,11,1,1,1,1,14,20,16,1,1,1,69256350464,0,0,0,0,0,0,0,0,1,1,0,1,0,0,0,0,0,0,0,0,0,0,0,0,0,0,0,0,0,1,0,0,0,0,0,0,1,0,0,0,0,0,0,0,0,0,0,0,Nenad Milijas,£1.80m ,37.0,188.0,Midfielder - Central Midfield,left,Retired,30.0,5.0,6.0,2408.0,26.0,3.0,1.0,1221.0,29.0,9.0,11.0,2537.0,36.0,9.0,8.0,3014.0,57.0,24.0,14.0,4891.0,28.0,3.0,9.0,2029.0,10.0,0.0,0.0,270.0,37.0,2.0,6.0,1314.0,8.0,0.0,2.0,241.0,Premier League,nan,nan,nan,nan,nan,nan,nan,nan
19/6/2011,Nadir Minotti,43058969,776,5/16/1992,19,0,0,0,0,50,4500,4500,160,95,176359,182,75,M/AM C,1,1,2,3,1,1,1,2,2,3,2,10,9,11,13,11,7,11,12,5,6,12,12,11,12,13,11,10,11,9,12,10,14,12,12,8,10,10,11,11,11,10,10,8,12,12,20,11,13,14,10,11,5,13,10,13,14,15,12,14,16,6,1,1,18,20,1,1,20,M/AM C,521,1,1,1,20,1,1,1,1,1,15,18,1,1,1,1,0,0,0,0,0,0,0,0,0,0,0,0,0,0,0,0,0,0,0,0,0,0,0,0,0,0,0,0,0,0,0,0,0,0,0,0,0,0,0,0,0,0,0,0,0,0,0,0,0,Nadir Minotti,£675Th. ,28.0,188.0,Midfielder - Defensive Midfield,right,FC Lumezzane,29.0,13.0,0.0,2301.0,12.0,1.0,0.0,852.0,25.0,1.0,0.0,1413.0,25.0,2.0,0.0,1549.0,28.0,1.0,2.0,2013.0,26.0,1.0,0.0,1674.0,32.0,4.0,2.0,2394.0,nan,nan,nan,nan,nan,nan,nan,nan,Serie A,nan,nan,nan,nan,nan,nan,nan,nan
19/6/2011,Nacho Cases,67018616,796,12/22/1987,23,0,0,0,0,4150,6150,6150,143,128,428653,172,65,M C,1,2,3,1,3,1,3,3,1,2,3,13,11,13,8,13,13,7,12,9,10,15,10,13,14,7,14,13,13,13,15,15,10,14,9,13,9,11,13,13,13,15,8,20,11,12,7,13,12,14,7,12,9,10,9,14,5,7,14,9,7,13,1,1,20,10,5,5,20,M C,401,1,1,1,10,2,2,1,1,1,10,20,5,5,1,1,0,0,0,0,0,0,0,0,0,0,0,0,0,0,0,0,0,0,0,0,0,0,0,0,0,0,0,0,0,0,0,0,0,0,0,0,0,0,0,0,0,0,0,0,0,0,0,0,0,Nacho Cases,£1.62m ,32.0,175.0,Midfielder - Central Midfield,left,AEK Larnaca,36.0,4.0,2.0,2978.0,22.0,0.0,5.0,1422.0,34.0,3.0,1.0,2546.0,28.0,2.0,5.0,2136.0,33.0,2.0,3.0,2774.0,25.0,1.0,0.0,2012.0,23.0,2.0,1.0,1642.0,25.0,0.0,1.0,1289.0,25.0,1.0,0.0,1595.0,LaLiga,26.0,2.0,2.0,1654.0,nan,nan,nan,nan
19/6/2011,Mubarak Wakaso,12006112,21,7/25/1990,20,0,0,0,0,4250,5489,6250,148,122,680661,169,67,DM/M LC,1,1,1,3,3,3,3,3,1,1,1,12,13,12,8,11,11,5,14,8,10,13,9,13,12,18,11,16,7,8,12,9,14,12,6,12,8,13,17,16,16,13,6,20,17,14,7,18,11,12,14,10,5,9,9,11,9,7,8,8,7,14,10,12,20,9,1,15,20,DM/M LC,424,1,1,1,8,9,1,1,10,1,16,20,15,1,12,1,137573302272,0,0,0,0,0,0,0,0,0,0,0,0,0,0,0,0,0,1,0,0,0,0,0,0,0,0,0,1,0,0,0,0,0,0,0,0,0,1,0,0,0,0,0,0,0,0,0,0,Mubarak Wakaso,£1.80m ,30.0,171.0,Midfielder - Central Midfield,left,Jiangsu Suning,38.0,3.0,1.0,2011.0,10.0,0.0,0.0,311.0,27.0,3.0,6.0,1917.0,18.0,2.0,2.0,841.0,13.0,1.0,1.0,849.0,24.0,2.0,2.0,1204.0,27.0,2.0,3.0,2158.0,24.0,0.0,2.0,1374.0,29.0,1.0,1.0,1663.0,LaLiga,32.0,0.0,1.0,2466.0,nan,nan,nan,nan
19/6/2011,Moussa Sissoko,8448722,769,8/16/1989,21,2,0,11,2,6600,6569,6550,165,146,5191698,187,83,DM/M C,3,3,1,3,1,1,1,4,2,2,1,6,9,13,11,14,11,13,15,5,12,14,8,11,14,11,15,14,14,14,14,12,17,11,10,12,12,12,16,16,13,16,14,8,15,13,20,17,16,13,11,15,7,8,11,15,14,11,13,14,14,6,1,1,20,14,14,12,20,DM/M C,421,1,1,5,10,12,14,1,1,1,16,20,12,14,1,1,292,0,0,1,0,0,1,0,0,1,0,0,0,0,0,0,0,0,0,0,0,0,0,0,0,0,0,0,0,0,0,0,0,0,0,0,0,0,0,0,0,0,0,0,0,0,0,0,0,Moussa Sissoko,£8.55m ,31.0,187.0,Midfielder - Central Midfield,right,Tottenham Hotspur,38.0,6.0,2.0,3167.0,37.0,2.0,3.0,3066.0,40.0,4.0,4.0,3461.0,38.0,3.0,6.0,3242.0,38.0,5.0,2.0,3275.0,39.0,1.0,8.0,3402.0,34.0,0.0,4.0,1307.0,47.0,2.0,5.0,2431.0,44.0,0.0,4.0,3403.0,Ligue 1,35.0,2.0,2.0,2873.0,7.0,0.0,0.0,430.0
19/6/2011,Morten Gamst Pedersen,751770,786,9/8/1981,29,68,15,18,10,6000,7250,7250,152,134,1928584,183,74,M/AM RLC,2,3,3,1,3,3,3,9,2,3,2,19,16,8,12,14,14,10,14,18,8,12,12,8,14,8,14,8,12,13,14,12,13,14,5,12,14,17,17,12,14,14,14,20,17,10,16,16,12,8,11,13,5,12,14,12,14,10,16,10,13,5,1,8,20,17,16,20,18,M/AM RLC,416,1,1,10,17,17,16,1,1,1,1,18,20,16,8,1,1125968626320128,0,0,0,0,0,0,0,0,1,1,0,0,0,0,0,0,0,0,0,0,0,0,0,0,0,0,0,0,0,0,0,0,0,0,0,0,1,0,0,0,0,0,0,0,0,0,0,0,Morten Gamst Pedersen,£4.05m ,39.0,183.0,Midfielder - Central Midfield,left,Alta IF,39.0,4.0,7.0,2878.0,37.0,4.0,10.0,3224.0,33.0,1.0,7.0,1999.0,40.0,4.0,8.0,2384.0,11.0,1.0,2.0,616.0,9.0,0.0,0.0,415.0,26.0,2.0,11.0,2229.0,29.0,1.0,6.0,2670.0,32.0,1.0,9.0,2514.0,Premier League,12.0,7.0,0.0,985.0,nan,nan,nan,nan
19/6/2011,Moritz Stoppelkamp,8728271,771,12/11/1986,24,0,0,0,0,4000,6500,6500,137,130,921099,180,79,M/AM RC,1,3,1,3,1,1,1,10,3,1,2,10,11,12,11,11,9,8,12,11,9,12,10,11,11,11,13,14,11,12,11,11,10,6,10,12,11,17,15,13,13,12,10,16,11,13,20,17,10,13,8,12,7,13,9,5,14,13,13,10,9,8,1,1,19,20,20,14,18,M/AM RC,523,1,1,1,18,14,20,1,1,1,12,16,14,19,1,1,0,0,0,0,0,0,0,0,0,0,0,0,0,0,0,0,0,0,0,0,0,0,0,0,0,0,0,0,0,0,0,0,0,0,0,0,0,0,0,0,0,0,0,0,0,0,0,0,0,Moritz Stoppelkamp,£900Th. ,33.0,180.0,Forward - Right Winger,right,MSV Duisburg,24.0,0.0,0.0,1091.0,28.0,2.0,0.0,721.0,36.0,9.0,12.0,3039.0,36.0,7.0,13.0,3201.0,28.0,4.0,2.0,2299.0,31.0,6.0,2.0,2233.0,24.0,4.0,2.0,2134.0,33.0,9.0,8.0,2825.0,29.0,3.0,2.0,2039.0,Bundesliga,36.0,19.0,12.0,3118.0,nan,nan,nan,nan
19/6/2011,Moritz Leitner,16020473,771,12/8/1992,18,0,0,0,0,3150,6000,6000,139,120,18181818,174,65,M/AM RLC,1,2,2,1,3,1,2,4,3,3,2,9,13,14,7,13,13,5,13,2,5,14,6,5,14,9,10,14,11,11,13,11,12,13,4,13,4,13,14,14,16,8,7,15,12,13,20,10,7,8,3,8,4,17,9,14,11,9,13,12,13,9,1,1,19,20,18,18,20,M/AM RLC,526,1,1,1,20,16,16,1,1,1,12,19,18,18,1,1,268435456,0,0,0,0,0,0,0,0,0,0,0,0,0,0,0,0,0,0,0,0,0,0,0,0,0,0,0,0,1,0,0,0,0,0,0,0,0,0,0,0,0,0,0,0,0,0,0,0,Moritz Leitner,£3.60m ,27.0,174.0,Midfielder - Central Midfield,right,Norwich City,27.0,0.0,5.0,1318.0,25.0,0.0,3.0,998.0,31.0,0.0,3.0,1222.0,24.0,1.0,2.0,1751.0,21.0,1.0,2.0,1208.0,21.0,3.0,6.0,1087.0,8.0,0.0,0.0,248.0,12.0,0.0,0.0,863.0,31.0,2.0,2.0,1802.0,Bundesliga,10.0,0.0,0.0,805.0,1.0,0.0,0.0,45.0
19/6/2011,Morgan Amalfitano,8434344,769,3/20/1985,26,0,0,0,0,5150,6479,6450,150,144,1193461,176,68,M/AM RC,2,3,1,2,2,3,1,2,2,2,2,12,14,14,10,15,13,9,13,7,6,15,11,9,15,12,14,14,13,13,16,13,16,14,8,12,12,11,15,15,13,13,8,12,18,12,20,18,12,16,12,14,5,17,16,15,12,14,17,13,8,10,1,1,20,16,16,10,20,M/AM RC,413,1,1,14,15,10,16,1,1,1,10,20,10,16,1,1,2251799813816448,0,0,0,0,0,0,0,1,0,0,0,0,0,0,0,0,0,1,0,0,0,0,0,0,0,0,0,0,0,0,0,0,0,0,0,0,0,0,0,0,0,0,0,0,0,0,0,0,Morgan Amalfitano,£6.30m ,35.0,178.0,Forward - Right Winger,right,Retired,42.0,5.0,16.0,3835.0,49.0,2.0,10.0,3683.0,36.0,1.0,6.0,2513.0,32.0,4.0,4.0,2228.0,28.0,3.0,2.0,1352.0,21.0,2.0,1.0,1450.0,25.0,1.0,0.0,1294.0,15.0,0.0,0.0,767.0,nan,nan,nan,nan,Ligue 1,nan,nan,nan,nan,nan,nan,nan,nan
19/6/2011,Moisés Hurtado,814312,796,2/20/1981,30,0,0,0,0,3000,6000,6000,145,120,317646,185,85,DM/M C,2,2,3,3,3,1,1,6,1,1,1,8,7,10,8,14,10,14,14,9,12,14,10,13,12,14,12,15,11,12,12,13,14,10,13,8,14,15,16,9,8,14,13,10,10,10,20,13,14,14,10,12,12,14,6,13,18,16,15,12,14,4,10,5,19,1,10,1,19,DM/M C,311,1,1,1,1,1,1,10,1,10,20,19,1,5,1,5,576,0,0,0,0,0,0,1,0,0,1,0,0,0,0,0,0,0,0,0,0,0,0,0,0,0,0,0,0,0,0,0,0,0,0,0,0,0,0,0,0,0,0,0,0,0,0,0,0,Moisés Hurtado,£1.35m ,39.0,185.0,Midfielder - Defensive Midfield,right,Retired,18.0,0.0,0.0,1147.0,18.0,0.0,0.0,1382.0,12.0,1.0,0.0,880.0,3.0,1.0,0.0,240.0,nan,nan,nan,nan,nan,nan,nan,nan,nan,nan,nan,nan,nan,nan,nan,nan,nan,nan,nan,nan,LaLiga,nan,nan,nan,nan,nan,nan,nan,nan
19/6/2011,Mohamed Sissoko,919990,31,1/22/1985,26,28,2,0,0,6100,7000,6300,150,140,2529644,187,81,DM/M C,2,2,3,3,1,1,3,4,1,2,1,5,8,11,5,11,5,13,8,10,14,12,7,17,14,15,14,15,10,11,11,10,15,8,11,8,13,15,18,14,13,18,13,12,9,15,20,17,18,15,14,13,15,10,15,16,14,11,9,13,10,9,1,1,17,1,12,1,17,DM/M C,311,1,1,1,1,1,1,1,1,1,20,17,1,12,1,1,137438953536,0,0,0,0,0,0,1,0,0,0,0,0,0,0,0,0,0,0,0,0,0,0,0,0,0,0,0,0,0,0,0,0,0,0,0,0,0,1,0,0,0,0,0,0,0,0,0,0,Mohamed Sissoko,£6.75m ,35.0,191.0,Midfielder - Defensive Midfield,right,Retired,29.0,0.0,2.0,1599.0,30.0,2.0,1.0,2150.0,12.0,0.0,0.0,448.0,10.0,0.0,0.0,427.0,36.0,1.0,1.0,2318.0,13.0,2.0,0.0,1170.0,28.0,5.0,3.0,2384.0,14.0,1.0,0.0,1061.0,16.0,0.0,0.0,560.0,Ligue 1,nan,nan,nan,nan,nan,nan,nan,nan
19/6/2011,Mohamed Diamé,8434183,41,6/14/1987,24,3,0,0,0,4750,7000,6750,153,140,1537029,181,71,DM/M C,2,3,3,2,3,3,3,1,3,2,1,4,11,13,6,14,4,13,11,5,12,14,4,17,12,14,15,16,15,8,13,7,15,6,8,6,18,15,18,14,12,17,11,9,15,15,20,18,19,11,12,10,12,8,15,12,12,11,15,10,8,10,10,1,20,1,1,1,20,DM/M C,311,1,1,1,1,1,1,10,1,1,20,20,1,1,1,1,9075265896448,0,0,0,0,0,0,0,0,0,0,0,0,0,0,0,0,0,0,0,0,0,0,0,0,0,0,0,0,0,0,0,0,1,0,0,0,0,0,1,0,0,0,0,1,0,0,0,0,Mohamed Diamé,£4.50m ,33.0,184.0,Midfielder - Central Midfield,right,Al-Ahli SC,40.0,3.0,3.0,2997.0,26.0,3.0,0.0,1595.0,34.0,3.0,0.0,2670.0,41.0,4.0,4.0,2816.0,16.0,4.0,0.0,1053.0,45.0,10.0,4.0,3143.0,41.0,6.0,3.0,2773.0,33.0,2.0,0.0,2181.0,29.0,0.0,0.0,2165.0,Premier League,22.0,0.0,2.0,1980.0,4.0,0.0,0.0,350.0
19/6/2011,Miralem Pjanic,8438112,759,4/2/1990,21,24,3,0,0,5700,7755,6350,160,141,7509499,180,68,M/AM C,1,2,1,3,3,3,3,2,1,1,1,14,14,14,8,16,14,10,14,7,5,15,12,5,16,7,12,10,14,12,16,13,15,13,8,13,8,14,11,15,14,13,10,12,13,13,20,14,11,13,7,16,8,10,13,16,13,12,15,14,14,7,1,1,18,20,14,12,20,M/AM C,521,1,1,1,20,12,14,1,1,1,10,18,12,14,1,1,5243008,0,0,0,0,0,0,0,1,0,0,0,0,0,0,0,0,0,0,0,0,1,0,1,0,0,0,0,0,0,0,0,0,0,0,0,0,0,0,0,0,0,0,0,0,0,0,0,0,Miralem Pjanic,£11.25m ,30.0,180.0,Midfielder - Defensive Midfield,right,FC Barcelona,39.0,4.0,3.0,1956.0,36.0,4.0,12.0,2724.0,29.0,4.0,8.0,1899.0,38.0,6.0,6.0,2809.0,46.0,5.0,10.0,3347.0,41.0,12.0,11.0,3343.0,47.0,8.0,14.0,3428.0,44.0,7.0,11.0,3569.0,44.0,4.0,8.0,3275.0,Serie A,43.0,3.0,8.0,3350.0,3.0,0.0,0.0,103.0
19/6/2011,Mikel Rico,1502244,796,11/4/1984,26,0,0,0,0,2512,5864,5864,128,122,279373,178,75,M RC,3,3,1,3,3,3,2,1,2,3,3,10,9,10,12,14,8,7,12,7,12,13,11,12,14,10,12,13,14,12,12,12,10,12,9,12,12,15,15,12,12,13,11,9,14,12,20,15,12,16,9,13,8,9,5,18,6,7,15,14,9,11,13,10,20,15,17,11,20,M RC,403,1,1,5,15,6,12,1,1,13,14,20,11,17,4,10,0,0,0,0,0,0,0,0,0,0,0,0,0,0,0,0,0,0,0,0,0,0,0,0,0,0,0,0,0,0,0,0,0,0,0,0,0,0,0,0,0,0,0,0,0,0,0,0,0,Mikel Rico,£2.25m ,35.0,178.0,Midfielder - Central Midfield,right,SD Huesca,46.0,2.0,0.0,4071.0,38.0,3.0,3.0,3194.0,39.0,2.0,0.0,3423.0,39.0,7.0,2.0,3039.0,54.0,3.0,2.0,4186.0,30.0,2.0,3.0,1342.0,23.0,1.0,0.0,714.0,25.0,0.0,0.0,1559.0,4.0,0.0,0.0,242.0,LaLiga,42.0,7.0,5.0,3241.0,3.0,0.0,0.0,225.0
19/6/2011,Mikel Arteta,6701089,796,3/28/1982,29,0,0,7,1,6600,7400,7900,166,159,20234440,176,64,M/AM RC,3,1,1,2,3,2,1,4,2,1,2,14,17,15,12,17,15,7,12,3,11,16,17,10,17,13,14,9,16,15,16,15,14,15,12,14,13,14,15,12,14,15,9,14,15,13,20,14,11,14,10,13,11,14,17,15,17,15,16,10,14,7,1,1,20,17,17,13,20,M/AM RC,413,1,1,1,13,13,17,1,1,1,13,20,13,17,1,1,21495824,0,0,0,0,1,0,0,0,0,0,0,0,0,0,0,0,0,0,0,1,0,0,1,0,1,0,0,0,0,0,0,0,0,0,0,0,0,0,0,0,0,0,0,0,0,0,0,0,Mikel Arteta,£13.05m ,38.0,177.0,Midfielder - Central Midfield,right,Retired,33.0,3.0,4.0,2764.0,41.0,8.0,3.0,3429.0,43.0,6.0,6.0,3795.0,43.0,3.0,0.0,3428.0,13.0,1.0,1.0,854.0,15.0,0.0,1.0,416.0,nan,nan,nan,nan,nan,nan,nan,nan,nan,nan,nan,nan,Premier League,nan,nan,nan,nan,nan,nan,nan,nan
19/6/2011,Mikel Aranburu,6700155,796,2/18/1979,32,0,0,4,0,4600,6400,6400,148,132,247161,178,72,M C,1,1,2,1,3,1,3,5,2,2,3,11,12,15,11,13,7,7,13,6,9,14,11,13,16,10,13,14,13,12,12,13,14,14,13,10,13,13,14,9,14,12,9,15,8,12,20,14,12,11,7,14,6,17,8,15,20,14,16,15,10,4,1,1,20,14,12,13,20,M C,401,1,1,1,14,13,12,1,1,1,14,20,11,11,1,1,17592186046464,0,0,0,0,0,0,0,0,0,0,0,1,0,0,0,0,0,0,0,0,0,0,0,0,0,0,0,0,0,0,0,0,0,0,0,0,0,0,0,0,0,0,0,0,1,0,0,0,Mikel Aranburu,£2.25m ,41.0,180.0,Midfielder - Defensive Midfield,both,Retired,34.0,5.0,2.0,2415.0,32.0,3.0,2.0,2283.0,nan,nan,nan,nan,nan,nan,nan,nan,nan,nan,nan,nan,nan,nan,nan,nan,nan,nan,nan,nan,nan,nan,nan,nan,nan,nan,nan,nan,LaLiga,nan,nan,nan,nan,nan,nan,nan,nan
19/6/2011,Miguel Veloso,744536,788,5/11/1986,25,14,1,12,3,6250,7500,6900,155,139,1895157,180,79,DM/M C,1,1,1,2,2,2,2,7,3,1,1,15,12,11,10,15,17,10,14,7,11,15,13,13,17,11,16,11,15,15,15,13,10,10,12,11,16,14,14,11,12,15,11,20,11,11,8,13,13,14,9,13,6,13,14,15,12,17,11,14,12,8,10,9,18,1,1,10,18,DM/M C,311,1,8,1,1,1,1,10,10,1,20,18,10,1,9,1,73018638848,0,0,0,0,0,0,0,0,0,1,0,0,0,0,0,0,0,0,0,0,0,0,1,0,0,0,0,0,0,0,0,0,1,0,0,0,1,0,0,0,0,0,0,0,0,0,0,0,Miguel Veloso,£9.00m ,34.0,180.0,Midfielder - Defensive Midfield,left,Hellas Verona,23.0,0.0,5.0,1433.0,31.0,2.0,1.0,2273.0,37.0,3.0,8.0,3223.0,32.0,2.0,5.0,2678.0,28.0,6.0,1.0,1714.0,30.0,3.0,6.0,2282.0,25.0,1.0,5.0,1993.0,23.0,1.0,0.0,1861.0,22.0,0.0,1.0,1294.0,Serie A,35.0,3.0,6.0,2936.0,2.0,0.0,0.0,180.0
19/6/2011,Miguel Pallardó,67004759,796,9/5/1986,24,0,0,0,0,4264,6271,6271,142,126,187929,173,73,DM/M C,2,2,1,3,2,2,1,2,3,2,3,7,8,10,7,13,10,8,8,5,13,13,12,15,11,12,15,15,12,16,11,15,13,11,8,11,15,15,16,12,13,14,8,5,14,13,20,16,13,15,12,14,6,11,12,12,12,14,16,15,12,8,1,1,19,1,5,1,19,DM/M C,311,1,1,1,1,1,1,1,1,1,20,19,1,5,1,1,4294967360,0,0,0,0,0,0,1,0,0,0,0,0,0,0,0,0,0,0,0,0,0,0,0,0,0,0,0,0,0,0,0,0,1,0,0,0,0,0,0,0,0,0,0,0,0,0,0,0,Miguel Pallardó,£1.35m ,34.0,174.0,Midfielder - Central Midfield,right,Without Club,29.0,0.0,0.0,1996.0,14.0,1.0,1.0,590.0,24.0,0.0,0.0,725.0,4.0,0.0,0.0,145.0,24.0,1.0,3.0,1792.0,19.0,0.0,0.0,1091.0,4.0,0.0,0.0,160.0,6.0,0.0,0.0,203.0,nan,nan,nan,nan,LaLiga,nan,nan,nan,nan,nan,nan,nan,nan
19/6/2011,Mickaël Tavares,8431842,41,10/25/1982,28,8,0,0,0,3250,5400,5400,130,108,64266,185,75,M C,1,1,2,1,1,3,1,1,1,3,1,5,10,12,7,13,6,10,7,8,10,15,8,12,15,6,13,7,13,7,10,8,12,7,10,9,11,11,7,16,15,12,12,7,12,14,20,13,14,8,10,9,8,6,16,12,10,16,14,14,14,8,1,1,20,1,1,1,20,M C,401,1,1,1,1,1,1,1,1,1,15,20,1,1,1,1,279172874240,0,0,0,0,0,0,0,0,0,0,0,0,0,0,0,0,0,0,0,0,0,0,0,0,0,0,0,0,0,0,0,0,1,0,0,0,0,0,1,0,0,0,0,0,0,0,0,0,MickaÃ«l Tavares,£180Th. ,38.0,185.0,Midfielder - Defensive Midfield,right,US SÃ©nart-Moissy,13.0,0.0,0.0,906.0,1.0,0.0,0.0,90.0,4.0,0.0,0.0,360.0,10.0,0.0,0.0,730.0,27.0,0.0,0.0,2209.0,25.0,1.0,1.0,1884.0,8.0,0.0,0.0,665.0,nan,nan,nan,nan,nan,nan,nan,nan,Bundesliga,nan,nan,nan,nan,nan,nan,nan,nan
19/6/2011,Mickaël Isabey,3503380,769,2/20/1975,36,0,0,0,0,3750,4700,4700,140,105,25179,169,64,AM C,2,1,3,3,2,3,3,1,2,3,3,13,13,12,7,14,13,8,12,7,5,14,12,6,14,5,12,11,13,11,13,12,12,11,13,11,9,15,10,12,13,11,5,12,11,9,20,8,8,11,5,15,7,10,9,11,16,14,15,15,15,6,1,1,15,20,13,10,20,AM C,501,1,1,1,20,10,13,1,1,1,1,15,10,13,1,1,0,0,0,0,0,0,0,0,0,0,0,0,0,0,0,0,0,0,0,0,0,0,0,0,0,0,0,0,0,0,0,0,0,0,0,0,0,0,0,0,0,0,0,0,0,0,0,0,0
19/6/2011,Michu,1509232,796,3/21/1986,25,0,0,0,0,3700,5700,5700,130,116,237154,191,78,M/AM C,3,3,3,1,2,1,3,7,2,2,3,11,10,11,10,13,13,13,13,5,7,13,11,9,13,8,12,9,9,9,12,12,14,13,10,12,9,12,14,12,10,14,16,20,12,12,10,14,15,13,5,9,7,12,8,10,8,10,13,15,16,9,1,1,20,17,1,1,20,M/AM C,411,1,1,9,17,1,1,1,1,1,12,20,1,1,1,1,2147483904,0,0,0,0,0,0,0,0,1,0,0,0,0,0,0,0,0,0,0,0,0,0,0,0,0,0,0,0,0,0,0,1,0,0,0,0,0,0,0,0,0,0,0,0,0,0,0,0,Michu,£5.40m ,34.0,185.0,Forward - Second Striker,left,Retired,35.0,7.0,0.0,1947.0,39.0,17.0,4.0,3405.0,43.0,22.0,5.0,3566.0,24.0,6.0,6.0,1852.0,6.0,0.0,1.0,240.0,nan,nan,nan,nan,28.0,3.0,1.0,1299.0,nan,nan,nan,nan,nan,nan,nan,nan,LaLiga,nan,nan,nan,nan,nan,nan,nan,nan
19/6/2011,Michele Pazienza,3802360,776,8/5/1982,28,0,0,0,0,5250,6950,6950,140,138,813840,178,75,DM/M C,3,1,1,1,1,1,1,5,2,2,2,9,9,9,8,12,6,11,9,13,14,14,7,15,11,17,14,15,9,14,14,13,15,7,7,12,15,17,17,13,15,14,8,7,11,13,20,17,13,15,17,15,6,11,14,14,14,14,16,13,11,4,1,1,17,1,1,1,17,DM/M C,311,1,1,1,1,1,1,1,1,1,20,17,1,1,1,1,32768,0,0,0,0,0,0,0,0,0,0,0,0,0,0,0,1,0,0,0,0,0,0,0,0,0,0,0,0,0,0,0,0,0,0,0,0,0,0,0,0,0,0,0,0,0,0,0,0,Michele Pazienza,£3.60m ,38.0,175.0,Midfielder - Defensive Midfield,right,Retired,39.0,1.0,2.0,3000.0,28.0,1.0,0.0,1799.0,17.0,0.0,2.0,1041.0,24.0,1.0,1.0,1628.0,nan,nan,nan,nan,13.0,0.0,1.0,666.0,25.0,1.0,0.0,2028.0,nan,nan,nan,nan,nan,nan,nan,nan,Serie A,nan,nan,nan,nan,nan,nan,nan,nan
19/6/2011,Míchel,1507887,796,11/8/1985,25,0,0,0,0,3350,6300,6300,137,126,162747,183,74,M C,2,2,1,2,1,1,3,5,3,3,2,9,8,11,10,12,8,12,14,11,13,14,10,14,12,14,11,16,13,11,12,12,12,8,11,10,12,14,12,12,13,13,11,12,14,12,20,13,13,13,12,12,7,12,8,13,13,10,10,9,8,6,1,1,20,10,1,1,20,M C,401,1,1,1,10,1,1,1,1,1,14,20,1,1,1,1,64,0,0,0,0,0,0,1,0,0,0,0,0,0,0,0,0,0,0,0,0,0,0,0,0,0,0,0,0,0,0,0,0,0,0,0,0,0,0,0,0,0,0,0,0,0,0,0,0,Míchel,£2.25m ,34.0,183.0,Midfielder - Central Midfield,right,Marino Luanco,21.0,1.0,1.0,1375.0,24.0,1.0,1.0,1818.0,19.0,0.0,0.0,1244.0,17.0,0.0,0.0,1112.0,26.0,1.0,0.0,1537.0,25.0,4.0,0.0,1712.0,34.0,6.0,5.0,2643.0,35.0,6.0,3.0,2785.0,36.0,8.0,5.0,2700.0,LaLiga,25.0,1.0,4.0,1933.0,2.0,0.0,0.0,66.0
19/6/2011,Michael Tonge,5104899,765,4/7/1983,28,0,0,2,0,3050,5750,5950,128,119,274474,183,75,M RLC,3,1,2,3,3,1,2,5,2,1,2,12,14,14,8,15,13,8,14,5,6,14,7,8,15,11,10,8,10,14,14,12,12,13,4,12,8,14,13,11,15,10,11,12,12,10,20,12,12,12,5,12,5,10,4,10,15,10,15,8,16,1,1,1,20,10,16,15,20,M RLC,406,1,1,1,1,1,10,1,1,1,1,20,15,16,1,1,257,1,0,0,0,0,0,0,0,1,0,0,0,0,0,0,0,0,0,0,0,0,0,0,0,0,0,0,0,0,0,0,0,0,0,0,0,0,0,0,0,0,0,0,0,0,0,0,0,Michael Tonge,£450Th. ,37.0,183.0,Midfielder - Central Midfield,left,Retired,9.0,1.0,1.0,696.0,11.0,0.0,0.0,608.0,40.0,5.0,1.0,3185.0,25.0,0.0,1.0,1687.0,18.0,0.0,0.0,1085.0,30.0,2.0,2.0,2563.0,31.0,1.0,2.0,1471.0,38.0,4.0,4.0,2972.0,1.0,0.0,0.0,16.0,Premier League,nan,nan,nan,nan,nan,nan,nan,nan
19/6/2011,Michael Carrick,122025,765,7/28/1981,29,22,0,14,2,6400,7250,7550,162,150,2215421,185,75,DM/M C,2,1,1,1,3,3,1,8,3,2,3,12,11,7,9,16,10,10,11,8,14,18,14,13,16,6,16,8,14,13,15,15,12,6,4,10,14,17,13,11,12,14,13,15,15,12,20,15,13,12,7,12,5,8,8,15,14,13,15,18,19,1,5,1,20,6,1,1,20,DM/M C,421,1,1,1,6,1,1,5,1,1,18,20,1,1,1,1,4299685888,0,0,0,0,0,0,0,0,0,0,0,0,0,0,0,0,0,0,0,1,0,0,1,0,0,0,0,0,0,0,0,0,1,0,0,0,0,0,0,0,0,0,0,0,0,0,0,0,Michael Carrick,£12.60m ,39.0,189.0,Midfielder - Defensive Midfield,both,Retired,44.0,0.0,1.0,3389.0,41.0,2.0,4.0,3362.0,46.0,2.0,6.0,3764.0,40.0,1.0,0.0,3332.0,21.0,1.0,2.0,1655.0,42.0,0.0,1.0,3039.0,38.0,1.0,1.0,2696.0,5.0,0.0,0.0,379.0,nan,nan,nan,nan,Premier League,nan,nan,nan,nan,nan,nan,nan,nan
19/6/2011,Michael Bradley,980486,390,7/31/1987,23,59,9,25,5,6500,6550,6500,145,130,379447,185,82,DM/M C,1,1,1,1,1,1,1,1,1,1,1,6,9,7,15,11,10,12,13,9,17,11,13,14,10,17,17,18,9,9,10,8,17,6,13,16,11,18,19,8,10,14,14,12,16,16,20,19,13,10,14,17,12,13,15,18,8,12,19,9,7,4,1,1,20,14,8,8,20,DM/M C,421,1,1,1,14,1,1,1,1,1,17,20,8,8,1,1,139586469984,0,0,0,0,0,1,1,0,0,0,0,0,0,0,0,1,0,0,0,0,0,0,0,0,0,0,0,0,0,0,0,1,0,0,0,0,0,1,0,0,0,0,0,0,0,0,0,0,Michael Bradley,£3.15m ,33.0,189.0,Midfielder - Central Midfield,right,Toronto FC,27.0,4.0,3.0,2030.0,36.0,1.0,1.0,3043.0,35.0,1.0,2.0,2682.0,38.0,4.0,1.0,2963.0,28.0,5.0,3.0,2504.0,30.0,2.0,4.0,2760.0,38.0,0.0,3.0,3420.0,43.0,0.0,4.0,3847.0,35.0,3.0,1.0,3152.0,Serie A,10.0,0.0,0.0,880.0,nan,nan,nan,nan
19/6/2011,Michael Ballack,12415,771,9/26/1976,34,98,42,19,7,7500,7100,7100,178,150,693155,189,88,M/AM C,2,1,2,2,2,2,2,8,3,3,2,11,14,8,13,14,13,18,15,8,12,15,20,12,14,10,18,15,19,19,11,16,19,7,16,14,15,15,11,7,7,14,16,19,16,12,20,11,17,15,12,19,12,13,11,17,14,20,19,11,7,10,1,1,20,19,10,10,20,M/AM C,411,1,10,1,19,1,1,1,1,1,15,20,10,10,1,1,71434336,0,0,0,0,0,1,1,0,0,0,0,0,0,0,0,0,0,1,0,0,0,0,1,0,0,0,1,0,0,0,0,0,0,0,0,0,0,0,0,0,0,0,0,0,0,0,0,0
19/6/2011,Mesut Özil,35002219,771,10/15/1988,22,26,4,16,5,8250,8800,8450,182,166,0,183,76,AM LC,2,2,2,2,2,2,1,8,2,1,1,14,15,17,10,18,12,5,11,6,4,19,13,5,18,5,17,7,13,14,18,18,6,17,5,19,6,17,8,18,17,11,9,20,10,16,10,11,9,10,4,12,6,10,8,17,5,13,14,11,18,12,1,1,15,20,11,16,20,AM LC,504,1,1,10,20,16,11,1,1,1,1,15,15,10,1,1,18350224,0,0,0,0,1,0,0,1,0,0,0,0,0,0,0,0,0,0,0,1,1,0,0,0,1,0,0,0,0,0,0,0,0,0,0,0,0,0,0,0,0,0,0,0,0,0,0,0,Mesut Özil,£28.80m ,32.0,180.0,Midfielder - Attacking Midfield,left,Arsenal FC,54.0,10.0,29.0,3907.0,52.0,7.0,28.0,3850.0,52.0,10.0,24.0,3549.0,42.0,7.0,14.0,3367.0,32.0,5.0,9.0,2711.0,45.0,8.0,20.0,3940.0,44.0,12.0,14.0,3746.0,35.0,5.0,14.0,2953.0,35.0,6.0,3.0,2420.0,LaLiga,23.0,1.0,3.0,1812.0,nan,nan,nan,nan
19/6/2011,Mehmet Ekici,29022517,799,3/25/1990,21,4,0,0,0,5000,6750,6750,155,135,3935936,180,70,M/AM C,1,3,3,3,1,1,1,9,2,1,3,18,17,12,14,18,14,6,13,6,9,16,15,8,18,11,12,10,16,12,13,9,16,12,9,8,11,10,14,12,16,17,9,10,11,12,20,13,10,8,7,11,10,15,5,14,5,17,17,14,13,6,1,1,20,17,13,11,20,M/AM C,411,1,1,8,17,10,12,1,1,1,14,20,11,13,1,1,4503600739385344,0,0,0,0,0,0,0,0,0,0,0,0,0,0,0,0,0,0,0,1,0,0,1,0,0,1,0,0,0,0,1,0,0,0,0,0,0,0,0,0,0,0,0,0,0,0,0,0,Mehmet Ekici,£4.50m ,30.0,180.0,Midfielder - Attacking Midfield,both,Without Club,36.0,4.0,11.0,2824.0,22.0,1.0,4.0,972.0,9.0,2.0,0.0,463.0,12.0,1.0,0.0,658.0,42.0,10.0,14.0,3261.0,22.0,5.0,3.0,1679.0,19.0,3.0,1.0,1551.0,11.0,0.0,1.0,426.0,25.0,5.0,2.0,1288.0,Bundesliga,13.0,0.0,2.0,716.0,nan,nan,nan,nan
19/6/2011,Mehdi Lacen,918888,5,5/15/1984,27,9,0,0,0,4750,6500,6500,136,133,656836,176,74,M C,3,1,1,3,2,2,3,2,2,1,2,7,9,10,7,12,13,12,13,12,12,12,11,15,12,15,15,16,9,13,12,11,15,8,12,12,11,17,18,13,14,13,10,20,17,13,7,19,15,14,14,15,7,14,17,14,8,15,15,9,8,10,11,12,20,8,1,12,20,M C,401,1,1,1,8,1,1,1,11,1,15,20,12,1,12,1,32,0,0,0,0,0,1,0,0,0,0,0,0,0,0,0,0,0,0,0,0,0,0,0,0,0,0,0,0,0,0,0,0,0,0,0,0,0,0,0,0,0,0,0,0,0,0,0,0,Mehdi Lacen,£3.15m ,36.0,176.0,Midfielder - Defensive Midfield,left,Retired,34.0,1.0,3.0,2456.0,34.0,1.0,2.0,2468.0,23.0,0.0,0.0,1188.0,23.0,0.0,2.0,1442.0,30.0,2.0,2.0,2600.0,32.0,0.0,0.0,2697.0,39.0,1.0,2.0,2891.0,19.0,0.0,0.0,1120.0,15.0,0.0,0.0,764.0,LaLiga,nan,nan,nan,nan,nan,nan,nan,nan
19/6/2011,McDonald Mariga,8117342,25,4/4/1987,24,27,3,0,0,5000,6500,6750,150,135,162458,188,86,DM/M C,2,3,3,3,1,1,1,2,3,1,2,9,10,10,12,10,6,14,13,10,13,13,7,17,11,16,13,15,13,12,10,12,14,10,8,13,13,15,15,12,10,16,14,10,16,14,20,17,18,14,14,14,13,8,15,14,15,13,15,14,12,4,1,1,20,5,10,1,20,DM/M C,421,1,1,1,5,1,5,1,1,1,16,20,1,10,1,1,137440002304,0,0,0,0,0,0,0,0,1,0,0,0,0,0,0,0,0,0,0,0,1,0,0,0,0,0,0,0,0,0,0,0,0,0,0,0,0,1,0,0,0,0,0,0,0,0,0,0,McDonald Mariga,£5.40m ,33.0,183.0,Midfielder - Defensive Midfield,right,Retired,21.0,1.0,0.0,684.0,29.0,1.0,1.0,2080.0,5.0,0.0,0.0,159.0,1.0,0.0,0.0,45.0,11.0,0.0,0.0,569.0,13.0,2.0,2.0,985.0,29.0,0.0,0.0,2102.0,15.0,0.0,1.0,909.0,nan,nan,nan,nan,Serie A,nan,nan,nan,nan,nan,nan,nan,nan
19/6/2011,Maxi Sepúlveda,14000700,1649,3/29/1990,21,0,0,0,0,1750,3599,2595,127,80,1698,172,66,M C,3,3,2,3,2,2,3,1,1,1,3,5,5,7,7,11,9,9,9,1,12,11,9,12,13,8,10,8,5,9,11,11,9,9,3,7,8,11,13,13,9,10,7,20,16,12,10,10,7,10,7,10,13,10,13,10,6,13,14,6,9,2,1,1,20,1,1,1,20,M C,401,1,1,1,1,1,1,1,1,1,14,20,1,1,1,1,0,0,0,0,0,0,0,0,0,0,0,0,0,0,0,0,0,0,0,0,0,0,0,0,0,0,0,0,0,0,0,0,0,0,0,0,0,0,0,0,0,0,0,0,0,0,0,0,0
19/6/2011,Maxi Rodríguez,6300474,1649,1/2/1981,30,41,12,0,0,7000,7920,7500,169,144,1826222,180,79,M/AM RLC,1,2,1,1,2,1,3,3,2,1,3,14,14,13,12,14,10,12,13,4,9,14,13,11,15,13,15,14,16,15,13,14,15,12,10,16,13,15,14,11,14,14,11,13,15,12,20,14,14,14,5,14,8,17,16,16,17,16,17,17,18,6,1,1,18,20,20,15,18,M/AM RLC,526,1,1,4,18,15,20,1,1,1,9,15,12,18,1,1,56,0,0,0,1,1,1,0,0,0,0,0,0,0,0,0,0,0,0,0,0,0,0,0,0,0,0,0,0,0,0,0,0,0,0,0,0,0,0,0,0,0,0,0,0,0,0,0,0,Maxi Rodríguez,£3.15m ,39.0,173.0,Forward - Left Winger,right,Club Atlético Newell's Old Boys,35.0,10.0,1.0,2458.0,21.0,6.0,3.0,1427.0,38.0,8.0,3.0,3178.0,27.0,11.0,4.0,2280.0,46.0,21.0,6.0,3875.0,16.0,4.0,0.0,1415.0,41.0,15.0,3.0,3313.0,34.0,9.0,3.0,2139.0,10.0,5.0,0.0,852.0,Premier League,24.0,6.0,1.0,2115.0,nan,nan,nan,nan
19/6/2011,Mauricio Isla,75000523,1652,6/12/1988,23,24,1,1,0,4700,7450,7450,164,150,2330937,175,72,D/WB/DM/M RC,2,3,1,2,2,3,2,3,2,1,3,7,10,14,8,14,6,6,7,7,11,13,10,15,12,18,16,16,12,15,14,12,15,10,13,17,12,17,18,15,14,14,6,9,15,15,20,18,11,14,12,13,3,19,17,15,13,13,12,12,9,6,16,20,17,1,20,7,17,D/WB/DM/M RC,243,1,1,1,1,1,1,1,1,16,17,17,1,14,7,20,1048608,0,0,0,0,0,1,0,0,0,0,0,0,0,0,0,0,0,0,0,0,1,0,0,0,0,0,0,0,0,0,0,0,0,0,0,0,0,0,0,0,0,0,0,0,0,0,0,0,Mauricio Isla,£12.60m ,32.0,176.0,Defender - Right-Back,right,Clube de Regatas do Flamengo,35.0,3.0,7.0,2938.0,28.0,3.0,2.0,2239.0,21.0,0.0,3.0,1302.0,27.0,0.0,2.0,1582.0,27.0,0.0,2.0,2161.0,39.0,2.0,2.0,3125.0,35.0,1.0,8.0,2958.0,29.0,0.0,3.0,1942.0,37.0,0.0,7.0,3001.0,Serie A,37.0,0.0,7.0,2900.0,nan,nan,nan,nan
19/6/2011,Matuzalém,121163,1651,6/10/1980,31,0,0,4,1,5500,6750,7000,153,140,1128171,175,70,M/AM C,1,2,1,3,1,1,1,1,2,2,1,16,15,14,7,16,14,6,15,5,6,17,13,12,17,15,10,13,14,13,17,14,14,14,10,14,11,12,14,11,14,12,8,20,10,12,13,11,11,12,14,15,15,8,15,15,8,12,13,10,16,11,1,1,20,16,4,9,20,M/AM C,411,1,1,1,16,1,1,1,1,1,15,20,9,4,1,1,26389357002880,0,0,0,0,0,0,0,1,0,0,0,0,0,0,0,0,0,0,0,0,0,0,1,0,0,0,0,0,0,0,1,0,0,0,0,0,0,0,0,0,0,0,0,1,1,0,0,0,Matuzalém,£1.80m ,40.0,178.0,Midfielder - Defensive Midfield,left,Retired,23.0,0.0,0.0,1795.0,29.0,1.0,3.0,1748.0,15.0,1.0,2.0,1281.0,21.0,0.0,4.0,1609.0,39.0,0.0,0.0,3320.0,10.0,0.0,0.0,384.0,11.0,3.0,6.0,778.0,19.0,1.0,0.0,1247.0,nan,nan,nan,nan,Serie A,nan,nan,nan,nan,nan,nan,nan,nan
19/6/2011,Matthias Zimmermann,35017462,771,6/16/1992,19,0,0,0,0,2400,5600,5600,158,112,3791743,178,76,D/WB/DM/M RC,3,2,1,1,3,2,3,4,1,1,3,10,12,9,6,11,6,7,6,10,14,12,6,13,11,14,13,14,11,13,11,10,15,8,12,6,11,15,14,14,13,13,8,20,13,14,5,12,8,12,7,9,6,6,4,15,13,14,15,14,13,5,20,16,16,1,20,14,16,D/WB/DM/M RC,133,1,1,1,1,1,1,1,14,20,18,16,1,8,12,16,32800,0,0,0,0,0,1,0,0,0,0,0,0,0,0,0,1,0,0,0,0,0,0,0,0,0,0,0,0,0,0,0,0,0,0,0,0,0,0,0,0,0,0,0,0,0,0,0,0,Matthias Zimmermann,£900Th. ,28.0,177.0,Defender - Right-Back,right,Fortuna Düsseldorf,34.0,1.0,1.0,3042.0,14.0,1.0,1.0,1124.0,34.0,2.0,3.0,2775.0,21.0,0.0,1.0,1520.0,34.0,3.0,7.0,2849.0,36.0,1.0,1.0,2941.0,30.0,1.0,0.0,1726.0,7.0,0.0,0.0,427.0,36.0,1.0,3.0,3230.0,Bundesliga,38.0,2.0,4.0,3250.0,5.0,1.0,0.0,288.0
19/6/2011,Matteo Brighi,3802812,776,2/14/1981,30,4,0,34,2,5250,6500,6950,147,137,301649,179,78,M LC,2,3,1,3,2,3,3,5,2,3,1,9,12,12,9,13,10,8,10,8,13,14,12,14,14,14,13,15,12,15,14,13,18,13,14,12,15,18,18,12,13,12,8,8,12,14,20,15,14,16,10,15,6,15,8,15,17,16,19,17,18,7,1,1,20,1,12,17,20,M LC,404,1,1,1,1,1,1,1,1,1,15,20,17,12,1,1,4194304,0,0,0,0,0,0,0,0,0,0,0,0,0,0,0,0,0,0,0,0,0,0,1,0,0,0,0,0,0,0,0,0,0,0,0,0,0,0,0,0,0,0,0,0,0,0,0,0,Matteo Brighi,£2.25m ,39.0,178.0,Midfielder - Central Midfield,right,Retired,32.0,1.0,0.0,1769.0,12.0,0.0,0.0,836.0,25.0,2.0,1.0,1779.0,25.0,2.0,0.0,1438.0,24.0,0.0,0.0,1329.0,24.0,0.0,0.0,1546.0,40.0,3.0,2.0,3279.0,28.0,2.0,1.0,1642.0,10.0,1.0,0.0,223.0,Serie A,nan,nan,nan,nan,nan,nan,nan,nan
19/6/2011,Mato Jajalo,24004081,761,5/25/1988,23,0,0,28,5,4000,5759,6400,145,128,710790,182,77,M RC,1,2,2,1,2,3,3,1,3,1,2,11,11,13,10,13,10,12,15,11,10,13,10,12,14,12,12,13,10,13,15,11,12,12,10,12,10,14,14,12,14,14,12,8,16,13,20,14,14,14,4,14,3,12,13,12,12,12,13,14,12,6,5,9,20,10,15,12,20,M RC,403,1,1,3,10,6,6,5,3,3,15,20,12,15,7,9,0,0,0,0,0,0,0,0,0,0,0,0,0,0,0,0,0,0,0,0,0,0,0,0,0,0,0,0,0,0,0,0,0,0,0,0,0,0,0,0,0,0,0,0,0,0,0,0,0,Mato Jajalo,£2.03m ,32.0,182.0,Midfielder - Defensive Midfield,right,Udinese Calcio,33.0,2.0,4.0,2423.0,33.0,5.0,2.0,2420.0,26.0,0.0,3.0,1364.0,21.0,1.0,5.0,1523.0,48.0,3.0,9.0,3507.0,29.0,0.0,1.0,2124.0,26.0,1.0,1.0,1861.0,41.0,1.0,5.0,3368.0,35.0,3.0,3.0,3103.0,Bundesliga,28.0,0.0,0.0,1831.0,nan,nan,nan,nan
19/6/2011,Mathieu Flamini,8428576,769,3/7/1984,27,3,0,8,1,6100,6696,7400,156,148,1337199,178,67,DM/M C,2,3,3,1,1,2,2,5,3,3,3,5,11,12,10,13,6,13,13,14,15,13,10,15,12,17,13,17,13,13,13,12,14,6,13,13,16,15,14,15,15,14,9,11,15,15,20,16,13,14,18,10,7,14,14,15,14,12,16,9,8,11,12,14,20,1,14,10,20,DM/M C,421,1,1,1,1,1,1,1,6,12,18,20,10,14,8,14,137455730688,0,0,0,0,0,0,0,0,0,0,0,0,0,0,0,0,0,0,0,0,0,0,0,0,1,0,0,0,0,0,0,0,0,0,0,0,0,1,0,0,0,0,0,0,0,0,0,0,Mathieu Flamini,£5.40m ,36.0,178.0,Midfielder - Defensive Midfield,right,Retired,29.0,2.0,1.0,1938.0,3.0,1.0,0.0,149.0,22.0,4.0,1.0,1657.0,36.0,2.0,0.0,2289.0,33.0,1.0,2.0,2078.0,24.0,2.0,0.0,1682.0,13.0,0.0,1.0,538.0,8.0,0.0,0.0,482.0,13.0,0.0,0.0,642.0,Serie A,nan,nan,nan,nan,nan,nan,nan,nan
19/6/2011,Mathieu Coutadeur,8431809,769,3/20/1986,25,0,0,7,0,2100,6350,6350,160,140,1155969,170,69,M C,1,3,1,3,1,1,1,4,1,1,1,13,11,11,8,13,12,6,14,9,7,15,14,12,13,10,14,14,14,14,14,14,15,12,16,8,14,15,17,14,12,12,5,10,15,13,20,17,12,16,10,14,5,7,14,16,15,13,16,16,14,7,1,1,20,12,1,1,20,M C,401,1,1,1,12,1,1,1,1,1,14,20,1,1,1,1,4194304,0,0,0,0,0,0,0,0,0,0,0,0,0,0,0,0,0,0,0,0,0,0,1,0,0,0,0,0,0,0,0,0,0,0,0,0,0,0,0,0,0,0,0,0,0,0,0,0,Mathieu Coutadeur,£2.25m ,34.0,170.0,Midfielder - Central Midfield,right,AC Ajaccio,21.0,2.0,2.0,1206.0,35.0,3.0,3.0,2614.0,5.0,0.0,0.0,359.0,18.0,1.0,1.0,1256.0,12.0,0.0,0.0,802.0,32.0,1.0,1.0,2812.0,39.0,5.0,4.0,3277.0,40.0,6.0,4.0,3334.0,33.0,5.0,3.0,2947.0,Ligue 1,28.0,2.0,6.0,2466.0,6.0,0.0,0.0,469.0
19/6/2011,Mathieu Bodmer,910568,769,11/22/1982,28,0,0,3,0,4950,6235,6235,155,138,779666,190,91,M/AM C,1,1,3,2,3,3,3,7,2,3,1,8,12,13,9,15,13,13,15,7,10,16,12,13,16,8,15,15,14,11,15,13,14,13,12,12,13,16,11,9,10,17,15,12,11,11,20,13,17,10,12,14,15,18,13,15,15,15,13,16,13,10,14,8,18,20,10,1,20,M/AM C,521,1,12,1,20,1,1,14,1,8,14,18,1,10,1,8,16778112,0,0,0,0,0,0,0,1,1,1,0,0,0,0,0,0,0,0,0,0,0,0,0,0,1,0,0,0,0,0,0,0,0,0,0,0,0,0,0,0,0,0,0,0,0,0,0,0,Mathieu Bodmer,£6.30m ,37.0,190.0,Midfielder - Defensive Midfield,right,Retired,42.0,10.0,6.0,2743.0,42.0,3.0,4.0,2900.0,23.0,2.0,1.0,1038.0,29.0,2.0,2.0,2514.0,24.0,2.0,1.0,2061.0,21.0,1.0,1.0,1564.0,30.0,1.0,1.0,1904.0,14.0,1.0,0.0,478.0,29.0,1.0,0.0,1247.0,Ligue 1,10.0,1.0,2.0,162.0,nan,nan,nan,nan
19/6/2011,Mateusz Klich,54005896,787,6/13/1990,21,1,0,1,0,3250,5500,5500,125,115,1531292,183,68,M/AM C,1,1,1,1,1,1,1,6,3,3,3,11,10,12,10,14,12,9,11,3,9,13,10,9,13,9,8,10,13,12,13,12,10,14,10,11,9,13,12,12,11,12,13,13,13,13,20,10,11,14,7,11,12,10,15,14,15,14,15,14,7,2,1,1,20,20,1,1,20,M/AM C,411,1,1,1,20,1,1,1,1,1,1,20,1,1,1,1,4294967300,0,0,1,0,0,0,0,0,0,0,0,0,0,0,0,0,0,0,0,0,0,0,0,0,0,0,0,0,0,0,0,0,1,0,0,0,0,0,0,0,0,0,0,0,0,0,0,0,Mateusz Klich,£540Th. ,30.0,183.0,Midfielder - Central Midfield,right,Leeds United,29.0,4.0,8.0,2264.0,9.0,1.0,2.0,608.0,17.0,2.0,2.0,1342.0,34.0,4.0,10.0,2826.0,13.0,4.0,4.0,902.0,20.0,3.0,1.0,1309.0,30.0,6.0,4.0,2693.0,26.0,1.0,3.0,1728.0,50.0,10.0,9.0,4065.0,Bundesliga,47.0,7.0,5.0,3998.0,6.0,2.0,2.0,518.0
19/6/2011,Massimo Gobbi,6100012,776,10/30/1980,30,1,0,0,0,3750,6300,6300,136,126,242740,183,79,D/WB/M LC,2,2,2,2,2,2,3,7,3,1,3,9,12,12,9,14,7,9,11,14,11,14,8,12,14,15,10,14,13,10,11,10,12,8,11,13,12,14,15,13,14,11,9,9,14,14,20,14,12,11,16,11,10,12,11,12,11,10,14,14,11,4,19,17,20,7,1,19,20,D/WB/M LC,434,1,1,1,1,7,1,1,19,1,1,20,15,1,17,1,8796094070801,1,0,0,0,1,0,0,0,0,0,0,0,0,0,0,0,0,0,0,0,1,0,0,0,0,0,0,0,0,0,0,0,0,0,0,0,0,0,0,0,0,0,0,1,0,0,0,0,Massimo Gobbi,£1.08m ,39.0,183.0,Defender - Left-Back,left,Retired,34.0,0.0,3.0,2571.0,26.0,2.0,1.0,2236.0,35.0,1.0,1.0,3064.0,30.0,1.0,2.0,2471.0,34.0,0.0,3.0,2831.0,35.0,0.0,1.0,2904.0,32.0,1.0,2.0,2782.0,26.0,0.0,2.0,2158.0,17.0,0.0,1.0,1271.0,Serie A,nan,nan,nan,nan,nan,nan,nan,nan
19/6/2011,Massimo Ambrosini,66,776,5/29/1977,34,35,0,18,1,6500,6900,7450,168,151,464398,182,72,DM/M C,2,3,1,3,2,2,1,3,3,3,3,4,11,9,12,13,4,19,11,18,15,14,10,16,13,17,16,18,15,14,13,14,18,7,19,14,15,16,17,10,14,16,13,14,14,12,20,14,15,13,16,13,17,14,15,14,20,19,18,13,14,12,8,1,20,1,12,14,20,DM/M C,421,1,1,5,1,1,1,8,1,1,18,20,14,12,1,1,137438986248,0,0,0,1,0,0,0,0,0,0,0,0,0,0,0,1,0,0,0,0,0,0,0,0,0,0,0,0,0,0,0,0,0,0,0,0,0,1,0,0,0,0,0,0,0,0,0,0,Massimo Ambrosini,£900Th. ,43.0,182.0,Midfielder - Central Midfield,right,Retired,23.0,1.0,3.0,1659.0,31.0,1.0,2.0,2073.0,25.0,0.0,1.0,1660.0,30.0,1.0,3.0,1938.0,nan,nan,nan,nan,nan,nan,nan,nan,nan,nan,nan,nan,nan,nan,nan,nan,nan,nan,nan,nan,Serie A,nan,nan,nan,nan,nan,nan,nan,nan
19/6/2011,Marvin Martin,8440961,769,1/10/1988,23,2,2,10,1,6500,7350,6600,165,147,3363656,171,63,M/AM C,2,1,2,3,2,3,1,4,3,2,3,15,14,14,7,16,14,7,13,6,4,16,12,7,16,9,13,12,14,14,17,15,15,14,10,13,10,15,16,14,15,12,6,12,16,13,20,17,7,15,9,15,7,10,8,15,15,16,14,17,17,8,1,1,20,18,10,13,20,M/AM C,411,1,1,1,18,13,10,1,1,1,12,20,13,10,1,1,17592207016064,0,0,0,0,0,0,0,1,0,0,0,0,0,0,0,0,0,0,0,0,0,0,1,0,1,0,0,0,0,0,0,0,0,0,0,0,0,0,0,0,0,0,0,0,1,0,0,0,Marvin Martin,£8.55m ,32.0,171.0,Midfielder - Attacking Midfield,right,FC Chambly,41.0,4.0,18.0,3659.0,36.0,2.0,9.0,3069.0,45.0,0.0,8.0,3306.0,22.0,0.0,3.0,1412.0,8.0,0.0,0.0,377.0,15.0,0.0,1.0,702.0,13.0,0.0,1.0,516.0,16.0,1.0,2.0,572.0,13.0,0.0,1.0,626.0,Ligue 1,6.0,0.0,0.0,148.0,2.0,0.0,0.0,110.0
19/6/2011,Martinho,19032956,1651,4/15/1988,23,0,0,0,0,2072,5550,5750,133,115,164682,181,73,M/AM LC,2,1,3,3,3,3,1,1,1,2,1,11,11,15,10,13,10,8,10,11,8,14,10,7,13,8,11,8,8,10,12,8,14,11,8,11,13,9,11,15,14,11,13,20,10,14,8,14,11,12,6,10,13,12,13,15,13,9,11,7,8,4,10,13,20,18,1,20,16,M/AM LC,414,1,1,1,14,18,1,1,10,1,1,16,20,1,13,1,0,0,0,0,0,0,0,0,0,0,0,0,0,0,0,0,0,0,0,0,0,0,0,0,0,0,0,0,0,0,0,0,0,0,0,0,0,0,0,0,0,0,0,0,0,0,0,0,0,Marinho,£1.17m ,37.0,166.0,Forward - Right Winger,left,Retired,30.0,2.0,1.0,1883.0,34.0,7.0,2.0,2162.0,41.0,4.0,5.0,2818.0,32.0,1.0,2.0,1461.0,17.0,4.0,1.0,990.0,21.0,3.0,0.0,899.0,44.0,4.0,5.0,3411.0,33.0,6.0,3.0,2079.0,23.0,1.0,2.0,629.0,Liga NOS,nan,nan,nan,nan,nan,nan,nan,nan
19/6/2011,Martin Rowlands,109139,789,2/8/1979,32,5,0,0,0,2150,5039,4900,120,112,145193,175,69,M RC,3,2,2,3,3,1,2,5,3,3,1,11,11,12,11,12,13,10,13,3,10,15,13,11,14,13,12,11,11,11,12,11,10,11,12,12,13,13,14,11,11,14,8,11,13,10,20,10,10,12,12,13,16,18,17,15,12,13,16,12,10,6,8,10,20,10,19,14,20,M RC,403,1,1,1,10,10,10,1,1,8,10,20,14,19,1,10,2148007972,0,0,1,0,0,1,0,0,0,0,0,0,0,0,0,0,0,0,0,1,0,0,0,0,0,0,0,0,0,0,0,1,0,0,0,0,0,0,0,0,0,0,0,0,0,0,0,0,Martin Rowlands,£675Th. ,41.0,175.0,Midfielder - Central Midfield,both,Retired,5.0,0.0,0.0,34.0,21.0,2.0,1.0,1280.0,40.0,4.0,1.0,3124.0,36.0,2.0,1.0,2187.0,nan,nan,nan,nan,nan,nan,nan,nan,nan,nan,nan,nan,nan,nan,nan,nan,nan,nan,nan,nan,Premier League,nan,nan,nan,nan,nan,nan,nan,nan
19/6/2011,Martin Lanig,895903,771,7/11/1984,26,0,0,0,0,4500,6250,6250,135,125,749678,190,79,DM C,2,2,3,1,2,2,2,3,3,2,1,8,10,9,10,12,6,18,13,13,12,12,12,14,9,11,13,15,15,9,11,10,9,14,12,11,14,14,14,11,13,15,17,10,14,13,20,15,15,9,18,10,5,13,8,14,8,9,13,8,4,6,7,7,15,5,10,7,15,DM C,301,1,7,3,5,1,1,7,3,3,20,15,7,10,5,7,525356,0,0,1,1,0,1,0,0,0,0,1,0,0,0,0,0,0,0,0,1,0,0,0,0,0,0,0,0,0,0,0,0,0,0,0,0,0,0,0,0,0,0,0,0,0,0,0,0,Martin Harnik,£9.90m ,33.0,185.0,Forward - Right Winger,right,TuS Dassendorf,44.0,17.0,12.0,2477.0,38.0,17.0,10.0,3072.0,47.0,12.0,7.0,3656.0,35.0,10.0,3.0,2316.0,29.0,9.0,3.0,2320.0,21.0,3.0,0.0,1084.0,33.0,21.0,4.0,2554.0,32.0,11.0,4.0,2067.0,22.0,7.0,4.0,917.0,Bundesliga,25.0,3.0,2.0,1383.0,2.0,1.0,1.0,116.0
19/6/2011,Marouane Fellaini,8170873,757,11/22/1987,23,27,4,8,0,7000,7500,7500,172,160,3894595,194,85,DM/M C,1,1,3,3,3,2,2,1,1,1,3,9,9,13,13,15,8,19,10,12,12,15,12,13,15,16,16,18,16,16,12,13,17,10,5,14,16,18,18,9,13,18,17,14,16,12,20,17,19,17,15,14,5,12,12,15,9,13,14,6,5,9,1,1,18,10,1,1,18,DM/M C,311,1,1,1,10,1,1,1,1,1,20,18,1,1,1,1,274878038016,0,0,0,0,0,0,0,0,0,0,0,0,0,0,0,0,0,1,0,0,0,0,0,0,0,0,0,0,0,0,0,0,0,0,0,0,0,0,1,0,0,0,0,0,0,0,0,0,Marouane Fellaini,£18.00m ,32.0,194.0,Midfielder - Central Midfield,right,Shandong Luneng Taishan,25.0,3.0,3.0,2147.0,43.0,5.0,7.0,3726.0,36.0,12.0,8.0,3213.0,25.0,1.0,4.0,1725.0,31.0,7.0,1.0,2165.0,35.0,5.0,4.0,2301.0,47.0,4.0,2.0,2651.0,23.0,5.0,1.0,878.0,55.0,14.0,7.0,4108.0,Premier League,14.0,4.0,0.0,1034.0,nan,nan,nan,nan
19/6/2011,Markus Mendler,91100204,771,1/7/1993,18,0,0,0,0,4527,5935,6036,146,118,2085958,173,67,M/AM RLC,2,1,2,2,1,2,3,2,3,3,1,11,12,13,7,12,6,5,11,5,9,11,10,11,12,16,11,8,9,12,14,6,8,9,12,10,7,14,13,13,12,12,6,20,18,13,12,13,9,10,10,10,10,10,10,8,12,6,12,17,17,12,1,1,18,20,20,18,18,M/AM RLC,526,1,1,1,16,18,20,1,1,1,1,18,14,16,1,1,0,0,0,0,0,0,0,0,0,0,0,0,0,0,0,0,0,0,0,0,0,0,0,0,0,0,0,0,0,0,0,0,0,0,0,0,0,0,0,0,0,0,0,0,0,0,0,0,0,Markus Mendler,£720Th. ,27.0,173.0,Forward - Left Winger,left,1.FC Saarbrücken,25.0,5.0,1.0,1740.0,17.0,2.0,1.0,1002.0,11.0,4.0,0.0,855.0,11.0,0.0,0.0,711.0,20.0,3.0,0.0,876.0,30.0,4.0,1.0,1611.0,23.0,4.0,5.0,1184.0,32.0,12.0,18.0,2233.0,34.0,9.0,11.0,2196.0,Bundesliga,28.0,9.0,5.0,1679.0,4.0,2.0,0.0,114.0
19/6/2011,Markus Feulner,883735,771,2/12/1982,29,0,0,13,1,5255,6206,6200,133,124,208530,181,73,M/AM RLC,2,2,2,1,2,3,1,3,2,3,2,12,14,13,7,13,11,7,12,6,8,13,7,10,12,12,13,11,11,13,11,12,12,11,8,11,9,12,13,14,13,10,9,17,11,12,20,12,10,10,8,10,13,12,13,16,7,12,14,14,13,6,1,5,20,16,18,19,20,M/AM RLC,416,1,1,8,16,14,14,1,1,1,14,20,19,18,5,5,2304,0,0,0,0,0,0,0,0,1,0,0,1,0,0,0,0,0,0,0,0,0,0,0,0,0,0,0,0,0,0,0,0,0,0,0,0,0,0,0,0,0,0,0,0,0,0,0,0,Markus Feulner,£1.35m ,38.0,183.0,Midfielder - Central Midfield,right,Retired,9.0,0.0,0.0,66.0,30.0,4.0,4.0,2274.0,23.0,4.0,2.0,1529.0,26.0,2.0,3.0,1878.0,25.0,1.0,0.0,1972.0,26.0,1.0,0.0,1462.0,2.0,0.0,0.0,17.0,25.0,2.0,0.0,1697.0,23.0,2.0,3.0,1285.0,Bundesliga,nan,nan,nan,nan,nan,nan,nan,nan
19/6/2011,Markel,7458284,796,5/5/1986,25,0,0,0,0,4300,6050,6050,135,126,634342,180,74,DM/M C,3,2,2,1,2,2,1,2,3,2,1,4,6,11,9,12,5,11,7,5,13,12,9,16,11,13,14,13,12,11,10,12,10,7,10,8,14,15,17,13,12,12,10,11,13,13,20,17,14,11,9,10,11,9,13,13,15,12,9,7,11,5,1,1,17,1,1,1,17,DM/M C,311,1,1,1,1,1,1,1,1,1,20,17,1,1,1,1,0,0,0,0,0,0,0,0,0,0,0,0,0,0,0,0,0,0,0,0,0,0,0,0,0,0,0,0,0,0,0,0,0,0,0,0,0,0,0,0,0,0,0,0,0,0,0,0,0,Marcelo,£22.50m ,32.0,174.0,Defender - Left-Back,left,Real Madrid,50.0,5.0,10.0,4239.0,44.0,3.0,10.0,3540.0,19.0,1.0,1.0,1386.0,39.0,2.0,8.0,2998.0,53.0,4.0,10.0,4168.0,41.0,2.0,4.0,3383.0,47.0,3.0,13.0,3878.0,44.0,5.0,11.0,3671.0,34.0,3.0,6.0,2858.0,LaLiga,23.0,2.0,7.0,1884.0,3.0,0.0,1.0,270.0
19/6/2011,Mark van Bommel,4752,784,4/22/1977,34,68,10,0,0,7000,8000,7600,165,153,458498,187,85,DM/M C,2,1,2,2,1,1,3,10,2,3,2,8,12,10,13,12,10,13,14,12,15,14,14,15,11,19,16,19,15,13,15,16,19,4,19,14,18,18,15,9,9,15,14,14,17,13,20,14,14,18,19,14,12,10,16,19,12,14,12,2,4,14,1,1,20,8,10,1,20,DM/M C,421,1,1,1,8,1,1,1,1,1,17,20,1,10,1,1,8797166960640,0,0,0,0,0,0,0,0,0,0,0,0,0,0,0,0,1,1,0,0,0,0,0,0,0,0,0,0,0,0,1,0,0,0,0,0,0,0,0,0,0,0,0,1,0,0,0,0,Mark van Bommel,£2.25m ,43.0,186.0,Midfielder - Defensive Midfield,right,Retired,34.0,0.0,3.0,2791.0,34.0,0.0,0.0,2776.0,35.0,8.0,4.0,3097.0,nan,nan,nan,nan,nan,nan,nan,nan,nan,nan,nan,nan,nan,nan,nan,nan,nan,nan,nan,nan,nan,nan,nan,nan,Serie A,nan,nan,nan,nan,nan,nan,nan,nan
19/6/2011,Mario Suárez,7458309,796,2/24/1987,24,0,0,5,0,4869,6763,6763,151,139,19180069,185,77,DM/M C,3,2,2,3,3,2,2,5,3,2,1,9,8,12,12,13,9,13,14,7,11,14,2,12,13,15,13,16,14,15,12,13,12,11,8,12,14,16,15,12,13,16,13,11,17,13,20,16,14,12,15,14,5,13,5,13,14,10,13,12,11,8,5,1,18,8,10,7,18,DM/M C,311,1,1,1,8,1,1,5,1,1,20,18,7,10,1,1,64,0,0,0,0,0,0,1,0,0,0,0,0,0,0,0,0,0,0,0,0,0,0,0,0,0,0,0,0,0,0,0,0,0,0,0,0,0,0,0,0,0,0,0,0,0,0,0,0,Mario Suárez,£4.50m ,33.0,189.0,Midfielder - Defensive Midfield,right,Rayo Vallecano,35.0,2.0,2.0,2125.0,42.0,0.0,0.0,3131.0,43.0,1.0,2.0,3190.0,25.0,0.0,0.0,2100.0,35.0,2.0,1.0,2353.0,30.0,1.0,0.0,1600.0,36.0,3.0,5.0,2796.0,18.0,2.0,2.0,1569.0,14.0,2.0,0.0,1026.0,LaLiga,37.0,7.0,2.0,2708.0,3.0,0.0,0.0,141.0
19/6/2011,Mario Paglialunga,14006616,1649,10/29/1988,22,0,0,0,0,4500,5309,5100,148,118,249493,182,81,DM C,3,3,2,1,1,1,3,6,2,2,1,5,9,12,8,11,7,12,10,6,14,14,9,11,12,9,14,15,7,11,12,12,13,6,13,12,14,14,14,11,12,14,12,20,13,13,8,15,13,8,8,12,5,10,12,12,15,8,12,13,9,9,10,1,15,1,1,1,15,DM C,301,1,1,1,1,1,1,10,1,1,20,15,1,1,1,1,17592186044480,0,0,0,0,0,0,1,0,0,0,0,0,0,0,0,0,0,0,0,0,0,0,0,0,0,0,0,0,0,0,0,0,0,0,0,0,0,0,0,0,0,0,0,0,1,0,0,0,Mario Paglialunga,£450Th. ,31.0,182.0,Midfielder - Defensive Midfield,left,Club Atlético Central Córdoba (Cba),12.0,2.0,1.0,978.0,5.0,1.0,0.0,450.0,26.0,2.0,0.0,1874.0,25.0,0.0,0.0,2056.0,28.0,0.0,1.0,1388.0,6.0,0.0,0.0,246.0,nan,nan,nan,nan,nan,nan,nan,nan,nan,nan,nan,nan,Serie A,nan,nan,nan,nan,nan,nan,nan,nan
19/6/2011,Mario Licka,5646187,763,4/30/1982,29,2,0,16,2,4500,5624,5600,135,125,470618,179,74,M C,2,3,1,2,1,3,2,1,1,2,2,14,14,13,8,14,11,8,12,6,7,14,11,9,14,8,13,12,13,12,13,12,13,13,11,11,11,14,16,14,14,12,9,10,13,10,20,14,12,14,8,14,10,12,16,13,18,14,15,15,15,7,1,1,20,14,10,10,20,M C,401,1,1,1,14,1,1,1,1,1,10,20,10,10,1,1,17592191287296,0,0,0,0,0,0,0,0,0,0,0,0,0,0,0,0,0,0,0,0,1,0,1,0,0,0,0,0,0,0,0,0,0,0,0,0,0,0,0,0,0,0,0,0,1,0,0,0,Mario Licka,£1.35m ,38.0,179.0,Midfielder - Attacking Midfield,right,SK Benesov,36.0,3.0,4.0,2501.0,27.0,0.0,1.0,1619.0,26.0,0.0,2.0,1773.0,17.0,0.0,0.0,773.0,29.0,0.0,0.0,1889.0,11.0,0.0,0.0,419.0,nan,nan,nan,nan,1.0,0.0,0.0,90.0,nan,nan,nan,nan,Ligue 1,17.0,8.0,0.0,1551.0,6.0,3.0,0.0,473.0
19/6/2011,Marek Hamsik,7564092,794,7/27/1987,23,46,8,0,0,7250,8000,8000,178,162,4938291,183,73,M/AM LC,1,3,2,2,1,2,3,6,3,1,1,13,13,14,16,13,12,15,13,9,8,16,16,8,17,11,14,12,18,13,17,16,13,15,16,18,13,15,10,15,15,13,12,11,15,14,20,15,12,10,6,16,5,14,17,16,18,10,13,8,8,8,1,1,20,18,10,17,20,M/AM LC,414,1,1,1,18,17,10,1,1,1,14,20,11,10,1,1,549890031664,0,0,0,0,1,1,0,0,0,0,0,0,0,0,0,0,0,0,0,0,0,0,0,0,0,0,0,1,0,0,0,0,0,0,0,0,0,0,0,1,0,0,0,0,0,0,0,0,Marek Hamsik,£22.50m ,33.0,183.0,Midfielder - Central Midfield,both,Dalian Professional,49.0,13.0,9.0,3868.0,50.0,12.0,9.0,3826.0,44.0,11.0,20.0,3501.0,41.0,7.0,9.0,2792.0,54.0,13.0,16.0,3517.0,46.0,8.0,7.0,3707.0,49.0,15.0,9.0,3914.0,49.0,7.0,3.0,3162.0,50.0,4.0,4.0,4047.0,Serie A,14.0,2.0,1.0,1253.0,nan,nan,nan,nan
19/6/2011,Marcos Senna,302558,796,7/17/1976,34,27,1,0,0,6350,7350,7350,160,146,376156,178,76,DM/M C,1,2,2,3,2,2,3,2,3,3,2,13,11,10,10,14,14,9,17,11,11,15,13,15,14,16,14,17,12,15,13,14,17,11,16,11,13,18,16,13,12,15,9,11,16,11,20,14,13,16,14,18,17,12,16,15,17,14,18,15,12,6,1,1,20,9,14,1,20,DM/M C,421,1,1,1,9,1,1,1,1,1,16,20,1,14,1,1,832,0,0,0,0,0,0,1,0,1,1,0,0,0,0,0,0,0,0,0,0,0,0,0,0,0,0,0,0,0,0,0,0,0,0,0,0,0,0,0,0,0,0,0,0,0,0,0,0,Marcos Senna,£1.35m ,44.0,176.0,Midfielder - Defensive Midfield,right,Retired,27.0,1.0,1.0,1616.0,38.0,5.0,2.0,2509.0,46.0,10.0,1.0,3377.0,14.0,2.0,1.0,1126.0,22.0,3.0,0.0,1765.0,nan,nan,nan,nan,nan,nan,nan,nan,nan,nan,nan,nan,nan,nan,nan,nan,LaLiga,nan,nan,nan,nan,nan,nan,nan,nan
19/6/2011,Marcos Paulo,85013938,1651,7/13/1988,22,0,0,0,0,2049,5000,5750,135,115,556927,182,70,M C,2,3,2,2,2,2,2,1,3,3,3,7,7,11,6,13,11,11,14,5,10,13,7,12,13,11,13,14,11,11,11,9,13,8,7,8,8,13,11,13,13,14,11,9,15,12,20,16,11,12,11,13,7,8,9,12,10,11,14,14,14,6,1,1,20,8,5,1,20,M C,401,1,1,1,8,1,1,1,1,1,13,20,1,5,1,1,0,0,0,0,0,0,0,0,0,0,0,0,0,0,0,0,0,0,0,0,0,0,0,0,0,0,0,0,0,0,0,0,0,0,0,0,0,0,0,0,0,0,0,0,0,0,0,0,0,Marcos Paulo,£900Th. ,32.0,182.0,Midfielder - Central Midfield,right,FC Vizela,28.0,1.0,0.0,2199.0,29.0,0.0,0.0,2387.0,16.0,0.0,0.0,912.0,15.0,5.0,0.0,1107.0,24.0,2.0,0.0,1669.0,29.0,2.0,1.0,2343.0,31.0,3.0,1.0,2632.0,30.0,3.0,0.0,2318.0,15.0,0.0,2.0,1017.0,Liga NOS,23.0,1.0,3.0,1747.0,8.0,1.0,0.0,624.0
19/6/2011,Marco Rigoni,704382,776,1/5/1980,31,0,0,0,0,3000,6200,6200,137,127,364172,178,75,M/AM RC,1,3,3,1,1,2,1,4,3,2,3,12,13,15,13,12,14,6,12,12,8,14,13,10,16,9,10,8,12,13,17,15,8,17,9,15,14,13,13,12,15,7,7,6,10,12,20,12,10,12,12,14,8,7,5,10,10,15,14,10,2,12,1,1,20,18,16,11,20,M/AM RC,413,1,1,1,18,10,16,1,1,1,1,20,11,1,1,1,26388279067792,0,0,0,0,1,0,0,1,0,0,1,0,0,0,0,0,0,0,0,0,0,0,0,0,0,0,0,0,0,0,0,0,0,0,0,0,0,0,0,0,0,0,0,1,1,0,0,0,Marco Rigoni,£1.17m ,40.0,175.0,Midfielder - Central Midfield,right,Retired,43.0,6.0,6.0,3526.0,36.0,11.0,7.0,3170.0,25.0,2.0,3.0,1272.0,29.0,3.0,1.0,1923.0,nan,nan,nan,nan,nan,nan,nan,nan,nan,nan,nan,nan,nan,nan,nan,nan,nan,nan,nan,nan,Serie A,nan,nan,nan,nan,nan,nan,nan,nan
19/6/2011,Marco Parolo,7982798,776,1/25/1985,26,1,0,0,0,5250,7200,7200,154,142,1691541,184,75,M/AM C,1,1,1,1,1,1,1,1,1,1,1,7,11,10,10,13,12,13,17,6,10,13,12,13,14,13,12,11,11,11,14,12,17,13,11,13,13,14,17,13,11,12,12,16,14,14,20,16,13,14,10,14,3,10,14,17,18,18,17,16,15,6,1,1,20,17,1,13,20,M/AM C,411,1,1,1,17,11,1,1,1,1,1,20,13,1,1,1,0,0,0,0,0,0,0,0,0,0,0,0,0,0,0,0,0,0,0,0,0,0,0,0,0,0,0,0,0,0,0,0,0,0,0,0,0,0,0,0,0,0,0,0,0,0,0,0,0,Marco Parolo,£4.05m ,35.0,184.0,Midfielder - Central Midfield,right,SS Lazio,38.0,5.0,4.0,3254.0,35.0,1.0,1.0,2922.0,37.0,3.0,3.0,3126.0,38.0,8.0,7.0,3353.0,40.0,11.0,4.0,3568.0,40.0,6.0,1.0,3372.0,38.0,5.0,1.0,3260.0,43.0,6.0,7.0,3562.0,42.0,6.0,3.0,3133.0,Serie A,37.0,2.0,1.0,2346.0,5.0,0.0,0.0,111.0
19/6/2011,Marco Höger,92014217,771,9/16/1989,21,0,0,0,0,4500,6550,6550,146,131,535365,186,78,D/DM/M RC,3,3,3,2,3,1,1,1,2,2,1,9,16,8,9,14,11,12,15,5,9,14,16,10,14,11,13,12,15,11,13,15,16,9,12,10,10,15,12,10,11,12,13,17,9,11,20,13,12,12,8,11,12,12,5,15,12,12,15,9,14,8,18,14,20,12,18,1,20,D/DM/M RC,433,1,1,1,1,1,12,1,1,18,17,20,1,15,1,14,0,0,0,0,0,0,0,0,0,0,0,0,0,0,0,0,0,0,0,0,0,0,0,0,0,0,0,0,0,0,0,0,0,0,0,0,0,0,0,0,0,0,0,0,0,0,0,0,0,Marco HÃ¶ger,£3.60m ,31.0,182.0,Midfielder - Defensive Midfield,right,1. FC KÃ¶ln,37.0,10.0,9.0,3235.0,43.0,1.0,5.0,2983.0,30.0,3.0,2.0,1858.0,14.0,2.0,1.0,1039.0,34.0,1.0,3.0,2756.0,6.0,0.0,0.0,219.0,32.0,0.0,1.0,2124.0,26.0,0.0,0.0,1876.0,28.0,1.0,3.0,2155.0,Bundesliga,16.0,0.0,0.0,727.0,3.0,0.0,0.0,109.0
19/6/2011,Marco Gallozzi,1413286,776,7/27/1988,22,0,0,0,0,1512,4618,4618,124,102,13877,185,66,M/AM RC,1,2,2,1,3,3,1,3,2,2,1,11,14,11,7,13,9,8,10,10,8,14,4,13,14,8,14,5,14,10,11,14,9,17,10,10,9,17,14,13,12,11,13,5,11,13,20,9,4,10,11,10,10,10,13,18,8,13,15,13,12,16,1,1,20,17,20,1,17,M/AM RC,413,1,1,1,1,1,17,1,1,1,1,17,1,20,1,1,0,0,0,0,0,0,0,0,0,0,0,0,0,0,0,0,0,0,0,0,0,0,0,0,0,0,0,0,0,0,0,0,0,0,0,0,0,0,0,0,0,0,0,0,0,0,0,0,0,Marco Gallozzi,£270Th. ,32.0,185.0,Midfielder - Right Midfield,right,Tolentino Calcio,28.0,1.0,0.0,1838.0,6.0,0.0,0.0,303.0,6.0,0.0,0.0,332.0,20.0,2.0,0.0,984.0,16.0,1.0,0.0,916.0,3.0,0.0,0.0,177.0,1.0,0.0,0.0,37.0,24.0,0.0,2.0,1542.0,29.0,1.0,3.0,1928.0,Serie A,18.0,1.0,2.0,1146.0,3.0,0.0,0.0,143.0
19/6/2011,Marco Estrada,5250475,1652,5/28/1983,28,29,1,0,0,5400,6031,6031,140,133,678564,178,73,DM/M C,1,3,3,3,3,3,3,1,1,1,1,14,15,11,8,13,15,11,16,13,11,14,8,12,13,13,13,14,12,12,16,13,13,9,12,11,13,14,14,13,13,13,8,20,13,12,8,15,12,13,13,14,9,15,13,14,14,12,11,11,8,11,10,10,18,1,1,14,18,DM/M C,311,1,1,1,1,1,1,1,10,1,20,18,14,1,10,1,43980465111296,0,0,0,0,0,0,0,0,1,0,0,0,0,0,0,0,0,0,0,0,0,0,0,0,0,0,0,0,0,0,0,0,0,0,0,0,0,0,0,0,0,0,0,1,0,1,0,0,Marco Estrada,£3.60m ,37.0,174.0,Midfielder - Defensive Midfield,left,Retired,34.0,3.0,6.0,2599.0,33.0,2.0,5.0,2306.0,32.0,4.0,1.0,2314.0,11.0,2.0,1.0,990.0,nan,nan,nan,nan,11.0,0.0,2.0,540.0,nan,nan,nan,nan,nan,nan,nan,nan,nan,nan,nan,nan,Ligue 1,nan,nan,nan,nan,nan,nan,nan,nan
19/6/2011,Marco Donadel,830544,776,4/21/1983,28,0,0,31,1,4500,6650,6650,134,133,579652,179,73,DM/M C,1,1,1,1,1,1,1,1,1,1,1,9,10,10,7,12,9,10,12,8,15,12,10,15,11,18,14,13,14,17,12,14,13,9,14,11,13,16,17,12,14,15,9,5,13,13,20,16,14,16,16,14,11,9,12,13,13,13,15,15,12,3,1,1,20,1,1,1,20,DM/M C,311,1,1,1,1,1,1,1,1,1,20,20,1,1,1,1,4311744640,0,0,0,0,0,0,0,1,0,0,0,0,0,0,0,0,0,0,0,0,0,0,0,0,1,0,0,0,0,0,0,0,1,0,0,0,0,0,0,0,0,0,0,0,0,0,0,0,Marco Donadel,£2.70m ,37.0,179.0,Midfielder - Defensive Midfield,right,Retired,31.0,1.0,0.0,2343.0,1.0,0.0,0.0,16.0,15.0,0.0,1.0,938.0,24.0,1.0,0.0,1267.0,34.0,1.0,8.0,2731.0,26.0,0.0,5.0,1984.0,21.0,2.0,1.0,1604.0,2.0,0.0,0.0,96.0,nan,nan,nan,nan,Serie A,nan,nan,nan,nan,nan,nan,nan,nan
19/6/2011,Marco Caligiuri,8707875,771,4/14/1984,27,0,0,2,0,3350,6250,6250,131,128,496060,180,75,D/WB/DM/M RC,1,1,2,3,1,3,1,3,1,1,2,5,11,11,9,13,6,10,9,7,13,12,8,16,13,7,15,12,15,11,12,12,13,14,10,12,14,11,14,12,13,12,13,10,14,12,20,12,11,14,11,11,13,10,14,13,8,8,13,13,11,8,16,16,17,10,16,14,17,D/WB/DM/M RC,343,1,1,1,10,10,10,16,10,14,20,17,14,16,12,16,4503603922337856,0,0,0,0,0,0,1,0,0,0,0,0,0,0,0,0,0,0,0,0,0,0,0,0,0,0,0,0,0,0,0,0,1,0,0,0,0,0,0,0,0,0,0,0,0,0,0,0,Marco Caligiuri,£2.25m ,36.0,180.0,Defender - Centre-Back,right,Retired,23.0,1.0,1.0,1708.0,32.0,2.0,2.0,2279.0,26.0,2.0,1.0,1436.0,16.0,0.0,1.0,1191.0,30.0,0.0,0.0,2341.0,33.0,0.0,0.0,2970.0,32.0,0.0,0.0,2784.0,33.0,4.0,0.0,2860.0,25.0,3.0,1.0,1954.0,Bundesliga,30.0,1.0,0.0,2627.0,nan,nan,nan,nan
19/6/2011,Marco Biagianti,837199,776,4/19/1984,27,0,0,0,0,4761,6658,6658,136,133,831150,180,73,DM/M LC,1,1,1,1,1,1,1,1,1,1,1,7,12,8,10,10,6,13,14,8,14,14,10,15,13,14,12,13,12,14,12,12,16,11,16,12,15,16,15,13,14,14,10,8,14,13,20,15,14,16,10,15,12,12,9,16,18,14,15,14,15,6,1,1,19,1,11,15,19,DM/M LC,314,1,1,1,1,1,1,1,1,1,20,19,15,11,1,1,65808,0,0,0,0,1,0,0,0,1,0,0,0,0,0,0,0,1,0,0,0,0,0,0,0,0,0,0,0,0,0,0,0,0,0,0,0,0,0,0,0,0,0,0,0,0,0,0,0,Marco Biagianti,£2.70m ,36.0,180.0,Midfielder - Defensive Midfield,right,Retired,15.0,0.0,0.0,1286.0,15.0,0.0,1.0,800.0,29.0,0.0,0.0,1595.0,27.0,0.0,0.0,1977.0,27.0,0.0,4.0,2034.0,28.0,2.0,0.0,1402.0,31.0,2.0,3.0,2646.0,35.0,2.0,2.0,2491.0,39.0,4.0,0.0,3063.0,Serie A,24.0,1.0,0.0,1180.0,nan,nan,nan,nan
19/6/2011,Marcelo Benítez,14010074,1649,5/29/1989,22,0,0,11,1,2350,3350,3850,106,77,33099,177,72,DM C,3,3,3,2,2,2,2,1,1,2,3,7,8,6,5,10,6,4,9,5,8,12,7,10,10,14,10,12,7,10,8,10,10,8,9,6,10,13,12,12,8,10,7,8,14,9,20,13,8,14,9,10,7,10,9,15,8,8,12,9,13,9,1,1,15,8,1,1,15,DM C,301,1,1,1,8,1,1,1,1,1,20,15,1,1,1,1,140737555464192,0,0,0,0,0,0,0,0,0,0,0,0,0,0,0,0,0,0,0,0,0,0,0,0,0,0,1,0,0,0,0,0,0,0,0,0,0,0,0,0,0,0,0,0,0,0,0,1
19/6/2011,Marcel Gecov,5653961,763,1/1/1988,23,0,0,13,1,2083,6000,6000,140,120,409091,180,70,DM C,2,3,3,1,3,1,3,3,2,1,3,8,8,14,10,13,10,9,8,5,10,15,12,8,14,7,10,9,9,12,15,11,8,13,16,13,11,8,14,15,11,9,9,11,6,15,20,16,11,12,10,12,12,10,14,8,10,6,10,10,10,2,1,1,15,10,1,1,15,DM C,301,1,1,1,10,1,1,1,1,1,20,15,1,1,1,1,4194304,0,0,0,0,0,0,0,0,0,0,0,0,0,0,0,0,0,0,0,0,0,0,1,0,0,0,0,0,0,0,0,0,0,0,0,0,0,0,0,0,0,0,0,0,0,0,0,0,Marcel Gecov,£450Th. ,32.0,183.0,Midfielder - Central Midfield,right,Retired,25.0,1.0,1.0,2089.0,12.0,0.0,0.0,845.0,21.0,2.0,1.0,1372.0,30.0,1.0,0.0,2435.0,25.0,3.0,1.0,1966.0,28.0,1.0,0.0,1928.0,nan,nan,nan,nan,nan,nan,nan,nan,nan,nan,nan,nan,Premier League,nan,nan,nan,nan,nan,nan,nan,nan
19/6/2011,Marc Wilson,5114764,789,8/17/1987,23,1,0,0,0,4417,6275,6650,146,130,1636364,188,80,DM/M RC,2,1,1,2,3,3,1,2,1,1,1,12,15,11,8,13,14,12,8,6,8,14,16,12,12,14,12,12,15,12,14,13,16,10,13,10,12,10,14,11,10,14,14,17,14,12,20,14,13,14,8,11,7,12,14,12,15,10,12,9,9,14,15,8,18,1,15,12,18,DM/M RC,313,1,1,1,1,1,1,15,12,15,20,18,8,8,8,8,149537880539136,0,0,0,0,0,0,0,0,0,0,0,0,0,0,0,0,0,0,0,0,0,0,1,0,0,0,0,0,0,0,0,0,1,0,0,0,0,0,0,0,0,0,0,1,0,0,0,1,Marc Wilson,£4.50m ,33.0,188.0,Defender - Centre-Back,both,Retired,41.0,1.0,2.0,2942.0,45.0,0.0,1.0,3801.0,20.0,0.0,0.0,1611.0,38.0,0.0,0.0,3121.0,30.0,0.0,1.0,2394.0,11.0,1.0,0.0,929.0,8.0,1.0,0.0,526.0,22.0,0.0,0.0,1779.0,17.0,0.0,0.0,1267.0,Premier League,nan,nan,nan,nan,nan,nan,nan,nan
19/6/2011,Marc Hornschuh,35011184,771,3/2/1991,20,0,0,3,0,2800,5250,5250,122,105,225945,188,71,D/DM/M RC,3,1,3,3,1,1,2,2,2,1,3,5,6,6,5,10,5,11,6,12,14,9,8,14,9,12,13,13,11,9,7,11,11,5,7,6,13,14,12,10,12,13,14,10,12,12,20,14,13,12,9,11,8,13,6,14,12,18,12,11,12,5,20,15,16,1,17,5,20,D/DM/M RC,123,1,1,1,1,1,1,20,5,17,19,16,5,5,5,15,0,0,0,0,0,0,0,0,0,0,0,0,0,0,0,0,0,0,0,0,0,0,0,0,0,0,0,0,0,0,0,0,0,0,0,0,0,0,0,0,0,0,0,0,0,0,0,0,0,Marc Hornschuh,£225Th. ,29.0,188.0,Defender - Centre-Back,right,Hamburger SV II,25.0,1.0,0.0,2241.0,17.0,1.0,0.0,1440.0,31.0,0.0,3.0,2466.0,36.0,2.0,1.0,3240.0,33.0,1.0,0.0,2832.0,27.0,2.0,2.0,2280.0,22.0,0.0,1.0,1908.0,7.0,0.0,0.0,609.0,4.0,0.0,0.0,341.0,Bundesliga,7.0,0.0,0.0,571.0,9.0,0.0,0.0,781.0
19/6/2011,Marat Izmailov,475783,791,9/21/1982,28,31,2,0,0,5508,6573,7300,155,146,4743083,169,70,M/AM RLC,3,2,2,1,2,2,2,2,1,3,1,14,15,13,13,13,13,7,16,10,8,14,14,8,14,11,13,10,17,14,14,12,18,14,7,15,11,11,15,15,16,11,9,12,14,16,20,11,9,14,8,13,14,13,15,16,17,20,15,15,18,13,1,1,20,17,20,16,17,M/AM RLC,416,1,1,1,17,10,17,1,1,1,4,17,16,20,1,1,17593260312640,0,0,0,0,0,0,1,0,0,0,0,1,0,0,0,0,0,0,0,1,0,0,0,0,0,0,0,0,0,0,1,0,0,0,0,0,0,0,0,0,0,0,0,0,1,0,0,0,Marat Izmailov,£4.50m ,38.0,172.0,Midfielder - Central Midfield,right,Retired,3.0,0.0,0.0,173.0,25.0,6.0,2.0,1628.0,24.0,1.0,1.0,1236.0,15.0,1.0,0.0,1024.0,31.0,1.0,3.0,1911.0,nan,nan,nan,nan,11.0,2.0,0.0,735.0,4.0,2.0,0.0,315.0,nan,nan,nan,nan,Liga NOS,nan,nan,nan,nan,nan,nan,nan,nan
19/6/2011,Manuele Blasi,703720,776,8/17/1980,30,8,0,6,0,4250,6400,6400,144,127,618150,178,67,DM/M C,1,2,1,1,1,1,2,1,1,1,2,5,8,7,5,14,9,12,5,10,14,14,8,15,8,18,13,20,10,13,12,13,18,6,15,12,15,18,16,12,12,16,11,9,15,13,20,17,17,15,19,14,7,16,12,16,10,10,13,8,8,10,10,12,20,1,14,5,20,DM/M C,421,1,1,1,1,1,1,1,1,10,16,20,5,14,1,12,4312301632,0,0,0,0,0,0,1,0,0,0,0,0,0,0,0,1,0,0,0,1,0,0,0,0,1,0,0,0,0,0,0,0,1,0,0,0,0,0,0,0,0,0,0,0,0,0,0,0,Manuele Blasi,£720Th. ,40.0,178.0,Midfielder - Central Midfield,right,Retired,5.0,0.0,0.0,205.0,23.0,0.0,0.0,1472.0,12.0,0.0,0.0,823.0,24.0,0.0,0.0,1834.0,39.0,0.0,0.0,2221.0,10.0,0.0,0.0,708.0,nan,nan,nan,nan,nan,nan,nan,nan,nan,nan,nan,nan,Serie A,nan,nan,nan,nan,nan,nan,nan,nan
19/6/2011,Manuel Zeitz,91016944,771,8/1/1990,20,0,0,0,0,3000,5250,5250,139,105,419575,180,74,DM/M C,3,3,3,3,1,2,1,1,1,1,3,12,11,11,11,12,10,9,11,5,11,14,12,11,12,14,12,12,12,11,12,13,13,12,10,12,11,14,15,11,12,10,10,7,11,10,20,12,7,11,6,10,5,13,9,15,10,12,11,11,11,7,11,1,18,13,1,1,18,DM/M C,311,1,1,1,13,1,1,11,1,1,20,18,1,1,1,1,0,0,0,0,0,0,0,0,0,0,0,0,0,0,0,0,0,0,0,0,0,0,0,0,0,0,0,0,0,0,0,0,0,0,0,0,0,0,0,0,0,0,0,0,0,0,0,0,0,Manuel Zeitz,£360Th. ,30.0,181.0,Midfielder - Defensive Midfield,right,1.FC Saarbrücken,31.0,6.0,6.0,2621.0,26.0,4.0,1.0,2246.0,25.0,2.0,0.0,1197.0,27.0,0.0,0.0,1596.0,23.0,6.0,0.0,2039.0,33.0,2.0,1.0,2780.0,32.0,3.0,2.0,2770.0,34.0,4.0,3.0,2914.0,34.0,5.0,1.0,3000.0,Bundesliga,29.0,3.0,2.0,2604.0,6.0,0.0,0.0,540.0
19/6/2011,Manuel Schmiedebach,35008171,771,12/5/1988,22,0,0,0,0,4100,6700,6700,151,139,1030925,170,70,D/WB/DM/M RC,3,3,3,3,1,1,3,5,2,3,3,9,13,12,6,13,7,5,6,16,17,14,7,12,14,17,9,16,12,10,12,13,13,13,10,8,9,15,18,16,17,14,6,10,12,12,20,18,8,15,9,12,7,16,12,12,11,10,12,13,14,6,18,18,19,15,18,1,19,D/WB/DM/M RC,343,1,1,1,1,1,15,1,1,18,20,19,1,16,1,18,16809984,0,0,0,0,0,0,0,0,0,0,0,0,0,0,0,1,0,0,0,0,0,0,0,0,1,0,0,0,0,0,0,0,0,0,0,0,0,0,0,0,0,0,0,0,0,0,0,0,Manuel Schmiedebach,£4.95m ,31.0,171.0,Midfielder - Defensive Midfield,right,Without Club,33.0,0.0,6.0,2693.0,44.0,0.0,2.0,3344.0,36.0,1.0,1.0,2144.0,28.0,2.0,2.0,1936.0,28.0,0.0,1.0,2343.0,24.0,1.0,1.0,1967.0,28.0,0.0,2.0,2366.0,7.0,0.0,0.0,226.0,36.0,0.0,2.0,3032.0,Bundesliga,6.0,0.0,0.0,255.0,nan,nan,nan,nan
19/6/2011,Manuel Lucena,1502706,796,11/18/1982,28,0,0,0,0,3000,5510,5510,119,118,39663,186,84,D/DM/M C,2,1,1,1,2,1,2,1,2,1,2,6,10,6,4,10,10,15,10,10,14,12,6,12,10,8,11,15,12,12,10,12,16,6,18,9,14,15,15,10,11,13,15,18,10,10,20,12,15,14,7,14,5,11,16,14,18,14,16,15,15,7,18,1,16,1,1,1,18,D/DM/M C,331,1,10,1,1,1,1,18,1,1,20,16,1,1,1,1,274877906944,0,0,0,0,0,0,0,0,0,0,0,0,0,0,0,0,0,0,0,0,0,0,0,0,0,0,0,0,0,0,0,0,0,0,0,0,0,0,1,0,0,0,0,0,0,0,0,0,Manuel Lucena,£630Th. ,37.0,186.0,Defender - Centre-Back,nan,Retired,26.0,1.0,0.0,2150.0,6.0,0.0,0.0,271.0,3.0,0.0,0.0,197.0,12.0,0.0,2.0,636.0,nan,nan,nan,nan,nan,nan,nan,nan,nan,nan,nan,nan,nan,nan,nan,nan,nan,nan,nan,nan,LaLiga,nan,nan,nan,nan,nan,nan,nan,nan
19/6/2011,Manuel Giandonato,43052125,776,10/10/1991,19,0,0,1,0,2022,5428,5027,142,120,134610,184,82,DM/M C,2,3,1,2,3,2,3,4,3,2,3,10,10,7,11,14,10,10,12,4,14,14,10,14,14,11,13,4,5,11,10,13,7,5,8,8,14,17,12,14,14,14,11,20,11,14,11,9,11,10,5,10,5,10,14,10,9,10,11,7,5,4,1,1,18,1,1,1,18,DM/M C,311,1,1,1,1,1,1,1,1,1,20,18,1,1,1,1,0,0,0,0,0,0,0,0,0,0,0,0,0,0,0,0,0,0,0,0,0,0,0,0,0,0,0,0,0,0,0,0,0,0,0,0,0,0,0,0,0,0,0,0,0,0,0,0,0,Manuel Giandonato,£450Th. ,29.0,188.0,Midfielder - Central Midfield,right,Olbia Calcio 1905,17.0,5.0,0.0,1138.0,8.0,0.0,0.0,208.0,25.0,1.0,4.0,1261.0,11.0,0.0,0.0,345.0,27.0,2.0,1.0,1512.0,22.0,0.0,4.0,639.0,17.0,0.0,2.0,1335.0,25.0,0.0,0.0,1389.0,33.0,3.0,1.0,2367.0,Serie A,24.0,0.0,3.0,1650.0,5.0,0.0,0.0,403.0
19/6/2011,Manuel Curto,744632,788,7/9/1986,24,0,0,0,0,1500,5100,6000,112,108,607189,187,78,DM/M C,2,1,3,2,2,3,1,3,3,2,1,11,11,11,12,10,10,13,11,9,8,12,12,9,11,11,12,11,10,10,12,11,10,12,10,12,10,11,10,10,11,13,14,14,12,9,20,12,14,10,8,10,12,10,7,14,14,3,3,8,7,6,1,1,17,7,1,1,17,DM/M C,311,1,1,7,7,1,1,1,1,1,20,17,1,1,1,1,0,0,0,0,0,0,0,0,0,0,0,0,0,0,0,0,0,0,0,0,0,0,0,0,0,0,0,0,0,0,0,0,0,0,0,0,0,0,0,0,0,0,0,0,0,0,0,0,0,Manuel Curto,£720Th. ,34.0,187.0,Midfielder - Defensive Midfield,right,Retired,19.0,2.0,1.0,1519.0,22.0,1.0,1.0,1522.0,13.0,4.0,3.0,1025.0,17.0,1.0,1.0,1309.0,6.0,0.0,0.0,377.0,13.0,2.0,0.0,874.0,nan,nan,nan,nan,nan,nan,nan,nan,nan,nan,nan,nan,Liga NOS,nan,nan,nan,nan,nan,nan,nan,nan
19/6/2011,Mamadou Bah,85000951,22,4/25/1988,23,18,3,0,0,3500,5850,5278,138,117,412196,183,75,DM/M C,2,2,2,1,1,2,3,1,2,1,2,5,7,10,8,12,8,13,12,7,12,13,7,10,12,12,15,13,11,11,12,10,14,11,8,11,11,12,15,14,12,15,11,8,13,12,20,14,15,12,12,14,7,10,9,15,12,12,9,12,12,7,12,1,18,12,1,10,18,DM/M C,311,1,1,1,12,10,1,12,1,1,20,18,10,1,1,1,260,0,0,1,0,0,0,0,0,1,0,0,0,0,0,0,0,0,0,0,0,0,0,0,0,0,0,0,0,0,0,0,0,0,0,0,0,0,0,0,0,0,0,0,0,0,0,0,0,Mamadou Bah,£450Th. ,32.0,181.0,Midfielder - Defensive Midfield,left,US Raon-l'Étape,9.0,0.0,0.0,706.0,3.0,0.0,0.0,11.0,1.0,0.0,0.0,21.0,17.0,1.0,0.0,1423.0,1.0,0.0,0.0,21.0,nan,nan,nan,nan,nan,nan,nan,nan,nan,nan,nan,nan,1.0,0.0,0.0,54.0,Bundesliga,1.0,0.0,0.0,90.0,nan,nan,nan,nan
19/6/2011,Makoto Hasebe,778087,116,1/18/1984,27,45,2,0,0,6250,6500,6850,140,137,5313293,179,72,DM/M RC,2,2,2,2,2,1,2,1,3,2,3,10,17,12,7,12,8,12,10,11,16,15,8,14,15,15,13,16,9,14,9,11,16,7,12,7,10,19,18,13,15,9,8,14,17,14,20,17,7,16,5,12,5,17,12,10,17,12,18,15,12,1,14,12,20,12,15,1,20,DM/M RC,423,1,1,1,12,1,1,1,1,14,18,20,1,15,1,12,137472540736,0,0,0,0,0,0,1,0,0,0,0,0,0,0,0,1,0,0,0,0,0,0,0,0,0,1,0,0,0,0,0,0,0,0,0,0,0,1,0,0,0,0,0,0,0,0,0,0,Makoto Hasebe,£3.15m ,36.0,180.0,Midfielder - Defensive Midfield,right,Eintracht Frankfurt,24.0,0.0,2.0,1662.0,24.0,1.0,3.0,1836.0,27.0,2.0,2.0,2094.0,15.0,0.0,1.0,1265.0,35.0,0.0,2.0,3032.0,36.0,1.0,2.0,3033.0,25.0,1.0,1.0,2152.0,29.0,0.0,0.0,2569.0,44.0,0.0,0.0,3932.0,Bundesliga,39.0,0.0,0.0,3344.0,5.0,0.0,0.0,450.0
19/6/2011,Lukas Schmitz,35021353,771,10/13/1988,22,0,0,0,0,4600,6400,6800,132,127,1386540,184,80,D/M/AM LC,3,2,2,3,1,2,1,1,3,2,2,13,16,9,10,8,12,9,13,15,9,10,11,11,8,14,8,15,9,16,12,10,14,6,11,13,7,18,16,13,10,15,12,8,13,16,20,17,13,15,6,9,4,17,6,13,12,18,15,14,17,5,17,15,20,18,1,20,15,D/M/AM LC,434,1,1,1,1,18,1,1,17,1,1,15,20,1,15,1,1116691496968,0,0,0,1,0,0,0,0,0,0,0,0,0,0,0,0,0,0,0,0,0,0,0,0,0,0,0,0,0,0,0,0,0,0,1,0,0,0,0,0,1,0,0,0,0,0,0,0,Lukas Schmitz,£2.25m ,32.0,183.0,Defender - Left-Back,left,VVV-Venlo,37.0,0.0,4.0,2743.0,27.0,0.0,4.0,1994.0,23.0,0.0,1.0,1762.0,6.0,0.0,0.0,364.0,23.0,1.0,3.0,1971.0,28.0,1.0,4.0,2454.0,34.0,0.0,5.0,3001.0,13.0,1.0,3.0,925.0,33.0,2.0,4.0,2955.0,Bundesliga,38.0,1.0,2.0,3232.0,5.0,0.0,0.0,441.0
19/6/2011,Lukas Rupp,91012163,771,1/8/1991,20,0,0,0,0,1500,5400,5400,132,108,243145,179,67,M/AM RC,3,3,3,1,3,2,1,5,1,2,2,9,9,13,10,14,10,6,12,3,4,15,12,4,14,8,12,11,13,11,15,9,13,12,9,14,7,13,9,13,14,9,10,6,12,12,20,14,7,11,6,9,6,8,9,12,9,10,14,14,12,7,1,1,16,20,18,14,20,M/AM RC,523,1,1,10,20,14,18,1,1,1,6,15,12,16,1,1,8813277085824,0,0,0,0,0,0,0,1,0,0,0,0,0,0,0,0,0,0,0,0,0,0,1,0,0,0,0,0,0,0,0,0,0,0,1,0,0,0,0,0,0,0,0,1,0,0,0,0,Lukas Rupp,£900Th. ,29.0,178.0,Midfielder - Central Midfield,right,Norwich City,27.0,4.0,0.0,1561.0,26.0,4.0,6.0,1605.0,28.0,0.0,4.0,1652.0,15.0,1.0,0.0,394.0,32.0,4.0,2.0,2050.0,32.0,6.0,6.0,2324.0,17.0,3.0,0.0,955.0,25.0,3.0,3.0,1466.0,4.0,0.0,3.0,238.0,Bundesliga,24.0,0.0,0.0,1319.0,7.0,0.0,0.0,527.0
19/6/2011,Luka Modric,653054,761,9/9/1985,25,44,7,11,1,7505,9006,8262,178,170,8403632,171,66,M/AM RLC,2,2,1,2,2,2,3,8,1,1,1,13,12,16,7,17,13,7,8,11,7,17,15,9,17,12,15,13,14,15,17,18,15,15,17,14,7,18,18,15,16,16,4,15,16,14,20,18,9,13,6,17,6,14,12,17,14,17,16,15,15,3,1,1,20,20,16,18,20,M/AM RLC,416,1,1,1,20,18,16,1,1,1,1,20,15,12,1,1,551903381505,1,0,0,0,0,0,0,0,0,0,0,1,0,0,1,0,1,0,0,0,0,0,0,0,0,0,0,0,0,0,0,1,0,0,0,0,0,0,0,1,0,0,0,0,0,0,0,0,Luka Modric,£35.10m ,35.0,172.0,Midfielder - Central Midfield,both,Real Madrid,43.0,4.0,3.0,3540.0,41.0,5.0,7.0,3548.0,53.0,4.0,8.0,3284.0,51.0,2.0,9.0,4061.0,25.0,1.0,5.0,2007.0,44.0,3.0,4.0,3530.0,41.0,1.0,5.0,3304.0,43.0,2.0,8.0,3339.0,46.0,4.0,8.0,3571.0,Premier League,40.0,5.0,8.0,2631.0,7.0,2.0,0.0,430.0
19/6/2011,Luiz Gustavo,19016523,1651,7/23/1987,23,0,0,0,0,6500,7000,7750,162,148,36363636,187,80,DM/M C,2,2,3,1,3,1,3,6,1,1,3,8,11,9,5,12,5,8,10,12,18,13,6,18,13,16,17,18,8,10,9,12,16,8,10,8,13,17,18,14,13,16,12,20,14,17,12,17,13,11,15,12,7,18,12,14,8,5,13,6,7,10,14,14,18,1,1,14,18,DM/M C,311,1,1,1,1,1,1,12,14,1,20,18,1,1,14,1,33718592,0,0,0,0,0,0,1,0,1,0,0,0,0,0,0,1,0,1,0,0,0,0,0,0,0,1,0,0,0,0,0,0,0,0,0,0,0,0,0,0,0,0,0,0,0,0,0,0,Luiz Gustavo,£13.50m ,33.0,187.0,Midfielder - Defensive Midfield,left,Fenerbahce SK,38.0,3.0,5.0,3174.0,46.0,1.0,2.0,3112.0,36.0,4.0,1.0,2039.0,33.0,4.0,3.0,2903.0,47.0,7.0,1.0,4058.0,30.0,1.0,3.0,2529.0,32.0,0.0,0.0,2794.0,57.0,6.0,2.0,4961.0,38.0,4.0,0.0,3117.0,Bundesliga,35.0,3.0,1.0,3023.0,6.0,0.0,0.0,527.0
19/6/2011,Luiz Carlos,19108538,1651,7/5/1985,25,0,0,0,0,250,4450,4450,120,107,92749,175,75,M C,2,3,2,3,1,1,2,6,1,3,2,10,7,7,13,14,10,10,10,6,8,10,10,13,14,12,11,10,12,13,12,12,10,14,7,10,9,13,14,14,12,12,7,6,10,12,20,10,12,10,13,10,13,10,10,4,8,8,15,1,1,11,1,1,20,12,1,1,20,M C,401,1,1,1,12,1,1,1,1,1,12,20,1,1,1,1,0,0,0,0,0,0,0,0,0,0,0,0,0,0,0,0,0,0,0,0,0,0,0,0,0,0,0,0,0,0,0,0,0,0,0,0,0,0,0,0,0,0,0,0,0,0,0,0,0,Luiz Carlos,£270Th. ,32.0,191.0,Goalkeeper,right,Without Club,0.0,0.0,0.0,0.0,4.0,7.0,1.0,360.0,nan,nan,nan,nan,nan,nan,nan,nan,0.0,0.0,0.0,0.0,0.0,0.0,0.0,0.0,nan,nan,nan,nan,nan,nan,nan,nan,nan,nan,nan,nan,Liga NOS,nan,nan,nan,nan,nan,nan,nan,nan
19/6/2011,Luís Alberto,315562,1651,11/17/1983,27,0,0,0,0,2529,6350,6350,137,127,395257,182,68,DM/M C,2,1,1,3,2,2,3,5,1,1,2,10,10,10,13,11,8,16,13,10,14,13,14,14,12,15,15,15,10,15,13,14,15,10,12,14,15,15,13,12,13,15,17,9,15,12,20,14,15,14,11,12,10,16,14,14,14,14,13,9,9,14,11,13,20,9,13,1,20,DM/M C,311,1,6,7,9,1,3,7,1,11,20,20,1,6,1,13,549823447080,0,0,0,1,0,1,0,0,0,0,0,0,0,0,0,0,0,0,0,1,0,0,0,0,0,0,1,0,0,0,0,0,0,0,0,0,0,0,0,1,0,0,0,0,0,0,0,0,Luís Alberto,£1.17m ,36.0,183.0,Midfielder - Defensive Midfield,right,Without Club,30.0,6.0,1.0,2639.0,15.0,2.0,0.0,912.0,27.0,3.0,0.0,1908.0,19.0,3.0,0.0,469.0,nan,nan,nan,nan,24.0,4.0,2.0,1553.0,13.0,1.0,0.0,716.0,9.0,0.0,2.0,738.0,nan,nan,nan,nan,Liga NOS,nan,nan,nan,nan,nan,nan,nan,nan
19/6/2011,Luigi Giorgi,1400873,776,4/19/1987,24,0,0,0,0,2549,6000,6000,140,123,433327,186,74,M/AM C,2,1,2,3,1,3,2,1,2,2,3,10,8,12,12,12,10,14,11,6,8,15,8,13,14,10,13,14,12,13,15,15,10,12,12,13,13,13,13,12,12,15,12,5,14,12,20,12,10,15,8,14,4,10,11,4,7,17,8,14,9,12,1,1,18,20,1,1,20,M/AM C,521,1,1,1,20,1,1,1,1,1,1,18,1,1,1,1,0,0,0,0,0,0,0,0,0,0,0,0,0,0,0,0,0,0,0,0,0,0,0,0,0,0,0,0,0,0,0,0,0,0,0,0,0,0,0,0,0,0,0,0,0,0,0,0,0,Luigi Giorgi,£495Th. ,33.0,186.0,Midfielder - Central Midfield,right,Without Club,36.0,4.0,0.0,2682.0,26.0,1.0,2.0,1416.0,26.0,5.0,0.0,1540.0,2.0,0.0,0.0,107.0,27.0,0.0,3.0,2077.0,24.0,5.0,2.0,1656.0,27.0,0.0,5.0,1892.0,6.0,0.0,0.0,173.0,10.0,0.0,0.0,307.0,Serie A,18.0,1.0,2.0,1177.0,nan,nan,nan,nan
19/6/2011,Ludovic Obraniak,915581,787,11/10/1984,26,16,4,0,0,5767,7110,6443,145,141,790435,174,72,M/AM RLC,1,1,3,3,1,3,1,4,2,1,1,14,14,15,9,15,14,7,14,7,4,14,12,6,15,8,12,11,13,13,13,14,15,13,10,12,9,12,13,15,14,12,7,20,15,14,14,13,12,13,8,16,6,13,6,15,10,12,14,12,10,10,1,1,18,20,16,20,17,M/AM RLC,526,1,1,1,17,20,16,1,1,1,12,17,18,16,1,1,2560,0,0,0,0,0,0,0,0,0,1,0,1,0,0,0,0,0,0,0,0,0,0,0,0,0,0,0,0,0,0,0,0,0,0,0,0,0,0,0,0,0,0,0,0,0,0,0,0,Ludovic Obraniak,£3.60m ,35.0,174.0,Midfielder - Attacking Midfield,left,Retired,43.0,4.0,7.0,2074.0,38.0,6.0,10.0,2499.0,43.0,8.0,5.0,3439.0,39.0,5.0,5.0,2827.0,21.0,2.0,5.0,1435.0,29.0,3.0,1.0,2319.0,25.0,0.0,2.0,2099.0,20.0,0.0,3.0,1419.0,nan,nan,nan,nan,Ligue 1,nan,nan,nan,nan,nan,nan,nan,nan
19/6/2011,Lucho González,6300238,1649,1/19/1981,30,43,7,0,0,6050,6750,6750,165,150,1572628,185,75,M/AM C,1,3,3,1,1,2,2,5,2,3,3,15,14,13,12,16,14,9,13,8,8,17,14,11,17,12,15,9,16,11,16,14,18,14,12,15,12,18,17,9,13,13,12,12,15,12,20,17,9,10,8,14,10,12,13,15,14,15,16,15,17,8,1,1,20,17,8,1,20,M/AM C,411,1,1,1,17,1,8,1,1,1,10,20,1,8,1,1,1589384,0,0,0,1,0,0,0,1,0,0,0,0,0,0,1,0,0,0,0,1,1,0,0,0,0,0,0,0,0,0,0,0,0,0,0,0,0,0,0,0,0,0,0,0,0,0,0,0,Lucho González,£6.30m ,39.0,186.0,Midfielder - Central Midfield,right,Club Athletico Paranaense,50.0,10.0,7.0,3987.0,46.0,6.0,4.0,3233.0,44.0,10.0,7.0,3447.0,40.0,6.0,6.0,3196.0,18.0,1.0,1.0,815.0,25.0,1.0,1.0,1535.0,38.0,5.0,2.0,2553.0,39.0,2.0,3.0,2739.0,24.0,1.0,1.0,1263.0,Ligue 1,11.0,2.0,0.0,407.0,nan,nan,nan,nan
19/6/2011,Lucas Leiva,8833577,1651,1/9/1987,24,16,0,9,4,7000,8200,7750,162,155,4840741,179,74,DM/M C,1,2,2,3,3,3,2,7,1,1,3,11,13,13,8,14,10,8,8,5,15,14,7,16,15,11,15,13,15,15,14,14,15,11,9,14,16,16,17,13,15,13,12,12,15,14,20,17,14,16,8,15,3,14,15,16,15,16,14,10,12,10,1,1,20,14,10,1,20,DM/M C,311,1,1,1,14,1,1,1,1,1,20,20,1,10,1,1,17592190763024,0,0,0,0,1,0,0,0,0,0,0,0,0,0,0,0,0,0,0,1,0,0,1,0,0,0,0,0,0,0,0,0,0,0,0,0,0,0,0,0,0,0,0,0,1,0,0,0,Lucas Leiva,£13.50m ,33.0,179.0,Midfielder - Defensive Midfield,right,SS Lazio,47.0,1.0,2.0,3882.0,15.0,0.0,1.0,1295.0,32.0,0.0,1.0,2315.0,30.0,0.0,0.0,2100.0,32.0,0.0,0.0,2281.0,40.0,0.0,1.0,2850.0,32.0,1.0,3.0,1778.0,50.0,4.0,5.0,4031.0,36.0,0.0,4.0,2711.0,Premier League,30.0,0.0,1.0,2143.0,6.0,0.0,0.0,400.0
19/6/2011,Luca Rigoni,837879,776,12/7/1984,26,0,0,0,0,3950,6450,6450,138,129,535737,185,78,DM/M C,3,1,2,3,2,2,3,1,1,2,1,9,10,9,10,12,8,12,10,6,12,14,10,14,10,10,14,16,13,14,12,11,15,8,10,13,13,14,16,13,14,14,12,8,14,12,20,16,14,13,9,10,5,12,15,12,12,14,12,12,12,10,1,1,20,1,1,1,20,DM/M C,421,1,1,1,1,1,1,1,1,1,18,20,1,1,1,1,0,0,0,0,0,0,0,0,0,0,0,0,0,0,0,0,0,0,0,0,0,0,0,0,0,0,0,0,0,0,0,0,0,0,0,0,0,0,0,0,0,0,0,0,0,0,0,0,0,Luca Rigoni,£2.88m ,35.0,185.0,Midfielder - Central Midfield,right,LR Vicenza Virtus,29.0,1.0,1.0,2343.0,27.0,2.0,0.0,2123.0,32.0,1.0,3.0,2804.0,34.0,4.0,2.0,3020.0,32.0,9.0,1.0,2768.0,30.0,5.0,0.0,2018.0,32.0,3.0,3.0,2474.0,24.0,2.0,2.0,1625.0,24.0,2.0,0.0,1855.0,Serie A,19.0,0.0,0.0,1133.0,3.0,1.0,0.0,201.0
19/6/2011,Luca Marrone,43025940,776,3/28/1990,21,0,0,16,1,2000,5500,5500,154,119,224003,186,75,DM/M C,1,1,1,1,1,2,3,3,2,1,1,6,6,9,6,11,7,11,11,10,13,14,6,14,12,13,14,14,14,12,11,15,15,7,12,8,12,14,14,12,12,13,12,6,15,12,20,13,13,13,10,9,6,10,8,14,13,5,12,14,11,13,1,1,18,1,1,1,18,DM/M C,311,1,1,1,1,1,1,1,1,1,20,18,1,1,1,1,0,0,0,0,0,0,0,0,0,0,0,0,0,0,0,0,0,0,0,0,0,0,0,0,0,0,0,0,0,0,0,0,0,0,0,0,0,0,0,0,0,0,0,0,0,0,0,0,0,Luca Marrone,£2.25m ,30.0,186.0,Defender - Centre-Back,right,FC Crotone,19.0,1.0,3.0,1237.0,6.0,1.0,1.0,304.0,15.0,0.0,0.0,1172.0,15.0,0.0,3.0,1140.0,0.0,0.0,0.0,0.0,25.0,1.0,5.0,1992.0,28.0,1.0,0.0,1779.0,34.0,1.0,1.0,2930.0,25.0,0.0,0.0,2058.0,Serie A,31.0,3.0,0.0,2576.0,4.0,0.0,0.0,360.0
19/6/2011,Luca Cigarini,7990880,776,6/20/1986,24,0,0,29,1,5250,6515,6950,153,137,334967,175,72,M C,1,2,3,3,2,1,1,4,3,1,3,15,13,13,9,12,16,10,14,13,12,18,16,13,15,14,12,11,12,12,16,12,9,14,10,14,12,15,13,13,14,10,8,10,14,13,20,14,9,13,6,12,8,10,15,12,12,9,15,13,15,8,1,1,20,5,1,1,20,M C,401,1,1,1,5,1,1,1,1,1,15,20,1,1,1,1,0,0,0,0,0,0,0,0,0,0,0,0,0,0,0,0,0,0,0,0,0,0,0,0,0,0,0,0,0,0,0,0,0,0,0,0,0,0,0,0,0,0,0,0,0,0,0,0,0,Luca Cigarini,£4.95m ,34.0,175.0,Midfielder - Defensive Midfield,right,FC Crotone,18.0,3.0,2.0,893.0,32.0,1.0,2.0,2547.0,30.0,2.0,5.0,2491.0,36.0,2.0,8.0,2618.0,34.0,1.0,3.0,2774.0,26.0,2.0,2.0,1902.0,7.0,0.0,0.0,471.0,27.0,2.0,3.0,2153.0,28.0,0.0,1.0,1933.0,Serie A,22.0,0.0,4.0,1604.0,5.0,0.0,1.0,391.0
19/6/2011,Lorenzo Davids,859350,784,9/4/1986,24,0,0,0,0,5020,5923,6100,137,122,158103,180,69,DM/M LC,2,1,1,1,3,3,3,5,2,1,3,7,9,12,6,14,7,11,7,10,14,13,10,13,15,15,14,13,11,11,13,12,14,13,10,16,14,13,16,11,11,12,11,20,14,11,10,15,12,14,6,15,3,12,14,15,9,15,17,10,12,12,11,13,20,12,9,17,20,DM/M LC,424,1,1,1,8,12,6,10,11,1,17,20,17,9,13,5,0,0,0,0,0,0,0,0,0,0,0,0,0,0,0,0,0,0,0,0,0,0,0,0,0,0,0,0,0,0,0,0,0,0,0,0,0,0,0,0,0,0,0,0,0,0,0,0,0,Lorenzo Davids,£900Th. ,34.0,180.0,Midfielder - Defensive Midfield,left,SV Nijmegen,30.0,2.0,3.0,2238.0,23.0,0.0,0.0,1760.0,10.0,0.0,0.0,684.0,7.0,0.0,0.0,185.0,nan,nan,nan,nan,nan,nan,nan,nan,nan,nan,nan,nan,1.0,0.0,0.0,90.0,8.0,0.0,0.0,750.0,Bundesliga,nan,nan,nan,nan,nan,nan,nan,nan
19/6/2011,Lewis Holtby,91000734,771,9/18/1990,20,2,0,10,5,5750,7050,7050,161,140,8547927,174,66,AM LC,2,1,3,2,3,2,2,6,1,3,3,13,12,14,11,17,11,7,12,5,6,17,10,7,16,9,14,8,10,7,17,11,13,15,10,13,6,8,14,14,16,12,6,20,11,13,15,14,8,9,5,11,4,9,12,15,11,11,15,12,14,6,1,1,15,20,14,18,20,AM LC,504,1,1,10,20,18,14,1,1,1,8,15,14,10,1,1,549773639812,0,0,1,0,0,0,0,1,0,0,0,0,0,0,0,0,0,0,0,0,1,0,0,0,1,0,0,0,0,0,0,0,0,0,0,0,0,0,0,1,0,0,0,0,0,0,0,0,Lewis Holtby,£7.20m ,30.0,176.0,Midfielder - Attacking Midfield,left,Blackburn Rovers,32.0,6.0,10.0,2157.0,41.0,9.0,5.0,2981.0,44.0,4.0,13.0,2934.0,37.0,6.0,9.0,2148.0,28.0,0.0,2.0,1918.0,35.0,3.0,4.0,2977.0,30.0,1.0,6.0,2511.0,17.0,6.0,0.0,1240.0,31.0,5.0,6.0,2300.0,Bundesliga,27.0,3.0,4.0,1301.0,8.0,1.0,0.0,630.0
19/6/2011,Levan Kobiashvili,3600805,770,7/10/1977,33,96,12,4,2,5900,6655,6500,155,121,418596,183,79,D/WB/DM LC,3,1,2,1,3,1,3,8,3,3,3,10,12,6,7,13,10,7,11,14,11,14,16,13,14,9,17,10,14,17,8,13,10,4,11,7,16,17,14,8,10,14,10,20,15,10,6,15,11,17,10,12,14,17,16,7,18,13,19,10,16,1,18,16,15,9,1,18,15,D/WB/DM LC,334,1,1,1,8,9,1,1,18,1,20,15,14,1,16,1,21579694080,0,0,0,0,0,0,0,0,0,0,0,0,0,0,0,0,0,0,0,0,0,0,1,0,0,1,1,0,0,0,0,0,1,0,1,0,0,0,0,0,0,0,0,0,0,0,0,0,Levan Kobiashvili,£450Th. ,43.0,183.0,Midfielder - Left Midfield,left,Retired,34.0,3.0,3.0,3015.0,36.0,2.0,2.0,3191.0,11.0,1.0,1.0,827.0,15.0,1.0,0.0,1061.0,nan,nan,nan,nan,nan,nan,nan,nan,nan,nan,nan,nan,nan,nan,nan,nan,nan,nan,nan,nan,Bundesliga,nan,nan,nan,nan,nan,nan,nan,nan
19/6/2011,Leonel Olímpio,2110008,1651,7/7/1982,28,0,0,0,0,3000,5219,5600,122,116,365026,185,77,DM/M C,3,2,3,3,2,1,1,5,3,2,2,9,9,9,9,11,10,13,12,10,11,12,10,9,11,14,13,13,13,14,9,12,14,6,13,9,13,13,13,12,12,14,14,8,15,11,20,14,14,14,10,12,6,11,13,12,13,14,14,14,14,5,7,1,20,1,7,1,20,DM/M C,311,1,1,1,1,1,1,7,1,7,20,20,1,5,1,1,0,0,0,0,0,0,0,0,0,0,0,0,0,0,0,0,0,0,0,0,0,0,0,0,0,0,0,0,0,0,0,0,0,0,0,0,0,0,0,0,0,0,0,0,0,0,0,0,0,Leonel Olímpio,£1.35m ,38.0,184.0,Midfielder - Defensive Midfield,right,Without Club,37.0,1.0,1.0,3076.0,30.0,0.0,1.0,2114.0,32.0,2.0,0.0,2694.0,33.0,2.0,0.0,2496.0,22.0,2.0,0.0,1726.0,nan,nan,nan,nan,41.0,1.0,0.0,3553.0,19.0,0.0,2.0,1512.0,5.0,1.0,0.0,329.0,Liga NOS,nan,nan,nan,nan,nan,nan,nan,nan
19/6/2011,Leonardo Ponzio,950349,1649,1/29/1982,29,7,0,7,0,4750,7000,6750,142,138,1417132,178,75,D/DM/M RC,3,1,3,2,2,3,3,1,2,3,1,10,11,9,7,11,12,6,17,12,12,12,12,15,11,16,15,17,8,16,9,10,16,9,15,8,12,16,18,14,12,13,9,12,15,12,20,17,12,14,13,13,6,17,13,14,14,14,17,17,15,8,17,11,16,1,17,12,16,D/DM/M RC,333,1,13,1,1,1,1,10,12,17,20,16,10,15,6,11,44117904065024,0,0,0,0,0,0,0,0,0,1,0,0,0,0,0,0,0,0,0,0,0,0,0,0,0,0,0,0,0,0,0,0,0,0,0,0,0,1,0,0,0,0,0,1,0,1,0,0,Leonardo Ponzio,£2.70m ,38.0,175.0,Midfielder - Defensive Midfield,right,Club Atlético River Plate,33.0,2.0,1.0,2657.0,26.0,1.0,1.0,2292.0,35.0,4.0,1.0,2713.0,27.0,1.0,0.0,2166.0,40.0,1.0,1.0,2793.0,21.0,0.0,2.0,1737.0,33.0,0.0,1.0,2943.0,30.0,1.0,0.0,2475.0,25.0,0.0,0.0,1532.0,LaLiga,8.0,0.0,0.0,380.0,nan,nan,nan,nan
19/6/2011,Leon Osman,106728,765,5/17/1981,30,0,0,0,0,4600,6550,6700,150,142,1015379,173,64,M/AM RC,2,1,1,2,2,2,1,5,2,2,3,10,12,16,14,16,12,10,14,1,8,15,15,12,15,8,13,13,14,13,15,13,14,14,9,15,12,15,15,13,15,11,6,13,15,10,20,14,7,14,8,13,10,12,4,10,15,13,15,14,17,3,1,1,18,20,18,14,20,M/AM RC,523,1,1,7,20,13,17,1,1,1,12,18,14,18,1,1,1048576,0,0,0,0,0,0,0,0,0,0,0,0,0,0,0,0,0,0,0,0,1,0,0,0,0,0,0,0,0,0,0,0,0,0,0,0,0,0,0,0,0,0,0,0,0,0,0,0,Leon Osman,£4.05m ,39.0,173.0,Midfielder - Central Midfield,right,Retired,31.0,5.0,7.0,2294.0,36.0,5.0,4.0,2867.0,42.0,8.0,2.0,3655.0,43.0,3.0,7.0,2492.0,30.0,3.0,2.0,1642.0,17.0,1.0,3.0,753.0,nan,nan,nan,nan,nan,nan,nan,nan,nan,nan,nan,nan,Premier League,nan,nan,nan,nan,nan,nan,nan,nan
19/6/2011,Leon Britton,5100711,765,9/16/1982,28,0,0,0,0,3250,5800,6000,120,116,138219,166,64,DM/M C,1,1,1,3,1,3,3,5,2,3,1,8,9,15,6,12,10,7,5,2,7,11,11,13,13,4,11,15,10,12,13,11,17,13,8,13,10,15,19,14,17,17,4,11,15,12,20,14,6,17,4,15,6,4,8,10,16,14,14,14,15,3,1,1,20,10,8,1,20,DM/M C,311,1,1,1,10,1,8,1,1,1,20,20,1,8,1,1,17626546831428,0,0,1,0,0,0,1,0,0,0,0,0,0,0,0,0,0,0,0,0,1,0,0,0,0,0,0,0,0,0,0,0,0,0,0,1,0,0,0,0,0,0,0,0,1,0,0,0,Leon Britton,£3.15m ,38.0,167.0,Midfielder - Central Midfield,right,Llanelli AFC,46.0,2.0,2.0,3432.0,37.0,0.0,1.0,3105.0,41.0,0.0,0.0,3231.0,34.0,0.0,4.0,2819.0,9.0,0.0,0.0,537.0,28.0,0.0,0.0,1764.0,18.0,0.0,0.0,1347.0,7.0,0.0,0.0,402.0,2.0,0.0,0.0,179.0,Premier League,nan,nan,nan,nan,nan,nan,nan,nan
19/6/2011,Leon Andreasen,927544,764,4/23/1983,28,15,2,23,6,5900,6100,6700,140,133,259050,185,84,D/DM/M C,2,3,2,1,3,2,2,4,1,3,2,6,10,7,9,13,13,14,13,12,14,11,13,15,11,17,13,17,14,13,11,13,15,9,14,6,13,15,13,12,13,12,15,11,11,12,20,15,14,11,14,16,17,15,5,16,14,14,9,6,5,16,18,8,16,5,13,11,18,D/DM/M C,331,1,5,1,5,1,1,18,11,13,20,16,1,1,8,8,35253091729920,0,0,0,0,0,0,0,0,0,1,0,0,0,0,0,1,0,1,0,0,0,0,0,0,0,0,0,0,0,0,0,0,0,0,0,0,1,0,0,0,0,0,0,0,0,1,0,0
19/6/2011,Lee Cattermole,5123105,765,3/21/1988,23,0,0,16,3,4650,6800,6800,145,136,4052344,178,77,M C,2,1,1,1,2,3,1,10,3,2,1,7,10,12,8,14,12,13,10,10,15,14,6,13,13,20,15,20,13,10,14,12,16,6,17,10,12,18,17,12,10,13,9,12,10,11,20,15,14,11,20,9,15,5,5,14,12,9,9,9,4,15,1,1,20,1,5,1,20,M C,401,1,1,1,1,1,1,1,1,1,15,20,1,5,1,1,2336462274560,0,0,0,0,0,0,0,0,0,0,0,0,0,0,0,0,1,0,0,0,0,0,0,0,0,0,0,0,0,0,0,0,0,0,0,0,0,1,0,0,0,1,0,0,0,0,0,0,Lee Cattermole,£5.40m ,32.0,178.0,Midfielder - Defensive Midfield,right,Retired,24.0,0.0,0.0,2012.0,28.0,0.0,0.0,2292.0,14.0,0.0,0.0,878.0,33.0,1.0,1.0,2514.0,28.0,1.0,0.0,2358.0,34.0,0.0,0.0,2407.0,9.0,0.0,0.0,661.0,35.0,1.0,6.0,3032.0,36.0,7.0,1.0,3065.0,Premier League,13.0,0.0,0.0,898.0,nan,nan,nan,nan
19/6/2011,Leandro Salino,8877986,1651,4/22/1985,26,0,0,0,0,3014,5964,6500,140,130,551729,170,69,M C,2,3,1,1,2,2,2,6,3,2,1,10,9,12,9,12,9,8,10,7,14,12,10,13,12,16,15,13,13,14,13,14,10,10,13,13,15,17,18,14,14,12,6,9,13,14,20,15,10,14,10,15,11,14,7,11,14,9,13,8,6,9,1,1,20,5,1,1,20,M C,401,1,1,1,5,1,1,1,1,1,14,20,1,1,1,1,0,0,0,0,0,0,0,0,0,0,0,0,0,0,0,0,0,0,0,0,0,0,0,0,0,0,0,0,0,0,0,0,0,0,0,0,0,0,0,0,0,0,0,0,0,0,0,0,0,Leandro Salino,£4.05m ,35.0,170.0,Defender - Right-Back,right,Betim Esporte Clube B,38.0,1.0,2.0,2336.0,33.0,1.0,3.0,2371.0,34.0,2.0,0.0,2890.0,30.0,0.0,3.0,2447.0,20.0,0.0,3.0,1758.0,26.0,0.0,1.0,2061.0,7.0,0.0,0.0,458.0,nan,nan,nan,nan,nan,nan,nan,nan,Liga NOS,1.0,0.0,0.0,90.0,nan,nan,nan,nan
19/6/2011,Leandro Greco,7984090,776,7/19/1986,24,0,0,0,0,4400,6000,6000,135,124,208017,177,73,M/AM LC,1,1,1,1,1,1,1,1,1,1,1,2,11,14,9,14,4,8,11,1,8,14,4,9,15,8,14,9,12,14,14,12,12,13,7,13,13,14,15,13,14,11,8,8,11,14,20,12,13,11,11,12,18,11,12,18,10,10,15,15,12,9,1,1,20,18,12,18,20,M/AM LC,414,1,1,1,18,18,12,1,1,1,13,20,15,12,1,1,320,0,0,0,0,0,0,1,0,1,0,0,0,0,0,0,0,0,0,0,0,0,0,0,0,0,0,0,0,0,0,0,0,0,0,0,0,0,0,0,0,0,0,0,0,0,0,0,0,Leandro Greco,£2.25m ,34.0,184.0,Midfielder - Central Midfield,left,FC Südtirol,19.0,1.0,2.0,983.0,21.0,0.0,2.0,975.0,38.0,1.0,4.0,2145.0,32.0,4.0,2.0,2408.0,28.0,0.0,2.0,1767.0,28.0,1.0,1.0,2033.0,11.0,0.0,0.0,574.0,18.0,0.0,1.0,1200.0,27.0,2.0,1.0,2039.0,Serie A,13.0,0.0,0.0,702.0,7.0,0.0,1.0,480.0
19/6/2011,Laurent Batlles,14248,769,9/23/1975,35,0,0,4,0,4600,5800,5800,140,129,54223,174,68,M C,3,1,2,3,1,1,2,1,2,3,2,13,13,11,8,14,14,7,16,5,6,15,14,9,14,9,13,13,14,16,13,14,14,11,15,9,12,14,14,10,13,13,7,12,16,12,20,12,13,14,9,16,8,10,14,14,13,14,14,14,16,8,1,1,20,14,10,10,20,M C,401,1,1,1,14,10,10,1,1,1,14,20,1,1,1,1,35184376283392,0,0,0,0,0,0,0,0,1,0,0,0,0,0,0,0,0,0,0,0,0,0,1,0,0,0,0,0,0,0,0,0,0,0,0,0,0,0,0,0,0,0,0,0,0,1,0,0,Laurent Batlles,£900Th. ,45.0,174.0,Midfielder - Attacking Midfield,both,Retired,36.0,4.0,3.0,2061.0,39.0,4.0,6.0,1510.0,nan,nan,nan,nan,nan,nan,nan,nan,nan,nan,nan,nan,nan,nan,nan,nan,nan,nan,nan,nan,nan,nan,nan,nan,nan,nan,nan,nan,Ligue 1,nan,nan,nan,nan,nan,nan,nan,nan
19/6/2011,Lassana Diarra,8434283,769,3/10/1985,26,28,0,18,0,7000,6884,7500,161,153,0,173,70,DM/M RC,2,1,3,2,1,1,1,8,2,1,1,11,10,11,6,13,9,8,10,12,12,15,6,16,13,16,14,16,12,14,11,13,19,8,8,12,14,19,17,15,15,16,7,12,18,13,20,19,13,19,14,16,4,16,17,15,9,17,10,14,15,14,15,12,20,8,15,1,20,DM/M RC,423,1,1,1,8,1,1,1,1,15,18,20,1,13,1,12,137438953536,0,0,0,0,0,0,1,0,0,0,0,0,0,0,0,0,0,0,0,0,0,0,0,0,0,0,0,0,0,0,0,0,0,0,0,0,0,1,0,0,0,0,0,0,0,0,0,0,Lassana Diarra,£13.50m ,35.0,173.0,Midfielder - Defensive Midfield,right,Retired,38.0,0.0,3.0,2362.0,25.0,0.0,1.0,1633.0,26.0,1.0,0.0,2167.0,21.0,1.0,1.0,1525.0,nan,nan,nan,nan,33.0,1.0,1.0,2751.0,12.0,0.0,0.0,817.0,20.0,0.0,1.0,1020.0,4.0,0.0,0.0,223.0,LaLiga,nan,nan,nan,nan,nan,nan,nan,nan
19/6/2011,Lars Stindl,35011818,771,8/26/1988,22,0,0,1,0,4150,6550,6550,149,131,656115,180,73,M/AM RC,1,2,1,1,1,3,3,3,2,3,2,13,12,12,13,14,13,8,14,4,6,14,15,7,14,7,12,12,13,13,15,13,14,12,10,14,8,16,14,13,11,12,10,8,13,14,20,15,13,11,9,11,5,13,9,14,13,11,15,14,13,9,1,1,20,19,18,14,20,M/AM RC,413,1,1,5,19,14,18,1,1,1,13,20,14,18,1,1,4398050705536,0,0,0,0,0,0,0,1,0,0,0,0,0,0,0,0,0,0,0,0,0,0,1,0,0,0,0,0,0,0,0,0,0,0,0,0,0,0,0,0,0,0,1,0,0,0,0,0,Lars Stindl,£5.40m ,32.0,181.0,Forward - Second Striker,right,Borussia Mönchengladbach,34.0,2.0,5.0,2302.0,43.0,6.0,7.0,3766.0,29.0,4.0,9.0,2435.0,33.0,3.0,3.0,2837.0,22.0,11.0,4.0,1884.0,39.0,14.0,15.0,3384.0,44.0,18.0,9.0,3811.0,34.0,6.0,5.0,3001.0,22.0,3.0,3.0,1602.0,Bundesliga,30.0,11.0,3.0,1712.0,7.0,2.0,1.0,438.0
19/6/2011,Lars Bender,35007385,771,4/27/1989,22,0,0,1,0,5400,6850,6850,160,137,871708,184,77,DM/M C,1,1,2,3,2,2,2,6,3,1,1,8,11,13,10,14,11,12,11,8,13,14,10,15,14,12,14,15,14,13,14,12,17,10,11,11,15,15,15,13,12,11,12,10,14,13,20,13,11,13,6,13,9,14,5,13,16,15,17,15,15,4,5,1,20,14,10,6,20,DM/M C,421,1,1,1,14,1,1,5,1,1,19,20,6,10,1,1,0,0,0,0,0,0,0,0,0,0,0,0,0,0,0,0,0,0,0,0,0,0,0,0,0,0,0,0,0,0,0,0,0,0,0,0,0,0,0,0,0,0,0,0,0,0,0,0,0,Lars Bender,£13.50m ,31.0,185.0,Defender - Right-Back,right,Bayer 04 Leverkusen,42.0,3.0,2.0,2202.0,37.0,5.0,5.0,3168.0,41.0,3.0,8.0,3469.0,39.0,4.0,2.0,3151.0,35.0,1.0,3.0,2806.0,17.0,2.0,0.0,1315.0,12.0,0.0,1.0,823.0,24.0,3.0,7.0,1792.0,27.0,1.0,5.0,1814.0,Bundesliga,28.0,2.0,1.0,2043.0,5.0,1.0,1.0,425.0
19/6/2011,Landry N'Guemo,8434325,11,11/28/1985,25,21,2,0,0,5350,6600,5982,145,132,653805,173,70,DM/M C,2,3,2,2,1,3,3,1,1,1,1,10,11,11,6,12,8,12,11,6,8,13,13,13,12,12,16,15,11,13,12,11,12,9,10,9,13,15,17,16,13,13,6,8,15,14,20,17,13,14,12,14,7,8,15,15,13,14,12,15,15,5,1,1,16,12,1,1,16,DM/M C,311,1,1,1,12,1,1,1,1,1,20,16,1,1,1,1,8797166764032,0,0,0,0,0,0,0,0,0,0,0,0,0,0,0,0,0,0,0,0,0,0,0,0,0,0,0,0,0,0,1,0,0,0,0,0,0,0,0,0,0,0,0,1,0,0,0,0,Landry N'Guémo,£3.60m ,34.0,174.0,Midfielder - Defensive Midfield,right,Retired,37.0,2.0,2.0,2992.0,35.0,1.0,1.0,2993.0,19.0,0.0,0.0,1180.0,29.0,1.0,2.0,2261.0,17.0,1.0,0.0,1100.0,37.0,2.0,4.0,2980.0,27.0,0.0,2.0,1470.0,nan,nan,nan,nan,21.0,0.0,1.0,1570.0,Ligue 1,nan,nan,nan,nan,nan,nan,nan,nan
19/6/2011,Kwadwo Asamoah,12012662,21,12/9/1988,22,29,1,0,0,5750,7450,7450,172,150,2431051,178,78,M C,3,1,2,1,2,1,1,9,2,1,2,6,11,15,12,14,8,8,14,3,14,13,12,15,14,14,13,16,15,13,12,13,13,11,8,14,14,12,14,16,15,17,9,20,17,15,8,16,16,14,13,14,6,14,14,15,12,15,12,14,16,4,1,1,20,15,1,12,20,M C,401,1,1,1,15,1,1,1,1,1,15,20,12,1,1,1,4,0,0,1,0,0,0,0,0,0,0,0,0,0,0,0,0,0,0,0,0,0,0,0,0,0,0,0,0,0,0,0,0,0,0,0,0,0,0,0,0,0,0,0,0,0,0,0,0,Kwadwo Asamoah,£13.50m ,31.0,173.0,Midfielder - Left Midfield,left,Without Club,39.0,2.0,3.0,3336.0,40.0,3.0,3.0,3385.0,36.0,3.0,9.0,2738.0,47.0,2.0,6.0,3847.0,10.0,0.0,1.0,884.0,13.0,0.0,2.0,770.0,24.0,0.0,2.0,1883.0,26.0,0.0,0.0,2029.0,42.0,0.0,2.0,3578.0,Serie A,11.0,0.0,1.0,899.0,nan,nan,nan,nan
19/6/2011,Korey Smith,28013681,765,1/31/1991,20,0,0,0,0,2400,5250,5250,135,108,449632,183,78,M C,3,2,3,2,2,1,3,4,1,2,1,6,9,11,10,10,4,9,12,2,12,12,7,13,12,13,12,13,12,12,12,12,14,11,6,12,11,12,14,12,12,13,9,8,13,13,20,13,13,13,5,10,3,13,9,13,12,9,13,12,16,1,13,12,20,14,14,1,20,M C,401,1,1,1,8,1,14,1,1,13,1,20,1,13,1,12,32,0,0,0,0,0,1,0,0,0,0,0,0,0,0,0,0,0,0,0,0,0,0,0,0,0,0,0,0,0,0,0,0,0,0,0,0,0,0,0,0,0,0,0,0,0,0,0,0,Korey Smith,£900Th. ,29.0,183.0,Midfielder - Defensive Midfield,right,Swansea City,30.0,0.0,3.0,1978.0,17.0,0.0,3.0,1282.0,35.0,1.0,4.0,2911.0,52.0,2.0,2.0,4702.0,54.0,2.0,3.0,4727.0,38.0,0.0,3.0,3416.0,24.0,0.0,1.0,1901.0,52.0,3.0,1.0,4313.0,6.0,0.0,0.0,326.0,Premier League,22.0,0.0,0.0,1686.0,8.0,0.0,1.0,702.0
19/6/2011,Koke,67047092,796,1/8/1992,19,0,0,0,0,4000,6150,6150,137,123,4745066,175,72,M/AM LC,3,2,3,2,3,2,2,9,3,1,3,8,13,12,8,13,12,8,13,6,11,15,10,12,15,7,11,12,14,13,14,15,15,13,12,11,10,13,14,10,12,13,8,20,14,12,10,13,10,13,5,12,5,10,14,14,14,13,15,11,12,6,1,1,20,17,10,15,20,M/AM LC,414,1,1,1,17,8,1,1,1,1,14,20,15,10,1,1,4194304,0,0,0,0,0,0,0,0,0,0,0,0,0,0,0,0,0,0,0,0,0,0,1,0,0,0,0,0,0,0,0,0,0,0,0,0,0,0,0,0,0,0,0,0,0,0,0,0,Koke,£3.15m ,28.0,176.0,Midfielder - Central Midfield,right,Atlético Madrid,32.0,4.0,1.0,2128.0,40.0,2.0,6.0,1907.0,48.0,3.0,13.0,3391.0,58.0,7.0,18.0,4624.0,49.0,4.0,18.0,4195.0,51.0,5.0,17.0,4430.0,54.0,5.0,10.0,4694.0,51.0,6.0,7.0,4093.0,41.0,6.0,7.0,3511.0,LaLiga,42.0,5.0,6.0,3526.0,6.0,0.0,0.0,421.0
19/6/2011,Kim Källström,4300331,797,8/24/1982,28,58,9,0,0,6050,7250,6688,155,148,1804271,181,79,M/AM LC,1,2,3,1,1,3,3,5,1,3,1,13,13,13,8,14,15,14,16,11,12,16,12,12,14,15,14,15,14,14,13,13,18,9,12,9,13,16,18,13,12,15,10,20,14,11,12,17,15,14,11,12,10,13,15,15,13,16,14,12,12,7,14,14,20,16,5,17,20,M/AM LC,414,1,1,8,16,15,5,1,14,1,12,20,17,5,14,1,35184372089472,0,0,0,0,0,0,0,1,0,1,0,0,0,0,0,0,0,0,0,0,0,0,0,0,0,0,0,0,0,0,0,0,0,0,0,0,0,0,0,0,0,0,0,0,0,1,0,0,Kim Källström,£7.65m ,38.0,185.0,Midfielder - Central Midfield,left,Retired,42.0,3.0,5.0,3246.0,51.0,2.0,11.0,4468.0,27.0,2.0,2.0,1896.0,16.0,1.0,2.0,683.0,28.0,2.0,3.0,2150.0,35.0,1.0,11.0,3111.0,52.0,3.0,13.0,4623.0,nan,nan,nan,nan,nan,nan,nan,nan,Ligue 1,nan,nan,nan,nan,nan,nan,nan,nan
19/6/2011,Kieron Dyer,2004002,765,12/29/1978,32,33,0,11,1,4500,5750,5750,150,129,215305,173,64,M/AM RC,2,1,3,3,2,2,2,4,2,1,1,6,13,15,13,13,9,9,9,3,11,15,6,12,14,12,15,11,13,10,13,13,13,14,5,15,8,11,10,14,13,15,6,12,6,13,20,12,9,10,6,11,20,15,7,12,10,12,8,7,7,13,10,14,20,20,16,12,20,M/AM RC,413,1,1,10,20,12,16,1,1,10,1,20,12,16,1,14,17302532,0,0,1,0,0,0,0,0,0,0,1,0,0,0,0,0,0,0,0,1,0,0,0,0,1,0,0,0,0,0,0,0,0,0,0,0,0,0,0,0,0,0,0,0,0,0,0,0,Kieron Dyer,£450Th. ,41.0,170.0,Midfielder - Right Midfield,right,Retired,19.0,0.0,1.0,901.0,1.0,0.0,0.0,7.0,16.0,3.0,2.0,977.0,nan,nan,nan,nan,nan,nan,nan,nan,nan,nan,nan,nan,nan,nan,nan,nan,nan,nan,nan,nan,nan,nan,nan,nan,Premier League,nan,nan,nan,nan,nan,nan,nan,nan
19/6/2011,Kieran Richardson,5107571,765,10/21/1984,26,8,2,12,1,5450,6650,6850,140,136,2133742,175,69,M/AM LC,1,1,3,3,3,3,1,1,2,1,3,12,12,13,8,17,12,6,13,7,8,12,13,12,15,12,10,10,8,6,13,7,8,14,9,13,10,10,13,16,15,15,7,20,13,18,12,14,9,7,8,7,10,15,14,9,14,10,10,8,8,4,15,12,16,20,8,15,20,M/AM LC,524,1,1,6,20,15,6,1,15,1,1,16,15,8,12,1,35185445832704,0,0,0,0,0,0,0,0,0,0,0,1,0,0,0,0,0,0,0,0,0,0,0,0,0,0,0,0,0,0,1,0,0,0,0,0,0,0,0,0,0,0,0,0,0,1,0,0,Kieran Richardson,£4.50m ,36.0,177.0,Defender - Left-Back,left,Retired,29.0,4.0,3.0,2309.0,34.0,3.0,3.0,2786.0,17.0,2.0,0.0,968.0,32.0,4.0,5.0,2468.0,26.0,0.0,1.0,1683.0,15.0,0.0,2.0,1113.0,6.0,0.0,0.0,164.0,nan,nan,nan,nan,nan,nan,nan,nan,Premier League,nan,nan,nan,nan,nan,nan,nan,nan
19/6/2011,Kevin-Prince Boateng,8723705,21,3/6/1987,24,9,1,6,0,6250,7500,7800,166,156,5267286,185,86,M/AM C,3,1,2,3,2,3,3,5,3,2,1,5,12,14,13,14,8,11,11,10,13,12,11,12,14,18,15,16,13,14,13,13,17,14,14,16,10,14,15,14,16,15,13,14,13,15,20,16,17,12,17,13,12,16,12,18,8,13,14,11,9,14,1,1,20,18,14,12,20,M/AM C,411,1,1,1,18,10,13,1,1,1,9,20,12,14,1,1,2233382993944,0,0,0,1,1,0,0,0,0,0,0,0,0,0,0,0,0,0,0,0,0,0,0,0,0,0,0,0,0,0,0,0,0,0,0,1,0,0,0,0,0,1,0,0,0,0,0,0,Kevin-Prince Boateng,£20.70m ,33.0,186.0,Midfielder - Attacking Midfield,right,AC Monza,34.0,3.0,3.0,2110.0,27.0,9.0,6.0,1874.0,37.0,3.0,7.0,2780.0,37.0,9.0,4.0,3188.0,25.0,0.0,5.0,1511.0,14.0,1.0,0.0,369.0,29.0,10.0,5.0,2009.0,36.0,6.0,2.0,2794.0,19.0,5.0,1.0,1389.0,Serie A,26.0,4.0,1.0,1283.0,2.0,0.0,0.0,90.0
19/6/2011,Kevin,67059115,796,2/13/1992,19,0,0,0,0,2550,5050,5050,152,101,274841,178,69,M/AM C,2,1,1,1,3,1,1,4,2,3,3,11,10,12,9,13,8,8,11,8,5,14,12,8,14,10,9,11,11,8,13,11,12,13,6,12,7,12,11,13,14,9,7,9,13,13,20,12,6,13,8,10,10,12,11,13,15,12,13,13,13,3,1,1,16,20,13,10,20,M/AM C,521,1,1,1,20,10,13,1,1,1,8,16,9,12,1,1,17592186044560,0,0,0,0,1,0,0,1,0,0,0,0,0,0,0,0,0,0,0,0,0,0,0,0,0,0,0,0,0,0,0,0,0,0,0,0,0,0,0,0,0,0,0,0,1,0,0,0,Kelvin,£1.80m ,27.0,175.0,Forward - Right Winger,left,Botafogo de Futebol e Regatas,4.0,1.0,0.0,324.0,27.0,2.0,2.0,1449.0,24.0,5.0,1.0,1382.0,23.0,1.0,2.0,1196.0,24.0,2.0,8.0,1464.0,35.0,2.0,3.0,2415.0,6.0,0.0,1.0,302.0,22.0,1.0,4.0,902.0,10.0,1.0,0.0,401.0,Liga NOS,6.0,0.0,0.0,346.0,nan,nan,nan,nan
19/6/2011,Kevin Foley,5107874,789,11/1/1984,26,8,0,9,1,3750,6250,6300,136,130,773497,176,70,D/WB/M RC,2,3,1,1,3,1,2,7,1,1,1,8,13,12,8,14,10,13,4,12,14,13,10,14,13,10,14,10,15,14,11,12,14,6,15,12,14,11,14,13,10,12,10,9,14,12,20,14,11,18,3,12,5,14,16,14,17,12,12,13,17,7,20,18,17,1,20,9,17,D/WB/M RC,123,1,1,1,1,1,1,1,9,20,13,17,1,13,1,18,32,0,0,0,0,0,1,0,0,0,0,0,0,0,0,0,0,0,0,0,0,0,0,0,0,0,0,0,0,0,0,0,0,0,0,0,0,0,0,0,0,0,0,0,0,0,0,0,0,Kevin Foley,£2.70m ,35.0,183.0,Defender - Right-Back,right,Retired,36.0,3.0,2.0,2967.0,18.0,0.0,1.0,1210.0,28.0,0.0,1.0,2276.0,17.0,1.0,0.0,1072.0,8.0,0.0,0.0,442.0,8.0,0.0,1.0,492.0,32.0,0.0,1.0,2390.0,1.0,0.0,0.0,90.0,nan,nan,nan,nan,Premier League,nan,nan,nan,nan,nan,nan,nan,nan
19/6/2011,Kévin Constant,8435076,22,5/10/1987,24,12,2,0,0,5000,6519,6900,150,138,895578,184,78,M/AM LC,3,3,2,1,3,3,3,8,3,2,2,14,11,14,11,14,13,9,15,6,8,12,14,6,16,11,14,11,12,14,13,12,10,13,7,14,9,11,12,15,14,14,10,20,15,14,10,16,14,13,11,15,7,14,14,15,12,10,9,13,13,12,1,1,18,20,1,16,20,M/AM LC,524,1,1,1,20,16,1,1,1,1,13,18,15,1,1,1,4194308,0,0,1,0,0,0,0,0,0,0,0,0,0,0,0,0,0,0,0,0,0,0,1,0,0,0,0,0,0,0,0,0,0,0,0,0,0,0,0,0,0,0,0,0,0,0,0,0,Kévin Constant,£4.50m ,33.0,184.0,Midfielder - Central Midfield,left,Retired,36.0,2.0,5.0,2486.0,23.0,1.0,1.0,1472.0,31.0,0.0,2.0,2289.0,26.0,0.0,1.0,1973.0,22.0,2.0,1.0,1691.0,18.0,0.0,2.0,1257.0,13.0,2.0,1.0,903.0,17.0,0.0,2.0,1340.0,3.0,0.0,0.0,262.0,Serie A,nan,nan,nan,nan,nan,nan,nan,nan
19/6/2011,Kemy Agustien,860297,784,8/20/1986,24,0,0,6,2,3350,5750,6000,131,106,438412,178,73,M RC,3,3,1,3,2,1,1,4,3,1,2,7,10,10,5,11,6,8,7,2,5,14,9,4,14,6,14,7,9,13,13,10,9,12,10,7,7,11,10,13,14,9,10,10,13,14,20,12,10,11,12,10,10,12,8,12,14,10,13,12,12,8,1,1,20,14,15,12,20,M RC,403,1,1,1,14,1,10,1,1,1,12,20,12,15,1,1,34359738368,0,0,0,0,0,0,0,0,0,0,0,0,0,0,0,0,0,0,0,0,0,0,0,0,0,0,0,0,0,0,0,0,0,0,0,1,0,0,0,0,0,0,0,0,0,0,0,0,Kemy Agustien,£900Th. ,34.0,178.0,Midfielder - Defensive Midfield,right,Mickleover Sports FC,19.0,0.0,2.0,969.0,18.0,0.0,2.0,1068.0,21.0,0.0,1.0,736.0,14.0,0.0,1.0,751.0,5.0,0.0,0.0,274.0,10.0,1.0,0.0,346.0,9.0,1.0,0.0,607.0,10.0,0.0,0.0,848.0,13.0,2.0,2.0,912.0,Premier League,nan,nan,nan,nan,nan,nan,nan,nan
19/6/2011,Karl Henry,5104194,765,11/26/1982,28,0,0,0,0,4100,6250,6500,137,135,972697,183,72,M C,1,1,2,3,3,3,3,4,2,2,3,9,9,10,9,13,9,13,8,5,14,14,8,16,12,17,14,15,14,10,13,12,16,7,16,12,13,15,18,12,11,12,11,8,16,14,20,17,16,15,15,14,9,15,10,11,19,11,15,15,16,2,10,1,20,1,10,1,20,M C,401,1,1,1,1,1,1,1,1,10,15,20,1,10,1,1,67108864,0,0,0,0,0,0,0,0,0,0,0,0,0,0,0,0,0,0,0,0,0,0,0,0,0,0,1,0,0,0,0,0,0,0,0,0,0,0,0,0,0,0,0,0,0,0,0,0,Karl Henry,£2.25m ,37.0,184.0,Midfielder - Defensive Midfield,right,Retired,31.0,0.0,2.0,2607.0,35.0,0.0,0.0,2843.0,41.0,0.0,0.0,3344.0,29.0,1.0,1.0,1699.0,35.0,0.0,0.0,2646.0,39.0,1.0,0.0,3212.0,15.0,0.0,0.0,1182.0,33.0,1.0,1.0,2838.0,6.0,0.0,0.0,409.0,Premier League,nan,nan,nan,nan,nan,nan,nan,nan
19/6/2011,Karim El-Hany,85087983,769,1/12/1988,23,0,0,0,0,2263,4688,3582,125,104,62642,170,60,M/AM LC,2,1,1,1,2,2,1,4,2,2,3,8,9,13,8,13,8,7,11,6,3,11,8,3,13,8,10,11,12,9,12,10,17,14,6,12,7,11,13,16,14,10,5,20,13,15,5,11,6,12,8,13,8,8,6,13,12,13,14,14,14,6,1,1,18,20,1,20,16,M/AM LC,524,1,1,1,16,20,1,1,1,1,1,16,18,1,1,1,2251799813685248,0,0,0,0,0,0,0,0,0,0,0,0,0,0,0,0,0,0,0,0,0,0,0,0,0,0,0,0,0,0,0,0,0,0,0,0,0,0,0,0,0,0,0,0,0,0,0,0,Karim El Hany,£180Th. ,32.0,170.0,Midfielder - Defensive Midfield,right,Mouloudia d'Oujda,27.0,0.0,0.0,1249.0,3.0,1.0,0.0,76.0,6.0,0.0,0.0,445.0,11.0,1.0,0.0,554.0,10.0,1.0,0.0,448.0,23.0,0.0,1.0,1691.0,nan,nan,nan,nan,23.0,0.0,4.0,1854.0,29.0,0.0,7.0,2569.0,Ligue 1,28.0,1.0,3.0,2314.0,nan,nan,nan,nan
19/6/2011,Kamil Vacek,5653968,763,5/18/1987,24,0,0,2,0,3250,6250,6250,135,120,1169960,183,81,AM RC,3,3,3,1,2,3,1,1,1,1,1,12,10,12,10,14,14,5,4,5,8,16,12,7,14,9,14,8,3,9,15,10,12,16,5,15,14,8,14,12,12,8,9,16,5,15,20,14,9,14,10,4,14,8,2,12,6,6,12,18,10,10,1,1,15,20,15,1,20,AM RC,503,1,1,1,20,1,15,1,1,1,15,15,1,15,1,1,0,0,0,0,0,0,0,0,0,0,0,0,0,0,0,0,0,0,0,0,0,0,0,0,0,0,0,0,0,0,0,0,0,0,0,0,0,0,0,0,0,0,0,0,0,0,0,0,0,Kamil Vacek,£1.35m ,33.0,184.0,Midfielder - Central Midfield,right,FC Bohemians Prag 1905,34.0,2.0,1.0,2887.0,31.0,4.0,2.0,1773.0,12.0,0.0,0.0,750.0,25.0,2.0,2.0,819.0,38.0,0.0,2.0,2175.0,33.0,5.0,8.0,2870.0,28.0,0.0,1.0,2186.0,25.0,0.0,1.0,1399.0,25.0,2.0,1.0,1760.0,Serie A,23.0,4.0,2.0,1395.0,6.0,0.0,0.0,464.0
19/6/2011,Kamel Chafni,915414,34,6/11/1982,29,4,0,0,0,4500,5714,5700,135,127,375865,181,72,M/AM RC,3,3,1,1,2,2,3,5,1,2,3,11,11,14,9,14,13,8,13,7,8,14,12,5,15,8,12,8,13,12,14,12,12,12,9,12,9,11,12,13,14,13,10,9,14,14,20,16,10,10,8,10,10,15,9,14,12,13,14,14,14,5,10,10,16,20,17,12,20,M/AM RC,523,1,1,10,20,12,17,1,1,10,1,16,12,14,1,10,34363932672,0,0,0,0,0,0,0,0,0,0,0,0,0,0,0,0,0,0,0,0,0,0,1,0,0,0,0,0,0,0,0,0,0,0,0,1,0,0,0,0,0,0,0,0,0,0,0,0,Kamel Chafni,£2.03m ,38.0,181.0,Midfielder - Attacking Midfield,right,Signal FC Bernex-Confignon,31.0,1.0,4.0,1814.0,33.0,2.0,4.0,2489.0,32.0,2.0,2.0,2266.0,21.0,7.0,7.0,1822.0,5.0,0.0,0.0,200.0,nan,nan,nan,nan,nan,nan,nan,nan,nan,nan,nan,nan,nan,nan,nan,nan,Ligue 1,nan,nan,nan,nan,6.0,3.0,0.0,508.0
19/6/2011,Juraj Kucka,63001138,794,2/26/1987,24,16,0,11,0,5500,6750,7000,155,142,1247466,186,87,M C,3,1,2,1,3,1,2,4,2,2,2,10,10,12,8,10,11,9,15,5,11,15,12,13,13,12,14,15,12,16,12,12,14,14,11,9,13,11,14,12,11,14,11,11,16,12,20,16,16,14,15,10,12,13,13,11,18,16,14,12,10,2,1,1,20,5,1,1,20,M C,401,1,1,1,5,1,1,1,1,1,15,20,1,1,1,1,4194824,0,0,0,1,0,0,0,0,0,1,0,0,0,0,0,0,0,0,0,0,0,0,1,0,0,0,0,0,0,0,0,0,0,0,0,0,0,0,0,0,0,0,0,0,0,0,0,0,Juraj Kucka,£4.32m ,33.0,186.0,Midfielder - Central Midfield,right,Parma Calcio 1913,42.0,5.0,1.0,3417.0,29.0,2.0,1.0,2019.0,33.0,3.0,3.0,2819.0,12.0,2.0,0.0,853.0,34.0,2.0,2.0,1861.0,35.0,1.0,4.0,2495.0,33.0,4.0,2.0,2369.0,28.0,3.0,6.0,2213.0,28.0,4.0,3.0,1964.0,Serie A,28.0,6.0,4.0,2049.0,5.0,1.0,0.0,441.0
19/6/2011,Júlio Baptista,308347,1651,10/1/1981,29,42,5,10,3,7000,7251,7700,155,153,4529524,187,81,M/AM/S C,2,3,1,3,1,3,2,5,1,3,2,10,12,13,15,13,16,13,16,10,10,14,16,12,15,14,12,16,14,13,13,14,17,16,10,14,10,11,15,13,14,17,14,12,18,14,20,16,17,15,12,11,10,14,14,19,13,16,13,9,9,11,1,1,17,20,13,14,20,M/AM/S C,531,1,1,16,20,14,13,1,1,1,8,17,4,4,1,1,274886296076,0,0,1,1,0,0,0,0,0,1,0,0,0,0,0,0,0,0,0,0,0,0,0,1,0,0,0,0,0,0,0,0,0,0,0,0,0,0,1,0,0,0,0,0,0,0,0,0,Júlio Baptista,£4.50m ,39.0,185.0,Midfielder - Attacking Midfield,both,Retired,19.0,9.0,2.0,1134.0,4.0,1.0,0.0,327.0,31.0,9.0,3.0,1831.0,22.0,6.0,0.0,1120.0,2.0,0.0,0.0,26.0,24.0,6.0,4.0,817.0,nan,nan,nan,nan,nan,nan,nan,nan,3.0,0.0,0.0,42.0,LaLiga,nan,nan,nan,nan,nan,nan,nan,nan
19/6/2011,Julien Sablé,3502838,769,9/11/1980,30,0,0,19,0,4450,5579,5553,145,124,120585,181,73,DM/M C,3,2,1,1,3,1,2,6,3,3,3,12,12,9,6,11,14,12,11,7,10,14,12,14,11,13,14,16,10,13,11,12,16,6,17,8,13,18,14,13,12,14,10,10,12,11,20,15,13,12,13,14,9,5,5,12,16,13,17,11,11,8,5,5,16,1,10,1,16,DM/M C,311,1,1,1,1,1,1,1,1,5,20,16,1,10,1,5,137438953472,0,0,0,0,0,0,0,0,0,0,0,0,0,0,0,0,0,0,0,0,0,0,0,0,0,0,0,0,0,0,0,0,0,0,0,0,0,1,0,0,0,0,0,0,0,0,0,0,Julien Sablé,£1.13m ,40.0,181.0,Midfielder - Defensive Midfield,right,Retired,36.0,0.0,0.0,2631.0,25.0,0.0,0.0,1755.0,24.0,0.0,0.0,1522.0,25.0,0.0,0.0,1613.0,nan,nan,nan,nan,nan,nan,nan,nan,nan,nan,nan,nan,nan,nan,nan,nan,nan,nan,nan,nan,Ligue 1,nan,nan,nan,nan,nan,nan,nan,nan
19/6/2011,Julien Féret,919594,769,7/5/1982,28,0,0,0,0,4950,6235,6235,145,138,1029159,187,74,M/AM RC,3,1,3,1,2,3,1,7,1,1,3,15,14,15,10,15,13,10,12,7,4,15,13,7,15,6,12,9,14,10,16,12,12,14,10,13,7,13,12,13,12,14,12,15,15,12,20,14,12,12,6,14,6,11,3,13,12,12,15,15,13,9,1,1,17,20,17,14,20,M/AM RC,523,1,1,1,20,14,17,1,1,1,1,15,14,17,1,1,5242880,0,0,0,0,0,0,0,0,0,0,0,0,0,0,0,0,0,0,0,0,1,0,1,0,0,0,0,0,0,0,0,0,0,0,0,0,0,0,0,0,0,0,0,0,0,0,0,0,Julien Féret,£4.95m ,38.0,187.0,Midfielder - Attacking Midfield,right,Retired,40.0,9.0,7.0,3443.0,49.0,12.0,16.0,3837.0,43.0,13.0,7.0,3257.0,19.0,1.0,2.0,1359.0,38.0,7.0,6.0,3013.0,40.0,4.0,8.0,3484.0,37.0,2.0,4.0,3247.0,42.0,0.0,2.0,3383.0,34.0,1.0,4.0,2019.0,Ligue 1,nan,nan,nan,nan,nan,nan,nan,nan
19/6/2011,Juliano,19004486,1651,2/14/1986,25,0,0,0,0,2500,5500,5500,128,110,190273,173,73,M/AM LC,2,2,3,1,1,1,1,2,2,3,1,13,13,13,11,13,13,8,11,12,7,13,13,6,13,7,10,12,12,11,12,13,16,9,8,11,9,11,12,13,11,10,7,20,11,13,8,13,10,10,5,11,11,9,12,10,19,12,12,12,16,5,1,1,17,20,10,18,20,M/AM LC,524,1,1,13,20,18,10,1,1,1,1,17,16,5,1,1,17733517312,0,0,0,0,0,0,0,0,0,0,0,0,0,0,0,0,0,0,0,0,0,0,0,0,1,0,0,0,0,1,0,0,0,0,1,0,0,0,0,0,0,0,0,0,0,0,0,0,Julian Korb,£180Th. ,28.0,177.0,Defender - Right-Back,right,Without Club,29.0,2.0,1.0,2540.0,28.0,1.0,4.0,2317.0,33.0,2.0,3.0,2959.0,25.0,0.0,0.0,2216.0,31.0,0.0,1.0,2671.0,24.0,2.0,3.0,1856.0,21.0,1.0,1.0,1322.0,29.0,1.0,2.0,2431.0,12.0,0.0,0.0,1007.0,Bundesliga,27.0,1.0,4.0,2111.0,nan,nan,nan,nan
19/6/2011,Julian Schuster,8723859,771,4/15/1985,26,0,0,0,0,5000,6600,6600,140,134,766744,190,78,DM/M/AM C,1,1,1,3,2,2,2,5,2,2,3,17,15,13,11,14,18,13,11,8,14,14,14,14,13,12,15,12,15,15,11,14,15,16,8,12,12,13,13,12,10,13,14,10,14,11,20,15,14,14,6,14,7,10,11,14,11,9,13,12,11,10,1,1,20,16,14,10,20,DM/M/AM C,321,1,1,1,16,1,1,1,1,1,20,20,10,14,1,1,68723671168,0,0,0,0,0,0,0,1,0,0,0,0,0,0,0,0,0,0,0,0,0,0,1,0,0,0,0,0,0,0,0,0,0,0,0,0,1,0,0,0,0,0,0,0,0,0,0,0,Julian Schuster,£2.70m ,35.0,189.0,Midfielder - Defensive Midfield,right,Retired,28.0,3.0,4.0,2358.0,23.0,1.0,5.0,1898.0,36.0,1.0,6.0,3168.0,31.0,4.0,1.0,2322.0,24.0,1.0,0.0,1816.0,15.0,4.0,1.0,598.0,14.0,0.0,0.0,891.0,20.0,1.0,0.0,1490.0,nan,nan,nan,nan,Bundesliga,nan,nan,nan,nan,nan,nan,nan,nan
19/6/2011,Julian Baumgartlinger,5607656,755,1/2/1988,23,13,0,17,1,3900,6000,6000,147,128,343053,183,80,DM/M C,3,1,3,2,2,1,1,2,3,3,2,5,6,10,6,12,8,14,9,8,14,11,5,16,11,12,10,16,11,10,9,9,16,9,17,16,13,17,18,13,13,13,12,16,14,13,20,14,14,14,8,10,13,13,13,15,6,10,15,16,11,4,1,1,20,1,1,1,20,DM/M C,311,1,1,1,1,1,1,1,1,1,20,20,1,1,1,1,1073741888,0,0,0,0,0,0,1,0,0,0,0,0,0,0,0,0,0,0,0,0,0,0,0,0,0,0,0,0,0,0,1,0,0,0,0,0,0,0,0,0,0,0,0,0,0,0,0,0,Julian Baumgartlinger,£2.25m ,32.0,184.0,Midfielder - Defensive Midfield,right,Bayer 04 Leverkusen,40.0,3.0,8.0,3219.0,30.0,0.0,5.0,1790.0,36.0,1.0,2.0,3167.0,12.0,1.0,1.0,760.0,28.0,0.0,0.0,2459.0,33.0,2.0,1.0,2897.0,30.0,0.0,2.0,2036.0,24.0,1.0,0.0,1577.0,27.0,0.0,1.0,1955.0,Bundesliga,40.0,2.0,2.0,2404.0,5.0,0.0,1.0,167.0
19/6/2011,Juan Rodríguez,7444674,796,4/1/1982,29,0,0,0,0,4200,6250,6250,135,125,504596,185,80,DM/M C,2,3,3,1,1,2,2,1,1,1,1,8,10,9,10,11,8,12,15,7,13,11,12,13,10,16,15,16,13,14,9,13,14,7,13,11,14,15,15,12,12,15,13,10,13,13,20,15,11,13,14,9,4,15,12,13,13,8,14,12,8,7,1,1,19,10,12,6,19,DM/M C,311,1,1,1,10,1,8,1,1,1,20,19,6,12,1,1,0,0,0,0,0,0,0,0,0,0,0,0,0,0,0,0,0,0,0,0,0,0,0,0,0,0,0,0,0,0,0,0,0,0,0,0,0,0,0,0,0,0,0,0,0,0,0,0,0,Juan Rodríguez,£2.70m ,38.0,185.0,Midfielder - Defensive Midfield,right,Retired,36.0,1.0,1.0,3025.0,18.0,0.0,0.0,1000.0,11.0,2.0,1.0,713.0,16.0,0.0,1.0,1107.0,38.0,1.0,0.0,3129.0,34.0,0.0,2.0,2692.0,20.0,1.0,0.0,1440.0,nan,nan,nan,nan,nan,nan,nan,nan,LaLiga,nan,nan,nan,nan,nan,nan,nan,nan
19/6/2011,Juan Manuel Vargas,8826193,1656,10/5/1983,27,27,3,0,0,5250,6850,7450,150,149,2817986,185,85,M/AM LC,1,1,1,1,1,1,1,1,1,1,1,12,17,14,12,13,14,6,17,15,12,16,14,13,13,14,11,12,12,11,12,12,17,11,11,15,12,12,14,15,14,14,10,20,17,15,5,16,14,18,8,17,6,14,15,15,17,17,17,15,12,6,10,15,17,20,8,20,16,M/AM LC,524,1,1,1,1,20,8,1,10,1,1,16,17,1,15,1,4673058636800,0,0,0,0,0,0,0,0,0,0,1,0,0,0,0,0,0,0,0,0,0,0,0,0,0,0,0,1,0,0,0,0,0,0,0,0,0,0,1,0,0,0,1,0,0,0,0,0,Juan Manuel Vargas,£8.10m ,37.0,186.0,Defender - Left-Back,left,Retired,24.0,4.0,6.0,1651.0,26.0,0.0,7.0,1609.0,20.0,0.0,1.0,1342.0,31.0,6.0,0.0,1760.0,29.0,4.0,1.0,1478.0,22.0,3.0,2.0,1898.0,21.0,4.0,2.0,1632.0,22.0,2.0,2.0,1585.0,nan,nan,nan,nan,Serie A,nan,nan,nan,nan,nan,nan,nan,nan
19/6/2011,Josué,55013011,788,9/17/1990,20,0,0,0,0,2250,3750,4850,148,107,585661,175,67,M C,1,2,2,3,3,2,2,1,3,3,1,14,14,12,11,15,15,7,8,10,10,15,15,10,14,11,14,10,7,11,14,12,14,12,11,14,12,12,13,12,12,8,8,8,12,11,20,11,7,11,7,13,7,10,10,13,14,13,14,14,14,6,1,1,20,10,1,1,20,M C,401,1,1,1,10,1,1,1,1,1,1,20,1,1,1,1,0,0,0,0,0,0,0,0,0,0,0,0,0,0,0,0,0,0,0,0,0,0,0,0,0,0,0,0,0,0,0,0,0,0,0,0,0,0,0,0,0,0,0,0,0,0,0,0,0,Josué,£900Th. ,30.0,174.0,Midfielder - Attacking Midfield,left,Hapoel Beer Sheva,13.0,0.0,0.0,946.0,23.0,1.0,0.0,1160.0,32.0,4.0,3.0,2309.0,35.0,5.0,10.0,2209.0,39.0,9.0,7.0,3121.0,39.0,5.0,6.0,2745.0,33.0,4.0,6.0,1787.0,10.0,0.0,3.0,743.0,29.0,4.0,4.0,2331.0,Liga NOS,32.0,6.0,6.0,2538.0,7.0,5.0,2.0,629.0
19/6/2011,Josip Ilicic,29041284,795,1/29/1988,23,10,0,5,0,4500,6550,6850,160,141,831981,190,79,M/AM LC,2,3,2,1,1,1,2,2,3,2,1,12,13,12,14,12,12,9,17,5,6,15,12,6,16,15,14,11,14,15,14,14,15,15,12,15,12,12,15,13,14,13,15,20,12,13,11,13,13,15,7,13,7,11,14,15,14,14,16,15,15,7,1,1,18,20,10,16,20,M/AM LC,524,1,1,10,20,16,10,1,1,1,1,18,15,5,1,1,0,0,0,0,0,0,0,0,0,0,0,0,0,0,0,0,0,0,0,0,0,0,0,0,0,0,0,0,0,0,0,0,0,0,0,0,0,0,0,0,0,0,0,0,0,0,0,0,0,Josip Ilicic,£7.20m ,32.0,190.0,Forward - Second Striker,left,Atalanta BC,50.0,12.0,13.0,3761.0,36.0,6.0,6.0,2455.0,32.0,11.0,2.0,2498.0,31.0,6.0,4.0,1760.0,34.0,10.0,4.0,1966.0,37.0,15.0,5.0,2276.0,36.0,6.0,5.0,2099.0,41.0,15.0,10.0,2561.0,36.0,13.0,9.0,2532.0,Serie A,34.0,21.0,9.0,2233.0,3.0,0.0,1.0,175.0
19/6/2011,Joshua,67010757,796,1/28/1989,22,0,0,0,0,2050,4050,4050,108,81,82843,180,75,DM/M C,1,2,3,2,3,1,2,2,1,1,3,13,12,11,9,9,12,7,10,2,10,13,4,10,10,7,7,18,9,6,13,15,12,14,6,13,12,6,12,8,9,9,10,5,14,12,20,7,10,13,5,10,6,11,14,17,12,20,14,14,9,14,1,1,20,1,1,1,20,DM/M C,421,1,1,1,1,1,1,1,1,1,18,20,1,1,1,1,17592190238720,0,0,0,0,0,0,0,0,0,0,0,0,0,0,0,0,0,0,0,0,0,0,1,0,0,0,0,0,0,0,0,0,0,0,0,0,0,0,0,0,0,0,0,0,1,0,0,0
19/6/2011,Josep Lluís Martí,4206709,796,4/28/1975,36,0,0,0,0,5000,6900,6900,145,139,147951,180,74,DM/M C,1,3,2,2,3,1,1,1,2,1,1,15,13,8,9,13,11,14,13,10,13,13,12,15,12,17,15,15,12,15,11,14,12,6,18,9,16,17,17,11,10,16,11,13,15,11,20,14,13,19,15,13,8,10,15,17,14,12,17,17,9,15,10,1,19,1,1,1,19,DM/M C,311,1,7,1,1,1,1,10,1,1,20,19,1,1,1,1,562949953421376,0,0,0,0,0,0,1,0,0,0,0,0,0,0,0,0,0,0,0,0,0,0,0,0,0,0,0,0,0,0,0,0,0,0,0,0,0,0,0,0,0,0,0,0,0,0,0,0,Josep Lluís Martí,£810Th. ,45.0,180.0,Midfielder - Defensive Midfield,right,Retired,37.0,0.0,3.0,2991.0,34.0,1.0,2.0,2475.0,33.0,1.0,1.0,2065.0,16.0,0.0,3.0,999.0,15.0,1.0,1.0,916.0,nan,nan,nan,nan,nan,nan,nan,nan,nan,nan,nan,nan,nan,nan,nan,nan,LaLiga,nan,nan,nan,nan,nan,nan,nan,nan
19/6/2011,José Pedro,7002268,788,10/18/1978,32,0,0,0,0,2997,5495,5495,110,110,81158,186,77,M/AM LC,3,1,2,1,3,3,1,1,2,3,1,15,16,12,14,13,16,10,17,10,7,15,12,6,14,8,15,9,14,11,14,15,9,13,8,13,9,9,10,8,9,16,11,20,11,8,5,13,15,12,7,11,7,10,13,12,13,12,12,16,16,4,1,1,20,20,1,20,20,M/AM LC,414,1,1,1,20,10,1,1,1,1,5,20,20,1,1,1,0,0,0,0,0,0,0,0,0,0,0,0,0,0,0,0,0,0,0,0,0,0,0,0,0,0,0,0,0,0,0,0,0,0,0,0,0,0,0,0,0,0,0,0,0,0,0,0,0,José Pedro,£630Th. ,42.0,187.0,Midfielder - Central Midfield,left,Retired,18.0,1.0,0.0,908.0,16.0,0.0,1.0,919.0,19.0,2.0,0.0,1001.0,nan,nan,nan,nan,nan,nan,nan,nan,nan,nan,nan,nan,nan,nan,nan,nan,nan,nan,nan,nan,nan,nan,nan,nan,Liga NOS,nan,nan,nan,nan,nan,nan,nan,nan
19/6/2011,José María Movilla,4202601,796,2/8/1975,36,0,0,0,0,4050,6100,6100,148,122,44791,171,70,DM/M C,3,2,2,1,1,3,1,6,2,1,2,8,11,9,8,13,7,10,9,6,12,13,8,14,14,15,14,17,15,15,12,15,16,10,16,13,15,16,15,12,11,12,4,5,16,10,20,15,13,14,14,12,4,7,12,17,6,15,9,7,5,18,1,1,20,1,5,8,20,DM/M C,421,1,1,1,1,1,1,1,1,1,19,20,8,5,1,1,149538954805248,0,0,0,0,0,0,0,0,0,0,0,0,0,0,0,0,0,0,0,1,0,0,1,0,0,0,0,0,0,0,1,0,1,0,0,0,0,0,0,0,0,0,0,1,0,0,0,1,José María Movilla,£630Th. ,45.0,171.0,Midfielder - Defensive Midfield,both,Retired,42.0,2.0,0.0,3389.0,38.0,2.0,3.0,2804.0,38.0,0.0,4.0,2721.0,14.0,0.0,0.0,814.0,nan,nan,nan,nan,nan,nan,nan,nan,nan,nan,nan,nan,nan,nan,nan,nan,nan,nan,nan,nan,LaLiga,nan,nan,nan,nan,nan,nan,nan,nan
19/6/2011,José Manuel Jurado,7451707,796,6/29/1986,24,0,0,13,5,6250,7000,6650,150,143,2818203,173,72,M/AM C,2,1,3,3,1,1,1,6,3,2,2,13,12,16,14,19,13,5,14,6,5,17,13,7,18,6,13,7,11,7,17,10,6,17,6,15,7,12,7,14,16,9,8,17,12,13,20,11,8,8,4,16,10,13,11,8,10,10,12,13,12,7,1,1,16,20,11,14,20,M/AM C,521,1,1,6,20,14,11,1,1,1,5,16,13,7,1,1,68159620,0,0,1,0,0,0,0,1,0,0,0,1,0,0,0,0,0,0,0,0,1,0,0,0,0,0,1,0,0,0,0,0,0,0,0,0,0,0,0,0,0,0,0,0,0,0,0,0,José Manuel Jurado,£5.40m ,34.0,176.0,Midfielder - Attacking Midfield,right,Without Club,46.0,9.0,5.0,3174.0,28.0,1.0,7.0,1584.0,24.0,3.0,5.0,1681.0,32.0,8.0,2.0,2734.0,20.0,3.0,4.0,1226.0,31.0,0.0,3.0,2274.0,32.0,3.0,4.0,2579.0,31.0,0.0,3.0,1678.0,26.0,1.0,5.0,2061.0,Bundesliga,15.0,0.0,0.0,479.0,nan,nan,nan,nan
19/6/2011,José Javier Barkero,6700154,796,4/27/1979,32,0,0,0,0,4250,6500,6500,140,132,645189,180,71,M/AM RLC,1,1,2,2,2,2,3,1,3,2,3,17,16,12,13,16,17,9,15,8,8,15,17,12,15,12,9,12,14,12,13,12,14,16,12,12,12,13,12,14,12,12,10,20,13,12,8,13,11,15,10,14,10,14,9,14,15,10,13,14,17,5,1,5,19,20,15,19,20,M/AM RLC,526,1,1,1,20,19,15,1,1,1,5,17,19,15,5,1,149533581378816,0,0,0,0,0,0,0,0,1,0,1,0,0,0,0,0,0,0,0,0,0,0,0,0,0,0,0,0,0,0,0,0,0,0,0,0,0,0,0,0,0,0,0,1,0,0,0,1,José Javier Barkero,£1.80m ,41.0,181.0,Midfielder - Attacking Midfield,left,Retired,40.0,15.0,0.0,3565.0,36.0,8.0,9.0,2711.0,39.0,6.0,7.0,2802.0,30.0,3.0,2.0,1897.0,nan,nan,nan,nan,nan,nan,nan,nan,nan,nan,nan,nan,nan,nan,nan,nan,nan,nan,nan,nan,LaLiga,nan,nan,nan,nan,nan,nan,nan,nan
19/6/2011,José Campaña,67089223,796,5/30/1993,18,0,0,0,0,3000,5300,5300,137,107,812992,179,74,M/AM C,2,1,1,2,2,3,3,5,2,2,1,11,13,11,7,15,14,5,11,9,7,15,10,8,15,9,14,8,14,13,15,14,10,14,2,11,10,13,10,11,10,9,8,20,9,10,8,10,9,13,12,10,5,9,11,15,12,6,7,11,7,5,1,1,20,18,8,12,20,M/AM C,411,1,1,1,18,1,1,1,1,1,13,20,12,8,1,1,128,0,0,0,0,0,0,0,1,0,0,0,0,0,0,0,0,0,0,0,0,0,0,0,0,0,0,0,0,0,0,0,0,0,0,0,0,0,0,0,0,0,0,0,0,0,0,0,0,José Campaña,£1.35m ,27.0,179.0,Midfielder - Central Midfield,right,Levante UD,17.0,1.0,1.0,1302.0,18.0,0.0,3.0,600.0,6.0,0.0,1.0,215.0,16.0,1.0,3.0,899.0,12.0,1.0,2.0,883.0,35.0,3.0,2.0,2971.0,40.0,4.0,5.0,3002.0,38.0,1.0,4.0,3013.0,39.0,4.0,9.0,3390.0,LaLiga,40.0,2.0,7.0,3388.0,5.0,0.0,1.0,450.0
19/6/2011,Joris Marveaux,919536,769,8/15/1982,28,0,0,0,0,2168,6136,6136,138,136,413800,178,74,DM/M C,2,1,1,2,2,1,2,1,1,3,1,7,12,12,7,12,9,12,13,7,12,14,8,13,12,13,15,15,13,13,12,13,14,6,12,8,13,15,17,15,13,14,9,8,14,13,20,16,14,16,11,14,10,12,12,12,12,14,15,15,15,6,12,12,20,10,12,1,20,DM/M C,421,1,1,1,10,1,1,10,1,12,16,20,1,12,1,12,256,0,0,0,0,0,0,0,0,1,0,0,0,0,0,0,0,0,0,0,0,0,0,0,0,0,0,0,0,0,0,0,0,0,0,0,0,0,0,0,0,0,0,0,0,0,0,0,0,Joris Marveaux,£3.15m ,38.0,179.0,Midfielder - Defensive Midfield,right,Retired,42.0,1.0,0.0,3163.0,32.0,1.0,0.0,1696.0,12.0,0.0,0.0,430.0,30.0,1.0,0.0,2155.0,30.0,0.0,1.0,1847.0,9.0,1.0,0.0,438.0,11.0,0.0,0.0,570.0,22.0,2.0,0.0,1821.0,18.0,1.0,0.0,1249.0,Ligue 1,nan,nan,nan,nan,nan,nan,nan,nan
19/6/2011,Jordan Henderson,28005568,765,6/17/1990,21,1,0,10,1,5500,7150,7000,155,133,8863636,183,67,M/AM RC,1,1,3,3,3,3,2,7,3,2,1,13,17,14,11,13,13,6,13,4,7,15,4,8,13,6,13,8,14,10,13,10,10,15,10,14,8,11,14,13,13,12,9,10,16,15,20,16,8,10,7,8,4,14,8,12,15,10,15,9,9,6,1,1,20,19,19,10,20,M/AM RC,413,1,1,5,10,10,19,1,1,1,3,20,10,18,1,1,4400328212512,0,0,0,0,0,1,0,0,0,0,0,0,0,0,0,0,0,0,0,0,0,0,0,0,0,0,0,1,0,0,0,1,0,0,0,0,0,0,0,0,0,0,1,0,0,0,0,0,Jordan Henderson,£13.50m ,30.0,187.0,Midfielder - Central Midfield,right,Liverpool FC,39.0,3.0,5.0,3319.0,48.0,2.0,4.0,3499.0,44.0,6.0,5.0,2642.0,40.0,5.0,7.0,3483.0,54.0,7.0,15.0,4739.0,26.0,2.0,3.0,1950.0,27.0,1.0,4.0,2355.0,41.0,1.0,2.0,3308.0,44.0,1.0,5.0,2811.0,Premier League,40.0,4.0,5.0,3167.0,5.0,0.0,0.0,335.0
19/6/2011,Jonjo Shelvey,28011776,765,2/27/1992,19,0,0,0,0,3500,5800,5700,151,120,2640938,183,70,M/AM C,1,3,3,3,2,3,3,4,3,3,2,13,14,9,12,14,13,6,13,6,7,15,12,9,14,9,11,8,15,12,14,13,16,13,9,16,9,12,14,8,9,13,10,11,16,12,20,16,11,12,6,13,7,15,9,17,15,13,13,15,10,10,8,1,20,18,10,10,20,M/AM C,411,1,1,10,18,10,10,1,8,1,10,20,10,10,1,1,4718592,0,0,0,0,0,0,0,0,0,0,0,0,0,0,0,0,0,0,0,1,0,0,1,0,0,0,0,0,0,0,0,0,0,0,0,0,0,0,0,0,0,0,0,0,0,0,0,0,Jonjo Shelvey,£2.70m ,28.0,184.0,Midfielder - Central Midfield,right,Newcastle United,26.0,1.0,1.0,1106.0,28.0,11.0,4.0,1849.0,37.0,6.0,4.0,2276.0,42.0,6.0,8.0,3080.0,35.0,3.0,6.0,2770.0,34.0,1.0,7.0,2400.0,47.0,5.0,12.0,3817.0,33.0,2.0,3.0,2518.0,18.0,2.0,1.0,1039.0,Premier League,29.0,6.0,2.0,2254.0,6.0,1.0,0.0,522.0
19/6/2011,Jonathan de Guzman,860972,784,9/13/1987,23,0,0,4,3,6511,6863,7012,158,146,632467,173,65,M/AM RC,1,2,2,3,1,2,2,8,3,1,2,14,12,15,11,16,12,12,13,8,11,15,13,8,15,15,14,13,12,13,15,14,9,17,9,15,14,15,14,14,14,13,9,12,13,13,20,13,11,15,14,13,18,10,12,16,13,12,14,13,12,12,8,8,20,19,16,12,20,M/AM RC,413,1,1,12,19,12,16,1,8,8,12,20,12,16,8,8,35184377332768,0,0,0,0,0,1,0,0,0,0,1,0,0,0,0,0,0,0,0,0,1,0,1,0,0,0,0,0,0,0,0,0,0,0,0,0,0,0,0,0,0,0,0,0,0,1,0,0,Jonathan de Guzmán,£5.40m ,33.0,173.0,Midfielder - Central Midfield,right,OFI Crete,36.0,6.0,4.0,3072.0,27.0,1.0,2.0,1584.0,45.0,8.0,8.0,3511.0,48.0,7.0,5.0,3310.0,36.0,7.0,3.0,2021.0,5.0,1.0,0.0,111.0,29.0,2.0,2.0,1533.0,19.0,0.0,5.0,1346.0,39.0,3.0,9.0,2083.0,LaLiga,10.0,1.0,1.0,193.0,nan,nan,nan,nan
19/6/2011,John Obi Mikel,5116933,38,4/22/1987,24,34,2,6,1,7500,7519,8000,170,159,36363636,188,86,DM/M C,3,3,1,2,3,2,3,5,2,2,1,10,12,11,6,18,10,8,4,3,14,17,13,14,16,14,17,14,19,13,16,15,18,10,10,13,17,14,15,9,13,16,12,15,17,10,20,18,20,14,11,16,8,12,18,19,10,16,10,8,12,15,1,1,18,10,1,1,18,DM/M C,311,1,1,1,10,1,1,1,1,1,20,18,1,1,1,1,17593264635904,0,0,0,0,0,0,0,0,0,0,0,0,0,0,0,0,0,1,0,1,0,0,1,0,0,0,0,0,0,0,1,0,0,0,0,0,0,0,0,0,0,0,0,0,1,0,0,0
19/6/2011,Johannes Flum,35007722,771,12/14/1987,23,0,0,0,0,3900,6250,6250,150,128,541185,190,78,DM/M C,1,3,2,3,1,1,1,5,2,1,2,8,7,10,11,11,12,13,12,9,13,13,9,14,12,10,13,12,12,13,12,11,12,7,8,10,13,14,14,12,10,14,13,14,15,13,20,15,13,8,5,13,9,11,11,11,13,9,12,13,10,9,9,1,20,14,1,1,20,DM/M C,421,1,1,1,14,1,1,9,1,1,17,20,1,1,1,1,524352,0,0,0,0,0,0,1,0,0,0,0,0,0,0,0,0,0,0,0,1,0,0,0,0,0,0,0,0,0,0,0,0,0,0,0,0,0,0,0,0,0,0,0,0,0,0,0,0,Johannes Flum,£3.60m ,32.0,190.0,Midfielder - Central Midfield,right,SC Freiburg II,14.0,3.0,0.0,1024.0,30.0,3.0,5.0,2488.0,30.0,2.0,0.0,1341.0,40.0,3.0,2.0,3087.0,8.0,0.0,0.0,157.0,6.0,0.0,2.0,167.0,11.0,0.0,0.0,640.0,30.0,4.0,2.0,1869.0,22.0,1.0,1.0,1630.0,Bundesliga,18.0,0.0,0.0,821.0,9.0,2.0,1.0,702.0
19/6/2011,Johan Cavalli,3504101,769,9/12/1981,29,0,0,0,0,4200,5311,5311,125,118,405090,170,65,M/AM LC,2,3,1,1,2,3,1,7,3,2,2,13,13,13,6,14,12,7,11,5,6,14,11,11,14,14,13,15,9,11,14,13,16,11,12,8,11,16,14,13,14,12,5,20,12,12,8,14,8,13,14,15,9,10,8,13,13,12,11,8,8,10,1,1,16,20,12,18,20,M/AM LC,524,1,1,1,20,18,12,1,1,1,10,16,16,12,1,1,2251799817879680,0,0,0,0,0,0,0,1,0,0,0,0,0,0,0,0,0,0,0,0,0,0,1,0,0,0,0,0,0,0,0,0,0,0,0,0,0,0,0,0,0,0,0,0,0,0,0,0,Johan Cavalli,£1.13m ,39.0,170.0,Midfielder - Attacking Midfield,left,Retired,33.0,1.0,7.0,2559.0,32.0,4.0,7.0,2405.0,34.0,2.0,8.0,2522.0,21.0,1.0,6.0,1528.0,35.0,5.0,11.0,2779.0,37.0,6.0,3.0,2970.0,20.0,5.0,3.0,1568.0,36.0,6.0,5.0,2276.0,31.0,2.0,5.0,1905.0,Ligue 1,19.0,1.0,3.0,1031.0,nan,nan,nan,nan
19/6/2011,Joey Barton,5114014,765,9/2/1982,28,1,0,2,1,5360,6956,6950,145,144,2126607,175,70,M RC,2,2,3,2,2,3,2,8,3,3,1,15,15,10,11,13,14,10,12,5,12,15,12,15,14,18,14,16,16,16,15,15,19,10,16,15,12,15,18,11,12,14,8,10,9,10,20,16,13,13,14,14,12,13,12,16,8,12,13,8,7,20,1,1,20,12,19,10,20,M RC,403,1,1,1,12,1,1,1,1,1,14,20,10,19,1,1,10995118047360,0,0,0,0,0,0,0,1,0,0,0,0,0,0,0,0,1,1,0,1,1,0,0,0,0,0,0,0,0,0,0,0,0,0,0,0,0,0,0,0,0,1,0,1,0,0,0,0,Joey Barton,£4.50m ,38.0,180.0,Midfielder - Central Midfield,right,Retired,35.0,5.0,9.0,2988.0,34.0,3.0,2.0,2943.0,33.0,1.0,3.0,2422.0,39.0,3.0,3.0,3391.0,28.0,1.0,3.0,2350.0,40.0,3.0,3.0,3329.0,26.0,1.0,0.0,2029.0,nan,nan,nan,nan,nan,nan,nan,nan,Premier League,nan,nan,nan,nan,nan,nan,nan,nan
19/6/2011,Joel Chukwuma Obi,43008775,38,5/22/1991,20,5,0,0,0,3850,5714,6250,157,127,488387,177,70,M C,1,1,1,1,1,1,1,1,1,1,1,12,12,14,9,11,7,7,10,7,10,12,8,13,13,17,13,14,11,10,12,11,13,14,8,13,10,12,13,16,17,13,7,20,13,14,9,15,11,13,12,13,13,16,15,12,13,13,6,7,12,9,1,1,20,14,10,14,20,M C,401,1,1,1,14,14,10,1,1,1,8,20,14,10,1,1,34493956100,0,0,1,0,0,0,0,0,0,0,0,0,0,0,0,0,0,0,0,0,0,0,0,0,0,0,0,1,0,0,0,0,0,0,0,1,0,0,0,0,0,0,0,0,0,0,0,0
19/6/2011,Joe Allen,29007955,801,3/14/1990,21,2,0,13,1,4122,6234,5932,145,115,660965,168,81,DM/M C,3,3,1,2,2,3,2,1,2,2,3,2,9,12,10,13,2,4,11,4,6,14,6,11,12,9,10,13,10,12,12,10,15,11,2,11,12,13,10,14,14,13,5,15,11,13,20,6,10,13,6,15,7,11,6,9,14,16,14,14,15,2,1,1,20,14,10,1,20,DM/M C,311,1,1,1,14,1,10,1,1,1,20,20,1,10,1,1,17592186044992,0,0,0,0,0,0,1,0,0,1,0,0,0,0,0,0,0,0,0,0,0,0,0,0,0,0,0,0,0,0,0,0,0,0,0,0,0,0,0,0,0,0,0,0,1,0,0,0,Joe Allen,£3.60m ,30.0,168.0,Midfielder - Central Midfield,right,Stoke City,48.0,2.0,6.0,3500.0,39.0,4.0,4.0,3018.0,37.0,2.0,0.0,2640.0,26.0,1.0,1.0,1593.0,32.0,1.0,1.0,2409.0,37.0,3.0,3.0,1778.0,39.0,6.0,4.0,3155.0,38.0,4.0,7.0,3277.0,46.0,6.0,3.0,4132.0,Premier League,35.0,4.0,2.0,2940.0,nan,nan,nan,nan
19/6/2011,João Vilela,745267,788,9/9/1985,25,0,0,0,0,1500,5000,5000,109,100,125579,181,78,M/AM C,1,2,3,3,3,3,2,4,2,3,2,12,12,12,11,12,12,11,12,8,9,11,12,8,12,10,13,10,12,11,12,11,12,13,10,13,9,10,13,12,11,13,11,5,13,11,20,11,13,11,7,10,7,11,8,14,14,12,14,14,14,6,1,1,16,20,5,5,20,M/AM C,521,1,1,1,20,5,5,1,1,1,1,16,1,5,1,1,4194304,0,0,0,0,0,0,0,0,0,0,0,0,0,0,0,0,0,0,0,0,0,0,1,0,0,0,0,0,0,0,0,0,0,0,0,0,0,0,0,0,0,0,0,0,0,0,0,0,João Vilela,£810Th. ,35.0,184.0,Midfielder - Central Midfield,right,Without Club,33.0,4.0,1.0,1905.0,12.0,3.0,0.0,749.0,23.0,2.0,0.0,1452.0,23.0,4.0,1.0,1747.0,32.0,7.0,3.0,2332.0,1.0,0.0,0.0,12.0,19.0,1.0,4.0,1071.0,nan,nan,nan,nan,nan,nan,nan,nan,Liga NOS,nan,nan,nan,nan,nan,nan,nan,nan
19/6/2011,João Victor,2114918,1651,11/7/1988,22,0,0,0,0,4750,5967,6400,142,132,531315,181,78,DM/M C,3,1,1,1,1,3,2,3,3,1,3,10,12,12,12,14,9,7,12,4,13,14,12,11,13,9,11,11,14,13,11,12,10,12,13,13,13,13,14,13,14,13,12,12,14,13,20,14,14,14,11,12,9,11,11,10,6,7,14,9,5,14,1,1,18,14,1,1,18,DM/M C,311,1,1,1,14,1,1,1,1,1,20,18,1,1,1,1,0,0,0,0,0,0,0,0,0,0,0,0,0,0,0,0,0,0,0,0,0,0,0,0,0,0,0,0,0,0,0,0,0,0,0,0,0,0,0,0,0,0,0,0,0,0,0,0,0,João Victor,£2.25m ,31.0,181.0,Midfielder - Defensive Midfield,right,Hyderabad FC,36.0,0.0,1.0,2462.0,17.0,0.0,1.0,1093.0,7.0,0.0,0.0,275.0,nan,nan,nan,nan,37.0,1.0,1.0,3144.0,25.0,3.0,0.0,2231.0,33.0,4.0,0.0,2919.0,35.0,7.0,2.0,3143.0,30.0,4.0,0.0,2700.0,LaLiga,22.0,0.0,0.0,1715.0,nan,nan,nan,nan
19/6/2011,João Moutinho,744539,788,9/8/1986,24,34,1,15,2,6100,7200,7550,159,151,3701558,171,66,M C,1,1,2,1,1,3,1,9,1,2,2,13,13,12,11,15,14,8,14,8,12,16,14,13,15,15,15,16,17,17,15,16,17,12,15,16,15,17,17,12,12,9,8,9,13,12,20,15,11,17,7,15,5,17,12,18,11,16,17,17,17,6,1,1,20,13,8,8,20,M C,401,1,1,1,13,5,5,1,1,1,13,20,8,8,1,1,1095761928,0,0,0,1,0,0,0,0,0,0,0,0,0,0,0,0,0,0,0,0,1,0,1,0,1,0,0,0,0,0,1,0,0,0,0,0,0,0,0,0,0,0,0,0,0,0,0,0,João Moutinho,£20.70m ,34.0,170.0,Midfielder - Central Midfield,right,Wolverhampton Wanderers,53.0,2.0,8.0,4129.0,44.0,3.0,8.0,3622.0,43.0,5.0,15.0,3514.0,34.0,1.0,8.0,2878.0,52.0,5.0,8.0,4473.0,37.0,1.0,8.0,3076.0,52.0,3.0,8.0,3236.0,44.0,1.0,7.0,3571.0,44.0,1.0,8.0,3444.0,Liga NOS,57.0,1.0,13.0,4598.0,6.0,0.0,0.0,345.0
19/6/2011,João Luiz,19035988,1651,6/24/1985,25,0,0,0,0,1154,4814,5250,120,107,43017,182,79,DM/M C,1,3,3,1,2,3,2,4,3,3,1,8,10,11,10,12,11,12,12,10,10,12,11,12,13,12,11,13,13,12,12,11,14,10,10,12,11,13,14,11,13,13,14,8,14,11,20,12,13,11,9,10,7,12,14,13,14,6,14,14,14,5,1,1,17,7,10,5,17,DM/M C,311,1,1,1,7,1,1,1,1,1,20,17,5,10,1,1,0,0,0,0,0,0,0,0,0,0,0,0,0,0,0,0,0,0,0,0,0,0,0,0,0,0,0,0,0,0,0,0,0,0,0,0,0,0,0,0,0,0,0,0,0,0,0,0,0,João Luiz,£450Th. ,35.0,182.0,Midfielder - Defensive Midfield,right,Al-Hala,28.0,0.0,0.0,2044.0,11.0,0.0,0.0,408.0,18.0,0.0,0.0,1432.0,23.0,0.0,0.0,1584.0,17.0,1.0,0.0,936.0,nan,nan,nan,nan,nan,nan,nan,nan,nan,nan,nan,nan,nan,nan,nan,nan,Liga NOS,nan,nan,nan,nan,nan,nan,nan,nan
19/6/2011,João Alves,4101112,788,8/18/1980,30,3,0,0,0,2046,5750,5750,115,112,135310,178,72,M C,1,3,2,1,2,2,3,5,1,2,1,13,13,11,10,12,14,9,14,9,9,13,12,11,12,10,12,11,12,15,12,12,13,12,12,13,13,14,12,11,14,12,12,8,13,11,20,14,11,14,8,13,12,12,7,13,14,10,16,14,18,4,1,1,20,10,5,5,20,M C,401,1,1,1,10,1,1,1,1,1,14,20,5,5,1,1,2147484008,0,0,0,1,0,1,1,0,1,0,0,0,0,0,0,0,0,0,0,0,0,0,0,0,0,0,0,0,0,0,0,1,0,0,0,0,0,0,0,0,0,0,0,0,0,0,0,0,João Alves,£1.80m ,40.0,178.0,Midfielder - Central Midfield,right,Retired,30.0,2.0,2.0,1970.0,26.0,0.0,0.0,1132.0,15.0,1.0,2.0,553.0,28.0,4.0,0.0,1941.0,2.0,0.0,0.0,43.0,nan,nan,nan,nan,nan,nan,nan,nan,nan,nan,nan,nan,nan,nan,nan,nan,Liga NOS,nan,nan,nan,nan,nan,nan,nan,nan
19/6/2011,Joan Verdú,7443838,796,5/5/1983,28,0,0,0,0,4494,6991,6991,147,140,1112070,176,70,M/AM C,2,3,3,3,1,1,1,4,3,2,1,12,14,13,11,15,15,9,14,9,9,15,14,11,16,8,15,9,14,12,14,12,11,10,10,14,10,14,12,15,15,11,8,10,10,13,20,12,9,10,4,7,7,17,12,4,10,8,13,13,17,4,1,1,18,20,14,12,20,M/AM C,521,1,1,1,20,12,14,1,1,1,10,18,10,13,1,1,17597571531776,0,0,0,0,0,0,0,0,0,0,1,0,0,0,0,0,0,0,0,0,0,0,0,0,1,0,0,0,0,0,1,0,1,0,0,0,0,0,0,0,0,0,0,0,1,0,0,0,Joan Verdú,£4.50m ,37.0,172.0,Midfielder - Attacking Midfield,right,Without Club,39.0,4.0,6.0,3219.0,42.0,6.0,7.0,3537.0,38.0,9.0,3.0,3193.0,30.0,3.0,2.0,2067.0,24.0,10.0,8.0,2111.0,21.0,2.0,1.0,1255.0,30.0,9.0,9.0,2681.0,30.0,16.0,3.0,2652.0,8.0,2.0,1.0,712.0,LaLiga,nan,nan,nan,nan,nan,nan,nan,nan
19/6/2011,Jiri Bilek,5643757,763,11/4/1983,27,0,0,2,0,2085,6600,6000,132,120,205733,183,73,DM C,1,3,3,2,1,3,1,5,2,3,3,4,7,7,8,11,6,17,11,7,17,11,7,17,10,14,14,12,9,16,9,13,12,11,13,7,16,15,15,10,11,12,13,8,9,11,20,16,15,14,10,14,14,8,14,13,11,15,14,13,10,8,1,1,15,1,1,1,15,DM C,301,1,1,1,1,1,1,1,1,1,20,15,1,1,1,1,0,0,0,0,0,0,0,0,0,0,0,0,0,0,0,0,0,0,0,0,0,0,0,0,0,0,0,0,0,0,0,0,0,0,0,0,0,0,0,0,0,0,0,0,0,0,0,0,0,Jiri Bilek,£630Th. ,36.0,182.0,Defender - Centre-Back,right,Retired,16.0,0.0,1.0,1262.0,15.0,3.0,2.0,1346.0,33.0,0.0,1.0,2885.0,35.0,0.0,0.0,3035.0,27.0,3.0,0.0,2430.0,23.0,3.0,1.0,1558.0,23.0,1.0,1.0,1903.0,3.0,0.0,0.0,270.0,nan,nan,nan,nan,Bundesliga,nan,nan,nan,nan,nan,nan,nan,nan
19/6/2011,Jérôme Leroy,11109,769,11/4/1974,36,0,0,0,0,4800,6000,6000,150,134,38064,185,75,M/AM C,3,2,1,2,1,1,1,5,1,3,3,14,14,14,8,16,14,9,12,7,5,15,13,8,16,12,13,13,14,14,16,15,8,14,15,13,10,15,12,11,14,14,11,14,13,9,20,13,11,13,12,16,9,12,13,14,13,17,15,14,14,8,1,1,18,20,13,13,20,M/AM C,521,1,1,1,20,13,13,1,1,1,10,18,13,13,1,1,281474980905088,0,0,0,0,0,0,0,1,0,0,0,0,0,0,0,0,0,0,0,0,0,0,1,0,0,0,0,0,0,0,0,0,0,0,0,0,0,0,0,0,0,0,0,0,0,0,0,0,Jérôme Leroy,£450Th. ,45.0,185.0,Midfielder - Attacking Midfield,right,Retired,37.0,4.0,8.0,2148.0,20.0,4.0,0.0,1021.0,nan,nan,nan,nan,37.0,8.0,7.0,3338.0,17.0,2.0,0.0,1141.0,nan,nan,nan,nan,nan,nan,nan,nan,nan,nan,nan,nan,nan,nan,nan,nan,Ligue 1,nan,nan,nan,nan,nan,nan,nan,nan
19/6/2011,Jermaine Jones,885273,390,11/3/1981,29,11,0,0,0,6150,7250,6100,152,142,846356,184,78,DM/M C,1,1,3,3,1,1,1,9,2,1,2,8,9,8,6,8,7,9,7,11,18,10,14,17,8,18,9,19,13,16,7,8,19,5,16,10,14,18,20,17,14,18,10,16,15,15,20,18,16,17,16,12,8,12,14,17,10,11,13,7,5,15,8,12,18,1,14,12,18,DM/M C,311,1,1,6,1,1,1,1,1,8,20,18,12,14,1,12,2336462307328,0,0,0,0,0,0,0,0,0,0,0,0,0,0,0,1,1,0,0,0,0,0,0,0,0,0,0,0,0,0,0,0,0,0,0,0,0,1,0,0,0,1,0,0,0,0,0,0,Jermaine Jones,£4.50m ,38.0,184.0,Midfielder - Defensive Midfield,both,Retired,31.0,1.0,1.0,2444.0,31.0,1.0,2.0,2493.0,33.0,2.0,7.0,2616.0,47.0,4.0,5.0,3416.0,19.0,0.0,0.0,1402.0,13.0,3.0,2.0,1032.0,20.0,1.0,4.0,1588.0,nan,nan,nan,nan,nan,nan,nan,nan,Bundesliga,nan,nan,nan,nan,nan,nan,nan,nan
19/6/2011,Jermaine Jenas,5103363,765,2/18/1983,28,21,1,10,0,5500,6900,6900,150,144,604051,184,71,M C,3,3,2,1,1,1,2,2,2,1,1,11,12,12,10,13,12,12,12,6,11,13,10,13,13,11,13,11,11,11,12,9,13,11,13,13,13,18,18,15,14,13,12,13,14,15,20,15,13,10,8,15,11,13,5,18,13,11,13,13,11,10,1,1,20,15,14,10,20,M C,401,1,1,1,15,1,1,1,1,1,15,20,10,14,1,1,2147483716,0,0,1,0,0,0,1,0,0,0,0,0,0,0,0,0,0,0,0,0,0,0,0,0,0,0,0,0,0,0,0,1,0,0,0,0,0,0,0,0,0,0,0,0,0,0,0,0,Jermaine Jenas,£5.85m ,37.0,181.0,Midfielder - Central Midfield,right,Retired,27.0,0.0,2.0,1663.0,3.0,0.0,0.0,108.0,19.0,3.0,0.0,997.0,28.0,2.0,2.0,1423.0,nan,nan,nan,nan,nan,nan,nan,nan,nan,nan,nan,nan,nan,nan,nan,nan,nan,nan,nan,nan,Premier League,nan,nan,nan,nan,nan,nan,nan,nan
19/6/2011,Jérémy Toulalan,916258,769,9/10/1983,27,36,0,20,3,6600,7200,7250,155,144,3118665,183,77,DM/M C,2,3,1,1,2,1,2,5,2,3,3,6,11,9,5,12,9,13,9,6,13,13,10,16,12,13,16,18,14,14,12,13,15,6,13,7,14,20,18,12,14,15,11,11,16,11,20,18,15,14,13,16,8,13,11,15,15,11,17,14,14,6,14,5,18,10,7,1,18,DM/M C,311,1,1,1,10,1,7,14,1,5,20,18,1,7,1,5,137438953728,0,0,0,0,0,0,0,0,1,0,0,0,0,0,0,0,0,0,0,0,0,0,0,0,0,0,0,0,0,0,0,0,0,0,0,0,0,1,0,0,0,0,0,0,0,0,0,0,Jérémy Toulalan,£13.50m ,37.0,183.0,Midfielder - Defensive Midfield,right,Retired,35.0,0.0,1.0,2912.0,29.0,3.0,0.0,2499.0,29.0,0.0,0.0,2285.0,35.0,1.0,2.0,3047.0,42.0,0.0,1.0,3722.0,36.0,0.0,2.0,3099.0,36.0,0.0,0.0,3084.0,25.0,0.0,0.0,2280.0,nan,nan,nan,nan,LaLiga,nan,nan,nan,nan,nan,nan,nan,nan
19/6/2011,Jérémy Clément,8428571,769,8/26/1984,26,0,0,6,0,4650,5850,5850,135,130,632411,174,61,DM/M C,1,2,3,2,3,2,1,1,1,3,2,8,9,10,6,13,9,12,12,7,12,12,8,15,13,14,15,15,12,14,8,14,16,7,13,7,13,16,17,14,12,13,7,20,15,14,8,18,9,15,16,14,8,7,12,14,14,12,16,14,14,7,10,10,16,1,1,10,16,DM/M C,311,1,1,1,1,1,1,1,10,1,20,16,10,1,10,1,17179869184,0,0,0,0,0,0,0,0,0,0,0,0,0,0,0,0,0,0,0,0,0,0,0,0,0,0,0,0,0,0,0,0,0,0,1,0,0,0,0,0,0,0,0,0,0,0,0,0,Jérémy Clément,£4.50m ,36.0,180.0,Midfielder - Defensive Midfield,left,Retired,44.0,0.0,0.0,2522.0,37.0,0.0,0.0,3284.0,32.0,0.0,0.0,2856.0,35.0,0.0,1.0,2448.0,43.0,1.0,1.0,3863.0,39.0,0.0,1.0,3299.0,6.0,0.0,0.0,419.0,18.0,0.0,1.0,1346.0,16.0,0.0,0.0,1090.0,Ligue 1,nan,nan,nan,nan,nan,nan,nan,nan
19/6/2011,Jens Hegeler,92001113,771,1/21/1988,23,0,0,4,0,4700,6450,6200,146,129,332726,193,85,DM/M/AM RLC,2,1,3,3,3,1,2,4,1,3,3,4,12,12,9,11,7,14,9,6,13,12,8,14,11,12,13,12,11,14,11,14,14,8,9,11,14,14,15,13,10,14,16,9,13,13,20,15,14,16,4,13,4,15,10,12,13,12,14,15,18,2,1,1,20,18,19,15,20,DM/M/AM RLC,436,1,1,1,14,14,18,1,1,1,18,20,15,19,1,1,0,0,0,0,0,0,0,0,0,0,0,0,0,0,0,0,0,0,0,0,0,0,0,0,0,0,0,0,0,0,0,0,0,0,0,0,0,0,0,0,0,0,0,0,0,0,0,0,0,Jens Hegeler,£1.80m ,32.0,193.0,Midfielder - Central Midfield,right,Career break,38.0,3.0,5.0,2745.0,35.0,1.0,2.0,2033.0,37.0,5.0,0.0,1534.0,26.0,1.0,3.0,878.0,27.0,1.0,1.0,1572.0,21.0,0.0,0.0,749.0,21.0,0.0,0.0,1162.0,7.0,1.0,0.0,478.0,0.0,0.0,0.0,0.0,Bundesliga,nan,nan,nan,nan,nan,nan,nan,nan
19/6/2011,Jeffrey Sarpong,856984,784,8/3/1988,22,0,0,0,0,4250,5708,5708,147,125,422810,176,65,AM RLC,1,1,3,3,3,1,1,5,3,3,3,13,13,14,12,15,14,9,14,3,5,13,10,5,14,11,11,10,9,8,12,10,10,12,7,13,4,9,10,14,15,7,7,14,11,14,20,13,13,8,8,8,9,13,13,10,11,11,16,12,5,7,1,1,15,20,16,18,20,AM RLC,506,1,1,8,20,18,16,1,1,1,1,15,15,12,1,1,2251799813685760,0,0,0,0,0,0,0,0,0,1,0,0,0,0,0,0,0,0,0,0,0,0,0,0,0,0,0,0,0,0,0,0,0,0,0,0,0,0,0,0,0,0,0,0,0,0,0,0,Jeffrey Sarpong,£900Th. ,32.0,176.0,Forward - Left Winger,right,Without Club,19.0,2.0,1.0,483.0,14.0,1.0,1.0,566.0,14.0,1.0,0.0,612.0,32.0,2.0,4.0,2454.0,36.0,3.0,6.0,2349.0,13.0,0.0,1.0,676.0,25.0,5.0,5.0,2031.0,20.0,1.0,5.0,1275.0,22.0,0.0,1.0,1111.0,LaLiga,nan,nan,nan,nan,nan,nan,nan,nan
19/6/2011,Jazz Richards,28028902,801,4/12/1991,20,0,0,10,0,2400,5350,4450,135,98,231110,186,83,M C,2,1,2,2,2,3,3,1,2,3,3,5,5,4,6,10,4,9,5,7,5,12,7,10,10,14,10,12,10,11,12,10,14,8,11,11,10,10,15,14,12,11,12,11,15,12,20,15,14,9,8,10,16,12,12,14,10,11,12,10,13,8,13,1,20,15,13,1,20,M C,401,1,1,1,15,1,1,1,1,13,1,20,1,1,1,1,0,0,0,0,0,0,0,0,0,0,0,0,0,0,0,0,0,0,0,0,0,0,0,0,0,0,0,0,0,0,0,0,0,0,0,0,0,0,0,0,0,0,0,0,0,0,0,0,0,Jazz Richards,£900Th. ,29.0,174.0,Defender - Right-Back,right,Without Club,8.0,0.0,0.0,703.0,26.0,0.0,0.0,2146.0,15.0,0.0,3.0,1152.0,11.0,0.0,0.0,782.0,27.0,0.0,2.0,2164.0,26.0,0.0,1.0,2078.0,28.0,0.0,1.0,2442.0,11.0,0.0,0.0,957.0,5.0,0.0,0.0,187.0,Premier League,13.0,0.0,0.0,1156.0,nan,nan,nan,nan
19/6/2011,Javier Zanetti,7931,1649,8/10/1973,37,145,5,6,0,7231,8195,7530,174,149,226907,178,75,D/WB/DM/M RLC,1,1,1,1,1,1,1,1,1,1,1,5,10,16,5,11,4,8,10,10,14,11,9,16,12,14,15,13,13,16,6,16,18,7,19,7,15,17,18,13,13,19,7,9,19,14,20,17,15,19,6,17,2,19,19,14,20,15,20,19,18,5,20,18,18,1,20,17,18,D/WB/DM/M RLC,136,1,1,1,1,1,1,1,17,20,18,18,11,14,15,18,88240371531776,0,0,0,0,0,0,0,0,0,0,0,0,0,0,0,0,0,0,0,0,0,0,0,0,0,0,0,0,1,0,0,0,1,0,0,0,0,0,1,0,0,0,0,0,1,0,1,0,Javier Zanetti,£900Th. ,47.0,178.0,Defender - Right-Back,right,Retired,52.0,2.0,2.0,4625.0,45.0,0.0,4.0,4001.0,48.0,0.0,1.0,4117.0,13.0,0.0,0.0,520.0,nan,nan,nan,nan,nan,nan,nan,nan,nan,nan,nan,nan,nan,nan,nan,nan,nan,nan,nan,nan,Serie A,nan,nan,nan,nan,nan,nan,nan,nan
19/6/2011,Javier Matilla,67067070,796,8/16/1988,22,0,0,1,0,4600,6600,6600,154,132,482738,176,72,M C,3,2,2,2,2,2,1,5,1,3,3,11,12,12,9,16,10,7,10,5,10,16,12,10,16,10,12,9,12,12,16,14,13,13,9,11,12,15,12,13,14,10,8,13,12,11,20,13,11,13,8,12,8,8,11,15,13,12,15,14,13,6,1,1,20,8,1,1,20,M C,401,1,1,1,8,1,1,1,1,1,13,20,1,1,1,1,4194304,0,0,0,0,0,0,0,0,0,0,0,0,0,0,0,0,0,0,0,0,0,0,1,0,0,0,0,0,0,0,0,0,0,0,0,0,0,0,0,0,0,0,0,0,0,0,0,0,Javier Matilla,£1.35m ,32.0,178.0,Midfielder - Central Midfield,right,Aris Thessaloniki,18.0,0.0,0.0,832.0,15.0,0.0,0.0,453.0,35.0,12.0,4.0,3026.0,26.0,1.0,1.0,1562.0,18.0,2.0,2.0,1445.0,nan,nan,nan,nan,15.0,2.0,1.0,1155.0,10.0,0.0,0.0,559.0,31.0,3.0,5.0,2115.0,LaLiga,43.0,2.0,5.0,3887.0,6.0,1.0,0.0,418.0
19/6/2011,Javier Mascherano,951028,1649,6/8/1984,27,61,2,22,1,8255,8510,8510,176,170,13454545,174,77,DM/M C,1,1,1,1,2,2,2,9,1,1,2,7,8,10,6,15,5,8,7,4,18,13,10,20,13,18,18,20,18,17,12,16,19,8,16,10,19,18,18,14,13,15,8,10,14,15,20,19,16,18,16,18,7,13,15,18,7,19,13,8,7,15,14,1,18,1,10,1,18,DM/M C,311,1,1,1,1,1,1,14,1,1,20,18,1,10,1,1,25786581056,0,0,0,0,0,0,1,0,0,0,0,0,0,0,0,0,0,0,0,0,0,0,0,0,1,0,0,0,0,0,0,0,0,1,1,0,0,0,0,0,0,0,0,0,0,0,0,0,Javier Mascherano,£27.00m ,36.0,174.0,Midfielder - Defensive Midfield,right,Club Estudiantes de La Plata,46.0,0.0,1.0,3145.0,52.0,0.0,0.0,4494.0,41.0,0.0,1.0,3264.0,46.0,0.0,0.0,3850.0,47.0,0.0,2.0,3873.0,51.0,0.0,1.0,4279.0,40.0,1.0,4.0,3012.0,39.0,1.0,1.0,3308.0,27.0,0.0,9.0,2430.0,LaLiga,8.0,0.0,1.0,720.0,nan,nan,nan,nan
19/6/2011,Javier Farinós,4201540,796,3/29/1978,33,2,0,0,0,4600,6500,6500,150,132,447501,173,69,DM/M/AM C,3,2,2,2,2,2,3,1,2,1,3,16,13,11,12,13,16,10,15,11,10,15,16,12,14,14,13,15,13,14,15,15,15,13,15,10,13,14,14,11,12,12,9,9,15,10,20,15,14,16,15,16,9,17,12,17,12,12,12,12,15,8,11,9,19,16,14,10,19,DM/M/AM C,321,1,1,1,16,8,13,6,6,11,20,19,10,14,5,9,140737492550016,0,0,0,0,0,0,0,1,1,0,0,0,0,0,0,0,0,0,0,0,0,0,1,0,0,0,0,0,0,0,0,0,0,0,0,0,0,0,0,0,0,0,0,0,0,0,0,1
19/6/2011,Javier Casquero,6700186,796,8/19/1976,34,0,0,0,0,4850,6750,6750,147,134,330484,180,75,DM/M C,2,2,2,3,3,3,3,8,1,3,3,14,10,11,14,15,14,10,18,13,7,15,13,11,13,14,13,14,12,14,13,15,18,14,14,14,12,15,14,10,9,13,8,15,14,10,20,11,12,15,14,10,4,15,17,16,13,9,15,18,14,7,1,1,20,13,10,1,20,DM/M C,421,1,1,1,13,1,1,1,1,1,16,20,1,10,1,1,2147484420,0,0,1,0,0,0,0,0,1,1,0,0,0,0,0,0,0,0,0,0,0,0,0,0,0,0,0,0,0,0,0,1,0,0,0,0,0,0,0,0,0,0,0,0,0,0,0,0,Javier Casquero,£900Th. ,44.0,180.0,Midfielder - Defensive Midfield,both,Retired,33.0,2.0,2.0,1590.0,29.0,1.0,0.0,1727.0,27.0,3.0,1.0,1781.0,13.0,0.0,0.0,480.0,nan,nan,nan,nan,nan,nan,nan,nan,nan,nan,nan,nan,nan,nan,nan,nan,nan,nan,nan,nan,LaLiga,nan,nan,nan,nan,nan,nan,nan,nan
19/6/2011,Javi Martínez,1512305,796,9/2/1988,22,3,0,14,0,5500,7750,7750,166,157,5343423,190,87,M C,1,2,3,1,1,2,1,5,1,2,2,6,9,11,12,12,9,15,13,8,14,14,13,14,14,14,15,15,15,16,13,15,14,13,14,14,15,16,16,13,13,14,16,13,15,14,20,17,16,17,9,14,7,13,15,16,14,13,15,14,12,4,1,1,20,14,12,1,20,M C,401,1,1,1,14,1,1,1,1,1,13,20,1,12,1,1,0,0,0,0,0,0,0,0,0,0,0,0,0,0,0,0,0,0,0,0,0,0,0,0,0,0,0,0,0,0,0,0,0,0,0,0,0,0,0,0,0,0,0,0,0,0,0,0,0,Javi Martínez,£19.80m ,32.0,192.0,Midfielder - Defensive Midfield,right,Bayern Munich,38.0,4.0,1.0,3242.0,54.0,4.0,1.0,4615.0,43.0,3.0,4.0,3071.0,34.0,1.0,0.0,2217.0,3.0,0.0,0.0,96.0,27.0,1.0,2.0,1915.0,37.0,2.0,1.0,2975.0,37.0,2.0,2.0,2738.0,33.0,4.0,0.0,2257.0,LaLiga,24.0,0.0,0.0,1015.0,7.0,1.0,0.0,248.0
19/6/2011,Javi Márquez,1509534,796,5/11/1986,25,0,0,0,0,4750,7000,7000,150,140,1099884,174,71,DM/M LC,2,2,1,3,3,2,2,1,1,1,3,11,12,12,9,14,12,9,13,9,10,14,9,12,14,12,14,12,14,14,14,15,12,12,9,14,13,15,17,14,13,11,8,20,12,14,8,14,12,12,9,9,9,13,9,12,15,14,10,8,7,19,1,1,20,14,1,17,20,DM/M LC,424,1,1,1,14,13,1,1,1,1,17,20,17,1,1,1,0,0,0,0,0,0,0,0,0,0,0,0,0,0,0,0,0,0,0,0,0,0,0,0,0,0,0,0,0,0,0,0,0,0,0,0,0,0,0,0,0,0,0,0,0,0,0,0,0,Javi Márquez,£5.40m ,34.0,179.0,Midfielder - Central Midfield,left,Without Club,33.0,2.0,1.0,2470.0,9.0,0.0,0.0,594.0,26.0,3.0,2.0,1597.0,30.0,2.0,1.0,2157.0,26.0,0.0,0.0,1487.0,21.0,0.0,1.0,1443.0,39.0,6.0,6.0,2998.0,13.0,0.0,0.0,572.0,25.0,1.0,3.0,1508.0,LaLiga,11.0,2.0,0.0,796.0,nan,nan,nan,nan
19/6/2011,Javi López,67006184,796,1/21/1986,25,0,0,0,0,2500,5750,5750,130,120,240418,179,74,D/WB/DM/M RC,1,2,3,3,1,1,3,1,1,3,3,9,12,12,11,10,9,7,11,9,12,13,5,11,12,13,12,11,12,10,11,11,10,7,8,13,12,12,14,14,13,8,8,12,14,12,20,12,10,14,8,10,7,17,8,7,12,14,8,18,10,6,18,20,19,14,20,10,15,D/WB/DM/M RC,243,1,1,1,1,8,14,1,5,18,16,15,10,19,8,20,0,0,0,0,0,0,0,0,0,0,0,0,0,0,0,0,0,0,0,0,0,0,0,0,0,0,0,0,0,0,0,0,0,0,0,0,0,0,0,0,0,0,0,0,0,0,0,0,0,Javi López,£2.25m ,34.0,180.0,Defender - Right-Back,right,Without Club,27.0,0.0,0.0,1752.0,32.0,1.0,2.0,2412.0,33.0,1.0,0.0,2577.0,35.0,0.0,1.0,3105.0,33.0,0.0,1.0,2621.0,33.0,0.0,1.0,2613.0,20.0,0.0,1.0,1614.0,15.0,0.0,0.0,1039.0,25.0,0.0,0.0,2159.0,LaLiga,28.0,1.0,1.0,2375.0,nan,nan,nan,nan
19/6/2011,Javi Fuego,7441609,796,1/4/1984,27,0,0,1,0,4000,6000,6000,132,120,485415,181,74,DM/M C,1,2,1,2,2,1,3,3,1,3,3,9,12,11,12,13,15,8,14,8,6,14,13,12,14,9,12,12,12,12,14,13,10,13,13,12,13,13,13,12,13,10,10,8,8,12,20,12,11,12,6,12,14,12,7,4,16,6,7,10,11,11,1,1,20,12,1,1,20,DM/M C,421,1,1,1,12,1,1,1,1,1,18,20,1,1,1,1,35184376283392,0,0,0,0,0,0,0,0,1,0,0,0,0,0,0,0,0,0,0,0,0,0,1,0,0,0,0,0,0,0,0,0,0,0,0,0,0,0,0,0,0,0,0,0,0,1,0,0,Javi Fuego,£1.80m ,36.0,182.0,Midfielder - Defensive Midfield,right,Sporting Gijón,38.0,1.0,0.0,3384.0,32.0,0.0,1.0,2833.0,36.0,0.0,1.0,3213.0,41.0,2.0,0.0,3303.0,38.0,3.0,1.0,3274.0,38.0,0.0,1.0,2872.0,32.0,1.0,0.0,2686.0,32.0,0.0,0.0,2213.0,11.0,0.0,1.0,657.0,LaLiga,34.0,0.0,1.0,2310.0,6.0,0.0,0.0,500.0
19/6/2011,Javad Nekounam,145669,114,10/7/1980,30,118,26,0,0,5750,7500,7000,149,145,395257,186,78,DM/M C,2,2,3,2,3,1,2,1,3,2,2,11,10,12,15,14,13,16,15,9,11,15,13,13,14,17,14,15,13,15,13,14,16,9,13,7,16,17,17,9,10,16,14,9,15,11,20,17,14,15,16,16,6,7,12,14,14,16,18,16,18,3,9,1,17,8,3,3,17,DM/M C,311,1,5,1,8,1,1,9,1,1,20,17,3,3,1,1,35184372089664,0,0,0,0,0,0,1,0,1,1,0,0,0,0,0,0,0,0,0,0,0,0,0,0,0,0,0,0,0,0,0,0,0,0,0,0,0,0,0,0,0,0,0,0,0,1,0,0,Javad Nekounam,£2.70m ,40.0,186.0,Midfielder - Defensive Midfield,right,Retired,28.0,6.0,1.0,2406.0,33.0,6.0,0.0,2683.0,38.0,8.0,1.0,3356.0,26.0,8.0,2.0,2330.0,23.0,5.0,0.0,1845.0,21.0,4.0,0.0,1806.0,nan,nan,nan,nan,nan,nan,nan,nan,nan,nan,nan,nan,LaLiga,nan,nan,nan,nan,nan,nan,nan,nan
19/6/2011,Jason Lowe,28027434,765,9/2/1991,19,0,0,0,0,3100,5750,6000,137,105,740561,176,75,D/M RC,3,1,1,2,3,3,2,1,2,3,2,8,4,8,7,10,10,6,8,2,9,11,5,13,10,10,11,7,14,12,13,10,14,9,8,7,9,13,17,13,11,11,9,7,15,11,20,18,13,10,12,4,6,9,6,14,7,7,13,12,11,6,16,1,20,1,16,1,20,D/M RC,423,1,1,1,1,1,1,1,1,16,12,20,1,10,1,1,67108928,0,0,0,0,0,0,1,0,0,0,0,0,0,0,0,0,0,0,0,0,0,0,0,0,0,0,1,0,0,0,0,0,0,0,0,0,0,0,0,0,0,0,0,0,0,0,0,0,Jason Lowe,£1.35m ,29.0,183.0,Midfielder - Defensive Midfield,right,Salford City,18.0,2.0,2.0,1581.0,38.0,0.0,1.0,3117.0,42.0,0.0,3.0,3291.0,42.0,1.0,3.0,3592.0,14.0,0.0,0.0,1071.0,13.0,0.0,1.0,1050.0,49.0,0.0,3.0,4363.0,11.0,0.0,0.0,572.0,37.0,0.0,0.0,3197.0,Premier League,34.0,0.0,1.0,2947.0,10.0,0.0,1.0,900.0
19/6/2011,Jaroslav Plasil,916148,763,1/5/1982,29,63,5,16,1,5800,7200,6489,150,144,1077302,183,71,M/AM RLC,3,3,2,1,1,3,2,2,3,2,3,15,14,13,8,15,14,9,14,6,7,16,12,5,16,11,12,10,13,15,14,14,15,13,12,13,10,18,15,12,12,13,11,15,14,14,20,15,10,14,11,14,5,12,10,14,13,10,18,14,14,7,1,1,20,18,16,17,20,M/AM RLC,416,1,1,1,18,12,12,1,1,1,12,20,17,16,1,1,4718608,0,0,0,0,1,0,0,0,0,0,0,0,0,0,0,0,0,0,0,1,0,0,1,0,0,0,0,0,0,0,0,0,0,0,0,0,0,0,0,0,0,0,0,0,0,0,0,0,Jaroslav Plasil,£5.85m ,38.0,182.0,Midfielder - Central Midfield,right,Retired,42.0,4.0,14.0,3654.0,40.0,3.0,6.0,3601.0,49.0,2.0,3.0,3809.0,33.0,1.0,1.0,2500.0,38.0,0.0,3.0,3209.0,37.0,4.0,3.0,2818.0,45.0,2.0,5.0,2933.0,26.0,0.0,1.0,1217.0,35.0,0.0,3.0,2400.0,Ligue 1,nan,nan,nan,nan,nan,nan,nan,nan
19/6/2011,Jan-Ingwer Callsen-Bracker,8701229,771,9/23/1984,26,0,0,5,0,4850,6100,6100,125,122,429427,187,78,D/DM/M C,2,2,3,2,3,3,3,1,2,1,2,7,6,8,10,7,6,15,9,6,14,10,8,15,7,9,13,13,13,15,8,14,10,6,14,13,14,14,12,12,9,15,15,9,13,12,20,14,15,12,8,13,5,8,11,12,13,11,11,14,18,3,20,1,18,1,1,1,20,D/DM/M C,121,1,1,1,1,1,1,20,1,1,20,18,1,1,1,1,0,0,0,0,0,0,0,0,0,0,0,0,0,0,0,0,0,0,0,0,0,0,0,0,0,0,0,0,0,0,0,0,0,0,0,0,0,0,0,0,0,0,0,0,0,0,0,0,0,Jan-Ingwer Callsen-Bracker,£1.35m ,36.0,188.0,Defender - Centre-Back,right,Retired,29.0,2.0,0.0,2281.0,32.0,4.0,1.0,2520.0,27.0,3.0,1.0,2309.0,36.0,2.0,0.0,3179.0,24.0,1.0,1.0,2142.0,15.0,1.0,0.0,1076.0,2.0,0.0,0.0,61.0,15.0,1.0,0.0,1331.0,5.0,0.0,0.0,366.0,Bundesliga,nan,nan,nan,nan,nan,nan,nan,nan
19/6/2011,Jan Rosenthal,8728478,771,4/7/1986,25,0,0,17,2,5000,6550,6550,143,132,765094,185,75,M/AM RLC,1,2,3,3,3,3,2,4,2,1,3,10,11,12,13,12,10,10,13,10,7,13,10,11,14,12,13,15,8,8,11,10,17,12,12,14,10,13,15,13,12,14,13,14,12,15,20,14,14,9,5,9,13,17,8,15,14,7,15,14,11,6,1,7,18,20,20,18,18,M/AM RLC,526,1,1,1,18,18,20,1,1,1,11,15,15,18,7,7,512,0,0,0,0,0,0,0,0,0,1,0,0,0,0,0,0,0,0,0,0,0,0,0,0,0,0,0,0,0,0,0,0,0,0,0,0,0,0,0,0,0,0,0,0,0,0,0,0,Jan Rosenthal,£2.70m ,34.0,186.0,Forward - Second Striker,right,Retired,23.0,5.0,0.0,1660.0,21.0,2.0,1.0,1349.0,24.0,5.0,5.0,1765.0,24.0,2.0,2.0,1119.0,9.0,1.0,1.0,315.0,25.0,0.0,5.0,1529.0,19.0,0.0,0.0,856.0,12.0,0.0,0.0,439.0,nan,nan,nan,nan,Bundesliga,2.0,0.0,0.0,118.0,nan,nan,nan,nan
19/6/2011,Jan Polak,132976,763,3/14/1981,30,57,7,46,0,6050,6500,5950,137,129,935599,181,77,M C,2,2,3,1,3,2,1,1,1,1,1,8,10,10,10,12,12,11,15,10,11,14,10,13,12,14,14,14,12,14,13,13,14,14,18,12,13,16,16,11,10,13,11,8,13,12,20,18,13,14,12,13,9,11,10,18,10,14,13,10,7,10,1,1,20,1,14,1,20,M C,401,1,1,1,1,1,1,1,1,1,14,20,1,14,1,1,772,0,0,1,0,0,0,0,0,1,1,0,0,0,0,0,0,0,0,0,0,0,0,0,0,0,0,0,0,0,0,0,0,0,0,0,0,0,0,0,0,0,0,0,0,0,0,0,0,Jan Polak,£1.35m ,39.0,181.0,Midfielder - Defensive Midfield,right,Retired,37.0,3.0,1.0,2699.0,16.0,0.0,0.0,1100.0,31.0,1.0,3.0,2541.0,20.0,0.0,0.0,905.0,24.0,0.0,1.0,1922.0,17.0,2.0,0.0,728.0,24.0,2.0,0.0,2047.0,25.0,1.0,0.0,2073.0,20.0,0.0,1.0,1764.0,Bundesliga,16.0,0.0,1.0,1371.0,nan,nan,nan,nan
19/6/2011,Jan Moravek,25007942,763,11/1/1989,21,3,0,9,0,5150,6000,6500,149,127,1147650,180,75,M/AM C,3,3,3,1,2,1,1,5,3,1,3,11,12,13,15,16,10,13,14,6,7,14,12,10,16,5,14,6,13,8,15,15,6,13,5,16,10,14,13,10,12,7,8,10,14,13,20,12,9,9,5,12,6,11,12,10,14,9,13,12,19,2,1,1,18,20,13,14,20,M/AM C,521,1,1,1,20,14,13,1,1,1,10,18,10,12,1,1,1184,0,0,0,0,0,1,0,1,0,0,1,0,0,0,0,0,0,0,0,0,0,0,0,0,0,0,0,0,0,0,0,0,0,0,0,0,0,0,0,0,0,0,0,0,0,0,0,0,Jan Morávek,£1.58m ,30.0,180.0,Midfielder - Central Midfield,right,FC Augsburg,33.0,5.0,2.0,2255.0,17.0,0.0,1.0,562.0,23.0,1.0,3.0,1359.0,17.0,0.0,1.0,1064.0,0.0,0.0,0.0,0.0,15.0,3.0,1.0,575.0,13.0,0.0,0.0,697.0,16.0,0.0,0.0,699.0,14.0,0.0,2.0,834.0,Bundesliga,11.0,0.0,1.0,467.0,nan,nan,nan,nan
19/6/2011,Jamie O'Hara,5113930,765,9/25/1986,24,0,0,7,0,4800,6400,6650,155,136,1272727,181,78,M LC,1,1,3,2,3,2,1,6,2,3,3,14,13,11,10,14,15,8,15,5,10,15,11,11,13,11,13,14,15,14,14,14,16,14,7,11,9,15,15,14,12,11,8,20,14,12,12,15,10,12,8,14,7,11,9,13,12,15,15,9,14,5,12,12,20,10,5,15,20,M LC,404,1,1,1,10,10,1,1,12,1,10,20,15,5,12,3,16384,0,0,0,0,0,0,0,0,0,0,0,0,0,0,1,0,0,0,0,0,0,0,0,0,0,0,0,0,0,0,0,0,0,0,0,0,0,0,0,0,0,0,0,0,0,0,0,0,Jamie O'Hara,£4.50m ,34.0,180.0,Midfielder - Central Midfield,left,Retired,14.0,3.0,1.0,1117.0,21.0,3.0,3.0,1730.0,21.0,0.0,4.0,1404.0,12.0,3.0,1.0,941.0,28.0,2.0,6.0,2442.0,39.0,1.0,3.0,2895.0,3.0,0.0,0.0,92.0,nan,nan,nan,nan,1.0,0.0,0.0,20.0,Premier League,0.0,0.0,0.0,0.0,nan,nan,nan,nan
19/6/2011,James Morrison,5113352,793,5/25/1986,25,13,1,0,0,4750,6750,6500,142,130,993822,178,77,M/AM RC,3,2,3,3,2,2,2,1,3,2,3,9,13,15,10,14,8,8,11,3,8,13,5,9,14,9,12,8,13,12,15,12,13,14,7,15,11,12,14,14,13,13,7,16,15,12,20,13,10,14,7,12,9,14,14,15,14,12,14,13,14,6,2,3,20,20,20,14,20,M/AM RC,413,1,1,1,20,14,20,1,1,2,4,16,14,20,1,3,42,0,1,0,1,0,1,0,0,0,0,0,0,0,0,0,0,0,0,0,0,0,0,0,0,0,0,0,0,0,0,0,0,0,0,0,0,0,0,0,0,0,0,0,0,0,0,0,0,James Morrison,£4.05m ,34.0,183.0,Midfielder - Central Midfield,right,Retired,32.0,4.0,3.0,2367.0,33.0,5.0,5.0,2357.0,37.0,5.0,7.0,3026.0,35.0,1.0,4.0,2351.0,37.0,4.0,1.0,2885.0,19.0,4.0,3.0,1432.0,35.0,5.0,3.0,2092.0,6.0,1.0,0.0,373.0,27.0,0.0,1.0,1396.0,Premier League,nan,nan,nan,nan,nan,nan,nan,nan
19/6/2011,James Milner,5106363,765,1/4/1986,25,19,0,46,9,6400,7500,7500,160,150,18181818,176,70,M/AM RLC,3,3,3,3,3,2,1,4,2,1,2,13,14,12,12,14,15,9,13,12,9,14,12,12,12,12,15,14,14,15,14,15,17,14,14,13,10,18,19,13,15,13,8,12,18,12,20,18,11,16,4,15,4,14,7,15,15,16,18,12,14,1,10,3,20,18,18,17,20,M/AM RLC,416,1,1,8,10,17,18,1,3,10,1,20,15,15,2,3,70918499991683,1,1,0,0,0,0,0,1,0,0,0,0,0,0,0,0,0,0,0,0,0,0,0,0,0,0,0,0,0,0,0,0,0,0,0,0,0,0,0,1,0,0,0,0,0,0,1,0,James Milner,£18.90m ,34.0,175.0,Midfielder - Central Midfield,right,Liverpool FC,42.0,3.0,8.0,2688.0,37.0,3.0,5.0,2198.0,36.0,4.0,8.0,2421.0,44.0,2.0,15.0,2323.0,45.0,8.0,9.0,2704.0,45.0,7.0,14.0,3862.0,40.0,7.0,4.0,3437.0,47.0,1.0,11.0,2787.0,45.0,7.0,7.0,2836.0,Premier League,37.0,4.0,4.0,1708.0,7.0,0.0,0.0,305.0
19/6/2011,James McCarthy,61002273,789,11/12/1990,20,3,0,6,1,4250,6000,6350,156,132,2942728,181,63,DM/M RC,1,2,3,3,2,3,1,2,1,3,2,12,12,14,14,14,5,11,13,4,7,16,8,11,17,12,14,13,14,7,12,13,10,12,5,15,11,13,14,14,12,10,8,10,14,13,20,16,5,11,8,14,5,10,12,5,18,14,15,1,10,17,1,1,20,13,15,1,20,DM/M RC,423,1,1,1,13,1,1,1,1,1,17,20,1,15,1,1,51539609760,0,0,0,0,0,1,0,1,0,0,0,1,0,0,0,0,0,0,0,0,0,0,0,0,0,0,0,0,0,0,0,0,0,0,1,1,0,0,0,0,0,0,0,0,0,0,0,0,James McCarthy,£4.95m ,29.0,180.0,Midfielder - Central Midfield,right,Crystal Palace,27.0,3.0,2.0,2044.0,34.0,0.0,3.0,2973.0,42.0,3.0,2.0,3645.0,45.0,1.0,3.0,3841.0,37.0,2.0,3.0,2936.0,37.0,2.0,2.0,3045.0,13.0,1.0,2.0,678.0,6.0,0.0,0.0,356.0,2.0,0.0,0.0,104.0,Premier League,35.0,0.0,0.0,1847.0,4.0,0.0,0.0,319.0
19/6/2011,James McArthur,5217388,793,10/7/1987,23,4,1,2,0,4000,6600,6300,155,124,806660,168,64,M C,1,1,1,1,1,1,1,1,1,1,1,8,12,15,8,14,8,7,6,7,10,17,7,13,14,11,14,13,15,14,15,13,13,5,14,12,15,17,17,11,12,14,9,5,14,10,20,15,8,16,12,18,6,7,5,13,16,10,17,13,14,2,1,1,20,1,10,1,20,M C,401,1,1,1,1,1,1,1,1,1,10,20,1,10,1,1,4718656,0,0,0,0,0,0,1,0,0,0,0,0,0,0,0,0,0,0,0,1,0,0,1,0,0,0,0,0,0,0,0,0,0,0,0,0,0,0,0,0,0,0,0,0,0,0,0,0,James McArthur,£2.25m ,33.0,178.0,Midfielder - Central Midfield,both,Crystal Palace,29.0,1.0,0.0,1412.0,35.0,3.0,2.0,2116.0,40.0,4.0,5.0,2730.0,54.0,4.0,4.0,4378.0,38.0,3.0,3.0,3147.0,31.0,2.0,2.0,2402.0,31.0,5.0,3.0,2095.0,35.0,7.0,1.0,2614.0,40.0,3.0,6.0,3166.0,Premier League,38.0,0.0,4.0,3155.0,5.0,0.0,0.0,430.0
19/6/2011,Jamel Saihi,8445738,51,1/21/1987,24,4,1,0,0,4550,6350,5700,140,127,483015,181,73,DM C,3,2,1,3,1,2,2,1,2,1,1,9,9,11,6,13,11,11,14,8,11,13,8,12,13,12,14,15,13,13,13,12,15,9,9,8,13,16,16,12,13,14,10,8,13,11,20,16,12,13,12,14,11,8,16,13,17,13,14,14,14,6,1,1,15,1,1,1,15,DM C,301,1,1,1,1,1,1,1,1,1,20,15,1,1,1,1,0,0,0,0,0,0,0,0,0,0,0,0,0,0,0,0,0,0,0,0,0,0,0,0,0,0,0,0,0,0,0,0,0,0,0,0,0,0,0,0,0,0,0,0,0,0,0,0,0,Jamel Saihi,£3.15m ,33.0,182.0,Midfielder - Defensive Midfield,right,Retired,18.0,1.0,0.0,848.0,33.0,0.0,1.0,2610.0,15.0,0.0,0.0,1262.0,14.0,0.0,0.0,793.0,21.0,0.0,0.0,1468.0,15.0,0.0,0.0,707.0,9.0,0.0,0.0,473.0,nan,nan,nan,nan,nan,nan,nan,nan,Ligue 1,nan,nan,nan,nan,nan,nan,nan,nan
19/6/2011,Jack Rodwell,28010312,765,3/11/1991,20,0,0,17,2,4750,6750,6750,165,135,3939874,188,80,DM/M C,2,1,1,2,1,1,1,6,3,3,3,4,9,12,12,14,4,14,12,3,13,14,10,13,14,12,12,12,14,11,11,13,12,5,14,8,13,14,14,14,12,14,14,14,15,14,20,15,13,9,7,12,5,10,6,15,13,14,13,11,15,5,1,1,20,13,7,7,20,DM/M C,421,1,1,1,13,1,1,1,1,1,18,20,7,7,1,1,33088,0,0,0,0,0,0,1,0,1,0,0,0,0,0,0,1,0,0,0,0,0,0,0,0,0,0,0,0,0,0,0,0,0,0,0,0,0,0,0,0,0,0,0,0,0,0,0,0,Jack Rodwell,£13.50m ,29.0,188.0,Midfielder - Defensive Midfield,right,Sheffield United,29.0,1.0,2.0,1754.0,19.0,2.0,2.0,1343.0,16.0,2.0,1.0,670.0,10.0,0.0,0.0,336.0,26.0,3.0,0.0,1663.0,24.0,3.0,2.0,1292.0,23.0,0.0,1.0,1763.0,9.0,1.0,0.0,669.0,23.0,1.0,0.0,1589.0,Premier League,2.0,0.0,0.0,73.0,nan,nan,nan,nan
19/6/2011,Jack Colback,28005566,765,10/24/1989,21,0,0,0,0,3250,6250,6500,140,116,1202539,176,73,M LC,1,1,1,1,2,2,1,7,1,2,2,10,7,11,13,13,8,9,9,5,12,13,11,14,12,17,14,16,13,10,12,12,13,11,10,12,13,15,15,12,10,11,7,20,12,12,10,12,11,14,10,10,10,13,8,14,12,10,11,8,6,8,10,1,20,1,1,15,20,M LC,404,1,1,1,1,1,1,1,10,1,12,20,15,1,1,1,137438953472,0,0,0,0,0,0,0,0,0,0,0,0,0,0,0,0,0,0,0,0,0,0,0,0,0,0,0,0,0,0,0,0,0,0,0,0,0,1,0,0,0,0,0,0,0,0,0,0,Jack Colback,£4.05m ,31.0,177.0,Midfielder - Defensive Midfield,left,Nottingham Forest,33.0,1.0,3.0,2449.0,39.0,2.0,2.0,3071.0,40.0,0.0,2.0,3230.0,42.0,3.0,3.0,3110.0,38.0,4.0,7.0,3429.0,30.0,1.0,1.0,2414.0,34.0,0.0,2.0,2288.0,19.0,1.0,0.0,1696.0,39.0,3.0,2.0,3477.0,Premier League,nan,nan,nan,nan,6.0,0.0,0.0,484.0
19/6/2011,Ja-Cheol Ku,66001373,135,2/27/1989,22,19,8,16,5,4400,6500,6400,155,128,316205,182,72,M/AM C,2,3,3,2,2,3,1,6,3,1,3,14,16,9,13,15,12,8,15,4,9,15,12,8,14,14,13,11,12,11,14,11,15,11,12,15,9,12,16,10,11,12,9,17,11,10,20,13,10,7,12,15,10,16,15,11,14,11,12,10,9,13,1,1,20,18,12,1,20,M/AM C,411,1,1,10,18,1,1,1,1,1,14,20,1,12,1,1,8796093546912,0,0,0,0,0,1,0,1,1,0,0,0,0,0,0,0,0,0,0,1,0,0,0,0,0,0,0,0,0,0,0,0,0,0,0,0,0,0,0,0,0,0,0,1,0,0,0,0,Ja-cheol Koo,£3.15m ,31.0,182.0,Midfielder - Central Midfield,right,Al-Gharafa SC,10.0,0.0,1.0,281.0,27.0,5.0,3.0,1811.0,22.0,3.0,2.0,1687.0,26.0,1.0,2.0,1446.0,26.0,7.0,2.0,1751.0,38.0,8.0,4.0,2590.0,25.0,3.0,4.0,1981.0,29.0,2.0,0.0,2066.0,28.0,2.0,1.0,1827.0,Bundesliga,18.0,1.0,0.0,1617.0,4.0,1.0,0.0,335.0
19/6/2011,Ivan Todorovic,5753770,802,7/29/1983,27,0,0,12,0,2022,5500,4500,115,101,104575,183,77,M/AM LC,1,1,3,1,2,3,3,2,3,3,2,10,8,12,8,10,8,7,9,10,9,12,8,8,12,11,11,14,10,10,9,8,11,5,10,8,9,13,9,11,15,12,11,20,13,13,14,15,13,11,18,13,8,11,15,10,10,10,12,12,12,6,1,1,20,16,1,15,20,M/AM LC,414,1,1,1,16,12,1,1,1,1,13,20,15,1,1,1,0,0,0,0,0,0,0,0,0,0,0,0,0,0,0,0,0,0,0,0,0,0,0,0,0,0,0,0,0,0,0,0,0,0,0,0,0,0,0,0,0,0,0,0,0,0,0,0,0,Ivan Todorovic,£720Th. ,37.0,184.0,Midfielder - Defensive Midfield,right,Retired,18.0,0.0,0.0,1091.0,30.0,1.0,0.0,2039.0,27.0,1.0,2.0,2051.0,27.0,2.0,0.0,2419.0,36.0,4.0,1.0,2809.0,15.0,0.0,0.0,1117.0,nan,nan,nan,nan,nan,nan,nan,nan,nan,nan,nan,nan,Liga NOS,nan,nan,nan,nan,nan,nan,nan,nan
19/6/2011,Ivan Rakitic,5727652,761,3/10/1988,23,27,8,3,2,6500,7650,7250,171,151,6324111,184,77,M/AM C,3,3,1,1,3,1,2,7,1,1,2,18,16,10,13,17,15,10,17,6,8,15,14,10,17,8,14,9,14,11,14,12,7,11,9,13,11,16,14,9,12,11,12,17,14,16,20,15,11,9,6,11,6,12,10,14,9,11,10,14,18,12,1,1,20,18,14,14,20,M/AM C,411,1,1,8,18,14,14,1,1,1,12,20,12,12,1,1,1108347136,0,0,0,0,0,0,0,0,1,0,0,1,0,0,0,0,0,0,0,0,1,0,0,0,0,1,0,0,0,0,1,0,0,0,0,0,0,0,0,0,0,0,0,0,0,0,0,0,Ivan Rakitic,£8.10m ,32.0,184.0,Midfielder - Central Midfield,right,Sevilla FC,42.0,7.0,8.0,3361.0,39.0,1.0,6.0,2078.0,42.0,11.0,14.0,3519.0,52.0,15.0,18.0,4168.0,51.0,8.0,10.0,3344.0,57.0,9.0,5.0,4065.0,51.0,8.0,7.0,3524.0,55.0,4.0,5.0,4266.0,54.0,5.0,10.0,4237.0,LaLiga,42.0,1.0,5.0,2111.0,7.0,1.0,1.0,535.0
19/6/2011,Ivan Radovanovic,62013021,802,8/29/1988,22,1,0,11,0,3600,6000,5550,138,114,108399,186,76,DM C,1,1,3,1,1,1,2,2,3,1,3,11,12,11,9,12,11,12,11,8,12,14,10,13,13,13,9,11,7,8,14,11,15,10,11,10,11,12,12,12,11,12,12,10,11,12,20,15,11,12,14,9,9,8,14,9,16,8,16,18,12,2,10,8,15,10,7,10,15,DM C,301,1,1,1,10,1,1,6,10,1,20,15,1,7,8,1,0,0,0,0,0,0,0,0,0,0,0,0,0,0,0,0,0,0,0,0,0,0,0,0,0,0,0,0,0,0,0,0,0,0,0,0,0,0,0,0,0,0,0,0,0,0,0,0,0,Ivan Radovanovic,£810Th. ,32.0,187.0,Midfielder - Defensive Midfield,right,Genoa CFC,16.0,1.0,0.0,635.0,30.0,2.0,0.0,1696.0,17.0,0.0,0.0,718.0,35.0,1.0,1.0,2519.0,31.0,1.0,0.0,2476.0,27.0,0.0,0.0,2148.0,37.0,0.0,0.0,3025.0,36.0,1.0,1.0,3261.0,36.0,0.0,0.0,3080.0,Serie A,22.0,0.0,1.0,1522.0,4.0,0.0,0.0,161.0
19/6/2011,Ivan Perisic,34012563,761,2/2/1989,22,3,0,8,3,5250,6800,6800,157,139,2149203,187,79,AM LC,2,3,2,3,2,3,3,2,2,1,1,11,13,12,17,15,14,17,12,5,5,13,14,6,14,7,16,14,15,12,12,14,14,13,6,17,8,7,9,14,10,11,16,16,15,14,20,11,11,11,7,15,6,17,9,14,10,14,7,14,8,6,1,1,15,20,14,19,20,AM LC,504,1,1,14,20,19,14,1,1,1,12,15,15,14,1,1,1056,0,0,0,0,0,1,0,0,0,0,1,0,0,0,0,0,0,0,0,0,0,0,0,0,0,0,0,0,0,0,0,0,0,0,0,0,0,0,0,0,0,0,0,0,0,0,0,0,Ivan Perisic,£6.30m ,31.0,187.0,Forward - Left Winger,both,Inter Milan,46.0,22.0,10.0,3787.0,41.0,9.0,6.0,1525.0,34.0,5.0,2.0,1400.0,38.0,11.0,7.0,2586.0,35.0,7.0,9.0,2380.0,41.0,10.0,6.0,2915.0,42.0,11.0,10.0,3042.0,39.0,11.0,11.0,3489.0,45.0,9.0,8.0,3631.0,Bundesliga,35.0,8.0,10.0,1756.0,6.0,0.0,2.0,397.0
19/6/2011,Iriney,310756,1651,4/23/1981,30,0,0,0,0,4650,6650,6650,139,133,578823,179,70,DM/M C,2,2,1,2,2,3,1,5,1,3,1,8,10,11,7,13,6,11,14,5,13,12,10,15,13,16,16,13,13,13,11,14,15,11,16,11,16,14,17,12,13,12,9,10,13,12,20,13,12,16,13,17,10,12,12,15,13,14,17,13,12,7,1,1,19,5,1,1,19,DM/M C,311,1,1,1,5,1,1,1,1,1,20,19,1,1,1,1,274878071296,0,0,0,0,0,0,0,0,0,1,0,0,0,0,0,1,0,1,0,0,0,0,0,0,0,0,0,0,0,0,0,0,0,0,0,0,0,0,1,0,0,0,0,0,0,0,0,0,Iriney,£2.25m ,39.0,179.0,Midfielder - Central Midfield,right,Retired,42.0,3.0,0.0,3495.0,33.0,0.0,0.0,2628.0,27.0,0.0,0.0,1952.0,28.0,0.0,0.0,1823.0,nan,nan,nan,nan,nan,nan,nan,nan,nan,nan,nan,nan,nan,nan,nan,nan,nan,nan,nan,nan,LaLiga,nan,nan,nan,nan,nan,nan,nan,nan
19/6/2011,Ilkay Gündogan,91003875,771,10/24/1990,20,0,0,3,0,5000,7050,7050,162,138,18181818,180,78,M/AM C,3,3,3,1,3,1,2,2,2,3,3,12,11,14,12,17,12,9,13,6,8,16,12,11,17,11,13,12,10,10,15,14,14,13,11,14,9,12,13,12,16,14,9,12,13,12,20,13,11,9,8,11,11,14,9,15,13,13,14,14,13,5,1,1,20,19,11,11,20,M/AM C,411,1,1,1,19,11,11,1,1,1,13,20,11,11,1,1,5243044,0,0,1,0,0,1,0,1,0,0,0,0,0,0,0,0,0,0,0,0,1,0,1,0,0,0,0,0,0,0,0,0,0,0,0,0,0,0,0,0,0,0,0,0,0,0,0,0,Ilkay Gündogan,£8.10m ,30.0,180.0,Midfielder - Central Midfield,right,Manchester City,26.0,5.0,3.0,1917.0,37.0,4.0,4.0,2565.0,45.0,4.0,4.0,3541.0,3.0,1.0,0.0,227.0,33.0,3.0,5.0,2715.0,40.0,3.0,7.0,3008.0,16.0,5.0,2.0,1230.0,49.0,6.0,7.0,2816.0,50.0,6.0,8.0,3387.0,Bundesliga,50.0,5.0,5.0,3551.0,3.0,1.0,0.0,183.0
19/6/2011,Ignacio Piatti,963494,1649,2/4/1985,26,0,0,0,0,4511,6265,6200,130,124,516195,181,76,M/AM RC,3,1,3,2,2,2,2,7,1,3,2,12,16,15,12,15,13,9,13,7,9,14,14,11,15,11,10,13,13,13,13,12,16,11,7,13,10,11,14,12,14,13,11,6,14,12,20,14,10,11,5,13,8,12,6,16,7,11,13,14,15,6,1,1,17,20,17,10,20,M/AM RC,523,1,1,1,20,10,15,1,1,1,1,17,8,17,1,1,0,0,0,0,0,0,0,0,0,0,0,0,0,0,0,0,0,0,0,0,0,0,0,0,0,0,0,0,0,0,0,0,0,0,0,0,0,0,0,0,0,0,0,0,0,0,0,0,0,Ignacio Piatti,£900Th. ,35.0,180.0,Forward - Left Winger,right,Club Atlético San Lorenzo de Almagro,26.0,3.0,2.0,1319.0,12.0,0.0,0.0,659.0,23.0,3.0,0.0,1610.0,51.0,16.0,4.0,3739.0,39.0,12.0,12.0,3248.0,38.0,21.0,7.0,3385.0,31.0,19.0,6.0,2630.0,34.0,16.0,11.0,2867.0,15.0,7.0,1.0,1122.0,Serie A,4.0,0.0,1.0,162.0,nan,nan,nan,nan
19/6/2011,Ignacio Camacho,67015002,796,5/4/1990,21,0,0,3,0,4250,6500,6500,155,130,1585653,177,72,DM/M C,3,1,1,2,3,2,3,2,2,3,2,6,11,10,10,13,9,14,8,5,14,13,6,15,12,14,14,15,11,12,13,14,10,13,14,8,13,16,17,10,11,13,9,10,15,13,20,14,14,13,15,14,8,12,12,17,13,16,16,19,15,7,10,1,16,1,1,1,16,DM/M C,311,1,1,1,1,1,1,10,1,1,20,16,1,1,1,1,32832,0,0,0,0,0,0,1,0,0,0,0,0,0,0,0,1,0,0,0,0,0,0,0,0,0,0,0,0,0,0,0,0,0,0,0,0,0,0,0,0,0,0,0,0,0,0,0,0,Ignacio Camacho,£900Th. ,30.0,182.0,Midfielder - Defensive Midfield,right,Retired,21.0,0.0,1.0,1402.0,14.0,1.0,0.0,863.0,48.0,3.0,1.0,3726.0,34.0,5.0,2.0,2461.0,28.0,4.0,2.0,2479.0,24.0,2.0,1.0,2065.0,35.0,4.0,2.0,3146.0,15.0,1.0,0.0,1082.0,6.0,0.0,0.0,540.0,LaLiga,nan,nan,nan,nan,nan,nan,nan,nan
19/6/2011,Hugo Viana,727976,788,1/15/1983,28,33,2,0,0,4350,6500,6650,137,133,623710,178,74,M C,2,3,1,1,1,2,1,8,2,2,1,15,17,14,14,17,17,8,16,11,10,17,17,13,17,11,16,10,14,15,17,17,13,11,14,14,11,13,11,10,14,15,9,20,11,8,7,16,12,12,7,12,11,10,7,18,13,11,16,16,13,6,1,2,20,14,5,13,20,M C,401,1,1,1,14,7,1,1,1,1,9,20,13,5,2,1,149551839182848,0,0,0,0,0,0,0,0,0,0,0,0,0,0,0,0,0,0,0,0,0,0,1,0,0,0,0,0,0,0,1,0,0,0,1,0,0,0,0,0,0,0,0,1,0,0,0,1,Hugo Viana,£6.75m ,37.0,178.0,Midfielder - Central Midfield,left,Retired,39.0,3.0,7.0,2691.0,43.0,5.0,11.0,3771.0,44.0,9.0,3.0,3671.0,30.0,3.0,4.0,2476.0,15.0,0.0,8.0,1270.0,25.0,2.0,11.0,2236.0,nan,nan,nan,nan,nan,nan,nan,nan,nan,nan,nan,nan,Liga NOS,nan,nan,nan,nan,nan,nan,nan,nan
19/6/2011,Hugo Morais,7002215,788,2/12/1978,33,0,0,0,0,1500,5000,5000,110,107,42276,182,80,M C,1,1,3,3,2,1,1,1,1,1,3,14,10,13,11,13,16,11,13,12,11,12,11,10,13,9,14,12,14,12,13,13,13,12,10,13,11,13,14,12,11,13,13,20,11,12,4,15,15,11,10,11,9,11,11,12,13,10,13,14,15,5,5,5,20,10,1,10,20,M C,401,1,1,1,10,1,1,1,5,1,10,20,10,1,5,1,17610443983104,0,0,0,0,0,0,0,0,1,0,0,1,0,0,0,0,0,1,0,0,0,0,1,0,0,0,0,0,0,0,1,0,0,0,1,0,0,0,0,0,0,0,0,0,1,0,0,0,Hugo Morais,£540Th. ,42.0,182.0,Midfielder - Central Midfield,left,Retired,28.0,1.0,1.0,2301.0,20.0,0.0,0.0,985.0,34.0,6.0,2.0,2630.0,34.0,4.0,0.0,2098.0,nan,nan,nan,nan,nan,nan,nan,nan,nan,nan,nan,nan,nan,nan,nan,nan,nan,nan,nan,nan,Liga NOS,nan,nan,nan,nan,nan,nan,nan,nan
19/6/2011,Hugo Leal,4100153,788,5/21/1980,31,1,0,20,4,4000,5500,5500,112,110,118901,180,77,DM/M C,2,3,3,2,2,3,1,10,3,1,2,15,14,13,7,15,14,8,14,8,7,16,11,8,15,10,15,10,16,11,15,16,13,13,10,11,12,12,13,7,9,13,12,8,11,8,20,12,13,14,7,12,18,10,8,7,14,14,17,18,18,4,1,1,20,10,5,5,20,DM/M C,421,1,1,1,10,1,5,1,1,1,17,20,5,5,1,1,192,0,0,0,0,0,0,1,1,0,0,0,0,0,0,0,0,0,0,0,0,0,0,0,0,0,0,0,0,0,0,0,0,0,0,0,0,0,0,0,0,0,0,0,0,0,0,0,0,Hugo Leal,£810Th. ,40.0,180.0,Midfielder - Central Midfield,right,Retired,27.0,1.0,0.0,2164.0,25.0,1.0,0.0,1828.0,9.0,0.0,0.0,350.0,nan,nan,nan,nan,nan,nan,nan,nan,nan,nan,nan,nan,nan,nan,nan,nan,nan,nan,nan,nan,nan,nan,nan,nan,Liga NOS,nan,nan,nan,nan,nan,nan,nan,nan
19/6/2011,Houssine Kharja,727975,34,11/9/1982,28,64,5,0,0,5000,6500,6750,140,135,479313,181,77,DM/M C,1,2,1,3,2,3,3,1,3,2,3,12,14,14,12,13,14,10,14,8,8,14,14,13,14,13,13,14,13,11,15,14,12,14,10,15,13,15,14,12,13,15,8,10,16,13,20,13,13,12,12,13,5,15,13,12,13,13,15,15,15,3,1,1,20,15,12,10,20,DM/M C,421,1,1,1,15,10,10,1,1,1,16,20,10,12,1,1,0,0,0,0,0,0,0,0,0,0,0,0,0,0,0,0,0,0,0,0,0,0,0,0,0,0,0,0,0,0,0,0,0,0,0,0,0,0,0,0,0,0,0,0,0,0,0,0,0,Houssine Kharja,£2.70m ,37.0,180.0,Midfielder - Central Midfield,right,Retired,34.0,2.0,5.0,1995.0,21.0,0.0,1.0,1117.0,19.0,2.0,0.0,1688.0,nan,nan,nan,nan,22.0,1.0,1.0,1629.0,11.0,0.0,2.0,714.0,nan,nan,nan,nan,nan,nan,nan,nan,nan,nan,nan,nan,Serie A,nan,nan,nan,nan,nan,nan,nan,nan
19/6/2011,Hernanes,2114781,1651,5/29/1985,26,3,0,7,1,6250,7261,7750,161,155,3118665,180,76,DM/M RLC,2,1,3,3,2,1,2,6,2,1,3,9,13,14,14,15,16,8,16,8,12,15,12,10,15,12,13,13,12,12,14,12,16,13,13,14,12,14,13,13,12,10,10,20,14,14,18,14,10,15,5,13,3,18,13,14,15,15,8,12,14,9,8,10,20,15,16,18,20,DM/M RLC,426,1,1,5,15,14,13,1,8,1,18,20,18,16,10,5,513,1,0,0,0,0,0,0,0,0,1,0,0,0,0,0,0,0,0,0,0,0,0,0,0,0,0,0,0,0,0,0,0,0,0,0,0,0,0,0,0,0,0,0,0,0,0,0,0,Hernanes,£14.40m ,35.0,180.0,Midfielder - Attacking Midfield,both,São Paulo Futebol Clube,37.0,12.0,6.0,2952.0,42.0,11.0,5.0,2875.0,53.0,14.0,8.0,4035.0,38.0,6.0,7.0,2850.0,36.0,5.0,6.0,2332.0,24.0,1.0,0.0,1489.0,40.0,11.0,3.0,3277.0,14.0,4.0,1.0,1105.0,27.0,2.0,4.0,1412.0,Serie A,24.0,2.0,0.0,1155.0,nan,nan,nan,nan
19/6/2011,Henning Hauger,760385,786,7/17/1985,25,21,0,14,0,4750,6500,6400,138,130,142292,179,71,DM/M C,3,3,1,3,1,1,3,2,2,2,1,11,12,13,10,16,13,4,11,7,13,15,5,14,15,13,13,12,13,13,13,14,13,13,12,12,10,18,15,11,12,14,8,9,11,10,20,16,10,15,7,16,11,9,11,14,20,14,17,15,6,3,1,1,20,12,10,10,20,DM/M C,421,1,1,1,12,1,1,1,1,1,16,20,10,10,1,1,0,0,0,0,0,0,0,0,0,0,0,0,0,0,0,0,0,0,0,0,0,0,0,0,0,0,0,0,0,0,0,0,0,0,0,0,0,0,0,0,0,0,0,0,0,0,0,0,0,Henning Hauger,£900Th. ,35.0,179.0,Midfielder - Defensive Midfield,right,Without Club,16.0,0.0,2.0,1424.0,23.0,0.0,0.0,1547.0,21.0,2.0,2.0,1763.0,34.0,0.0,1.0,2922.0,33.0,1.0,0.0,2694.0,31.0,0.0,0.0,2343.0,28.0,0.0,1.0,2360.0,31.0,0.0,0.0,2506.0,15.0,0.0,1.0,756.0,Bundesliga,nan,nan,nan,nan,nan,nan,nan,nan
19/6/2011,Hendry Thomas,5397614,376,2/23/1985,26,40,2,7,3,4663,6261,6261,145,132,582655,180,80,DM/M C,2,1,3,1,3,2,3,4,2,1,1,8,9,10,11,11,11,12,9,8,12,12,13,13,12,16,14,14,13,13,13,12,14,7,14,12,12,13,13,13,12,15,11,11,15,15,20,14,15,15,16,10,6,10,14,10,14,12,14,10,10,18,1,1,20,1,1,1,20,DM/M C,311,1,1,1,1,1,1,1,1,1,20,20,1,1,1,1,35184372088832,0,0,0,0,0,0,0,0,0,0,0,0,0,0,0,0,0,0,0,0,0,0,0,0,0,0,0,0,0,0,0,0,0,0,0,0,0,0,0,0,0,0,0,0,0,1,0,0,Hendry Thomas,£1.35m ,35.0,180.0,Midfielder - Defensive Midfield,right,Retired,30.0,0.0,0.0,2404.0,13.0,0.0,0.0,1087.0,28.0,2.0,1.0,2391.0,11.0,0.0,1.0,799.0,14.0,0.0,1.0,1184.0,nan,nan,nan,nan,nan,nan,nan,nan,nan,nan,nan,nan,nan,nan,nan,nan,Premier League,nan,nan,nan,nan,nan,nan,nan,nan
19/6/2011,Hélder Castro,55008289,788,1/24/1986,25,0,0,0,0,1500,4700,4700,105,94,18360,174,71,AM C,1,3,1,2,1,1,2,1,3,1,3,11,12,13,11,14,13,9,13,9,9,13,13,10,14,10,12,10,10,11,12,12,11,14,10,13,10,10,11,12,13,10,9,3,12,12,20,12,11,11,8,10,9,12,9,13,14,12,12,13,13,7,1,1,15,20,10,10,20,AM C,501,1,1,1,20,10,10,1,1,1,1,15,1,1,1,1,0,0,0,0,0,0,0,0,0,0,0,0,0,0,0,0,0,0,0,0,0,0,0,0,0,0,0,0,0,0,0,0,0,0,0,0,0,0,0,0,0,0,0,0,0,0,0,0,0,HÃ©lder Castro,£540Th. ,34.0,174.0,Midfielder - Central Midfield,right,LusitÃ¢nia FC Lourosa,10.0,0.0,1.0,562.0,21.0,2.0,1.0,1161.0,28.0,6.0,4.0,2205.0,32.0,1.0,0.0,2169.0,6.0,0.0,0.0,289.0,4.0,1.0,0.0,185.0,nan,nan,nan,nan,26.0,5.0,0.0,1624.0,3.0,1.0,0.0,274.0,Liga NOS,3.0,1.0,0.0,127.0,nan,nan,nan,nan
19/6/2011,Håvard Nordtveit,53000623,786,6/21/1990,20,1,0,15,1,4850,5849,6450,142,130,5376676,188,72,D/DM/M C,3,2,1,3,1,2,2,1,2,3,1,5,11,9,6,14,7,12,7,19,12,15,5,14,13,11,15,12,14,9,13,15,14,7,13,7,12,17,12,12,9,10,14,12,13,17,20,13,12,11,8,14,9,10,14,14,16,16,15,12,16,7,18,10,17,1,12,1,18,D/DM/M C,331,1,12,1,1,1,1,18,1,12,20,17,1,1,1,10,8796181626880,0,0,0,0,0,0,0,0,0,0,0,0,0,0,0,0,0,0,0,1,0,0,1,0,1,0,1,0,0,0,0,0,0,0,0,0,0,0,0,0,0,0,0,1,0,0,0,0,Havard Nordtveit,£4.95m ,30.0,188.0,Defender - Centre-Back,right,TSG 1899 Hoffenheim,25.0,2.0,1.0,2196.0,36.0,1.0,0.0,2872.0,42.0,2.0,6.0,3563.0,22.0,1.0,2.0,1285.0,30.0,3.0,1.0,1550.0,39.0,4.0,1.0,2996.0,22.0,0.0,1.0,1420.0,23.0,0.0,1.0,1502.0,16.0,1.0,1.0,1011.0,Bundesliga,12.0,0.0,1.0,818.0,nan,nan,nan,nan
19/6/2011,Hassan Yebda,916298,5,5/14/1984,27,11,0,0,0,4500,6750,6900,144,138,1474828,187,77,DM/M C,2,1,3,3,2,3,3,1,1,2,1,10,11,13,10,15,9,15,11,8,11,14,12,12,13,14,14,13,13,13,13,13,13,7,11,12,12,12,15,11,11,15,14,11,15,13,20,16,16,14,6,13,12,12,12,17,9,13,8,13,11,11,8,5,20,5,12,5,20,DM/M C,421,1,1,1,5,5,5,8,1,5,16,20,1,12,1,5,0,0,0,0,0,0,0,0,0,0,0,0,0,0,0,0,0,0,0,0,0,0,0,0,0,0,0,0,0,0,0,0,0,0,0,0,0,0,0,0,0,0,0,0,0,0,0,0,0,Hassan Yebda,£3.15m ,36.0,187.0,Midfielder - Central Midfield,right,Retired,39.0,1.0,1.0,2173.0,13.0,0.0,0.0,923.0,2.0,0.0,0.0,43.0,23.0,1.0,0.0,1082.0,13.0,1.0,2.0,1134.0,nan,nan,nan,nan,21.0,0.0,0.0,1351.0,29.0,3.0,2.0,2326.0,nan,nan,nan,nan,LaLiga,nan,nan,nan,nan,nan,nan,nan,nan
19/6/2011,Hanno Balitsch,876458,771,1/2/1981,30,1,0,20,2,4500,5750,6750,135,135,1058293,181,80,D/DM/M RC,1,2,1,2,1,1,2,1,3,3,3,6,10,10,8,11,9,12,10,11,14,12,12,15,12,18,14,16,14,14,8,14,18,7,16,8,14,17,16,12,12,13,10,11,14,13,20,13,13,14,13,16,6,15,8,16,16,17,16,16,12,8,20,14,18,1,20,12,18,D/DM/M RC,123,1,1,1,1,1,1,10,11,20,20,18,9,12,12,14,0,0,0,0,0,0,0,0,0,0,0,0,0,0,0,0,0,0,0,0,0,0,0,0,0,0,0,0,0,0,0,0,0,0,0,0,0,0,0,0,0,0,0,0,0,0,0,0,0,Hanno Balitsch,£1.80m ,39.0,182.0,Midfielder - Defensive Midfield,right,Retired,33.0,3.0,1.0,1546.0,23.0,1.0,1.0,1499.0,34.0,1.0,2.0,2848.0,23.0,0.0,1.0,1894.0,29.0,1.0,2.0,2532.0,33.0,3.0,3.0,2873.0,nan,nan,nan,nan,nan,nan,nan,nan,nan,nan,nan,nan,Bundesliga,nan,nan,nan,nan,nan,nan,nan,nan
19/6/2011,Hamit Altintop,884384,799,12/8/1982,28,64,6,9,2,6900,8000,7600,151,150,0,183,82,M/AM RC,2,3,3,3,2,3,3,1,3,1,3,12,14,12,7,13,14,8,16,14,12,14,13,12,14,16,13,16,13,15,10,14,17,8,15,12,9,15,16,12,14,14,11,13,10,15,20,15,13,16,6,17,15,18,16,16,15,19,17,15,16,5,14,15,20,17,18,14,20,M/AM RC,413,1,1,1,15,14,17,1,1,14,15,20,14,18,8,15,69826773506,0,1,0,0,0,0,0,0,0,1,0,0,0,0,0,0,0,0,0,0,0,0,0,0,0,1,0,0,0,0,1,0,0,0,0,0,1,0,0,0,0,0,0,0,0,0,0,0,Hamit Altintop,£4.50m ,37.0,183.0,Midfielder - Right Midfield,right,Retired,25.0,2.0,6.0,1317.0,12.0,1.0,0.0,604.0,40.0,1.0,8.0,2977.0,8.0,0.0,1.0,267.0,32.0,2.0,0.0,1889.0,nan,nan,nan,nan,25.0,1.0,0.0,1804.0,18.0,1.0,0.0,1533.0,nan,nan,nan,nan,LaLiga,nan,nan,nan,nan,nan,nan,nan,nan
19/6/2011,Hajime Hosogai,781280,116,6/10/1986,25,6,1,9,1,4650,5750,6000,137,120,111849,176,68,DM/M C,2,2,3,3,3,2,1,1,3,2,1,10,9,12,8,13,10,12,12,4,11,12,10,11,11,11,12,11,10,11,12,11,7,11,8,11,13,14,12,11,12,11,8,18,13,13,20,13,11,10,17,10,11,10,13,12,14,7,13,15,12,14,1,1,20,11,12,1,20,DM/M C,311,1,1,1,11,1,1,1,1,1,20,20,1,12,1,1,0,0,0,0,0,0,0,0,0,0,0,0,0,0,0,0,0,0,0,0,0,0,0,0,0,0,0,0,0,0,0,0,0,0,0,0,0,0,0,0,0,0,0,0,0,0,0,0,0,Hajime Hosogai,£2.70m ,34.0,177.0,Midfielder - Defensive Midfield,right,True Bangkok United,7.0,0.0,0.0,491.0,33.0,3.0,1.0,2829.0,23.0,0.0,0.0,1395.0,34.0,0.0,1.0,2889.0,22.0,0.0,1.0,1637.0,25.0,0.0,1.0,2001.0,32.0,0.0,0.0,1347.0,10.0,0.0,0.0,493.0,16.0,0.0,0.0,1204.0,Bundesliga,10.0,1.0,0.0,734.0,nan,nan,nan,nan
19/6/2011,Guillermo Giacomazzi,115013,1657,11/21/1977,33,17,0,0,0,5500,6000,6200,145,124,348554,183,81,DM/M C,1,1,1,1,1,1,1,1,1,1,1,6,14,14,13,15,10,16,15,8,13,16,11,13,15,12,10,12,13,12,15,12,18,15,18,15,15,18,15,10,10,13,13,5,14,10,20,7,14,10,18,14,8,17,16,12,19,16,18,17,14,5,10,1,20,13,13,10,20,DM/M C,421,1,1,1,13,10,13,10,1,1,17,20,10,13,1,1,17592253153312,0,0,0,0,0,1,0,0,0,0,0,0,0,0,0,0,0,0,0,0,0,0,0,0,0,0,1,0,0,0,0,0,0,0,0,0,0,0,0,0,0,0,0,0,1,0,0,0,Guillermo Giacomazzi,£450Th. ,42.0,185.0,Midfielder - Defensive Midfield,right,Retired,32.0,3.0,6.0,2594.0,34.0,3.0,3.0,2842.0,28.0,6.0,2.0,2253.0,42.0,5.0,3.0,3135.0,28.0,1.0,1.0,2365.0,nan,nan,nan,nan,nan,nan,nan,nan,nan,nan,nan,nan,nan,nan,nan,nan,Serie A,nan,nan,nan,nan,nan,nan,nan,nan
19/6/2011,Guillaume Loriot,8441954,769,5/21/1986,25,0,0,0,0,4300,5400,5400,135,120,167902,188,79,DM/M C,2,3,2,2,2,2,2,4,2,2,3,6,13,12,8,12,6,12,11,8,10,13,11,13,14,12,13,14,13,12,12,12,14,9,12,11,13,14,15,13,12,15,14,20,11,12,5,13,15,13,12,11,14,11,11,12,17,13,15,15,15,6,10,10,20,10,1,12,20,DM/M C,421,1,1,1,10,1,1,1,10,1,16,20,12,1,10,1,0,0,0,0,0,0,0,0,0,0,0,0,0,0,0,0,0,0,0,0,0,0,0,0,0,0,0,0,0,0,0,0,0,0,0,0,0,0,0,0,0,0,0,0,0,0,0,0,0,Guillaume Loriot,£360Th. ,34.0,188.0,Midfielder - Central Midfield,left,Retired,9.0,0.0,1.0,628.0,16.0,0.0,0.0,948.0,31.0,2.0,0.0,2656.0,17.0,3.0,0.0,1449.0,30.0,2.0,1.0,2382.0,11.0,1.0,0.0,815.0,17.0,0.0,0.0,945.0,7.0,0.0,0.0,431.0,nan,nan,nan,nan,Ligue 1,nan,nan,nan,nan,nan,nan,nan,nan
19/6/2011,Guillaume Lacour,917621,769,8/2/1980,30,0,0,0,0,4400,5550,5550,130,123,222550,173,68,DM RC,1,2,1,2,3,2,1,3,3,1,2,11,11,10,6,10,8,6,8,9,9,13,7,12,10,12,13,14,13,13,11,12,14,6,14,6,13,17,15,15,12,12,6,12,14,13,20,17,9,15,12,14,9,17,5,13,15,14,16,17,17,6,15,15,15,10,15,10,15,DM RC,303,1,1,1,1,1,10,10,10,15,20,15,10,14,10,15,0,0,0,0,0,0,0,0,0,0,0,0,0,0,0,0,0,0,0,0,0,0,0,0,0,0,0,0,0,0,0,0,0,0,0,0,0,0,0,0,0,0,0,0,0,0,0,0,0,Guillaume Lacour,£540Th. ,40.0,173.0,Defender - Right-Back,right,Retired,32.0,0.0,3.0,2853.0,4.0,0.0,0.0,259.0,22.0,0.0,0.0,1411.0,30.0,0.0,0.0,2152.0,22.0,0.0,0.0,1716.0,nan,nan,nan,nan,nan,nan,nan,nan,nan,nan,nan,nan,nan,nan,nan,nan,Ligue 1,nan,nan,nan,nan,nan,nan,nan,nan
19/6/2011,Guilherme,55024926,1651,5/21/1991,20,0,0,0,0,2000,2500,4650,150,93,109321,174,70,AM LC,3,2,2,1,3,3,1,5,2,2,1,11,12,12,10,14,13,5,12,7,6,12,12,8,13,12,12,11,7,9,11,11,12,15,12,13,7,8,11,12,12,8,7,20,12,12,6,9,7,12,9,12,9,10,14,15,10,12,11,10,10,18,1,1,15,20,7,15,20,AM LC,504,1,1,1,20,15,7,1,1,1,1,15,8,7,1,1,0,0,0,0,0,0,0,0,0,0,0,0,0,0,0,0,0,0,0,0,0,0,0,0,0,0,0,0,0,0,0,0,0,0,0,0,0,0,0,0,0,0,0,0,0,0,0,0,0,Guilherme,£450Th. ,29.0,174.0,Forward - Right Winger,left,Göztepe,8.0,2.0,0.0,383.0,27.0,1.0,1.0,1067.0,32.0,3.0,7.0,2522.0,2.0,0.0,0.0,164.0,30.0,1.0,2.0,2157.0,55.0,8.0,11.0,3830.0,41.0,7.0,8.0,2955.0,34.0,7.0,4.0,2469.0,35.0,5.0,7.0,2577.0,Liga NOS,44.0,9.0,8.0,2649.0,5.0,2.0,0.0,312.0
19/6/2011,Gueïda Fofana,34011543,769,5/16/1991,20,0,0,0,0,2623,5399,4121,160,120,654545,182,74,DM/M C,3,2,3,3,2,3,1,5,3,1,1,8,9,11,7,11,13,9,13,5,8,13,10,9,14,13,14,13,12,10,12,10,14,11,13,9,11,14,14,16,13,14,11,8,15,13,20,15,14,12,13,15,6,8,7,15,12,14,13,15,15,7,1,1,20,1,12,1,20,DM/M C,421,1,1,1,1,1,1,1,1,1,16,20,1,12,1,1,274877906980,0,0,1,0,0,1,0,0,0,0,0,0,0,0,0,0,0,0,0,0,0,0,0,0,0,0,0,0,0,0,0,0,0,0,0,0,0,0,1,0,0,0,0,0,0,0,0,0,Gueïda Fofana,£3.15m ,29.0,182.0,Midfielder - Defensive Midfield,right,Retired,36.0,3.0,3.0,2593.0,25.0,0.0,0.0,1502.0,38.0,5.0,6.0,2658.0,39.0,4.0,1.0,3145.0,2.0,0.0,0.0,41.0,0.0,0.0,0.0,0.0,nan,nan,nan,nan,nan,nan,nan,nan,nan,nan,nan,nan,Ligue 1,nan,nan,nan,nan,nan,nan,nan,nan
19/6/2011,Grégory Sertic,8443655,769,8/5/1989,21,0,0,5,0,4350,5500,5500,145,122,486113,181,69,M/AM LC,3,1,2,1,2,3,2,1,1,1,2,13,12,13,7,14,14,10,13,5,5,13,12,7,14,7,11,12,13,12,14,11,15,11,8,11,8,12,13,14,14,14,10,12,14,11,20,13,11,12,7,14,6,15,19,14,13,11,14,13,13,6,8,1,20,18,12,16,20,M/AM LC,414,1,1,1,18,14,12,8,1,1,10,20,16,12,1,1,4194336,0,0,0,0,0,1,0,0,0,0,0,0,0,0,0,0,0,0,0,0,0,0,1,0,0,0,0,0,0,0,0,0,0,0,0,0,0,0,0,0,0,0,0,0,0,0,0,0,Grégory Sertic,£1.13m ,31.0,183.0,Midfielder - Defensive Midfield,right,Without Club,24.0,0.0,2.0,1099.0,22.0,0.0,1.0,1008.0,44.0,1.0,5.0,3112.0,37.0,3.0,11.0,3061.0,30.0,1.0,1.0,2341.0,3.0,0.0,0.0,141.0,28.0,1.0,1.0,2319.0,13.0,0.0,0.0,716.0,17.0,0.0,0.0,1103.0,Ligue 1,nan,nan,nan,nan,nan,nan,nan,nan
19/6/2011,Grégory Proment,3503892,769,12/10/1978,32,0,0,0,0,4500,5650,5650,145,126,211483,176,69,DM/M C,3,3,1,2,2,1,1,3,2,3,2,14,13,9,6,12,15,11,12,8,9,13,17,13,12,10,14,14,14,12,13,12,13,7,17,7,13,16,16,11,12,14,9,12,14,11,20,13,13,14,10,14,9,10,5,12,15,13,15,15,15,6,13,1,18,10,1,1,18,DM/M C,311,1,10,1,10,1,1,13,1,1,20,18,1,1,1,1,0,0,0,0,0,0,0,0,0,0,0,0,0,0,0,0,0,0,0,0,0,0,0,0,0,0,0,0,0,0,0,0,0,0,0,0,0,0,0,0,0,0,0,0,0,0,0,0,0,Grégory Proment,£720Th. ,41.0,176.0,Midfielder - Defensive Midfield,right,Retired,17.0,0.0,0.0,1158.0,37.0,2.0,1.0,2498.0,36.0,2.0,0.0,2827.0,nan,nan,nan,nan,nan,nan,nan,nan,nan,nan,nan,nan,nan,nan,nan,nan,nan,nan,nan,nan,nan,nan,nan,nan,Ligue 1,nan,nan,nan,nan,nan,nan,nan,nan
19/6/2011,Graham Dorrans,5207960,793,5/5/1987,24,5,0,6,0,5000,7000,6601,148,137,1059623,181,73,M/AM RLC,3,3,1,2,3,2,3,5,2,1,3,11,12,14,12,13,13,9,13,6,10,14,11,9,14,9,12,11,13,12,14,15,16,13,12,15,12,14,15,14,13,13,8,12,14,14,20,14,10,13,8,10,5,14,17,13,14,13,15,11,13,3,1,2,20,20,15,15,20,M/AM RLC,416,1,1,10,20,15,15,1,1,1,14,20,15,15,1,2,2260595911426048,0,0,0,0,0,0,0,0,0,0,0,0,0,0,0,0,0,0,0,1,0,0,1,0,0,0,0,0,0,0,0,0,0,0,0,0,0,0,0,0,0,0,0,1,0,0,0,0,Graham Dorrans,£2.25m ,33.0,177.0,Midfielder - Central Midfield,right,Dundee FC,25.0,1.0,3.0,1778.0,37.0,4.0,3.0,2061.0,28.0,1.0,3.0,1940.0,17.0,2.0,0.0,1405.0,40.0,4.0,4.0,2794.0,27.0,0.0,3.0,1726.0,24.0,6.0,1.0,1925.0,20.0,5.0,4.0,1628.0,3.0,0.0,0.0,88.0,Premier League,23.0,1.0,5.0,2007.0,3.0,1.0,1.0,270.0
19/6/2011,Gonzalo Colsa,4200440,796,4/2/1979,32,0,0,0,0,4750,6700,6700,143,134,863549,185,77,DM/M C,2,2,1,3,2,1,1,5,3,3,1,12,12,6,12,13,12,18,15,12,12,14,11,14,13,13,13,17,11,16,14,13,15,11,17,12,14,18,19,7,10,15,13,11,17,7,20,16,15,14,10,17,8,6,13,15,15,15,18,14,11,11,1,1,20,7,1,1,20,DM/M C,421,1,1,1,7,1,1,1,1,1,16,20,1,1,1,1,71303232,0,0,0,0,0,0,1,0,0,0,0,0,0,0,0,0,0,0,0,0,0,0,1,0,0,0,1,0,0,0,0,0,0,0,0,0,0,0,0,0,0,0,0,0,0,0,0,0,Gonzalo Colsa,£1.80m ,41.0,185.0,Midfielder - Defensive Midfield,right,Retired,33.0,2.0,1.0,2873.0,19.0,1.0,0.0,1293.0,5.0,0.0,0.0,145.0,nan,nan,nan,nan,nan,nan,nan,nan,nan,nan,nan,nan,nan,nan,nan,nan,nan,nan,nan,nan,nan,nan,nan,nan,LaLiga,nan,nan,nan,nan,nan,nan,nan,nan
19/6/2011,Gonzalo Castro,8723487,771,6/11/1987,24,5,0,21,3,5500,6850,6850,160,142,3194925,171,74,D/WB/DM/M/AM RLC,1,1,2,2,3,3,2,4,3,2,2,13,13,14,8,14,13,8,11,11,12,15,12,11,14,12,13,12,11,11,13,11,12,13,7,12,9,13,13,15,16,13,6,15,12,13,20,12,10,8,8,12,4,19,10,11,17,11,12,12,14,4,20,16,20,16,20,16,20,D/WB/DM/M/AM RLC,146,1,1,1,10,16,10,1,16,20,16,20,16,12,12,16,1048584,0,0,0,1,0,0,0,0,0,0,0,0,0,0,0,0,0,0,0,0,1,0,0,0,0,0,0,0,0,0,0,0,0,0,0,0,0,0,0,0,0,0,0,0,0,0,0,0,Gonzalo Castro,£8.10m ,33.0,172.0,Midfielder - Central Midfield,right,VfB Stuttgart,32.0,6.0,9.0,2262.0,40.0,2.0,8.0,3474.0,40.0,8.0,9.0,3140.0,39.0,5.0,12.0,3176.0,32.0,2.0,11.0,2772.0,41.0,7.0,11.0,2679.0,42.0,4.0,8.0,2885.0,28.0,1.0,3.0,1840.0,28.0,2.0,4.0,1892.0,Bundesliga,31.0,3.0,7.0,2321.0,6.0,1.0,1.0,466.0
19/6/2011,Gonzalo Castellani,964854,1649,8/10/1987,23,0,0,0,0,2000,5250,5000,145,118,105237,183,75,M C,1,3,2,1,3,2,2,5,3,1,1,14,10,13,11,14,13,9,12,4,8,14,15,8,13,12,8,11,12,11,14,14,13,13,13,11,8,12,10,11,10,12,11,12,16,11,20,10,12,13,8,12,4,9,11,12,15,14,15,15,16,11,1,1,20,15,1,1,20,M C,401,1,1,1,15,1,1,1,1,1,1,20,1,1,1,1,0,0,0,0,0,0,0,0,0,0,0,0,0,0,0,0,0,0,0,0,0,0,0,0,0,0,0,0,0,0,0,0,0,0,0,0,0,0,0,0,0,0,0,0,0,0,0,0,0,Gonzalo Castellani,£720Th. ,33.0,183.0,Midfielder - Attacking Midfield,right,Unión La Calera,18.0,0.0,0.0,927.0,22.0,0.0,1.0,1139.0,29.0,2.0,0.0,2064.0,39.0,4.0,3.0,3029.0,23.0,0.0,4.0,1248.0,7.0,0.0,0.0,315.0,27.0,1.0,3.0,1385.0,50.0,4.0,5.0,3596.0,17.0,0.0,0.0,981.0,LaLiga,26.0,1.0,2.0,1655.0,nan,nan,nan,nan
19/6/2011,Gökhan Inler,43012402,798,6/27/1984,26,48,4,0,0,6550,7700,7800,159,157,4054265,182,77,DM/M C,2,2,2,2,1,3,2,6,2,3,1,5,9,10,14,13,8,13,17,3,14,15,15,15,14,15,13,15,15,14,13,13,16,9,17,6,16,17,14,12,12,16,13,18,19,13,20,14,15,15,13,15,2,8,17,15,18,16,18,20,17,4,1,1,20,1,10,10,20,DM/M C,421,1,1,1,1,1,1,1,1,1,19,20,10,10,1,1,83886592,0,0,0,0,0,0,0,0,0,1,0,0,0,0,0,0,0,0,0,0,0,0,0,0,1,0,1,0,0,0,0,0,0,0,0,0,0,0,0,0,0,0,0,0,0,0,0,0,Gökhan Inler,£14.40m ,36.0,183.0,Midfielder - Defensive Midfield,both,Adana Demirspor,36.0,3.0,5.0,3095.0,49.0,2.0,5.0,3647.0,39.0,6.0,2.0,2624.0,45.0,4.0,3.0,3729.0,33.0,1.0,0.0,2562.0,12.0,0.0,0.0,885.0,32.0,0.0,2.0,1601.0,35.0,1.0,1.0,1934.0,17.0,0.0,2.0,1069.0,Serie A,12.0,0.0,1.0,449.0,4.0,0.0,0.0,269.0
19/6/2011,Gojko Kacar,5779401,802,1/26/1987,24,22,0,15,8,6250,6808,6628,157,142,8304880,183,77,D/DM/M C,3,2,3,1,2,2,3,1,1,2,3,7,10,14,15,10,9,17,13,12,17,10,9,17,14,18,14,18,12,8,14,16,18,10,13,17,9,12,19,10,13,17,15,11,6,15,20,10,13,11,9,15,12,20,16,17,8,12,9,10,7,6,16,11,20,12,14,1,20,D/DM/M C,431,1,1,10,12,1,1,16,1,10,19,20,1,14,1,11,8933531976228,0,0,1,0,0,1,0,0,0,1,0,0,0,0,0,0,0,0,0,0,0,0,0,0,0,0,0,0,0,0,0,0,0,0,0,0,0,1,0,0,0,0,0,1,0,0,0,0,Gojko Kacar,£3.60m ,33.0,185.0,Midfielder - Defensive Midfield,right,Without Club,23.0,2.0,1.0,1592.0,23.0,1.0,1.0,1319.0,7.0,0.0,0.0,356.0,26.0,3.0,1.0,2114.0,15.0,3.0,0.0,829.0,19.0,1.0,0.0,1117.0,23.0,0.0,1.0,1184.0,6.0,1.0,0.0,225.0,6.0,0.0,0.0,275.0,Bundesliga,nan,nan,nan,nan,nan,nan,nan,nan
19/6/2011,Glenn Whelan,5108095,789,1/13/1984,27,29,2,14,2,4600,6750,6700,140,132,971693,181,79,M C,2,2,1,2,2,2,2,4,3,3,3,13,9,10,10,12,14,10,15,5,14,14,12,14,14,14,13,14,12,13,13,13,14,12,13,12,14,15,16,11,13,13,9,11,15,11,20,14,13,11,12,15,5,13,13,15,14,14,14,8,11,7,1,1,20,10,12,1,20,M C,401,1,1,1,10,1,1,1,1,1,10,20,1,12,1,1,17592190763072,0,0,0,0,0,0,1,0,0,0,0,0,0,0,0,0,0,0,0,1,0,0,1,0,0,0,0,0,0,0,0,0,0,0,0,0,0,0,0,0,0,0,0,0,1,0,0,0,Glenn Whelan,£3.60m ,36.0,180.0,Midfielder - Defensive Midfield,right,Fleetwood Town,39.0,0.0,3.0,2256.0,43.0,2.0,3.0,3441.0,34.0,0.0,4.0,2764.0,36.0,0.0,1.0,2721.0,30.0,0.0,0.0,2444.0,42.0,0.0,2.0,3529.0,31.0,0.0,1.0,2368.0,35.0,1.0,1.0,2555.0,38.0,1.0,3.0,2301.0,Premier League,30.0,0.0,0.0,2561.0,11.0,0.0,0.0,971.0
19/6/2011,Giuseppe Colucci,704213,776,8/24/1980,30,0,0,5,0,4250,6350,6350,127,127,477035,180,73,M/AM RC,1,1,1,1,1,1,1,1,1,1,1,16,13,12,9,14,13,8,10,7,7,15,13,12,13,13,14,11,13,10,14,12,13,13,16,14,10,13,11,12,11,7,9,14,14,13,20,11,9,10,12,13,14,15,12,14,10,8,14,17,12,12,1,1,19,20,15,10,20,M/AM RC,523,1,1,1,20,10,15,1,1,1,15,19,10,15,1,1,70368745226496,0,0,0,0,0,0,0,0,1,0,0,0,0,0,0,0,0,0,0,0,1,0,0,0,0,0,0,0,0,0,0,0,0,0,0,0,0,0,0,0,0,0,0,0,0,0,1,0,Giuseppe Colucci,£450Th. ,40.0,180.0,Midfielder - Central Midfield,right,Retired,33.0,1.0,0.0,2757.0,24.0,0.0,1.0,1555.0,30.0,1.0,2.0,2229.0,10.0,0.0,0.0,679.0,nan,nan,nan,nan,nan,nan,nan,nan,nan,nan,nan,nan,nan,nan,nan,nan,nan,nan,nan,nan,Serie A,nan,nan,nan,nan,nan,nan,nan,nan
19/6/2011,Giulio Migliaccio,6100010,776,6/23/1981,29,0,0,0,0,5000,7200,7200,158,145,1416985,171,72,DM/M C,1,2,2,1,1,1,1,5,3,3,2,8,9,7,6,11,9,18,10,9,17,14,5,17,13,13,16,16,15,15,11,15,19,9,18,14,15,18,18,10,14,16,8,10,14,12,20,17,17,18,12,18,3,15,14,14,15,16,18,13,17,2,13,1,18,1,1,1,18,DM/M C,311,1,1,1,1,1,1,13,1,1,20,18,1,1,1,1,0,0,0,0,0,0,0,0,0,0,0,0,0,0,0,0,0,0,0,0,0,0,0,0,0,0,0,0,0,0,0,0,0,0,0,0,0,0,0,0,0,0,0,0,0,0,0,0,0,Giulio Migliaccio,£3.60m ,39.0,180.0,Midfielder - Central Midfield,right,Retired,45.0,4.0,3.0,3925.0,33.0,2.0,2.0,2842.0,28.0,1.0,0.0,1223.0,21.0,1.0,1.0,1393.0,22.0,1.0,0.0,1335.0,19.0,0.0,0.0,536.0,4.0,0.0,0.0,26.0,nan,nan,nan,nan,nan,nan,nan,nan,Serie A,nan,nan,nan,nan,nan,nan,nan,nan
19/6/2011,Gianni Munari,837974,776,6/24/1983,27,0,0,0,0,3750,6400,6400,130,128,452895,190,84,M RC,3,3,1,1,2,2,1,5,1,3,1,10,14,14,13,13,9,16,16,10,10,15,12,13,13,15,13,14,14,13,13,11,16,10,11,15,8,14,12,11,10,12,16,8,15,13,20,11,15,12,9,14,13,13,11,13,15,13,16,13,14,7,1,1,20,1,18,1,20,M RC,403,1,1,1,1,1,1,1,1,1,14,20,1,18,1,1,1099511628288,0,0,0,0,0,0,0,0,0,1,0,0,0,0,0,0,0,0,0,0,0,0,0,0,0,0,0,0,0,0,0,0,0,0,0,0,0,0,0,0,1,0,0,0,0,0,0,0,Gianni Munari,£1.26m ,37.0,190.0,Midfielder - Central Midfield,right,Retired,35.0,2.0,7.0,2664.0,33.0,1.0,4.0,2279.0,28.0,3.0,0.0,1557.0,13.0,1.0,0.0,338.0,31.0,3.0,4.0,2116.0,22.0,2.0,1.0,1509.0,30.0,3.0,2.0,1914.0,28.0,1.0,1.0,2114.0,6.0,0.0,0.0,249.0,Serie A,nan,nan,nan,nan,nan,nan,nan,nan
19/6/2011,Giampiero Pinzi,3801517,776,3/11/1981,30,1,0,27,3,4750,6750,6850,140,137,1247333,180,73,M C,3,3,1,1,1,1,2,3,1,2,1,10,10,11,8,12,6,6,13,10,14,13,10,15,11,17,15,17,13,15,12,14,18,6,14,13,15,16,15,13,13,14,10,10,11,12,20,16,12,16,15,12,10,15,17,9,9,16,14,6,10,13,1,10,20,15,14,1,20,M C,401,1,1,1,15,1,1,1,1,1,14,20,1,14,1,10,32768,0,0,0,0,0,0,0,0,0,0,0,0,0,0,0,1,0,0,0,0,0,0,0,0,0,0,0,0,0,0,0,0,0,0,0,0,0,0,0,0,0,0,0,0,0,0,0,0,Giampiero Pinzi,£3.15m ,39.0,180.0,Midfielder - Central Midfield,right,Retired,35.0,1.0,4.0,2787.0,36.0,2.0,3.0,2772.0,25.0,3.0,3.0,1783.0,30.0,1.0,1.0,2140.0,21.0,1.0,1.0,1439.0,18.0,0.0,0.0,988.0,31.0,1.0,0.0,2518.0,29.0,0.0,3.0,2170.0,6.0,0.0,0.0,323.0,Serie A,nan,nan,nan,nan,nan,nan,nan,nan
19/6/2011,Giacomo Bonaventura,43006720,776,5/13/1989,22,0,0,0,0,3766,6414,6400,157,129,506351,181,75,M/AM RLC,3,1,2,2,2,3,2,3,1,3,3,11,13,14,11,14,11,9,12,7,7,14,11,10,15,9,9,12,12,12,13,12,17,14,11,13,11,12,11,15,14,8,9,10,13,14,20,13,9,15,7,15,4,15,12,16,12,12,14,12,9,12,1,1,20,19,19,19,20,M/AM RLC,416,1,1,1,19,17,16,1,1,1,12,20,19,19,1,1,144,0,0,0,0,1,0,0,1,0,0,0,0,0,0,0,0,0,0,0,0,0,0,0,0,0,0,0,0,0,0,0,0,0,0,0,0,0,0,0,0,0,0,0,0,0,0,0,0,Giacomo Bonaventura,£2.70m ,31.0,180.0,Midfielder - Central Midfield,right,ACF Fiorentina,33.0,9.0,5.0,1952.0,30.0,2.0,1.0,1835.0,36.0,8.0,4.0,2702.0,31.0,5.0,4.0,2520.0,36.0,7.0,5.0,2843.0,39.0,7.0,11.0,3310.0,22.0,5.0,5.0,1874.0,47.0,9.0,4.0,3557.0,10.0,3.0,0.0,797.0,Serie A,32.0,4.0,6.0,1530.0,5.0,0.0,1.0,388.0
19/6/2011,Georges Mandjeck,35015134,11,12/9/1988,22,7,0,2,1,3250,6750,6350,140,127,577965,183,72,DM C,1,3,2,1,3,3,3,3,2,3,1,5,7,12,9,13,11,15,11,5,15,14,10,15,14,12,13,13,12,11,11,12,13,12,11,8,13,12,13,12,13,12,13,8,13,14,20,13,13,13,10,11,5,11,13,12,10,12,13,11,9,5,14,12,15,1,12,1,15,DM C,301,1,1,1,1,1,1,14,1,12,20,15,1,1,1,12,0,0,0,0,0,0,0,0,0,0,0,0,0,0,0,0,0,0,0,0,0,0,0,0,0,0,0,0,0,0,0,0,0,0,0,0,0,0,0,0,0,0,0,0,0,0,0,0,0,Georges Mandjeck,£1.58m ,31.0,185.0,Midfielder - Defensive Midfield,right,Waasland-Beveren,24.0,0.0,0.0,940.0,32.0,1.0,0.0,2629.0,31.0,1.0,0.0,2419.0,25.0,1.0,2.0,1771.0,12.0,0.0,0.0,633.0,27.0,0.0,1.0,2049.0,30.0,3.0,0.0,2459.0,27.0,0.0,0.0,1878.0,32.0,5.0,1.0,2545.0,Ligue 1,18.0,0.0,0.0,1049.0,1.0,0.0,0.0,73.0
19/6/2011,Geoffrey Dernis,3502471,769,12/24/1980,30,0,0,0,0,4600,5750,5750,135,128,157683,171,66,M/AM LC,2,1,1,3,1,3,3,1,1,3,1,14,14,12,7,13,14,6,15,8,5,14,11,6,13,9,12,13,12,12,14,11,14,11,12,11,9,12,13,14,15,11,5,20,12,13,12,15,9,14,9,14,10,8,12,13,14,13,15,15,15,9,1,1,17,20,13,17,20,M/AM LC,524,1,1,1,20,17,13,1,1,1,1,15,17,13,1,1,256,0,0,0,0,0,0,0,0,1,0,0,0,0,0,0,0,0,0,0,0,0,0,0,0,0,0,0,0,0,0,0,0,0,0,0,0,0,0,0,0,0,0,0,0,0,0,0,0,Geoffrey Dernis,£1.13m ,39.0,171.0,Forward - Left Winger,left,Retired,30.0,1.0,1.0,1437.0,23.0,5.0,2.0,1234.0,25.0,2.0,1.0,952.0,21.0,1.0,3.0,1110.0,2.0,0.0,0.0,118.0,nan,nan,nan,nan,nan,nan,nan,nan,nan,nan,nan,nan,nan,nan,nan,nan,Ligue 1,nan,nan,nan,nan,nan,nan,nan,nan
19/6/2011,Gennaro Gattuso,3801681,776,1/9/1978,33,73,1,21,1,7100,7100,7250,173,147,364786,177,77,DM/M C,2,3,3,2,1,1,3,9,3,1,3,4,11,9,8,9,3,12,11,9,17,12,5,18,12,19,16,20,15,17,12,14,19,4,19,12,17,20,19,12,13,16,8,12,16,12,20,14,16,14,15,12,13,14,17,13,20,19,18,7,5,15,1,1,20,1,13,8,20,DM/M C,421,1,1,1,1,1,1,1,1,1,16,20,8,13,1,1,2336462438400,0,0,0,0,0,0,0,0,0,0,0,0,0,0,0,1,1,1,0,0,0,0,0,0,0,0,0,0,0,0,0,0,0,0,0,0,0,1,0,0,0,1,0,0,0,0,0,0,Gennaro Gattuso,£900Th. ,42.0,177.0,Midfielder - Central Midfield,right,Retired,38.0,2.0,3.0,2668.0,7.0,0.0,0.0,334.0,32.0,1.0,1.0,2412.0,nan,nan,nan,nan,nan,nan,nan,nan,nan,nan,nan,nan,nan,nan,nan,nan,nan,nan,nan,nan,nan,nan,nan,nan,Serie A,nan,nan,nan,nan,nan,nan,nan,nan
19/6/2011,Gennaro Delvecchio,3802380,776,3/25/1978,33,1,0,0,0,4496,5745,5745,140,116,80143,191,84,M C,2,2,2,1,2,1,1,3,2,1,2,4,8,9,11,10,4,18,9,8,12,11,8,17,11,19,14,16,8,13,12,10,16,6,18,11,13,17,15,11,10,15,17,8,11,11,20,16,18,15,16,14,5,8,2,15,13,13,16,12,9,10,1,1,20,8,12,8,20,M C,401,1,1,5,8,5,5,1,1,1,13,20,8,12,1,1,824633721112,0,0,0,1,1,0,0,0,1,0,0,0,0,0,0,0,0,0,0,0,0,0,0,0,0,0,0,0,0,0,0,0,0,0,0,0,0,0,1,1,0,0,0,0,0,0,0,0,Gennaro Delvecchio,£270Th. ,42.0,191.0,Midfielder - Central Midfield,right,Retired,25.0,2.0,3.0,1103.0,29.0,1.0,1.0,1991.0,26.0,5.0,0.0,2235.0,22.0,2.0,2.0,1380.0,nan,nan,nan,nan,nan,nan,nan,nan,nan,nan,nan,nan,nan,nan,nan,nan,nan,nan,nan,nan,Serie A,nan,nan,nan,nan,nan,nan,nan,nan
19/6/2011,Gary Medel,75000560,1652,8/3/1987,23,31,3,0,0,5800,7250,7000,160,144,1441490,172,71,D/WB/DM/M RC,2,3,1,2,2,2,3,5,3,1,1,8,10,9,13,10,6,15,13,13,16,12,4,17,11,17,16,19,6,14,11,12,14,12,13,10,15,14,19,13,14,14,8,9,17,13,20,18,11,14,12,16,4,18,13,15,16,12,12,9,7,14,17,16,17,1,17,1,17,D/WB/DM/M RC,343,1,1,1,1,1,1,17,1,16,20,16,1,17,1,16,33088,0,0,0,0,0,0,1,0,1,0,0,0,0,0,0,1,0,0,0,0,0,0,0,0,0,0,0,0,0,0,0,0,0,0,0,0,0,0,0,0,0,0,0,0,0,0,0,0,Gary Medel,£5.40m ,33.0,171.0,Midfielder - Defensive Midfield,right,Bologna FC 1909,35.0,0.0,0.0,2866.0,37.0,2.0,0.0,3071.0,39.0,7.0,3.0,3226.0,35.0,0.0,1.0,2918.0,44.0,0.0,3.0,3739.0,34.0,1.0,3.0,2790.0,31.0,0.0,0.0,2576.0,40.0,1.0,2.0,3043.0,35.0,0.0,0.0,2826.0,LaLiga,26.0,0.0,0.0,2015.0,2.0,0.0,1.0,45.0
19/6/2011,Gareth Barry,108586,765,2/23/1981,30,46,2,27,2,6503,7603,7253,155,147,1468193,183,79,DM/M LC,1,3,3,1,2,1,2,1,1,2,2,14,15,9,12,14,11,13,10,9,14,15,16,15,12,12,16,14,16,16,15,16,15,8,13,12,15,15,15,12,10,14,11,20,15,10,12,15,14,14,6,15,2,15,6,12,13,13,15,12,14,2,14,1,20,10,1,16,20,DM/M LC,424,1,1,1,1,10,1,10,14,1,18,20,16,1,1,1,4194304,0,0,0,0,0,0,0,0,0,0,0,0,0,0,0,0,0,0,0,0,0,0,1,0,0,0,0,0,0,0,0,0,0,0,0,0,0,0,0,0,0,0,0,0,0,0,0,0,Gareth Barry,£9.00m ,39.0,184.0,Midfielder - Defensive Midfield,left,Retired,47.0,2.0,3.0,3668.0,44.0,1.0,3.0,3459.0,43.0,2.0,5.0,3432.0,37.0,3.0,4.0,3223.0,44.0,0.0,3.0,3824.0,39.0,0.0,4.0,3327.0,34.0,2.0,1.0,2200.0,30.0,1.0,1.0,2234.0,27.0,1.0,1.0,1586.0,Premier League,6.0,0.0,0.0,326.0,nan,nan,nan,nan
19/6/2011,Gaetano D'Agostino,3801597,776,6/3/1982,29,5,0,17,4,5250,6500,6800,150,136,580634,182,81,DM/M C,1,3,2,1,3,1,2,6,3,2,1,13,13,14,12,15,17,9,12,4,8,17,15,12,15,11,12,14,13,13,17,15,13,15,15,9,14,17,13,12,12,13,10,20,13,11,7,14,12,13,11,14,8,12,14,16,12,13,15,11,11,11,1,1,20,15,1,1,20,DM/M C,421,1,1,1,15,1,1,1,1,1,18,20,1,1,1,1,149533586096256,0,0,0,0,0,0,0,1,0,0,0,0,0,0,0,0,0,0,0,1,0,0,1,0,0,0,0,0,0,0,0,0,0,0,0,0,0,0,0,0,0,0,0,1,0,0,0,1,Gaetano D'Agostino,£2.70m ,38.0,180.0,Midfielder - Central Midfield,left,Retired,22.0,5.0,2.0,1397.0,26.0,4.0,1.0,1817.0,18.0,4.0,2.0,1247.0,17.0,5.0,2.0,844.0,19.0,1.0,1.0,1508.0,22.0,1.0,1.0,1611.0,nan,nan,nan,nan,nan,nan,nan,nan,nan,nan,nan,nan,Serie A,nan,nan,nan,nan,nan,nan,nan,nan
19/6/2011,Gaël Danic,910894,769,11/19/1981,29,0,0,1,0,4750,5986,5959,140,133,609175,176,65,M/AM LC,2,1,3,1,3,3,2,3,1,1,1,16,16,14,9,15,14,7,15,7,3,13,13,5,15,8,12,8,11,12,14,13,9,12,7,13,8,13,12,16,14,12,8,20,13,13,10,14,7,12,8,15,7,6,14,14,12,8,10,14,11,11,1,1,18,20,10,20,17,M/AM LC,524,1,1,1,17,20,10,1,1,1,1,15,18,10,1,1,17179869185,1,0,0,0,0,0,0,0,0,0,0,0,0,0,0,0,0,0,0,0,0,0,0,0,0,0,0,0,0,0,0,0,0,0,1,0,0,0,0,0,0,0,0,0,0,0,0,0,Gaël Danic,£2.70m ,38.0,176.0,Forward - Left Winger,left,US Saint-Malo,40.0,9.0,8.0,2983.0,39.0,8.0,4.0,3204.0,32.0,6.0,11.0,2592.0,20.0,0.0,0.0,606.0,19.0,1.0,4.0,1265.0,40.0,6.0,4.0,2960.0,31.0,4.0,3.0,2042.0,27.0,3.0,1.0,1678.0,33.0,7.0,4.0,2461.0,Ligue 1,nan,nan,nan,nan,7.0,0.0,1.0,326.0
19/6/2011,Gaby Mudingayi,6601385,757,10/1/1981,29,15,0,6,0,4000,6209,6900,141,138,1492144,180,80,DM/M C,1,1,1,1,1,1,1,1,1,1,1,6,12,12,5,10,6,15,7,11,17,11,5,19,10,18,13,16,12,15,10,11,17,8,13,10,16,19,18,14,14,17,13,7,15,16,20,17,18,8,16,13,14,14,12,14,13,12,14,14,9,11,1,4,20,1,13,11,20,DM/M C,421,1,1,1,1,1,1,1,1,1,17,20,11,13,4,4,4299194688,0,0,0,0,0,0,1,0,1,0,0,0,0,0,0,1,0,0,0,0,0,0,1,0,0,0,0,0,0,0,0,0,1,0,0,0,0,0,0,0,0,0,0,0,0,0,0,0,Gaby Mudingayi,£3.15m ,39.0,180.0,Midfielder - Defensive Midfield,right,Retired,32.0,1.0,1.0,2684.0,36.0,0.0,0.0,3126.0,14.0,0.0,0.0,550.0,5.0,0.0,0.0,293.0,9.0,0.0,1.0,728.0,nan,nan,nan,nan,2.0,0.0,0.0,54.0,nan,nan,nan,nan,nan,nan,nan,nan,Serie A,nan,nan,nan,nan,nan,nan,nan,nan
19/6/2011,Gabriel Peñalba,963205,1649,9/23/1984,26,0,0,0,0,4000,5534,5534,136,123,336873,193,85,M C,2,2,1,2,3,2,3,5,2,2,3,10,13,14,8,16,11,14,13,12,10,14,14,7,16,8,12,11,12,12,15,14,14,15,6,12,9,12,10,10,12,16,16,12,10,9,20,12,16,12,8,13,12,12,8,12,15,14,13,13,16,8,1,1,20,14,12,1,20,M C,401,1,1,8,14,1,12,1,1,1,1,20,1,12,1,1,8830452760704,0,0,0,0,0,0,0,1,0,0,0,0,0,0,0,0,0,0,0,0,0,0,0,0,0,0,0,0,0,0,0,0,0,0,0,1,0,0,0,0,0,0,0,1,0,0,0,0,Gabriel Peñalba,£585Th. ,36.0,194.0,Midfielder - Central Midfield,right,Retired,11.0,0.0,1.0,534.0,10.0,0.0,0.0,237.0,29.0,4.0,2.0,2170.0,29.0,0.0,1.0,1588.0,36.0,2.0,2.0,2769.0,36.0,4.0,2.0,2918.0,37.0,6.0,3.0,2900.0,26.0,0.0,2.0,2004.0,13.0,0.0,0.0,848.0,Ligue 1,15.0,0.0,0.0,913.0,nan,nan,nan,nan
19/6/2011,Gabi,7442709,796,7/10/1983,27,0,0,13,0,4909,6956,6956,146,142,21293007,179,73,M C,2,2,3,3,2,2,3,2,1,3,2,15,14,13,10,13,14,10,16,8,9,15,16,12,14,16,14,13,12,15,13,15,12,12,16,12,11,16,15,13,12,13,9,13,14,12,20,15,10,17,13,15,7,12,12,12,13,9,15,14,14,7,1,1,20,11,12,10,20,M C,401,1,1,1,11,1,1,1,1,1,13,20,10,12,1,1,137438953984,0,0,0,0,0,0,0,0,0,1,0,0,0,0,0,0,0,0,0,0,0,0,0,0,0,0,0,0,0,0,0,0,0,0,0,0,0,1,0,0,0,0,0,0,0,0,0,0,Gabi,£4.50m ,37.0,181.0,Midfielder - Defensive Midfield,right,Retired,38.0,12.0,5.0,3408.0,49.0,3.0,8.0,4099.0,46.0,0.0,5.0,3818.0,57.0,3.0,11.0,4857.0,48.0,1.0,7.0,3697.0,52.0,1.0,8.0,4250.0,50.0,0.0,2.0,4209.0,54.0,1.0,2.0,3864.0,32.0,0.0,0.0,2843.0,LaLiga,19.0,0.0,1.0,1688.0,nan,nan,nan,nan
19/6/2011,Fredy Guarín,5262184,1653,6/30/1986,24,25,0,32,6,5500,7250,6900,150,138,1135339,183,77,M C,1,1,1,3,3,3,1,6,3,2,2,14,12,13,13,16,17,13,18,14,11,17,16,12,16,12,12,12,14,12,13,12,15,11,11,12,11,13,12,11,12,16,13,10,14,11,20,16,17,13,12,13,12,10,12,14,12,11,13,13,15,7,5,1,20,10,10,5,20,M C,401,1,5,1,10,1,5,5,1,1,14,20,5,10,1,1,768,0,0,0,0,0,0,0,0,1,1,0,0,0,0,0,0,0,0,0,0,0,0,0,0,0,0,0,0,0,0,0,0,0,0,0,0,0,0,0,0,0,0,0,0,0,0,0,0,Fredy Guarín,£10.80m ,34.0,183.0,Midfielder - Central Midfield,right,Without Club,44.0,10.0,8.0,2587.0,17.0,1.0,4.0,1071.0,47.0,10.0,12.0,3520.0,35.0,4.0,13.0,2448.0,37.0,7.0,9.0,2898.0,46.0,6.0,7.0,3495.0,23.0,12.0,5.0,1883.0,31.0,9.0,7.0,2754.0,28.0,5.0,4.0,2193.0,Serie A,1.0,0.0,0.0,44.0,nan,nan,nan,nan
19/6/2011,Frank Lampard,2004697,765,6/20/1978,32,86,22,19,8,8200,8250,8500,180,165,36363636,184,88,M/AM C,1,1,3,2,1,3,2,5,2,1,1,10,10,12,17,17,14,11,15,7,10,16,19,11,15,13,16,14,18,17,16,18,18,8,18,16,12,17,17,10,14,14,12,15,20,10,20,15,12,18,9,19,2,14,14,17,17,15,20,15,16,5,1,1,20,16,6,6,20,M/AM C,411,1,1,1,16,1,1,1,1,1,12,20,6,6,1,1,193516193972488,0,0,0,1,0,0,0,0,1,0,0,0,0,0,0,0,0,0,0,0,0,0,0,0,0,0,0,0,0,0,0,1,0,0,0,0,0,0,0,0,0,0,0,0,1,1,0,1,Frank Lampard,£4.95m ,42.0,184.0,Midfielder - Central Midfield,both,Retired,32.0,13.0,6.0,2771.0,49.0,16.0,10.0,3581.0,50.0,17.0,8.0,3462.0,40.0,7.0,6.0,2829.0,48.0,11.0,6.0,2022.0,21.0,12.0,2.0,1399.0,nan,nan,nan,nan,nan,nan,nan,nan,nan,nan,nan,nan,Premier League,nan,nan,nan,nan,nan,nan,nan,nan
19/6/2011,Franco Zuculini,14006042,1649,9/5/1990,20,1,0,9,0,3900,6750,6250,144,123,476360,176,70,DM/M RC,2,2,2,3,1,3,2,6,1,3,2,6,10,12,6,15,6,8,7,12,18,14,8,12,14,18,7,19,7,9,10,8,18,9,11,10,7,15,19,17,15,14,7,8,12,13,20,18,12,9,14,12,6,12,2,9,12,10,7,9,7,14,1,1,20,1,15,14,20,DM/M RC,423,1,1,1,1,1,1,1,1,1,18,20,14,15,1,1,137438986240,0,0,0,0,0,0,0,0,0,0,0,0,0,0,0,1,0,0,0,0,0,0,0,0,0,0,0,0,0,0,0,0,0,0,0,0,0,1,0,0,0,0,0,0,0,0,0,0,Franco Zuculini,£2.70m ,30.0,176.0,Midfielder - Central Midfield,right,Defensor Sporting Club,23.0,0.0,1.0,1145.0,23.0,0.0,3.0,1161.0,20.0,2.0,1.0,1190.0,19.0,0.0,1.0,857.0,28.0,3.0,6.0,1805.0,3.0,1.0,0.0,174.0,16.0,1.0,1.0,565.0,14.0,0.0,0.0,592.0,20.0,0.0,0.0,1117.0,LaLiga,21.0,1.0,2.0,1239.0,nan,nan,nan,nan
19/6/2011,Francis Coquelin,34012022,769,5/13/1991,20,0,0,0,0,4400,5576,5576,164,123,2842045,178,73,DM/M C,1,3,1,1,1,1,3,4,3,1,1,5,8,11,5,13,6,9,7,5,8,14,8,12,13,12,13,15,12,12,12,13,16,8,11,9,12,14,16,15,13,12,8,12,14,12,20,15,11,13,12,15,11,15,13,16,14,13,13,15,15,5,12,12,16,12,12,1,16,DM/M C,311,1,1,1,10,1,12,1,1,12,20,16,1,12,1,12,0,0,0,0,0,0,0,0,0,0,0,0,0,0,0,0,0,0,0,0,0,0,0,0,0,0,0,0,0,0,0,0,0,0,0,0,0,0,0,0,0,0,0,0,0,0,0,0,0,Francis Coquelin,£2.70m ,29.0,177.0,Midfielder - Defensive Midfield,right,Villarreal CF,25.0,1.0,1.0,1296.0,18.0,0.0,1.0,1191.0,26.0,0.0,1.0,1293.0,24.0,1.0,0.0,1241.0,37.0,0.0,0.0,2770.0,36.0,0.0,0.0,2380.0,39.0,0.0,0.0,2338.0,26.0,1.0,1.0,1675.0,42.0,0.0,1.0,2810.0,Premier League,36.0,0.0,2.0,2579.0,6.0,0.0,0.0,371.0
19/6/2011,Francesco Marianini,704328,776,5/6/1979,32,0,0,1,0,2498,5495,5495,120,112,325465,185,74,M C,1,2,1,1,3,2,3,4,2,1,1,5,10,10,10,11,5,14,11,11,9,14,9,11,13,11,10,12,15,8,10,14,13,12,13,13,16,15,15,10,12,10,11,11,15,9,20,16,10,14,9,14,8,6,12,12,13,12,15,15,12,7,1,2,20,1,14,10,20,M C,401,1,1,1,1,1,1,1,1,1,15,20,10,14,2,2,65536,0,0,0,0,0,0,0,0,0,0,0,0,0,0,0,0,1,0,0,0,0,0,0,0,0,0,0,0,0,0,0,0,0,0,0,0,0,0,0,0,0,0,0,0,0,0,0,0,Francesco Marianini,£90Th. ,41.0,185.0,Midfielder - Central Midfield,right,Retired,42.0,1.0,4.0,3631.0,15.0,1.0,0.0,996.0,42.0,0.0,4.0,2788.0,29.0,0.0,0.0,1591.0,nan,nan,nan,nan,nan,nan,nan,nan,nan,nan,nan,nan,nan,nan,nan,nan,nan,nan,nan,nan,Serie A,nan,nan,nan,nan,nan,nan,nan,nan
19/6/2011,Francesco Lodi,829594,776,3/23/1984,27,0,0,3,0,4000,6400,6400,130,128,348510,182,77,DM/M/AM RC,1,1,3,2,3,1,1,4,3,2,3,16,14,13,12,14,19,10,16,5,7,15,14,9,14,8,9,9,13,11,15,14,13,14,11,11,12,15,12,12,10,12,10,20,13,13,10,10,13,14,6,12,4,11,9,13,12,9,13,15,15,8,1,1,18,20,20,8,18,DM/M/AM RC,533,1,1,1,14,8,20,1,1,1,18,18,8,10,1,1,0,0,0,0,0,0,0,0,0,0,0,0,0,0,0,0,0,0,0,0,0,0,0,0,0,0,0,0,0,0,0,0,0,0,0,0,0,0,0,0,0,0,0,0,0,0,0,0,0,Francesco Lodi,£4.95m ,36.0,183.0,Midfielder - Defensive Midfield,left,US Triestina,40.0,11.0,6.0,3136.0,37.0,9.0,7.0,3154.0,37.0,8.0,7.0,3263.0,30.0,5.0,5.0,2455.0,23.0,2.0,1.0,1637.0,24.0,1.0,1.0,1871.0,1.0,0.0,0.0,11.0,34.0,8.0,11.0,2843.0,43.0,15.0,8.0,3362.0,Serie A,29.0,6.0,4.0,2312.0,8.0,0.0,1.0,601.0
19/6/2011,Francesco Della Rocca,7983853,776,9/14/1987,23,0,0,0,0,3965,6613,6613,153,132,598744,182,77,M/AM RC,1,2,2,1,1,3,1,3,3,1,2,12,12,12,11,13,10,12,11,11,12,12,13,13,13,14,13,11,13,13,11,13,12,14,10,12,13,15,13,13,13,13,13,10,15,13,20,18,13,15,8,13,7,13,11,9,11,13,14,13,7,8,1,1,20,16,16,1,20,M/AM RC,413,1,1,1,16,1,1,1,1,1,10,20,1,16,1,1,0,0,0,0,0,0,0,0,0,0,0,0,0,0,0,0,0,0,0,0,0,0,0,0,0,0,0,0,0,0,0,0,0,0,0,0,0,0,0,0,0,0,0,0,0,0,0,0,0,Francesco Della Rocca,£2.70m ,33.0,182.0,Midfielder - Central Midfield,left,Without Club,27.0,0.0,2.0,2012.0,23.0,1.0,2.0,1223.0,19.0,1.0,0.0,1514.0,11.0,0.0,0.0,721.0,7.0,0.0,0.0,313.0,37.0,0.0,1.0,2611.0,30.0,2.0,0.0,2161.0,7.0,0.0,0.0,512.0,5.0,0.0,0.0,258.0,Serie A,nan,nan,nan,nan,nan,nan,nan,nan
19/6/2011,Francesco Bolzoni,43002298,776,5/7/1989,22,0,0,14,0,1155,5500,5500,137,110,259201,180,78,M C,1,1,1,1,1,1,1,1,1,1,1,4,9,10,4,12,5,10,10,6,10,13,13,14,12,15,12,14,12,11,10,12,15,8,9,10,13,12,14,12,13,14,12,8,12,12,20,15,13,10,14,13,9,6,10,12,16,12,17,17,17,7,1,1,20,1,1,1,20,M C,401,1,1,1,1,1,1,1,1,1,10,20,1,1,1,1,32832,0,0,0,0,0,0,1,0,0,0,0,0,0,0,0,1,0,0,0,0,0,0,0,0,0,0,0,0,0,0,0,0,0,0,0,0,0,0,0,0,0,0,0,0,0,0,0,0,Francesco Bolzoni,£1.08m ,31.0,183.0,Midfielder - Central Midfield,right,Calcio Lecco 1912,28.0,3.0,2.0,2254.0,20.0,1.0,0.0,1119.0,27.0,0.0,0.0,1684.0,39.0,4.0,1.0,3351.0,24.0,0.0,0.0,1092.0,2.0,0.0,0.0,51.0,14.0,0.0,0.0,722.0,30.0,0.0,0.0,2364.0,33.0,1.0,0.0,2665.0,Serie A,15.0,0.0,0.0,1001.0,4.0,0.0,0.0,283.0
19/6/2011,Fran Rico,1511811,796,8/3/1987,23,0,0,0,0,3500,5500,5500,129,117,311866,178,71,M C,3,3,1,3,1,1,3,4,3,2,1,12,10,12,6,16,10,6,10,4,5,15,10,8,16,12,14,9,14,13,16,15,10,12,16,12,8,14,12,12,12,10,8,9,12,12,20,13,8,15,13,15,15,10,15,6,8,11,6,17,8,6,1,1,20,9,1,1,20,M C,401,1,1,1,9,1,1,1,1,1,15,20,1,1,1,1,4194304,0,0,0,0,0,0,0,0,0,0,0,0,0,0,0,0,0,0,0,0,0,0,1,0,0,0,0,0,0,0,0,0,0,0,0,0,0,0,0,0,0,0,0,0,0,0,0,0,Fran Rico,£900Th. ,33.0,178.0,Midfielder - Central Midfield,right,Retired,31.0,6.0,1.0,2641.0,20.0,2.0,1.0,1290.0,nan,nan,nan,nan,33.0,2.0,6.0,2561.0,32.0,3.0,1.0,2639.0,31.0,4.0,0.0,1638.0,22.0,2.0,1.0,1447.0,nan,nan,nan,nan,1.0,0.0,0.0,56.0,LaLiga,nan,nan,nan,nan,nan,nan,nan,nan
19/6/2011,Fran Mérida,29005328,796,3/4/1990,21,0,0,4,0,4750,6250,6250,145,127,675961,173,69,M/AM C,1,3,1,1,1,2,2,2,2,1,1,9,14,14,10,15,12,4,13,3,6,15,9,6,16,8,12,9,14,13,15,14,12,15,5,13,8,13,11,12,15,14,7,20,13,11,13,12,9,14,4,10,4,12,13,16,10,11,12,12,9,8,1,1,20,19,10,14,20,M/AM C,411,1,1,1,19,12,8,1,1,1,1,20,14,10,1,1,4210688,0,0,0,0,0,0,0,0,0,0,0,0,0,0,1,0,0,0,0,0,0,0,1,0,0,0,0,0,0,0,0,0,0,0,0,0,0,0,0,0,0,0,0,0,0,0,0,0,Fran Mérida,£2.25m ,30.0,174.0,Midfielder - Central Midfield,left,RCD Espanyol Barcelona,27.0,3.0,4.0,1071.0,11.0,1.0,0.0,261.0,25.0,2.0,1.0,1591.0,6.0,0.0,1.0,208.0,21.0,1.0,0.0,1131.0,39.0,9.0,4.0,3047.0,17.0,1.0,0.0,922.0,37.0,8.0,5.0,3045.0,31.0,1.0,1.0,2418.0,LaLiga,25.0,1.0,1.0,1338.0,8.0,1.0,0.0,585.0
19/6/2011,Foued Kadir,8442537,5,12/5/1983,27,5,0,0,0,5050,6300,5650,141,126,507003,179,73,M/AM RC,3,3,3,3,3,1,3,3,3,3,2,7,11,13,8,14,9,10,13,6,5,12,12,8,15,8,12,10,13,12,15,12,12,13,8,12,8,12,11,14,14,12,9,12,12,13,20,13,11,13,8,14,6,10,10,13,12,11,12,14,14,7,10,10,17,20,17,10,20,M/AM RC,523,1,1,1,20,10,17,1,1,10,10,16,10,17,1,10,4194560,0,0,0,0,0,0,0,0,1,0,0,0,0,0,0,0,0,0,0,0,0,0,1,0,0,0,0,0,0,0,0,0,0,0,0,0,0,0,0,0,0,0,0,0,0,0,0,0,Foued Kadir,£2.03m ,36.0,180.0,Midfielder - Attacking Midfield,right,FC Martigues,12.0,4.0,0.0,961.0,37.0,6.0,4.0,2658.0,34.0,6.0,5.0,1623.0,33.0,7.0,3.0,2114.0,28.0,1.0,6.0,1927.0,10.0,0.0,1.0,545.0,27.0,0.0,0.0,1403.0,14.0,0.0,1.0,481.0,3.0,2.0,0.0,270.0,Ligue 1,2.0,0.0,0.0,180.0,5.0,3.0,0.0,450.0
19/6/2011,Florian Trinks,92002691,771,3/11/1992,19,0,0,0,0,3250,5250,5750,143,108,1212135,185,74,M/AM RLC,2,2,1,2,3,2,1,4,2,2,3,13,14,16,10,14,16,6,14,6,4,11,12,5,14,13,10,7,8,7,12,6,5,15,3,14,5,7,11,14,13,7,10,13,12,12,20,10,9,8,14,13,10,13,9,18,8,12,6,3,5,18,1,1,17,20,19,19,20,M/AM RLC,526,1,1,13,20,19,19,1,1,1,5,17,15,15,1,1,0,0,0,0,0,0,0,0,0,0,0,0,0,0,0,0,0,0,0,0,0,0,0,0,0,0,0,0,0,0,0,0,0,0,0,0,0,0,0,0,0,0,0,0,0,0,0,0,0,Florian Trinks,£540Th. ,28.0,185.0,Midfielder - Attacking Midfield,right,Without Club,14.0,0.0,2.0,743.0,23.0,1.0,0.0,1593.0,22.0,4.0,9.0,1797.0,32.0,4.0,7.0,1626.0,20.0,1.0,0.0,932.0,17.0,1.0,2.0,773.0,13.0,4.0,2.0,879.0,10.0,1.0,1.0,529.0,24.0,9.0,4.0,1771.0,Bundesliga,nan,nan,nan,nan,nan,nan,nan,nan
19/6/2011,Florian Kringe,876649,771,8/18/1982,28,0,0,4,0,4450,6100,5700,134,122,62175,187,83,M RLC,2,2,2,3,1,1,1,1,1,3,1,9,12,11,9,9,8,10,14,13,12,9,11,12,9,13,12,18,12,14,9,9,11,9,11,14,13,18,14,10,10,14,14,18,13,12,20,17,14,15,10,12,10,19,6,7,14,8,16,14,14,8,13,14,20,12,18,20,18,M RLC,406,1,1,1,9,12,12,1,13,13,14,18,20,18,14,14,256,0,0,0,0,0,0,0,0,1,0,0,0,0,0,0,0,0,0,0,0,0,0,0,0,0,0,0,0,0,0,0,0,0,0,0,0,0,0,0,0,0,0,0,0,0,0,0,0,Florian Trinks,£540Th. ,28.0,185.0,Midfielder - Attacking Midfield,right,Without Club,14.0,0.0,2.0,743.0,23.0,1.0,0.0,1593.0,22.0,4.0,9.0,1797.0,32.0,4.0,7.0,1626.0,20.0,1.0,0.0,932.0,17.0,1.0,2.0,773.0,13.0,4.0,2.0,879.0,10.0,1.0,1.0,529.0,24.0,9.0,4.0,1771.0,Bundesliga,nan,nan,nan,nan,nan,nan,nan,nan
19/6/2011,Florent Balmont,3503806,769,2/2/1980,31,0,0,3,0,5100,6434,6400,145,143,620045,168,71,DM/M C,3,2,3,2,1,1,1,4,3,2,1,11,8,11,5,12,11,8,13,6,12,14,8,14,13,15,16,17,14,15,12,15,15,6,14,9,14,18,18,15,14,13,4,8,16,12,20,18,13,17,15,14,5,10,5,15,14,16,15,12,9,7,10,10,20,1,12,1,20,DM/M C,421,1,1,1,1,1,1,1,1,10,18,20,1,12,1,10,320,0,0,0,0,0,0,1,0,1,0,0,0,0,0,0,0,0,0,0,0,0,0,0,0,0,0,0,0,0,0,0,0,0,0,0,0,0,0,0,0,0,0,0,0,0,0,0,0,Florent Balmont,£3.60m ,40.0,168.0,Midfielder - Central Midfield,right,Retired,39.0,0.0,3.0,3127.0,41.0,3.0,4.0,3304.0,44.0,3.0,3.0,3421.0,37.0,0.0,7.0,3008.0,44.0,2.0,6.0,3300.0,31.0,0.0,1.0,2183.0,23.0,0.0,2.0,1737.0,23.0,1.0,3.0,1000.0,28.0,1.0,2.0,1618.0,Ligue 1,16.0,0.0,1.0,623.0,nan,nan,nan,nan
19/6/2011,Flávio Ferreira,55022003,788,10/19/1991,19,0,0,0,0,500,1500,1500,109,90,58202,176,76,DM/M C,2,2,1,2,3,1,3,4,2,3,3,8,8,9,7,10,8,11,8,10,13,9,10,13,10,12,12,12,12,12,10,12,12,7,10,10,12,12,12,10,10,9,11,8,11,10,20,10,10,12,9,8,9,10,12,10,13,10,9,10,10,8,14,1,20,1,1,1,20,DM/M C,421,1,1,1,1,1,1,14,1,1,17,20,1,1,1,1,0,0,0,0,0,0,0,0,0,0,0,0,0,0,0,0,0,0,0,0,0,0,0,0,0,0,0,0,0,0,0,0,0,0,0,0,0,0,0,0,0,0,0,0,0,0,0,0,0,Flávio Ferreira,£360Th. ,29.0,180.0,Defender - Centre-Back,right,Retired,22.0,0.0,0.0,1868.0,22.0,0.0,0.0,1253.0,38.0,1.0,1.0,3450.0,16.0,0.0,0.0,1325.0,0.0,0.0,0.0,0.0,nan,nan,nan,nan,nan,nan,nan,nan,nan,nan,nan,nan,nan,nan,nan,nan,Liga NOS,nan,nan,nan,nan,nan,nan,nan,nan
19/6/2011,Filippo Porcari,837277,776,4/28/1984,27,0,0,0,0,3250,6400,6400,135,132,519452,176,70,DM RC,2,1,2,1,1,2,1,8,3,1,2,10,10,10,7,11,10,10,14,5,13,12,8,17,13,16,17,17,10,15,14,17,13,10,12,14,17,15,18,11,10,9,9,5,11,13,20,17,13,14,12,15,5,11,12,15,12,8,17,14,17,13,1,1,15,1,15,11,15,DM RC,303,1,1,1,1,1,1,1,1,1,20,15,11,15,1,1,137455796736,0,0,0,0,0,0,0,0,0,1,0,0,0,0,0,0,1,0,0,0,0,0,0,0,1,0,0,0,0,0,0,0,0,0,0,0,0,1,0,0,0,0,0,0,0,0,0,0,Filippo Porcari,£630Th. ,36.0,176.0,Midfielder - Defensive Midfield,right,Borgo San Donnino,41.0,3.0,1.0,3646.0,37.0,2.0,4.0,2989.0,36.0,2.0,2.0,2965.0,39.0,1.0,0.0,3400.0,39.0,0.0,4.0,3380.0,24.0,0.0,0.0,1499.0,28.0,3.0,1.0,1858.0,33.0,1.0,1.0,2812.0,21.0,2.0,0.0,1068.0,Serie A,21.0,1.0,1.0,1646.0,nan,nan,nan,nan
19/6/2011,Filipe Anunciação,7004623,788,5/27/1979,32,0,0,1,0,1500,5250,5250,106,104,245262,180,73,DM/M C,2,1,2,3,3,3,2,7,3,1,3,11,12,9,7,11,10,15,8,12,12,11,11,12,11,14,12,11,14,16,8,9,13,5,10,11,13,13,11,11,13,11,14,6,10,11,20,13,12,10,10,10,6,12,11,14,12,11,10,9,9,4,10,10,20,1,10,5,20,DM/M C,311,1,5,1,1,1,1,5,1,10,20,20,5,10,1,10,4295000128,0,0,0,0,0,0,1,0,0,0,0,0,0,0,0,1,0,0,0,0,0,0,0,0,0,0,0,0,0,0,0,0,1,0,0,0,0,0,0,0,0,0,0,0,0,0,0,0,Filipe Anunciacão,£450Th. ,41.0,179.0,Midfielder - Defensive Midfield,right,Retired,21.0,1.0,1.0,1143.0,34.0,0.0,0.0,2855.0,21.0,0.0,0.0,708.0,27.0,0.0,1.0,2140.0,0.0,0.0,0.0,0.0,nan,nan,nan,nan,nan,nan,nan,nan,nan,nan,nan,nan,nan,nan,nan,nan,Liga NOS,nan,nan,nan,nan,nan,nan,nan,nan
19/6/2011,Ferrie Bodde,142394,784,5/5/1982,29,0,0,0,0,3250,5750,6150,131,128,544327,178,74,DM/M C,1,1,3,2,2,3,2,6,3,2,2,10,8,12,13,14,16,10,16,8,12,18,13,15,16,16,13,15,15,13,15,12,12,13,15,14,14,14,14,10,10,12,10,4,15,11,20,14,13,15,16,16,10,13,15,16,16,12,15,15,3,11,1,1,20,10,1,1,20,DM/M C,311,1,1,1,10,1,1,1,1,1,20,20,1,1,1,1,43980469305856,0,0,0,0,0,0,0,0,0,1,0,0,0,0,0,0,0,0,0,0,0,0,1,0,0,0,0,0,0,0,0,0,0,0,0,0,0,0,0,0,0,0,0,1,0,1,0,0,Ferrie Bodde,£900Th. ,38.0,177.0,Midfielder - Central Midfield,right,Retired,nan,nan,nan,nan,2.0,0.0,0.0,60.0,nan,nan,nan,nan,nan,nan,nan,nan,nan,nan,nan,nan,nan,nan,nan,nan,nan,nan,nan,nan,nan,nan,nan,nan,nan,nan,nan,nan,Premier League,nan,nan,nan,nan,nan,nan,nan,nan
19/6/2011,Fernando Tissone,1408776,1649,7/24/1986,24,0,0,0,0,4000,6017,6900,141,127,551474,180,77,DM/M C,2,3,3,1,3,2,2,2,2,1,2,11,12,12,12,13,12,8,14,6,10,13,10,11,13,11,14,14,13,13,13,14,15,11,10,9,14,13,13,12,12,10,7,10,16,11,20,14,10,15,9,16,7,15,15,15,13,16,15,14,15,5,1,1,20,12,10,10,20,DM/M C,311,1,1,1,12,1,1,1,1,1,20,20,10,10,1,1,4194304,0,0,0,0,0,0,0,0,0,0,0,0,0,0,0,0,0,0,0,0,0,0,1,0,0,0,0,0,0,0,0,0,0,0,0,0,0,0,0,0,0,0,0,0,0,0,0,0,Fernando Tissone,£2.25m ,34.0,182.0,Midfielder - Central Midfield,right,Without Club,27.0,1.0,1.0,1705.0,29.0,0.0,0.0,1961.0,27.0,0.0,2.0,1693.0,28.0,1.0,2.0,2287.0,8.0,0.0,0.0,348.0,13.0,0.0,0.0,1087.0,nan,nan,nan,nan,27.0,1.0,0.0,2191.0,12.0,1.0,0.0,844.0,LaLiga,nan,nan,nan,nan,nan,nan,nan,nan
19/6/2011,Fernando Gago,961083,1649,4/10/1986,25,28,0,15,0,6361,7513,7262,156,146,0,178,73,DM C,3,1,3,2,1,2,1,3,3,2,2,7,10,11,6,17,8,7,10,8,11,16,12,13,15,15,15,14,16,16,13,15,17,6,11,9,16,16,15,13,15,13,8,11,15,12,20,16,11,14,14,12,10,6,18,13,15,14,14,14,16,7,1,1,15,8,1,1,15,DM C,301,1,1,1,8,1,1,1,1,1,20,15,1,1,1,1,64,0,0,0,0,0,0,1,0,0,0,0,0,0,0,0,0,0,0,0,0,0,0,0,0,0,0,0,0,0,0,0,0,0,0,0,0,0,0,0,0,0,0,0,0,0,0,0,0,Fernando Gago,£5.85m ,34.0,177.0,Midfielder - Defensive Midfield,right,Club Atlético Vélez Sarsfield,7.0,0.0,0.0,193.0,32.0,1.0,3.0,2403.0,25.0,1.0,1.0,1747.0,26.0,0.0,5.0,2194.0,30.0,3.0,4.0,2297.0,18.0,1.0,0.0,1396.0,16.0,2.0,1.0,1434.0,11.0,0.0,0.0,660.0,8.0,0.0,0.0,720.0,Serie A,13.0,0.0,0.0,1034.0,nan,nan,nan,nan
19/6/2011,Fernando Alexandre,745269,788,8/2/1985,25,0,0,0,0,2750,5750,5750,118,112,593123,183,82,DM/M C,2,2,2,3,3,3,3,4,1,2,1,11,11,10,10,13,11,13,11,11,14,11,11,12,13,13,14,12,14,15,11,12,12,6,11,11,15,14,13,11,12,14,13,8,12,11,20,14,14,13,10,12,8,12,12,12,11,11,11,13,14,7,1,1,20,10,5,5,20,DM/M C,311,1,1,1,10,1,1,1,1,1,20,20,5,5,1,1,0,0,0,0,0,0,0,0,0,0,0,0,0,0,0,0,0,0,0,0,0,0,0,0,0,0,0,0,0,0,0,0,0,0,0,0,0,0,0,0,0,0,0,0,0,0,0,0,0,Fernando Alexandre,£900Th. ,35.0,184.0,Midfielder - Defensive Midfield,right,Retired,31.0,1.0,0.0,2666.0,29.0,0.0,0.0,2404.0,25.0,1.0,1.0,2159.0,29.0,3.0,0.0,2591.0,25.0,0.0,0.0,1930.0,29.0,3.0,0.0,2520.0,23.0,0.0,1.0,1982.0,10.0,1.0,0.0,378.0,16.0,1.0,0.0,959.0,Liga NOS,nan,nan,nan,nan,nan,nan,nan,nan
19/6/2011,Félix Van Hulst,85054535,769,4/30/1990,21,0,0,0,0,1251,4184,2502,125,93,11501,178,71,DM C,3,2,2,3,2,2,2,4,2,3,1,8,10,9,7,12,13,7,13,6,6,11,7,8,12,10,11,11,13,13,13,12,13,11,7,7,8,12,12,12,12,12,9,5,15,11,20,15,11,14,10,10,5,8,7,13,13,13,13,15,15,6,1,1,15,1,1,1,15,DM C,301,1,1,1,1,1,1,1,1,1,20,15,1,1,1,1,4194304,0,0,0,0,0,0,0,0,0,0,0,0,0,0,0,0,0,0,0,0,0,0,1,0,0,0,0,0,0,0,0,0,0,0,0,0,0,0,0,0,0,0,0,0,0,0,0,0
19/6/2011,Felipe Seymour,75003077,1652,7/23/1987,23,1,0,0,0,4000,6500,6500,140,130,546023,174,67,DM/M C,1,3,2,1,2,2,2,3,3,2,1,9,10,11,10,11,7,12,14,8,14,11,6,14,11,12,14,12,14,15,12,12,11,8,10,9,13,15,16,13,13,11,12,8,16,13,20,17,15,13,7,15,4,11,13,15,14,14,13,8,6,17,1,1,20,10,14,12,20,DM/M C,421,1,1,1,10,6,8,1,1,1,19,20,12,14,1,1,4294967296,0,0,0,0,0,0,0,0,0,0,0,0,0,0,0,0,0,0,0,0,0,0,0,0,0,0,0,0,0,0,0,0,1,0,0,0,0,0,0,0,0,0,0,0,0,0,0,0,Felipe Seymour,£1.17m ,33.0,174.0,Midfielder - Defensive Midfield,right,Unión La Calera,20.0,0.0,0.0,1673.0,28.0,1.0,0.0,1338.0,23.0,0.0,1.0,1244.0,33.0,1.0,2.0,2374.0,2.0,0.0,0.0,49.0,nan,nan,nan,nan,27.0,1.0,0.0,1845.0,21.0,1.0,0.0,1460.0,18.0,0.0,0.0,1319.0,Serie A,5.0,0.0,0.0,379.0,nan,nan,nan,nan
19/6/2011,Federico Casarini,43006683,776,8/7/1989,21,0,0,0,0,3050,6500,6500,164,129,699889,181,72,M C,1,2,1,2,1,2,3,4,3,3,2,10,12,13,9,10,10,11,12,8,11,15,4,13,16,12,11,14,8,12,13,11,14,14,6,11,11,15,15,14,13,10,12,12,13,14,20,15,12,14,8,13,3,6,10,7,12,11,9,9,11,9,1,1,20,14,1,1,20,M C,401,1,1,1,14,1,1,1,1,1,1,20,1,1,1,1,0,0,0,0,0,0,0,0,0,0,0,0,0,0,0,0,0,0,0,0,0,0,0,0,0,0,0,0,0,0,0,0,0,0,0,0,0,0,0,0,0,0,0,0,0,0,0,0,0,Federico Casarini,£1.08m ,31.0,181.0,Midfielder - Central Midfield,right,US Alessandria Calcio 1912,35.0,0.0,2.0,2118.0,13.0,0.0,0.0,820.0,11.0,1.0,0.0,363.0,35.0,2.0,3.0,2901.0,35.0,1.0,3.0,2723.0,35.0,0.0,5.0,3052.0,41.0,3.0,2.0,3594.0,30.0,1.0,0.0,2324.0,19.0,0.0,2.0,976.0,Serie A,21.0,3.0,1.0,1220.0,8.0,0.0,0.0,640.0
19/6/2011,Fayçal Fajr,85084000,34,8/1/1988,22,0,0,0,0,1300,4769,2650,125,106,31620,178,72,M/AM C,3,2,1,3,3,3,2,5,2,3,3,12,13,13,8,13,14,6,11,5,2,13,12,2,14,5,10,8,11,10,13,10,17,15,6,11,5,11,10,14,13,12,9,12,13,11,20,11,11,13,13,14,6,8,10,15,13,12,14,11,11,5,1,1,16,20,14,12,20,M/AM C,521,1,1,1,20,12,14,1,1,1,1,16,12,14,1,1,34359738496,0,0,0,0,0,0,0,1,0,0,0,0,0,0,0,0,0,0,0,0,0,0,0,0,0,0,0,0,0,0,0,0,0,0,0,1,0,0,0,0,0,0,0,0,0,0,0,0,Fayçal Fajr,£630Th. ,32.0,179.0,Midfielder - Central Midfield,right,Sivasspor,2.0,1.0,0.0,66.0,17.0,2.0,1.0,1079.0,34.0,5.0,7.0,2843.0,38.0,10.0,15.0,2950.0,38.0,1.0,5.0,2769.0,41.0,5.0,5.0,2962.0,26.0,0.0,3.0,1293.0,33.0,1.0,4.0,2564.0,40.0,5.0,9.0,3578.0,Ligue 1,16.0,0.0,1.0,930.0,4.0,1.0,0.0,340.0
19/6/2011,Fanol Perdedaj,91018525,771,7/16/1991,19,0,0,0,0,693,5000,5000,130,100,178910,172,66,DM C,3,1,1,2,1,3,1,4,3,3,1,9,7,6,4,10,9,11,8,3,12,10,10,13,10,15,11,17,10,12,10,10,18,3,11,9,11,17,18,10,12,12,6,5,17,12,20,13,15,10,12,10,3,9,12,12,7,14,16,15,14,2,1,1,15,1,1,1,15,DM C,301,1,1,1,1,1,1,1,1,1,20,15,1,1,1,1,137438953984,0,0,0,0,0,0,0,0,0,1,0,0,0,0,0,0,0,0,0,0,0,0,0,0,0,0,0,0,0,0,0,0,0,0,0,0,0,1,0,0,0,0,0,0,0,0,0,0,Fanol Perdedaj,£720Th. ,29.0,173.0,Midfielder - Central Midfield,right,1.FC Saarbrücken,21.0,0.0,1.0,1169.0,27.0,2.0,0.0,2073.0,26.0,1.0,2.0,1917.0,21.0,0.0,2.0,1425.0,38.0,1.0,2.0,3330.0,32.0,3.0,5.0,2862.0,17.0,0.0,0.0,1275.0,14.0,2.0,0.0,875.0,30.0,6.0,5.0,2035.0,Bundesliga,24.0,5.0,8.0,1871.0,1.0,0.0,0.0,23.0
19/6/2011,Fabrice Muamba,5111919,765,4/6/1988,23,0,0,33,0,4750,6500,6600,140,130,834025,188,78,DM/M C,3,3,2,1,3,1,1,2,2,1,3,9,9,9,6,11,7,9,7,7,14,11,7,14,9,16,15,17,10,12,9,13,16,9,9,11,15,16,17,15,13,13,13,12,17,14,20,17,16,13,9,11,2,10,10,9,16,12,14,13,12,7,1,1,20,1,1,1,20,DM/M C,311,1,1,1,1,1,1,1,1,1,20,20,1,1,1,1,159048531968,0,0,0,0,0,0,0,0,0,0,0,0,0,0,0,0,0,0,0,1,0,0,0,0,0,0,0,1,0,0,0,0,1,0,1,0,0,1,0,0,0,0,0,0,0,0,0,0,Fabrice Muamba,£4.50m ,32.0,188.0,Midfielder - Central Midfield,right,Retired,41.0,1.0,2.0,2981.0,24.0,2.0,1.0,1605.0,nan,nan,nan,nan,nan,nan,nan,nan,nan,nan,nan,nan,nan,nan,nan,nan,nan,nan,nan,nan,nan,nan,nan,nan,nan,nan,nan,nan,Premier League,nan,nan,nan,nan,nan,nan,nan,nan
19/6/2011,Fabrice Abriel,3504224,769,7/6/1979,31,0,0,0,0,4700,5900,5900,140,132,468693,176,69,M C,1,3,2,1,3,3,1,4,1,3,2,13,13,12,7,15,14,8,13,7,8,14,12,13,15,10,15,11,13,13,13,11,14,12,13,11,12,16,14,12,13,12,7,8,17,14,20,17,10,12,10,15,4,15,6,14,14,15,16,14,13,9,8,8,20,14,14,10,20,M C,401,1,1,1,12,10,14,5,1,8,14,20,10,14,1,8,17179869344,0,0,0,0,0,1,0,1,0,0,0,0,0,0,0,0,0,0,0,0,0,0,0,0,0,0,0,0,0,0,0,0,0,0,1,0,0,0,0,0,0,0,0,0,0,0,0,0,Fabrice Abriel,£900Th. ,41.0,176.0,Midfielder - Central Midfield,right,Retired,29.0,0.0,0.0,945.0,33.0,0.0,2.0,2332.0,32.0,1.0,2.0,2173.0,29.0,1.0,1.0,1912.0,26.0,0.0,2.0,2123.0,nan,nan,nan,nan,nan,nan,nan,nan,nan,nan,nan,nan,nan,nan,nan,nan,Ligue 1,nan,nan,nan,nan,nan,nan,nan,nan
19/6/2011,Fábio Simplício,302461,1651,9/23/1979,31,1,0,0,0,3700,6750,6550,142,131,401335,171,75,DM/M/AM C,2,3,2,3,3,3,3,5,1,2,2,9,9,12,14,14,9,8,11,9,10,14,12,9,13,14,14,12,11,12,14,13,17,13,5,12,15,14,14,13,12,14,6,9,16,14,20,14,15,15,15,15,9,15,11,14,15,13,15,12,14,2,1,1,19,20,1,1,20,DM/M/AM C,531,1,1,1,20,1,1,1,1,1,16,19,1,1,1,1,4194308,0,0,1,0,0,0,0,0,0,0,0,0,0,0,0,0,0,0,0,0,0,0,1,0,0,0,0,0,0,0,0,0,0,0,0,0,0,0,0,0,0,0,0,0,0,0,0,0,Fábio Simplício,£1.35m ,41.0,173.0,Midfielder - Central Midfield,right,Retired,31.0,5.0,3.0,2089.0,40.0,7.0,2.0,2604.0,39.0,6.0,10.0,3286.0,27.0,3.0,4.0,2038.0,nan,nan,nan,nan,nan,nan,nan,nan,nan,nan,nan,nan,nan,nan,nan,nan,nan,nan,nan,nan,Serie A,nan,nan,nan,nan,nan,nan,nan,nan
19/6/2011,Fabio Sciacca,43002359,776,5/16/1989,22,0,0,0,0,3000,5650,5650,140,113,211707,182,76,DM/M C,1,1,1,1,1,1,1,1,1,1,1,8,10,9,10,12,12,15,15,4,7,14,9,11,13,12,10,14,11,8,14,8,14,11,13,14,9,12,12,12,11,13,10,11,10,13,20,12,14,13,13,10,15,14,14,16,16,13,16,12,12,5,1,1,20,10,14,12,20,DM/M C,421,1,1,1,10,1,1,1,1,1,17,20,12,14,1,1,272,0,0,0,0,1,0,0,0,1,0,0,0,0,0,0,0,0,0,0,0,0,0,0,0,0,0,0,0,0,0,0,0,0,0,0,0,0,0,0,0,0,0,0,0,0,0,0,0,Fabio Sciacca,£540Th. ,31.0,184.0,Midfielder - Central Midfield,right,Calcio Biancavilla 1990,9.0,0.0,0.0,674.0,25.0,1.0,0.0,1466.0,4.0,0.0,0.0,129.0,5.0,0.0,0.0,309.0,16.0,0.0,2.0,864.0,nan,nan,nan,nan,3.0,0.0,0.0,111.0,21.0,0.0,0.0,884.0,nan,nan,nan,nan,Serie A,2.0,0.0,0.0,107.0,3.0,0.0,0.0,187.0
19/6/2011,Fabio Caserta,3802529,776,9/24/1978,32,0,0,0,0,2750,5900,5900,126,118,86378,180,71,M/AM LC,1,1,1,1,1,1,1,1,1,1,1,14,13,11,11,9,14,10,14,4,7,16,13,9,13,14,11,13,12,16,13,13,16,12,9,11,12,14,13,10,10,12,9,13,14,11,20,12,12,11,8,14,8,16,12,11,8,13,15,15,15,6,1,1,20,18,13,19,20,M/AM LC,414,1,1,1,18,17,13,1,1,1,1,20,19,13,1,1,140737493074304,0,0,0,0,0,0,0,1,1,0,0,0,0,0,0,0,0,0,0,1,0,0,1,0,0,0,0,0,0,0,0,0,0,0,0,0,0,0,0,0,0,0,0,0,0,0,0,1,Fabio Caserta,£180Th. ,42.0,179.0,Midfielder - Central Midfield,right,Retired,26.0,1.0,2.0,1644.0,17.0,2.0,0.0,625.0,34.0,7.0,5.0,2664.0,23.0,3.0,2.0,1684.0,34.0,4.0,1.0,1283.0,3.0,0.0,0.0,17.0,nan,nan,nan,nan,nan,nan,nan,nan,nan,nan,nan,nan,Serie A,nan,nan,nan,nan,nan,nan,nan,nan
19/6/2011,Fabien Lemoine,8431727,769,3/16/1987,24,0,0,1,0,4650,5800,5800,140,129,474308,175,67,DM/M C,2,1,3,3,2,2,2,3,3,1,3,12,11,9,6,12,12,9,11,6,12,13,7,13,12,13,14,15,12,13,12,13,15,7,12,7,12,16,17,14,12,13,8,10,13,13,20,16,11,14,13,15,10,8,10,13,16,14,16,13,13,7,5,5,16,10,10,1,16,DM/M C,311,1,1,1,1,1,10,1,1,5,20,16,1,10,1,5,0,0,0,0,0,0,0,0,0,0,0,0,0,0,0,0,0,0,0,0,0,0,0,0,0,0,0,0,0,0,0,0,0,0,0,0,0,0,0,0,0,0,0,0,0,0,0,0,0,Fabien Lemoine,£4.05m ,33.0,175.0,Midfielder - Defensive Midfield,right,FC Lorient,20.0,0.0,2.0,805.0,30.0,0.0,5.0,2288.0,41.0,1.0,3.0,3032.0,40.0,2.0,3.0,3319.0,48.0,2.0,4.0,3963.0,43.0,0.0,1.0,3294.0,24.0,1.0,0.0,1422.0,35.0,2.0,3.0,3055.0,33.0,1.0,2.0,2796.0,Ligue 1,26.0,0.0,0.0,2260.0,7.0,0.0,0.0,451.0
19/6/2011,Fabian Lustenberger,69003477,798,5/2/1988,23,0,0,25,2,4250,6250,6250,147,126,519231,180,70,DM/M C,2,2,1,1,1,1,2,2,3,1,1,6,9,10,6,14,8,13,8,7,10,15,6,12,14,14,16,14,13,10,13,15,16,6,6,10,12,17,16,14,15,10,9,8,2,14,20,14,6,11,7,10,17,16,12,15,11,13,16,16,11,4,1,1,18,13,14,1,18,DM/M C,311,1,1,1,12,1,13,1,1,1,20,18,1,14,1,1,20971520,0,0,0,0,0,0,0,0,0,0,0,0,0,0,0,0,0,0,0,0,0,0,1,0,1,0,0,0,0,0,0,0,0,0,0,0,0,0,0,0,0,0,0,0,0,0,0,0,Fabian Lustenberger,£1.80m ,32.0,180.0,Defender - Centre-Back,right,BSC Young Boys,22.0,1.0,2.0,1633.0,19.0,1.0,1.0,1017.0,34.0,0.0,2.0,3021.0,21.0,0.0,0.0,1920.0,30.0,1.0,0.0,2489.0,34.0,1.0,0.0,2927.0,22.0,0.0,1.0,1717.0,29.0,0.0,0.0,2076.0,30.0,0.0,1.0,2185.0,Bundesliga,41.0,1.0,0.0,3293.0,9.0,0.0,0.0,810.0
19/6/2011,Fabian Delph,29001228,765,11/21/1989,21,0,0,4,0,5000,6500,7000,162,128,1260936,174,60,M C,3,1,3,2,2,1,2,2,3,3,2,10,12,14,11,14,10,3,14,1,5,13,8,10,13,17,10,15,14,10,12,9,16,14,10,12,10,11,12,17,18,16,8,20,15,15,7,15,8,12,3,10,9,12,8,16,15,12,14,7,3,4,1,1,20,13,14,14,20,M C,401,1,1,1,13,1,1,1,1,1,10,20,14,14,1,1,140892107178116,0,0,1,0,0,0,0,1,0,0,0,0,0,0,0,0,0,0,0,0,0,0,0,0,0,0,0,0,0,0,0,0,0,0,1,0,0,1,0,0,0,0,0,0,0,0,0,1,Fabian Delph,£3.15m ,30.0,174.0,Midfielder - Central Midfield,left,Everton FC,8.0,0.0,0.0,503.0,16.0,0.0,0.0,1274.0,32.0,1.0,0.0,2320.0,36.0,4.0,3.0,3153.0,32.0,2.0,5.0,2793.0,27.0,2.0,0.0,1235.0,13.0,2.0,0.0,515.0,29.0,1.0,2.0,2324.0,20.0,0.0,1.0,1219.0,Premier League,20.0,0.0,0.0,1471.0,4.0,0.0,0.0,216.0
19/6/2011,Ever Banega,14001284,1649,6/29/1988,22,2,0,14,0,6500,7650,7500,168,154,5142705,174,71,M C,2,3,3,1,1,2,2,7,3,2,1,13,13,15,10,18,10,6,13,7,8,18,12,11,18,14,14,9,18,11,18,16,14,15,8,13,9,15,11,13,14,13,7,14,12,12,20,13,11,9,14,13,11,10,8,13,12,11,6,11,8,15,1,1,20,12,7,7,20,M C,401,1,1,1,12,1,1,1,1,1,13,20,7,7,1,1,17593263980800,0,0,0,0,0,0,0,0,1,0,0,0,0,0,0,0,0,0,0,0,0,0,1,0,0,0,0,0,0,0,1,0,0,0,0,0,0,0,0,0,0,0,0,0,1,0,0,0,Éver Banega,£11.70m ,32.0,174.0,Midfielder - Central Midfield,right,Al-Shabab Riyadh,34.0,3.0,3.0,2181.0,25.0,1.0,2.0,1805.0,40.0,4.0,8.0,2557.0,42.0,2.0,5.0,2993.0,49.0,3.0,4.0,3306.0,45.0,9.0,5.0,3377.0,33.0,6.0,7.0,1899.0,50.0,5.0,6.0,3981.0,51.0,8.0,11.0,4075.0,LaLiga,43.0,3.0,11.0,3056.0,1.0,0.0,0.0,87.0
19/6/2011,Eugen Polanski,894132,787,3/17/1986,25,0,0,0,0,5268,6511,6750,146,135,917928,183,73,DM/M C,3,1,2,3,1,2,3,1,3,2,2,10,8,10,8,12,11,11,14,8,15,12,12,14,11,18,12,17,8,16,11,14,17,7,16,12,9,14,18,13,13,13,11,10,16,14,20,17,17,13,12,10,7,13,10,18,9,12,14,11,13,11,1,1,20,12,12,12,20,DM/M C,421,1,1,1,12,1,1,1,1,1,18,20,12,12,1,1,1073742336,0,0,0,0,0,0,0,0,0,1,0,0,0,0,0,0,0,0,0,0,0,0,0,0,0,0,0,0,0,0,1,0,0,0,0,0,0,0,0,0,0,0,0,0,0,0,0,0,Eugen Polanski,£3.60m ,34.0,183.0,Midfielder - Defensive Midfield,right,Retired,29.0,0.0,4.0,2255.0,29.0,3.0,2.0,2245.0,26.0,0.0,3.0,1726.0,36.0,3.0,5.0,3053.0,33.0,6.0,0.0,2840.0,27.0,1.0,3.0,1758.0,14.0,0.0,0.0,631.0,14.0,0.0,1.0,579.0,nan,nan,nan,nan,Bundesliga,nan,nan,nan,nan,nan,nan,nan,nan
19/6/2011,Etienne Didot,144183,769,7/24/1983,27,0,0,13,0,2222,6335,6335,148,140,644167,175,65,DM/M C,1,1,3,1,1,3,2,6,1,3,1,15,13,10,7,12,14,8,14,8,8,16,8,12,12,9,14,14,14,16,13,15,14,7,14,9,15,16,17,14,13,13,7,8,13,12,20,17,13,16,9,15,11,10,10,16,14,14,16,14,14,6,1,1,20,10,12,1,20,DM/M C,421,1,1,1,10,1,1,1,1,1,17,20,1,12,1,1,8796093022464,0,0,0,0,0,0,0,0,1,0,0,0,0,0,0,0,0,0,0,0,0,0,0,0,0,0,0,0,0,0,0,0,0,0,0,0,0,0,0,0,0,0,0,1,0,0,0,0,Étienne Didot,£3.60m ,37.0,175.0,Midfielder - Central Midfield,right,Retired,37.0,2.0,3.0,3107.0,24.0,1.0,2.0,2045.0,40.0,2.0,9.0,3193.0,34.0,1.0,2.0,2547.0,21.0,0.0,1.0,1346.0,26.0,0.0,2.0,1848.0,31.0,1.0,1.0,2330.0,23.0,2.0,1.0,1632.0,36.0,1.0,2.0,2485.0,Ligue 1,nan,nan,nan,nan,nan,nan,nan,nan
19/6/2011,Etienne Capoue,8448716,769,7/11/1988,22,0,0,13,0,5150,6450,6450,165,143,1712166,189,80,DM C,3,3,2,2,2,2,2,3,1,1,3,5,11,12,6,13,8,16,8,7,13,15,8,13,13,13,17,15,14,14,13,14,13,11,8,10,14,15,16,12,13,16,14,8,16,13,20,17,16,15,13,15,5,10,5,15,15,15,13,14,14,7,14,12,15,10,12,1,15,DM C,301,1,1,1,10,1,1,14,1,12,20,15,1,1,1,12,8796093022240,0,0,0,0,0,1,0,0,0,0,0,0,0,0,0,0,0,0,0,0,0,0,0,0,0,0,0,0,0,0,0,0,0,0,0,0,0,0,0,0,0,0,0,1,0,0,0,0,Étienne Capoue,£10.80m ,32.0,189.0,Midfielder - Defensive Midfield,right,Watford FC,39.0,2.0,0.0,3540.0,34.0,3.0,5.0,2909.0,38.0,7.0,1.0,3406.0,19.0,1.0,1.0,1284.0,19.0,1.0,2.0,1284.0,36.0,0.0,1.0,3017.0,39.0,7.0,1.0,3357.0,26.0,3.0,0.0,1755.0,39.0,4.0,3.0,3352.0,Ligue 1,30.0,0.0,3.0,2632.0,2.0,0.0,0.0,73.0
19/6/2011,Esteban Granero,7458313,796,7/2/1987,23,0,0,8,2,5750,7350,7350,159,147,0,180,75,M/AM RLC,1,3,3,3,1,2,3,1,2,1,2,16,15,15,12,17,13,10,14,7,6,16,13,8,16,10,12,13,15,11,17,13,15,16,10,13,10,12,13,13,15,10,9,13,12,13,20,13,10,12,12,13,7,13,13,14,14,16,13,16,15,7,1,1,18,20,15,16,20,M/AM RLC,526,1,1,1,20,16,15,1,1,1,8,18,13,12,1,1,17592186044564,0,0,1,0,1,0,0,1,0,0,0,0,0,0,0,0,0,0,0,0,0,0,0,0,0,0,0,0,0,0,0,0,0,0,0,0,0,0,0,0,0,0,0,0,1,0,0,0,Esteban Granero,£6.30m ,33.0,180.0,Midfielder - Central Midfield,right,Marbella FC,32.0,2.0,4.0,1271.0,28.0,0.0,2.0,1000.0,27.0,1.0,1.0,1886.0,8.0,0.0,1.0,367.0,39.0,1.0,2.0,2791.0,15.0,0.0,0.0,872.0,22.0,0.0,1.0,736.0,31.0,2.0,3.0,1752.0,30.0,3.0,1.0,2137.0,LaLiga,27.0,1.0,3.0,1651.0,2.0,0.0,0.0,178.0
19/6/2011,Esteban Cambiasso,3100494,1649,8/18/1980,30,47,5,11,2,7750,8550,7950,171,157,6052381,177,78,DM/M C,1,1,1,1,1,1,1,1,1,1,1,13,9,9,12,11,10,12,12,8,16,14,8,18,13,15,18,17,16,17,13,15,18,10,18,14,19,20,19,11,13,15,9,20,14,12,9,17,14,17,11,17,14,16,18,15,19,14,19,17,15,4,14,1,19,11,1,1,19,DM/M C,311,1,1,1,11,1,1,14,1,1,20,19,1,1,1,1,137443213320,0,0,0,1,0,0,0,0,0,0,0,0,0,0,0,0,1,0,0,0,0,0,1,0,0,0,0,0,0,0,0,0,0,0,0,0,0,1,0,0,0,0,0,0,0,0,0,0,Esteban Cambiasso,£11.70m ,40.0,177.0,Midfielder - Defensive Midfield,left,Retired,45.0,8.0,3.0,3753.0,47.0,5.0,3.0,3937.0,48.0,4.0,8.0,3802.0,33.0,4.0,2.0,2803.0,33.0,5.0,1.0,2537.0,21.0,4.0,2.0,1461.0,28.0,3.0,1.0,1609.0,nan,nan,nan,nan,nan,nan,nan,nan,Serie A,nan,nan,nan,nan,nan,nan,nan,nan
19/6/2011,Eric Tié-Bi,34011692,24,7/20/1990,20,0,0,0,0,1250,2500,2500,135,100,60188,189,76,DM C,2,3,3,1,3,2,3,4,2,2,3,5,5,8,5,11,7,13,9,5,10,11,11,8,11,14,13,13,11,11,9,8,14,11,9,7,11,14,16,15,11,14,14,5,16,12,20,18,14,14,14,14,5,6,5,13,13,14,15,14,14,5,1,1,15,1,1,1,15,DM C,301,1,1,1,1,1,1,1,1,1,20,15,1,1,1,1,1073741824,0,0,0,0,0,0,0,0,0,0,0,0,0,0,0,0,0,0,0,0,0,0,0,0,0,0,0,0,0,0,1,0,0,0,0,0,0,0,0,0,0,0,0,0,0,0,0,0,Eric Tié Bi,£900Th. ,30.0,181.0,Midfielder - Defensive Midfield,right,Unknown,25.0,0.0,0.0,1675.0,26.0,0.0,3.0,1398.0,24.0,0.0,2.0,1332.0,22.0,0.0,1.0,1732.0,19.0,0.0,0.0,1039.0,29.0,0.0,1.0,2096.0,14.0,0.0,0.0,1155.0,26.0,0.0,0.0,1358.0,nan,nan,nan,nan,Ligue 1,nan,nan,nan,nan,nan,nan,nan,nan
19/6/2011,Enzo Maresca,703149,776,2/10/1980,31,0,0,15,2,5000,6250,6750,150,132,3153481,180,77,DM/M C,2,2,2,1,3,1,3,5,1,2,3,16,11,12,8,13,14,11,14,7,11,14,18,12,15,15,13,14,13,14,15,14,12,13,14,14,13,15,14,12,10,13,9,10,7,11,20,12,12,11,15,15,7,12,16,16,12,14,11,10,8,13,1,1,20,10,5,1,20,DM/M C,421,1,1,1,10,1,1,1,1,1,19,20,1,5,1,1,8796097216676,0,0,1,0,0,1,0,1,0,0,0,0,0,0,0,0,0,0,0,0,0,0,1,0,0,0,0,0,0,0,0,0,0,0,0,0,0,0,0,0,0,0,0,1,0,0,0,0,Enzo Maresca,£1.80m ,40.0,180.0,Midfielder - Central Midfield,right,Retired,25.0,4.0,3.0,1099.0,20.0,2.0,1.0,847.0,17.0,3.0,1.0,1210.0,16.0,0.0,1.0,1244.0,20.0,0.0,0.0,1206.0,16.0,1.0,0.0,1074.0,9.0,0.0,0.0,428.0,nan,nan,nan,nan,nan,nan,nan,nan,LaLiga,nan,nan,nan,nan,nan,nan,nan,nan
19/6/2011,Emmanuel Badu,12035987,21,12/2/1990,20,22,1,0,0,3500,6300,6050,149,129,789860,173,70,DM/M C,2,2,3,2,1,2,2,2,3,2,3,11,11,8,6,10,14,11,14,11,15,12,9,14,11,15,13,15,12,12,11,11,11,9,13,12,12,15,15,14,14,15,8,8,15,13,20,14,14,12,13,14,6,8,10,12,11,11,12,11,12,7,1,1,18,1,1,1,18,DM/M C,311,1,1,1,1,1,1,1,1,1,20,18,1,1,1,1,35184372089600,0,0,0,0,0,0,0,0,1,1,0,0,0,0,0,0,0,0,0,0,0,0,0,0,0,0,0,0,0,0,0,0,0,0,0,0,0,0,0,0,0,0,0,0,0,1,0,0,Emmanuel Badu,£1.62m ,29.0,173.0,Midfielder - Central Midfield,right,Hellas Verona,11.0,0.0,0.0,432.0,18.0,0.0,1.0,1265.0,32.0,0.0,2.0,1990.0,32.0,5.0,1.0,2054.0,27.0,1.0,1.0,1869.0,34.0,4.0,3.0,2745.0,30.0,0.0,3.0,2118.0,19.0,1.0,1.0,1512.0,4.0,0.0,0.0,161.0,Serie A,10.0,0.0,0.0,224.0,nan,nan,nan,nan
19/6/2011,Emerse Faé,916250,24,1/24/1984,27,37,1,0,0,5513,6808,6115,145,131,982915,173,70,DM/M C,3,2,2,1,2,2,2,6,2,2,1,9,11,11,6,14,7,6,13,4,6,13,8,13,14,11,13,14,13,12,12,12,17,11,11,10,12,14,16,16,13,11,5,10,12,13,20,14,12,13,11,12,10,8,7,13,12,12,14,14,11,9,1,1,20,14,14,1,20,DM/M C,421,1,1,1,12,1,14,1,1,1,17,20,1,14,1,1,32,0,0,0,0,0,1,0,0,0,0,0,0,0,0,0,0,0,0,0,0,0,0,0,0,0,0,0,0,0,0,0,0,0,0,0,0,0,0,0,0,0,0,0,0,0,0,0,0,Emerse Faé,- ,36.0,175.0,Midfielder - Central Midfield,both,Retired,29.0,3.0,3.0,2639.0,4.0,0.0,1.0,302.0,nan,nan,nan,nan,nan,nan,nan,nan,nan,nan,nan,nan,nan,nan,nan,nan,nan,nan,nan,nan,nan,nan,nan,nan,nan,nan,nan,nan,Ligue 1,nan,nan,nan,nan,nan,nan,nan,nan
19/6/2011,Elvis,19062098,1651,9/9/1990,20,0,0,0,0,1802,5550,5550,131,111,128725,170,70,M/AM C,1,2,2,3,3,2,2,2,2,1,1,12,12,13,11,13,10,10,11,5,6,13,10,6,14,11,11,9,11,12,13,12,10,13,12,12,6,12,13,13,14,6,5,10,12,14,20,13,6,12,7,7,8,13,6,9,10,9,6,8,11,11,1,1,16,20,1,1,20,M/AM C,521,1,1,1,20,1,1,1,1,1,1,16,1,1,1,1,0,0,0,0,0,0,0,0,0,0,0,0,0,0,0,0,0,0,0,0,0,0,0,0,0,0,0,0,0,0,0,0,0,0,0,0,0,0,0,0,0,0,0,0,0,0,0,0,0,Elias,£7.20m ,35.0,173.0,Midfielder - Central Midfield,right,Esporte Clube Bahia,16.0,2.0,0.0,736.0,35.0,5.0,4.0,2858.0,46.0,5.0,3.0,3910.0,24.0,3.0,2.0,2098.0,34.0,9.0,9.0,2847.0,15.0,3.0,0.0,1056.0,55.0,8.0,4.0,3974.0,35.0,5.0,4.0,2493.0,41.0,3.0,3.0,3354.0,LaLiga,6.0,0.0,0.0,518.0,nan,nan,nan,nan
19/6/2011,Elliott Bennett,28006433,765,12/18/1988,22,0,0,0,0,3350,5550,5900,136,111,580394,178,73,M/AM RLC,1,2,2,1,1,1,2,2,1,1,1,14,14,11,7,12,13,5,13,3,8,12,9,8,11,7,9,7,10,11,13,10,14,9,5,13,11,13,12,15,9,8,9,10,14,14,20,14,8,15,5,12,2,16,10,12,13,11,14,13,16,1,9,9,19,20,20,19,19,M/AM RLC,526,1,1,1,19,19,20,1,1,9,1,19,15,19,1,9,0,0,0,0,0,0,0,0,0,0,0,0,0,0,0,0,0,0,0,0,0,0,0,0,0,0,0,0,0,0,0,0,0,0,0,0,0,0,0,0,0,0,0,0,0,0,0,0,0,Elliott Bennett,£2.70m ,31.0,179.0,Defender - Right-Back,right,Blackburn Rovers,53.0,8.0,20.0,4571.0,37.0,1.0,7.0,2295.0,29.0,2.0,3.0,1284.0,6.0,1.0,3.0,442.0,21.0,0.0,1.0,1315.0,42.0,2.0,5.0,3091.0,31.0,4.0,2.0,2153.0,47.0,2.0,7.0,3962.0,42.0,1.0,5.0,3611.0,Premier League,42.0,0.0,4.0,2829.0,1.0,0.0,0.0,11.0
19/6/2011,Elizeu,19097681,1651,5/28/1989,22,0,0,0,0,1772,5436,5400,126,109,95103,183,78,DM/M C,2,3,1,3,2,3,1,4,1,1,1,9,10,11,9,11,7,11,11,7,13,12,11,12,12,10,12,10,12,12,10,12,15,5,7,8,13,15,14,12,12,15,12,8,14,12,20,14,16,12,11,11,6,10,11,15,5,11,10,13,13,15,1,1,18,1,1,1,18,DM/M C,311,1,1,1,1,1,1,1,1,1,20,18,1,1,1,1,0,0,0,0,0,0,0,0,0,0,0,0,0,0,0,0,0,0,0,0,0,0,0,0,0,0,0,0,0,0,0,0,0,0,0,0,0,0,0,0,0,0,0,0,0,0,0,0,0,Elizeu,£720Th. ,31.0,184.0,Defender - Centre-Back,right,Petaling Jaya City FC,nan,nan,nan,nan,21.0,1.0,0.0,1352.0,13.0,0.0,0.0,657.0,nan,nan,nan,nan,nan,nan,nan,nan,nan,nan,nan,nan,19.0,3.0,1.0,1770.0,nan,nan,nan,nan,21.0,1.0,0.0,1855.0,Liga NOS,6.0,1.0,0.0,540.0,nan,nan,nan,nan
19/6/2011,Élio,727566,788,3/26/1985,26,0,0,0,0,1517,4500,4500,100,94,138126,185,75,AM C,1,2,1,2,1,2,3,1,1,3,1,11,11,12,10,12,10,8,11,7,8,13,12,8,12,10,10,12,8,10,12,10,12,12,8,12,8,14,12,9,13,12,12,20,10,10,5,14,15,9,7,10,10,10,7,10,13,10,13,14,14,4,1,1,15,20,8,14,20,AM C,501,1,1,10,20,14,8,1,1,1,5,15,12,6,1,1,0,0,0,0,0,0,0,0,0,0,0,0,0,0,0,0,0,0,0,0,0,0,0,0,0,0,0,0,0,0,0,0,0,0,0,0,0,0,0,0,0,0,0,0,0,0,0,0,0
19/6/2011,Elias,317289,1651,5/16/1985,26,8,0,0,0,4812,7158,6758,153,141,2760019,173,70,DM/M C,2,2,3,3,3,3,2,4,2,2,1,5,11,13,13,12,5,11,14,4,14,14,14,14,14,7,14,12,13,14,14,13,16,14,7,14,15,13,15,15,14,13,8,12,13,13,20,14,13,14,6,14,6,13,5,13,15,16,13,12,12,11,1,1,20,15,10,1,20,DM/M C,421,1,1,7,15,1,1,1,1,1,18,20,1,10,1,1,1032,0,0,0,1,0,0,0,0,0,0,1,0,0,0,0,0,0,0,0,0,0,0,0,0,0,0,0,0,0,0,0,0,0,0,0,0,0,0,0,0,0,0,0,0,0,0,0,0,Elias,£7.20m ,35.0,173.0,Midfielder - Central Midfield,right,Esporte Clube Bahia,16.0,2.0,0.0,736.0,35.0,5.0,4.0,2858.0,46.0,5.0,3.0,3910.0,24.0,3.0,2.0,2098.0,34.0,9.0,9.0,2847.0,15.0,3.0,0.0,1056.0,55.0,8.0,4.0,3974.0,35.0,5.0,4.0,2493.0,41.0,3.0,3.0,3354.0,LaLiga,6.0,0.0,0.0,518.0,nan,nan,nan,nan
19/6/2011,Eliaquim Mangala,18031822,769,2/13/1991,20,0,0,9,0,4000,6000,6000,132,123,2213439,187,84,D/DM/M C,3,1,3,2,2,2,1,5,3,2,2,7,7,9,10,10,8,15,8,12,15,7,10,13,10,14,14,15,8,14,8,7,14,10,7,8,10,15,17,14,14,18,17,8,15,14,20,10,17,11,12,7,12,10,13,14,14,11,9,10,8,5,20,14,18,1,14,14,20,D/DM/M C,121,1,1,1,1,1,1,20,14,14,19,18,12,14,14,14,0,0,0,0,0,0,0,0,0,0,0,0,0,0,0,0,0,0,0,0,0,0,0,0,0,0,0,0,0,0,0,0,0,0,0,0,0,0,0,0,0,0,0,0,0,0,0,0,0,Eliaquim Mangala,£4.50m ,29.0,187.0,Defender - Centre-Back,left,Valencia CF,41.0,2.0,2.0,3356.0,14.0,1.0,0.0,1160.0,40.0,7.0,2.0,3363.0,42.0,5.0,2.0,3725.0,31.0,0.0,2.0,2728.0,33.0,0.0,1.0,2848.0,33.0,2.0,0.0,2886.0,17.0,0.0,0.0,1178.0,5.0,0.0,0.0,251.0,Liga NOS,11.0,0.0,0.0,884.0,1.0,0.0,0.0,17.0
19/6/2011,Efraín Juárez,51000041,379,2/22/1988,23,35,1,4,1,4500,7150,6500,145,130,880925,178,68,WB/DM/M RC,1,2,3,1,2,3,3,1,3,2,2,5,9,10,6,11,5,6,9,5,13,12,11,13,14,13,12,12,13,12,11,13,14,13,13,12,8,14,13,17,13,13,9,10,14,15,20,15,12,15,11,16,4,18,14,16,12,15,10,12,12,6,15,19,16,1,19,1,16,WB/DM/M RC,333,1,1,1,1,1,1,1,1,15,20,16,1,14,1,19,32,0,0,0,0,0,1,0,0,0,0,0,0,0,0,0,0,0,0,0,0,0,0,0,0,0,0,0,0,0,0,0,0,0,0,0,0,0,0,0,0,0,0,0,0,0,0,0,0,Efraín Juárez,£1.35m ,32.0,178.0,Defender - Right-Back,right,Retired,20.0,2.0,1.0,1144.0,16.0,1.0,1.0,1394.0,16.0,0.0,0.0,974.0,26.0,1.0,0.0,2138.0,30.0,0.0,1.0,2495.0,33.0,2.0,2.0,2820.0,28.0,1.0,0.0,1475.0,34.0,1.0,1.0,2406.0,21.0,0.0,4.0,1661.0,LaLiga,nan,nan,nan,nan,nan,nan,nan,nan
19/6/2011,Edu Bedia,67053077,796,3/23/1989,22,0,0,1,0,4000,5750,5750,135,112,165357,184,74,M C,2,1,3,3,1,1,3,1,3,2,2,14,13,12,13,13,14,8,11,8,8,14,13,8,15,7,12,7,13,12,15,13,9,15,8,12,8,10,10,11,13,7,11,20,11,11,12,11,6,12,7,12,8,7,10,14,11,8,15,15,10,8,1,1,20,15,1,1,20,M C,401,1,1,1,15,1,1,1,1,1,6,20,1,1,1,1,8796160131072,0,0,0,0,0,0,0,0,0,0,0,0,0,0,0,0,0,0,0,0,0,0,0,0,0,0,1,0,0,0,0,0,0,0,0,0,0,0,0,0,0,0,0,1,0,0,0,0,Edu Bedia,£450Th. ,31.0,183.0,Midfielder - Central Midfield,left,FC Goa,27.0,3.0,0.0,1290.0,14.0,0.0,1.0,965.0,34.0,5.0,8.0,2625.0,39.0,7.0,2.0,3021.0,10.0,0.0,0.0,806.0,26.0,0.0,2.0,1111.0,22.0,1.0,1.0,1259.0,21.0,1.0,2.0,1753.0,23.0,8.0,5.0,1791.0,LaLiga,13.0,1.0,2.0,529.0,nan,nan,nan,nan
19/6/2011,Édson Sitta,316806,1651,6/17/1983,28,0,0,0,0,2250,5800,5600,124,112,151521,180,77,M RC,2,1,3,2,2,1,3,1,1,1,3,11,13,12,11,11,11,11,14,12,12,11,11,12,12,13,13,12,12,11,10,13,11,12,7,13,12,13,14,11,14,11,6,8,13,11,20,13,9,15,10,12,10,15,11,13,7,12,13,12,12,11,14,15,20,8,15,10,20,M RC,403,1,1,1,5,1,8,1,10,14,15,20,7,15,5,15,290,0,1,0,0,0,1,0,0,1,0,0,0,0,0,0,0,0,0,0,0,0,0,0,0,0,0,0,0,0,0,0,0,0,0,0,0,0,0,0,0,0,0,0,0,0,0,0,0,Edson Sitta,£360Th. ,37.0,180.0,Midfielder - Defensive Midfield,right,Retired,18.0,0.0,1.0,1212.0,2.0,0.0,0.0,26.0,30.0,1.0,1.0,2522.0,31.0,1.0,0.0,2320.0,8.0,0.0,0.0,641.0,25.0,3.0,1.0,1894.0,nan,nan,nan,nan,nan,nan,nan,nan,nan,nan,nan,nan,Liga NOS,nan,nan,nan,nan,nan,nan,nan,nan
19/6/2011,Edouard Cissé,3501135,769,3/30/1978,33,0,0,15,1,4550,5700,5700,140,127,159611,186,77,DM C,3,3,1,2,1,1,3,2,1,3,3,9,10,10,7,12,9,13,10,8,11,13,13,14,12,13,17,12,16,13,10,13,12,9,10,10,15,16,13,12,12,15,13,12,15,9,20,14,14,13,13,16,7,14,10,13,15,13,17,10,13,6,8,5,15,1,10,1,15,DM C,301,1,1,1,1,1,1,8,1,5,20,15,1,10,1,5,562958543355968,0,0,0,0,0,0,1,0,0,0,0,0,0,0,0,0,0,0,0,0,0,0,0,0,0,0,0,0,0,0,0,0,0,1,0,0,0,0,0,0,0,0,0,0,0,0,0,0,Édouard Cissé,£1.13m ,42.0,185.0,Midfielder - Defensive Midfield,right,Retired,32.0,0.0,0.0,2307.0,31.0,2.0,1.0,2692.0,nan,nan,nan,nan,nan,nan,nan,nan,nan,nan,nan,nan,nan,nan,nan,nan,nan,nan,nan,nan,nan,nan,nan,nan,nan,nan,nan,nan,Ligue 1,nan,nan,nan,nan,nan,nan,nan,nan
19/6/2011,Edgar Barreto,5280189,1655,7/15/1984,26,56,3,15,3,5850,7535,6850,145,137,1130511,175,78,DM/M C,3,1,1,1,2,2,1,5,3,2,2,12,13,12,10,13,16,11,16,7,12,15,13,13,14,13,12,11,10,13,14,13,15,12,13,10,13,15,14,12,13,14,8,13,10,12,20,13,12,14,14,15,14,11,16,14,16,12,16,19,18,3,1,1,20,9,10,1,20,DM/M C,421,1,1,1,9,1,1,1,1,1,19,20,1,10,1,1,4194816,0,0,0,0,0,0,0,0,0,1,0,0,0,0,0,0,0,0,0,0,0,0,1,0,0,0,0,0,0,0,0,0,0,0,0,0,0,0,0,0,0,0,0,0,0,0,0,0,Édgar Barreto,£4.50m ,36.0,180.0,Midfielder - Central Midfield,right,NEC Nijmegen,29.0,1.0,7.0,2410.0,34.0,1.0,3.0,2925.0,32.0,0.0,0.0,2840.0,34.0,4.0,10.0,2674.0,25.0,2.0,6.0,2123.0,32.0,0.0,1.0,2345.0,33.0,2.0,0.0,2785.0,30.0,3.0,1.0,2149.0,13.0,0.0,2.0,875.0,Serie A,2.0,0.0,0.0,89.0,5.0,0.0,0.0,254.0
19/6/2011,Éderson,317312,1651,1/13/1986,25,1,0,0,0,5450,7150,6050,145,135,260585,181,74,M/AM LC,1,3,3,3,3,3,3,4,2,2,2,12,13,15,9,15,14,11,14,7,5,13,13,5,17,9,13,11,12,12,14,11,12,15,6,12,7,9,12,14,14,14,10,14,11,13,20,13,12,11,9,14,13,10,13,15,14,10,16,15,15,7,1,1,18,20,13,16,20,M/AM LC,524,1,1,10,20,16,13,1,1,1,7,18,16,13,1,1,1280,0,0,0,0,0,0,0,0,1,0,1,0,0,0,0,0,0,0,0,0,0,0,0,0,0,0,0,0,0,0,0,0,0,0,0,0,0,0,0,0,0,0,0,0,0,0,0,0,Ederson,£4.50m ,34.0,181.0,Midfielder - Attacking Midfield,right,Retired,8.0,2.0,0.0,428.0,25.0,2.0,0.0,1037.0,23.0,3.0,3.0,854.0,22.0,1.0,1.0,963.0,13.0,4.0,1.0,407.0,8.0,1.0,0.0,308.0,5.0,0.0,0.0,218.0,0.0,0.0,0.0,0.0,nan,nan,nan,nan,Ligue 1,nan,nan,nan,nan,nan,nan,nan,nan
19/6/2011,Eden Hazard,18004418,757,1/7/1991,20,20,0,0,0,6648,8058,7252,180,161,8577286,172,72,M/AM LC,1,1,3,3,1,3,1,6,3,2,1,14,13,18,10,18,13,7,13,5,3,16,13,3,18,8,12,9,13,13,15,13,10,15,6,14,7,11,12,18,16,13,6,14,16,15,20,14,12,14,8,15,7,8,15,17,15,13,12,14,14,9,1,1,16,20,14,19,20,M/AM LC,524,1,1,10,20,19,14,1,1,1,1,16,12,12,1,1,2322202918649984,0,0,0,0,0,0,0,1,0,0,0,0,0,0,0,0,0,0,0,0,1,0,0,0,0,0,0,0,0,0,0,0,0,0,0,1,0,0,0,0,0,0,0,0,0,0,1,0,Eden Hazard,£29.70m ,29.0,175.0,Forward - Left Winger,both,Real Madrid,54.0,12.0,14.0,4110.0,49.0,22.0,22.0,4193.0,62.0,13.0,24.0,4523.0,49.0,17.0,10.0,3943.0,52.0,19.0,13.0,4441.0,43.0,6.0,8.0,3079.0,43.0,17.0,7.0,3373.0,52.0,17.0,13.0,3804.0,52.0,21.0,17.0,3878.0,Ligue 1,22.0,1.0,7.0,1545.0,nan,nan,nan,nan
19/6/2011,Distel Zola,8432569,53,2/5/1989,22,0,0,0,0,2500,5084,3750,140,113,133196,182,76,DM/M C,2,3,2,2,1,3,1,3,1,2,2,6,8,11,6,11,7,13,9,6,8,12,9,11,13,12,14,14,12,12,14,12,15,9,11,7,13,14,16,11,13,13,11,6,13,12,20,15,15,14,10,14,10,8,11,14,16,14,14,14,14,6,1,1,16,12,1,1,16,DM/M C,311,1,1,1,12,1,1,1,1,1,20,16,1,1,1,1,0,0,0,0,0,0,0,0,0,0,0,0,0,0,0,0,0,0,0,0,0,0,0,0,0,0,0,0,0,0,0,0,0,0,0,0,0,0,0,0,0,0,0,0,0,0,0,0,0,Distel Zola,£360Th. ,31.0,189.0,Midfielder - Defensive Midfield,right,El Paso Locomotive FC,28.0,1.0,1.0,2170.0,17.0,1.0,1.0,1235.0,36.0,1.0,0.0,2520.0,33.0,0.0,0.0,2188.0,22.0,0.0,0.0,1491.0,3.0,0.0,0.0,138.0,16.0,0.0,1.0,939.0,nan,nan,nan,nan,27.0,0.0,0.0,2178.0,Ligue 1,11.0,0.0,0.0,460.0,nan,nan,nan,nan
19/6/2011,Diogo Melo,19019172,1651,4/18/1984,27,0,0,0,0,1000,5000,5250,110,105,106749,182,80,M C,1,2,2,2,2,3,1,1,1,2,2,12,12,12,11,14,12,10,12,10,12,13,12,10,13,7,12,9,12,12,11,12,12,12,11,12,10,12,10,9,10,12,10,8,7,9,20,12,11,12,7,10,8,10,12,12,12,11,11,12,12,7,1,1,20,10,1,1,20,M C,401,1,1,1,10,1,1,1,1,1,7,20,1,1,1,1,0,0,0,0,0,0,0,0,0,0,0,0,0,0,0,0,0,0,0,0,0,0,0,0,0,0,0,0,0,0,0,0,0,0,0,0,0,0,0,0,0,0,0,0,0,0,0,0,0,Diogo Melo,£720Th. ,36.0,182.0,Midfielder - Defensive Midfield,right,SR Almancilense,35.0,2.0,1.0,2816.0,24.0,0.0,1.0,1850.0,12.0,0.0,0.0,761.0,15.0,0.0,0.0,607.0,33.0,0.0,0.0,2371.0,17.0,0.0,0.0,1031.0,1.0,0.0,0.0,90.0,nan,nan,nan,nan,nan,nan,nan,nan,Liga NOS,nan,nan,nan,nan,nan,nan,nan,nan
19/6/2011,Diniyar Bilyaletdinov,8055577,791,2/27/1985,26,42,5,8,3,6100,7700,6900,155,140,1258979,185,79,M/AM LC,3,1,1,3,1,3,1,8,3,2,1,14,13,12,14,12,12,13,15,7,11,16,15,8,13,10,12,11,15,13,15,13,15,14,15,12,10,14,13,14,14,13,11,20,14,12,12,14,10,11,10,12,11,14,9,14,17,8,15,15,14,7,7,5,18,20,10,18,20,M/AM LC,524,1,1,1,20,17,10,1,7,1,1,15,18,5,5,1,21990233604608,0,0,0,0,0,0,0,0,0,1,0,0,0,0,0,0,0,0,0,0,1,0,0,0,0,0,0,0,0,0,0,0,0,0,0,0,0,0,0,0,0,0,1,0,1,0,0,0,Diniyar Bilyaletdinov,£5.85m ,35.0,185.0,Midfielder - Attacking Midfield,left,Retired,40.0,3.0,3.0,1763.0,12.0,0.0,1.0,726.0,19.0,3.0,1.0,1240.0,14.0,2.0,3.0,866.0,19.0,2.0,3.0,1392.0,21.0,2.0,3.0,1118.0,9.0,7.0,0.0,807.0,25.0,5.0,2.0,1996.0,5.0,1.0,1.0,433.0,Premier League,nan,nan,nan,nan,nan,nan,nan,nan
19/6/2011,Diego Estrada,80001537,366,5/25/1989,22,3,0,12,2,2035,5000,4071,119,102,37071,169,65,AM C,3,1,1,3,1,1,1,1,2,1,2,13,12,14,7,15,11,6,8,5,5,15,13,6,16,7,11,6,13,10,16,12,10,16,8,10,7,13,9,13,15,9,4,20,10,10,8,8,6,8,4,8,6,10,10,6,7,14,11,12,5,5,1,1,15,20,1,1,20,AM C,501,1,1,1,20,1,1,1,1,1,1,15,1,1,1,1,524416,0,0,0,0,0,0,0,1,0,0,0,0,0,0,0,0,0,0,0,1,0,0,0,0,0,0,0,0,0,0,0,0,0,0,0,0,0,0,0,0,0,0,0,0,0,0,0,0,Dani Estrada,£2.25m ,33.0,179.0,Defender - Right-Back,right,Barakaldo CF,21.0,1.0,1.0,1806.0,32.0,2.0,1.0,2531.0,20.0,0.0,1.0,1060.0,5.0,0.0,0.0,405.0,1.0,0.0,0.0,0.0,21.0,1.0,0.0,1133.0,19.0,2.0,2.0,1670.0,35.0,1.0,0.0,2974.0,39.0,2.0,0.0,3510.0,LaLiga,26.0,3.0,0.0,2283.0,1.0,0.0,0.0,90.0
19/6/2011,Didier Digard,917372,769,7/12/1986,24,0,0,10,0,4850,6095,6095,145,134,584355,184,81,DM C,1,2,2,3,3,3,2,1,2,2,3,12,10,9,6,11,8,13,12,7,12,13,8,14,11,15,14,16,13,13,12,14,15,6,13,9,14,14,16,14,13,15,11,8,12,13,20,15,15,13,15,15,13,15,8,15,13,14,15,13,11,9,12,10,15,8,10,1,15,DM C,301,1,1,1,8,1,1,12,1,10,20,15,1,1,1,10,8796093022724,0,0,1,0,0,0,0,0,0,1,0,0,0,0,0,0,0,0,0,0,0,0,0,0,0,0,0,0,0,0,0,0,0,0,0,0,0,0,0,0,0,0,0,1,0,0,0,0,Didier Digard,£2.70m ,34.0,183.0,Midfielder - Defensive Midfield,right,Retired,28.0,0.0,3.0,2300.0,33.0,0.0,3.0,2704.0,40.0,2.0,2.0,3428.0,35.0,2.0,1.0,2908.0,16.0,1.0,1.0,964.0,10.0,0.0,0.0,444.0,3.0,0.0,0.0,194.0,6.0,0.0,0.0,363.0,nan,nan,nan,nan,Ligue 1,nan,nan,nan,nan,nan,nan,nan,nan
19/6/2011,Dickson Etuhu,5101914,38,6/8/1982,29,17,0,0,0,5000,6500,6400,135,128,830960,188,83,M C,2,3,3,3,2,3,3,6,1,1,3,6,7,11,10,11,6,14,12,11,15,11,7,16,12,15,12,16,12,10,9,11,15,10,11,14,11,16,14,13,14,14,12,12,16,12,20,15,17,11,14,11,11,10,12,15,6,5,10,8,5,14,10,1,20,10,10,10,20,M C,401,1,10,1,10,1,1,10,1,1,15,20,10,10,1,1,137438954048,0,0,0,0,0,0,1,0,0,1,0,0,0,0,0,0,0,0,0,0,0,0,0,0,0,0,0,0,0,0,0,0,0,0,0,0,0,1,0,0,0,0,0,0,0,0,0,0,Dickson Etuhu,£1.80m ,38.0,189.0,Midfielder - Defensive Midfield,right,Retired,31.0,3.0,2.0,2203.0,34.0,0.0,0.0,1721.0,22.0,1.0,1.0,1812.0,8.0,0.0,1.0,426.0,21.0,2.0,1.0,1671.0,9.0,0.0,0.0,688.0,1.0,0.0,0.0,90.0,nan,nan,nan,nan,nan,nan,nan,nan,Premier League,nan,nan,nan,nan,nan,nan,nan,nan
19/6/2011,Dias,55013002,788,2/25/1991,20,0,0,0,0,1250,4500,4500,110,90,182386,189,79,M C,2,2,2,3,3,3,2,4,2,2,1,10,11,11,9,11,10,14,12,10,11,10,10,10,11,12,12,12,10,10,10,9,13,8,15,10,13,13,11,10,11,14,15,10,12,11,20,11,13,12,12,10,9,11,9,15,13,15,13,11,10,8,5,1,20,8,1,1,20,M C,401,1,1,1,8,1,1,5,1,1,15,20,1,1,1,1,0,0,0,0,0,0,0,0,0,0,0,0,0,0,0,0,0,0,0,0,0,0,0,0,0,0,0,0,0,0,0,0,0,0,0,0,0,0,0,0,0,0,0,0,0,0,0,0,0
19/6/2011,Dennis Aogo,8718399,771,1/14/1987,24,7,0,25,4,6350,7350,7350,149,137,3039111,184,84,D/WB/M LC,1,3,2,2,3,2,1,1,2,1,1,16,17,11,7,16,13,7,12,13,9,15,16,10,15,6,14,8,15,8,14,15,6,15,9,11,10,16,8,11,16,14,12,20,13,15,9,14,13,12,7,8,5,17,6,15,15,13,16,11,14,13,20,17,18,12,10,20,18,D/WB/M LC,124,1,1,1,12,1,1,8,20,9,14,18,14,10,17,1,4644341410695176,0,0,0,1,0,0,0,0,0,0,0,1,0,0,0,0,0,0,0,0,0,0,0,0,0,0,0,0,0,0,0,0,1,0,0,0,0,0,0,0,0,0,0,0,0,0,0,1,Dennis Aogo,£5.85m ,33.0,184.0,Midfielder - Defensive Midfield,left,Retired,20.0,0.0,1.0,1786.0,33.0,1.0,4.0,3000.0,28.0,2.0,6.0,2048.0,18.0,0.0,3.0,1447.0,32.0,1.0,3.0,2599.0,30.0,0.0,1.0,2350.0,14.0,2.0,1.0,901.0,30.0,0.0,6.0,2030.0,17.0,0.0,0.0,1243.0,Bundesliga,4.0,0.0,0.0,272.0,nan,nan,nan,nan
19/6/2011,Dejan Stankovic,3801519,802,9/11/1978,32,98,16,0,0,7100,8140,7450,175,148,2566458,181,75,DM/M/AM C,1,1,1,1,1,1,1,1,1,1,1,13,13,11,13,13,12,12,17,8,12,15,12,14,14,15,14,16,13,13,14,15,16,14,17,14,16,17,16,12,13,14,10,11,15,11,20,15,15,16,16,15,13,18,18,15,18,10,15,12,12,5,1,1,20,17,12,13,20,DM/M/AM C,431,1,1,1,17,12,11,1,1,1,18,20,13,12,1,1,549890032392,0,0,0,1,0,0,0,0,1,1,0,0,0,0,0,0,0,0,0,0,0,0,0,0,0,0,0,1,0,0,0,0,0,0,0,0,0,0,0,1,0,0,0,0,0,0,0,0,Dejan Stanković,£2.70m ,42.0,181.0,Midfielder - Central Midfield,right,Retired,40.0,9.0,6.0,2718.0,25.0,0.0,2.0,1684.0,3.0,0.0,0.0,113.0,nan,nan,nan,nan,nan,nan,nan,nan,nan,nan,nan,nan,nan,nan,nan,nan,nan,nan,nan,nan,nan,nan,nan,nan,Serie A,nan,nan,nan,nan,nan,nan,nan,nan
19/6/2011,Dean Whitehead,5101805,765,1/12/1982,29,0,0,0,0,4700,6500,6700,134,132,923077,183,77,M C,2,2,2,1,3,3,2,4,3,1,3,13,12,10,9,13,10,9,8,10,13,14,12,14,14,13,14,14,14,14,10,14,17,6,15,12,14,18,18,10,12,12,11,12,16,11,20,16,12,17,7,10,7,14,5,7,19,11,15,16,16,11,12,1,20,1,14,1,20,M C,401,1,1,1,1,1,1,1,1,12,14,20,1,14,1,1,524352,0,0,0,0,0,0,1,0,0,0,0,0,0,0,0,0,0,0,0,1,0,0,0,0,0,0,0,0,0,0,0,0,0,0,0,0,0,0,0,0,0,0,0,0,0,0,0,0,Dean Whitehead,£2.70m ,38.0,183.0,Midfielder - Central Midfield,right,Retired,43.0,2.0,1.0,3084.0,47.0,1.0,3.0,3253.0,30.0,1.0,0.0,1739.0,38.0,1.0,0.0,3106.0,25.0,0.0,0.0,1529.0,36.0,0.0,2.0,2907.0,20.0,0.0,0.0,1202.0,7.0,0.0,0.0,211.0,nan,nan,nan,nan,Premier League,nan,nan,nan,nan,nan,nan,nan,nan
19/6/2011,Dawda Bah,8750580,20,11/12/1983,27,8,2,0,0,4000,5500,5500,125,118,63241,187,74,M/AM LC,1,1,3,2,3,1,1,1,3,2,3,6,9,15,8,16,6,11,7,6,4,15,10,7,15,12,12,10,11,12,15,13,12,16,7,12,6,7,8,12,16,12,15,14,12,13,20,12,13,11,12,13,6,10,9,14,6,6,8,10,16,17,1,4,16,20,7,19,20,M/AM LC,524,1,1,14,20,19,7,1,1,1,1,16,15,7,4,4,72602127253504,0,0,0,0,0,0,0,0,0,0,0,0,0,0,1,0,1,0,0,0,0,0,0,0,0,0,0,0,0,0,0,0,0,0,0,1,0,0,0,0,0,1,0,0,0,0,1,0
19/6/2011,Davide Biondini,830705,776,1/24/1983,28,0,0,2,0,4750,6500,6500,131,130,806352,178,67,DM/M C,3,2,1,2,2,3,1,4,2,3,3,6,6,8,8,10,9,13,10,11,16,10,8,16,10,18,15,18,12,13,12,11,16,5,12,12,12,17,15,12,14,16,8,11,17,12,20,18,16,13,13,11,5,16,16,16,12,10,12,12,14,8,10,10,20,1,10,8,20,DM/M C,421,1,1,1,1,1,1,1,8,10,19,20,7,7,6,10,274877906944,0,0,0,0,0,0,0,0,0,0,0,0,0,0,0,0,0,0,0,0,0,0,0,0,0,0,0,0,0,0,0,0,0,0,0,0,0,0,1,0,0,0,0,0,0,0,0,0,Davide Biondini,£3.42m ,37.0,180.0,Midfielder - Central Midfield,right,Retired,39.0,1.0,4.0,3259.0,37.0,1.0,1.0,3033.0,25.0,0.0,1.0,1850.0,32.0,2.0,2.0,2501.0,31.0,0.0,0.0,1983.0,23.0,0.0,0.0,1197.0,22.0,0.0,1.0,1505.0,8.0,0.0,0.0,230.0,24.0,1.0,2.0,1565.0,Serie A,nan,nan,nan,nan,nan,nan,nan,nan
19/6/2011,David Zurutuza,1507535,796,8/7/1986,24,0,0,0,0,4650,6750,6750,155,140,1036675,184,70,M/AM C,3,3,2,3,3,3,2,3,2,2,1,11,12,15,11,13,10,11,11,4,5,15,10,11,17,13,13,12,16,12,16,14,15,14,14,13,8,14,15,12,12,16,9,13,12,13,20,9,12,10,6,12,12,9,14,15,18,15,14,14,7,5,1,1,19,20,9,12,20,M/AM C,521,1,1,1,20,12,9,1,1,1,9,19,10,7,1,1,4194304,0,0,0,0,0,0,0,0,0,0,0,0,0,0,0,0,0,0,0,0,0,0,1,0,0,0,0,0,0,0,0,0,0,0,0,0,0,0,0,0,0,0,0,0,0,0,0,0,David Zurutuza,£3.60m ,34.0,186.0,Midfielder - Central Midfield,right,Retired,36.0,2.0,4.0,2517.0,37.0,3.0,4.0,2773.0,22.0,2.0,4.0,1196.0,38.0,1.0,3.0,2432.0,22.0,3.0,0.0,1382.0,16.0,1.0,3.0,1128.0,37.0,3.0,1.0,3015.0,37.0,1.0,2.0,2645.0,24.0,2.0,1.0,1409.0,LaLiga,5.0,0.0,0.0,155.0,nan,nan,nan,nan
19/6/2011,David Vaughan,134968,801,2/18/1983,28,25,1,8,2,3650,6750,6900,147,138,3992898,170,66,M LC,3,3,2,1,2,3,1,8,2,1,2,15,14,14,11,13,9,13,11,7,15,17,12,16,14,13,14,15,15,12,13,12,16,14,11,12,13,14,14,10,12,15,11,20,14,12,11,14,12,18,4,15,12,13,15,16,14,13,14,15,15,3,1,1,20,12,1,15,20,M LC,404,1,1,1,1,12,1,1,1,1,15,20,15,1,1,1,524292,0,0,1,0,0,0,0,0,0,0,0,0,0,0,0,0,0,0,0,1,0,0,0,0,0,0,0,0,0,0,0,0,0,0,0,0,0,0,0,0,0,0,0,0,0,0,0,0,David Vaughan,£2.70m ,37.0,171.0,Midfielder - Defensive Midfield,left,Retired,35.0,2.0,3.0,3150.0,28.0,2.0,2.0,1830.0,32.0,1.0,0.0,1410.0,14.0,0.0,1.0,1002.0,15.0,0.0,0.0,1071.0,37.0,1.0,2.0,2972.0,33.0,1.0,2.0,2387.0,16.0,0.0,1.0,1233.0,24.0,0.0,1.0,1715.0,Premier League,nan,nan,nan,nan,nan,nan,nan,nan
19/6/2011,David Vandenbossche,3503517,769,9/27/1980,30,0,0,0,0,3600,4500,4500,118,100,53811,183,75,M RLC,1,2,1,3,3,3,3,4,2,1,2,10,10,11,6,13,12,7,14,6,5,12,12,5,13,6,12,10,10,10,13,8,9,8,10,9,7,11,12,12,11,12,11,12,9,10,20,13,13,12,6,8,14,8,5,12,13,8,13,13,11,7,1,1,20,10,16,18,20,M RLC,406,1,1,1,10,1,1,1,1,1,10,20,18,16,1,1,4194304,0,0,0,0,0,0,0,0,0,0,0,0,0,0,0,0,0,0,0,0,0,0,1,0,0,0,0,0,0,0,0,0,0,0,0,0,0,0,0,0,0,0,0,0,0,0,0,0
19/6/2011,David Timor,67067064,796,10/17/1989,21,0,0,0,0,2526,4776,4776,125,95,170140,185,77,DM/M C,1,3,3,3,3,1,1,1,3,2,2,7,5,6,5,11,8,13,6,5,13,13,8,13,9,13,11,9,11,13,9,11,10,6,8,8,13,13,14,11,10,11,14,5,12,10,20,13,14,12,9,12,6,7,7,10,12,6,9,14,9,7,1,1,18,1,1,1,18,DM/M C,311,1,1,1,1,1,1,1,1,1,20,18,1,1,1,1,0,0,0,0,0,0,0,0,0,0,0,0,0,0,0,0,0,0,0,0,0,0,0,0,0,0,0,0,0,0,0,0,0,0,0,0,0,0,0,0,0,0,0,0,0,0,0,0,0,David Timor,£720Th. ,31.0,185.0,Midfielder - Defensive Midfield,left,Getafe CF,31.0,7.0,0.0,2526.0,27.0,0.0,2.0,1053.0,19.0,1.0,3.0,1203.0,39.0,8.0,3.0,3410.0,38.0,6.0,2.0,2919.0,35.0,2.0,2.0,2754.0,25.0,2.0,1.0,1965.0,19.0,2.0,0.0,1101.0,37.0,1.0,4.0,3166.0,LaLiga,33.0,3.0,1.0,1590.0,6.0,0.0,0.0,85.0
19/6/2011,David Silva,7458280,796,1/8/1986,25,48,11,9,7,7750,8250,8400,175,168,18181818,170,67,AM RLC,2,1,2,1,2,1,1,1,3,2,2,15,16,18,13,19,12,8,12,7,5,18,13,8,19,10,13,11,17,15,19,17,15,19,10,18,8,14,11,16,18,10,5,20,11,13,11,14,7,15,9,13,13,13,13,16,13,15,11,12,13,7,1,1,15,20,15,19,20,AM RLC,506,1,1,9,20,19,15,1,1,1,4,15,13,10,1,1,2251816993554576,0,0,0,0,1,0,0,1,0,0,0,0,0,0,0,0,0,0,0,0,0,0,0,0,0,0,0,0,0,0,0,0,0,0,1,0,0,0,0,0,0,0,0,0,0,0,0,0,David Silva,£45.00m ,34.0,170.0,Midfielder - Attacking Midfield,left,Real Sociedad,53.0,6.0,14.0,3817.0,49.0,8.0,21.0,3876.0,41.0,5.0,13.0,3203.0,40.0,8.0,16.0,3043.0,42.0,12.0,14.0,3282.0,36.0,4.0,12.0,2793.0,45.0,8.0,11.0,3646.0,40.0,10.0,14.0,3198.0,50.0,10.0,14.0,3727.0,Premier League,40.0,6.0,11.0,2602.0,6.0,0.0,0.0,429.0
19/6/2011,David Pizarro,120098,1652,9/11/1979,31,36,2,0,0,6650,8500,7450,160,148,1632402,170,65,DM/M C,1,1,1,1,1,1,1,1,1,1,1,15,14,17,11,16,13,6,12,8,9,18,18,12,17,10,15,15,14,12,17,14,14,14,13,12,14,16,14,11,17,9,5,14,12,11,20,13,9,15,11,14,10,10,12,16,11,12,15,14,13,12,1,1,20,13,4,4,20,DM/M C,421,1,1,1,13,4,4,1,1,1,19,20,4,4,1,1,158330752860160,0,0,0,0,0,0,0,0,0,0,0,0,0,0,0,0,0,0,0,1,0,0,1,0,0,0,0,0,0,0,1,0,0,0,0,0,0,0,0,0,0,0,0,0,1,0,0,1,David Pizarro,£2.70m ,41.0,168.0,Midfielder - Central Midfield,right,Retired,31.0,1.0,5.0,2484.0,15.0,1.0,2.0,698.0,31.0,3.0,2.0,2688.0,42.0,1.0,5.0,3099.0,37.0,0.0,4.0,2558.0,8.0,0.0,0.0,411.0,30.0,3.0,2.0,1043.0,29.0,3.0,6.0,1759.0,nan,nan,nan,nan,Premier League,nan,nan,nan,nan,nan,nan,nan,nan
19/6/2011,David López,824344,796,9/10/1982,28,0,0,0,0,4250,6500,6500,138,135,396100,181,75,M/AM RLC,2,3,2,3,1,3,2,5,3,2,1,14,14,13,12,13,16,8,13,9,9,14,12,10,14,9,13,11,10,12,13,11,12,10,10,12,11,13,13,12,13,11,10,16,9,13,20,14,12,10,11,13,6,14,11,12,11,13,12,14,10,11,1,1,18,20,20,15,18,M/AM RLC,526,1,1,1,18,12,20,1,1,1,10,15,15,18,1,1,0,0,0,0,0,0,0,0,0,0,0,0,0,0,0,0,0,0,0,0,0,0,0,0,0,0,0,0,0,0,0,0,0,0,0,0,0,0,0,0,0,0,0,0,0,0,0,0,0,David López,£2.70m ,38.0,181.0,Midfielder - Central Midfield,right,CD Eldense,30.0,6.0,8.0,1722.0,19.0,2.0,1.0,546.0,35.0,9.0,5.0,2683.0,36.0,3.0,3.0,2146.0,41.0,3.0,5.0,2577.0,30.0,2.0,2.0,1606.0,23.0,0.0,5.0,909.0,14.0,2.0,0.0,831.0,nan,nan,nan,nan,LaLiga,nan,nan,nan,nan,nan,nan,nan,nan
19/6/2011,David Jones,5107573,765,11/4/1984,26,0,0,1,0,3800,6000,6150,131,125,571680,180,64,M C,3,3,3,2,3,3,2,5,1,1,3,16,13,9,11,12,16,10,14,2,9,14,16,10,14,10,13,11,15,13,14,13,10,14,10,10,10,15,12,11,10,14,8,20,14,12,13,12,10,14,3,12,5,10,14,14,16,11,16,14,14,3,1,1,20,12,1,14,20,M C,401,1,1,1,12,1,1,1,1,1,10,20,14,1,1,1,68720525576,0,0,0,1,0,0,0,0,1,0,0,0,0,0,0,0,0,0,0,0,1,0,0,0,0,0,0,0,0,0,0,0,0,0,0,0,1,0,0,0,0,0,0,0,0,0,0,0,David Jones,£1.35m ,35.0,183.0,Midfielder,left,Retired,17.0,2.0,1.0,1405.0,17.0,0.0,1.0,1254.0,30.0,2.0,1.0,2237.0,49.0,2.0,5.0,4326.0,38.0,0.0,0.0,3346.0,43.0,1.0,7.0,3563.0,32.0,0.0,2.0,2078.0,33.0,1.0,1.0,2291.0,2.0,0.0,0.0,101.0,Premier League,6.0,0.0,0.0,431.0,nan,nan,nan,nan
19/6/2011,David Jarolim,500126,763,5/17/1979,32,29,1,11,2,5750,6750,6650,135,132,631993,172,68,DM/M C,2,1,3,2,2,1,1,1,3,2,3,7,10,12,5,13,4,7,5,10,12,14,7,14,17,12,17,18,16,18,9,12,15,5,13,6,15,19,18,11,12,18,7,8,19,11,20,19,13,18,17,16,8,16,17,7,19,13,19,3,14,5,1,1,20,14,12,1,20,DM/M C,421,1,1,1,14,1,10,1,1,1,19,20,1,12,1,1,117440576,0,0,0,0,0,0,1,0,0,0,0,0,0,0,0,0,0,0,0,0,0,0,0,0,1,1,1,0,0,0,0,0,0,0,0,0,0,0,0,0,0,0,0,0,0,0,0,0
19/6/2011,David Hellebuyck,3503797,769,5/12/1979,32,0,0,0,0,4700,5900,5900,140,132,157689,178,73,M LC,3,1,3,3,1,3,2,2,1,2,2,14,13,13,8,14,14,7,16,8,5,14,10,8,14,8,11,13,12,13,13,13,16,12,10,11,10,15,13,14,12,13,9,20,13,12,14,15,12,14,8,14,9,12,13,14,14,13,15,14,13,7,8,8,20,14,1,17,20,M LC,404,1,1,1,1,14,1,1,8,1,12,20,17,1,8,1,768,0,0,0,0,0,0,0,0,1,1,0,0,0,0,0,0,0,0,0,0,0,0,0,0,0,0,0,0,0,0,0,0,0,0,0,0,0,0,0,0,0,0,0,0,0,0,0,0,David Hellebuyck,£630Th. ,41.0,178.0,Midfielder - Central Midfield,left,Retired,9.0,0.0,1.0,352.0,17.0,1.0,2.0,949.0,nan,nan,nan,nan,nan,nan,nan,nan,nan,nan,nan,nan,nan,nan,nan,nan,nan,nan,nan,nan,nan,nan,nan,nan,nan,nan,nan,nan,Ligue 1,nan,nan,nan,nan,nan,nan,nan,nan
19/6/2011,David Fox,5101713,765,12/13/1983,27,0,0,2,0,2615,5650,5650,130,119,547493,176,77,DM/M C,1,1,1,1,1,1,1,1,1,1,1,11,12,11,8,12,12,6,12,4,11,14,11,12,14,9,12,10,13,12,14,14,17,11,8,12,12,14,12,10,11,13,7,10,13,12,20,12,10,12,4,11,2,9,7,9,12,5,14,11,12,2,1,1,16,1,9,6,16,DM/M C,311,1,1,1,1,1,1,1,1,1,20,16,6,9,1,1,17592186568704,0,0,0,0,0,0,0,0,0,0,0,0,0,0,0,0,0,0,0,1,0,0,0,0,0,0,0,0,0,0,0,0,0,0,0,0,0,0,0,0,0,0,0,0,1,0,0,0,David Fox,£1.80m ,36.0,175.0,Midfielder - Central Midfield,right,Retired,35.0,1.0,11.0,2784.0,32.0,0.0,2.0,2280.0,10.0,1.0,1.0,725.0,12.0,0.0,1.0,1046.0,33.0,2.0,4.0,2763.0,41.0,2.0,2.0,3528.0,47.0,1.0,3.0,3920.0,48.0,1.0,4.0,3851.0,47.0,1.0,5.0,3728.0,Premier League,nan,nan,nan,nan,nan,nan,nan,nan
19/6/2011,David Edwards,5111978,801,2/3/1986,25,22,3,9,1,4400,6150,5750,130,122,637573,186,71,M/AM RC,1,1,2,1,3,2,3,5,2,2,1,8,10,13,10,13,8,11,8,2,8,14,10,12,13,10,11,10,12,12,10,14,13,13,10,15,10,14,19,12,10,14,14,10,17,13,20,16,11,13,3,12,6,9,10,15,13,10,15,15,13,1,1,1,20,18,15,1,20,M/AM RC,413,1,1,4,18,1,15,1,1,1,1,20,1,15,1,1,36,0,0,1,0,0,1,0,0,0,0,0,0,0,0,0,0,0,0,0,0,0,0,0,0,0,0,0,0,0,0,0,0,0,0,0,0,0,0,0,0,0,0,0,0,0,0,0,0,David Edwards,£1.80m ,34.0,180.0,Midfielder - Central Midfield,right,Shrewsbury Town,19.0,1.0,0.0,1203.0,30.0,4.0,2.0,2192.0,27.0,2.0,1.0,1568.0,32.0,9.0,3.0,2129.0,44.0,8.0,2.0,2992.0,30.0,5.0,2.0,2360.0,49.0,10.0,4.0,4054.0,38.0,3.0,4.0,2846.0,6.0,0.0,0.0,247.0,Premier League,37.0,4.0,0.0,2612.0,1.0,0.0,0.0,74.0
19/6/2011,David Dunn,103358,765,12/27/1979,31,1,0,20,3,5200,6750,6600,152,136,504055,178,84,AM C,3,3,1,3,2,3,2,4,3,1,1,12,12,16,14,17,8,5,14,2,5,16,14,10,16,15,14,14,16,12,17,14,16,16,16,15,9,16,11,10,14,16,8,11,10,8,20,12,13,12,13,15,19,14,7,16,19,14,4,12,12,10,1,1,15,20,12,12,20,AM C,501,1,1,5,20,12,12,1,1,1,1,15,12,10,1,1,2253998836942980,0,0,1,0,0,0,0,1,0,0,0,1,0,0,0,0,0,0,0,0,0,0,0,0,0,0,0,0,0,0,0,0,0,0,0,0,0,0,0,0,0,1,0,0,0,0,0,0,David Dunn,£1.35m ,40.0,178.0,Midfielder - Attacking Midfield,right,Retired,30.0,4.0,2.0,1598.0,28.0,2.0,2.0,1717.0,18.0,1.0,2.0,902.0,25.0,4.0,6.0,1250.0,12.0,0.0,0.0,353.0,9.0,0.0,2.0,435.0,nan,nan,nan,nan,nan,nan,nan,nan,nan,nan,nan,nan,Premier League,nan,nan,nan,nan,nan,nan,nan,nan
19/6/2011,David Albelda,108551,796,9/1/1977,33,51,0,12,1,6000,6900,6900,159,137,111700,181,77,DM/M C,1,1,1,2,1,1,1,1,3,2,1,7,8,9,6,12,7,13,13,9,13,13,7,17,10,19,16,18,12,16,10,14,16,6,19,8,16,16,18,10,10,18,11,12,14,11,20,15,14,15,18,16,13,6,12,15,19,13,16,7,6,11,9,1,16,1,9,2,16,DM/M C,311,1,1,1,1,1,1,7,2,9,20,16,1,1,1,1,137439150400,0,0,0,0,0,0,1,0,1,0,0,0,0,0,0,0,1,1,0,0,0,0,0,0,0,0,0,0,0,0,0,0,0,0,0,0,0,1,0,0,0,0,0,0,0,0,0,0,David Albelda,£1.80m ,43.0,182.0,Midfielder - Defensive Midfield,right,Retired,22.0,0.0,1.0,1580.0,34.0,0.0,0.0,2712.0,27.0,0.0,0.0,1693.0,nan,nan,nan,nan,nan,nan,nan,nan,nan,nan,nan,nan,nan,nan,nan,nan,nan,nan,nan,nan,nan,nan,nan,nan,LaLiga,nan,nan,nan,nan,nan,nan,nan,nan
19/6/2011,David Alaba,16010162,755,6/24/1992,18,10,0,5,0,5750,6250,6450,170,131,5541489,178,72,M LC,3,1,1,3,1,3,3,1,2,2,2,10,14,12,7,16,13,5,10,9,9,15,11,11,15,7,9,10,13,9,13,12,19,14,11,10,8,12,15,14,16,15,9,20,18,16,9,13,12,10,8,16,6,16,15,17,10,16,16,16,16,6,12,14,20,14,1,18,20,M LC,404,1,1,1,14,14,1,1,12,1,14,20,18,1,14,1,4194304,0,0,0,0,0,0,0,0,0,0,0,0,0,0,0,0,0,0,0,0,0,0,1,0,0,0,0,0,0,0,0,0,0,0,0,0,0,0,0,0,0,0,0,0,0,0,0,0,David Alaba,£14.40m ,28.0,180.0,Defender - Centre-Back,left,Bayern Munich,31.0,2.0,3.0,2474.0,47.0,3.0,3.0,2787.0,38.0,5.0,6.0,3195.0,49.0,4.0,9.0,4241.0,29.0,5.0,3.0,2556.0,46.0,2.0,4.0,4022.0,47.0,5.0,7.0,3799.0,36.0,2.0,6.0,2638.0,43.0,3.0,7.0,3631.0,Bundesliga,42.0,2.0,2.0,3693.0,6.0,0.0,1.0,562.0
19/6/2011,Darren Pratley,5112486,765,4/22/1985,26,0,0,0,0,2600,6000,6000,140,124,469580,186,70,M/AM C,1,2,1,3,1,1,1,1,3,1,1,6,5,6,12,11,6,9,8,6,8,12,9,10,10,14,12,13,11,13,12,12,14,11,15,13,9,12,19,13,12,12,11,10,19,11,20,18,14,18,8,16,8,13,12,14,14,14,14,14,14,8,1,1,20,18,1,1,20,M/AM C,411,1,1,1,18,1,1,1,1,1,10,20,1,1,1,1,0,0,0,0,0,0,0,0,0,0,0,0,0,0,0,0,0,0,0,0,0,0,0,0,0,0,0,0,0,0,0,0,0,0,0,0,0,0,0,0,0,0,0,0,0,0,0,0,0,Darren Pratley,£675Th. ,35.0,186.0,Midfielder - Central Midfield,right,Charlton Athletic,41.0,12.0,5.0,2983.0,33.0,2.0,1.0,1838.0,36.0,2.0,4.0,2479.0,23.0,2.0,0.0,1658.0,27.0,5.0,2.0,2001.0,39.0,4.0,1.0,3302.0,12.0,0.0,0.0,897.0,35.0,2.0,3.0,2788.0,34.0,4.0,1.0,2122.0,Premier League,36.0,2.0,1.0,2811.0,8.0,0.0,0.0,662.0
19/6/2011,Darren Fletcher,127973,793,2/1/1984,27,53,4,2,0,7260,7761,8011,163,160,6998796,183,83,M C,3,2,3,2,3,1,1,3,1,3,3,11,15,7,10,14,8,15,7,8,13,15,12,15,14,17,16,17,12,15,14,16,18,6,15,13,17,19,20,13,15,14,13,13,17,12,20,20,15,17,12,20,6,12,10,14,18,16,19,17,18,4,10,8,20,12,13,8,20,M C,401,1,1,1,12,1,10,1,1,10,14,20,8,13,1,8,2147614720,0,0,0,0,0,0,0,0,0,0,0,0,0,0,0,0,0,1,0,0,0,0,0,0,0,0,0,0,0,0,0,1,0,0,0,0,0,0,0,0,0,0,0,0,0,0,0,0,Darren Fletcher,£9.00m ,36.0,184.0,Midfielder - Central Midfield,right,Retired,39.0,3.0,7.0,2842.0,12.0,2.0,1.0,982.0,12.0,1.0,1.0,855.0,21.0,0.0,0.0,1343.0,27.0,1.0,1.0,1803.0,42.0,3.0,3.0,3795.0,40.0,2.0,3.0,3383.0,29.0,1.0,1.0,2356.0,14.0,1.0,1.0,612.0,Premier League,nan,nan,nan,nan,nan,nan,nan,nan
19/6/2011,Danny Schwarz,14950,771,5/11/1975,36,0,0,2,1,1750,4750,4750,128,91,12868,180,75,DM/M C,2,3,1,2,2,1,3,1,2,2,3,6,8,7,8,10,12,8,13,8,11,12,12,13,12,12,12,12,11,12,12,11,18,8,18,8,13,12,12,9,7,9,7,15,10,9,20,10,10,11,13,12,11,14,10,11,13,14,14,12,13,8,14,14,18,1,14,1,18,DM/M C,311,1,1,1,1,1,1,1,1,14,20,18,1,14,1,14,0,0,0,0,0,0,0,0,0,0,0,0,0,0,0,0,0,0,0,0,0,0,0,0,0,0,0,0,0,0,0,0,0,0,0,0,0,0,0,0,0,0,0,0,0,0,0,0,0
19/6/2011,Danny Murphy,2004999,765,3/18/1977,34,9,1,4,0,5150,6600,6750,145,139,357417,175,80,M/AM C,3,1,2,2,1,1,1,6,3,1,1,13,14,11,12,15,13,9,14,8,10,16,18,12,14,11,15,13,16,13,17,11,14,13,17,16,14,15,13,10,14,16,9,9,15,9,20,12,15,14,10,16,5,12,6,15,15,14,14,11,12,7,1,1,20,20,1,1,20,M/AM C,411,1,1,1,20,1,1,1,1,1,1,20,1,1,1,1,17448322048,0,0,0,0,0,0,0,0,0,0,1,0,0,0,1,0,0,0,0,0,0,0,0,0,0,0,0,0,1,0,0,0,0,0,1,0,0,0,0,0,0,0,0,0,0,0,0,0,Danny Murphy,£900Th. ,43.0,177.0,Midfielder - Central Midfield,right,Retired,42.0,2.0,5.0,3560.0,49.0,7.0,9.0,3833.0,35.0,2.0,3.0,2871.0,nan,nan,nan,nan,nan,nan,nan,nan,nan,nan,nan,nan,nan,nan,nan,nan,nan,nan,nan,nan,nan,nan,nan,nan,Premier League,nan,nan,nan,nan,nan,nan,nan,nan
19/6/2011,Danny Guthrie,5118005,765,4/18/1987,24,0,0,0,0,3250,6250,6250,144,127,617648,171,73,M C,1,3,2,3,2,3,3,4,2,2,3,14,12,12,7,14,13,9,13,5,10,15,13,12,14,11,14,10,14,11,14,13,12,10,6,13,9,15,12,10,14,16,6,11,10,11,20,14,11,10,9,13,11,12,13,13,13,9,16,14,11,7,1,1,20,5,13,5,20,M C,401,1,1,1,5,1,5,1,1,1,8,20,5,13,1,1,550829555712,0,0,0,0,0,0,0,0,0,0,0,0,0,0,0,0,0,0,0,0,0,0,0,0,0,0,0,0,0,0,1,0,0,0,0,0,0,0,0,1,0,0,0,0,0,0,0,0,Danny Guthrie,£3.60m ,33.0,176.0,Midfielder - Central Midfield,right,Walsall FC,17.0,0.0,1.0,1204.0,21.0,2.0,0.0,1556.0,26.0,1.0,1.0,1862.0,33.0,3.0,3.0,2696.0,17.0,0.0,0.0,941.0,19.0,0.0,0.0,969.0,27.0,1.0,0.0,1936.0,30.0,2.0,2.0,2685.0,nan,nan,nan,nan,Premier League,28.0,1.0,2.0,1509.0,7.0,0.0,0.0,374.0
19/6/2011,Danilo Pereira,55013032,788,9/9/1991,19,0,0,0,0,2043,5000,5000,135,100,306312,186,70,DM/M C,1,2,3,3,2,3,3,1,2,1,3,10,11,10,9,11,10,11,10,7,10,10,11,11,11,12,11,11,11,10,10,11,12,11,11,11,10,12,11,11,12,11,14,8,14,12,20,11,11,12,8,12,8,12,12,14,12,10,15,16,16,3,10,1,20,10,10,1,20,DM/M C,421,1,1,1,10,1,1,10,1,1,18,20,1,10,1,1,0,0,0,0,0,0,0,0,0,0,0,0,0,0,0,0,0,0,0,0,0,0,0,0,0,0,0,0,0,0,0,0,0,0,0,0,0,0,0,0,0,0,0,0,0,0,0,0,0,Danilo Pereira,£450Th. ,29.0,188.0,Midfielder - Defensive Midfield,right,Paris Saint-Germain,15.0,2.0,0.0,1125.0,10.0,1.0,0.0,486.0,36.0,1.0,1.0,3056.0,32.0,1.0,1.0,2611.0,38.0,3.0,1.0,3390.0,45.0,6.0,2.0,3497.0,41.0,4.0,1.0,3599.0,30.0,4.0,3.0,2435.0,43.0,3.0,1.0,3523.0,Serie A,40.0,2.0,1.0,3149.0,5.0,0.0,0.0,450.0
19/6/2011,Danijel Pranjic,652982,761,12/2/1981,29,39,0,15,1,6603,7603,7503,146,142,5845601,172,67,WB/M/AM LC,2,3,2,1,1,2,1,6,3,3,2,15,16,12,14,10,13,6,13,10,10,14,17,9,13,15,12,14,16,10,12,11,14,10,7,17,8,15,16,13,16,10,5,20,13,15,6,17,7,13,7,8,8,16,17,12,18,15,7,18,5,9,15,19,20,19,14,19,20,WB/M/AM LC,434,1,1,1,18,19,14,1,15,1,12,20,19,14,19,1,549756863521,1,0,0,0,0,1,0,0,0,0,1,0,0,0,0,0,0,0,0,0,1,0,0,0,0,0,0,0,0,0,0,0,0,0,0,0,0,0,0,1,0,0,0,0,0,0,0,0,Danijel Pranjic,£2.25m ,38.0,172.0,Defender - Left-Back,left,Omonia Psevda,40.0,0.0,7.0,2940.0,15.0,0.0,0.0,689.0,28.0,0.0,1.0,1689.0,35.0,5.0,2.0,2780.0,40.0,4.0,6.0,2931.0,33.0,0.0,3.0,2667.0,20.0,1.0,0.0,1645.0,32.0,1.0,9.0,2760.0,31.0,6.0,2.0,2406.0,Bundesliga,nan,nan,nan,nan,nan,nan,nan,nan
19/6/2011,Daniele Galloppa,7982700,776,5/15/1985,26,2,0,9,0,4600,6500,6800,145,135,1128573,182,81,M LC,1,1,1,1,3,1,3,7,3,3,3,10,14,13,12,15,12,8,13,11,11,16,15,12,16,11,12,10,13,13,14,14,15,15,13,13,13,13,16,13,12,10,9,20,11,12,10,12,10,11,10,12,14,13,8,15,14,15,11,16,12,13,1,1,20,1,1,18,20,M LC,404,1,1,1,1,1,1,1,1,1,10,20,18,1,1,1,17592186044416,0,0,0,0,0,0,0,0,0,0,0,0,0,0,0,0,0,0,0,0,0,0,0,0,0,0,0,0,0,0,0,0,0,0,0,0,0,0,0,0,0,0,0,0,1,0,0,0,Daniele Galloppa,£4.50m ,35.0,181.0,Midfielder - Central Midfield,left,Retired,12.0,0.0,0.0,487.0,31.0,1.0,2.0,2398.0,12.0,1.0,1.0,671.0,3.0,0.0,0.0,158.0,19.0,0.0,1.0,886.0,15.0,1.0,1.0,1058.0,12.0,0.0,1.0,877.0,nan,nan,nan,nan,nan,nan,nan,nan,Serie A,nan,nan,nan,nan,nan,nan,nan,nan
19/6/2011,Daniele De Rossi,829412,776,7/24/1983,27,63,10,16,3,7250,7750,7750,157,154,4527629,184,83,DM/M C,1,1,1,1,1,1,1,1,1,1,1,11,10,12,11,14,14,16,13,10,14,16,13,16,13,19,14,18,13,13,14,13,20,12,19,12,17,16,16,11,13,14,11,14,13,10,20,15,15,14,17,13,5,11,13,17,20,12,17,15,13,9,10,1,19,1,8,8,19,DM/M C,311,1,1,1,1,1,1,10,1,1,20,19,8,8,1,1,149533719789824,0,0,0,0,0,0,0,0,1,0,0,0,0,0,0,0,0,0,0,0,0,0,1,0,0,0,0,1,0,0,0,0,0,0,0,0,0,0,0,0,0,0,0,1,0,0,0,1,Daniele De Rossi,£28.80m ,37.0,184.0,Midfielder - Defensive Midfield,both,Retired,40.0,3.0,8.0,3457.0,32.0,4.0,3.0,2824.0,29.0,0.0,5.0,2143.0,36.0,1.0,1.0,3083.0,34.0,3.0,2.0,2811.0,31.0,3.0,2.0,2429.0,40.0,5.0,6.0,2994.0,32.0,2.0,2.0,2610.0,25.0,3.0,1.0,1680.0,Serie A,5.0,0.0,0.0,345.0,nan,nan,nan,nan
19/6/2011,Daniele Conti,703589,776,1/9/1979,32,0,0,1,0,4750,6900,6900,141,138,835194,178,71,DM/M C,3,1,3,2,3,3,1,4,2,2,2,12,13,11,14,13,12,16,14,4,11,14,12,14,14,18,12,14,11,13,14,12,16,10,20,10,15,15,14,10,11,15,10,14,18,11,20,14,13,15,18,15,8,12,10,8,18,14,4,10,8,11,8,1,20,1,11,1,20,DM/M C,421,1,1,1,1,1,1,8,1,1,18,20,1,11,1,1,8796093153536,0,0,0,0,0,0,0,0,1,0,0,0,0,0,0,0,0,1,0,0,0,0,0,0,0,0,0,0,0,0,0,0,0,0,0,0,0,0,0,0,0,0,0,1,0,0,0,0,Daniele Conti,£900Th. ,41.0,178.0,Midfielder - Defensive Midfield,right,Retired,29.0,5.0,3.0,2350.0,34.0,5.0,5.0,2768.0,29.0,3.0,3.0,2559.0,32.0,4.0,2.0,2878.0,21.0,2.0,2.0,1781.0,nan,nan,nan,nan,nan,nan,nan,nan,nan,nan,nan,nan,nan,nan,nan,nan,Serie A,nan,nan,nan,nan,nan,nan,nan,nan
19/6/2011,Daniel Royer,16018632,755,5/22/1990,21,2,0,5,0,1405,5459,4385,140,121,316205,177,72,M/AM RLC,1,1,1,3,2,3,3,3,1,1,3,9,13,13,10,13,10,10,11,5,11,11,7,11,14,8,9,13,9,8,11,11,10,15,8,11,12,11,11,13,14,10,11,17,14,13,20,14,12,8,6,4,9,11,7,2,9,11,7,10,9,9,1,11,20,20,20,20,20,M/AM RLC,416,1,1,1,1,20,17,1,1,1,1,20,20,20,11,11,2748780118016,0,0,0,0,0,0,0,0,0,0,0,0,0,0,0,0,0,0,0,0,1,0,0,0,0,0,0,0,0,0,0,0,0,0,0,0,0,0,0,1,0,1,0,0,0,0,0,0,Daniel Royer,£720Th. ,30.0,177.0,Forward - Left Winger,both,New York Red Bulls,41.0,5.0,7.0,3019.0,24.0,2.0,3.0,1899.0,29.0,3.0,2.0,1354.0,41.0,7.0,9.0,2656.0,36.0,7.0,5.0,2259.0,43.0,3.0,5.0,2622.0,34.0,15.0,3.0,2442.0,41.0,16.0,4.0,2899.0,37.0,14.0,8.0,2808.0,Bundesliga,18.0,4.0,2.0,1297.0,nan,nan,nan,nan
19/6/2011,Daniel Kofi Agyei,43026881,21,1/1/1992,19,0,0,0,0,1000,5500,5000,159,105,208774,181,75,DM C,2,1,1,3,2,2,3,3,3,3,2,7,6,9,7,12,6,9,9,14,14,14,5,13,13,12,15,11,12,12,10,10,18,6,8,12,10,10,12,11,12,12,9,5,15,13,20,13,12,12,8,14,5,8,18,16,17,14,16,18,14,4,1,1,15,1,1,1,15,DM C,301,1,1,1,1,1,1,1,1,1,20,15,1,1,1,1,1077936384,0,0,0,0,0,0,0,0,1,0,0,0,0,0,0,0,0,0,0,0,0,0,1,0,0,0,0,0,0,0,1,0,0,0,0,0,0,0,0,0,0,0,0,0,0,0,0,0,Daniel Kofi Agyei,£270Th. ,28.0,178.0,Midfielder - Defensive Midfield,both,Carrarese Calcio 1908,24.0,0.0,0.0,1771.0,33.0,1.0,0.0,3028.0,20.0,0.0,0.0,1143.0,20.0,0.0,0.0,1275.0,33.0,2.0,0.0,2139.0,25.0,2.0,0.0,2024.0,35.0,1.0,2.0,2617.0,30.0,1.0,0.0,2027.0,24.0,1.0,1.0,1841.0,Serie A,15.0,0.0,0.0,346.0,8.0,0.0,0.0,627.0
19/6/2011,Daniel Didavi,92012101,771,2/21/1990,21,0,0,4,0,3250,5600,5900,139,112,269183,180,77,M LC,1,1,2,3,1,3,3,3,2,2,3,13,14,12,8,13,15,7,12,4,3,14,13,7,14,7,12,7,11,11,16,11,10,14,4,12,8,13,14,12,12,13,11,20,11,11,8,12,10,10,4,10,10,8,4,12,11,7,2,14,10,18,1,1,20,15,1,20,17,M LC,404,1,1,1,1,15,1,1,1,1,1,17,20,1,1,1,256,0,0,0,0,0,0,0,0,1,0,0,0,0,0,0,0,0,0,0,0,0,0,0,0,0,0,0,0,0,0,0,0,0,0,0,0,0,0,0,0,0,0,0,0,0,0,0,0,Daniel Didavi,£2.25m ,30.0,180.0,Midfielder - Attacking Midfield,left,VfB Stuttgart,15.0,0.0,2.0,672.0,27.0,9.0,3.0,1809.0,5.0,0.0,0.0,145.0,9.0,1.0,2.0,582.0,14.0,5.0,0.0,986.0,34.0,14.0,5.0,2694.0,22.0,4.0,5.0,1235.0,33.0,10.0,7.0,2411.0,23.0,2.0,2.0,1111.0,Bundesliga,21.0,6.0,4.0,1609.0,6.0,1.0,2.0,468.0
19/6/2011,Daniel Brinkmann,8719018,771,1/29/1986,25,0,0,1,0,4000,5750,5750,122,115,420854,193,89,DM/M RC,3,3,1,3,1,2,1,2,2,2,3,14,12,13,9,14,10,9,11,10,9,12,10,13,14,13,13,12,12,9,12,13,10,13,12,13,14,13,13,11,10,15,16,7,12,12,20,12,13,12,7,12,11,9,6,11,12,11,7,10,8,7,10,12,20,13,15,1,20,DM/M RC,313,1,1,1,1,1,13,1,1,10,20,20,1,15,1,12,0,0,0,0,0,0,0,0,0,0,0,0,0,0,0,0,0,0,0,0,0,0,0,0,0,0,0,0,0,0,0,0,0,0,0,0,0,0,0,0,0,0,0,0,0,0,0,0,0,Daniel Brinkmann,£450Th. ,34.0,193.0,Midfielder - Central Midfield,right,Retired,25.0,0.0,4.0,1524.0,17.0,2.0,2.0,977.0,4.0,1.0,0.0,95.0,5.0,2.0,0.0,307.0,35.0,0.0,1.0,1821.0,7.0,0.0,0.0,630.0,15.0,0.0,0.0,800.0,26.0,3.0,5.0,1648.0,32.0,7.0,4.0,2264.0,Bundesliga,16.0,1.0,1.0,937.0,nan,nan,nan,nan
19/6/2011,Daniel Baier,8707355,771,5/18/1984,27,0,0,1,0,4600,6100,6100,127,122,594052,175,73,M/AM RC,1,3,1,2,2,1,2,6,2,1,2,14,13,13,9,13,13,10,13,12,10,14,13,13,13,13,13,11,9,10,12,11,11,13,11,9,13,13,15,13,12,11,8,12,15,12,20,13,10,11,8,13,7,16,12,13,13,10,11,12,9,10,1,12,20,20,16,1,20,M/AM RC,413,1,1,1,20,1,16,1,1,1,10,20,1,13,1,12,0,0,0,0,0,0,0,0,0,0,0,0,0,0,0,0,0,0,0,0,0,0,0,0,0,0,0,0,0,0,0,0,0,0,0,0,0,0,0,0,0,0,0,0,0,0,0,0,0,Daniel Baier,£1.58m ,36.0,176.0,Midfielder - Defensive Midfield,right,Retired,19.0,1.0,1.0,1034.0,35.0,0.0,5.0,2949.0,36.0,2.0,2.0,3212.0,37.0,0.0,2.0,3330.0,35.0,1.0,1.0,3145.0,37.0,1.0,2.0,3070.0,29.0,1.0,3.0,2579.0,30.0,0.0,2.0,2633.0,36.0,0.0,1.0,3089.0,Bundesliga,24.0,1.0,0.0,2036.0,nan,nan,nan,nan
19/6/2011,Dani Parejo,67030707,796,4/16/1989,22,0,0,3,1,5000,6900,6900,160,141,3607321,180,75,M/AM C,1,1,1,1,1,1,1,1,1,2,2,17,16,16,11,17,17,4,15,4,5,16,12,7,16,13,13,14,16,13,17,14,12,15,6,13,10,14,14,10,14,11,10,14,12,10,20,13,11,13,15,12,8,8,9,15,14,13,12,11,11,8,1,1,20,18,10,10,20,M/AM C,411,1,1,3,18,10,10,1,1,1,13,20,8,8,1,1,67111040,0,0,0,0,0,0,0,1,0,0,0,1,0,0,0,0,0,0,0,0,0,0,0,0,0,0,1,0,0,0,0,0,0,0,0,0,0,0,0,0,0,0,0,0,0,0,0,0,Dani Parejo,£5.40m ,31.0,182.0,Midfielder - Central Midfield,right,Villarreal CF,44.0,4.0,6.0,3056.0,30.0,0.0,1.0,1643.0,36.0,2.0,7.0,2679.0,46.0,5.0,7.0,3678.0,37.0,11.0,8.0,3095.0,50.0,11.0,6.0,4096.0,39.0,6.0,9.0,3419.0,42.0,8.0,10.0,3618.0,56.0,10.0,9.0,4695.0,LaLiga,47.0,10.0,6.0,4140.0,6.0,1.0,0.0,540.0
19/6/2011,Dan Gosling,29007273,765,2/1/1990,21,0,0,2,0,3500,6250,6250,150,122,2565562,178,70,D/DM/M RC,1,3,1,2,2,3,1,5,1,3,3,7,9,13,11,12,8,10,8,8,10,13,9,10,12,9,11,12,14,14,13,12,14,7,14,14,13,13,14,12,12,10,9,12,15,11,20,14,12,15,4,14,11,14,12,12,8,15,15,13,14,2,16,10,20,13,18,1,20,D/DM/M RC,333,1,1,1,10,1,13,1,1,16,20,20,1,18,1,10,17592186044482,0,1,0,0,0,0,1,0,0,0,0,0,0,0,0,0,0,0,0,0,0,0,0,0,0,0,0,0,0,0,0,0,0,0,0,0,0,0,0,0,0,0,0,0,1,0,0,0,Dan Gosling,£1.35m ,30.0,180.0,Midfielder - Central Midfield,right,AFC Bournemouth,2.0,0.0,1.0,90.0,22.0,5.0,5.0,941.0,14.0,2.0,1.0,831.0,26.0,3.0,1.0,1799.0,24.0,5.0,2.0,814.0,37.0,4.0,2.0,2595.0,30.0,3.0,1.0,1600.0,32.0,3.0,1.0,2331.0,26.0,2.0,1.0,1827.0,Premier League,25.0,3.0,1.0,1350.0,8.0,2.0,0.0,509.0
19/6/2011,Cristian Ledesma,835222,776,9/24/1982,28,1,0,0,0,6100,7400,7400,150,148,1702257,180,70,DM/M C,2,2,2,1,1,1,3,2,2,3,1,15,12,13,5,16,16,7,14,10,13,16,11,14,15,15,13,14,15,12,17,15,15,11,14,8,15,16,14,11,11,14,8,13,16,11,20,14,14,14,14,18,9,10,18,15,15,13,16,16,8,8,1,1,20,4,1,1,20,DM/M C,421,1,1,1,4,1,1,1,1,1,18,20,1,1,1,1,8796097216896,0,0,0,0,0,0,0,1,1,0,0,0,0,0,0,0,0,0,0,0,0,0,1,0,0,0,0,0,0,0,0,0,0,0,0,0,0,0,0,0,0,0,0,1,0,0,0,0,Cristian Ledesma,£10.80m ,38.0,181.0,Midfielder - Defensive Midfield,right,Retired,36.0,1.0,9.0,2825.0,47.0,3.0,8.0,3967.0,52.0,1.0,2.0,4065.0,34.0,0.0,4.0,2687.0,20.0,1.0,4.0,1141.0,nan,nan,nan,nan,34.0,4.0,4.0,2790.0,27.0,1.0,1.0,1758.0,nan,nan,nan,nan,Serie A,nan,nan,nan,nan,nan,nan,nan,nan
19/6/2011,Cristian Brocchi,706418,776,1/30/1976,35,1,0,0,0,4000,6500,6800,150,136,101817,171,75,M C,2,1,1,3,2,1,3,5,3,1,3,8,13,11,5,15,8,8,10,11,13,14,11,16,11,17,16,16,14,16,14,14,15,9,15,14,14,18,16,12,13,15,8,6,12,12,20,15,12,15,14,13,8,16,15,14,14,12,17,14,15,10,1,1,20,1,13,10,20,M C,401,1,1,1,1,1,1,1,1,1,14,20,10,13,1,1,142936512233472,0,0,0,0,0,0,0,0,0,0,0,0,0,0,0,1,1,0,0,1,0,0,0,0,0,0,0,0,0,0,0,0,0,0,0,0,0,0,0,0,0,1,0,0,0,0,0,1,Cristian Brocchi,£360Th. ,44.0,171.0,Midfielder - Central Midfield,right,Retired,33.0,0.0,2.0,2402.0,18.0,1.0,2.0,1233.0,11.0,0.0,0.0,282.0,nan,nan,nan,nan,nan,nan,nan,nan,nan,nan,nan,nan,nan,nan,nan,nan,nan,nan,nan,nan,nan,nan,nan,nan,Serie A,nan,nan,nan,nan,nan,nan,nan,nan
19/6/2011,Cristian Battocchio,43072700,1649,2/10/1992,19,0,0,0,0,1550,5450,5400,145,108,406871,160,55,M C,2,2,1,2,2,3,3,2,2,1,2,12,8,15,8,14,12,1,13,3,8,16,12,11,14,14,10,8,13,8,15,9,13,15,7,6,7,11,13,14,15,8,1,12,10,12,20,9,5,10,7,12,4,10,16,13,12,12,11,14,16,3,1,1,20,1,1,1,20,M C,401,1,1,1,1,1,1,1,1,1,15,20,1,1,1,1,4194304,0,0,0,0,0,0,0,0,0,0,0,0,0,0,0,0,0,0,0,0,0,0,1,0,0,0,0,0,0,0,0,0,0,0,0,0,0,0,0,0,0,0,0,0,0,0,0,0,Cristian Battocchio,£720Th. ,28.0,177.0,Midfielder - Central Midfield,right,Stade Brest 29,23.0,5.0,0.0,1945.0,15.0,1.0,0.0,955.0,26.0,2.0,2.0,1577.0,41.0,5.0,3.0,2557.0,32.0,0.0,3.0,2328.0,33.0,5.0,4.0,2591.0,38.0,8.0,6.0,3316.0,36.0,1.0,2.0,2297.0,14.0,2.0,3.0,648.0,Serie A,27.0,3.0,2.0,1506.0,5.0,0.0,0.0,177.0
19/6/2011,Cris,744765,788,1/17/1984,27,0,0,0,0,2010,5263,5250,110,102,113351,178,63,M C,2,2,2,3,3,1,2,1,1,2,1,12,12,12,10,12,11,10,11,9,10,11,11,10,13,13,13,11,9,10,12,12,14,13,10,14,10,13,13,12,13,10,10,7,13,13,20,11,10,13,7,11,6,14,4,13,14,13,14,15,14,8,1,1,20,10,14,7,20,M C,401,1,1,1,10,5,7,1,1,1,10,20,7,14,1,1,0,0,0,0,0,0,0,0,0,0,0,0,0,0,0,0,0,0,0,0,0,0,0,0,0,0,0,0,0,0,0,0,0,0,0,0,0,0,0,0,0,0,0,0,0,0,0,0,0,Cris,£1.35m ,43.0,183.0,Defender - Centre-Back,right,Retired,27.0,1.0,1.0,2356.0,28.0,2.0,1.0,2545.0,49.0,2.0,2.0,4063.0,nan,nan,nan,nan,nan,nan,nan,nan,nan,nan,nan,nan,nan,nan,nan,nan,nan,nan,nan,nan,nan,nan,nan,nan,Ligue 1,nan,nan,nan,nan,nan,nan,nan,nan
19/6/2011,Craig Gardner,5123512,765,11/25/1986,24,0,0,14,2,4600,6100,6100,144,129,2181818,178,72,M RC,1,2,2,1,2,1,3,5,2,3,2,14,11,11,12,12,13,8,14,9,6,12,12,12,12,18,11,18,11,12,10,12,12,12,8,14,12,14,16,14,12,14,8,11,15,12,20,17,12,12,14,9,9,14,5,14,7,12,12,7,10,6,14,1,20,14,16,14,20,M RC,403,1,1,1,14,1,1,1,1,14,1,20,14,16,1,1,35321811042560,0,0,0,0,0,0,0,0,1,0,0,0,0,0,0,0,0,0,0,0,0,0,0,0,0,0,0,0,0,0,0,0,0,0,0,0,0,1,0,0,0,0,0,0,0,1,0,0,Craig Gardner,£5.40m ,33.0,176.0,Midfielder - Central Midfield,right,Retired,37.0,10.0,0.0,2764.0,38.0,4.0,1.0,2846.0,37.0,8.0,2.0,3192.0,26.0,3.0,2.0,1271.0,38.0,3.0,5.0,2949.0,38.0,3.0,3.0,2454.0,30.0,2.0,1.0,1914.0,30.0,2.0,2.0,2067.0,22.0,1.0,1.0,768.0,Premier League,1.0,0.0,0.0,90.0,nan,nan,nan,nan
19/6/2011,Clint Dempsey,980561,390,3/9/1983,28,77,22,0,0,5850,6650,6750,145,145,1146843,185,84,AM RC,2,1,3,1,3,3,2,4,2,2,1,7,14,14,13,15,8,12,14,1,8,13,12,10,16,12,10,10,13,14,12,12,14,15,7,13,13,14,14,13,13,14,13,16,14,12,20,15,12,14,12,14,7,13,13,16,10,13,14,12,8,14,1,1,15,20,20,10,20,AM RC,503,1,1,15,20,10,20,1,1,1,1,15,10,15,1,1,2233382994216,0,0,0,1,0,1,0,0,1,0,0,0,0,0,0,0,0,0,0,0,0,0,0,0,0,0,0,0,0,0,0,0,0,0,0,1,0,0,0,0,0,1,0,0,0,0,0,0,Clint Dempsey,£13.50m ,37.0,185.0,Forward - Second Striker,right,Retired,42.0,13.0,4.0,3472.0,46.0,23.0,8.0,4098.0,55.0,13.0,8.0,3810.0,38.0,17.0,7.0,3182.0,24.0,12.0,9.0,2085.0,19.0,10.0,1.0,1610.0,33.0,15.0,4.0,2565.0,17.0,2.0,3.0,1168.0,nan,nan,nan,nan,Premier League,nan,nan,nan,nan,nan,nan,nan,nan
19/6/2011,Clément Chantôme,8444109,769,9/11/1987,23,0,0,7,0,5050,6327,6327,150,140,3850075,180,71,M C,3,3,1,3,2,2,2,8,3,3,3,13,12,13,6,15,14,9,13,9,8,14,14,12,15,14,12,16,12,13,14,14,16,12,9,13,12,17,17,14,13,14,10,10,13,12,20,17,12,15,14,16,7,10,9,15,16,14,12,10,12,8,1,1,20,15,14,10,20,M C,401,1,1,1,15,10,12,1,1,1,12,20,10,14,1,1,4195360,0,0,0,0,0,1,0,0,0,0,1,0,0,0,0,0,0,0,0,0,0,0,1,0,0,0,0,0,0,0,0,0,0,0,0,0,0,0,0,0,0,0,0,0,0,0,0,0,Clément Chantôme,£5.40m ,33.0,180.0,Midfielder - Defensive Midfield,right,AS Poissy,44.0,3.0,2.0,3652.0,21.0,0.0,3.0,1280.0,38.0,1.0,4.0,2227.0,28.0,2.0,5.0,2243.0,25.0,1.0,3.0,1509.0,35.0,2.0,2.0,2859.0,8.0,0.0,0.0,411.0,23.0,1.0,1.0,1818.0,17.0,0.0,0.0,1233.0,Ligue 1,nan,nan,nan,nan,4.0,0.0,0.0,281.0
19/6/2011,Clemens Fritz,6001338,771,12/7/1980,30,22,2,1,0,6200,6700,6700,142,135,1457288,183,81,D/WB/DM/M RC,3,3,2,2,2,1,1,2,1,1,3,9,11,9,5,12,6,8,7,14,11,13,8,15,12,10,14,14,13,15,10,12,11,5,11,9,12,17,9,12,11,16,10,14,8,17,20,13,13,9,8,12,16,16,13,13,9,12,12,15,13,7,20,20,16,12,20,12,15,D/WB/DM/M RC,133,1,1,8,1,5,12,1,12,20,16,15,5,16,5,20,1048586,0,1,0,1,0,0,0,0,0,0,0,0,0,0,0,0,0,0,0,0,1,0,0,0,0,0,0,0,0,0,0,0,0,0,0,0,0,0,0,0,0,0,0,0,0,0,0,0,Clemens Fritz,£2.70m ,39.0,183.0,Midfielder - Central Midfield,right,Retired,37.0,1.0,3.0,3291.0,33.0,1.0,4.0,2957.0,23.0,0.0,1.0,1654.0,23.0,0.0,3.0,1939.0,30.0,1.0,3.0,2554.0,33.0,1.0,4.0,2845.0,19.0,0.0,3.0,1372.0,nan,nan,nan,nan,nan,nan,nan,nan,Bundesliga,nan,nan,nan,nan,nan,nan,nan,nan
19/6/2011,Claudio Marchisio,1400716,776,1/19/1986,25,13,0,19,1,6500,7500,7350,155,147,2857735,180,71,DM/M C,3,2,1,2,2,1,2,7,1,1,3,10,13,14,14,14,6,8,14,9,9,14,15,14,14,13,15,11,14,10,14,16,12,13,15,16,14,15,13,14,14,14,10,9,13,13,20,15,13,12,6,17,7,14,7,15,12,15,12,14,14,8,1,1,20,9,11,11,20,DM/M C,421,1,1,1,8,9,1,1,1,1,18,20,11,11,1,1,549760008192,0,0,0,0,0,0,0,0,0,0,0,0,0,0,0,0,0,0,0,0,0,0,1,0,0,0,0,0,0,0,0,0,0,0,0,0,0,0,0,1,0,0,0,0,0,0,0,0,Claudio Marchisio,£20.70m ,34.0,180.0,Midfielder - Central Midfield,right,Retired,41.0,4.0,4.0,3517.0,39.0,10.0,4.0,3230.0,40.0,8.0,9.0,3401.0,43.0,4.0,2.0,2996.0,52.0,3.0,10.0,4340.0,32.0,0.0,2.0,2692.0,29.0,2.0,2.0,2043.0,20.0,0.0,1.0,1055.0,15.0,2.0,0.0,743.0,Serie A,nan,nan,nan,nan,nan,nan,nan,nan
19/6/2011,Clarence Seedorf,11946,784,4/1/1976,35,87,11,0,0,7000,7650,7350,176,150,344463,177,80,M/AM LC,2,3,1,1,3,2,1,5,2,2,1,16,14,15,14,18,14,10,16,12,11,16,14,7,18,12,15,13,17,13,15,14,15,17,18,16,11,14,12,11,14,15,8,13,15,9,20,13,13,10,8,17,8,15,20,11,14,20,13,18,14,14,1,1,18,20,14,16,20,M/AM LC,524,1,1,1,20,15,14,1,1,1,13,18,16,12,1,1,17593260835584,0,0,0,0,0,0,0,0,1,1,0,0,0,0,0,0,0,0,0,0,1,0,0,0,0,0,0,0,0,0,1,0,0,0,0,0,0,0,0,0,0,0,0,0,1,0,0,0,Clarence Seedorf,£900Th. ,44.0,176.0,Midfielder - Central Midfield,right,Retired,40.0,4.0,7.0,2832.0,56.0,12.0,9.0,3991.0,34.0,8.0,9.0,2938.0,nan,nan,nan,nan,nan,nan,nan,nan,nan,nan,nan,nan,nan,nan,nan,nan,nan,nan,nan,nan,nan,nan,nan,nan,Serie A,nan,nan,nan,nan,nan,nan,nan,nan
19/6/2011,Christoph Moritz,91018390,771,1/27/1990,21,0,0,4,0,4650,6350,6350,142,127,478893,186,73,DM/M C,3,2,3,2,1,3,2,1,3,2,1,8,12,9,6,13,6,8,9,11,9,13,8,10,14,9,16,10,15,17,11,15,12,5,12,8,13,19,17,12,13,9,13,10,11,12,20,18,10,17,6,10,14,16,6,11,10,10,13,9,14,13,10,8,18,12,10,1,18,DM/M C,311,1,1,1,12,1,1,1,1,10,20,18,1,10,1,8,0,0,0,0,0,0,0,0,0,0,0,0,0,0,0,0,0,0,0,0,0,0,0,0,0,0,0,0,0,0,0,0,0,0,0,0,0,0,0,0,0,0,0,0,0,0,0,0,0,Christoph Moritz,£2.25m ,30.0,186.0,Midfielder - Central Midfield,right,SSV Jahn Regensburg,18.0,0.0,2.0,1046.0,17.0,0.0,0.0,947.0,11.0,0.0,0.0,606.0,27.0,2.0,2.0,1840.0,13.0,1.0,0.0,840.0,10.0,0.0,0.0,389.0,29.0,1.0,2.0,2439.0,32.0,5.0,1.0,2445.0,24.0,1.0,0.0,931.0,Bundesliga,10.0,0.0,2.0,458.0,5.0,0.0,0.0,279.0
19/6/2011,Christian Träsch,35003512,771,8/1/1987,23,7,0,0,0,6300,7450,7450,151,148,9172104,180,74,D/WB/DM/M RLC,1,3,1,1,2,2,3,1,2,2,3,9,14,11,6,7,9,6,15,15,18,9,9,17,7,16,15,17,9,17,7,12,13,5,14,7,13,19,18,15,10,10,11,16,17,13,20,19,11,18,4,15,6,18,9,7,12,5,15,11,13,9,18,17,19,1,18,16,19,D/WB/DM/M RLC,346,1,1,1,1,1,1,10,16,18,20,19,12,14,15,17,154618856000,0,0,0,0,0,0,1,0,0,1,0,0,0,0,0,1,0,0,0,0,0,0,0,0,0,0,0,0,0,0,0,0,0,0,1,0,0,1,0,0,0,0,0,0,0,0,0,0,Christian Träsch,£6.30m ,33.0,180.0,Midfielder - Defensive Midfield,right,Retired,45.0,1.0,3.0,4005.0,34.0,0.0,5.0,2716.0,21.0,1.0,0.0,1079.0,26.0,0.0,2.0,2184.0,22.0,1.0,2.0,1376.0,38.0,0.0,3.0,2720.0,14.0,0.0,1.0,891.0,26.0,1.0,0.0,2166.0,11.0,0.0,0.0,758.0,Bundesliga,1.0,0.0,0.0,75.0,nan,nan,nan,nan
19/6/2011,Christian Tiffert,876257,771,2/18/1982,29,0,0,24,2,3500,6750,6750,146,140,1542591,183,75,DM/M/AM RC,1,2,2,2,3,1,2,1,2,3,1,15,14,13,11,14,14,9,12,7,12,16,9,13,14,14,15,13,11,13,14,14,12,14,11,11,13,14,17,12,13,11,11,8,14,12,20,14,12,15,9,12,6,13,11,14,13,12,12,12,12,6,1,1,20,17,18,1,20,DM/M/AM RC,433,1,1,1,16,1,17,1,1,1,17,20,1,18,1,1,0,0,0,0,0,0,0,0,0,0,0,0,0,0,0,0,0,0,0,0,0,0,0,0,0,0,0,0,0,0,0,0,0,0,0,0,0,0,0,0,0,0,0,0,0,0,0,0,0,Christian Tiffert,£1.80m ,38.0,183.0,Midfielder - Defensive Midfield,right,Retired,37.0,2.0,20.0,3312.0,51.0,3.0,7.0,4318.0,1.0,0.0,0.0,4.0,25.0,0.0,3.0,1977.0,nan,nan,nan,nan,36.0,0.0,5.0,2611.0,32.0,0.0,2.0,2865.0,36.0,0.0,7.0,3194.0,14.0,0.0,0.0,936.0,Bundesliga,nan,nan,nan,nan,nan,nan,nan,nan
19/6/2011,Christian Schulz,885274,771,4/1/1983,28,3,0,16,5,6100,6850,6850,139,137,1382097,185,80,D/WB/DM/M LC,2,3,1,3,3,1,3,2,1,2,3,10,11,11,8,11,11,12,13,17,14,12,12,14,12,15,14,13,12,11,11,13,16,8,11,10,14,17,12,12,11,14,14,20,15,13,11,16,14,16,14,13,8,17,5,15,18,9,16,13,17,9,20,18,16,10,5,20,16,D/WB/DM/M LC,134,1,1,1,1,10,1,16,20,5,19,16,14,1,18,1,0,0,0,0,0,0,0,0,0,0,0,0,0,0,0,0,0,0,0,0,0,0,0,0,0,0,0,0,0,0,0,0,0,0,0,0,0,0,0,0,0,0,0,0,0,0,0,0,0,Christian Schulz,£3.15m ,37.0,185.0,Defender - Centre-Back,left,Hannover 96 II,34.0,4.0,1.0,3061.0,39.0,1.0,0.0,2748.0,28.0,1.0,1.0,2337.0,28.0,1.0,0.0,2240.0,33.0,1.0,0.0,2825.0,27.0,2.0,1.0,2303.0,30.0,3.0,0.0,2674.0,20.0,0.0,0.0,1555.0,28.0,1.0,0.0,2421.0,Bundesliga,11.0,2.0,0.0,963.0,4.0,0.0,0.0,360.0
19/6/2011,Christian Romaric,8162110,24,6/4/1983,28,38,5,11,2,6050,7000,6700,154,141,1026391,186,86,DM/M LC,1,1,1,1,3,3,1,7,3,2,2,15,13,13,10,15,16,11,15,10,11,15,15,11,16,13,13,14,12,9,16,10,13,14,10,13,12,13,12,10,14,17,14,20,16,11,13,16,16,7,11,13,9,16,12,17,13,9,7,12,7,14,8,1,20,14,8,15,20,DM/M LC,424,1,1,4,14,12,8,8,1,1,17,20,15,1,1,1,13194139730432,0,0,0,0,0,0,0,0,0,1,0,0,0,0,0,0,1,1,0,0,0,0,0,0,0,0,0,0,0,0,0,0,0,0,0,0,0,0,0,0,0,0,1,1,0,0,0,0,Christian Pouga,£900Th. ,34.0,193.0,Forward - Centre-Forward,right,SA Mamertins,23.0,3.0,2.0,878.0,17.0,3.0,0.0,726.0,27.0,5.0,5.0,1408.0,2.0,0.0,0.0,54.0,12.0,1.0,1.0,473.0,1.0,0.0,0.0,0.0,2.0,0.0,1.0,167.0,nan,nan,nan,nan,nan,nan,nan,nan,Liga NOS,nan,nan,nan,nan,nan,nan,nan,nan
19/6/2011,Christian Poulsen,3401045,764,2/28/1980,31,83,6,8,0,6100,7000,6750,155,135,796661,182,76,DM/M C,1,3,2,3,2,3,2,2,2,2,2,8,11,8,8,13,10,14,9,13,16,14,13,13,10,12,14,13,14,16,9,14,17,5,13,13,16,16,16,13,13,16,9,12,15,11,20,16,14,15,16,14,12,12,15,17,15,12,17,4,6,6,9,8,16,1,9,1,16,DM/M C,311,1,1,1,1,1,1,9,1,7,20,16,1,9,1,8,137506291712,0,0,0,0,0,0,0,0,0,0,0,0,0,0,0,1,1,1,0,0,0,0,0,0,0,0,1,0,0,0,0,0,0,0,0,0,0,1,0,0,0,0,0,0,0,0,0,0,Christian Poulsen,£2.03m ,40.0,181.0,Midfielder - Defensive Midfield,right,Retired,22.0,0.0,0.0,1562.0,27.0,0.0,0.0,2406.0,37.0,0.0,1.0,2657.0,43.0,1.0,3.0,2299.0,21.0,1.0,1.0,1093.0,nan,nan,nan,nan,nan,nan,nan,nan,nan,nan,nan,nan,nan,nan,nan,nan,Ligue 1,nan,nan,nan,nan,nan,nan,nan,nan
19/6/2011,Christian Obodo,7980103,38,5/11/1984,27,14,3,0,0,3900,6000,5520,140,120,64271,176,72,DM/M C,3,1,1,2,2,1,3,1,3,3,1,4,6,9,10,11,8,10,13,7,12,13,8,14,10,13,12,16,14,11,14,8,11,8,8,16,11,15,14,12,11,13,11,10,9,10,20,17,13,10,14,13,15,9,16,12,16,14,16,13,15,5,1,1,20,1,10,1,20,DM/M C,421,1,1,1,1,1,1,1,1,1,18,20,1,10,1,1,1077936576,0,0,0,0,0,0,1,1,1,0,0,0,0,0,0,0,0,0,0,0,0,0,1,0,0,0,0,0,0,0,1,0,0,0,0,0,0,0,0,0,0,0,0,0,0,0,0,0,Christian Obodo,£450Th. ,36.0,180.0,Midfielder - Central Midfield,right,Without Club,17.0,2.0,1.0,1042.0,24.0,0.0,1.0,1583.0,1.0,0.0,0.0,10.0,13.0,0.0,0.0,899.0,37.0,1.0,0.0,2507.0,19.0,5.0,1.0,1710.0,29.0,2.0,1.0,2003.0,nan,nan,nan,nan,nan,nan,nan,nan,Serie A,nan,nan,nan,nan,nan,nan,nan,nan
19/6/2011,Christian Gentner,8707887,771,8/14/1985,25,5,0,11,1,5400,6850,6850,153,142,3566570,189,81,M/AM RLC,3,1,3,1,1,1,1,4,3,1,1,10,16,13,7,14,9,12,7,10,11,13,8,9,14,14,9,12,7,10,15,15,9,9,11,13,10,16,17,15,10,12,14,20,17,15,17,17,11,11,8,12,4,17,13,17,11,15,14,16,19,12,1,1,20,16,16,19,20,M/AM RLC,416,1,1,1,16,16,15,1,1,1,14,20,19,16,1,1,0,0,0,0,0,0,0,0,0,0,0,0,0,0,0,0,0,0,0,0,0,0,0,0,0,0,0,0,0,0,0,0,0,0,0,0,0,0,0,0,0,0,0,0,0,0,0,0,0,Christian Gentner,£4.50m ,35.0,189.0,Midfielder - Central Midfield,right,1.FC Union Berlin,42.0,8.0,3.0,2906.0,32.0,5.0,3.0,1735.0,52.0,9.0,8.0,4563.0,33.0,5.0,5.0,2970.0,34.0,5.0,4.0,3031.0,32.0,5.0,5.0,2816.0,36.0,7.0,4.0,3112.0,29.0,3.0,2.0,2595.0,32.0,1.0,5.0,2231.0,Bundesliga,34.0,4.0,3.0,2628.0,4.0,0.0,0.0,198.0
19/6/2011,Chris Brunt,5113355,785,12/14/1984,26,33,1,5,1,5600,7250,7250,152,139,1271357,185,74,M/AM RLC,2,2,2,2,3,1,3,7,1,1,1,15,16,11,12,13,16,13,14,8,10,15,14,10,14,10,14,12,13,12,14,13,14,12,16,13,13,15,16,12,13,14,14,20,14,12,11,14,13,14,9,15,5,15,15,14,14,11,16,14,10,3,5,9,20,20,20,20,15,M/AM RLC,416,1,1,4,15,20,20,1,5,1,10,15,20,20,9,1,44530220925696,0,0,0,0,0,0,0,0,1,1,0,0,0,0,0,0,0,0,0,0,0,0,0,0,0,0,0,0,0,0,0,0,0,0,0,0,0,0,0,1,0,0,0,1,0,1,0,0,Chris Brunt,£5.85m ,35.0,187.0,Midfielder - Central Midfield,left,Bristol City,35.0,4.0,11.0,3104.0,30.0,3.0,8.0,2427.0,34.0,3.0,10.0,2420.0,30.0,3.0,5.0,2394.0,39.0,3.0,11.0,3319.0,26.0,0.0,3.0,2012.0,33.0,4.0,4.0,2616.0,29.0,0.0,8.0,2120.0,36.0,2.0,7.0,2291.0,Premier League,16.0,0.0,0.0,849.0,5.0,0.0,0.0,213.0
19/6/2011,Chris Baird,5102412,785,2/25/1982,29,51,0,6,1,4600,6500,6500,135,135,2465047,181,75,D RC,3,3,1,3,2,3,3,3,1,3,3,5,11,8,5,13,14,13,8,11,16,13,7,15,12,11,13,15,14,13,10,14,14,9,13,14,16,15,15,12,10,12,12,5,14,12,20,15,14,15,8,14,6,16,10,9,17,15,15,13,16,1,20,8,15,1,20,10,20,D RC,103,1,1,1,1,1,1,20,10,20,15,15,1,1,1,8,283467841536,0,0,0,0,0,0,0,0,0,0,0,0,0,0,0,0,0,0,0,0,0,0,0,0,0,0,0,0,0,0,0,0,0,1,0,0,0,0,1,0,0,0,0,0,0,0,0,0,Chris Baird,£1.80m ,38.0,185.0,Midfielder - Defensive Midfield,right,Retired,31.0,2.0,2.0,2566.0,28.0,0.0,0.0,2100.0,22.0,2.0,0.0,1571.0,16.0,0.0,2.0,1178.0,24.0,0.0,1.0,1109.0,23.0,0.0,1.0,1251.0,39.0,0.0,3.0,3161.0,23.0,0.0,1.0,1977.0,nan,nan,nan,nan,Premier League,nan,nan,nan,nan,nan,nan,nan,nan
19/6/2011,Cheick Tioté,8170194,24,6/21/1986,24,14,0,0,0,5250,7000,7000,163,148,4688422,180,76,DM/M C,2,1,2,2,3,3,3,8,2,2,2,8,13,13,7,14,10,13,11,7,14,13,4,13,14,17,15,16,16,10,12,13,18,12,10,12,16,16,18,14,14,18,10,12,14,12,20,13,15,15,13,10,6,10,14,15,9,12,5,8,8,5,14,14,20,1,14,1,20,DM/M C,311,1,1,1,1,1,1,14,1,14,20,20,1,1,1,14,21743271936,0,0,0,0,0,0,0,0,0,0,0,0,0,0,0,0,0,0,0,0,0,0,0,0,0,0,0,0,1,0,0,0,1,0,1,0,0,0,0,0,0,0,0,0,0,0,0,0,Cheik Tioté,£11.25m ,nan,180.0,Midfielder - Defensive Midfield,right,---,31.0,1.0,1.0,2612.0,24.0,0.0,3.0,2044.0,31.0,0.0,1.0,2255.0,36.0,0.0,2.0,3064.0,12.0,0.0,2.0,987.0,22.0,0.0,0.0,1397.0,14.0,0.0,0.0,1105.0,nan,nan,nan,nan,nan,nan,nan,nan,Premier League,nan,nan,nan,nan,nan,nan,nan,nan
19/6/2011,Charlie Adam,5208257,793,12/10/1985,25,11,1,5,1,5500,7000,7250,152,137,6482222,186,83,M/AM C,3,2,2,1,1,2,2,2,3,3,3,16,14,14,15,15,16,15,15,10,12,16,16,10,15,16,14,13,13,11,17,9,15,16,16,13,11,15,13,10,10,14,11,20,12,9,12,14,13,15,10,15,5,14,14,15,10,18,13,12,15,2,1,1,20,16,1,13,20,M/AM C,411,1,1,1,16,5,1,1,1,1,1,20,13,1,1,1,149602300854656,0,0,0,0,0,0,0,1,1,0,0,0,0,0,0,0,0,0,0,0,0,0,0,0,0,0,0,0,0,0,0,0,0,0,0,0,1,0,0,0,0,0,0,1,0,0,0,1,Charlie Adam,£7.20m ,34.0,185.0,Midfielder - Central Midfield,left,Dundee FC,37.0,13.0,8.0,3189.0,35.0,2.0,10.0,2665.0,30.0,3.0,6.0,1941.0,35.0,9.0,4.0,1972.0,36.0,7.0,1.0,1918.0,25.0,1.0,1.0,1305.0,30.0,2.0,4.0,1920.0,17.0,1.0,1.0,902.0,20.0,1.0,1.0,938.0,Premier League,28.0,2.0,4.0,1128.0,3.0,1.0,0.0,239.0
19/6/2011,Charles Kaboré,34013978,9,2/9/1988,23,26,2,0,0,5550,6900,6200,160,138,704117,181,75,DM/M RC,3,1,2,3,2,1,2,5,3,3,2,7,8,12,6,12,6,13,13,10,11,12,10,13,13,15,16,15,13,12,10,13,16,8,13,9,14,14,17,14,13,14,10,8,17,14,20,17,15,13,14,14,5,11,15,15,15,16,13,14,16,7,15,15,20,1,15,1,20,DM/M RC,423,1,1,1,1,1,1,8,1,15,17,20,1,10,1,15,320,0,0,0,0,0,0,1,0,1,0,0,0,0,0,0,0,0,0,0,0,0,0,0,0,0,0,0,0,0,0,0,0,0,0,0,0,0,0,0,0,0,0,0,0,0,0,0,0,Charles Kaboré,£4.50m ,32.0,183.0,Midfielder - Defensive Midfield,right,Dynamo Moscow,44.0,0.0,3.0,2857.0,38.0,0.0,1.0,2061.0,39.0,0.0,5.0,3178.0,35.0,1.0,7.0,2999.0,31.0,0.0,4.0,2649.0,32.0,0.0,1.0,2770.0,33.0,1.0,2.0,2765.0,22.0,0.0,0.0,1657.0,37.0,1.0,2.0,3073.0,Ligue 1,21.0,0.0,0.0,1368.0,11.0,0.0,0.0,732.0
19/6/2011,Cesc Fàbregas,5120110,796,5/4/1987,24,58,6,11,2,8750,8750,9000,186,177,25536741,177,70,M/AM C,2,2,3,1,2,1,3,4,1,3,1,13,10,14,15,17,13,8,12,5,10,19,13,12,18,12,18,16,18,15,19,17,20,14,14,18,12,17,16,12,15,17,9,15,13,11,20,16,11,16,11,17,8,12,17,20,14,16,16,8,12,13,1,1,20,18,12,1,20,M/AM C,411,1,1,1,18,1,1,1,1,1,11,20,1,12,1,1,5898368,0,0,0,0,0,0,0,1,0,0,0,0,0,0,0,0,0,1,0,1,1,0,1,0,0,0,0,0,0,0,0,0,0,0,0,0,0,0,0,0,0,0,0,0,0,0,0,0,Cesc Fàbregas,£49.50m ,33.0,179.0,Midfielder - Central Midfield,right,AS Monaco,36.0,9.0,16.0,2544.0,48.0,15.0,20.0,3327.0,48.0,14.0,13.0,3253.0,55.0,13.0,17.0,3767.0,47.0,5.0,24.0,3923.0,49.0,6.0,9.0,3951.0,38.0,7.0,15.0,1952.0,49.0,3.0,9.0,3687.0,31.0,2.0,2.0,2083.0,LaLiga,22.0,0.0,3.0,1097.0,6.0,0.0,0.0,374.0
19/6/2011,César Peixoto,7000677,788,5/12/1980,31,1,0,3,0,2750,6150,6150,122,120,55609,182,73,D LC,2,1,3,3,1,3,3,5,3,2,2,16,16,14,12,14,16,13,16,11,11,14,14,13,15,10,14,12,11,12,14,13,15,12,9,14,13,13,13,11,14,15,12,20,10,11,5,14,14,10,9,13,13,13,12,15,12,14,14,14,14,5,20,8,15,12,1,20,15,D LC,104,1,1,1,10,12,1,1,20,1,5,15,15,1,8,1,35184372091393,1,0,0,0,0,0,0,0,0,1,0,1,0,0,0,0,0,0,0,0,0,0,0,0,0,0,0,0,0,0,0,0,0,0,0,0,0,0,0,0,0,0,0,0,0,1,0,0,César Peixoto,£900Th. ,40.0,182.0,Midfielder - Left Midfield,left,Retired,36.0,0.0,4.0,1973.0,12.0,0.0,1.0,713.0,27.0,1.0,1.0,2144.0,20.0,3.0,1.0,1555.0,6.0,0.0,1.0,346.0,nan,nan,nan,nan,nan,nan,nan,nan,nan,nan,nan,nan,nan,nan,nan,nan,Liga NOS,nan,nan,nan,nan,nan,nan,nan,nan
19/6/2011,Cédric Makiadi,8707354,53,2/23/1984,27,8,2,0,0,3750,6250,6500,136,133,626779,177,77,M C,1,3,3,3,3,3,2,5,2,3,2,7,13,14,12,11,9,8,9,8,14,13,11,13,13,13,12,11,14,13,11,11,13,11,8,13,10,15,17,14,14,12,11,11,14,14,20,13,13,13,8,14,7,14,13,14,13,12,13,13,13,6,8,9,20,14,14,10,20,M C,401,1,1,8,8,10,14,1,1,8,14,20,10,14,1,9,384,0,0,0,0,0,0,0,1,1,0,0,0,0,0,0,0,0,0,0,0,0,0,0,0,0,0,0,0,0,0,0,0,0,0,0,0,0,0,0,0,0,0,0,0,0,0,0,0,CÃ©dric Makiadi,£2.70m ,36.0,177.0,Midfielder - Central Midfield,right,Retired,35.0,0.0,4.0,2981.0,34.0,7.0,2.0,2877.0,34.0,3.0,2.0,2648.0,31.0,1.0,2.0,2426.0,19.0,0.0,0.0,743.0,28.0,0.0,2.0,2115.0,nan,nan,nan,nan,nan,nan,nan,nan,nan,nan,nan,nan,Bundesliga,nan,nan,nan,nan,nan,nan,nan,nan
19/6/2011,Cédric Barbosa,510,769,3/6/1976,35,0,0,0,0,1482,5400,5400,145,121,22336,179,67,M/AM LC,1,1,1,3,1,2,2,1,1,1,1,13,13,12,7,12,14,7,15,7,5,14,11,6,14,8,12,12,14,13,13,13,12,11,11,9,8,12,14,12,12,13,9,20,11,11,15,12,9,14,8,12,12,10,14,11,14,14,15,13,13,7,1,1,17,20,13,15,20,M/AM LC,524,1,1,1,20,15,13,1,1,1,1,17,15,13,1,1,0,0,0,0,0,0,0,0,0,0,0,0,0,0,0,0,0,0,0,0,0,0,0,0,0,0,0,0,0,0,0,0,0,0,0,0,0,0,0,0,0,0,0,0,0,0,0,0,0,Cédric Barbosa,£450Th. ,44.0,179.0,Forward - Left Winger,right,Retired,25.0,4.0,5.0,1337.0,32.0,8.0,8.0,2187.0,36.0,8.0,3.0,2514.0,30.0,1.0,6.0,1816.0,31.0,4.0,3.0,1806.0,33.0,6.0,2.0,2233.0,nan,nan,nan,nan,nan,nan,nan,nan,nan,nan,nan,nan,Ligue 1,nan,nan,nan,nan,nan,nan,nan,nan
19/6/2011,Cauê,19029503,1651,5/24/1989,22,0,0,0,0,500,5400,5450,125,111,189597,186,81,DM/M C,3,1,1,3,1,1,1,1,2,2,1,9,9,8,8,10,8,13,10,11,11,10,8,13,11,13,12,12,13,12,9,11,12,7,10,11,12,16,14,12,11,16,15,7,14,11,20,14,16,12,10,10,7,10,10,7,8,10,11,12,13,15,1,1,18,1,1,1,18,DM/M C,311,1,1,1,1,1,1,1,1,1,20,18,1,1,1,1,0,0,0,0,0,0,0,0,0,0,0,0,0,0,0,0,0,0,0,0,0,0,0,0,0,0,0,0,0,0,0,0,0,0,0,0,0,0,0,0,0,0,0,0,0,0,0,0,0,Cauê,£1.44m ,31.0,186.0,Midfielder - Defensive Midfield,right,Belenenses SAD,34.0,1.0,0.0,3064.0,35.0,5.0,0.0,3017.0,34.0,1.0,1.0,2379.0,19.0,2.0,0.0,1666.0,31.0,1.0,2.0,2397.0,26.0,0.0,1.0,1654.0,52.0,5.0,1.0,4341.0,15.0,3.0,1.0,1301.0,35.0,3.0,3.0,2780.0,Liga NOS,nan,nan,nan,nan,4.0,0.0,0.0,210.0
19/6/2011,Carlos Sánchez,78011012,1653,2/6/1986,25,8,1,0,0,5000,6750,6500,145,125,650180,182,82,DM/M C,3,3,1,1,1,1,3,1,2,2,1,8,11,11,8,13,9,13,10,6,13,12,11,12,13,14,15,14,12,11,10,13,13,8,13,9,12,16,14,13,11,15,11,10,15,12,20,16,15,13,12,14,6,10,12,13,10,13,15,15,12,10,10,1,20,5,10,1,20,DM/M C,421,1,1,1,5,1,1,10,1,1,18,20,1,10,1,1,33554688,0,0,0,0,0,0,0,0,1,0,0,0,0,0,0,0,0,0,0,0,0,0,0,0,0,1,0,0,0,0,0,0,0,0,0,0,0,0,0,0,0,0,0,0,0,0,0,0,Carlos Sánchez,£2.70m ,34.0,182.0,Midfielder - Defensive Midfield,left,Without Club,31.0,2.0,1.0,2613.0,23.0,0.0,1.0,1772.0,31.0,2.0,1.0,2320.0,31.0,0.0,1.0,2216.0,34.0,1.0,1.0,2345.0,23.0,0.0,0.0,1623.0,41.0,1.0,1.0,2714.0,25.0,1.0,0.0,1664.0,9.0,0.0,0.0,313.0,Ligue 1,10.0,0.0,1.0,428.0,nan,nan,nan,nan
19/6/2011,Carlos Martins,727974,788,4/29/1982,29,12,2,5,3,4650,6800,6800,145,136,453130,172,73,M C,1,1,1,1,3,3,3,1,1,2,2,16,14,12,13,14,16,9,18,10,9,16,16,10,14,15,14,14,7,10,16,13,15,14,12,12,11,12,12,11,12,12,10,13,10,10,20,11,11,11,13,12,13,11,10,16,10,8,9,7,6,12,1,1,20,14,10,1,20,M C,401,1,1,1,14,1,1,1,1,1,14,20,1,10,1,1,13194143744896,0,0,0,0,0,0,0,1,1,1,0,0,0,0,1,0,0,0,0,0,0,0,1,0,0,0,0,0,0,0,0,0,0,0,0,0,0,0,0,0,0,0,1,1,0,0,0,0,Carlos Martins,£4.50m ,38.0,172.0,Midfielder - Attacking Midfield,both,Retired,46.0,3.0,11.0,2569.0,29.0,3.0,6.0,2040.0,23.0,0.0,0.0,877.0,9.0,0.0,2.0,755.0,16.0,1.0,3.0,1178.0,30.0,4.0,10.0,2232.0,nan,nan,nan,nan,nan,nan,nan,nan,nan,nan,nan,nan,LaLiga,nan,nan,nan,nan,nan,nan,nan,nan
19/6/2011,Carlos Marchena,4204105,796,7/31/1979,31,62,2,17,0,6400,7550,7550,159,149,1268453,183,78,D/DM C,1,1,3,1,1,2,2,4,1,1,3,8,10,11,7,12,8,15,11,9,17,14,10,16,12,17,16,15,12,18,11,14,17,7,15,9,17,16,15,11,11,14,11,12,13,12,20,15,13,14,17,13,13,12,9,16,12,7,16,5,7,8,20,1,15,1,1,1,20,D/DM C,111,1,13,1,1,1,1,20,1,1,16,15,1,1,1,1,137439150080,0,0,0,0,0,0,0,0,0,0,0,0,0,0,0,0,1,1,0,0,0,0,0,0,0,0,0,0,0,0,0,0,0,0,0,0,0,1,0,0,0,0,0,0,0,0,0,0,Carlos Marchena,£2.70m ,41.0,182.0,Defender - Centre-Back,right,Retired,40.0,3.0,2.0,3238.0,24.0,1.0,1.0,1274.0,23.0,2.0,0.0,1872.0,23.0,3.0,0.0,1621.0,1.0,0.0,0.0,51.0,nan,nan,nan,nan,nan,nan,nan,nan,nan,nan,nan,nan,nan,nan,nan,nan,LaLiga,nan,nan,nan,nan,nan,nan,nan,nan
19/6/2011,Carlos Grossmüller,5512974,1657,5/4/1983,28,8,0,5,0,3750,4750,5950,123,110,359009,184,79,M C,2,3,1,3,2,3,1,3,3,3,2,11,13,15,12,15,12,10,12,6,10,15,14,10,13,7,11,8,11,11,15,10,8,13,9,15,12,10,8,10,12,12,10,15,16,10,20,12,12,7,14,10,11,15,4,12,12,8,8,10,6,7,1,1,20,14,14,14,20,M C,401,1,1,12,14,10,14,1,1,1,15,20,14,14,1,1,70368745227392,0,0,0,0,0,0,0,1,0,0,1,0,0,0,0,0,0,0,0,0,1,0,0,0,0,0,0,0,0,0,0,0,0,0,0,0,0,0,0,0,0,0,0,0,0,0,1,0,Carlos Grossmüller,£360Th. ,37.0,184.0,Midfielder - Central Midfield,right,Danubio FC,25.0,1.0,0.0,1528.0,14.0,2.0,2.0,913.0,17.0,0.0,5.0,1228.0,20.0,4.0,5.0,1365.0,27.0,3.0,1.0,2261.0,23.0,6.0,4.0,1638.0,26.0,3.0,2.0,1410.0,30.0,8.0,4.0,1661.0,32.0,9.0,4.0,2246.0,Serie A,4.0,0.0,0.0,76.0,nan,nan,nan,nan
19/6/2011,Carlos Carmona,8835439,1652,2/21/1987,24,23,0,0,0,5000,7040,6450,145,128,141350,178,76,DM/M C,1,1,3,3,1,2,2,8,2,3,2,9,10,9,8,12,9,10,12,10,13,14,8,15,11,15,12,12,8,14,12,14,14,9,14,8,14,15,15,13,13,12,11,9,16,13,20,16,14,15,15,15,6,10,18,13,15,12,13,15,13,8,1,1,20,1,5,5,20,DM/M C,421,1,1,1,1,1,1,1,1,1,19,20,5,5,1,1,137443147840,0,0,0,0,0,0,1,0,0,0,0,0,0,0,0,0,0,0,0,0,0,0,1,0,0,0,0,0,0,0,0,0,0,0,0,0,0,1,0,0,0,0,0,0,0,0,0,0,Carlos Carmona,£1.80m ,33.0,178.0,Midfielder - Defensive Midfield,right,CSD Colo Colo,32.0,0.0,3.0,2606.0,29.0,1.0,0.0,2045.0,23.0,2.0,2.0,1705.0,33.0,2.0,0.0,2636.0,34.0,0.0,0.0,2898.0,9.0,0.0,0.0,558.0,35.0,2.0,1.0,2996.0,29.0,1.0,3.0,2421.0,2.0,0.0,0.0,177.0,Serie A,10.0,0.0,0.0,655.0,nan,nan,nan,nan
19/6/2011,Cani,823746,796,8/3/1981,29,0,0,0,0,5155,7353,7350,152,146,1272988,180,75,M/AM RLC,3,1,2,2,1,2,1,2,2,3,3,14,15,16,12,17,11,9,14,8,6,17,13,8,17,10,13,11,15,12,17,15,14,17,12,14,7,13,11,12,14,11,10,13,13,13,20,12,10,11,11,16,8,14,12,15,10,12,13,14,11,9,1,1,18,20,19,16,20,M/AM RLC,526,1,1,10,20,16,19,1,1,1,1,15,15,18,1,1,404,0,0,1,0,1,0,0,1,1,0,0,0,0,0,0,0,0,0,0,0,0,0,0,0,0,0,0,0,0,0,0,0,0,0,0,0,0,0,0,0,0,0,0,0,0,0,0,0,Cani,£5.40m ,39.0,178.0,Midfielder - Attacking Midfield,right,Retired,53.0,10.0,6.0,3182.0,35.0,1.0,4.0,2399.0,38.0,3.0,5.0,2787.0,27.0,3.0,6.0,2065.0,20.0,2.0,4.0,960.0,19.0,0.0,0.0,900.0,32.0,1.0,3.0,2181.0,nan,nan,nan,nan,nan,nan,nan,nan,LaLiga,nan,nan,nan,nan,nan,nan,nan,nan
19/6/2011,Camel Meriem,3506532,769,10/18/1979,31,3,0,8,0,5250,5850,5850,145,130,440548,174,70,M/AM RLC,3,3,1,1,2,3,1,10,1,3,1,14,13,13,8,15,14,7,12,7,4,15,13,6,15,6,11,10,13,13,14,12,13,11,9,12,8,13,11,13,14,12,7,17,9,12,20,13,9,11,6,14,13,10,8,13,14,11,14,15,17,9,1,1,18,20,15,15,20,M/AM RLC,526,1,1,1,20,15,15,1,1,1,8,18,12,12,1,1,4194432,0,0,0,0,0,0,0,1,0,0,0,0,0,0,0,0,0,0,0,0,0,0,1,0,0,0,0,0,0,0,0,0,0,0,0,0,0,0,0,0,0,0,0,0,0,0,0,0,Camel Meriem,£540Th. ,41.0,174.0,Midfielder - Attacking Midfield,right,Retired,34.0,2.0,4.0,2612.0,23.0,0.0,3.0,1276.0,29.0,2.0,3.0,1427.0,40.0,3.0,0.0,3138.0,34.0,1.0,0.0,2432.0,nan,nan,nan,nan,nan,nan,nan,nan,nan,nan,nan,nan,nan,nan,nan,nan,Ligue 1,nan,nan,nan,nan,nan,nan,nan,nan
19/6/2011,Bruno,67040650,796,6/12/1984,27,1,0,0,0,5513,7409,7400,152,148,2330560,185,77,DM C,1,2,3,2,2,1,3,1,2,3,1,10,13,12,4,16,9,12,11,9,10,17,10,14,16,11,17,12,15,18,14,16,15,9,12,8,19,19,15,9,12,14,12,20,13,11,11,15,11,17,13,13,8,9,14,13,17,11,16,11,10,8,12,1,15,1,1,1,15,DM C,301,1,13,1,1,1,1,12,1,1,20,15,1,1,1,1,8589934656,0,0,0,0,0,0,1,0,0,0,0,0,0,0,0,0,0,0,0,0,0,0,0,0,0,0,0,0,0,0,0,0,0,1,0,0,0,0,0,0,0,0,0,0,0,0,0,0,Bruno,£1.80m ,40.0,180.0,Defender - Right-Back,right,Retired,25.0,0.0,1.0,2074.0,18.0,0.0,1.0,1179.0,31.0,1.0,6.0,2597.0,33.0,1.0,2.0,2722.0,37.0,3.0,1.0,3053.0,48.0,1.0,3.0,4236.0,42.0,0.0,5.0,3719.0,26.0,0.0,1.0,2107.0,18.0,0.0,1.0,1537.0,LaLiga,nan,nan,nan,nan,nan,nan,nan,nan
19/6/2011,Bruno Grougi,913252,769,4/26/1983,28,0,0,0,0,4500,5650,5650,130,126,470193,173,70,M/AM C,1,3,1,3,2,1,3,6,1,2,2,13,14,12,11,13,16,6,12,6,4,14,12,7,13,8,13,11,15,12,14,12,14,11,11,11,10,14,14,14,13,11,6,10,15,13,20,15,11,13,8,15,8,12,9,13,15,12,13,13,13,8,1,1,20,16,10,10,20,M/AM C,411,1,1,10,16,10,10,1,1,1,12,20,10,10,1,1,1077936132,0,0,1,0,0,0,0,0,0,0,0,0,0,0,0,0,0,0,0,0,0,0,1,0,0,0,0,0,0,0,1,0,0,0,0,0,0,0,0,0,0,0,0,0,0,0,0,0,Bruno Grougi,£3.15m ,37.0,173.0,Midfielder - Central Midfield,right,St-Pierre de Milizac,36.0,10.0,6.0,2479.0,36.0,9.0,5.0,3080.0,33.0,1.0,1.0,2199.0,33.0,9.0,2.0,2741.0,35.0,7.0,2.0,2192.0,31.0,1.0,1.0,2261.0,32.0,3.0,2.0,2276.0,23.0,3.0,0.0,1508.0,nan,nan,nan,nan,Ligue 1,nan,nan,nan,nan,nan,nan,nan,nan
19/6/2011,Bruno Gallo,19045496,1651,5/7/1988,23,0,0,0,0,1587,5350,5350,125,107,104678,182,75,D/WB/M LC,2,1,2,3,1,1,1,4,1,2,3,11,12,12,10,12,11,9,11,10,10,11,12,12,12,11,12,11,12,11,12,13,13,11,10,12,11,11,12,12,12,12,11,20,13,12,6,12,12,10,8,7,8,12,12,13,10,13,14,14,14,6,17,17,20,7,1,20,15,D/WB/M LC,434,1,1,1,1,7,1,1,17,1,1,15,20,1,17,1,0,0,0,0,0,0,0,0,0,0,0,0,0,0,0,0,0,0,0,0,0,0,0,0,0,0,0,0,0,0,0,0,0,0,0,0,0,0,0,0,0,0,0,0,0,0,0,0,0,Bruno Gallo,£720Th. ,32.0,182.0,Midfielder - Central Midfield,left,Without Club,13.0,0.0,2.0,844.0,20.0,0.0,1.0,1373.0,19.0,0.0,0.0,715.0,nan,nan,nan,nan,47.0,8.0,2.0,3524.0,6.0,0.0,0.0,272.0,1.0,0.0,0.0,19.0,20.0,4.0,0.0,1799.0,46.0,4.0,2.0,3763.0,Liga NOS,nan,nan,nan,nan,nan,nan,nan,nan
19/6/2011,Bruno Amaro,741750,788,2/17/1983,28,0,0,2,0,2250,5500,5500,114,108,430398,175,68,M C,1,1,2,2,1,3,3,4,1,1,1,15,15,11,14,12,17,10,18,10,11,13,15,12,12,16,13,14,12,12,12,12,13,12,11,15,12,15,16,11,11,11,12,5,11,11,20,13,11,13,8,11,17,12,10,13,13,12,12,11,10,7,10,1,20,1,10,1,20,M C,401,1,1,1,1,1,1,1,1,10,1,20,1,10,1,1,70866977280,0,0,0,0,0,0,0,0,0,1,0,0,0,0,1,0,0,0,0,0,0,0,0,0,0,0,0,0,0,0,0,1,0,0,0,0,1,0,0,0,0,0,0,0,0,0,0,0,Bruno Amaro,£1.35m ,37.0,181.0,Midfielder - Central Midfield,right,Retired,31.0,1.0,0.0,2242.0,29.0,4.0,1.0,2406.0,35.0,0.0,2.0,2810.0,33.0,5.0,1.0,2745.0,17.0,0.0,0.0,1072.0,nan,nan,nan,nan,nan,nan,nan,nan,nan,nan,nan,nan,nan,nan,nan,nan,Liga NOS,nan,nan,nan,nan,nan,nan,nan,nan
19/6/2011,Bradley Johnson,5133341,765,4/28/1987,24,0,0,0,0,4000,6000,6250,137,120,716034,178,69,M LC,3,3,3,2,2,1,1,2,2,1,2,11,14,12,13,12,13,16,17,6,10,13,13,10,11,14,12,11,13,14,11,12,11,12,8,12,14,16,16,13,12,13,15,20,13,13,7,16,13,11,14,12,8,13,10,15,10,12,13,8,10,9,7,7,20,12,7,17,20,M LC,404,1,1,1,1,12,1,1,7,1,1,20,17,7,7,1,131840,0,0,0,0,0,0,0,0,1,1,0,0,0,0,0,0,0,1,0,0,0,0,0,0,0,0,0,0,0,0,0,0,0,0,0,0,0,0,0,0,0,0,0,0,0,0,0,0,Bradley Johnson,£1.80m ,33.0,178.0,Midfielder - Central Midfield,right,Blackburn Rovers,49.0,6.0,4.0,3982.0,30.0,2.0,6.0,2207.0,40.0,1.0,3.0,3497.0,36.0,3.0,1.0,2798.0,45.0,15.0,2.0,3887.0,38.0,5.0,2.0,3007.0,38.0,3.0,2.0,3268.0,35.0,4.0,5.0,2530.0,34.0,2.0,4.0,2607.0,Premier League,36.0,3.0,2.0,2458.0,8.0,3.0,0.0,720.0
19/6/2011,Boy Deul,37000104,380,8/30/1987,23,0,0,0,0,2750,4900,4900,122,102,99862,178,66,M/AM RC,3,2,2,2,3,1,1,2,2,1,2,8,12,13,12,12,8,5,7,3,5,12,10,5,12,9,12,13,12,12,13,12,10,9,8,14,11,14,14,10,13,13,8,10,18,11,20,12,11,10,14,10,11,10,12,6,12,5,10,10,7,20,1,1,18,20,16,14,20,M/AM RC,523,1,1,1,20,14,16,1,1,1,1,18,10,10,1,1,0,0,0,0,0,0,0,0,0,0,0,0,0,0,0,0,0,0,0,0,0,0,0,0,0,0,0,0,0,0,0,0,0,0,0,0,0,0,0,0,0,0,0,0,0,0,0,0,0
19/6/2011,Borja Valero,7458277,796,1/12/1985,26,1,0,0,0,5750,7750,7750,160,155,3016075,176,71,M RC,1,3,2,2,2,3,1,6,1,2,3,15,14,13,10,16,12,7,11,8,9,17,12,10,16,12,17,11,15,14,17,16,11,15,13,17,12,18,14,13,14,12,8,13,14,12,20,14,10,14,11,10,5,14,7,12,12,12,18,14,14,3,1,1,20,13,17,9,20,M RC,403,1,1,1,13,1,8,1,1,1,13,20,9,17,1,1,5242896,0,0,0,0,1,0,0,0,0,0,0,0,0,0,0,0,0,0,0,0,1,0,1,0,0,0,0,0,0,0,0,0,0,0,0,0,0,0,0,0,0,0,0,0,0,0,0,0,Borja Valero,£10.80m ,35.0,175.0,Midfielder - Central Midfield,right,ACF Fiorentina,53.0,5.0,12.0,4322.0,43.0,6.0,6.0,3698.0,41.0,2.0,13.0,3627.0,47.0,7.0,11.0,3927.0,42.0,2.0,4.0,3161.0,42.0,4.0,7.0,3504.0,40.0,2.0,10.0,3192.0,37.0,2.0,0.0,2653.0,38.0,0.0,0.0,1749.0,LaLiga,25.0,3.0,0.0,1347.0,2.0,0.0,0.0,40.0
19/6/2011,Boris Leschinski,890457,771,11/7/1983,27,0,0,0,0,1000,4450,4450,95,89,27880,182,74,D/DM C,3,2,1,1,2,1,2,3,1,2,2,5,4,7,7,9,8,14,10,8,9,8,7,12,10,11,9,6,9,12,9,10,7,8,8,9,12,14,12,14,14,13,13,11,11,12,20,7,11,10,10,8,5,12,4,9,16,13,7,14,14,16,20,8,15,1,10,10,20,D/DM C,111,1,1,1,1,1,1,20,10,10,18,15,1,1,8,8,0,0,0,0,0,0,0,0,0,0,0,0,0,0,0,0,0,0,0,0,0,0,0,0,0,0,0,0,0,0,0,0,0,0,0,0,0,0,0,0,0,0,0,0,0,0,0,0,0
19/6/2011,Blerim Dzemaili,5725580,798,4/12/1986,25,13,0,0,0,3500,7500,7100,155,142,826226,179,73,DM/M C,1,2,3,1,2,3,2,4,2,1,2,8,11,12,11,15,11,10,14,12,13,16,12,15,16,11,13,13,10,12,13,13,10,8,15,15,13,16,15,13,12,14,9,8,7,12,20,16,12,13,10,14,14,16,10,6,6,6,8,13,12,17,10,1,20,1,10,10,20,DM/M C,421,1,1,1,1,1,1,10,1,1,18,20,10,10,1,1,137438953472,0,0,0,0,0,0,0,0,0,0,0,0,0,0,0,0,0,0,0,0,0,0,0,0,0,0,0,0,0,0,0,0,0,0,0,0,0,1,0,0,0,0,0,0,0,0,0,0,Blerim Dzemaili,£6.30m ,34.0,180.0,Midfielder - Central Midfield,right,Without Club,31.0,1.0,1.0,2337.0,39.0,3.0,3.0,2458.0,41.0,9.0,3.0,2512.0,29.0,6.0,4.0,1882.0,20.0,1.0,2.0,1229.0,27.0,3.0,1.0,1786.0,58.0,17.0,15.0,4885.0,15.0,1.0,1.0,1195.0,30.0,2.0,1.0,1860.0,Serie A,14.0,1.0,1.0,695.0,nan,nan,nan,nan
19/6/2011,Blaise Matuidi,8442483,769,4/9/1987,24,3,0,25,0,6513,7314,6614,160,146,5842302,175,70,DM/M C,2,2,3,1,2,1,3,4,3,2,1,6,11,12,6,12,8,7,10,8,10,13,9,17,13,12,16,14,15,13,12,14,15,8,13,8,15,16,18,15,16,13,7,20,15,13,10,18,12,16,12,14,7,14,9,14,14,14,16,16,16,5,10,10,17,1,1,10,17,DM/M C,311,1,1,1,1,1,1,10,10,1,20,17,1,1,10,1,137438953472,0,0,0,0,0,0,0,0,0,0,0,0,0,0,0,0,0,0,0,0,0,0,0,0,0,0,0,0,0,0,0,0,0,0,0,0,0,1,0,0,0,0,0,0,0,0,0,0,Blaise Matuidi,£9.00m ,33.0,175.0,Midfielder - Central Midfield,left,Inter Miami CF,37.0,0.0,2.0,3322.0,35.0,1.0,1.0,2499.0,52.0,8.0,1.0,4464.0,52.0,7.0,7.0,3769.0,53.0,5.0,5.0,3637.0,48.0,5.0,9.0,3353.0,52.0,7.0,5.0,3720.0,49.0,4.0,2.0,3257.0,42.0,3.0,3.0,3290.0,Ligue 1,57.0,1.0,2.0,3888.0,nan,nan,nan,nan
19/6/2011,Benoît Pedretti,910806,769,11/12/1980,30,22,0,9,0,5850,6500,6500,150,144,561360,177,69,DM/M C,3,1,2,3,2,1,2,2,2,2,2,15,16,12,7,15,14,8,14,8,7,17,11,11,14,13,13,13,14,14,15,15,14,11,17,8,13,17,16,11,13,13,8,12,15,12,20,18,11,15,13,14,7,7,7,14,15,14,16,11,16,6,5,1,20,1,1,1,20,DM/M C,421,1,1,1,1,1,1,5,1,1,17,20,1,1,1,1,8796097216640,0,0,0,0,0,0,0,1,0,0,0,0,0,0,0,0,0,0,0,0,0,0,1,0,0,0,0,0,0,0,0,0,0,0,0,0,0,0,0,0,0,0,0,1,0,0,0,0,Benoît Pedretti,£4.05m ,39.0,178.0,Midfielder - Defensive Midfield,right,Retired,31.0,6.0,6.0,2717.0,40.0,6.0,6.0,2892.0,41.0,2.0,5.0,2250.0,15.0,1.0,2.0,1132.0,31.0,2.0,1.0,2347.0,35.0,0.0,7.0,2492.0,26.0,1.0,2.0,1870.0,8.0,0.0,1.0,240.0,nan,nan,nan,nan,Ligue 1,nan,nan,nan,nan,nan,nan,nan,nan
19/6/2011,Benoît Cheyrou,911598,769,5/3/1981,30,0,0,15,1,5150,6524,6502,155,145,1106095,182,78,M LC,3,3,1,1,1,2,1,1,2,1,3,14,13,13,8,14,14,12,12,7,9,17,14,12,15,12,15,14,13,14,15,15,16,11,16,12,13,16,15,9,12,14,11,20,14,11,15,15,13,15,13,14,9,12,5,15,15,16,18,16,16,5,10,5,20,1,1,15,20,M LC,404,1,1,1,1,1,1,10,5,1,14,20,15,1,5,1,149533585572224,0,0,0,0,0,0,0,1,1,0,0,0,0,0,0,0,0,0,0,0,0,0,1,0,0,0,0,0,0,0,0,0,0,0,0,0,0,0,0,0,0,0,0,1,0,0,0,1,Benoît Cheyrou,£5.40m ,39.0,182.0,Midfielder - Defensive Midfield,left,Retired,46.0,3.0,11.0,3209.0,49.0,5.0,3.0,3733.0,35.0,2.0,2.0,2831.0,33.0,2.0,2.0,2247.0,31.0,2.0,2.0,2604.0,21.0,1.0,0.0,1209.0,15.0,2.0,0.0,683.0,nan,nan,nan,nan,nan,nan,nan,nan,Ligue 1,nan,nan,nan,nan,nan,nan,nan,nan
19/6/2011,Benjamin Nivet,3503500,769,1/2/1977,34,0,0,0,0,4650,5850,5850,142,130,318716,178,75,M/AM C,1,3,2,1,3,1,3,1,2,3,1,12,12,13,10,15,13,12,12,6,7,15,14,9,15,7,13,12,13,13,14,13,14,11,12,9,12,12,14,14,12,12,9,10,15,13,20,12,12,15,7,16,6,10,8,14,14,14,14,14,14,6,1,1,18,20,10,12,20,M/AM C,521,1,1,1,20,12,10,1,1,1,13,18,10,10,1,1,4194304,0,0,0,0,0,0,0,0,0,0,0,0,0,0,0,0,0,0,0,0,0,0,1,0,0,0,0,0,0,0,0,0,0,0,0,0,0,0,0,0,0,0,0,0,0,0,0,0,Benjamin Nivet,£630Th. ,43.0,178.0,Midfielder - Attacking Midfield,right,Retired,34.0,3.0,5.0,2421.0,36.0,7.0,2.0,1637.0,40.0,10.0,4.0,3123.0,41.0,10.0,9.0,2935.0,36.0,11.0,9.0,2187.0,36.0,4.0,7.0,2562.0,39.0,10.0,8.0,3233.0,29.0,4.0,2.0,1658.0,24.0,0.0,4.0,692.0,Ligue 1,nan,nan,nan,nan,nan,nan,nan,nan
19/6/2011,Benjamin Corgnet,85063843,769,4/6/1987,24,0,0,0,0,2631,5282,4070,140,117,284156,180,74,DM/M C,3,1,3,1,1,2,1,2,1,3,1,10,13,9,6,12,10,14,11,4,9,12,10,12,13,13,13,12,12,12,14,12,10,10,9,9,13,13,12,14,12,12,11,10,14,12,20,13,10,14,12,8,3,10,9,11,12,14,17,13,13,4,12,12,20,13,12,1,20,DM/M C,421,1,1,1,13,1,1,1,1,12,18,20,1,1,1,12,0,0,0,0,0,0,0,0,0,0,0,0,0,0,0,0,0,0,0,0,0,0,0,0,0,0,0,0,0,0,0,0,0,0,0,0,0,0,0,0,0,0,0,0,0,0,0,0,0,Benjamin Corgnet,£4.05m ,33.0,179.0,Midfielder - Attacking Midfield,right,Without Club,33.0,1.0,2.0,2508.0,40.0,9.0,3.0,3207.0,34.0,8.0,5.0,2576.0,33.0,7.0,2.0,2081.0,32.0,1.0,4.0,1542.0,25.0,3.0,2.0,1022.0,11.0,1.0,0.0,397.0,18.0,0.0,2.0,1380.0,20.0,1.0,3.0,917.0,Ligue 1,11.0,2.0,0.0,593.0,nan,nan,nan,nan
19/6/2011,Benjamin André,85028361,769,8/3/1990,20,0,0,6,0,2400,3650,3650,145,112,710681,177,68,M C,1,3,2,1,1,3,2,3,2,3,2,7,11,11,6,12,9,9,13,6,7,12,8,10,13,10,12,13,13,13,13,12,15,9,6,8,12,15,16,15,13,12,8,5,14,13,20,15,9,14,10,8,7,16,5,18,13,14,6,12,8,6,10,10,20,14,12,1,20,M C,401,1,1,1,14,1,1,10,1,10,12,20,1,12,1,10,0,0,0,0,0,0,0,0,0,0,0,0,0,0,0,0,0,0,0,0,0,0,0,0,0,0,0,0,0,0,0,0,0,0,0,0,0,0,0,0,0,0,0,0,0,0,0,0,0,Benjamin André,£2.03m ,30.0,180.0,Midfielder - Central Midfield,right,LOSC Lille,35.0,1.0,1.0,2524.0,34.0,4.0,4.0,2743.0,29.0,0.0,2.0,1844.0,38.0,4.0,5.0,3229.0,27.0,1.0,0.0,1763.0,34.0,1.0,3.0,2837.0,38.0,0.0,3.0,3326.0,39.0,4.0,2.0,3466.0,46.0,4.0,4.0,3956.0,Ligue 1,36.0,2.0,3.0,2819.0,8.0,0.0,0.0,673.0
19/6/2011,Beñat,7458307,796,2/19/1987,24,0,0,0,0,4565,6561,6561,145,131,678325,175,67,DM/M C,2,3,2,3,3,1,1,8,3,1,3,16,12,12,12,13,17,12,16,8,12,15,10,13,14,12,13,12,13,13,14,13,13,13,13,13,12,13,13,11,13,12,9,10,10,12,20,12,11,15,6,15,8,10,11,15,13,14,14,10,13,5,5,1,20,5,1,1,20,DM/M C,421,1,1,1,5,1,1,5,1,1,17,20,1,1,1,1,67109120,0,0,0,0,0,0,0,0,1,0,0,0,0,0,0,0,0,0,0,0,0,0,0,0,0,0,1,0,0,0,0,0,0,0,0,0,0,0,0,0,0,0,0,0,0,0,0,0
19/6/2011,Ben Watson,5113515,765,7/9/1985,25,0,0,1,0,4400,6300,6500,143,126,867359,178,69,M C,3,1,2,3,3,1,2,1,3,3,2,13,11,12,10,14,13,10,13,7,11,18,16,11,13,13,13,15,14,11,12,12,13,15,10,13,12,13,14,12,12,15,11,8,12,12,20,13,11,15,12,12,6,8,10,13,13,10,14,13,13,11,1,1,20,14,1,1,20,M C,401,1,1,1,14,1,1,1,1,1,11,20,1,1,1,1,8796160131200,0,0,0,0,0,0,0,1,0,0,0,0,0,0,0,0,0,0,0,0,0,0,0,0,0,0,1,0,0,0,0,0,0,0,0,0,0,0,0,0,0,0,0,1,0,0,0,0,Ben Watson,£2.70m ,35.0,178.0,Midfielder - Central Midfield,right,Charlton Athletic,36.0,4.0,2.0,2751.0,24.0,4.0,4.0,1465.0,15.0,2.0,3.0,842.0,33.0,5.0,4.0,2549.0,30.0,1.0,2.0,2333.0,41.0,1.0,3.0,3355.0,6.0,0.0,0.0,261.0,25.0,0.0,0.0,1880.0,21.0,0.0,0.0,1562.0,Premier League,45.0,3.0,4.0,4001.0,5.0,0.0,0.0,359.0
19/6/2011,Bastian Schweinsteiger,890618,771,8/1/1984,26,87,21,7,2,8505,9005,9005,167,165,36636653,181,77,DM/M C,2,2,2,2,3,3,1,6,3,2,1,12,13,13,12,16,12,9,15,10,11,17,15,15,17,11,15,16,19,15,12,13,12,10,11,15,13,19,17,12,15,19,10,10,19,12,20,18,13,14,8,16,2,15,4,6,19,16,14,15,12,12,3,11,20,15,14,14,20,DM/M C,421,1,1,1,15,14,14,1,3,1,19,20,14,14,11,7,140737560182784,0,0,0,0,0,0,0,0,0,0,0,0,0,0,0,0,0,0,0,1,0,0,1,0,0,0,1,0,0,0,0,0,0,0,0,0,0,0,0,0,0,0,0,0,0,0,0,1,Bastian Schweinsteiger,£31.50m ,36.0,183.0,Midfielder - Central Midfield,right,Retired,45.0,8.0,10.0,3847.0,36.0,5.0,5.0,2764.0,45.0,9.0,11.0,3672.0,36.0,8.0,5.0,2671.0,28.0,5.0,8.0,1938.0,31.0,1.0,1.0,1967.0,30.0,4.0,3.0,2273.0,35.0,4.0,6.0,3045.0,31.0,1.0,3.0,2708.0,Bundesliga,nan,nan,nan,nan,nan,nan,nan,nan
19/6/2011,Barry Bannan,29010507,793,12/1/1989,21,5,0,10,1,4000,6250,6750,150,119,1023631,170,60,M LC,2,2,1,3,1,3,2,4,1,1,1,11,14,13,10,14,11,6,11,3,4,15,15,8,14,11,11,11,14,10,15,12,13,14,4,13,9,12,12,16,13,14,6,20,14,12,7,12,5,14,5,10,3,15,10,14,12,16,10,10,12,4,1,1,20,14,13,16,20,M LC,404,1,1,1,10,14,11,1,1,1,1,20,16,13,1,1,10995120472064,0,0,0,0,0,0,0,0,0,0,0,0,0,0,0,0,0,0,0,0,0,0,1,0,0,0,0,0,0,0,0,0,0,0,0,0,0,0,0,0,0,1,0,1,0,0,0,0,Barry Bannan,£4.50m ,30.0,169.0,Midfielder - Central Midfield,left,Sheffield Wednesday,30.0,4.0,5.0,1804.0,38.0,4.0,6.0,2070.0,30.0,0.0,2.0,2122.0,17.0,1.0,2.0,1174.0,26.0,0.0,5.0,1808.0,41.0,3.0,2.0,3566.0,46.0,1.0,8.0,3942.0,31.0,1.0,3.0,2636.0,45.0,4.0,12.0,3952.0,Premier League,46.0,2.0,8.0,3963.0,8.0,1.0,0.0,720.0
19/6/2011,Bakaye Traoré,8434273,31,3/6/1985,26,10,1,0,0,4850,6000,5400,135,120,324733,185,74,DM/M C,2,2,2,2,2,3,2,1,2,2,2,7,12,13,10,12,7,14,11,8,10,11,13,10,13,10,13,14,13,13,12,12,14,11,9,12,10,13,14,15,11,14,12,8,15,12,20,15,12,14,10,15,6,15,9,14,15,12,11,14,14,6,1,1,20,14,14,10,20,DM/M C,421,1,1,1,10,10,14,1,1,1,16,20,10,14,1,1,0,0,0,0,0,0,0,0,0,0,0,0,0,0,0,0,0,0,0,0,0,0,0,0,0,0,0,0,0,0,0,0,0,0,0,0,0,0,0,0,0,0,0,0,0,0,0,0,0,Bakaye Traoré,£2.70m ,35.0,186.0,Midfielder - Central Midfield,right,Without Club,33.0,5.0,3.0,2051.0,23.0,5.0,2.0,1738.0,9.0,0.0,0.0,144.0,27.0,1.0,5.0,2015.0,18.0,2.0,2.0,866.0,13.0,3.0,0.0,974.0,nan,nan,nan,nan,nan,nan,nan,nan,nan,nan,nan,nan,Ligue 1,nan,nan,nan,nan,nan,nan,nan,nan
19/6/2011,Axel Witsel,8169215,757,1/12/1989,22,19,5,12,0,6500,7000,7100,165,142,6324111,183,73,M C,2,1,1,1,3,2,3,2,3,3,3,10,12,14,12,15,11,13,12,8,8,14,18,5,15,11,14,11,14,16,14,15,13,15,9,16,15,16,15,13,11,14,10,10,15,15,20,12,10,15,14,15,9,17,14,15,12,10,14,9,11,6,9,1,20,13,13,12,20,M C,401,1,1,10,12,11,13,9,1,1,14,20,12,13,1,1,549755813888,0,0,0,0,0,0,0,0,0,0,0,0,0,0,0,0,0,0,0,0,0,0,0,0,0,0,0,0,0,0,0,0,0,0,0,0,0,0,0,1,0,0,0,0,0,0,0,0,Axel Witsel,£12.60m ,31.0,188.0,Midfielder - Defensive Midfield,right,Borussia Dortmund,43.0,12.0,6.0,3816.0,49.0,5.0,6.0,3911.0,34.0,5.0,1.0,2845.0,43.0,4.0,4.0,3624.0,42.0,6.0,1.0,3495.0,41.0,6.0,5.0,3600.0,52.0,5.0,6.0,4467.0,18.0,2.0,1.0,1645.0,43.0,6.0,1.0,3703.0,Liga NOS,39.0,4.0,5.0,3216.0,7.0,0.0,0.0,552.0
19/6/2011,Asier Illarramendi,67039257,796,3/8/1990,21,0,0,0,0,3668,6029,6029,149,126,324913,177,74,M C,2,1,3,2,1,1,3,1,1,1,1,13,10,11,10,13,14,7,10,3,11,14,7,11,13,7,11,12,13,13,13,13,12,12,13,12,13,18,15,12,12,12,9,12,11,13,20,14,10,12,7,10,5,10,11,13,15,12,15,14,13,18,1,1,20,14,1,1,20,M C,401,1,1,1,14,1,1,1,1,1,15,20,1,1,1,1,0,0,0,0,0,0,0,0,0,0,0,0,0,0,0,0,0,0,0,0,0,0,0,0,0,0,0,0,0,0,0,0,0,0,0,0,0,0,0,0,0,0,0,0,0,0,0,0,0,Asier Illarramendi,£1.08m ,30.0,179.0,Midfielder - Defensive Midfield,right,Real Sociedad,31.0,3.0,0.0,2348.0,18.0,0.0,1.0,1405.0,34.0,0.0,1.0,2836.0,49.0,3.0,1.0,2506.0,41.0,0.0,0.0,1721.0,35.0,1.0,2.0,2990.0,39.0,1.0,4.0,3454.0,44.0,7.0,6.0,3738.0,26.0,1.0,1.0,2017.0,LaLiga,3.0,0.0,0.0,217.0,nan,nan,nan,nan
19/6/2011,Arturo Vidal,75000273,1652,5/22/1987,24,35,3,6,2,6000,7350,7850,171,157,3647694,180,74,DM/M C,3,3,2,2,1,2,2,10,3,2,1,12,14,13,9,16,9,15,12,11,17,16,19,17,16,19,15,17,18,7,14,9,17,17,13,9,10,5,19,13,17,16,12,14,18,13,20,18,11,13,17,15,4,18,9,19,5,18,10,3,6,14,13,13,20,14,13,13,20,DM/M C,421,1,7,1,14,1,1,10,13,13,19,20,12,12,13,13,176098377728,0,0,0,0,0,0,0,0,0,0,0,0,0,0,0,0,0,0,0,1,0,0,1,0,0,0,0,0,0,0,0,0,1,0,0,1,0,1,0,0,0,0,0,0,0,0,0,0,Arturo Vidal,£21.60m ,33.0,180.0,Midfielder - Central Midfield,right,Inter Milan,44.0,13.0,10.0,3505.0,35.0,7.0,4.0,2845.0,45.0,15.0,12.0,3753.0,46.0,18.0,5.0,3601.0,45.0,8.0,4.0,3625.0,48.0,7.0,12.0,3234.0,41.0,9.0,4.0,2946.0,35.0,6.0,2.0,2309.0,53.0,3.0,7.0,2744.0,Serie A,43.0,8.0,3.0,2245.0,6.0,0.0,0.0,393.0
19/6/2011,Arnold Mvuemba,8428680,769,1/28/1985,26,0,0,4,0,2000,5894,5850,145,131,352523,172,67,DM/M C,3,3,2,1,1,3,1,4,1,3,1,12,12,12,7,14,13,8,12,6,6,15,10,8,14,9,13,12,14,14,14,13,14,11,12,11,12,16,15,14,14,11,6,12,14,12,20,16,9,13,9,15,7,10,10,14,13,11,12,14,14,9,1,1,20,12,10,1,20,DM/M C,421,1,1,1,12,1,10,1,1,1,16,20,1,10,1,1,71303296,0,0,0,0,0,0,0,1,0,0,0,0,0,0,0,0,0,0,0,0,0,0,1,0,0,0,1,0,0,0,0,0,0,0,0,0,0,0,0,0,0,0,0,0,0,0,0,0,Arnold Mvuemba,£4.05m ,35.0,172.0,Midfielder - Defensive Midfield,right,Without Club,40.0,2.0,1.0,3479.0,38.0,5.0,7.0,3201.0,22.0,2.0,1.0,1017.0,30.0,2.0,5.0,2262.0,26.0,0.0,2.0,1250.0,9.0,0.0,0.0,394.0,36.0,1.0,1.0,3088.0,1.0,0.0,0.0,5.0,7.0,0.0,0.0,584.0,Ligue 1,12.0,0.0,3.0,1066.0,nan,nan,nan,nan
19/6/2011,Armin Bacinovic,64001279,795,10/24/1989,21,6,0,11,4,4500,6261,6900,165,138,6491726,183,75,DM/M C,3,1,1,2,3,2,2,2,2,2,2,9,10,11,10,11,9,14,16,7,13,14,8,13,12,10,13,12,14,12,16,14,15,12,10,13,14,14,12,12,11,14,12,10,13,11,20,14,14,12,13,13,11,12,14,12,12,15,10,10,11,13,12,1,20,1,12,1,20,DM/M C,421,1,13,1,1,1,1,11,1,12,18,20,1,1,1,1,512,0,0,0,0,0,0,0,0,0,1,0,0,0,0,0,0,0,0,0,0,0,0,0,0,0,0,0,0,0,0,0,0,0,0,0,0,0,0,0,0,0,0,0,0,0,0,0,0,Armin Bacinovic,£3.15m ,31.0,183.0,Midfielder - Defensive Midfield,right,Without Club,44.0,2.0,2.0,3346.0,14.0,0.0,0.0,681.0,20.0,1.0,2.0,1519.0,9.0,0.0,0.0,640.0,30.0,1.0,1.0,2068.0,31.0,1.0,1.0,2351.0,28.0,2.0,1.0,1963.0,27.0,0.0,2.0,1471.0,nan,nan,nan,nan,Serie A,nan,nan,nan,nan,nan,nan,nan,nan
19/6/2011,Apoño,1502372,796,2/13/1984,27,0,0,0,0,4509,6756,6756,145,138,2845850,178,69,DM/M C,1,3,1,1,3,3,3,5,2,2,2,13,11,12,10,14,11,11,14,7,11,13,17,14,12,8,13,11,12,12,14,12,12,13,9,12,12,12,14,14,12,11,10,17,6,12,20,14,12,8,11,14,17,11,13,12,12,14,12,8,8,12,1,1,19,14,1,1,19,DM/M C,311,1,1,1,14,1,1,1,1,1,20,19,1,1,1,1,21103744,0,0,0,0,0,0,0,1,0,0,1,0,0,0,0,0,0,1,0,0,0,0,1,0,1,0,0,0,0,0,0,0,0,0,0,0,0,0,0,0,0,0,0,0,0,0,0,0,Apoño,£2.70m ,36.0,174.0,Midfielder - Central Midfield,right,Alhaurín de la Torre CF,29.0,2.0,5.0,2245.0,26.0,6.0,1.0,1846.0,35.0,9.0,2.0,2773.0,33.0,2.0,2.0,2714.0,13.0,1.0,1.0,955.0,7.0,0.0,0.0,509.0,nan,nan,nan,nan,nan,nan,nan,nan,nan,nan,nan,nan,LaLiga,nan,nan,nan,nan,nan,nan,nan,nan
19/6/2011,Antonio Nocerino,7983965,776,4/9/1985,26,5,0,21,0,6400,7450,7350,154,147,4521107,178,79,DM/M C,2,2,3,2,1,3,1,7,1,2,3,11,11,11,13,12,6,12,15,11,16,14,9,15,13,16,15,17,12,13,12,14,15,9,13,12,14,15,15,13,13,13,9,10,15,14,20,16,14,13,13,14,2,13,14,14,17,12,12,12,12,8,1,10,20,1,13,1,20,DM/M C,421,1,1,1,1,1,1,1,1,1,17,20,1,13,1,10,34493972480,0,0,0,0,0,0,0,0,0,0,0,0,0,0,1,0,0,0,0,0,0,0,0,0,0,0,0,1,0,0,0,0,0,0,0,1,0,0,0,0,0,0,0,0,0,0,0,0,Antonio Nocerino,£9.90m ,35.0,175.0,Midfielder - Central Midfield,right,Retired,49.0,4.0,4.0,4329.0,50.0,11.0,2.0,4138.0,29.0,2.0,2.0,1908.0,27.0,0.0,3.0,1135.0,33.0,3.0,2.0,2395.0,26.0,0.0,0.0,1810.0,32.0,1.0,0.0,2324.0,nan,nan,nan,nan,9.0,0.0,0.0,602.0,Serie A,nan,nan,nan,nan,nan,nan,nan,nan
19/6/2011,Antônio da Silva,500471,1651,6/13/1978,33,0,0,0,0,4500,5000,6650,134,124,4444358,178,76,M/AM C,1,3,1,2,2,3,1,1,3,1,1,15,14,13,8,15,16,7,14,5,8,16,14,10,15,10,12,11,12,14,18,14,10,14,11,10,12,13,11,8,12,13,9,20,13,10,12,12,12,12,9,13,10,10,12,8,8,14,14,13,11,10,1,1,20,19,8,14,20,M/AM C,411,1,1,8,19,13,8,1,1,1,15,20,14,5,1,1,140806207832704,0,0,0,0,0,0,0,1,0,1,0,0,0,0,0,0,0,0,0,0,0,0,0,0,0,0,0,0,0,0,0,0,0,0,0,0,1,0,0,0,0,0,0,0,0,0,0,1
19/6/2011,Antonio Candreva,1400480,776,2/28/1987,24,2,0,14,0,5250,6650,6650,155,137,311029,180,72,M/AM C,1,3,2,3,2,2,3,1,3,1,3,13,13,14,13,15,14,11,14,4,7,16,13,8,16,12,14,13,15,13,14,13,14,15,11,13,11,11,12,13,14,13,9,12,14,12,20,12,12,13,5,15,7,15,13,16,11,14,18,15,16,3,1,1,19,20,13,14,20,M/AM C,521,1,1,1,20,14,13,1,1,1,11,19,12,10,1,1,549755813888,0,0,0,0,0,0,0,0,0,0,0,0,0,0,0,0,0,0,0,0,0,0,0,0,0,0,0,0,0,0,0,0,0,0,0,0,0,0,0,1,0,0,0,0,0,0,0,0,Antonio Candreva,£4.95m ,33.0,180.0,Midfielder - Right Midfield,right,UC Sampdoria,33.0,3.0,1.0,2409.0,38.0,9.0,6.0,2724.0,49.0,7.0,13.0,3697.0,44.0,12.0,10.0,3471.0,38.0,11.0,15.0,2968.0,44.0,12.0,4.0,3141.0,45.0,8.0,11.0,3514.0,37.0,0.0,8.0,2693.0,29.0,3.0,3.0,1048.0,Serie A,40.0,7.0,9.0,2537.0,3.0,0.0,1.0,207.0
19/6/2011,Anton Putsila,7485429,758,6/10/1987,24,21,4,11,1,5271,7260,6500,147,132,786366,180,74,M/AM LC,3,3,1,1,2,3,3,1,2,3,3,14,12,16,12,14,14,8,10,10,7,14,13,11,16,15,10,14,11,10,14,8,14,14,11,12,10,13,13,14,15,12,12,20,15,14,10,14,11,8,7,14,4,15,8,11,11,14,16,11,14,11,1,1,20,20,14,16,20,M/AM LC,414,1,1,13,20,16,14,1,1,1,10,20,16,13,1,1,26388280115204,0,0,1,0,0,0,0,0,0,0,0,0,0,0,0,0,0,0,0,0,1,0,0,0,0,0,0,0,0,0,0,0,0,0,0,0,0,0,0,0,0,0,0,1,1,0,0,0,Anton Putsila,£2.03m ,33.0,180.0,Midfielder - Attacking Midfield,right,Altay SK,31.0,2.0,5.0,2260.0,19.0,0.0,1.0,1297.0,13.0,0.0,0.0,962.0,26.0,2.0,2.0,2052.0,20.0,4.0,1.0,1599.0,21.0,2.0,2.0,1333.0,19.0,1.0,0.0,1047.0,25.0,4.0,6.0,1933.0,22.0,0.0,5.0,1507.0,Bundesliga,32.0,5.0,4.0,2695.0,2.0,0.0,0.0,180.0
19/6/2011,Antoine Devaux,8447192,769,2/21/1985,26,0,0,0,0,4300,5400,5400,135,121,175960,185,70,M/AM RC,3,2,1,1,2,2,1,2,2,3,1,8,11,13,8,15,8,10,9,8,6,13,9,6,15,8,11,11,12,12,14,15,14,12,8,10,8,12,13,14,12,14,12,12,10,12,20,13,9,13,8,14,12,11,9,14,12,12,13,15,15,5,1,1,18,20,17,12,20,M/AM RC,523,1,1,1,20,12,17,1,1,1,1,18,12,17,1,1,160,0,0,0,0,0,1,0,1,0,0,0,0,0,0,0,0,0,0,0,0,0,0,0,0,0,0,0,0,0,0,0,0,0,0,0,0,0,0,0,0,0,0,0,0,0,0,0,0,Antoine Devaux,£2.25m ,35.0,185.0,Midfielder - Central Midfield,right,Retired,29.0,1.0,1.0,2019.0,24.0,2.0,0.0,1828.0,37.0,0.0,6.0,2642.0,38.0,3.0,1.0,3055.0,31.0,1.0,0.0,2579.0,33.0,1.0,1.0,2819.0,15.0,1.0,0.0,1176.0,17.0,2.0,1.0,1559.0,nan,nan,nan,nan,Ligue 1,nan,nan,nan,nan,nan,nan,nan,nan
19/6/2011,Anthony Deroin,3501549,769,3/15/1979,32,0,0,0,0,4200,5250,5250,142,117,181207,163,66,DM/M/AM C,3,1,2,2,3,1,2,3,1,2,3,12,15,12,8,14,15,5,12,6,6,15,16,8,14,13,11,13,14,14,13,12,14,12,14,12,12,13,13,12,14,12,1,10,10,11,20,13,7,14,8,15,8,12,7,11,17,14,15,15,15,7,1,1,20,18,14,1,20,DM/M/AM C,431,1,1,1,18,1,14,1,1,1,16,20,1,14,1,1,4325440,0,0,0,0,0,0,1,0,0,0,0,0,0,0,0,0,0,1,0,0,0,0,1,0,0,0,0,0,0,0,0,0,0,0,0,0,0,0,0,0,0,0,0,0,0,0,0,0,Anthony Deroin,£270Th. ,41.0,163.0,Midfielder - Attacking Midfield,right,Retired,5.0,0.0,0.0,71.0,6.0,0.0,0.0,270.0,nan,nan,nan,nan,nan,nan,nan,nan,nan,nan,nan,nan,nan,nan,nan,nan,nan,nan,nan,nan,nan,nan,nan,nan,nan,nan,nan,nan,Ligue 1,nan,nan,nan,nan,nan,nan,nan,nan
19/6/2011,Anduele Pryor,860421,784,4/26/1985,26,0,0,0,0,1578,4600,4600,106,96,34537,183,78,M/AM RLC,1,3,3,2,3,2,3,3,1,2,2,10,12,14,7,12,6,4,7,5,5,11,12,3,15,8,13,12,11,10,10,10,10,15,8,12,4,11,9,14,13,12,11,8,10,13,20,8,6,12,4,12,11,10,13,15,16,12,12,13,14,14,1,1,17,20,16,20,17,M/AM RLC,526,1,1,3,17,20,16,1,1,1,1,17,11,11,1,1,549755813888,0,0,0,0,0,0,0,0,0,0,0,0,0,0,0,0,0,0,0,0,0,0,0,0,0,0,0,0,0,0,0,0,0,0,0,0,0,0,0,1,0,0,0,0,0,0,0,0
19/6/2011,Andrew Surman,5109929,765,8/20/1986,24,0,0,4,1,3400,5764,5854,140,124,580604,178,73,D/M LC,3,2,1,2,1,3,3,1,1,3,1,10,12,11,11,13,13,10,13,4,10,14,12,11,13,9,12,8,12,10,13,11,11,12,14,11,13,13,14,12,11,13,10,20,14,12,13,12,10,11,5,13,6,11,14,14,13,12,13,14,12,7,17,14,20,10,14,20,15,D/M LC,424,1,1,1,1,10,1,1,17,1,1,15,20,14,14,1,549755814912,0,0,0,0,0,0,0,0,0,0,1,0,0,0,0,0,0,0,0,0,0,0,0,0,0,0,0,0,0,0,0,0,0,0,0,0,0,0,0,1,0,0,0,0,0,0,0,0,Andrew Surman,£2.25m ,34.0,178.0,Midfielder - Central Midfield,left,Without Club,22.0,3.0,4.0,1513.0,31.0,5.0,4.0,2455.0,7.0,0.0,1.0,516.0,39.0,0.0,3.0,2829.0,43.0,3.0,4.0,3750.0,38.0,0.0,3.0,3420.0,23.0,0.0,2.0,1892.0,28.0,2.0,5.0,2119.0,20.0,0.0,1.0,1618.0,Premier League,9.0,0.0,0.0,593.0,nan,nan,nan,nan
19/6/2011,Andrew Sinkala,6001650,54,6/18/1979,32,22,1,0,0,4250,6750,5950,124,119,205201,175,75,D/DM/M C,2,2,1,1,3,3,3,8,3,1,3,6,10,12,6,8,7,11,13,7,14,13,8,15,13,9,13,12,13,4,10,14,14,10,8,13,14,14,13,12,12,13,8,10,13,13,20,15,14,10,11,8,14,14,15,11,14,9,13,15,16,5,16,1,17,1,12,1,17,D/DM/M C,331,1,1,1,1,1,1,16,1,12,20,17,1,1,1,1,34359738368,0,0,0,0,0,0,0,0,0,0,0,0,0,0,0,0,0,0,0,0,0,0,0,0,0,0,0,0,0,0,0,0,0,0,0,1,0,0,0,0,0,0,0,0,0,0,0,0,Andrew Sinkala,£270Th. ,41.0,175.0,Defender - Centre-Back,right,Retired,7.0,0.0,0.0,201.0,13.0,0.0,1.0,674.0,23.0,0.0,1.0,1808.0,0.0,0.0,0.0,0.0,nan,nan,nan,nan,nan,nan,nan,nan,nan,nan,nan,nan,nan,nan,nan,nan,nan,nan,nan,nan,Bundesliga,nan,nan,nan,nan,nan,nan,nan,nan
19/6/2011,Andrew Crofts,5113587,801,5/29/1984,27,17,0,10,1,3600,6400,6150,125,122,710539,176,73,M C,1,1,2,3,3,1,3,6,3,3,1,7,10,11,11,11,7,11,11,6,12,12,10,14,13,14,11,16,11,13,11,13,17,8,13,12,11,14,15,11,12,14,11,8,16,12,20,16,15,15,14,13,3,14,6,16,12,13,18,14,15,2,12,8,20,14,14,10,20,M C,401,1,1,1,14,4,4,1,8,12,15,20,10,14,8,8,137438953472,0,0,0,0,0,0,0,0,0,0,0,0,0,0,0,0,0,0,0,0,0,0,0,0,0,0,0,0,0,0,0,0,0,0,0,0,0,1,0,0,0,0,0,0,0,0,0,0,Andrew Crofts,£1.80m ,36.0,175.0,Midfielder - Central Midfield,right,Brighton & Hove Albion U23,44.0,8.0,5.0,3923.0,27.0,0.0,2.0,1558.0,25.0,0.0,1.0,1450.0,24.0,5.0,1.0,2126.0,8.0,0.0,1.0,598.0,27.0,1.0,1.0,1526.0,51.0,1.0,3.0,4176.0,9.0,0.0,1.0,466.0,12.0,0.0,0.0,693.0,Premier League,9.0,0.0,0.0,666.0,4.0,0.0,0.0,360.0
19/6/2011,Andrés Iniesta,824041,796,5/11/1984,27,58,9,19,6,8750,9100,9100,187,182,9155692,170,65,M/AM LC,3,3,2,1,3,2,1,9,3,1,1,15,15,19,12,19,14,5,13,5,7,20,13,10,20,5,18,12,19,17,20,17,15,19,11,18,12,17,13,14,18,12,6,14,15,12,20,14,7,16,4,18,13,16,6,15,16,17,19,16,15,4,1,1,19,20,13,15,20,M/AM LC,524,1,1,1,20,15,13,1,1,1,9,19,13,13,1,1,17609639592128,0,0,0,0,0,0,1,1,0,0,0,0,0,0,0,0,0,0,0,0,1,0,1,0,0,0,0,0,1,0,0,0,0,0,1,0,0,0,0,0,0,0,0,0,1,0,0,0,Andrés Iniesta,£58.50m ,36.0,171.0,Midfielder - Central Midfield,both,Vissel Kobe,50.0,9.0,15.0,4140.0,46.0,8.0,12.0,3189.0,48.0,6.0,22.0,3515.0,52.0,3.0,13.0,3695.0,42.0,3.0,8.0,2924.0,44.0,1.0,4.0,3508.0,37.0,1.0,5.0,2288.0,59.0,5.0,6.0,4006.0,25.0,7.0,7.0,2108.0,LaLiga,25.0,4.0,9.0,1968.0,nan,nan,nan,nan
19/6/2011,Andreas Ottl,8707853,771,3/1/1985,26,0,0,4,0,5400,6650,6650,136,130,913290,185,77,DM/M C,1,3,1,2,3,2,2,1,1,1,2,8,12,9,12,10,9,10,13,12,12,12,9,12,11,8,11,9,13,14,12,11,10,9,12,12,15,17,14,13,13,13,15,10,16,14,20,17,14,14,8,15,5,14,12,8,12,14,9,6,13,4,10,14,18,5,14,10,18,DM/M C,311,1,1,1,5,1,1,10,1,1,20,18,1,1,10,14,512,0,0,0,0,0,0,0,0,0,1,0,0,0,0,0,0,0,0,0,0,0,0,0,0,0,0,0,0,0,0,0,0,0,0,0,0,0,0,0,0,0,0,0,0,0,0,0,0
19/6/2011,Andreas Neuendorf,8677,771,2/9/1975,36,0,0,23,1,2550,5450,5450,140,109,31958,178,74,M/AM RC,2,3,3,1,1,1,3,2,3,1,3,12,12,12,7,12,11,7,11,4,7,13,10,8,13,12,14,13,12,12,12,12,10,11,13,12,7,13,11,12,12,9,7,20,12,12,10,11,12,13,11,14,14,18,6,14,18,10,9,11,5,14,1,1,18,20,18,12,20,M/AM RC,523,1,1,1,20,10,1,1,1,1,1,15,12,18,1,1,196608,0,0,0,0,0,0,0,0,0,0,0,0,0,0,0,0,1,1,0,0,0,0,0,0,0,0,0,0,0,0,0,0,0,0,0,0,0,0,0,0,0,0,0,0,0,0,0,0
19/6/2011,Andrea Poli,43006570,776,9/28/1989,21,0,0,13,1,4522,6516,6666,172,134,873547,181,70,M C,3,1,2,3,2,2,3,5,1,1,2,15,10,12,10,16,12,10,12,8,10,17,10,12,15,12,12,12,14,15,15,15,12,16,10,17,12,12,12,13,12,12,10,10,15,10,20,16,12,16,10,16,8,12,15,16,12,10,10,10,10,13,1,1,20,1,1,1,20,M C,401,1,1,1,1,1,1,1,1,1,10,20,1,1,1,1,549755813888,0,0,0,0,0,0,0,0,0,0,0,0,0,0,0,0,0,0,0,0,0,0,0,0,0,0,0,0,0,0,0,0,0,0,0,0,0,0,0,1,0,0,0,0,0,0,0,0,Andrea Poli,£6.75m ,31.0,182.0,Midfielder - Central Midfield,right,Bologna FC 1909,28.0,0.0,2.0,1754.0,21.0,1.0,1.0,1136.0,32.0,3.0,0.0,2630.0,37.0,2.0,4.0,2161.0,35.0,1.0,3.0,2244.0,24.0,0.0,3.0,981.0,13.0,0.0,0.0,380.0,33.0,2.0,0.0,2658.0,32.0,4.0,1.0,2124.0,Serie A,30.0,3.0,1.0,2047.0,1.0,0.0,0.0,64.0
19/6/2011,Andrea Pirlo,703963,776,5/19/1979,32,74,9,46,16,7700,8000,8000,181,159,1518961,177,68,DM/M C,2,2,3,3,2,3,2,8,3,1,3,14,15,13,12,16,13,7,14,9,13,17,18,7,19,10,14,12,18,15,18,17,14,18,15,13,15,16,14,11,13,14,8,14,14,12,20,14,11,14,9,16,14,14,13,14,18,19,18,20,19,6,1,1,18,14,8,7,18,DM/M C,311,1,1,1,14,1,1,1,1,1,20,18,7,8,1,1,8864817217664,0,0,0,0,0,0,0,1,0,0,0,0,0,0,0,0,0,0,0,1,0,0,1,0,0,0,0,0,0,0,0,0,0,0,0,0,1,0,0,0,0,0,0,1,0,0,0,0,Andrea Pirlo,£9.00m ,41.0,177.0,Midfielder - Defensive Midfield,both,Retired,25.0,1.0,4.0,1791.0,41.0,3.0,14.0,3707.0,45.0,5.0,11.0,3922.0,45.0,6.0,8.0,3712.0,46.0,5.0,7.0,3746.0,33.0,1.0,6.0,2845.0,16.0,0.0,1.0,1086.0,nan,nan,nan,nan,nan,nan,nan,nan,Serie A,nan,nan,nan,nan,nan,nan,nan,nan
19/6/2011,Andrea Lazzari,7982744,776,12/3/1984,26,0,0,10,1,4500,6400,6400,130,128,410234,184,75,M/AM LC,2,2,2,2,2,2,2,2,2,2,2,12,14,11,11,16,12,9,14,11,9,15,12,11,16,10,12,12,11,8,16,10,8,15,8,13,10,13,12,8,12,18,10,20,16,11,13,15,14,12,8,13,6,16,8,15,12,11,12,18,17,10,1,1,20,18,12,19,20,M/AM LC,414,1,1,6,18,16,12,1,1,1,1,20,19,10,1,1,8796095120640,0,0,0,0,0,0,0,0,1,0,1,0,0,0,0,0,0,0,0,0,0,1,0,0,0,0,0,0,0,0,0,0,0,0,0,0,0,0,0,0,0,0,0,1,0,0,0,0,Andrea Lazzari,£3.60m ,35.0,184.0,Midfielder - Central Midfield,left,FC Vigor Senigallia,32.0,1.0,5.0,1923.0,36.0,2.0,1.0,2538.0,29.0,1.0,6.0,2045.0,30.0,2.0,5.0,1852.0,9.0,0.0,1.0,343.0,19.0,2.0,1.0,652.0,20.0,0.0,0.0,1216.0,26.0,1.0,2.0,2147.0,27.0,0.0,1.0,1860.0,Serie A,nan,nan,nan,nan,nan,nan,nan,nan
19/6/2011,Andrea Cossu,706323,776,5/3/1980,31,2,0,0,0,5750,6750,7200,146,144,506871,171,63,M/AM C,2,2,1,2,1,1,1,10,1,2,1,12,14,17,6,15,13,7,11,6,8,15,10,7,15,15,16,13,12,13,15,13,18,16,14,16,10,14,14,16,18,11,5,14,15,10,20,12,11,12,11,12,7,12,6,10,20,10,18,12,8,12,1,1,16,20,10,10,20,M/AM C,521,1,1,1,20,10,10,1,1,1,8,16,1,1,1,1,18691697672208,0,0,0,0,1,0,0,0,0,0,0,0,0,0,0,0,0,0,0,0,0,0,0,0,0,0,0,0,0,0,0,0,0,0,0,0,0,0,0,0,1,0,0,0,1,0,0,0,Andrea Cossu,£3.15m ,40.0,170.0,Midfielder - Attacking Midfield,right,Retired,36.0,4.0,12.0,2970.0,33.0,1.0,6.0,2618.0,25.0,0.0,8.0,1271.0,29.0,0.0,1.0,1662.0,24.0,2.0,3.0,1804.0,16.0,2.0,5.0,1319.0,27.0,2.0,11.0,2109.0,13.0,0.0,1.0,362.0,nan,nan,nan,nan,Serie A,nan,nan,nan,nan,nan,nan,nan,nan
19/6/2011,Andrea Bertolacci,43028376,776,1/11/1991,20,0,0,0,0,2500,5750,5750,166,125,247952,179,75,M C,3,2,2,3,2,2,3,1,1,1,2,9,11,13,12,12,9,8,12,9,12,15,8,13,13,12,13,13,13,12,14,11,15,12,13,15,12,14,15,13,13,10,9,20,13,13,5,14,11,13,11,12,8,13,11,14,14,13,14,13,14,5,1,1,20,15,1,1,20,M C,401,1,1,7,15,1,1,1,1,1,15,20,1,1,1,1,0,0,0,0,0,0,0,0,0,0,0,0,0,0,0,0,0,0,0,0,0,0,0,0,0,0,0,0,0,0,0,0,0,0,0,0,0,0,0,0,0,0,0,0,0,0,0,0,0,Andrea Bertolacci,£2.25m ,29.0,179.0,Midfielder - Central Midfield,left,Without Club,10.0,4.0,0.0,734.0,28.0,3.0,3.0,1273.0,29.0,4.0,5.0,2027.0,26.0,2.0,1.0,1996.0,35.0,6.0,8.0,2726.0,30.0,1.0,1.0,2025.0,18.0,1.0,1.0,1048.0,34.0,1.0,1.0,3018.0,4.0,0.0,0.0,139.0,Serie A,12.0,0.0,0.0,536.0,nan,nan,nan,nan
19/6/2011,Andrea Barberis,43078258,776,12/11/1993,17,0,0,0,0,50,2600,2600,113,60,22529,184,81,M C,1,1,3,2,2,1,2,1,1,2,3,8,7,2,7,10,8,7,11,1,8,8,3,11,12,14,11,2,9,4,8,11,7,4,1,5,7,10,11,9,12,10,8,8,8,12,20,8,5,10,12,10,5,9,8,10,8,9,7,12,6,10,1,1,20,1,1,1,20,M C,401,1,1,1,1,1,1,1,1,1,15,20,1,1,1,1,0,0,0,0,0,0,0,0,0,0,0,0,0,0,0,0,0,0,0,0,0,0,0,0,0,0,0,0,0,0,0,0,0,0,0,0,0,0,0,0,0,0,0,0,0,0,0,0,0,Andrea Barberis,£113Th. ,26.0,177.0,Midfielder - Central Midfield,right,AC Monza,25.0,0.0,0.0,1672.0,25.0,2.0,0.0,2174.0,29.0,3.0,0.0,1430.0,24.0,1.0,2.0,1478.0,27.0,1.0,1.0,1544.0,29.0,1.0,1.0,2456.0,27.0,0.0,3.0,2153.0,39.0,2.0,2.0,3108.0,33.0,2.0,1.0,2813.0,Serie A,39.0,2.0,9.0,3335.0,4.0,0.0,0.0,280.0
19/6/2011,André Martins,55009957,788,1/21/1990,21,0,0,4,1,1250,5250,5250,125,110,449645,166,56,M C,2,3,3,1,2,2,2,1,2,3,2,12,12,12,10,14,11,6,11,7,9,13,11,10,14,12,13,11,11,11,12,12,14,11,9,11,10,14,14,13,11,6,6,8,10,12,20,10,8,12,9,9,7,11,10,11,14,12,15,15,15,5,1,1,20,10,1,1,20,M C,401,1,1,1,10,1,1,1,1,1,10,20,1,1,1,1,0,0,0,0,0,0,0,0,0,0,0,0,0,0,0,0,0,0,0,0,0,0,0,0,0,0,0,0,0,0,0,0,0,0,0,0,0,0,0,0,0,0,0,0,0,0,0,0,0,André Martins,£2.25m ,30.0,169.0,Midfielder - Central Midfield,right,Legia Warszawa,4.0,0.0,0.0,118.0,21.0,0.0,2.0,929.0,22.0,0.0,2.0,1108.0,29.0,3.0,5.0,2089.0,27.0,1.0,1.0,1357.0,8.0,0.0,0.0,349.0,39.0,1.0,3.0,2529.0,14.0,1.0,1.0,697.0,28.0,2.0,3.0,2124.0,Liga NOS,44.0,0.0,1.0,3339.0,6.0,0.0,0.0,214.0
19/6/2011,André Leão,8876784,788,5/20/1985,26,0,0,0,0,3000,5650,5650,125,115,237154,185,78,DM/M C,2,1,2,3,2,2,2,1,1,2,1,15,14,13,12,14,15,11,15,11,11,14,15,11,15,11,13,11,14,14,14,13,15,11,11,13,12,14,14,12,13,13,13,20,12,11,5,11,12,12,7,10,9,12,15,5,11,7,10,5,5,3,1,1,20,10,1,10,20,DM/M C,421,1,1,1,10,1,1,1,1,1,17,20,10,1,1,1,768,0,0,0,0,0,0,0,0,1,1,0,0,0,0,0,0,0,0,0,0,0,0,0,0,0,0,0,0,0,0,0,0,0,0,0,0,0,0,0,0,0,0,0,0,0,0,0,0,André Leão,£630Th. ,35.0,185.0,Midfielder - Defensive Midfield,right,CD Trofense,33.0,1.0,0.0,2801.0,32.0,0.0,1.0,2818.0,38.0,2.0,1.0,3251.0,35.0,1.0,2.0,2971.0,37.0,0.0,4.0,3095.0,31.0,0.0,2.0,2202.0,39.0,0.0,1.0,3279.0,23.0,0.0,0.0,1770.0,13.0,1.0,0.0,903.0,Liga NOS,1.0,0.0,0.0,40.0,nan,nan,nan,nan
19/6/2011,André Fontes,745055,788,5/27/1985,26,0,0,0,0,786,4184,3000,100,93,15897,179,75,M C,3,2,3,1,1,2,3,3,2,1,1,10,10,10,9,12,10,10,10,10,9,10,10,11,12,10,11,10,12,11,10,10,12,7,10,11,11,12,11,11,11,11,11,8,12,11,20,11,11,11,7,9,9,13,9,10,12,10,14,14,13,5,1,1,20,13,10,10,20,M C,401,1,1,1,13,1,1,1,1,1,10,20,10,10,1,1,0,0,0,0,0,0,0,0,0,0,0,0,0,0,0,0,0,0,0,0,0,0,0,0,0,0,0,0,0,0,0,0,0,0,0,0,0,0,0,0,0,0,0,0,0,0,0,0,0,André Fontes,£450Th. ,35.0,179.0,Midfielder - Attacking Midfield,right,FC Oliveira do Hospital,32.0,4.0,0.0,2068.0,9.0,0.0,0.0,234.0,45.0,1.0,0.0,3739.0,52.0,3.0,0.0,4409.0,31.0,2.0,3.0,2490.0,9.0,1.0,0.0,405.0,44.0,2.0,8.0,3835.0,23.0,1.0,0.0,1301.0,1.0,0.0,0.0,0.0,Liga NOS,2.0,0.0,0.0,116.0,nan,nan,nan,nan
19/6/2011,André Cunha,7002129,788,2/16/1978,33,0,0,0,0,1025,4499,2997,105,100,6981,182,79,DM/M C,2,1,3,2,1,3,1,1,3,2,3,11,11,11,13,12,8,12,10,5,5,11,12,6,13,10,10,12,15,14,12,12,11,10,7,14,8,12,13,8,9,13,12,12,12,9,20,11,13,12,6,10,6,8,10,11,11,9,10,16,15,5,1,1,20,14,1,1,20,DM/M C,421,1,1,10,14,1,1,1,1,1,17,20,1,1,1,1,0,0,0,0,0,0,0,0,0,0,0,0,0,0,0,0,0,0,0,0,0,0,0,0,0,0,0,0,0,0,0,0,0,0,0,0,0,0,0,0,0,0,0,0,0,0,0,0,0,André Cunha,£270Th. ,42.0,184.0,Midfielder - Attacking Midfield,right,Retired,31.0,3.0,0.0,2532.0,30.0,2.0,1.0,2519.0,33.0,2.0,4.0,2683.0,nan,nan,nan,nan,1.0,0.0,0.0,90.0,nan,nan,nan,nan,nan,nan,nan,nan,nan,nan,nan,nan,nan,nan,nan,nan,Liga NOS,nan,nan,nan,nan,nan,nan,nan,nan
19/6/2011,André Castro,55004179,788,4/2/1988,23,0,0,10,0,4750,5849,6250,147,130,212516,179,75,M/AM C,2,3,2,1,2,3,1,1,1,1,1,12,13,10,12,14,9,10,15,10,12,13,12,12,13,13,11,13,14,13,10,13,16,9,11,12,14,15,16,14,14,12,11,8,13,13,20,12,12,13,9,11,7,14,10,13,18,12,16,13,13,5,1,1,20,17,10,1,20,M/AM C,411,1,1,1,17,1,1,1,1,1,10,20,1,10,1,1,0,0,0,0,0,0,0,0,0,0,0,0,0,0,0,0,0,0,0,0,0,0,0,0,0,0,0,0,0,0,0,0,0,0,0,0,0,0,0,0,0,0,0,0,0,0,0,0,0,André Castro,£2.25m ,32.0,181.0,Midfielder - Central Midfield,right,SC Braga,21.0,2.0,1.0,1011.0,29.0,2.0,1.0,2164.0,24.0,1.0,2.0,630.0,34.0,3.0,4.0,2951.0,32.0,5.0,1.0,2735.0,33.0,4.0,4.0,2805.0,39.0,7.0,5.0,3315.0,33.0,4.0,9.0,2951.0,34.0,1.0,10.0,2863.0,LaLiga,34.0,4.0,2.0,2254.0,6.0,1.0,0.0,420.0
19/6/2011,André Ayew,8442448,21,12/17/1989,21,32,2,12,4,6050,7500,6750,165,150,2055336,176,72,M/AM LC,2,1,3,2,1,1,2,2,1,3,2,11,13,15,11,14,8,14,12,5,6,13,15,13,15,14,13,15,13,13,13,14,16,13,13,13,12,16,18,16,15,15,9,20,15,16,5,17,13,15,14,16,7,12,11,17,13,12,12,13,14,12,8,8,20,17,10,17,20,M/AM LC,414,1,1,12,12,17,10,1,8,1,1,20,17,10,8,1,2251954432507944,0,0,0,1,0,1,0,0,0,0,0,0,0,0,0,0,0,0,0,0,0,0,0,0,0,0,0,0,0,0,0,0,0,0,1,0,0,1,0,0,0,0,0,0,0,0,0,0,André Ayew,£13.50m ,30.0,176.0,Forward - Left Winger,left,Swansea City,51.0,13.0,6.0,3850.0,39.0,16.0,4.0,3153.0,45.0,12.0,5.0,3846.0,29.0,8.0,4.0,2482.0,30.0,11.0,6.0,2519.0,35.0,12.0,5.0,2943.0,26.0,6.0,3.0,1453.0,36.0,6.0,5.0,2361.0,38.0,5.0,2.0,2620.0,Ligue 1,47.0,18.0,7.0,4116.0,8.0,3.0,1.0,720.0
19/6/2011,André Almeida,55011100,788,9/10/1990,20,0,0,0,0,1799,5300,5300,139,106,62373,186,75,D/M RC,1,3,2,1,1,2,3,1,2,3,1,12,12,12,9,13,12,8,12,8,10,13,13,9,14,10,14,10,12,12,12,13,12,11,12,12,13,13,11,12,12,10,11,6,13,12,20,11,11,9,6,10,8,12,11,15,14,12,14,14,14,5,20,7,20,13,20,10,20,D/M RC,113,1,1,1,13,10,10,5,1,20,10,20,10,10,1,7,0,0,0,0,0,0,0,0,0,0,0,0,0,0,0,0,0,0,0,0,0,0,0,0,0,0,0,0,0,0,0,0,0,0,0,0,0,0,0,0,0,0,0,0,0,0,0,0,0,André Almeida,£900Th. ,30.0,186.0,Defender - Right-Back,right,SL Benfica,22.0,2.0,0.0,1699.0,16.0,1.0,0.0,1188.0,40.0,1.0,1.0,2953.0,27.0,0.0,1.0,2035.0,31.0,0.0,3.0,2112.0,37.0,0.0,6.0,3090.0,25.0,2.0,3.0,1851.0,40.0,2.0,8.0,3354.0,53.0,2.0,12.0,4727.0,Liga NOS,27.0,4.0,5.0,2366.0,5.0,0.0,2.0,374.0
19/6/2011,Anderson,320552,1651,4/13/1988,23,8,0,0,0,6514,7266,7516,168,151,2882597,176,69,M C,1,1,2,2,1,3,1,9,1,2,3,12,13,13,5,15,14,7,3,7,8,15,15,12,15,14,13,14,13,12,14,11,13,12,7,13,10,16,17,18,16,17,8,20,16,16,13,12,17,12,10,16,5,9,14,16,13,18,12,11,15,8,1,1,20,15,10,12,20,M C,401,1,1,1,15,11,10,1,1,1,12,20,12,8,1,1,17179869316,0,0,1,0,0,0,0,1,0,0,0,0,0,0,0,0,0,0,0,0,0,0,0,0,0,0,0,0,0,0,0,0,0,0,1,0,0,0,0,0,0,0,0,0,0,0,0,0,Anderson,£10.80m ,32.0,175.0,Midfielder - Central Midfield,left,Retired,32.0,6.0,3.0,1995.0,16.0,2.0,1.0,1078.0,27.0,2.0,5.0,1566.0,17.0,0.0,0.0,602.0,36.0,0.0,5.0,2272.0,20.0,1.0,1.0,948.0,12.0,0.0,0.0,536.0,nan,nan,nan,nan,14.0,0.0,0.0,769.0,Premier League,1.0,0.0,0.0,45.0,nan,nan,nan,nan
19/6/2011,Ander Iturraspe,67037562,796,3/8/1989,22,0,0,0,0,4350,6250,6250,144,128,236277,187,75,M C,3,1,2,1,1,1,2,2,3,3,1,4,10,12,10,13,6,12,13,7,9,13,8,11,14,10,11,12,11,12,14,13,13,11,11,10,11,15,13,13,11,12,14,14,11,13,20,13,13,12,7,12,7,11,13,12,14,13,10,10,6,5,1,1,20,14,14,1,20,M C,401,1,1,1,14,1,1,1,1,1,10,20,1,14,1,1,0,0,0,0,0,0,0,0,0,0,0,0,0,0,0,0,0,0,0,0,0,0,0,0,0,0,0,0,0,0,0,0,0,0,0,0,0,0,0,0,0,0,0,0,0,0,0,0,0,Ander Iturraspe,£3.15m ,31.0,187.0,Midfielder - Defensive Midfield,right,Without Club,18.0,0.0,0.0,624.0,58.0,1.0,0.0,4524.0,41.0,0.0,1.0,3098.0,38.0,0.0,3.0,3145.0,38.0,2.0,0.0,2759.0,28.0,0.0,2.0,1423.0,32.0,0.0,1.0,1589.0,38.0,0.0,0.0,2445.0,5.0,0.0,0.0,260.0,LaLiga,18.0,0.0,0.0,975.0,nan,nan,nan,nan
19/6/2011,Ander Herrera,67009261,796,8/14/1989,21,0,0,9,1,4950,7000,7000,161,139,5691700,182,72,M/AM C,2,3,2,1,1,3,3,3,2,3,3,11,10,14,8,18,9,8,10,8,6,16,11,10,17,14,13,12,13,11,18,15,16,16,12,13,8,15,13,14,18,7,10,11,12,12,20,11,8,8,12,16,6,12,8,15,14,13,15,12,13,8,1,1,20,18,10,10,20,M/AM C,411,1,1,1,18,10,10,1,1,1,9,20,10,10,1,1,17592187093136,0,0,0,0,1,0,0,1,0,0,0,0,0,0,0,0,0,0,0,0,1,0,0,0,0,0,0,0,0,0,0,0,0,0,0,0,0,0,0,0,0,0,0,0,1,0,0,0,Ander Herrera,£7.20m ,31.0,182.0,Midfielder - Central Midfield,right,Paris Saint-Germain,35.0,2.0,2.0,2663.0,54.0,4.0,11.0,3751.0,35.0,2.0,2.0,2885.0,39.0,5.0,6.0,2934.0,31.0,8.0,5.0,2134.0,41.0,5.0,6.0,2410.0,50.0,2.0,11.0,4020.0,39.0,2.0,2.0,2209.0,28.0,3.0,3.0,1887.0,LaLiga,22.0,1.0,1.0,1282.0,9.0,0.0,0.0,545.0
19/6/2011,Altin Lala,3601057,752,11/18/1976,34,74,3,0,0,3950,6325,6000,134,115,60522,172,68,DM/M C,3,1,1,2,1,2,3,1,2,1,1,7,9,7,6,9,8,7,7,12,17,12,12,17,8,18,16,17,14,17,7,10,17,8,18,6,16,19,14,12,14,13,9,12,15,7,20,12,12,18,17,11,7,14,18,13,19,11,15,7,13,8,1,1,18,1,1,1,18,DM/M C,311,1,1,1,1,1,1,1,1,1,20,18,1,1,1,1,2199027449856,0,0,0,0,0,0,0,0,0,0,0,0,0,0,0,0,0,0,0,0,0,0,1,0,0,0,0,0,0,0,0,0,0,0,0,0,0,0,0,0,0,1,0,0,0,0,0,0
19/6/2011,Alou Diarra,876548,769,7/15/1981,29,34,0,15,1,5800,7200,6489,155,144,1581028,190,79,DM C,3,1,1,1,1,3,3,4,3,1,3,5,11,8,8,12,10,17,12,8,15,12,7,16,12,17,16,16,15,12,8,13,16,6,18,7,15,15,17,14,12,17,16,8,14,12,20,18,17,12,17,16,6,10,13,16,12,13,11,11,10,13,13,1,15,1,10,1,15,DM C,301,1,1,1,1,1,1,13,1,1,20,15,1,10,1,1,8623489088,0,0,0,0,0,0,1,0,0,0,0,0,0,0,0,0,0,0,0,0,0,0,0,0,0,1,0,0,0,0,0,0,0,1,0,0,0,0,0,0,0,0,0,0,0,0,0,0,Alou Diarra,£5.40m ,39.0,189.0,Midfielder - Defensive Midfield,right,Retired,33.0,4.0,1.0,2888.0,50.0,2.0,1.0,3755.0,20.0,0.0,1.0,1245.0,8.0,0.0,0.0,404.0,12.0,1.0,0.0,691.0,33.0,0.0,0.0,2734.0,23.0,2.0,0.0,1637.0,nan,nan,nan,nan,nan,nan,nan,nan,Ligue 1,nan,nan,nan,nan,nan,nan,nan,nan
19/6/2011,Almog Cohen,42004287,775,9/1/1988,22,7,0,14,0,5200,6600,6400,144,128,568194,169,65,DM/M C,2,2,3,2,3,2,2,1,1,1,1,9,8,11,9,13,10,5,14,8,14,13,7,14,15,14,13,15,11,12,10,13,16,8,11,11,13,14,17,14,12,9,6,9,12,13,20,15,10,15,5,11,12,8,17,14,13,14,17,15,16,4,1,1,18,12,1,1,18,DM/M C,311,1,1,1,12,1,1,1,1,1,20,18,1,1,1,1,65536,0,0,0,0,0,0,0,0,0,0,0,0,0,0,0,0,1,0,0,0,0,0,0,0,0,0,0,0,0,0,0,0,0,0,0,0,0,0,0,0,0,0,0,0,0,0,0,0,Almog Cohen,£1.80m ,32.0,170.0,Midfielder - Central Midfield,right,Maccabi Netanya,27.0,2.0,0.0,1703.0,26.0,0.0,0.0,1236.0,22.0,1.0,1.0,1527.0,25.0,1.0,2.0,1983.0,5.0,0.0,0.0,141.0,20.0,0.0,2.0,825.0,33.0,7.0,2.0,2638.0,30.0,3.0,1.0,2359.0,22.0,1.0,0.0,1712.0,Bundesliga,25.0,0.0,1.0,1977.0,1.0,0.0,0.0,90.0
19/6/2011,Almen Abdi,5725575,798,10/21/1986,24,6,0,5,0,4800,6400,6700,142,137,820614,182,75,M/AM C,2,3,3,2,1,3,3,5,2,1,2,12,12,12,11,14,14,8,16,4,8,14,13,12,14,13,14,12,14,11,15,11,11,14,7,12,10,14,15,12,12,12,10,11,12,13,20,12,11,14,8,13,9,15,9,14,10,10,10,14,13,9,1,1,19,20,1,1,20,M/AM C,521,1,1,1,20,1,1,1,1,1,14,19,1,1,1,1,0,0,0,0,0,0,0,0,0,0,0,0,0,0,0,0,0,0,0,0,0,0,0,0,0,0,0,0,0,0,0,0,0,0,0,0,0,0,0,0,0,0,0,0,0,0,0,0,0,Almen Abdi,£1.35m ,34.0,181.0,Midfielder - Central Midfield,right,Without Club,21.0,0.0,1.0,869.0,33.0,1.0,1.0,1531.0,44.0,12.0,9.0,3657.0,16.0,2.0,3.0,982.0,33.0,9.0,2.0,2268.0,38.0,2.0,0.0,2335.0,16.0,1.0,0.0,742.0,7.0,0.0,0.0,325.0,nan,nan,nan,nan,Serie A,nan,nan,nan,nan,nan,nan,nan,nan
19/6/2011,Alexander Tettey,762026,786,4/4/1986,25,7,0,12,0,3650,5804,5800,145,129,312603,180,75,DM/M C,1,1,3,2,2,2,3,4,2,3,1,5,11,7,10,11,6,10,12,3,12,11,7,13,11,15,16,12,8,11,8,11,15,8,14,14,14,17,19,13,11,12,12,12,17,14,20,18,15,14,10,15,5,9,11,15,14,12,16,14,15,5,12,1,18,1,1,8,18,DM/M C,311,1,1,1,1,1,1,12,1,1,20,18,8,1,1,1,616,0,0,0,1,0,1,1,0,0,1,0,0,0,0,0,0,0,0,0,0,0,0,0,0,0,0,0,0,0,0,0,0,0,0,0,0,0,0,0,0,0,0,0,0,0,0,0,0,Alexander Tettey,£2.03m ,34.0,181.0,Midfielder - Defensive Midfield,right,Norwich City,20.0,4.0,2.0,1603.0,32.0,1.0,0.0,1716.0,31.0,1.0,2.0,2163.0,22.0,1.0,0.0,1608.0,39.0,1.0,1.0,3223.0,23.0,2.0,0.0,1952.0,37.0,0.0,0.0,3050.0,27.0,0.0,1.0,2125.0,32.0,1.0,0.0,2558.0,Ligue 1,32.0,1.0,1.0,2502.0,1.0,0.0,0.0,90.0
19/6/2011,Alexander Merkel,35017440,771,2/22/1992,19,0,0,0,0,1922,5039,5533,142,112,292258,179,70,M/AM RC,2,2,1,1,3,2,1,1,1,3,1,13,14,10,8,12,14,9,12,7,4,13,8,5,14,9,13,11,9,11,14,10,14,9,7,14,7,9,11,13,14,9,9,11,14,15,20,11,8,12,7,7,8,16,17,14,15,11,15,18,16,10,1,1,20,17,16,12,20,M/AM RC,413,1,1,1,17,9,14,1,1,1,1,20,12,16,1,1,16,0,0,0,0,1,0,0,0,0,0,0,0,0,0,0,0,0,0,0,0,0,0,0,0,0,0,0,0,0,0,0,0,0,0,0,0,0,0,0,0,0,0,0,0,0,0,0,0,Alexander Merkel,£4.50m ,28.0,179.0,Midfielder - Central Midfield,right,Al-Faisaly Harmah,19.0,1.0,1.0,1132.0,17.0,0.0,3.0,1139.0,12.0,1.0,0.0,462.0,12.0,1.0,2.0,640.0,11.0,0.0,1.0,405.0,2.0,0.0,0.0,109.0,11.0,0.0,1.0,628.0,18.0,1.0,4.0,1247.0,36.0,0.0,2.0,2947.0,Serie A,28.0,2.0,4.0,2341.0,2.0,0.0,0.0,180.0
19/6/2011,Alex Song,8428095,11,9/9/1987,23,24,0,0,0,6264,7867,7717,167,157,20148243,185,74,D/DM/M C,1,1,1,1,1,2,3,4,1,1,2,5,9,12,9,13,5,15,7,10,14,13,10,16,13,14,16,16,17,16,12,14,17,9,9,13,15,16,18,12,14,16,13,13,16,11,20,18,17,16,11,13,5,15,14,14,15,12,15,13,16,8,17,1,18,1,1,1,18,D/DM/M C,331,1,1,1,1,1,1,17,1,1,20,18,1,1,1,1,4,0,0,1,0,0,0,0,0,0,0,0,0,0,0,0,0,0,0,0,0,0,0,0,0,0,0,0,0,0,0,0,0,0,0,0,0,0,0,0,0,0,0,0,0,0,0,0,0,Alex Song,£25.65m ,33.0,185.0,Midfielder - Defensive Midfield,right,Without Club,42.0,5.0,4.0,3390.0,46.0,1.0,14.0,4079.0,34.0,1.0,1.0,2394.0,31.0,0.0,1.0,1720.0,31.0,0.0,3.0,2434.0,16.0,0.0,1.0,938.0,16.0,0.0,2.0,1075.0,7.0,1.0,0.0,319.0,16.0,0.0,0.0,1064.0,Premier League,12.0,1.0,0.0,584.0,nan,nan,nan,nan
19/6/2011,Alessandro Gazzi,830317,776,1/28/1983,28,0,0,0,0,2570,7000,7000,140,135,1540624,184,83,DM/M C,1,1,1,1,1,1,1,1,1,1,1,5,7,9,8,8,7,14,10,7,14,13,4,17,11,16,16,17,14,14,12,13,16,7,16,10,17,19,18,12,11,15,11,8,16,11,20,18,16,15,15,15,4,9,14,15,15,15,18,18,18,5,8,1,20,1,1,1,20,DM/M C,421,1,1,1,1,1,1,8,1,1,18,20,1,1,1,1,274877907008,0,0,0,0,0,0,1,0,0,0,0,0,0,0,0,0,0,0,0,0,0,0,0,0,0,0,0,0,0,0,0,0,0,0,0,0,0,0,1,0,0,0,0,0,0,0,0,0,Alessandro Gazzi,£1.80m ,37.0,184.0,Midfielder - Defensive Midfield,left,US Alessandria Calcio 1912,33.0,1.0,2.0,2741.0,35.0,1.0,3.0,2800.0,35.0,2.0,0.0,2959.0,11.0,0.0,1.0,460.0,41.0,0.0,0.0,3302.0,17.0,1.0,0.0,1145.0,27.0,0.0,0.0,2178.0,34.0,0.0,1.0,2579.0,39.0,0.0,1.0,2737.0,Serie A,19.0,0.0,0.0,1004.0,5.0,0.0,0.0,222.0
19/6/2011,Aleksandar Ignjovski,62013411,802,1/27/1991,20,0,0,1,0,3500,5939,6550,154,132,678486,175,68,DM/M C,3,1,1,3,1,3,2,3,3,1,3,8,10,11,7,13,6,8,7,8,17,13,10,17,12,18,12,17,8,8,11,13,18,6,10,10,9,15,19,15,17,11,8,15,14,12,20,16,8,11,12,11,4,19,14,15,13,14,17,14,13,5,14,14,19,12,14,14,19,DM/M C,311,1,1,1,12,1,1,1,14,14,20,19,13,13,14,14,137438986240,0,0,0,0,0,0,0,0,0,0,0,0,0,0,0,1,0,0,0,0,0,0,0,0,0,0,0,0,0,0,0,0,0,0,0,0,0,1,0,0,0,0,0,0,0,0,0,0,Aleksandar Ignjovski,£3.60m ,29.0,175.0,Midfielder - Defensive Midfield,right,Holstein Kiel,25.0,0.0,2.0,1953.0,26.0,0.0,1.0,1994.0,21.0,1.0,2.0,1667.0,14.0,0.0,0.0,811.0,22.0,0.0,1.0,1366.0,19.0,0.0,2.0,1239.0,21.0,0.0,0.0,1243.0,1.0,0.0,0.0,55.0,17.0,0.0,0.0,1059.0,Bundesliga,22.0,0.0,0.0,1261.0,5.0,0.0,0.0,224.0
19/6/2011,Alejandro Faurlin,956670,1649,8/9/1986,24,0,0,10,2,3250,5250,6550,152,138,841690,185,79,DM/M C,2,2,1,1,2,1,1,2,2,2,2,14,13,15,10,16,12,9,13,5,11,18,15,12,15,9,13,12,15,12,13,16,14,15,10,11,12,14,13,14,12,13,12,20,16,12,6,12,14,12,7,14,4,9,12,11,13,12,13,13,15,6,1,1,20,14,1,1,20,DM/M C,421,1,1,1,14,1,1,1,1,1,17,20,1,1,1,1,17196646400,0,0,0,0,0,0,0,0,0,0,0,0,0,0,0,0,0,0,0,0,0,0,0,0,1,0,0,0,0,0,0,0,0,0,1,0,0,0,0,0,0,0,0,0,0,0,0,0,Alejandro Faurlín,£4.05m ,34.0,185.0,Midfielder - Central Midfield,left,Without Club,41.0,3.0,3.0,3553.0,21.0,1.0,2.0,1890.0,21.0,0.0,3.0,1442.0,9.0,0.0,1.0,582.0,3.0,0.0,0.0,150.0,30.0,0.0,6.0,2469.0,31.0,5.0,1.0,2300.0,17.0,0.0,0.0,851.0,20.0,0.0,0.0,1480.0,Premier League,13.0,0.0,1.0,882.0,nan,nan,nan,nan
19/6/2011,Albin Ekdal,8120012,797,7/28/1989,21,0,0,8,2,3000,6250,6500,167,134,529935,186,75,M C,1,1,1,2,3,2,1,1,1,3,1,11,12,12,9,15,12,12,13,10,11,15,14,12,16,7,14,17,15,14,16,15,14,15,13,15,14,14,14,10,12,11,13,5,15,12,20,13,12,9,5,14,11,13,10,14,12,15,12,12,10,3,1,1,20,15,8,8,20,M C,401,1,1,1,15,8,8,1,1,1,14,20,7,5,1,1,0,0,0,0,0,0,0,0,0,0,0,0,0,0,0,0,0,0,0,0,0,0,0,0,0,0,0,0,0,0,0,0,0,0,0,0,0,0,0,0,0,0,0,0,0,0,0,0,0,Albin Ekdal,£2.70m ,31.0,186.0,Midfielder - Defensive Midfield,right,UC Sampdoria,24.0,1.0,1.0,1556.0,31.0,1.0,1.0,2080.0,34.0,1.0,1.0,2547.0,23.0,1.0,0.0,1786.0,34.0,5.0,3.0,2813.0,15.0,0.0,0.0,1194.0,23.0,1.0,1.0,1423.0,19.0,0.0,1.0,1108.0,33.0,0.0,0.0,2771.0,Serie A,33.0,0.0,4.0,2406.0,5.0,0.0,0.0,412.0
19/6/2011,Alberto Rivera,4211129,796,2/19/1978,33,0,0,0,0,4439,6683,6683,146,133,487426,170,69,DM/M C,3,3,1,3,1,3,2,3,3,2,1,7,10,14,11,14,11,9,9,7,8,15,16,9,14,5,15,14,13,13,16,14,17,11,16,13,15,14,15,12,16,12,8,6,10,13,20,15,12,15,8,13,12,14,13,15,16,15,13,12,14,9,1,1,20,10,6,6,20,DM/M C,421,1,1,1,10,1,1,1,1,1,16,20,6,6,1,1,128,0,0,0,0,0,0,0,1,0,0,0,0,0,0,0,0,0,0,0,0,0,0,0,0,0,0,0,0,0,0,0,0,0,0,0,0,0,0,0,0,0,0,0,0,0,0,0,0,Alberto Rivera,£1.35m ,42.0,167.0,Midfielder - Central Midfield,both,Retired,31.0,0.0,2.0,2551.0,29.0,0.0,3.0,1884.0,39.0,0.0,0.0,3305.0,15.0,0.0,0.0,808.0,nan,nan,nan,nan,nan,nan,nan,nan,nan,nan,nan,nan,nan,nan,nan,nan,nan,nan,nan,nan,LaLiga,nan,nan,nan,nan,nan,nan,nan,nan
19/6/2011,Alberto Lora,67011231,796,3/25/1987,24,0,0,0,0,4500,6534,6534,151,141,707375,165,66,D/M RC,3,2,1,2,3,3,2,5,2,3,2,9,13,12,9,13,4,13,13,13,13,15,11,13,14,12,13,14,11,14,9,13,12,11,10,13,13,16,16,13,14,14,8,7,15,14,20,16,14,18,10,12,10,12,14,10,14,13,18,17,8,15,20,15,19,15,20,5,19,D/M RC,113,1,1,5,13,5,15,1,5,20,5,19,5,15,5,15,0,0,0,0,0,0,0,0,0,0,0,0,0,0,0,0,0,0,0,0,0,0,0,0,0,0,0,0,0,0,0,0,0,0,0,0,0,0,0,0,0,0,0,0,0,0,0,0,0,Alberto Lora,£2.52m ,33.0,164.0,Midfielder - Central Midfield,right,Marino Luanco,37.0,0.0,5.0,3261.0,28.0,3.0,1.0,2331.0,32.0,0.0,4.0,2381.0,37.0,0.0,4.0,2866.0,41.0,1.0,0.0,3637.0,32.0,0.0,4.0,2501.0,7.0,0.0,0.0,376.0,10.0,1.0,0.0,683.0,16.0,0.0,0.0,1129.0,LaLiga,27.0,0.0,0.0,2400.0,2.0,0.0,0.0,66.0
19/6/2011,Alberto Costa,8438629,1649,1/9/1985,26,1,0,0,0,5600,6773,7250,149,147,3490060,176,75,M C,2,1,2,1,2,3,3,5,2,3,2,17,15,12,13,14,18,8,17,5,7,13,14,13,13,13,15,16,15,12,13,13,16,12,12,15,12,16,17,14,13,13,8,20,14,12,11,16,12,14,13,14,7,10,18,17,10,12,16,11,11,7,1,1,20,12,10,10,20,M C,401,1,1,1,12,10,10,1,1,1,14,20,10,10,1,1,8798240506112,0,0,0,0,0,0,0,0,1,0,0,0,0,0,0,0,0,0,0,0,0,0,0,0,0,0,0,0,0,0,0,1,0,0,0,0,0,0,0,0,0,0,0,1,0,0,0,0,Alberto Botía,£5.40m ,31.0,188.0,Defender - Centre-Back,right,Al-Wahda Mekka,29.0,1.0,0.0,2528.0,36.0,1.0,2.0,3142.0,25.0,2.0,0.0,1746.0,35.0,0.0,2.0,3036.0,26.0,2.0,0.0,2083.0,27.0,4.0,0.0,2222.0,36.0,2.0,2.0,3157.0,17.0,2.0,0.0,1352.0,30.0,2.0,0.0,2651.0,LaLiga,26.0,1.0,0.0,2322.0,2.0,0.0,0.0,180.0
19/6/2011,Alberto Aquilani,836911,776,7/7/1984,26,16,2,20,5,6500,7500,7500,149,145,1755060,186,77,M/AM C,1,1,1,1,1,1,1,1,1,1,1,13,12,13,10,15,12,8,15,6,10,15,15,12,15,9,14,7,12,12,16,15,9,11,6,13,13,14,14,12,13,14,12,12,11,14,20,13,13,11,10,15,17,12,10,11,16,13,16,15,12,6,1,1,20,17,8,8,20,M/AM C,411,1,1,1,17,5,5,1,1,1,13,20,8,8,1,1,26388283261696,0,0,0,0,0,0,0,0,1,1,0,0,0,0,0,0,0,0,0,0,0,0,1,0,0,0,0,0,0,0,0,0,0,0,0,0,0,0,0,0,0,0,0,1,1,0,0,0,Alberto Aquilani,£8.10m ,36.0,186.0,Midfielder - Central Midfield,right,Retired,36.0,2.0,6.0,2854.0,31.0,1.0,7.0,1791.0,27.0,7.0,6.0,1857.0,44.0,7.0,5.0,3459.0,34.0,1.0,0.0,1952.0,32.0,5.0,2.0,1626.0,25.0,1.0,1.0,1786.0,23.0,0.0,0.0,1389.0,nan,nan,nan,nan,Serie A,nan,nan,nan,nan,nan,nan,nan,nan
19/6/2011,Alain Traoré,34001338,9,1/1/1988,23,15,7,0,0,5350,6650,5980,150,133,586439,176,66,M/AM C,2,2,1,1,1,1,1,4,3,2,3,11,13,14,10,14,14,6,15,6,4,13,12,5,16,7,13,11,13,11,15,13,14,14,7,13,10,14,14,15,14,12,8,20,14,13,11,15,7,12,7,14,10,8,11,14,14,12,11,16,16,7,1,1,18,20,1,14,20,M/AM C,521,1,1,1,20,14,1,1,1,1,12,18,14,1,1,1,640,0,0,0,0,0,0,0,1,0,1,0,0,0,0,0,0,0,0,0,0,0,0,0,0,0,0,0,0,0,0,0,0,0,0,0,0,0,0,0,0,0,0,0,0,0,0,0,0,Alain Traoré,£4.50m ,31.0,176.0,Midfielder - Attacking Midfield,left,Renaissance de Berkane,25.0,5.0,0.0,1863.0,27.0,9.0,8.0,2143.0,14.0,6.0,4.0,1111.0,22.0,2.0,1.0,1400.0,8.0,0.0,0.0,286.0,7.0,0.0,0.0,210.0,19.0,1.0,2.0,684.0,16.0,4.0,1.0,1039.0,22.0,3.0,2.0,1306.0,Ligue 1,25.0,6.0,7.0,1299.0,nan,nan,nan,nan
19/6/2011,Ákos Buzsáky,133659,773,5/7/1982,29,19,2,0,0,4200,6350,6050,140,122,544884,180,74,M/AM RLC,2,2,1,1,2,1,1,2,2,1,2,11,14,13,14,14,13,6,14,8,7,16,11,10,15,10,10,7,14,11,14,13,8,16,7,12,10,10,13,10,11,13,9,14,15,12,20,11,12,9,4,10,13,11,15,11,15,8,13,12,13,9,1,1,20,20,15,17,20,M/AM RLC,416,1,1,8,20,17,15,1,1,1,1,20,10,14,1,1,17665200488704,0,0,0,0,0,0,0,0,1,0,0,0,0,0,0,0,0,0,0,0,0,0,0,0,0,0,0,0,0,0,0,0,1,0,0,0,1,0,0,0,0,0,0,0,1,0,0,0,Ákos Buzsáky,£900Th. ,38.0,180.0,Midfielder - Central Midfield,right,Retired,19.0,0.0,0.0,847.0,21.0,2.0,2.0,1061.0,13.0,0.0,0.0,885.0,4.0,0.0,1.0,187.0,nan,nan,nan,nan,nan,nan,nan,nan,nan,nan,nan,nan,nan,nan,nan,nan,nan,nan,nan,nan,Premier League,nan,nan,nan,nan,nan,nan,nan,nan
19/6/2011,Akaki Gogia,92025869,771,1/18/1992,19,0,0,0,0,1599,5900,5900,129,110,646382,177,76,M/AM C,2,1,3,1,2,2,2,1,1,2,1,12,8,12,13,12,14,12,13,1,8,11,10,11,13,11,14,3,7,9,12,12,7,10,2,9,10,11,11,12,11,7,8,14,10,13,20,8,7,10,9,10,7,10,7,14,14,17,12,11,13,13,1,1,18,20,1,1,20,M/AM C,521,1,1,15,20,1,1,1,1,1,1,18,1,1,1,1,0,0,0,0,0,0,0,0,0,0,0,0,0,0,0,0,0,0,0,0,0,0,0,0,0,0,0,0,0,0,0,0,0,0,0,0,0,0,0,0,0,0,0,0,0,0,0,0,0,Akaki Gogia,£540Th. ,28.0,178.0,Forward - Right Winger,both,1.FC Union Berlin,36.0,18.0,2.0,2954.0,14.0,0.0,1.0,588.0,25.0,1.0,3.0,1413.0,36.0,8.0,5.0,2962.0,38.0,13.0,10.0,3267.0,14.0,0.0,1.0,503.0,24.0,10.0,2.0,1800.0,22.0,2.0,5.0,1471.0,31.0,6.0,5.0,1505.0,Bundesliga,3.0,0.0,0.0,120.0,0.0,0.0,0.0,0.0
19/6/2011,Adrien,55001975,788,3/15/1989,22,0,0,14,1,3250,5750,6000,135,113,113253,175,75,DM/M C,3,2,2,2,2,3,3,4,1,2,1,13,13,12,12,14,11,9,12,8,8,14,11,11,13,12,14,12,15,15,16,14,14,11,10,13,15,14,13,10,12,11,8,8,14,10,20,12,9,16,8,13,7,13,14,14,16,13,15,16,17,5,1,1,20,10,5,5,20,DM/M C,421,1,1,1,10,1,1,1,1,1,17,20,5,5,1,1,16777280,0,0,0,0,0,0,1,0,0,0,0,0,0,0,0,0,0,0,0,0,0,0,0,0,1,0,0,0,0,0,0,0,0,0,0,0,0,0,0,0,0,0,0,0,0,0,0,0,Adrián, ,33.0,190.0,Goalkeeper,right,Liverpool FC,9.0,6.0,4.0,810.0,11.0,12.0,5.0,990.0,32.0,46.0,11.0,2869.0,26.0,42.0,7.0,2340.0,42.0,54.0,10.0,3781.0,36.0,44.0,10.0,3300.0,19.0,36.0,6.0,1710.0,22.0,31.0,8.0,1980.0,5.0,8.0,2.0,450.0,LaLiga,18.0,24.0,3.0,1563.0,5.0,11.0,2.0,450.0
19/6/2011,Adrián,67011224,796,5/25/1988,23,0,0,0,0,4016,5923,5923,131,124,510871,184,75,M LC,3,3,1,2,3,2,3,7,1,3,2,13,13,13,11,14,12,9,13,10,7,13,11,7,13,7,11,12,13,11,13,11,10,13,11,11,9,10,10,14,14,9,11,20,14,14,11,14,9,11,6,11,11,11,12,13,10,11,14,12,7,11,1,1,20,15,1,17,20,M LC,404,1,1,1,12,15,1,1,1,1,7,20,17,1,1,1,141836999983136,0,0,0,0,0,1,0,0,0,0,0,0,0,0,0,0,0,0,0,0,0,0,0,0,0,0,0,0,0,0,0,0,0,0,0,0,0,0,0,0,1,0,0,0,0,0,0,1,Adrián, ,33.0,190.0,Goalkeeper,right,Liverpool FC,9.0,6.0,4.0,810.0,11.0,12.0,5.0,990.0,32.0,46.0,11.0,2869.0,26.0,42.0,7.0,2340.0,42.0,54.0,10.0,3781.0,36.0,44.0,10.0,3300.0,19.0,36.0,6.0,1710.0,22.0,31.0,8.0,1980.0,5.0,8.0,2.0,450.0,LaLiga,18.0,24.0,3.0,1563.0,5.0,11.0,2.0,450.0
19/6/2011,Adrián Ricchiuti,702448,1649,6/30/1978,32,0,0,0,0,4250,5000,6250,132,125,336478,168,70,M/AM C,2,3,3,3,1,1,1,3,1,3,3,14,13,17,11,14,14,6,12,5,8,16,14,8,15,8,10,13,13,13,14,14,14,16,15,14,8,12,14,15,16,10,6,20,14,13,5,10,6,17,12,13,12,10,18,13,14,17,18,20,16,5,1,1,18,20,10,14,20,M/AM C,521,1,1,11,20,14,10,1,1,1,1,18,12,8,1,1,17627084752896,0,0,0,0,0,0,0,0,0,0,0,1,0,0,0,0,0,0,0,0,0,1,0,0,0,0,0,0,0,1,0,0,0,0,0,1,0,0,0,0,0,0,0,0,1,0,0,0,Adrián Ricchiuti,£270Th. ,42.0,168.0,Forward - Second Striker,right,Without Club,31.0,1.0,3.0,1898.0,21.0,0.0,1.0,855.0,9.0,0.0,0.0,99.0,11.0,2.0,1.0,440.0,18.0,5.0,2.0,1346.0,22.0,2.0,1.0,1347.0,nan,nan,nan,nan,15.0,5.0,0.0,1177.0,21.0,9.0,0.0,1601.0,Serie A,4.0,1.0,1.0,264.0,nan,nan,nan,nan
19/6/2011,Ádám Pintér,38001863,773,6/12/1988,23,5,0,7,0,3717,5726,5726,129,115,374240,190,76,D/DM C,2,1,2,3,1,2,1,7,1,2,2,7,10,9,8,11,12,16,8,10,14,11,8,13,10,12,11,14,9,13,8,10,10,6,10,7,12,16,14,8,10,14,16,13,12,12,20,13,13,14,10,11,10,11,8,12,9,13,6,15,7,8,20,1,15,1,1,1,20,D/DM C,111,1,9,1,1,1,1,20,1,1,19,15,1,1,1,1,0,0,0,0,0,0,0,0,0,0,0,0,0,0,0,0,0,0,0,0,0,0,0,0,0,0,0,0,0,0,0,0,0,0,0,0,0,0,0,0,0,0,0,0,0,0,0,0,0,Ádám Pintér,£900Th. ,32.0,190.0,Defender - Centre-Back,right,MTK Budapest,15.0,1.0,0.0,847.0,17.0,0.0,0.0,1259.0,20.0,0.0,0.0,1466.0,13.0,0.0,0.0,548.0,17.0,0.0,0.0,1151.0,26.0,3.0,0.0,1698.0,29.0,0.0,0.0,1982.0,10.0,0.0,0.0,518.0,25.0,0.0,0.0,2059.0,LaLiga,24.0,0.0,1.0,2108.0,nan,nan,nan,nan
19/6/2011,Adam Nemec,7562297,794,9/2/1985,25,2,0,0,0,4014,6071,6250,134,125,192038,190,84,M/AM/S C,2,2,2,3,1,1,3,3,3,2,2,2,8,11,12,14,3,16,8,8,13,14,7,14,13,4,14,14,11,16,11,13,13,12,10,12,15,19,20,10,4,19,17,8,13,11,20,18,19,13,5,11,9,7,8,12,11,9,12,13,9,9,1,1,17,20,1,1,20,M/AM/S C,531,1,1,20,20,1,1,1,1,1,1,17,1,1,1,1,262144,0,0,0,0,0,0,0,0,0,0,0,0,0,0,0,0,0,0,1,0,0,0,0,0,0,0,0,0,0,0,0,0,0,0,0,0,0,0,0,0,0,0,0,0,0,0,0,0,Adam Nemec,£630Th. ,35.0,190.0,Forward - Centre-Forward,both,Dinamo Bucharest,27.0,4.0,2.0,1073.0,24.0,5.0,1.0,1523.0,30.0,9.0,2.0,2221.0,29.0,5.0,2.0,1661.0,18.0,2.0,1.0,1034.0,19.0,6.0,0.0,1095.0,31.0,13.0,3.0,2263.0,33.0,7.0,4.0,2188.0,28.0,16.0,2.0,2407.0,Bundesliga,14.0,1.0,3.0,1125.0,5.0,1.0,0.0,450.0
19/6/2011,Adam Matuszczyk,35014358,787,2/14/1989,22,10,1,4,0,3900,6500,6200,145,124,307212,183,73,DM C,1,1,1,3,3,2,2,5,1,1,2,10,9,11,10,10,13,10,15,10,12,12,11,11,13,11,13,12,14,13,12,12,13,9,13,9,13,14,13,12,12,13,11,15,14,11,20,12,11,13,13,12,6,12,12,13,15,13,14,11,12,8,8,7,15,7,10,7,15,DM C,301,1,1,1,7,1,3,8,5,5,20,15,5,10,7,7,0,0,0,0,0,0,0,0,0,0,0,0,0,0,0,0,0,0,0,0,0,0,0,0,0,0,0,0,0,0,0,0,0,0,0,0,0,0,0,0,0,0,0,0,0,0,0,0,0,Adam Matuschyk,£1.80m ,31.0,183.0,Midfielder - Defensive Midfield,both,1.FC Düren,27.0,2.0,1.0,1766.0,20.0,1.0,0.0,629.0,30.0,1.0,1.0,2183.0,25.0,1.0,0.0,1462.0,13.0,0.0,0.0,615.0,32.0,1.0,3.0,2507.0,2.0,0.0,0.0,92.0,34.0,0.0,1.0,2678.0,27.0,0.0,1.0,2165.0,Bundesliga,25.0,1.0,0.0,1914.0,1.0,0.0,0.0,37.0
19/6/2011,Abel,7444809,796,2/20/1982,29,0,0,0,0,4000,6000,6000,129,125,423014,182,72,M/AM C,3,3,2,1,3,1,3,1,1,2,1,15,12,10,8,13,17,8,14,8,9,14,14,9,14,7,10,10,14,11,15,12,13,15,10,12,13,15,12,13,12,12,10,12,14,12,20,13,10,15,6,11,5,12,11,12,10,10,14,15,12,8,1,1,20,20,1,1,20,M/AM C,411,1,1,1,20,1,1,1,1,1,1,20,1,1,1,1,68719477376,0,0,0,0,0,0,0,1,0,1,0,0,0,0,0,0,0,0,0,0,0,0,0,0,0,0,0,0,0,0,0,0,0,0,0,0,1,0,0,0,0,0,0,0,0,0,0,0
19/6/2011,Abdoulaye Coulibaly,85074660,31,4/6/1991,20,0,0,0,0,1308,4850,2617,125,97,45289,186,73,DM/M C,3,2,2,2,3,1,1,2,3,1,2,5,6,8,7,11,6,12,9,6,9,11,6,11,11,12,13,13,12,12,9,13,15,5,6,9,9,14,14,12,12,14,13,20,14,10,8,13,13,12,12,13,8,8,8,13,13,11,14,14,14,6,1,1,16,1,1,12,16,DM/M C,311,1,1,1,1,1,1,1,1,1,20,16,12,1,1,1,64,0,0,0,0,0,0,1,0,0,0,0,0,0,0,0,0,0,0,0,0,0,0,0,0,0,0,0,0,0,0,0,0,0,0,0,0,0,0,0,0,0,0,0,0,0,0,0,0,Adama Coulibaly,£2.70m ,40.0,186.0,Defender - Centre-Back,right,Retired,50.0,1.0,1.0,4474.0,9.0,0.0,0.0,747.0,26.0,1.0,0.0,2257.0,43.0,3.0,1.0,3930.0,28.0,2.0,0.0,2403.0,nan,nan,nan,nan,nan,nan,nan,nan,nan,nan,nan,nan,nan,nan,nan,nan,Ligue 1,nan,nan,nan,nan,nan,nan,nan,nan
19/6/2011,Abdou Traoré,34010357,31,1/17/1988,23,12,2,1,1,5110,6274,5692,145,125,427227,180,74,M/AM RC,3,2,2,2,3,2,2,7,2,3,3,9,12,13,6,14,7,9,10,7,4,13,8,4,14,8,11,13,12,12,13,10,14,13,6,11,8,12,14,15,13,13,10,10,14,14,20,17,12,12,8,15,11,10,13,15,14,11,14,14,14,6,1,1,18,20,20,12,17,M/AM RC,523,1,1,1,17,12,20,1,1,1,1,17,12,18,1,1,549755813888,0,0,0,0,0,0,0,0,0,0,0,0,0,0,0,0,0,0,0,0,0,0,0,0,0,0,0,0,0,0,0,0,0,0,0,0,0,0,0,1,0,0,0,0,0,0,0,0,Abdou Traoré,£900Th. ,32.0,180.0,Midfielder - Central Midfield,right,Al-Nahda,28.0,1.0,1.0,1733.0,10.0,1.0,0.0,285.0,11.0,0.0,1.0,699.0,23.0,1.0,0.0,1650.0,20.0,1.0,0.0,873.0,20.0,0.0,0.0,1081.0,10.0,0.0,0.0,130.0,nan,nan,nan,nan,nan,nan,nan,nan,Ligue 1,nan,nan,nan,nan,nan,nan,nan,nan
19/6/2011,Abdou Sissoko,85022790,769,3/20/1990,21,0,0,3,0,2500,3750,3750,145,114,405426,180,68,DM/M LC,3,3,2,3,2,1,2,4,1,1,1,6,9,11,6,11,8,12,11,7,7,12,7,10,13,12,14,12,12,12,12,12,14,11,9,8,10,13,16,15,13,14,11,8,15,12,20,15,11,13,12,14,7,10,12,16,13,12,8,11,11,13,1,1,20,1,1,16,20,DM/M LC,424,1,1,1,1,1,1,1,1,1,18,20,16,1,1,1,0,0,0,0,0,0,0,0,0,0,0,0,0,0,0,0,0,0,0,0,0,0,0,0,0,0,0,0,0,0,0,0,0,0,0,0,0,0,0,0,0,0,0,0,0,0,0,0,0,Abdoul Sissoko,£900Th. ,30.0,183.0,Midfielder - Defensive Midfield,left,Al-Kuwait Sports Club,27.0,0.0,1.0,1899.0,12.0,1.0,0.0,645.0,39.0,0.0,0.0,3252.0,34.0,3.0,2.0,2836.0,13.0,0.0,0.0,856.0,35.0,3.0,6.0,2681.0,24.0,1.0,0.0,1722.0,38.0,2.0,0.0,3127.0,45.0,0.0,0.0,3855.0,Serie A,4.0,0.0,0.0,366.0,nan,nan,nan,nan
19/6/2011,Aaron Ramsey,29000737,801,12/26/1990,20,14,3,12,2,5500,7250,7250,185,138,20426510,178,67,M C,1,1,3,1,2,3,3,3,2,2,3,7,11,12,11,15,6,4,12,3,7,16,5,11,17,8,11,10,14,12,15,12,17,15,7,15,9,12,15,12,17,13,8,16,16,11,20,14,10,14,3,13,5,15,14,14,17,13,17,16,10,3,10,1,20,13,12,1,20,M C,401,1,1,10,13,1,12,1,1,10,1,20,1,12,1,1,4294967424,0,0,0,0,0,0,0,1,0,0,0,0,0,0,0,0,0,0,0,0,0,0,0,0,0,0,0,0,0,0,0,0,1,0,0,0,0,0,0,0,0,0,0,0,0,0,0,0,Aaron Ramsey,£10.35m ,29.0,182.0,Midfielder - Central Midfield,both,Juventus FC,20.0,2.0,0.0,1189.0,44.0,3.0,6.0,3160.0,47.0,2.0,4.0,2692.0,34.0,16.0,10.0,2724.0,41.0,10.0,8.0,2918.0,40.0,6.0,5.0,3134.0,32.0,4.0,5.0,2016.0,32.0,11.0,12.0,2466.0,40.0,6.0,8.0,2171.0,Premier League,35.0,4.0,1.0,1384.0,4.0,0.0,1.0,327.0
