GameDate,Name,UID,NationID,Born,Age,IntCaps,IntGoals,U21Caps,U21Goals,WorldReputation,HomeReputation,CurrentReputation,PA,CA,Price,Height,Weight,PositionsString,GK/AerialAbility,GK/CommandOfArea,GK/Communication,GK/Eccentricity,GK/Handling,GK/Kicking,GK/OneOnOnes,GK/Reflexes,GK/RushingOut,GK/TendencyToPunch,GK/Throwing,Tech/Corners,Tech/Crossing,Tech/Dribbling,Tech/Finishing,Tech/FirstTouch,Tech/Freekicks,Tech/Heading,Tech/LongShots,Tech/Longthrows,Tech/Marking,Tech/Passing,Tech/PenaltyTaking,Tech/Tackling,Tech/Technique,Mental/Aggression,Mental/Anticipation,Mental/Bravery,Mental/Composure,Mental/Concentration,Mental/Vision,Mental/Decisions,Mental/Determination,Mental/Flair,Mental/Leadership,Mental/OffTheBall,Mental/Positioning,Mental/Teamwork,Mental/Workrate,Phy/Acceleration,Phy/Agility,Phy/Balance,Phy/Jumping,Phy/LeftFoot,Phy/NaturalFitness,Phy/Pace,Phy/RightFoot,Phy/Stamina,Phy/Strength,Hidden/Consistency,Hidden/Dirtiness,Hidden/ImportantMatches,Hidden/InjuryProness,Hidden/Versatility,Personality/Adaptability,Personality/Ambition,Personality/Loyalty,Personality/Pressure,Personality/Professional,Personality/Sportsmanship,Personality/Temperament,Personality/Controversy,Positions/PositionsDesc,Positions/PositionsDescVal,Positions/Striker,Positions/AttackingMidfielder,Positions/Centre,Positions/Defender,Positions/DefensiveMidfielder,Positions/Goalkeeper,Positions/Left,Positions/Midfielder,Positions/Right,Positions/Sweeper,Positions/WingBack,Positions/AttackingMidCentral,Positions/AttackingMidLeft,Positions/AttackingMidRight,Positions/DefenderCentral,Positions/DefenderLeft,Positions/DefenderRight,Positions/MidfielderCentral,Positions/MidfielderLeft,Positions/MidfielderRight,Positions/WingBackLeft,Positions/WingBackRight,PPMVal,PPM0,PPM1,PPM2,PPM3,PPM4,PPM5,PPM6,PPM7,PPM8,PPM9,PPM10,PPM11,PPM12,PPM13,PPM14,PPM15,PPM16,PPM17,PPM18,PPM19,PPM20,PPM21,PPM22,PPM23,PPM24,PPM25,PPM26,PPM27,PPM28,PPM29,PPM30,PPM31,PPM32,PPM33,PPM34,PPM35,PPM36,PPM37,PPM38,PPM39,PPM40,PPM41,PPM42,PPM43,PPM44,PPM45,PPM46,PPM47,name,Market Value,current league
29/6/2010,Serge Aurier,85057643,24,12/24/1992,17,0,0,0,0,3422,5264,5250,161,117,14403016,182,70,D/WB R,2,3,3,1,2,1,2,6,3,3,1,8,12,9,6,11,5,10,7,9,11,10,6,12,11,12,14,13,9,13,10,11,15,9,12,9,12,15,14,15,13,13,11,5,14,14,20,15,13,14,12,10,8,10,13,14,14,16,13,15,15,8,D/WB R,112,1,1,14,20,14,1,1,10,20,1,16,1,1,1,1,6,20,10,1,1,1,16,0,0,0,0,0,0,0,0,0,0,0,0,0,0,0,0,0,0,0,0,0,0,0,0,0,0,0,0,0,0,0,0,0,0,0,0,0,0,0,0,0,0,0,0,0,0,0,0,0,Serge Aurier,Â£1.80m ,Ligue 1
29/6/2010,Dennis Appiah,85010865,769,6/9/1992,18,0,0,0,0,1300,4814,2650,179,107,2025411,179,68,D/WB RC,3,3,1,2,3,2,3,1,1,1,2,5,8,8,6,11,6,12,6,7,11,10,6,11,11,9,13,13,13,13,9,11,14,6,8,8,12,14,12,14,13,12,9,5,15,13,20,15,8,14,9,14,7,12,10,14,14,14,12,15,15,6,D/WB RC,113,1,1,18,20,14,1,1,1,20,1,16,1,1,1,18,13,20,1,1,1,1,16,64,0,0,0,0,0,0,1,0,0,0,0,0,0,0,0,0,0,0,0,0,0,0,0,0,0,0,0,0,0,0,0,0,0,0,0,0,0,0,0,0,0,0,0,0,0,0,0,0,Dennis Appiah,Â£135Th. ,Ligue 1
29/6/2010,Thanos Petsos,91014707,772,6/5/1991,19,0,0,1,0,500,4000,4000,125,85,376639,184,80,D RLC,3,1,1,3,3,3,3,1,2,2,3,10,8,8,10,7,5,14,4,4,11,8,5,14,12,9,12,14,9,13,4,6,10,4,11,5,9,11,13,9,8,7,12,20,10,13,9,9,8,4,9,10,11,10,8,13,10,16,7,9,7,9,D RLC,106,1,1,20,20,1,1,20,1,16,1,7,1,1,1,20,20,16,1,1,1,7,1,0,0,0,0,0,0,0,0,0,0,0,0,0,0,0,0,0,0,0,0,0,0,0,0,0,0,0,0,0,0,0,0,0,0,0,0,0,0,0,0,0,0,0,0,0,0,0,0,0,Thanos Petsos,Â£1.35m ,Bundesliga
29/6/2010,Rolf Feltscher,69003383,798,10/6/1990,19,0,0,10,0,3000,5750,5750,129,114,7673430,183,78,D/WB R,2,2,1,3,3,2,2,3,3,3,2,9,11,10,7,14,5,10,8,10,14,11,5,14,13,6,12,10,12,14,12,11,9,4,10,10,12,17,14,11,10,13,16,11,15,13,20,9,9,10,6,6,9,10,14,17,11,9,9,7,5,13,D/WB R,112,1,1,1,20,1,1,1,1,20,1,20,1,1,1,1,6,20,1,1,1,1,20,0,0,0,0,0,0,0,0,0,0,0,0,0,0,0,0,0,0,0,0,0,0,0,0,0,0,0,0,0,0,0,0,0,0,0,0,0,0,0,0,0,0,0,0,0,0,0,0,0,Rolf Feltscher,Â£450Th. ,Serie A
29/6/2010,Michele Contini,43026372,776,3/27/1991,19,0,0,0,0,50,400,400,105,35,1552,192,88,D RLC,1,1,1,1,1,2,2,1,3,2,3,1,3,6,2,4,0,8,2,8,4,2,2,10,2,17,7,5,3,7,2,9,6,4,11,2,11,10,9,12,12,11,12,6,14,12,20,5,5,7,10,10,13,10,8,2,13,13,15,9,7,16,D RLC,106,1,1,20,20,1,1,20,1,20,1,9,1,1,1,20,20,20,1,1,1,6,9,0,0,0,0,0,0,0,0,0,0,0,0,0,0,0,0,0,0,0,0,0,0,0,0,0,0,0,0,0,0,0,0,0,0,0,0,0,0,0,0,0,0,0,0,0,0,0,0,0,Michele Canini,Â£3.42m ,Serie A
29/6/2010,Mario,67066949,796,11/24/1990,19,0,0,0,0,3721,6100,6100,154,122,36629265,178,71,D/WB R,2,2,3,1,2,1,3,7,1,2,3,8,12,10,5,12,6,7,8,12,11,12,8,13,12,13,12,11,13,15,10,11,10,9,10,12,11,15,13,16,12,11,9,6,13,15,20,15,10,17,11,13,6,10,15,16,6,13,8,13,12,17,D/WB R,112,1,1,1,20,1,1,1,8,20,1,16,1,1,1,1,9,20,1,1,8,1,16,32,0,0,0,0,0,1,0,0,0,0,0,0,0,0,0,0,0,0,0,0,0,0,0,0,0,0,0,0,0,0,0,0,0,0,0,0,0,0,0,0,0,0,0,0,0,0,0,0,Marinho,Â£1.17m ,Liga NOS
29/6/2010,Marc Bartra,67063004,796,1/15/1991,19,0,0,0,0,2500,5250,5250,132,105,1978902,184,82,D RC,2,3,3,3,1,2,3,4,3,3,1,5,8,8,5,10,5,11,4,9,13,12,9,12,10,8,11,13,8,12,8,10,8,7,11,8,14,14,13,13,10,12,11,7,11,13,20,14,10,12,10,10,7,12,11,12,11,13,15,13,7,13,D RC,103,1,1,20,20,1,1,10,1,16,1,1,1,1,1,20,10,16,1,1,1,1,1,0,0,0,0,0,0,0,0,0,0,0,0,0,0,0,0,0,0,0,0,0,0,0,0,0,0,0,0,0,0,0,0,0,0,0,0,0,0,0,0,0,0,0,0,0,0,0,0,0,Marc Bartra,Â£1.35m ,LaLiga
29/6/2010,Francis Coquelin,34012022,769,5/13/1991,19,0,0,0,0,2025,3150,4250,149,90,-1,178,73,D/DM/M RC,1,2,2,2,2,1,3,1,1,2,1,5,5,8,5,10,4,9,5,5,10,11,3,13,12,12,11,15,9,10,8,9,16,8,13,10,10,14,15,12,10,12,8,12,14,10,20,15,12,14,5,10,10,15,13,16,14,10,13,15,14,5,D/DM/M RC,333,1,1,20,17,20,1,1,16,17,1,1,1,1,1,1,1,17,16,1,1,1,1,0,0,0,0,0,0,0,0,0,0,0,0,0,0,0,0,0,0,0,0,0,0,0,0,0,0,0,0,0,0,0,0,0,0,0,0,0,0,0,0,0,0,0,0,0,0,0,0,0,Francis Coquelin,Â£1.17m ,Ligue 1
29/6/2010,Fábio,2107501,1651,7/9/1990,19,0,0,0,0,3782,6750,6500,160,123,52274055,172,69,D/WB RL,1,1,2,1,3,2,3,4,3,2,1,6,13,13,12,14,5,10,10,9,10,11,13,11,13,13,11,12,11,10,8,10,14,15,10,14,8,10,14,17,15,13,9,13,14,17,20,10,9,12,11,14,13,13,14,16,10,16,15,14,16,6,D/WB RL,115,1,12,8,20,1,1,20,12,17,1,18,6,12,6,1,20,17,8,12,8,18,15,2.2518E+15,0,0,0,1,0,1,0,0,0,0,0,0,0,0,0,0,0,0,0,0,1,0,0,0,0,0,0,0,0,0,0,0,0,0,0,0,0,0,0,0,0,0,0,0,0,0,0,0,,,
29/6/2010,Davide Santon,43016424,776,1/2/1991,19,5,0,3,0,4970,7350,7350,163,141,99123370,187,77,D/WB RL,1,1,1,1,1,1,1,1,1,1,1,10,14,14,8,13,10,11,11,13,12,13,10,12,14,11,13,12,13,12,13,13,13,10,12,13,12,14,12,15,14,12,12,8,14,15,20,15,13,13,10,15,13,15,13,15,17,15,13,14,17,7,D/WB RL,115,1,12,1,20,1,1,19,14,20,1,19,1,12,12,1,19,20,1,12,14,18,19,268435458,0,1,0,0,0,0,0,0,0,0,0,0,0,0,0,0,0,0,0,0,0,0,0,0,0,0,0,0,1,0,0,0,0,0,0,0,0,0,0,0,0,0,0,0,0,0,0,0,Davide Santon,Â£6.75m ,Serie A
29/6/2010,Vincent Acapandié,8438696,769,2/9/1990,20,0,0,0,0,1300,2650,2650,140,106,5320401,180,79,D/WB R,2,2,3,1,3,3,2,1,1,3,1,6,9,10,9,11,7,7,12,7,11,8,10,10,11,12,14,13,10,10,9,8,14,12,6,12,9,12,13,16,11,14,10,10,14,14,20,14,14,12,12,15,10,16,6,13,15,11,14,14,14,6,D/WB R,112,14,10,14,20,1,1,1,10,20,1,17,1,1,10,10,13,20,1,1,10,1,17,514,0,1,0,0,0,0,0,0,0,1,0,0,0,0,0,0,0,0,0,0,0,0,0,0,0,0,0,0,0,0,0,0,0,0,0,0,0,0,0,0,0,0,0,0,0,0,0,0,Vincent AcapandiÃ©,Â£45Th. ,Ligue 1
29/6/2010,Patrick Funk,29022521,771,2/11/1990,20,0,0,0,0,3000,5750,5750,140,115,8835806,177,73,D/DM/M RC,3,2,1,2,2,3,1,1,1,2,2,14,6,9,5,12,10,10,7,6,12,13,17,13,12,15,12,17,12,12,11,13,14,5,16,8,12,16,18,11,10,12,9,6,15,11,20,14,15,12,6,14,4,16,12,14,16,16,13,12,10,11,D/DM/M RC,433,1,1,20,17,17,1,10,20,17,1,1,1,1,1,1,10,17,20,1,1,1,1,0,0,0,0,0,0,0,0,0,0,0,0,0,0,0,0,0,0,0,0,0,0,0,0,0,0,0,0,0,0,0,0,0,0,0,0,0,0,0,0,0,0,0,0,0,0,0,0,0,Patrick Funk,Â£675Th. ,Bundesliga
29/6/2010,Michel,19019226,1651,2/15/1990,20,0,0,3,0,3906,5624,5250,131,125,10515418,174,67,D/WB R,3,2,3,1,3,3,3,4,3,1,2,12,14,13,12,11,10,7,10,11,12,12,11,12,12,11,12,12,12,9,11,12,14,12,7,13,10,11,12,15,14,11,7,14,13,15,20,15,12,13,8,12,9,13,9,16,12,11,13,12,14,9,D/WB R,112,1,1,1,20,1,1,1,11,20,1,16,1,1,1,1,5,20,1,1,11,1,16,0,0,0,0,0,0,0,0,0,0,0,0,0,0,0,0,0,0,0,0,0,0,0,0,0,0,0,0,0,0,0,0,0,0,0,0,0,0,0,0,0,0,0,0,0,0,0,0,0,Michel,Â£45Th. ,Liga NOS
29/6/2010,Lamine Gassama,34011685,769,10/20/1989,20,0,0,3,0,1300,5309,5250,160,118,8038438,181,74,D/WB R,3,2,1,2,2,3,3,4,2,1,1,8,12,8,6,10,7,10,9,12,12,8,7,13,10,12,13,13,12,12,8,12,14,8,8,11,9,12,14,17,12,13,10,7,14,15,20,15,13,13,12,14,6,10,11,16,12,13,16,15,15,6,D/WB R,112,1,1,10,20,1,1,12,1,20,1,18,1,1,1,10,12,20,1,1,1,12,18,0,0,0,0,0,0,0,0,0,0,0,0,0,0,0,0,0,0,0,0,0,0,0,0,0,0,0,0,0,0,0,0,0,0,0,0,0,0,0,0,0,0,0,0,0,0,0,0,0,Lamine Gassama,Â£810Th. ,Ligue 1
29/6/2010,Jurado,67044755,796,3/14/1990,20,0,0,0,0,1806,4000,4000,125,85,1375851,173,61,D/WB/M R,3,3,3,1,1,3,3,1,1,3,1,9,13,11,9,13,8,7,9,6,9,8,3,9,13,17,10,8,9,7,10,7,7,15,6,7,11,13,10,11,13,13,4,10,16,13,20,8,6,10,8,10,10,8,10,14,14,7,15,11,10,10,D/WB/M R,122,1,14,14,20,1,1,1,17,20,1,18,12,1,14,1,1,20,14,1,17,1,18,0,0,0,0,0,0,0,0,0,0,0,0,0,0,0,0,0,0,0,0,0,0,0,0,0,0,0,0,0,0,0,0,0,0,0,0,0,0,0,0,0,0,0,0,0,0,0,0,0,,,
29/6/2010,Giuseppe Bellusci,43000005,776,8/21/1989,20,0,0,5,0,3422,5750,5750,148,117,4267935,185,81,D RC,1,2,3,1,3,2,3,2,2,3,3,5,10,8,5,5,5,15,5,11,15,10,5,15,10,16,13,12,10,14,10,14,16,5,8,9,15,11,11,13,10,11,13,5,18,10,20,10,15,10,16,10,2,12,9,15,13,10,16,11,9,7,D RC,103,1,1,20,20,1,1,1,1,15,1,1,1,1,1,20,1,15,1,1,1,1,1,32768,0,0,0,0,0,0,0,0,0,0,0,0,0,0,0,1,0,0,0,0,0,0,0,0,0,0,0,0,0,0,0,0,0,0,0,0,0,0,0,0,0,0,0,0,0,0,0,0,Giuseppe Bellusci,Â£1.08m ,Serie A
29/6/2010,Giulio Donati,43036529,776,2/5/1990,20,0,0,0,0,1250,5000,5000,114,105,236401,175,70,D R,1,1,1,1,1,1,1,1,1,1,1,3,10,7,4,9,6,10,10,11,13,9,6,14,7,16,12,13,12,13,4,10,18,5,13,8,15,16,16,13,12,14,10,5,14,12,20,16,14,17,10,13,8,11,12,14,14,14,17,14,14,5,D R,102,1,1,12,20,1,1,10,1,20,1,14,1,1,1,12,10,20,1,1,1,1,14,2.74878E+11,0,0,0,0,0,0,1,0,0,0,0,0,0,0,0,0,0,0,0,0,0,0,0,0,0,0,0,0,0,0,0,0,0,0,0,0,0,0,1,0,0,0,0,0,0,0,0,0,Giulio Donati,Â£765Th. ,Serie A
29/6/2010,Frédéric Duplus,34000468,769,4/7/1990,20,0,0,0,0,950,4724,4600,150,105,2807426,175,66,D R,2,1,3,3,2,1,2,3,1,2,1,8,12,7,5,8,6,7,7,7,8,9,7,10,10,5,11,12,13,13,11,14,14,6,11,9,13,12,14,12,11,12,7,10,13,14,20,15,6,15,9,10,9,12,13,16,6,14,8,10,6,5,D R,102,1,1,12,20,1,1,13,1,20,1,15,1,1,1,12,13,20,1,1,1,13,15,0,0,0,0,0,0,0,0,0,0,0,0,0,0,0,0,0,0,0,0,0,0,0,0,0,0,0,0,0,0,0,0,0,0,0,0,0,0,0,0,0,0,0,0,0,0,0,0,0,FrÃ©dÃ©ric Duplus,Â£450Th. ,Ligue 1
29/6/2010,Dennis Diekmeier,35016422,771,10/20/1989,20,0,0,0,0,2250,6750,6750,158,127,4399999,188,80,D/WB R,3,3,1,3,1,2,3,5,1,1,1,11,14,13,8,10,9,7,9,15,9,12,6,12,11,13,8,15,9,9,10,11,8,12,7,16,8,14,18,16,11,16,14,7,10,18,20,17,14,10,6,10,5,10,3,18,6,9,6,8,3,15,D/WB R,112,1,12,1,20,1,1,1,15,20,1,20,1,1,12,1,13,20,1,1,15,1,20,1.09951E+12,0,1,0,1,0,0,0,0,0,0,0,0,0,0,0,0,0,0,0,0,0,0,0,0,0,0,0,0,0,0,0,0,0,0,0,0,0,0,0,0,1,0,0,0,0,0,0,0,Dennis Diekmeier,Â£3.15m ,Bundesliga
29/6/2010,Dejan Lovren,24000971,761,7/5/1989,20,0,0,21,1,4489,6029,6000,165,134,32887462,188,84,D RC,1,1,1,1,3,3,3,1,2,2,1,5,8,11,7,13,9,14,10,14,13,12,10,15,13,14,14,16,11,9,10,10,17,9,13,8,12,15,15,12,13,14,15,16,15,14,20,15,14,13,14,13,7,14,12,18,15,15,14,11,12,8,D RC,103,1,1,20,20,1,1,13,1,18,14,13,1,1,1,20,13,18,1,1,1,10,13,3.51844E+13,0,0,0,0,0,0,0,0,0,0,0,0,0,0,0,0,0,1,0,0,0,0,0,0,0,0,0,0,0,0,0,0,0,0,0,0,0,0,0,0,0,0,0,0,0,1,0,0,Dejan Lovren,Â£6.53m ,Ligue 1
29/6/2010,Dan Gosling,29007273,765,2/1/1990,20,0,0,2,0,3500,5750,5750,150,122,5648247,178,70,D/DM/M RC,2,1,1,3,1,2,3,3,1,2,1,7,9,13,11,12,8,10,8,2,10,13,9,10,12,9,11,12,14,14,13,12,14,7,14,14,13,13,14,12,12,10,9,12,15,11,20,14,10,15,4,14,7,14,12,12,8,15,15,13,14,2,D/DM/M RC,333,1,13,20,16,20,1,1,20,18,1,10,10,1,13,1,1,16,20,1,18,1,10,1.75922E+13,0,1,0,0,0,0,1,0,0,0,0,0,0,0,0,0,0,0,0,0,0,0,0,0,0,0,0,0,0,0,0,0,0,0,0,0,0,0,0,0,0,0,0,0,1,0,0,0,Dan Gosling,Â£2.25m ,Premier League
29/6/2010,César Azpilicueta,67033300,796,8/28/1989,20,0,0,9,1,4970,7050,6350,163,141,33610183,178,70,D/WB R,2,1,2,1,3,2,1,4,3,1,1,8,15,10,8,12,7,7,10,17,14,12,8,15,12,17,12,16,12,16,8,12,16,8,13,13,13,17,15,15,12,12,9,8,17,15,20,18,11,15,12,14,2,20,15,13,18,11,18,14,11,7,D/WB R,112,1,1,10,20,10,1,10,14,20,1,18,1,1,1,1,10,20,10,8,14,8,18,1.12617E+15,0,0,0,0,0,1,0,0,0,0,0,0,0,0,0,0,0,0,0,0,0,0,0,0,0,0,0,0,0,0,0,0,0,0,0,0,0,0,1,0,0,0,0,0,0,0,0,0,CÃ©sar Azpilicueta,Â£5.85m ,Ligue 1
29/6/2010,Yoann Andreu,85016145,769,5/3/1989,21,0,0,0,0,1000,5174,5150,137,115,1487012,175,64,D RL,1,1,3,1,3,3,3,1,1,2,1,8,12,9,6,12,6,13,11,10,10,9,9,11,12,10,13,11,12,12,11,11,14,8,8,9,13,13,13,14,13,12,7,10,12,13,20,16,7,14,10,10,8,10,14,17,15,1,13,10,15,8,D RL,105,1,1,10,20,10,1,15,9,20,1,15,1,1,1,1,15,20,1,7,9,15,15,0,0,0,0,0,0,0,0,0,0,0,0,0,0,0,0,0,0,0,0,0,0,0,0,0,0,0,0,0,0,0,0,0,0,0,0,0,0,0,0,0,0,0,0,0,0,0,0,0,Yoann Andreu,Â£720Th. ,Ligue 1
29/6/2010,Stefano Celozzi,35000513,771,11/2/1988,21,0,0,0,0,3750,6450,6450,155,129,32282524,171,65,D/WB R,2,1,1,2,1,2,3,4,2,3,1,11,12,14,4,12,6,7,10,12,13,12,7,14,15,14,14,12,14,13,11,10,15,13,8,11,10,14,13,15,14,12,9,6,14,16,20,15,10,12,6,14,12,12,12,16,12,12,16,12,13,6,D/WB R,112,1,8,10,20,10,1,1,10,20,1,18,1,1,8,1,7,20,1,1,10,1,18,40,0,0,0,1,0,1,0,0,0,0,0,0,0,0,0,0,0,0,0,0,0,0,0,0,0,0,0,0,0,0,0,0,0,0,0,0,0,0,0,0,0,0,0,0,0,0,0,0,Stefano Celozzi,Â£1.13m ,Bundesliga
29/6/2010,Samba Diakité,85010614,769,1/24/1989,21,0,0,0,0,3306,5174,5150,135,115,1124463,186,76,D/WB/DM RC,2,3,3,2,1,1,2,7,2,3,2,5,7,8,6,11,6,11,7,9,13,9,6,12,11,15,14,14,12,12,8,10,16,7,8,7,10,15,17,16,12,14,13,5,15,12,20,17,14,14,15,14,5,10,8,12,10,14,13,12,12,7,D/WB/DM RC,333,1,1,20,16,20,1,1,15,16,1,16,1,1,1,12,1,16,15,1,1,1,16,1073741824,0,0,0,0,0,0,0,0,0,0,0,0,0,0,0,0,0,0,0,0,0,0,0,0,0,0,0,0,0,0,1,0,0,0,0,0,0,0,0,0,0,0,0,0,0,0,0,0,Samba DiakitÃ©,Â£1.62m ,Ligue 1
29/6/2010,Ryan Shotton,5129388,765,9/30/1988,21,0,0,0,0,2200,5100,5100,120,106,4371474,191,85,D RC,2,2,1,2,2,2,2,6,2,2,1,2,11,10,9,8,3,13,7,12,11,7,3,14,9,14,11,13,11,10,8,10,12,4,8,11,14,12,13,11,11,12,13,12,12,11,20,12,14,10,10,10,3,10,8,14,17,8,16,13,3,4,D RC,103,5,1,20,20,1,1,1,1,18,1,1,1,1,1,20,1,18,1,1,1,1,1,0,0,0,0,0,0,0,0,0,0,0,0,0,0,0,0,0,0,0,0,0,0,0,0,0,0,0,0,0,0,0,0,0,0,0,0,0,0,0,0,0,0,0,0,0,0,0,0,0,Ryan Shotton,Â£45Th. ,Premier League
29/6/2010,Neal Eardley,28003784,801,11/6/1988,21,13,0,10,1,3000,6000,5700,138,110,5033672,181,74,D R,2,1,3,2,1,2,1,2,3,1,1,9,13,13,13,9,13,13,12,8,13,13,15,14,10,11,11,12,10,10,10,12,11,5,14,9,13,8,15,10,9,9,10,11,16,14,20,10,13,13,6,8,3,10,11,14,14,12,10,10,14,11,D R,102,1,1,1,20,1,1,12,5,20,1,14,1,1,1,1,12,20,1,1,5,1,14,3.95827E+13,0,0,0,0,0,1,0,0,1,1,0,0,0,0,0,0,0,0,0,0,0,0,0,0,0,0,0,0,1,0,0,0,0,0,0,0,0,0,0,0,0,0,1,0,0,1,0,0,Neal Eardley,Â£900Th. ,Premier League
29/6/2010,Matias Ezequiel Schelotto,43048983,776,5/23/1989,21,0,0,3,0,4422,6250,6250,166,133,1171844,187,76,WB/M/AM R,1,2,2,1,3,3,3,3,1,3,1,10,13,13,14,8,12,8,10,14,10,14,10,8,11,9,13,14,14,10,8,9,19,11,6,15,9,13,9,15,9,10,13,13,17,14,20,16,15,13,8,12,4,14,18,19,18,6,17,13,8,6,WB/M/AM R,432,1,18,1,14,1,1,1,20,20,1,16,1,1,18,1,1,14,1,1,20,1,16,1.09951E+12,0,1,0,0,0,0,0,0,0,0,0,0,0,0,0,0,0,0,0,0,0,0,0,0,0,0,0,0,0,0,0,0,0,0,0,0,0,0,0,0,1,0,0,0,0,0,0,0,Ezequiel Schelotto,Â£2.97m ,Serie A
29/6/2010,Mapou Yanga Mbiwa,34000001,769,5/15/1989,21,0,0,4,0,4761,6209,6200,165,138,12611678,184,77,D/WB RLC,2,2,1,3,2,1,1,6,3,1,2,5,11,9,5,9,6,15,8,12,15,8,7,14,9,13,15,15,12,12,6,12,17,9,9,7,14,14,16,14,11,15,13,10,14,13,20,16,15,14,13,15,7,12,12,14,14,14,16,14,14,6,D/WB RLC,116,1,1,20,20,1,1,17,1,17,1,17,1,1,1,20,17,17,1,1,1,17,17,0,0,0,0,0,0,0,0,0,0,0,0,0,0,0,0,0,0,0,0,0,0,0,0,0,0,0,0,0,0,0,0,0,0,0,0,0,0,0,0,0,0,0,0,0,0,0,0,0,Mapou Yanga-Mbiwa,Â£4.05m ,Ligue 1
29/6/2010,Manuel Schmiedebach,35008171,771,12/5/1988,21,0,0,0,0,1000,5250,5250,122,105,5750333,174,68,D R,1,1,1,2,1,2,2,4,2,2,2,6,8,8,10,8,4,11,4,7,11,14,8,14,13,11,13,13,14,13,8,7,9,5,9,7,8,17,12,14,12,10,8,8,16,14,20,10,4,9,3,8,8,10,8,5,14,8,12,5,11,12,D R,102,1,1,10,20,10,1,1,5,20,1,15,1,1,1,1,6,20,1,1,5,1,15,0,0,0,0,0,0,0,0,0,0,0,0,0,0,0,0,0,0,0,0,0,0,0,0,0,0,0,0,0,0,0,0,0,0,0,0,0,0,0,0,0,0,0,0,0,0,0,0,0,Manuel Schmiedebach,Â£4.50m ,Bundesliga
29/6/2010,Loïc Abenzoar,8442417,769,2/14/1989,21,0,0,0,0,50,2600,2600,145,104,846062,182,74,D RC,2,2,1,2,1,1,1,1,1,1,2,5,7,7,5,10,6,14,7,6,12,7,6,9,10,11,12,14,12,12,7,11,10,6,10,7,11,11,14,16,9,13,11,5,13,13,20,14,13,14,11,10,11,10,11,11,14,12,9,9,10,20,D RC,103,1,1,20,20,1,1,1,1,15,1,15,1,1,1,20,1,15,1,1,1,1,15,0,0,0,0,0,0,0,0,0,0,0,0,0,0,0,0,0,0,0,0,0,0,0,0,0,0,0,0,0,0,0,0,0,0,0,0,0,0,0,0,0,0,0,0,0,0,0,0,0,LoÃ¯c Abenzoar,Â£315Th. ,Ligue 1
29/6/2010,Lionn,2108018,1651,1/29/1989,21,0,0,0,0,1000,3400,4500,125,92,490742,183,72,D R,1,2,2,1,1,2,3,1,1,3,2,12,14,9,10,12,10,9,7,10,13,11,8,14,14,11,6,13,9,8,8,10,8,9,9,5,13,17,12,12,14,14,11,7,12,14,20,9,7,10,8,10,12,10,14,14,10,9,11,4,3,7,D R,102,1,1,1,20,1,1,1,1,20,1,12,1,1,1,1,4,20,1,1,1,1,12,0,0,0,0,0,0,0,0,0,0,0,0,0,0,0,0,0,0,0,0,0,0,0,0,0,0,0,0,0,0,0,0,0,0,0,0,0,0,0,0,0,0,0,0,0,0,0,0,0,Lionn,Â£450Th. ,Liga NOS
29/6/2010,Lillo,67065634,796,3/27/1989,21,0,0,0,0,2401,5390,5500,124,98,2047147,176,74,D R,2,3,2,1,3,1,1,1,3,3,2,7,7,5,4,7,4,7,6,10,13,9,7,12,7,17,12,15,10,13,6,12,10,7,10,6,11,12,13,11,12,9,8,9,12,10,20,13,10,10,11,10,12,10,14,9,17,7,10,8,12,5,D R,102,1,1,12,20,5,1,1,7,20,1,10,1,1,1,12,4,20,1,1,7,1,10,0,0,0,0,0,0,0,0,0,0,0,0,0,0,0,0,0,0,0,0,0,0,0,0,0,0,0,0,0,0,0,0,0,0,0,0,0,0,0,0,0,0,0,0,0,0,0,0,0,,,
29/6/2010,Lamine Koné,34000665,769,2/1/1989,21,0,0,3,0,2500,3800,3800,150,116,2932393,186,83,D RC,2,2,1,1,2,2,2,3,1,1,2,5,7,8,6,9,6,14,8,6,14,8,6,11,9,14,14,15,13,13,6,12,14,8,9,9,13,13,14,11,9,16,14,20,13,13,8,16,16,14,14,14,10,8,5,13,14,13,15,15,15,6,D RC,103,1,1,18,20,1,1,14,1,20,1,14,1,1,1,18,14,20,1,1,1,14,14,32,0,0,0,0,0,1,0,0,0,0,0,0,0,0,0,0,0,0,0,0,0,0,0,0,0,0,0,0,0,0,0,0,0,0,0,0,0,0,0,0,0,0,0,0,0,0,0,0,Lamine KonÃÂ©,Â£900Th. ,Ligue 1
29/6/2010,Kyle Naughton,152937,765,11/11/1988,21,0,0,6,0,3250,6150,6150,142,126,27520005,180,73,D RL,1,2,2,3,3,3,1,1,3,1,3,7,12,9,5,10,3,12,5,14,14,11,8,13,13,10,12,13,13,8,8,11,9,8,12,14,12,15,14,14,14,13,11,12,18,16,20,12,10,12,4,13,6,15,9,16,12,6,15,16,11,4,D RL,105,7,1,10,20,1,1,15,13,20,1,15,1,1,1,1,15,20,10,10,13,12,15,0,0,0,0,0,0,0,0,0,0,0,0,0,0,0,0,0,0,0,0,0,0,0,0,0,0,0,0,0,0,0,0,0,0,0,0,0,0,0,0,0,0,0,0,0,0,0,0,0,Kyle Naughton,Â£1.80m ,Premier League
29/6/2010,Jerry Vandam,8440118,769,12/8/1988,21,0,0,0,0,3600,5400,5400,145,120,5167000,186,77,D R,3,2,1,2,3,2,3,1,1,3,2,6,13,9,5,9,7,13,8,10,13,10,7,12,11,8,14,14,12,12,11,11,12,7,9,9,12,13,16,15,10,14,13,5,15,14,20,16,14,14,8,13,5,10,9,12,16,13,11,15,15,6,D R,102,1,1,13,20,13,1,1,10,20,1,15,1,1,1,1,1,20,10,1,1,1,15,0,0,0,0,0,0,0,0,0,0,0,0,0,0,0,0,0,0,0,0,0,0,0,0,0,0,0,0,0,0,0,0,0,0,0,0,0,0,0,0,0,0,0,0,0,0,0,0,0,Jerry Vandam,Â£630Th. ,Ligue 1
29/6/2010,Jérôme Boateng,35002579,771,9/3/1988,21,10,0,15,1,4750,7200,7200,174,144,34339299,192,90,D/WB RLC,3,2,1,1,1,3,2,3,3,3,2,9,15,11,4,15,6,8,9,18,12,13,8,12,14,6,14,10,17,6,15,13,9,11,10,4,12,13,4,12,11,15,17,18,10,18,20,12,17,8,6,14,7,20,12,13,5,14,10,12,8,11,D/WB RLC,116,3,10,20,20,12,1,17,13,19,1,17,1,10,10,20,17,19,12,13,13,15,17,1.49813E+14,0,0,0,0,0,0,0,1,0,0,0,0,0,0,0,0,0,0,0,0,0,0,0,0,0,0,0,0,0,0,0,0,1,0,0,0,0,0,1,0,0,0,0,1,0,0,0,1,JÃ©rÃ´me Boateng,Â£13.50m ,Premier League
29/6/2010,Gaetano Berardi,1408506,798,8/21/1988,21,0,0,11,0,1350,5650,5400,118,117,1320000,182,80,D RL,1,3,1,1,2,1,2,3,3,3,1,1,12,11,4,6,7,13,13,4,16,12,1,12,12,6,12,8,9,10,11,10,9,4,4,11,13,8,14,15,13,12,14,15,11,13,20,11,11,9,3,10,4,15,13,18,17,6,14,13,13,5,D RL,105,1,1,13,20,1,1,20,10,15,1,13,1,1,1,13,20,15,1,10,1,13,1,0,0,0,0,0,0,0,0,0,0,0,0,0,0,0,0,0,0,0,0,0,0,0,0,0,0,0,0,0,0,0,0,0,0,0,0,0,0,0,0,0,0,0,0,0,0,0,0,0,Gaetano Berardi,Â£1.08m ,Serie A
29/6/2010,Felipe Mattioni,8833559,1651,10/15/1988,21,0,0,0,0,4750,6254,6500,164,139,19119659,177,72,D/WB R,1,2,2,1,2,3,1,6,3,1,2,12,13,15,7,12,11,8,10,12,11,13,5,11,16,12,13,12,11,12,13,11,13,14,6,13,11,10,13,17,15,8,10,7,12,16,20,13,9,12,11,10,10,14,12,15,8,12,14,15,11,17,D/WB R,222,1,9,1,18,1,1,1,15,20,1,20,1,1,9,1,1,18,1,1,15,1,20,32,0,0,0,0,0,1,0,0,0,0,0,0,0,0,0,0,0,0,0,0,0,0,0,0,0,0,0,0,0,0,0,0,0,0,0,0,0,0,0,0,0,0,0,0,0,0,0,0,Felipe Mattioni,Â£3.15m ,LaLiga
29/6/2010,Eneko Bóveda,67018261,796,12/14/1988,21,0,0,0,0,2256,4400,4400,121,95,4583649,180,77,D RL,1,3,3,1,2,3,2,2,3,3,2,4,9,10,3,12,6,11,8,12,10,11,4,12,11,10,9,14,11,11,8,11,10,9,10,8,11,12,13,10,11,10,10,20,8,11,10,13,12,13,13,10,13,14,11,10,7,10,15,8,13,14,D RL,105,1,1,14,20,1,1,15,14,20,1,15,1,1,1,14,15,20,1,1,14,15,15,0,0,0,0,0,0,0,0,0,0,0,0,0,0,0,0,0,0,0,0,0,0,0,0,0,0,0,0,0,0,0,0,0,0,0,0,0,0,0,0,0,0,0,0,0,0,0,0,0,,,
29/6/2010,Domagoj Vida,24003525,761,4/29/1989,21,2,0,14,0,3000,5900,6200,150,124,4799999,184,73,D/DM RC,2,3,1,1,3,2,2,4,3,1,3,7,11,10,9,10,6,13,10,12,12,10,8,16,11,16,10,16,10,10,8,10,17,5,17,12,13,13,17,13,10,13,12,6,15,14,20,16,14,13,13,10,6,16,5,18,15,8,15,12,8,2,D/DM RC,113,1,1,20,20,19,1,13,15,17,1,13,1,1,1,20,13,17,15,1,8,10,13,2.20332E+12,0,0,0,0,0,0,1,0,0,0,0,0,0,0,0,0,0,0,0,0,0,0,0,0,0,0,0,0,0,0,0,0,1,0,0,0,0,0,0,0,0,1,0,0,0,0,0,0,Domagoj Vida,Â£1.58m ,Bundesliga
29/6/2010,Daniel Williams,91003280,771,3/8/1989,21,0,0,0,0,2500,4500,4500,133,105,2239678,180,78,D/DM RLC,1,3,3,2,3,2,3,3,2,3,3,8,7,13,6,14,8,12,6,15,13,12,9,12,14,11,13,9,8,11,10,7,7,8,7,13,11,14,9,10,9,11,14,20,12,13,15,11,10,10,8,9,5,11,10,13,14,9,18,15,12,14,D/DM RLC,326,1,1,20,16,20,1,16,15,15,1,1,1,1,1,1,16,15,15,1,1,1,1,8.79609E+12,0,0,0,0,0,0,0,0,0,0,0,0,0,0,0,0,0,0,0,0,0,0,0,0,0,0,0,0,0,0,0,0,0,0,0,0,0,0,0,0,0,0,0,1,0,0,0,0,Danny Williams,Â£450Th. ,Bundesliga
29/6/2010,Daniel Schwaab,35008048,771,8/23/1988,21,0,0,23,1,3900,6600,6600,165,132,5682984,186,75,D/WB R,3,3,2,2,1,2,1,5,2,2,1,10,13,12,4,13,6,10,6,14,12,13,15,12,13,6,12,13,11,11,14,12,17,8,9,11,13,14,14,14,12,12,12,10,14,15,20,17,11,13,3,13,6,15,11,18,15,10,19,19,14,4,D/WB R,112,1,1,12,20,7,1,13,14,20,1,20,1,1,1,12,12,20,1,1,14,13,20,0,0,0,0,0,0,0,0,0,0,0,0,0,0,0,0,0,0,0,0,0,0,0,0,0,0,0,0,0,0,0,0,0,0,0,0,0,0,0,0,0,0,0,0,0,0,0,0,0,Daniel Schwaab,Â£4.50m ,Bundesliga
29/6/2010,Christopher Schorch,35012895,771,1/30/1989,21,0,0,0,0,3250,5750,5750,138,115,2971443,189,83,D RC,3,3,1,3,1,2,3,4,3,1,1,5,9,7,4,11,4,16,5,16,12,9,5,13,11,12,9,13,5,9,5,10,10,5,8,6,10,13,14,13,9,12,15,16,12,15,20,11,17,10,6,9,11,9,14,6,12,11,10,6,5,1,D RC,103,1,1,20,20,5,1,10,1,16,1,7,1,1,1,20,10,16,1,1,1,1,7,0,0,0,0,0,0,0,0,0,0,0,0,0,0,0,0,0,0,0,0,0,0,0,0,0,0,0,0,0,0,0,0,0,0,0,0,0,0,0,0,0,0,0,0,0,0,0,0,0,Christopher Schorch,Â£1.58m ,Bundesliga
29/6/2010,Cédric Mongongu,8432567,53,6/22/1989,21,4,0,0,0,3350,6500,5850,165,130,5608290,189,78,D RC,3,1,3,2,3,3,2,5,3,2,3,5,9,9,6,12,6,17,8,5,16,13,8,13,11,13,15,14,13,8,9,13,10,6,11,7,15,15,14,15,10,17,14,7,16,12,20,14,17,14,13,10,7,10,3,15,11,12,7,12,10,8,D RC,103,1,1,20,20,14,1,1,1,15,1,15,1,1,1,20,1,15,1,1,1,1,15,0,0,0,0,0,0,0,0,0,0,0,0,0,0,0,0,0,0,0,0,0,0,0,0,0,0,0,0,0,0,0,0,0,0,0,0,0,0,0,0,0,0,0,0,0,0,0,0,0,CÃ©dric Mongongu,Â£4.05m ,Ligue 1
29/6/2010,Carlos Valencia,14008007,1653,4/28/1989,21,0,0,0,0,1450,4634,5000,124,103,481374,172,62,D/WB R,1,2,1,2,2,2,3,2,1,3,3,13,13,14,8,14,7,6,11,14,8,12,12,8,14,13,11,13,12,10,12,10,15,15,6,16,9,10,11,15,15,12,7,6,13,15,20,13,10,14,5,12,5,13,14,11,13,12,11,11,13,5,D/WB R,112,1,1,1,20,1,1,10,12,20,1,20,1,1,1,1,10,20,1,10,12,10,20,1.09951E+12,0,1,0,0,0,0,0,0,0,0,0,0,0,0,0,0,0,0,0,0,0,0,0,0,0,0,0,0,0,0,0,0,0,0,0,0,0,0,0,0,1,0,0,0,0,0,0,0,Carlos Valencia,Â£180Th. ,Liga NOS
29/6/2010,Andrea Rispoli,43017761,776,9/29/1988,21,0,0,2,1,1050,5700,5700,157,119,931124,181,78,D/WB/M RL,1,1,2,3,1,2,2,1,3,1,3,9,13,12,9,10,4,7,10,10,8,11,7,11,14,8,13,7,10,14,10,10,10,11,8,15,11,10,14,15,12,8,5,5,14,15,20,13,10,13,8,12,6,15,8,17,12,5,6,13,9,5,D/WB/M RL,235,1,1,1,18,1,1,17,17,20,1,20,1,1,1,1,13,18,1,13,17,17,20,0,0,0,0,0,0,0,0,0,0,0,0,0,0,0,0,0,0,0,0,0,0,0,0,0,0,0,0,0,0,0,0,0,0,0,0,0,0,0,0,0,0,0,0,0,0,0,0,0,Andrea Rispoli,Â£900Th. ,Serie A
29/6/2010,Alberto Botía,67024158,796,1/27/1989,21,0,0,1,0,3750,6209,5750,162,138,4475459,187,80,D RC,3,1,2,1,3,3,2,1,3,1,1,4,9,7,8,11,5,15,9,10,14,12,5,15,10,12,15,14,13,15,9,14,12,5,7,5,15,15,14,14,13,15,15,2,13,14,20,15,12,13,9,11,14,10,14,12,15,10,15,12,10,4,D RC,103,1,1,20,20,10,1,1,1,15,1,1,1,1,1,20,1,15,1,1,1,1,1,0,0,0,0,0,0,0,0,0,0,0,0,0,0,0,0,0,0,0,0,0,0,0,0,0,0,0,0,0,0,0,0,0,0,0,0,0,0,0,0,0,0,0,0,0,0,0,0,0,Alberto BotÃ­a,Â£2.70m ,LaLiga
29/6/2010,Alassane Touré,34009553,769,2/9/1989,21,0,0,0,0,50,2250,2250,125,90,228511,183,71,D RC,2,2,2,3,1,3,3,1,1,1,3,4,7,7,4,10,3,12,5,8,9,12,4,14,6,4,12,10,8,12,7,10,11,9,3,10,9,12,15,14,14,14,11,5,13,14,20,11,11,10,7,10,10,10,8,6,17,11,12,9,14,12,D RC,103,1,1,20,20,1,1,1,1,15,1,1,1,1,1,20,1,15,1,1,1,1,1,0,0,0,0,0,0,0,0,0,0,0,0,0,0,0,0,0,0,0,0,0,0,0,0,0,0,0,0,0,0,0,0,0,0,0,0,0,0,0,0,0,0,0,0,0,0,0,0,0,Alassane TourÃ©,Â£810Th. ,Ligue 1
29/6/2010,Adrián Gunino,78023109,1657,2/3/1989,21,0,0,15,0,2500,4904,4900,135,109,123122,172,67,D R,1,2,2,3,1,3,3,2,1,2,2,7,12,11,4,12,7,10,7,14,11,12,8,10,12,15,10,13,11,12,11,10,12,11,4,12,10,13,14,15,13,8,7,14,13,14,20,13,8,11,8,9,6,14,7,6,14,11,7,1,2,8,D R,102,1,1,1,20,1,1,14,1,20,1,15,1,1,1,1,14,20,1,1,1,11,15,0,0,0,0,0,0,0,0,0,0,0,0,0,0,0,0,0,0,0,0,0,0,0,0,0,0,0,0,0,0,0,0,0,0,0,0,0,0,0,0,0,0,0,0,0,0,0,0,0,AdriÃ¡n Gunino,Â£1.80m ,Ligue 1
29/6/2010,Víctor Sánchez,67046419,796,8/8/1987,22,0,0,0,0,3969,6000,6000,140,126,451211,174,73,WB/DM/M RC,3,2,2,1,3,3,1,4,1,1,3,7,9,10,8,13,6,10,8,11,12,13,8,12,11,14,12,14,11,12,12,12,18,8,6,12,13,18,18,14,12,10,10,10,14,12,20,15,10,12,7,10,5,18,14,10,15,10,17,13,12,3,WB/DM/M RC,433,7,11,20,15,16,1,9,20,18,1,18,10,7,11,12,9,15,20,7,17,7,18,0,0,0,0,0,0,0,0,0,0,0,0,0,0,0,0,0,0,0,0,0,0,0,0,0,0,0,0,0,0,0,0,0,0,0,0,0,0,0,0,0,0,0,0,0,0,0,0,0,VÃ­ctor SÃ¡nchez,Â£900Th. ,LaLiga
29/6/2010,Sokratis Papastathopoulos,1804808,772,6/9/1988,22,12,0,9,2,4970,7000,7000,165,141,24000000,183,80,D RC,2,1,3,2,3,2,3,7,3,3,2,3,4,9,8,7,4,15,6,12,16,10,4,15,12,16,15,15,10,12,8,14,16,7,13,11,14,13,15,13,12,16,13,8,14,13,20,15,16,14,16,13,5,8,14,15,12,14,13,12,13,5,D RC,103,1,1,19,20,5,1,3,9,20,12,14,1,1,1,19,3,20,1,1,9,1,14,32770,0,1,0,0,0,0,0,0,0,0,0,0,0,0,0,1,0,0,0,0,0,0,0,0,0,0,0,0,0,0,0,0,0,0,0,0,0,0,0,0,0,0,0,0,0,0,0,0,,,
29/6/2010,Sílvio,55011718,788,9/28/1987,22,0,0,0,0,2750,6250,6250,145,127,2433974,178,72,D RL,3,1,3,2,1,1,1,4,1,3,2,10,11,10,8,12,9,9,11,11,11,11,11,14,13,13,13,12,13,13,10,11,14,11,10,14,12,13,14,16,14,11,9,14,13,15,20,13,11,13,8,12,7,15,5,12,13,14,14,14,15,6,D RL,105,1,1,1,20,1,1,17,1,20,1,10,1,1,1,1,17,20,1,1,1,1,10,0,0,0,0,0,0,0,0,0,0,0,0,0,0,0,0,0,0,0,0,0,0,0,0,0,0,0,0,0,0,0,0,0,0,0,0,0,0,0,0,0,0,0,0,0,0,0,0,0,SÃ­lvio,Â£6.75m ,Liga NOS
29/6/2010,Romain Inez,29023778,769,4/30/1988,22,0,0,0,0,150,3350,3350,122,101,2625197,183,74,D RLC,1,2,3,2,2,3,3,3,3,2,3,6,8,7,6,11,5,13,8,8,12,9,6,12,11,10,12,13,13,12,10,12,14,5,12,7,13,12,12,7,9,13,11,9,14,11,20,15,13,13,10,10,6,10,12,12,17,14,15,15,15,5,D RLC,106,1,1,15,20,1,1,17,1,20,1,12,1,1,1,15,17,20,1,1,1,12,12,0,0,0,0,0,0,0,0,0,0,0,0,0,0,0,0,0,0,0,0,0,0,0,0,0,0,0,0,0,0,0,0,0,0,0,0,0,0,0,0,0,0,0,0,0,0,0,0,0,Romain Inez,Â£675Th. ,Ligue 1
29/6/2010,Pereirinha,55001512,788,3/2/1988,22,0,0,11,0,2250,5800,5800,131,116,412122,173,68,D/M/AM R,2,2,3,2,2,3,3,3,3,2,3,12,12,12,8,10,7,6,9,9,9,9,9,12,11,11,9,13,13,10,11,8,11,13,9,13,8,9,10,16,13,6,7,8,13,15,20,10,7,10,8,11,7,16,11,11,15,12,16,16,16,3,D/M/AM R,432,1,20,12,17,1,1,10,20,20,1,14,12,10,20,1,1,17,10,8,15,1,14,19,1,1,0,0,1,0,0,0,0,0,0,0,0,0,0,0,0,0,0,0,0,0,0,0,0,0,0,0,0,0,0,0,0,0,0,0,0,0,0,0,0,0,0,0,0,0,0,0,Bruno Pereirinha,Â£2.93m ,Liga NOS
29/6/2010,Pablo Pintos,78015289,1657,7/1/1987,22,0,0,0,0,4356,6500,6050,150,132,2999998,182,78,D/WB/M R,2,1,3,3,1,3,2,8,1,2,1,4,13,12,6,12,4,10,8,10,12,12,5,11,14,14,13,13,12,8,12,7,13,15,7,13,11,15,15,17,13,14,13,10,17,18,20,15,14,11,14,12,4,18,10,10,10,12,14,7,8,6,D/WB/M R,122,1,1,1,20,1,1,1,17,20,1,19,1,1,1,1,10,20,1,1,17,1,19,32,0,0,0,0,0,1,0,0,0,0,0,0,0,0,0,0,0,0,0,0,0,0,0,0,0,0,0,0,0,0,0,0,0,0,0,0,0,0,0,0,0,0,0,0,0,0,0,0,Pablo Pintos,Â£1.35m ,LaLiga
29/6/2010,Nenad Tomovic,5768029,802,8/30/1987,22,2,0,20,1,4250,6050,6150,158,133,6207536,184,74,D RC,2,3,3,2,3,1,2,2,3,3,3,8,12,10,8,15,11,10,9,10,14,14,13,14,14,16,10,12,16,11,11,13,13,13,11,14,13,14,16,14,13,13,12,5,15,14,20,13,14,11,9,13,7,15,12,15,13,14,11,11,13,6,D RC,103,1,1,18,20,1,1,1,15,20,1,15,1,1,1,18,1,20,1,1,15,1,15,8.79609E+12,0,0,0,0,0,1,0,0,0,0,0,0,0,0,0,0,0,0,0,0,0,0,0,0,0,0,0,0,0,0,0,0,0,0,0,0,0,0,0,0,0,0,0,1,0,0,0,0,Nenad TomoviÄ,Â£1.62m ,Serie A
29/6/2010,Michael Mancienne,5006675,765,1/8/1988,22,0,0,21,1,3969,6000,6000,160,126,3027181,184,80,D RC,2,3,1,3,1,1,2,1,1,1,3,1,8,12,6,13,3,13,6,8,14,11,4,13,12,10,14,10,14,11,9,12,13,8,10,8,14,12,11,14,14,12,13,10,15,15,20,14,10,14,8,14,8,8,14,17,15,14,15,14,13,7,D RC,103,1,1,20,20,15,1,10,15,15,10,1,1,1,1,20,10,15,15,1,1,1,1,32832,0,0,0,0,0,0,1,0,0,0,0,0,0,0,0,1,0,0,0,0,0,0,0,0,0,0,0,0,0,0,0,0,0,0,0,0,0,0,0,0,0,0,0,0,0,0,0,0,Michael Mancienne,Â£3.15m ,Premier League
29/6/2010,Micah Richards,5005673,765,6/24/1988,22,11,1,14,3,4692,7150,7150,152,137,29235593,181,83,D RC,2,3,3,3,1,1,2,6,1,3,3,3,6,8,7,8,5,15,4,15,14,7,6,15,7,15,10,19,9,12,6,12,11,4,11,7,8,17,17,19,13,9,14,8,17,18,20,19,18,10,8,12,6,16,17,16,18,14,10,13,11,8,D RC,103,5,1,18,20,10,1,5,10,20,1,12,1,1,1,18,5,20,10,1,1,1,12,32808,0,0,0,1,0,1,0,0,0,0,0,0,0,0,0,1,0,0,0,0,0,0,0,0,0,0,0,0,0,0,0,0,0,0,0,0,0,0,0,0,0,0,0,0,0,0,0,0,Micah Richards,Â£9.00m ,Premier League
29/6/2010,Mauricio Isla,75000523,1652,6/12/1988,22,16,0,1,0,4500,6950,6950,167,139,36277081,175,72,D/WB/DM/M RC,3,2,3,1,3,3,3,8,2,3,3,7,8,14,8,12,6,6,7,7,10,11,10,14,13,18,16,15,9,14,13,12,15,10,14,15,11,16,18,15,14,14,6,9,15,15,20,18,9,14,12,13,3,20,17,15,11,12,12,12,9,6,D/WB/DM/M RC,243,1,8,20,16,18,1,10,20,20,1,20,1,8,8,1,1,16,20,8,14,10,20,32,0,0,0,0,0,1,0,0,0,0,0,0,0,0,0,0,0,0,0,0,0,0,0,0,0,0,0,0,0,0,0,0,0,0,0,0,0,0,0,0,0,0,0,0,0,0,0,0,Mauricio Isla,Â£9.00m ,Serie A
29/6/2010,Lorenzo De Silvestri,1401054,776,5/23/1988,22,0,0,17,0,4000,7250,7250,170,143,49280148,185,78,D R,1,1,1,1,1,1,1,1,1,1,1,5,13,10,4,7,3,14,7,9,12,11,5,15,10,15,14,17,10,14,7,12,13,4,10,16,13,16,16,17,15,15,14,7,16,17,20,18,18,15,12,14,11,11,15,12,14,12,15,16,13,10,D R,102,1,1,1,20,1,1,1,1,20,1,15,1,1,1,1,10,20,1,1,1,1,15,1.37439E+12,0,0,0,0,0,0,0,0,0,0,0,0,0,0,0,0,0,0,0,0,1,0,0,0,0,0,0,0,0,0,0,0,0,0,0,0,0,0,1,0,1,0,0,0,0,0,0,0,Lorenzo De Silvestri,Â£4.50m ,Serie A
29/6/2010,Larrys Mabiala,8444104,53,10/8/1987,22,8,0,0,0,3306,6000,5150,140,115,1563462,189,84,D RC,3,2,3,1,1,2,1,5,1,1,3,6,10,7,6,9,8,15,11,8,13,8,6,14,9,10,13,14,11,11,7,11,14,7,7,7,12,13,14,8,11,16,14,10,10,11,20,14,16,12,10,13,14,8,11,13,14,9,12,15,15,7,D RC,103,5,1,20,20,1,1,1,1,15,1,1,1,1,1,20,1,15,1,1,1,1,1,0,0,0,0,0,0,0,0,0,0,0,0,0,0,0,0,0,0,0,0,0,0,0,0,0,0,0,0,0,0,0,0,0,0,0,0,0,0,0,0,0,0,0,0,0,0,0,0,0,Larrys Mabiala,Â£1.17m ,Ligue 1
29/6/2010,Juan Guillermo Cuadrado,76010707,1653,5/26/1988,22,0,0,0,0,2750,6200,6150,145,124,4762371,176,66,WB/M R,1,1,1,2,2,3,3,3,3,1,1,9,12,14,7,12,14,10,15,12,9,12,8,10,14,10,12,13,11,10,13,10,13,14,8,13,8,13,14,15,14,9,9,11,15,14,20,14,8,11,9,15,8,13,12,12,15,13,13,14,14,7,WB/M R,212,1,15,5,15,1,1,1,19,20,1,20,1,1,15,1,1,15,5,1,19,1,20,3.51844E+13,0,0,0,0,0,0,0,0,0,1,0,0,0,0,0,0,0,0,0,0,0,0,0,0,0,0,0,0,0,0,0,0,0,0,0,0,0,0,0,0,0,0,0,0,0,1,0,0,,,
29/6/2010,João Gonçalves,55003168,788,1/18/1988,22,0,0,8,0,2000,5500,5500,145,110,179710,180,73,D R,1,3,1,2,1,3,3,1,1,3,2,11,12,10,8,12,10,10,10,12,11,10,12,13,12,12,12,12,12,12,11,11,12,9,10,14,12,12,12,12,12,12,11,8,12,12,20,12,12,13,8,10,11,10,6,11,15,13,14,15,15,5,D R,102,1,1,10,20,10,1,5,10,20,1,10,1,1,1,1,5,20,10,1,10,1,10,0,0,0,0,0,0,0,0,0,0,0,0,0,0,0,0,0,0,0,0,0,0,0,0,0,0,0,0,0,0,0,0,0,0,0,0,0,0,0,0,0,0,0,0,0,0,0,0,0,JoÃ£o GonÃ§alves,Â£720Th. ,Liga NOS
29/6/2010,Garry Bocaly,8439529,769,4/19/1988,22,0,0,14,0,4356,5900,5900,155,132,1840000,180,74,D/WB RC,2,2,1,3,1,1,2,2,2,3,1,12,11,11,7,11,7,13,10,10,12,9,7,15,12,14,13,14,12,13,10,13,16,8,10,12,12,12,15,15,13,14,10,5,15,14,20,15,14,15,12,14,6,10,9,16,14,14,14,14,14,6,D/WB RC,113,1,1,16,20,12,1,8,10,20,1,18,1,1,1,16,8,20,8,1,10,8,18,32,0,0,0,0,0,1,0,0,0,0,0,0,0,0,0,0,0,0,0,0,0,0,0,0,0,0,0,0,0,0,0,0,0,0,0,0,0,0,0,0,0,0,0,0,0,0,0,0,Garry Bocaly,Â£3.15m ,Ligue 1
29/6/2010,Felix Bastians,5006686,771,5/9/1988,22,0,0,0,0,4250,6250,6250,137,132,3801102,188,84,D LC,2,1,1,1,2,1,3,6,2,2,3,8,12,10,10,12,7,12,8,6,13,12,9,14,12,13,10,12,15,12,11,8,14,12,8,10,12,14,15,14,13,13,12,20,14,14,16,13,12,12,8,10,7,13,12,13,11,10,14,13,8,8,D LC,104,1,15,16,20,1,1,20,15,1,1,15,1,15,1,16,20,16,1,15,1,15,1,536870912,0,0,0,0,0,0,0,0,0,0,0,0,0,0,0,0,0,0,0,0,0,0,0,0,0,0,0,0,0,1,0,0,0,0,0,0,0,0,0,0,0,0,0,0,0,0,0,0,Felix Bastians,Â£4.05m ,Bundesliga
29/6/2010,Fabian Johnson,8726381,771,12/11/1987,22,0,0,6,0,2800,5600,5600,140,121,5637396,183,70,D/M RL,1,2,1,2,2,1,3,1,3,3,2,9,10,12,7,11,10,8,10,12,11,9,8,10,12,9,9,10,10,10,8,8,9,10,7,14,10,13,15,17,16,11,10,20,13,15,15,14,10,10,7,10,10,18,10,11,17,10,9,12,8,8,D/M RL,115,1,10,1,20,1,1,20,17,18,1,14,1,1,10,1,20,18,1,15,17,14,10,3,1,1,0,0,0,0,0,0,0,0,0,0,0,0,0,0,0,0,0,0,0,0,0,0,0,0,0,0,0,0,0,0,0,0,0,0,0,0,0,0,0,0,0,0,0,0,0,0,Fabian Johnson,Â£1.13m ,Bundesliga
29/6/2010,Dominik Schmidt,35007315,771,7/1/1987,22,0,0,0,0,250,4350,4350,105,87,898013,187,78,D/DM RC,3,3,1,1,1,3,2,1,2,1,2,6,9,8,3,10,6,11,8,4,9,7,4,13,11,8,11,8,10,12,8,8,10,11,1,9,13,10,11,13,11,13,15,7,16,12,20,7,8,10,4,10,9,10,11,6,9,10,10,9,3,13,D/DM RC,113,1,1,20,20,20,1,7,15,16,1,15,1,1,1,20,7,16,15,1,10,5,15,0,0,0,0,0,0,0,0,0,0,0,0,0,0,0,0,0,0,0,0,0,0,0,0,0,0,0,0,0,0,0,0,0,0,0,0,0,0,0,0,0,0,0,0,0,0,0,0,0,Dominik Schmidt,Â£720Th. ,Bundesliga
29/6/2010,Christian Träsch,35003512,771,8/1/1987,22,1,0,0,0,2750,6850,6850,151,148,19298213,180,74,D/WB/DM/M RLC,3,2,2,3,1,3,3,1,3,1,2,9,12,8,6,7,9,6,15,15,17,10,9,17,7,16,15,17,9,17,8,12,13,5,12,9,13,19,18,15,10,10,11,16,17,13,20,18,11,18,4,15,6,18,10,17,10,10,12,14,2,2,D/WB/DM/M RLC,446,1,1,20,19,19,1,18,20,19,1,18,1,1,1,10,18,19,20,12,15,16,18,1.54619E+11,0,0,0,0,0,0,1,0,0,1,0,0,0,0,0,1,0,0,0,0,0,0,0,0,0,0,0,0,0,0,0,0,0,0,1,0,0,1,0,0,0,0,0,0,0,0,0,0,Christian TrÃ¤sch,Â£9.00m ,Bundesliga
29/6/2010,Charles Kaboré,34013978,9,2/9/1988,22,20,1,0,0,4830,6950,6250,165,139,12766689,181,75,DM/M RC,2,3,2,2,1,1,3,1,1,1,3,8,10,12,6,13,6,13,13,8,12,12,11,14,12,16,15,15,13,13,11,13,16,8,14,9,13,14,17,14,12,14,10,8,17,14,20,17,15,13,12,15,5,11,15,15,14,16,13,14,16,7,DM/M RC,423,1,1,20,15,17,1,1,20,15,1,15,1,1,1,8,1,15,20,1,10,1,15,64,0,0,0,0,0,0,1,0,0,0,0,0,0,0,0,0,0,0,0,0,0,0,0,0,0,0,0,0,0,0,0,0,0,0,0,0,0,0,0,0,0,0,0,0,0,0,0,0,Charles KaborÃ©,Â£5.85m ,Ligue 1
29/6/2010,Bruno Montelongo,78017667,1657,9/12/1987,22,0,0,3,0,3250,5624,5000,140,125,473610,182,72,D/WB/DM/M RC,3,1,1,2,2,3,2,4,1,3,2,10,11,12,11,12,12,11,8,10,12,12,10,11,13,11,11,13,13,12,12,13,13,9,12,14,12,14,14,12,13,12,11,10,14,14,20,14,12,11,8,12,7,20,13,8,13,12,12,11,14,6,D/WB/DM/M RC,443,5,10,18,17,18,1,13,20,20,1,19,10,1,8,8,13,17,15,6,20,10,19,2147483680,0,0,0,0,0,1,0,0,0,0,0,0,0,0,0,0,0,0,0,0,0,0,0,0,0,0,0,0,0,0,0,1,0,0,0,0,0,0,0,0,0,0,0,0,0,0,0,0,Bruno Montelongo,Â£405Th. ,Serie A
29/6/2010,Blazej Augustyn,29003178,787,1/26/1988,22,0,0,0,0,3192,5084,5500,142,113,1833399,191,89,D/WB RLC,2,2,2,3,3,2,1,1,3,2,2,4,12,7,6,10,9,12,15,10,12,12,9,13,10,13,12,13,10,11,11,12,14,7,8,12,12,11,13,12,12,13,13,6,8,11,20,13,13,12,13,10,8,12,15,12,11,12,15,12,12,14,D/WB RLC,116,1,1,19,20,15,1,20,15,15,1,18,1,1,1,19,20,15,15,1,1,18,14,512,0,0,0,0,0,0,0,0,0,1,0,0,0,0,0,0,0,0,0,0,0,0,0,0,0,0,0,0,0,0,0,0,0,0,0,0,0,0,0,0,0,0,0,0,0,0,0,0,Blazej Augustyn,Â£585Th. ,Serie A
29/6/2010,Atsuto Uchida,788633,116,3/27/1988,22,31,1,12,0,4100,6500,6500,152,130,20318043,176,62,D/WB R,2,3,3,1,1,1,1,3,1,1,1,11,17,13,7,14,10,9,6,13,11,15,8,12,15,13,9,14,9,10,13,13,13,12,7,16,8,17,18,16,17,6,7,9,10,15,20,16,6,14,4,10,7,10,6,10,11,12,15,14,8,8,D/WB R,112,1,1,1,20,1,1,1,12,20,1,18,1,1,1,1,13,20,1,1,12,1,18,1.09965E+12,0,1,0,1,0,0,0,0,0,0,0,0,0,0,0,0,0,0,0,0,1,0,0,0,0,0,0,1,0,0,0,0,0,0,0,0,0,0,0,0,1,0,0,0,0,0,0,0,Atsuto Uchida,Â£4.95m ,Bundesliga
29/6/2010,Anthony Vanden Borre,8152564,757,10/24/1987,22,22,1,6,2,4096,5759,5750,152,128,880576,185,80,WB/DM/M RC,1,2,1,1,1,2,2,4,1,1,2,14,14,14,10,16,13,10,9,13,12,13,14,15,16,12,16,14,16,7,10,10,16,15,6,16,11,10,11,12,12,15,11,5,17,14,20,16,13,9,12,7,7,19,8,14,7,12,7,11,10,13,WB/DM/M RC,433,1,1,20,15,16,1,10,20,18,7,18,1,1,1,15,5,15,20,10,15,5,18,0,0,0,0,0,0,0,0,0,0,0,0,0,0,0,0,0,0,0,0,0,0,0,0,0,0,0,0,0,0,0,0,0,0,0,0,0,0,0,0,0,0,0,0,0,0,0,0,0,Anthony Vanden Borre,Â£1.98m ,Serie A
29/6/2010,Ahmed Elmohammady,12009828,16,9/9/1987,22,28,0,0,0,3900,6400,6400,149,129,2110834,180,75,D/WB/M R,3,3,2,3,2,1,3,1,2,2,3,13,14,13,11,13,13,14,12,14,9,11,10,12,14,15,14,14,10,8,11,13,15,13,12,13,8,12,12,15,15,12,14,6,15,15,20,14,13,9,12,12,7,11,10,14,12,10,9,4,8,8,D/WB/M R,232,10,15,10,19,1,1,1,18,20,1,20,1,1,15,1,1,19,1,1,18,1,20,7.05405E+13,0,0,0,0,0,0,0,0,0,0,0,0,0,0,0,0,0,0,0,0,0,0,0,0,0,0,0,0,0,0,0,0,0,0,0,1,0,1,0,0,0,0,0,0,0,0,1,0,Ahmed Elmohamady,Â£3.60m ,Premier League
29/6/2010,Yuto Nagatomo,45005331,116,9/12/1986,23,26,3,0,0,2750,6300,6150,145,125,4101916,170,65,D/WB RL,1,3,1,1,1,2,2,7,2,3,2,5,10,10,4,13,4,14,7,10,14,13,4,14,13,10,14,14,12,14,12,14,10,11,5,15,14,10,15,14,14,11,7,8,8,14,20,10,6,10,6,10,9,10,11,10,6,11,11,11,6,6,D/WB RL,115,1,1,1,20,1,1,20,1,19,1,18,1,1,1,1,20,19,1,1,1,17,18,0,0,0,0,0,0,0,0,0,0,0,0,0,0,0,0,0,0,0,0,0,0,0,0,0,0,0,0,0,0,0,0,0,0,0,0,0,0,0,0,0,0,0,0,0,0,0,0,0,Yuto Nagatomo,Â£7.65m ,Serie A
29/6/2010,Tobias Levels,35006409,771,11/22/1986,23,0,0,0,0,1000,5900,5900,128,126,4636361,186,81,D R,2,2,3,3,1,2,3,3,1,2,1,8,11,5,5,7,6,12,6,15,14,8,9,16,7,15,12,18,9,15,9,10,17,3,15,12,14,17,18,12,7,14,14,7,15,14,20,17,15,17,8,10,7,10,7,14,18,10,16,15,17,8,D R,102,1,1,14,20,5,1,5,1,20,5,14,1,1,1,14,5,20,1,1,1,5,14,0,0,0,0,0,0,0,0,0,0,0,0,0,0,0,0,0,0,0,0,0,0,0,0,0,0,0,0,0,0,0,0,0,0,0,0,0,0,0,0,0,0,0,0,0,0,0,0,0,Tobias Levels,Â£1.13m ,Bundesliga
29/6/2010,Sebastian Boenisch,35001645,787,2/1/1987,23,0,0,13,0,3750,6750,6750,137,127,11012827,191,86,D/WB RL,2,1,1,1,1,2,1,2,2,2,3,7,9,10,6,8,9,12,9,16,13,8,10,13,7,16,9,16,9,10,7,8,18,7,11,15,10,15,18,13,8,15,16,20,14,18,19,17,16,12,12,10,11,16,12,13,14,13,15,11,8,5,D/WB RL,115,1,1,12,20,1,1,20,12,15,1,20,1,1,1,12,20,15,1,12,1,20,15,131593,1,0,0,1,0,0,0,0,0,1,0,0,0,0,0,0,0,1,0,0,0,0,0,0,0,0,0,0,0,0,0,0,0,0,0,0,0,0,0,0,0,0,0,0,0,0,0,0,Sebastian Boenisch,Â£2.25m ,Bundesliga
29/6/2010,Romain Danzé,8428673,769,7/3/1986,23,0,0,3,0,4356,5900,5900,140,132,2059650,184,72,D/WB RL,2,3,2,1,2,1,1,7,3,2,1,8,13,11,7,11,7,12,8,10,12,10,9,10,12,7,14,13,11,13,10,12,16,9,7,11,13,14,16,15,13,14,12,8,13,14,20,17,12,13,7,14,8,15,15,13,16,14,16,16,16,5,D/WB RL,115,1,14,1,20,1,1,15,14,20,1,17,1,10,14,1,15,20,1,10,14,15,17,32,0,0,0,0,0,1,0,0,0,0,0,0,0,0,0,0,0,0,0,0,0,0,0,0,0,0,0,0,0,0,0,0,0,0,0,0,0,0,0,0,0,0,0,0,0,0,0,0,Romain DanzÃ©,Â£2.70m ,Ligue 1
29/6/2010,Rincón,5116917,1651,5/31/1987,23,0,0,0,0,1000,4500,4950,140,109,338933,186,79,D RC,1,1,1,1,1,1,1,1,1,1,1,6,5,12,11,13,10,13,12,9,14,14,12,13,14,15,12,11,9,5,14,12,8,13,11,13,9,12,13,12,11,14,12,10,15,13,20,9,14,5,12,12,5,18,10,11,11,9,15,15,17,9,D RC,103,1,1,20,20,12,1,1,1,15,1,1,1,1,1,20,1,15,1,1,1,1,1,0,0,0,0,0,0,0,0,0,0,0,0,0,0,0,0,0,0,0,0,0,0,0,0,0,0,0,0,0,0,0,0,0,0,0,0,0,0,0,0,0,0,0,0,0,0,0,0,0,RincÃ³n,Â£540Th. ,Serie A
29/6/2010,Peter Pekarik,7563749,794,10/30/1986,23,24,1,5,0,3000,6500,6500,150,125,3480153,176,72,D R,2,1,1,2,1,2,1,4,1,3,3,12,16,12,8,14,9,10,6,10,14,13,8,13,12,9,13,11,10,10,15,13,15,7,1,13,16,17,12,12,12,9,8,10,15,13,20,14,6,17,16,10,12,10,5,12,13,14,14,17,9,7,D R,102,1,1,8,20,1,1,1,8,20,1,14,1,1,1,8,1,20,1,1,8,1,14,0,0,0,0,0,0,0,0,0,0,0,0,0,0,0,0,0,0,0,0,0,0,0,0,0,0,0,0,0,0,0,0,0,0,0,0,0,0,0,0,0,0,0,0,0,0,0,0,0,Peter Pekarik,Â£2.25m ,Bundesliga
29/6/2010,Pau Cendrós,67006021,796,4/1/1987,23,0,0,0,0,3700,5100,5100,138,123,5354131,176,72,D/WB R,2,2,3,3,3,3,3,1,1,3,3,9,12,11,5,11,7,9,8,13,13,11,6,13,10,14,14,13,10,11,9,12,14,7,9,12,13,14,14,13,12,12,8,11,10,15,20,16,10,13,15,11,6,13,12,15,11,12,13,14,14,5,D/WB R,112,1,1,1,20,1,1,10,1,20,1,16,1,1,1,1,10,20,1,1,1,6,16,1.41734E+11,0,0,0,0,0,0,0,0,0,0,0,0,0,0,0,0,0,0,0,0,0,0,0,0,0,0,0,0,0,0,0,0,1,0,0,0,0,1,0,0,0,0,0,0,0,0,0,0,Pau CendrÃ³s,Â£1.44m ,LaLiga
29/6/2010,Onyekachi Apam,8632613,38,12/30/1986,23,12,0,10,1,4489,6700,6000,155,134,8999999,177,67,D RC,3,1,2,3,2,3,2,7,3,3,1,5,11,8,6,10,7,12,8,11,14,6,7,15,10,16,16,15,9,12,6,12,15,6,11,9,13,13,16,16,13,15,9,10,14,14,20,15,14,11,16,15,9,10,13,16,12,13,11,11,11,11,D RC,103,1,1,20,20,1,1,13,1,15,1,15,1,1,1,20,13,15,1,1,1,13,15,1.37439E+11,0,0,0,0,0,0,0,0,0,0,0,0,0,0,0,1,0,0,0,0,0,0,0,0,0,0,0,0,0,0,0,0,0,0,0,0,0,1,0,0,0,0,0,0,0,0,0,0,Onyekachi Apam,Â£3.60m ,Ligue 1
29/6/2010,Niko Bungert,8728048,771,10/24/1986,23,0,0,3,0,3250,6250,6250,135,125,2755092,188,68,D RC,2,2,2,1,1,1,2,1,2,2,1,3,11,5,5,13,3,12,5,7,16,13,5,12,11,11,16,11,8,14,9,13,13,9,6,4,12,14,12,14,16,11,15,5,12,14,20,12,13,11,6,6,4,10,12,14,7,8,11,15,8,7,D RC,103,1,1,20,20,1,1,1,1,16,1,1,1,1,1,20,1,16,1,1,1,1,1,2.74878E+11,0,0,0,0,0,0,0,0,0,0,0,0,0,0,0,0,0,0,0,0,0,0,0,0,0,0,0,0,0,0,0,0,0,0,0,0,0,0,1,0,0,0,0,0,0,0,0,0,Niko Bungert,Â£2.25m ,Bundesliga
29/6/2010,Nicolò Cherubin,1402118,776,12/2/1986,23,0,0,0,0,1750,5500,5500,135,111,1986151,188,83,D RC,1,1,1,1,1,1,1,1,1,1,1,2,4,4,4,8,4,15,5,8,13,7,5,14,8,12,14,11,8,11,8,11,14,6,14,5,13,14,14,12,11,14,16,6,14,12,20,12,15,15,12,13,4,14,5,12,18,10,14,12,8,4,D RC,103,1,1,20,20,1,1,14,1,15,10,1,1,1,1,20,14,15,1,1,1,1,1,0,0,0,0,0,0,0,0,0,0,0,0,0,0,0,0,0,0,0,0,0,0,0,0,0,0,0,0,0,0,0,0,0,0,0,0,0,0,0,0,0,0,0,0,0,0,0,0,0,NicolÃ² Cherubin,Â£1.17m ,Serie A
29/6/2010,Nicola Belmonte,7990575,776,4/15/1987,23,0,0,0,0,1000,5300,5300,130,121,2624222,183,77,D R,3,2,2,1,2,2,2,1,2,3,1,5,9,8,5,9,5,13,7,12,14,10,7,14,7,13,14,11,8,13,6,12,14,5,8,13,14,11,12,13,12,12,13,10,12,13,20,12,15,13,7,10,12,15,12,15,12,10,15,9,10,2,D R,102,1,1,14,20,1,1,14,1,20,1,8,1,1,1,14,14,20,1,1,1,1,8,64,0,0,0,0,0,0,1,0,0,0,0,0,0,0,0,0,0,0,0,0,0,0,0,0,0,0,0,0,0,0,0,0,0,0,0,0,0,0,0,0,0,0,0,0,0,0,0,0,Nicola Belmonte,Â£720Th. ,Serie A
29/6/2010,Nedum Onuoha,5114013,765,11/30/1986,23,0,0,21,2,4500,6750,6750,152,135,4173096,183,93,D RC,1,3,1,1,2,3,1,6,2,2,1,4,4,7,4,7,4,15,5,13,14,7,5,15,8,12,10,13,10,12,8,10,14,4,13,7,14,13,10,20,14,12,12,7,16,18,20,17,15,13,2,12,16,12,11,14,15,13,18,15,14,2,D RC,103,1,1,20,20,1,1,10,1,18,1,10,1,1,1,20,10,18,1,1,1,1,10,0,0,0,0,0,0,0,0,0,0,0,0,0,0,0,0,0,0,0,0,0,0,0,0,0,0,0,0,0,0,0,0,0,0,0,0,0,0,0,0,0,0,0,0,0,0,0,0,0,Nedum Onuoha,Â£5.40m ,Premier League
29/6/2010,Mouhamadou Dabo,919771,769,11/28/1986,23,0,0,17,0,4830,6200,6200,152,139,13768721,176,67,D/WB/M RL,2,3,3,3,3,2,3,7,1,3,1,10,12,12,6,12,9,11,11,13,10,12,8,14,13,11,12,13,13,13,11,12,16,11,9,11,13,12,14,16,13,13,8,14,12,14,20,15,8,14,11,15,8,17,9,16,11,14,17,14,14,9,D/WB/M RL,125,5,14,10,20,10,1,20,16,18,1,18,1,14,13,1,20,18,1,16,13,18,18,2.2518E+15,0,0,0,0,0,1,0,0,0,0,0,0,0,0,0,0,0,0,0,0,0,0,0,0,0,0,0,0,0,0,0,0,0,0,0,0,0,0,0,0,0,0,0,0,0,0,0,0,Mouhamadou Dabo,Â£4.50m ,LaLiga
29/6/2010,Modibo Diakité,1408579,769,3/2/1987,23,0,0,0,0,3000,5894,6500,153,131,4459425,192,84,D RC,1,1,2,3,1,3,2,1,1,3,1,2,2,6,6,4,2,17,4,15,14,8,6,15,6,15,13,14,10,12,4,10,12,3,6,8,14,11,14,15,11,17,18,7,7,13,20,15,18,12,15,12,10,11,10,12,11,12,11,12,14,8,D RC,103,1,1,20,20,1,1,1,1,15,10,1,1,1,1,20,1,15,1,1,1,1,1,2.92058E+11,0,0,0,0,0,0,1,0,0,0,0,0,0,0,0,1,0,0,0,0,0,0,0,0,0,0,0,0,0,0,0,0,0,0,1,0,0,0,1,0,0,0,0,0,0,0,0,0,Modibo DiakitÃ©,Â£1.35m ,Serie A
29/6/2010,Medhi Benatia,8443128,34,4/17/1987,23,6,0,0,0,2600,6150,4050,150,123,30853893,190,80,D RC,1,3,3,3,2,2,2,1,2,1,3,5,8,8,6,11,7,14,9,7,16,10,7,12,11,12,14,15,13,12,10,12,14,8,12,7,13,13,14,13,8,16,15,8,13,10,20,15,16,14,12,16,11,8,14,17,8,13,14,14,11,12,D RC,103,1,1,20,20,15,1,1,15,16,14,12,1,1,1,20,1,16,15,1,1,1,12,0,0,0,0,0,0,0,0,0,0,0,0,0,0,0,0,0,0,0,0,0,0,0,0,0,0,0,0,0,0,0,0,0,0,0,0,0,0,0,0,0,0,0,0,0,0,0,0,0,Medhi Benatia,Â£4.50m ,Serie A
29/6/2010,Maxime Josse,8428698,769,3/21/1987,23,0,0,3,0,3249,5100,5100,130,114,2340719,184,82,D RC,1,1,2,1,1,1,3,7,2,1,1,5,9,8,5,9,11,15,8,10,13,7,7,14,9,12,13,14,11,11,6,10,14,5,11,7,11,12,15,14,9,15,12,8,12,13,20,15,15,14,12,12,8,8,9,13,14,10,16,15,15,6,D RC,103,1,1,20,20,1,1,1,8,16,1,14,1,1,1,20,1,16,1,1,8,1,14,0,0,0,0,0,0,0,0,0,0,0,0,0,0,0,0,0,0,0,0,0,0,0,0,0,0,0,0,0,0,0,0,0,0,0,0,0,0,0,0,0,0,0,0,0,0,0,0,0,Maxime Josse,Â£630Th. ,Ligue 1
29/6/2010,Ludovic Sané,85032367,769,3/22/1987,23,0,0,0,0,4096,5759,5750,150,128,4353438,192,77,D RC,1,3,1,2,1,2,3,6,1,1,3,6,8,8,7,9,5,15,10,5,14,8,7,14,9,14,14,15,13,14,7,11,15,5,9,8,14,12,15,15,10,16,16,5,14,13,20,15,15,14,13,14,7,6,6,14,11,14,13,14,14,7,D RC,103,1,1,20,20,14,1,1,10,16,1,10,1,1,1,20,1,16,10,1,1,1,10,4.50387E+15,0,0,0,0,0,0,0,0,0,0,0,0,0,0,0,0,0,0,0,0,0,0,0,0,0,0,0,0,0,0,0,0,0,0,0,0,0,0,1,0,0,0,0,0,0,0,0,0,,,
29/6/2010,Kelvin Maynard,37002597,784,5/29/1987,23,0,0,0,0,2600,4750,4750,121,104,907453,180,83,D/WB R,3,3,2,1,1,1,3,2,1,2,2,7,10,6,4,12,4,3,2,6,11,11,5,11,14,13,11,14,11,9,12,11,10,4,7,8,12,13,13,12,13,13,11,15,11,12,20,12,12,10,5,10,12,10,9,3,20,5,6,12,12,14,D/WB R,112,1,1,10,20,10,1,1,10,20,1,17,1,1,1,10,13,20,10,1,9,1,17,0,0,0,0,0,0,0,0,0,0,0,0,0,0,0,0,0,0,0,0,0,0,0,0,0,0,0,0,0,0,0,0,0,0,0,0,0,0,0,0,0,0,0,0,0,0,0,0,0,Kelvin Maynard,Â£225Th. ,Liga NOS
29/6/2010,Juri Judt,8718376,771,7/24/1986,23,0,0,4,0,2500,5900,5900,129,117,4563354,173,67,D/DM/M RC,2,3,2,3,1,1,3,8,2,3,2,10,12,10,6,11,8,12,9,9,13,11,8,14,10,14,11,16,12,14,8,13,14,10,9,9,11,14,16,12,12,15,9,7,15,12,20,15,13,14,13,13,13,15,13,14,11,14,16,15,14,6,D/DM/M RC,333,1,4,20,17,20,1,1,17,17,1,14,4,1,1,1,1,17,17,1,11,1,14,1.40884E+14,0,0,0,0,0,0,0,0,0,0,0,0,0,0,0,0,0,0,0,0,0,0,0,0,0,1,0,0,0,0,0,0,0,1,0,0,0,1,0,0,0,0,0,0,0,0,0,1,Juri Judt,Â£1.13m ,Bundesliga
29/6/2010,Ignazio Abate,7983987,776,11/12/1986,23,0,0,19,2,4000,6850,6850,154,138,155002075,180,73,WB/M/AM R,3,2,1,3,3,2,1,8,3,3,1,9,13,14,7,13,8,11,9,12,13,13,8,11,12,15,14,13,11,11,9,11,14,12,7,18,13,14,15,17,17,13,9,8,12,16,20,14,12,12,10,9,11,15,10,15,16,12,17,15,14,7,WB/M/AM R,432,1,18,7,14,1,1,1,20,20,1,16,1,1,18,1,1,14,7,1,20,1,16,1.09951E+12,0,1,0,0,0,1,0,0,0,0,0,0,0,0,0,0,0,0,0,0,0,0,0,0,0,0,0,0,0,0,0,0,0,0,0,0,0,0,0,0,1,0,0,0,0,0,0,0,Ignazio Abate,Â£8.55m ,Serie A
29/6/2010,Ibrahim Kas,8491444,799,9/20/1986,23,7,0,7,0,3600,6000,5650,135,120,1516368,185,79,D RC,1,1,2,3,3,3,1,3,3,3,1,7,9,8,7,11,8,14,8,6,13,8,5,14,11,16,11,17,11,10,6,9,14,5,11,11,11,14,17,14,13,12,12,10,12,14,20,14,14,11,17,6,8,10,8,5,5,13,13,4,3,15,D RC,103,1,1,20,20,1,1,1,1,15,10,1,1,1,1,20,1,15,1,1,1,1,1,65536,0,0,0,0,0,0,0,0,0,0,0,0,0,0,0,0,1,0,0,0,0,0,0,0,0,0,0,0,0,0,0,0,0,0,0,0,0,0,0,0,0,0,0,0,0,0,0,0,Ibrahim Kas,Â£810Th. ,LaLiga
29/6/2010,Gonzalo Castro,8723487,771,6/11/1987,23,5,0,21,3,4500,6900,6900,168,138,13523993,171,72,D/WB/DM/M RC,1,3,1,2,2,2,2,1,2,2,3,13,13,14,8,13,13,8,11,11,12,15,12,11,14,12,13,11,11,11,13,11,12,12,7,12,10,13,13,16,16,13,6,15,12,13,20,12,10,12,8,12,4,16,10,11,17,11,12,12,14,4,D/WB/DM/M RC,133,1,12,18,20,18,1,14,16,20,1,20,12,1,11,1,14,20,16,1,12,14,20,1048584,0,0,0,1,0,0,0,0,0,0,0,0,0,0,0,0,0,0,0,0,1,0,0,0,0,0,0,0,0,0,0,0,0,0,0,0,0,0,0,0,0,0,0,0,0,0,0,0,Gonzalo Castro,Â£8.10m ,Bundesliga
29/6/2010,Gianni Zuiverloon,859941,784,12/30/1986,23,0,0,18,0,3906,6500,6000,145,125,11730078,178,70,D R,2,1,2,1,1,3,1,1,3,2,1,5,13,14,6,13,8,14,5,13,11,12,5,14,14,12,13,14,13,7,12,9,13,11,10,14,11,13,14,16,13,13,10,11,15,15,20,14,14,10,8,12,8,13,14,14,13,15,15,17,14,6,D R,102,1,1,12,20,5,1,4,10,20,8,15,1,1,1,12,4,20,3,1,10,4,15,1.75922E+13,0,1,0,0,0,0,0,0,0,0,0,0,0,0,0,0,0,0,0,0,0,0,0,0,0,0,0,0,0,0,0,0,0,0,0,0,0,0,0,0,0,0,0,0,1,0,0,0,Gianni Zuiverloon,Â£3.60m ,Premier League
29/6/2010,Fabrizio Cacciatore,7988563,776,10/8/1986,23,0,0,0,0,3600,5500,5500,135,120,2991663,182,75,D RL,3,3,3,1,2,1,1,2,1,1,2,10,12,9,8,9,9,12,8,14,13,10,9,14,8,15,12,12,7,13,9,12,12,10,9,13,14,14,16,12,11,10,12,10,15,12,20,15,13,14,8,14,7,14,15,14,10,5,12,12,7,11,D RL,105,1,1,12,20,1,1,15,1,20,1,9,1,1,1,12,15,20,1,1,1,1,9,2,0,1,0,0,0,0,0,0,0,0,0,0,0,0,0,0,0,0,0,0,0,0,0,0,0,0,0,0,0,0,0,0,0,0,0,0,0,0,0,0,0,0,0,0,0,0,0,0,Fabrizio Cacciatore,Â£450Th. ,Serie A
29/6/2010,Fabiano Santacroce,1400569,776,8/24/1986,23,0,0,6,0,3250,6700,6700,160,135,20621488,181,72,D RC,2,2,2,1,1,3,2,4,2,1,2,4,11,11,4,11,4,14,4,14,16,8,6,16,13,14,16,15,12,13,8,14,15,9,6,9,12,12,11,15,16,12,12,7,8,15,20,14,12,13,15,16,18,10,14,14,15,16,14,12,5,3,D RC,103,1,1,20,20,1,1,1,1,15,1,1,1,1,1,20,1,15,1,1,1,1,1,1.40737E+14,0,0,0,0,0,0,0,0,0,0,0,0,0,0,0,0,0,0,0,0,0,0,0,0,0,0,0,0,0,0,0,0,0,0,0,0,0,0,0,0,0,0,0,0,0,0,0,1,Fabiano Santacroce,Â£1.44m ,Serie A
29/6/2010,Danny Simpson,5116936,765,1/4/1987,23,0,0,0,0,3350,6250,6250,138,118,4522259,173,77,D R,1,1,1,1,1,1,1,1,1,1,1,4,11,11,6,13,1,8,4,8,11,10,6,14,12,10,10,12,12,11,8,8,14,12,4,9,10,14,16,17,12,12,7,14,14,17,20,16,10,11,8,10,5,7,10,16,13,14,10,13,13,6,D R,102,1,1,10,20,1,1,14,8,20,1,14,1,1,1,10,14,20,1,1,8,1,14,42,0,1,0,1,0,1,0,0,0,0,0,0,0,0,0,0,0,0,0,0,0,0,0,0,0,0,0,0,0,0,0,0,0,0,0,0,0,0,0,0,0,0,0,0,0,0,0,0,Danny Simpson,Â£2.25m ,Premier League
29/6/2010,Daniel Estrada,1507539,796,1/3/1987,23,0,0,0,0,3660,5650,5650,132,121,1535647,177,68,D/AM R,3,1,2,2,2,1,2,1,1,2,2,12,13,11,12,9,11,12,12,9,11,11,7,12,12,13,14,12,12,13,11,10,11,10,8,13,9,12,11,14,12,12,11,12,10,14,20,13,10,13,6,9,5,14,13,10,15,11,12,16,15,3,D/AM R,112,1,18,1,20,1,1,9,15,20,1,15,1,9,18,1,1,20,1,1,15,9,15,1.09951E+12,0,0,0,0,0,0,0,0,0,1,0,0,0,0,0,0,0,0,0,0,0,0,0,0,0,0,0,0,0,0,0,0,0,0,0,0,0,0,0,0,1,0,0,0,0,0,0,0,Dani Estrada,Â£900Th. ,LaLiga
29/6/2010,Besart Ibraimi,8408705,781,12/17/1986,23,0,0,0,0,2250,4750,4250,126,105,5405172,182,86,WB/M RC,3,2,3,1,3,1,3,2,3,2,3,9,12,11,10,12,10,9,11,10,10,14,11,12,17,13,14,7,12,13,11,13,12,11,6,11,10,13,12,10,9,14,9,12,12,9,20,9,11,14,9,10,7,9,13,14,12,13,13,13,11,5,WB/M RC,213,1,10,20,1,10,1,1,20,20,1,20,10,1,1,1,1,1,20,1,20,1,20,0,0,0,0,0,0,0,0,0,0,0,0,0,0,0,0,0,0,0,0,0,0,0,0,0,0,0,0,0,0,0,0,0,0,0,0,0,0,0,0,0,0,0,0,0,0,0,0,0,,,
29/6/2010,Benjamin Angoua,38001740,24,11/28/1986,23,7,1,4,1,3481,5900,5300,140,118,2686252,183,72,D/DM RC,2,2,3,2,2,1,3,8,2,1,1,5,9,6,6,7,5,14,7,10,13,8,6,13,7,13,15,14,15,13,10,12,13,9,6,8,13,15,13,10,12,14,12,10,13,14,20,15,13,15,13,13,8,10,14,12,13,13,14,11,11,7,D/DM RC,113,1,1,20,20,18,1,1,15,15,1,15,1,1,1,20,1,15,15,1,1,1,15,0,0,0,0,0,0,0,0,0,0,0,0,0,0,0,0,0,0,0,0,0,0,0,0,0,0,0,0,0,0,0,0,0,0,0,0,0,0,0,0,0,0,0,0,0,0,0,0,0,Benjamin Angoua,Â£1.98m ,Ligue 1
29/6/2010,Baiano,55012136,1651,2/23/1987,23,0,0,0,0,1000,3000,5250,117,108,154843,173,65,D R,2,3,3,1,3,2,1,1,2,3,2,12,13,11,9,12,12,10,12,13,11,11,12,13,13,11,12,10,13,11,10,11,9,10,8,14,11,12,13,14,14,12,10,6,14,14,20,12,12,11,10,10,9,9,11,12,11,11,12,12,12,5,D R,102,1,1,1,20,1,1,10,1,20,1,10,1,1,1,1,10,20,1,1,1,1,10,0,0,0,0,0,0,0,0,0,0,0,0,0,0,0,0,0,0,0,0,0,0,0,0,0,0,0,0,0,0,0,0,0,0,0,0,0,0,0,0,0,0,0,0,0,0,0,0,0,Baiano,Â£900Th. ,Liga NOS
29/6/2010,Andreas Beck,8723862,771,3/13/1987,23,3,0,27,2,3650,7300,7300,161,144,6774224,180,70,D/WB RL,2,2,2,3,3,1,2,3,2,2,1,7,10,12,5,11,5,8,6,10,11,12,8,15,13,16,15,14,10,11,13,15,16,8,12,15,10,17,18,16,15,10,9,15,16,15,20,18,9,13,5,12,6,13,15,12,12,10,17,16,18,2,D/WB RL,115,1,1,12,20,12,1,15,1,20,1,17,1,1,1,10,15,20,1,1,1,12,17,2.74896E+11,0,1,0,1,0,0,0,0,0,0,0,0,0,0,0,0,0,0,0,0,1,0,0,0,1,0,0,0,0,0,0,0,0,0,0,0,0,0,1,0,0,0,0,0,0,0,0,0,Andreas Beck,Â£5.85m ,Bundesliga
29/6/2010,Aleandro Rosi,7984127,776,5/17/1987,23,0,0,0,0,4225,6500,6500,140,130,4227212,184,80,D/WB/M/AM RL,2,1,2,1,1,2,2,1,3,2,1,3,12,13,11,9,6,10,10,10,11,11,10,11,13,13,11,12,12,11,10,10,11,12,6,14,11,12,16,16,12,11,11,10,14,15,20,13,14,10,15,14,6,18,16,12,12,12,15,13,11,5,D/WB/M/AM RL,245,1,16,6,17,6,1,15,20,20,1,20,3,12,16,4,15,17,6,15,20,15,20,1.13387E+12,0,0,0,0,0,0,0,0,0,0,0,0,0,0,0,1,0,0,0,0,1,0,0,0,0,0,0,0,0,0,0,0,0,0,0,1,0,0,0,0,1,0,0,0,0,0,0,0,Aleandro Rosi,Â£2.25m ,Serie A
29/6/2010,Alberto Lora,67011231,796,3/25/1987,23,0,0,0,0,1250,2000,2000,147,135,2040026,165,66,D/M RC,3,1,3,3,1,3,1,3,1,2,1,10,13,14,14,14,5,17,14,14,14,16,12,14,13,12,14,13,11,15,14,15,11,11,10,14,13,17,17,14,15,13,5,1,14,14,20,16,16,16,10,12,10,12,7,10,9,8,8,18,16,14,D/M RC,113,5,15,20,20,1,1,5,20,20,1,15,15,1,15,1,5,20,20,1,15,5,15,0,0,0,0,0,0,0,0,0,0,0,0,0,0,0,0,0,0,0,0,0,0,0,0,0,0,0,0,0,0,0,0,0,0,0,0,0,0,0,0,0,0,0,0,0,0,0,0,0,Alberto Lora,Â£3.15m ,LaLiga
29/6/2010,Younes Kaboul,918434,769,1/4/1986,24,0,0,20,1,5041,6400,6900,160,142,13800000,191,85,D RC,1,3,3,3,3,3,2,1,2,1,3,7,13,8,10,14,10,15,14,8,13,11,8,14,12,11,11,14,13,12,13,12,14,6,12,9,13,12,12,14,9,16,17,12,11,15,20,14,19,12,10,12,12,8,13,16,15,12,15,14,13,8,D RC,103,1,1,20,20,14,1,1,10,19,1,1,1,1,1,20,1,19,10,1,1,1,1,4.39848E+13,0,1,0,0,0,0,0,0,0,0,0,0,0,0,0,0,0,0,0,0,0,0,0,0,0,0,0,0,0,0,0,0,1,0,0,0,0,0,0,0,0,0,0,1,0,1,0,0,YounÃ¨s Kaboul,Â£6.75m ,Premier League
29/6/2010,Vedran Corluka,126527,761,3/31/1986,24,36,1,0,0,5184,7920,7400,164,144,43486185,192,89,D RC,1,1,2,3,2,1,2,5,2,1,2,3,11,11,9,13,5,15,5,15,13,11,6,15,15,14,15,13,17,12,10,12,17,5,12,8,12,15,14,14,13,16,15,13,14,12,20,14,16,15,4,16,11,12,13,14,15,13,16,17,15,8,D RC,103,1,1,16,20,12,1,10,15,20,12,14,1,1,1,16,10,20,15,1,1,1,14,1.43881E+11,0,0,0,1,0,1,0,0,0,0,0,0,0,0,0,0,0,0,0,0,0,0,0,0,0,0,0,0,0,0,0,1,1,0,0,0,0,1,0,0,0,0,0,0,0,0,0,0,Vedran Corluka,Â£10.80m ,Premier League
29/6/2010,Steven Taylor,5114243,765,1/23/1986,24,0,0,29,4,4422,6500,6500,150,133,3950340,188,81,D RC,2,1,3,1,3,1,3,6,1,3,1,5,8,9,10,9,3,16,3,8,14,10,5,15,9,17,14,18,9,11,8,9,18,5,14,10,13,11,18,13,11,12,16,8,11,15,20,15,16,11,16,16,9,10,10,15,9,14,12,7,9,5,D RC,103,1,1,20,20,1,1,10,1,18,1,1,1,1,1,20,10,18,1,1,1,1,1,2.19902E+12,0,0,0,0,0,1,0,0,0,0,0,0,0,0,0,1,1,0,0,0,0,0,0,0,0,0,0,0,0,0,0,0,0,0,0,0,0,0,0,0,0,1,0,0,0,0,0,0,Steven Taylor,Â£5.40m ,Premier League
29/6/2010,Sergio Sánchez,1507596,796,4/3/1986,24,0,0,4,0,4500,6600,6600,156,138,5999998,185,78,D RC,3,1,1,2,1,1,1,4,3,2,3,5,6,6,8,12,6,14,7,9,15,12,8,14,11,15,14,14,13,12,8,12,13,7,12,12,15,14,16,14,12,15,13,10,14,13,20,16,14,13,12,10,8,14,13,13,14,11,14,13,12,10,D RC,103,1,1,18,20,10,1,8,1,20,1,10,1,1,1,18,8,20,1,1,1,1,10,0,0,0,0,0,0,0,0,0,0,0,0,0,0,0,0,0,0,0,0,0,0,0,0,0,0,0,0,0,0,0,0,0,0,0,0,0,0,0,0,0,0,0,0,0,0,0,0,0,Sergio SÃ¡nchez,Â£3.60m ,LaLiga
29/6/2010,Sergio Ramos,7458272,796,3/30/1986,24,67,5,6,0,6642,8250,8250,173,163,165816446,183,81,D RC,1,1,2,1,3,2,1,5,1,1,3,10,15,13,11,15,13,17,13,16,15,13,10,17,15,16,15,17,10,13,12,10,16,13,12,13,15,15,16,13,15,14,13,13,16,15,20,17,12,14,15,13,3,15,15,18,12,13,12,11,13,11,D RC,103,1,2,16,20,11,1,10,9,20,8,15,2,1,2,16,10,20,9,1,9,5,15,3.51844E+13,0,0,0,0,0,1,0,0,0,0,0,0,0,0,0,0,0,0,0,0,0,0,0,0,0,0,0,0,0,0,0,0,0,0,0,0,0,0,0,0,0,0,0,0,0,1,0,0,Sergio Ramos,Â£27.00m ,LaLiga
29/6/2010,Ronald Zubar,919995,769,9/20/1985,24,0,0,15,2,3750,5600,6100,145,130,5999998,186,80,D RC,3,3,3,3,1,3,2,1,2,3,1,6,10,8,7,11,7,15,12,9,14,10,8,15,11,12,14,16,7,9,8,12,17,9,13,9,12,14,14,11,9,16,13,10,13,14,20,16,16,13,12,14,10,14,14,14,13,9,16,14,14,5,D RC,103,5,8,20,20,12,1,10,8,18,1,14,1,1,8,20,10,18,1,1,8,10,14,0,0,0,0,0,0,0,0,0,0,0,0,0,0,0,0,0,0,0,0,0,0,0,0,0,0,0,0,0,0,0,0,0,0,0,0,0,0,0,0,0,0,0,0,0,0,0,0,0,Ronald Zubar,Â£2.25m ,Premier League
29/6/2010,Rafinha,8833533,1651,9/7/1985,24,1,0,15,3,5929,7750,7700,166,154,17999999,172,68,D/WB R,2,3,2,1,2,2,2,1,2,3,1,10,14,15,7,14,10,9,9,10,12,14,17,13,16,17,14,16,14,10,15,17,18,13,6,15,12,14,17,16,17,7,6,14,15,15,20,17,6,11,19,12,4,7,10,7,8,16,6,2,8,17,D/WB R,112,1,1,12,20,9,1,8,14,20,1,19,1,1,1,1,8,20,12,1,14,8,19,1245194,0,1,0,1,0,0,0,0,0,0,0,0,0,0,0,0,1,1,0,0,1,0,0,0,0,0,0,0,0,0,0,0,0,0,0,0,0,0,0,0,0,0,0,0,0,0,0,0,Rafinha,Â£7.20m ,Serie A
29/6/2010,Mourad Benhamida,915741,769,1/18/1986,24,0,0,0,0,100,3550,3550,130,108,3390149,176,67,D RL,1,3,1,3,2,3,3,2,1,2,1,6,9,8,6,11,6,11,7,10,11,9,6,12,11,8,11,13,11,11,7,13,10,6,13,6,13,13,15,14,12,12,8,10,14,11,20,14,9,13,11,6,7,8,8,18,15,14,6,5,7,10,D RL,105,1,1,12,20,1,1,15,10,20,1,15,1,1,1,12,15,20,1,1,10,15,15,0,0,0,0,0,0,0,0,0,0,0,0,0,0,0,0,0,0,0,0,0,0,0,0,0,0,0,0,0,0,0,0,0,0,0,0,0,0,0,0,0,0,0,0,0,0,0,0,0,,,
29/6/2010,Miguel Torres,67011252,796,1/28/1986,24,0,0,12,0,4624,6550,6550,151,136,5690856,184,74,D RL,2,2,1,2,1,2,1,4,3,2,2,7,11,8,5,10,6,13,10,16,16,11,6,14,10,14,14,16,13,17,8,11,13,4,11,8,15,17,16,13,11,14,12,8,15,14,20,15,12,17,13,14,8,19,13,9,18,14,15,13,17,4,D RL,105,1,1,10,20,8,1,19,8,20,5,13,1,1,1,10,19,20,3,8,8,13,13,0,0,0,0,0,0,0,0,0,0,0,0,0,0,0,0,0,0,0,0,0,0,0,0,0,0,0,0,0,0,0,0,0,0,0,0,0,0,0,0,0,0,0,0,0,0,0,0,0,Miguel Torres,Â£2.70m ,LaLiga
29/6/2010,Mathieu Debuchy,915351,769,7/28/1985,24,0,0,3,0,4761,6200,6200,150,138,4002245,177,74,D/WB/M R,3,1,3,1,3,3,3,6,3,1,1,10,12,11,7,12,13,12,14,10,11,13,9,15,12,12,13,17,13,15,12,12,17,11,13,8,13,16,17,14,12,14,8,12,12,11,20,17,13,15,12,15,12,18,7,12,17,13,16,14,14,6,D/WB/M R,122,1,12,14,20,14,5,10,18,20,1,16,8,10,12,1,4,20,14,10,18,10,16,2,0,1,0,0,0,0,0,0,0,0,0,0,0,0,0,0,0,0,0,0,0,0,0,0,0,0,0,0,0,0,0,0,0,0,0,0,0,0,0,0,0,0,0,0,0,0,0,0,Mathieu Debuchy,Â£5.85m ,Ligue 1
29/6/2010,Marco Zambelli,7982685,776,8/22/1985,24,0,0,1,0,1400,5900,5900,151,132,4546917,178,75,D/WB/DM/M RC,1,1,1,1,1,1,1,1,1,1,1,10,16,9,7,12,2,9,14,4,15,14,1,16,12,12,14,10,12,7,12,9,9,12,15,4,15,12,14,16,14,12,6,5,12,17,20,14,9,10,5,11,12,14,8,2,19,7,11,12,5,14,D/WB/DM/M RC,133,1,12,20,20,18,1,1,20,20,1,20,1,1,12,1,12,20,20,1,20,1,20,0,0,0,0,0,0,0,0,0,0,0,0,0,0,0,0,0,0,0,0,0,0,0,0,0,0,0,0,0,0,0,0,0,0,0,0,0,0,0,0,0,0,0,0,0,0,0,0,0,Marco Zambelli,Â£1.53m ,Serie A
29/6/2010,Marco Motta,7990132,776,5/14/1986,24,0,0,38,1,4750,7100,7100,154,141,7440348,183,76,D/WB RL,1,1,1,1,1,1,1,1,1,1,1,8,11,13,8,11,5,11,11,11,16,14,5,14,14,15,14,15,8,10,11,10,16,11,13,15,12,16,16,15,12,13,12,15,13,15,20,15,12,13,8,15,7,18,6,15,17,14,18,19,13,13,D/WB RL,115,1,8,5,20,1,1,15,15,20,1,20,1,1,8,5,15,20,1,15,15,15,20,0,0,0,0,0,0,0,0,0,0,0,0,0,0,0,0,0,0,0,0,0,0,0,0,0,0,0,0,0,0,0,0,0,0,0,0,0,0,0,0,0,0,0,0,0,0,0,0,0,Marco Motta,Â£3.15m ,Serie A
29/6/2010,Marco Andreolli,7984570,776,6/10/1986,24,0,0,24,0,3500,6100,6100,148,125,3001521,187,81,D RC,3,1,1,2,1,2,1,1,3,3,2,4,13,8,8,10,8,15,9,11,15,11,6,15,8,9,14,13,12,13,10,17,15,5,8,10,13,14,14,13,13,13,14,5,15,13,20,12,12,13,13,10,15,14,19,15,13,8,7,11,12,11,D RC,103,1,1,20,20,10,1,10,1,16,1,1,1,1,1,20,10,16,1,1,1,1,1,0,0,0,0,0,0,0,0,0,0,0,0,0,0,0,0,0,0,0,0,0,0,0,0,0,0,0,0,0,0,0,0,0,0,0,0,0,0,0,0,0,0,0,0,0,0,0,0,0,Marco Andreolli,Â£2.70m ,Serie A
29/6/2010,Loïc Perrin,8433507,769,8/7/1985,24,0,0,4,0,1400,5900,5900,150,132,2605077,180,76,D/WB/DM RC,3,3,2,1,2,3,3,4,3,3,2,6,12,10,6,12,7,14,13,9,11,13,7,13,12,11,14,15,14,14,11,14,14,7,14,8,14,14,17,13,11,13,10,8,9,12,20,13,13,15,11,14,16,15,5,13,17,13,16,15,15,5,D/WB/DM RC,123,1,10,16,20,16,1,1,15,20,1,18,1,1,10,12,1,20,15,1,14,1,18,256,0,0,0,0,0,0,0,0,1,0,0,0,0,0,0,0,0,0,0,0,0,0,0,0,0,0,0,0,0,0,0,0,0,0,0,0,0,0,0,0,0,0,0,0,0,0,0,0,LoÃ¯c Perrin,Â£3.15m ,Ligue 1
29/6/2010,Jonathan Spector,979165,390,3/1/1986,24,26,0,0,0,3906,6150,6050,136,125,2360231,186,80,D RLC,1,1,1,1,1,1,1,1,1,1,1,3,8,7,10,12,4,12,9,8,14,11,6,14,13,15,12,15,10,12,8,12,15,12,11,11,12,13,12,15,12,14,12,8,13,14,20,13,12,13,12,13,5,15,15,18,14,14,15,12,13,8,D RLC,106,6,6,15,20,12,1,15,10,20,1,12,6,1,1,15,15,20,10,1,1,8,12,4294967300,0,0,1,0,0,0,0,0,0,0,0,0,0,0,0,0,0,0,0,0,0,0,0,0,0,0,0,0,0,0,0,0,1,0,0,0,0,0,0,0,0,0,0,0,0,0,0,0,Jonathan Spector,Â£2.25m ,Premier League
29/6/2010,Gonzalo Jara,5250132,1652,8/23/1985,24,38,3,0,0,4624,7000,6750,145,136,6550116,178,76,D/DM/M RLC,3,1,1,1,2,2,1,4,3,2,2,5,8,10,8,12,8,14,10,10,14,13,5,15,11,15,13,14,11,12,12,12,15,10,13,10,16,15,15,10,13,13,11,14,14,11,20,14,13,14,15,13,8,17,11,14,13,12,13,12,7,6,D/DM/M RLC,126,1,1,20,20,19,1,17,16,20,18,15,1,1,1,20,17,20,16,1,15,12,15,16810048,0,0,0,0,0,0,1,0,0,0,0,0,0,0,0,1,0,0,0,0,0,0,0,0,1,0,0,0,0,0,0,0,0,0,0,0,0,0,0,0,0,0,0,0,0,0,0,0,Gonzalo Jara,Â£2.70m ,Premier League
29/6/2010,Francesco Pisano,7988382,776,4/29/1986,24,0,0,12,0,2000,6400,6400,140,126,6594728,170,65,D/WB RL,2,3,1,3,3,3,1,4,1,2,2,8,12,12,9,10,5,8,8,14,12,10,6,13,11,17,16,15,7,12,9,12,11,5,11,13,12,12,11,15,15,12,5,7,15,14,20,17,13,10,11,10,6,10,10,10,10,10,9,10,11,6,D/WB RL,115,1,1,1,20,1,1,16,1,20,1,18,1,1,1,1,16,20,1,1,1,13,18,2.74878E+11,0,0,0,0,0,0,1,0,0,0,0,0,0,0,0,1,0,0,0,0,0,0,0,0,0,0,0,0,0,0,0,0,0,0,0,0,0,0,1,0,0,0,0,0,0,0,0,0,Francesco Pisano,Â£1.80m ,Serie A
29/6/2010,Ernesto Galán,1512134,796,6/17/1986,24,0,0,0,0,2000,5000,5000,125,110,1604909,181,79,D RC,3,3,2,1,3,1,2,1,2,3,3,9,14,12,11,10,8,11,10,11,13,11,10,11,11,12,12,11,10,7,13,9,10,11,8,14,14,15,14,15,15,13,11,7,13,11,20,14,12,11,8,13,15,11,12,13,9,10,10,14,10,9,D RC,103,1,1,20,20,1,1,1,1,20,1,15,1,1,1,20,1,20,1,1,1,1,15,0,0,0,0,0,0,0,0,0,0,0,0,0,0,0,0,0,0,0,0,0,0,0,0,0,0,0,0,0,0,0,0,0,0,0,0,0,0,0,0,0,0,0,0,0,0,0,0,0,Ernesto GalÃ¡n,Â£900Th. ,LaLiga
29/6/2010,Edson,19008137,1651,5/31/1986,24,0,0,0,0,2250,5750,5750,140,115,4600577,170,64,D/WB/M R,2,1,1,1,3,2,3,2,2,1,1,6,11,14,6,13,6,7,6,10,9,10,6,10,14,12,9,11,8,9,11,9,10,13,5,14,9,12,14,17,16,10,8,10,12,17,20,15,8,14,10,12,5,10,8,10,9,12,7,12,12,12,D/WB/M R,122,1,10,1,20,1,1,1,17,20,1,18,1,1,10,1,6,20,1,1,17,1,18,34,0,1,0,0,0,1,0,0,0,0,0,0,0,0,0,0,0,0,0,0,0,0,0,0,0,0,0,0,0,0,0,0,0,0,0,0,0,0,0,0,0,0,0,0,0,0,0,0,Ederson,Â£4.95m ,Ligue 1
29/6/2010,Carlos Martínez,1511410,796,4/9/1986,24,0,0,0,0,3782,5650,5650,134,123,5784201,188,78,D R,3,3,2,2,3,2,1,5,1,1,2,5,10,12,7,8,5,10,4,10,12,10,5,14,9,16,13,16,14,12,9,12,11,11,10,13,11,14,18,12,9,13,15,11,11,14,20,16,15,14,10,11,9,13,13,14,15,13,14,14,10,6,D R,102,1,1,14,20,1,1,1,9,20,1,15,1,1,1,14,5,20,1,1,9,1,15,0,0,0,0,0,0,0,0,0,0,0,0,0,0,0,0,0,0,0,0,0,0,0,0,0,0,0,0,0,0,0,0,0,0,0,0,0,0,0,0,0,0,0,0,0,0,0,0,0,Carlos MartÃ­nez,Â£2.70m ,LaLiga
29/6/2010,Camilo Zúñiga,8829100,1653,12/14/1985,24,7,0,15,2,3500,6299,6950,157,140,7898017,172,72,D/WB R,3,3,2,1,1,3,3,4,1,1,3,11,13,15,9,11,8,8,12,13,12,12,10,12,14,14,13,12,14,13,15,12,13,13,10,12,13,14,15,17,15,11,8,9,13,16,20,11,12,15,10,12,9,12,17,16,16,12,13,14,16,9,D/WB R,112,1,1,1,20,1,1,13,14,20,1,20,1,1,1,1,12,20,1,13,14,13,20,1.09965E+12,0,0,0,0,0,0,0,0,0,0,0,0,0,0,0,0,0,0,0,0,0,0,0,0,0,0,0,1,0,0,0,0,0,0,0,0,0,0,0,0,1,0,0,0,0,0,0,0,Camilo ZÃºÃ±iga,Â£4.05m ,Serie A
29/6/2010,Bakary Soro,8631066,24,12/5/1985,24,0,0,5,0,3300,5750,5150,140,115,2149819,184,74,D/WB RC,3,1,1,2,1,1,2,1,1,2,1,5,11,8,5,8,6,14,6,10,12,9,7,13,9,14,12,13,13,13,8,12,17,7,13,8,13,13,13,13,10,14,12,8,14,11,20,16,14,14,13,11,9,12,8,13,13,12,15,15,15,6,D/WB RC,113,1,1,20,20,12,1,10,8,17,1,17,1,1,1,20,10,17,8,1,1,10,17,0,0,0,0,0,0,0,0,0,0,0,0,0,0,0,0,0,0,0,0,0,0,0,0,0,0,0,0,0,0,0,0,0,0,0,0,0,0,0,0,0,0,0,0,0,0,0,0,0,Bakary Soro,Â£720Th. ,Ligue 1
29/6/2010,Andrea Masiello,7984549,776,2/5/1986,24,0,0,0,0,3500,6650,6650,156,141,4286859,185,75,D RC,1,2,2,1,1,1,2,5,3,2,2,3,8,7,5,10,5,15,5,3,16,10,4,16,10,13,16,15,14,13,8,14,14,12,16,8,16,14,13,13,13,14,13,6,14,13,20,16,15,14,8,14,7,10,14,16,16,3,16,14,11,3,D RC,103,1,1,20,20,1,1,9,1,18,13,1,1,1,1,20,9,18,1,1,1,1,1,0,0,0,0,0,0,0,0,0,0,0,0,0,0,0,0,0,0,0,0,0,0,0,0,0,0,0,0,0,0,0,0,0,0,0,0,0,0,0,0,0,0,0,0,0,0,0,0,0,Andrea Masiello,Â£2.70m ,Serie A
29/6/2010,Alex John-Baptiste,5112061,765,1/31/1986,24,0,0,0,0,2000,5750,5750,141,121,3355131,181,74,D RC,2,2,1,3,1,2,2,4,1,2,3,8,10,5,2,11,9,14,7,8,15,10,2,15,10,11,13,13,14,14,7,14,11,5,8,9,13,9,12,12,8,13,12,10,14,14,20,9,13,16,6,10,9,9,12,12,9,12,12,12,15,4,D RC,103,1,1,20,20,1,1,12,1,20,1,9,1,1,1,20,12,20,1,1,1,1,9,1.40737E+14,0,0,0,0,0,0,0,0,0,0,0,0,0,0,0,0,0,0,0,0,0,0,0,0,0,0,0,0,0,0,0,0,0,0,0,0,0,0,0,0,0,0,0,0,0,0,0,1,Alex Baptiste,Â£450Th. ,Premier League
29/6/2010,Valon Behrami,5724445,798,4/19/1985,25,28,2,4,0,5476,7500,7000,155,148,13491018,186,78,D/WB/M RLC,1,1,1,1,1,1,1,1,1,1,1,4,10,12,9,13,3,8,10,8,11,14,5,16,14,16,14,18,11,12,10,8,18,10,8,14,13,18,19,15,14,14,11,10,15,14,20,19,15,14,16,15,14,14,15,15,10,10,16,8,15,4,D/WB/M RLC,436,1,12,18,18,10,1,15,20,20,1,18,1,9,12,1,7,18,18,15,20,12,18,1.37453E+12,0,0,0,1,0,0,0,0,0,0,0,0,0,0,0,0,0,0,0,0,0,0,1,0,0,0,0,1,0,0,0,0,0,0,0,0,0,0,1,0,1,0,0,0,0,0,0,0,Valon Behrami,Â£7.20m ,Premier League
29/6/2010,Tim Hoogland,8707937,771,6/11/1985,25,0,0,0,0,3400,6000,6000,138,131,2911143,183,78,D/M RC,1,2,3,2,2,1,3,4,1,3,3,8,10,7,14,9,8,17,13,16,15,9,8,15,8,16,12,16,10,15,7,10,11,4,13,14,14,16,17,14,10,12,14,6,13,14,20,17,12,12,10,12,13,17,12,14,8,8,10,13,6,13,D/M RC,113,1,12,15,20,10,1,1,16,20,1,14,1,1,12,15,1,20,1,1,16,1,14,0,0,0,0,0,0,0,0,0,0,0,0,0,0,0,0,0,0,0,0,0,0,0,0,0,0,0,0,0,0,0,0,0,0,0,0,0,0,0,0,0,0,0,0,0,0,0,0,0,Tim Hoogland,Â£2.25m ,Bundesliga
29/6/2010,Sebastian Schachten,8718065,771,11/6/1984,25,0,0,0,0,1900,5900,5900,128,118,737981,190,82,D/WB RL,3,2,1,2,2,3,2,4,1,3,3,10,11,11,7,10,7,8,8,6,11,10,11,12,11,10,10,10,10,11,11,11,12,9,5,10,11,13,13,13,12,10,14,14,12,13,20,12,11,12,8,10,16,18,8,12,12,10,12,11,7,5,D/WB RL,115,1,1,10,20,1,1,15,15,20,1,18,1,1,1,10,4,20,1,1,15,15,18,0,0,0,0,0,0,0,0,0,0,0,0,0,0,0,0,0,0,0,0,0,0,0,0,0,0,0,0,0,0,0,0,0,0,0,0,0,0,0,0,0,0,0,0,0,0,0,0,0,Sebastian Schachten,Â£360Th. ,Bundesliga
29/6/2010,Sebastian Larsson,615722,797,6/6/1985,25,22,0,12,0,4489,7000,6500,142,134,4472863,178,70,M/AM RC,3,1,1,2,1,3,3,6,2,3,1,12,15,13,11,12,17,12,15,8,10,13,8,12,13,9,12,12,13,12,10,12,14,12,11,11,9,12,14,13,12,9,8,12,15,14,20,14,11,12,2,12,5,10,13,14,17,12,13,15,15,5,M/AM RC,413,1,19,19,15,10,1,14,20,20,1,15,1,1,19,1,1,15,19,14,20,14,15,68719476992,0,0,0,0,0,0,0,0,1,0,0,0,0,0,0,0,0,0,0,0,0,0,0,0,0,0,0,0,0,0,0,0,0,0,0,0,1,0,0,0,0,0,0,0,0,0,0,0,Sebastian Larsson,Â£5.40m ,Premier League
29/6/2010,Ryan Taylor,5111053,765,8/19/1984,25,0,0,4,0,3540,6000,6000,138,119,15092204,173,69,D/WB/M R,3,1,2,3,3,1,1,2,2,3,2,14,14,10,9,12,14,6,15,16,9,12,13,12,12,10,13,10,10,12,10,10,13,10,8,13,12,12,13,12,13,11,8,12,13,13,20,15,10,12,7,12,9,18,12,13,14,12,11,11,8,8,D/WB/M R,122,5,14,5,20,1,1,12,19,20,1,18,1,8,14,1,9,20,5,12,19,10,18,68719477024,0,0,0,0,0,1,0,0,1,0,0,0,0,0,0,0,0,0,0,0,0,0,0,0,0,0,0,0,0,0,0,0,0,0,0,0,1,0,0,0,0,0,0,0,0,0,0,0,Ryan Taylor,Â£1.35m ,Premier League
29/6/2010,Phil Bardsley,5107572,793,6/28/1985,25,0,0,0,0,3000,6500,6500,130,129,4369188,180,74,D R,3,2,3,3,2,1,2,3,1,3,2,5,11,9,8,10,11,10,9,10,14,11,6,14,11,17,14,17,11,14,7,14,18,5,12,9,12,15,15,14,12,12,9,7,16,13,20,16,11,6,14,11,4,8,7,16,15,12,13,6,9,10,D R,102,1,1,1,20,1,1,7,4,20,1,7,1,1,1,1,7,20,1,1,4,1,7,1.54619E+11,0,1,0,0,0,0,0,0,0,0,0,0,0,0,0,0,0,0,0,0,0,0,0,0,0,0,0,0,0,0,0,0,0,0,1,0,0,1,0,0,0,0,0,0,0,0,0,0,Phil Bardsley,Â£3.60m ,Premier League
29/6/2010,Pedro Queirós,55011074,788,8/8/1984,25,0,0,0,0,1980,4500,4500,105,89,453068,180,72,D R,3,3,2,3,2,3,1,4,3,3,1,10,10,9,7,10,9,9,10,10,10,9,10,12,10,11,10,11,11,11,7,10,13,8,10,11,11,12,12,12,11,11,10,7,13,12,20,12,12,11,10,10,8,10,10,10,13,11,12,13,13,6,D R,102,1,1,1,20,1,1,10,1,20,1,10,1,1,1,1,10,20,1,1,1,1,10,0,0,0,0,0,0,0,0,0,0,0,0,0,0,0,0,0,0,0,0,0,0,0,0,0,0,0,0,0,0,0,0,0,0,0,0,0,0,0,0,0,0,0,0,0,0,0,0,0,Pedro QueirÃ³s,Â£180Th. ,Liga NOS
29/6/2010,Pedrinho,743337,788,3/6/1985,25,0,0,0,0,2250,5500,5500,115,109,238676,175,72,D R,3,1,2,1,2,1,1,1,3,1,2,12,12,14,12,12,11,9,10,9,9,10,10,9,15,11,13,12,12,11,10,11,14,12,16,12,11,11,11,13,12,10,9,5,12,13,20,12,10,15,9,13,8,11,10,13,13,11,14,14,15,5,D R,102,1,13,5,20,1,1,1,12,20,1,10,5,1,13,1,1,20,1,1,12,1,10,19,1,1,0,0,1,0,0,0,0,0,0,0,0,0,0,0,0,0,0,0,0,0,0,0,0,0,0,0,0,0,0,0,0,0,0,0,0,0,0,0,0,0,0,0,0,0,0,0,Pedrinho,Â£1.17m ,Liga NOS
29/6/2010,Paolo Hernán Dellafiore,7988413,776,2/2/1985,25,0,0,6,0,3300,6150,6150,140,128,2056418,186,74,D RC,3,2,3,1,3,1,3,4,1,2,3,9,12,10,4,7,4,16,4,5,16,11,4,16,6,12,14,14,15,11,5,12,14,11,11,6,15,14,16,15,16,9,14,9,12,14,20,8,10,15,8,14,6,13,15,14,13,14,6,10,6,6,D RC,103,1,1,20,20,6,1,6,13,16,8,12,1,1,1,20,6,16,1,1,13,4,12,0,0,0,0,0,0,0,0,0,0,0,0,0,0,0,0,0,0,0,0,0,0,0,0,0,0,0,0,0,0,0,0,0,0,0,0,0,0,0,0,0,0,0,0,0,0,0,0,0,Paolo Dellafiore,Â£900Th. ,Serie A
29/6/2010,Pablo Zabaleta,951034,1649,1/16/1985,25,7,0,43,5,5476,6750,7250,155,148,67459202,177,76,D/WB/M RC,2,3,1,1,3,1,2,3,3,1,3,8,13,11,10,12,7,10,12,14,13,12,11,13,13,17,14,14,15,14,12,12,17,4,10,11,13,18,18,15,14,13,9,10,15,14,20,16,12,13,8,14,13,19,18,16,15,18,17,15,14,11,D/WB/M RC,123,1,14,18,20,14,1,1,18,20,1,18,1,1,14,1,13,20,18,1,18,1,18,0,0,0,0,0,0,0,0,0,0,0,0,0,0,0,0,0,0,0,0,0,0,0,0,0,0,0,0,0,0,0,0,0,0,0,0,0,0,0,0,0,0,0,0,0,0,0,0,0,Pablo Zabaleta,Â£10.80m ,Premier League
29/6/2010,Michel Bertasso,55012134,1651,3/6/1985,25,0,0,0,0,500,4500,4500,110,100,443024,183,77,D R,1,3,2,3,2,3,3,3,1,3,2,11,14,9,9,13,9,12,9,10,11,8,10,14,13,17,10,10,11,11,10,10,12,6,13,5,12,9,13,14,10,12,10,5,17,14,20,9,8,10,8,10,8,10,12,11,12,12,13,13,13,5,D R,102,1,1,10,20,1,1,10,1,20,1,10,1,1,1,10,10,20,1,1,1,1,10,0,0,0,0,0,0,0,0,0,0,0,0,0,0,0,0,0,0,0,0,0,0,0,0,0,0,0,0,0,0,0,0,0,0,0,0,0,0,0,0,0,0,0,0,0,0,0,0,0,Michel Bastos,Â£12.60m ,Ligue 1
29/6/2010,Michaël Chrétien,916312,34,7/10/1984,25,23,0,0,0,4830,6950,6250,150,139,4714799,179,69,D/WB RC,1,3,3,3,3,3,1,9,3,3,2,13,13,11,7,12,12,11,7,14,12,10,11,13,12,11,15,14,13,13,12,14,14,8,13,10,14,14,13,15,12,14,9,10,11,14,20,15,11,15,11,14,15,10,9,15,13,14,16,14,16,5,D/WB RC,113,1,1,16,20,12,1,10,12,20,1,18,1,1,1,16,10,20,10,8,12,10,18,2.74878E+11,0,0,0,0,0,1,0,0,0,0,0,0,0,0,0,0,0,0,0,0,0,0,0,0,0,0,0,0,0,0,0,0,0,0,0,0,0,0,1,0,0,0,0,0,0,0,0,0,,,
29/6/2010,Mensur Mujdza,658188,759,8/10/1984,25,0,0,4,0,3906,5624,6000,134,125,2728900,185,84,D/WB/M R,3,3,1,3,2,2,2,1,1,1,3,7,15,13,6,12,6,14,9,14,14,13,7,10,14,9,11,12,13,13,13,8,12,8,7,12,13,12,14,15,10,13,14,10,12,13,20,14,11,15,7,9,10,12,16,15,11,9,13,11,8,4,D/WB/M R,122,1,14,7,20,7,1,1,16,20,1,20,1,1,14,1,8,20,7,1,16,1,20,0,0,0,0,0,0,0,0,0,0,0,0,0,0,0,0,0,0,0,0,0,0,0,0,0,0,0,0,0,0,0,0,0,0,0,0,0,0,0,0,0,0,0,0,0,0,0,0,0,Mensur Mujdza,Â£1.80m ,Bundesliga
29/6/2010,Markus Berger,8708085,755,1/21/1985,25,0,0,33,0,2000,5000,5000,112,106,162037,183,75,D RC,2,3,2,3,1,2,1,1,3,3,1,7,7,8,8,9,7,14,9,10,12,9,10,12,10,13,11,11,15,15,8,11,12,6,9,8,12,13,11,11,10,13,14,4,13,10,20,12,13,11,8,10,7,13,9,12,9,10,13,13,12,10,D RC,103,1,1,20,20,12,1,8,1,15,1,5,1,1,1,20,8,15,1,1,1,1,5,0,0,0,0,0,0,0,0,0,0,0,0,0,0,0,0,0,0,0,0,0,0,0,0,0,0,0,0,0,0,0,0,0,0,0,0,0,0,0,0,0,0,0,0,0,0,0,0,0,Markus Berger,Â£900Th. ,Liga NOS
29/6/2010,Lukasz Piszczek,719130,787,6/3/1985,25,8,0,0,0,3500,6400,6400,135,127,3448725,184,78,D/WB/M/AM R,2,1,1,2,2,2,1,5,1,3,2,6,11,12,7,11,7,10,8,9,7,10,10,8,13,6,13,10,9,12,12,13,12,15,6,14,8,17,15,16,15,10,12,10,14,14,20,14,11,11,6,12,8,18,12,9,8,12,15,12,11,5,D/WB/M/AM R,442,14,20,14,16,1,1,14,20,20,1,17,10,14,20,1,1,16,1,1,18,1,17,0,0,0,0,0,0,0,0,0,0,0,0,0,0,0,0,0,0,0,0,0,0,0,0,0,0,0,0,0,0,0,0,0,0,0,0,0,0,0,0,0,0,0,0,0,0,0,0,0,Lukasz Piszczek,Â£5.40m ,Bundesliga
29/6/2010,Laure,67013448,796,3/22/1985,25,0,0,0,0,4225,6500,6500,142,130,3719407,171,66,D R,1,1,3,2,2,2,2,8,3,1,3,10,13,9,4,10,7,8,8,9,13,12,7,13,9,16,12,16,9,15,7,11,16,7,8,10,11,14,16,14,13,14,7,12,13,15,20,17,12,10,15,14,7,10,8,15,18,1,12,11,6,8,D R,102,1,1,6,20,1,1,9,9,20,1,15,1,1,1,6,9,20,1,2,9,9,15,32802,0,1,0,0,0,1,0,0,0,0,0,0,0,0,0,1,0,0,0,0,0,0,0,0,0,0,0,0,0,0,0,0,0,0,0,0,0,0,0,0,0,0,0,0,0,0,0,0,Laure,Â£810Th. ,LaLiga
29/6/2010,Lassana Diarra,8434283,769,3/10/1985,25,27,0,18,0,6084,7750,7500,166,156,166098613,172,73,DM/M RC,1,1,2,3,1,3,3,2,3,3,3,11,10,12,6,13,9,8,10,12,12,15,6,16,13,16,14,16,12,17,11,13,19,8,8,12,14,19,17,15,15,16,7,12,18,13,20,19,13,19,13,16,4,16,17,15,9,17,14,14,18,14,DM/M RC,313,1,8,20,15,20,1,1,19,15,1,12,8,1,6,1,1,15,19,1,13,1,12,1.37439E+11,0,0,0,0,0,0,1,0,0,0,0,0,0,0,0,0,0,0,0,0,0,0,0,0,0,0,0,0,0,0,0,0,0,0,0,0,0,1,0,0,0,0,0,0,0,0,0,0,Lassana Diarra,Â£16.20m ,LaLiga
29/6/2010,Kevin Foley,5107874,789,11/1/1984,25,2,0,9,1,4000,6250,6400,136,127,5069382,176,70,D/WB R,3,1,1,1,3,2,2,3,1,3,3,8,13,12,8,14,10,13,4,12,14,13,10,14,13,6,12,10,15,14,11,12,14,6,9,12,14,11,12,13,10,12,10,9,14,12,20,14,11,18,3,12,5,14,16,14,17,12,12,13,17,7,D/WB R,112,1,1,14,20,10,1,1,15,20,1,18,1,1,1,1,12,20,14,1,15,1,18,32,0,0,0,0,0,1,0,0,0,0,0,0,0,0,0,0,0,0,0,0,0,0,0,0,0,0,0,0,0,0,0,0,0,0,0,0,0,0,0,0,0,0,0,0,0,0,0,0,Kevin Foley,Â£2.70m ,Premier League
29/6/2010,Juan Valera,7456608,796,12/21/1984,25,0,0,1,0,4422,6500,6500,141,133,4999732,184,70,D/WB/M R,3,1,1,3,3,2,1,6,2,1,3,12,12,11,11,11,10,15,11,14,12,11,11,13,11,12,13,14,12,13,11,12,12,11,12,12,12,14,14,15,13,14,12,5,13,15,20,15,14,11,8,13,11,14,15,14,12,12,13,13,12,7,D/WB/M R,232,1,8,1,18,1,1,1,16,20,1,20,1,1,8,1,1,18,1,1,16,1,20,1.41837E+14,0,1,0,0,0,0,0,0,0,0,0,0,0,0,0,0,0,0,0,0,0,0,0,0,0,0,0,1,0,0,0,0,0,0,0,0,0,0,0,0,1,0,0,0,0,0,0,1,Juan Valera,Â£1.80m ,LaLiga
29/6/2010,Jorge Fucile,8829824,1657,11/19/1984,25,28,0,0,0,3500,7850,7150,158,143,44667850,177,73,D RL,3,3,1,2,3,2,3,6,2,3,3,11,12,11,8,14,11,9,12,15,13,11,11,15,13,16,12,14,13,12,11,13,15,11,11,14,12,13,15,15,14,12,10,13,14,14,20,14,12,15,11,14,12,13,14,13,15,17,14,12,12,5,D RL,105,1,1,1,20,1,1,15,8,20,1,13,1,1,1,1,15,20,1,1,8,5,13,5.49756E+11,1,1,0,0,0,1,0,0,0,0,0,0,0,0,0,0,0,0,0,0,0,0,0,0,0,0,0,0,0,0,0,0,0,0,0,0,0,0,0,1,0,0,0,0,0,0,0,0,Jorge Fucile,Â£5.13m ,Liga NOS
29/6/2010,Jordan Lotiès,8427417,769,8/5/1984,25,0,0,0,0,3844,5550,5550,138,124,3166983,190,82,D/DM RC,2,1,2,2,3,1,2,5,1,3,2,5,8,8,6,9,10,14,13,8,13,11,7,12,9,14,15,14,13,11,9,12,13,7,9,9,14,13,14,15,9,15,15,5,17,13,20,15,15,13,14,14,5,11,11,13,14,14,14,13,13,10,D/DM RC,113,1,1,20,20,17,1,1,15,15,1,15,1,1,1,20,1,15,15,1,1,1,15,33024,0,0,0,0,0,0,0,0,1,0,0,0,0,0,0,1,0,0,0,0,0,0,0,0,0,0,0,0,0,0,0,0,0,0,0,0,0,0,0,0,0,0,0,0,0,0,0,0,Jordan LotiÃ¨s,Â£1.44m ,Ligue 1
29/6/2010,Jesús Gámez,1501035,796,4/10/1985,25,0,0,4,2,5256,7250,7250,157,145,12969412,182,70,D/WB RC,3,2,2,1,3,3,2,2,1,1,1,3,13,9,5,13,4,13,6,14,13,13,7,14,14,14,13,15,14,13,11,12,12,6,18,15,13,14,14,14,14,14,12,11,15,13,20,14,14,17,8,14,8,8,8,16,15,11,12,12,8,5,D/WB RC,113,1,1,18,20,1,1,1,12,20,1,17,1,1,1,18,1,20,1,1,12,1,17,8.93353E+12,0,0,0,0,0,1,0,0,0,0,0,0,0,0,0,0,0,0,0,0,0,0,0,0,0,0,0,0,0,0,0,0,0,0,0,0,0,1,0,0,0,0,0,1,0,0,0,0,JesÃºs GÃ¡mez,Â£4.50m ,LaLiga
29/6/2010,Greg Halford,5110801,765,12/8/1984,25,0,0,0,0,2900,5750,5750,125,115,3624518,194,81,D/M R,1,1,2,3,2,2,1,1,2,1,2,11,12,11,12,12,14,16,13,19,10,13,10,11,13,10,12,9,12,12,12,9,11,12,10,13,10,12,13,11,11,10,16,10,15,12,20,12,15,10,8,10,5,16,8,15,15,8,10,15,14,8,D/M R,112,10,12,12,20,12,1,8,20,20,1,12,1,8,12,10,13,20,10,8,20,1,10,4.45302E+13,0,0,0,1,0,0,0,0,0,1,0,0,0,0,0,0,0,0,0,0,0,0,0,0,0,0,0,0,0,0,0,0,0,0,0,0,0,0,0,1,0,0,0,1,0,1,0,0,Greg Halford,Â£1.80m ,Premier League
29/6/2010,Glen Johnson,5112082,765,8/23/1984,25,26,1,14,0,5700,8000,8000,167,151,151878499,178,73,D R,1,2,2,3,1,1,1,7,2,2,2,3,15,13,10,13,8,12,10,6,12,13,12,14,13,11,13,12,13,11,12,16,13,9,7,14,11,13,16,15,14,16,13,14,17,15,20,17,15,16,7,13,14,14,18,16,15,14,15,16,17,5,D R,102,10,13,12,20,1,1,10,14,20,1,14,1,1,13,12,10,20,1,1,14,1,14,5.49756E+11,0,1,0,0,0,0,0,0,0,0,0,0,0,0,0,0,0,0,0,0,0,0,0,0,0,0,0,0,0,0,0,0,0,0,0,0,0,0,0,1,0,0,0,0,0,0,0,0,Glen Johnson,Â£13.50m ,Premier League
29/6/2010,Francisco Javier Chica,7451987,796,5/17/1985,25,0,0,0,0,4225,6250,6250,143,130,2454216,179,76,D/WB RL,3,3,2,1,3,1,3,2,2,2,2,6,10,9,5,9,6,9,6,12,13,10,9,14,9,15,14,15,11,12,9,11,14,7,12,9,14,16,17,14,11,14,11,13,14,14,20,16,13,14,10,11,7,15,10,16,13,12,12,15,10,9,D/WB RL,115,1,1,1,20,1,1,18,1,20,1,20,1,1,1,1,18,20,1,1,1,17,20,4295000064,0,0,0,0,0,0,0,0,0,0,0,0,0,0,0,1,0,0,0,0,0,0,0,0,0,0,0,0,0,0,0,0,1,0,0,0,0,0,0,0,0,0,0,0,0,0,0,0,,,
29/6/2010,Florian Dick,8708170,771,11/9/1984,25,0,0,0,0,3200,6300,6300,132,126,1544080,184,83,D/WB/M R,3,1,2,1,1,1,1,2,1,3,3,9,14,13,12,12,12,11,15,17,14,14,10,14,13,12,11,12,9,14,8,11,11,11,12,8,13,12,14,11,11,13,14,10,12,13,20,13,13,13,5,12,4,11,8,12,20,13,13,13,9,6,D/WB/M R,232,1,1,1,16,1,1,10,18,20,1,20,1,1,1,1,10,16,1,1,18,10,20,1.09951E+12,0,0,0,1,0,0,0,0,0,0,0,0,0,0,0,0,0,0,0,0,0,0,0,0,0,0,0,0,0,0,0,0,0,0,0,0,0,0,0,0,1,0,0,0,0,0,0,0,Florian Dick,Â£1.80m ,Bundesliga
29/6/2010,Dusan Basta,5754424,802,8/18/1984,25,2,0,18,1,4096,6100,6100,140,128,715831,184,74,D/WB R,2,3,3,2,3,2,2,6,2,2,1,10,14,14,8,9,6,12,15,15,8,13,8,9,12,16,12,15,12,8,16,8,12,14,9,19,8,15,17,15,17,11,12,13,8,15,20,17,9,17,9,11,14,16,12,9,12,14,13,15,16,4,D/WB R,222,1,10,10,18,10,1,1,13,20,1,20,1,1,10,1,1,18,10,1,13,1,20,1.40738E+14,0,1,0,0,0,0,0,0,0,0,0,0,0,0,0,0,0,0,0,0,0,0,0,0,1,0,0,1,0,0,0,0,0,0,0,0,0,0,0,0,0,0,0,0,0,0,0,1,Dusan Basta,Â£810Th. ,Serie A
29/6/2010,Drissa Diakité,8750151,31,2/18/1985,25,14,0,10,0,4096,6400,5750,145,128,3174424,175,69,D/DM RC,3,3,3,2,1,3,1,3,1,1,1,9,13,11,7,11,6,12,11,8,11,12,10,14,11,15,14,14,13,12,10,12,14,9,8,9,13,14,16,14,12,13,7,8,17,13,20,16,12,14,10,14,5,10,14,15,12,14,14,13,13,6,D/DM RC,113,1,1,18,20,18,1,1,15,20,8,15,1,1,1,12,1,20,15,1,8,1,15,32,0,0,0,0,0,1,0,0,0,0,0,0,0,0,0,0,0,0,0,0,0,0,0,0,0,0,0,0,0,0,0,0,0,0,0,0,0,0,0,0,0,0,0,0,0,0,0,0,Drissa DiakitÃ©,Â£1.62m ,Ligue 1
29/6/2010,Daniel Congré,8431097,769,4/5/1985,25,0,0,5,2,1450,6150,6150,155,137,4011853,184,78,D RC,1,1,1,1,1,3,3,1,2,3,2,5,10,9,6,11,7,16,8,8,16,9,6,13,11,12,14,16,13,13,8,12,17,5,13,6,14,14,14,13,11,15,12,15,13,11,20,14,15,15,12,15,11,12,13,15,17,14,16,15,15,7,D RC,103,1,1,20,20,10,1,12,1,18,1,1,1,1,1,20,12,18,1,1,1,1,1,0,0,0,0,0,0,0,0,0,0,0,0,0,0,0,0,0,0,0,0,0,0,0,0,0,0,0,0,0,0,0,0,0,0,0,0,0,0,0,0,0,0,0,0,0,0,0,0,0,Daniel CongrÃ©,Â£3.24m ,Ligue 1
29/6/2010,Damiano Ferronetti,829414,776,11/1/1984,25,0,0,5,0,3650,6350,6350,143,132,4781193,185,74,D RC,2,1,1,2,1,1,2,7,2,2,2,3,11,8,8,9,2,16,4,12,15,10,4,15,10,16,15,15,13,13,8,12,15,4,12,8,13,16,15,12,14,14,13,6,13,14,20,14,14,15,13,15,8,15,11,15,18,15,19,14,8,5,D RC,103,1,1,17,20,1,1,1,1,20,1,10,1,1,1,17,9,20,1,1,1,1,10,0,0,0,0,0,0,0,0,0,0,0,0,0,0,0,0,0,0,0,0,0,0,0,0,0,0,0,0,0,0,0,0,0,0,0,0,0,0,0,0,0,0,0,0,0,0,0,0,0,Damiano Ferronetti,Â£810Th. ,Serie A
29/6/2010,Claudemir,315153,1651,8/17/1984,25,0,0,0,0,2500,5200,5200,110,104,173075,170,63,D/WB R,1,2,3,2,1,1,1,3,1,1,2,14,9,10,7,10,12,12,12,13,10,10,9,9,9,9,8,5,11,12,10,7,10,7,10,9,12,12,14,13,15,10,9,12,14,15,20,16,10,10,11,11,8,10,13,13,11,7,12,12,11,8,D/WB R,112,1,1,10,20,10,1,1,1,20,1,16,1,1,1,1,1,20,1,1,1,1,16,770,0,1,0,0,0,0,0,0,1,1,0,0,0,0,0,0,0,0,0,0,0,0,0,0,0,0,0,0,0,0,0,0,0,0,0,0,0,0,0,0,0,0,0,0,0,0,0,0,Claudemir,Â£810Th. ,Liga NOS
29/6/2010,Andy Wilkinson,5107983,765,8/6/1984,25,0,0,0,0,3550,6150,6150,137,128,14972557,181,70,D RC,2,2,3,3,3,3,2,4,3,3,2,7,9,8,7,11,5,14,8,11,13,11,5,14,13,17,12,18,10,13,8,13,15,9,15,9,14,15,16,12,11,12,11,5,14,13,20,15,16,15,17,12,15,16,5,7,15,12,15,10,15,8,D RC,103,1,1,20,20,5,1,14,1,18,1,10,1,1,1,20,14,18,1,1,1,1,10,1.37439E+11,0,0,0,0,0,0,0,0,0,0,0,0,0,0,0,0,0,0,0,0,0,0,0,0,0,0,0,0,0,0,0,0,0,0,0,0,0,1,0,0,0,0,0,0,0,0,0,0,Andy Wilkinson,Â£2.25m ,Premier League
29/6/2010,Álvaro González,2001906,1657,10/29/1984,25,11,0,0,0,3969,6750,6750,138,126,3599999,172,66,DM/M RC,1,1,3,3,1,1,1,4,1,3,2,9,12,11,7,13,7,8,14,10,12,12,10,11,13,12,12,13,12,13,12,13,15,8,14,13,12,15,15,14,13,8,6,10,19,12,20,16,12,13,12,12,8,13,13,11,12,12,14,12,12,5,DM/M RC,423,1,6,17,12,17,1,11,20,20,1,15,1,1,6,1,5,12,15,11,20,7,15,0,0,0,0,0,0,0,0,0,0,0,0,0,0,0,0,0,0,0,0,0,0,0,0,0,0,0,0,0,0,0,0,0,0,0,0,0,0,0,0,0,0,0,0,0,0,0,0,0,Ãlvaro GonzÃ¡lez,Â£1.80m ,Serie A
29/6/2010,Alan Hutton,5204786,793,11/30/1984,25,15,0,7,0,5112,7250,6750,150,143,12569381,185,84,D/WB R,2,1,1,3,1,2,1,5,3,2,3,5,13,13,12,12,8,16,10,16,13,14,8,14,14,17,12,17,11,13,11,12,15,6,12,11,13,14,16,15,12,10,12,12,12,15,20,13,15,13,12,15,8,16,13,13,13,10,12,12,9,11,D/WB R,222,1,1,14,19,1,1,1,1,20,1,20,1,1,1,14,1,19,1,1,1,1,20,34,0,1,0,0,0,1,0,0,0,0,0,0,0,0,0,0,0,0,0,0,0,0,0,0,0,0,0,0,0,0,0,0,0,0,0,0,0,0,0,0,0,0,0,0,0,0,0,0,Alan Hutton,Â£6.75m ,Premier League
29/6/2010,Adriano,315865,1651,10/26/1984,25,3,0,0,0,5476,7150,7250,158,148,123829271,172,67,D/WB/M/AM RL,1,1,1,2,2,2,3,3,3,3,2,14,15,15,11,13,11,7,13,10,11,13,12,11,14,12,13,13,14,13,11,13,15,12,10,16,11,12,13,16,14,9,7,17,10,13,20,12,12,13,8,14,15,18,15,15,9,11,12,11,11,8,D/WB/M/AM RL,445,1,18,5,16,5,1,20,20,15,1,18,1,18,10,1,16,15,1,20,10,18,15,5.49757E+11,1,0,0,0,0,1,0,0,0,0,0,0,0,0,0,0,0,0,0,0,1,0,0,0,0,0,0,0,0,0,0,0,0,0,0,0,0,0,0,1,0,0,0,0,0,0,0,0,Adriano,Â£2.25m ,Serie A
