GameDate_2012,Name_2012,UID_2012,NationID_2012,Born_2012,Age_2012,IntCaps_2012,IntGoals_2012,U21Caps_2012,U21Goals_2012,WorldReputation_2012,HomeReputation_2012,CurrentReputation_2012,PA_2012,CA_2012,Price_2012,Height_2012,Weight_2012,PositionsString_2012,GK.AerialAbility_2012,GK.CommandOfArea_2012,GK.Communication_2012,GK.Eccentricity_2012,GK.Handling_2012,GK.Kicking_2012,GK.OneOnOnes_2012,GK.Reflexes_2012,GK.RushingOut_2012,GK.TendencyToPunch_2012,GK.Throwing_2012,Tech.Corners_2012,Tech.Crossing_2012,Tech.Dribbling_2012,Tech.Finishing_2012,Tech.FirstTouch_2012, Tech.Freekicks_2012,Tech.Heading_2012,Tech.LongShots_2012,Tech.Longthrows_2012,Tech.Marking_2012,Tech.Passing_2012,Tech.PenaltyTaking_2012, Tech.Tackling_2012,Tech.Technique_2012,Mental.Aggression_2012,Mental.Anticipation_2012,Mental.Bravery_2012,Mental.Composure_2012,Mental.Concentration_2012,Mental.Vision_2012,Mental.Decisions_2012,Mental.Determination_2012,Mental.Flair_2012,Mental.Leadership_2012, Mental.OffTheBall_2012,Mental.Positioning_2012,Mental.Teamwork_2012,Mental.Workrate_2012,Phy.Acceleration_2012,Phy.Agility_2012,Phy.Balance_2012,Phy.Jumping_2012,Phy.LeftFoot_2012,Phy.NaturalFitness_2012,Phy.Pace_2012,Phy.RightFoot_2012,Phy.Stamina_2012,Phy.Strength_2012, Hidden.Consistency_2012,Hidden.Dirtiness_2012,Hidden.ImportantMatches_2012,Hidden.InjuryProness_2012,Hidden.Versatility_2012,Personality.Adaptability_2012,Personality.Ambition_2012,Personality.Loyalty_2012,Personality.Pressure_2012,Personality.Professional_2012,Personality.Sportsmanship_2012,Personality.Temperament_2012,Personality.Controversy_2012,Positions.Defender_2012,Positions.WingBack_2012,Positions.Midfielder_2012,Positions.AttackingMidfielder_2012,Positions.Right_2012,Positions.Left_2012,Positions.Centre_2012,Positions.PositionsDesc_2012,Positions.PositionsDescVal_2012,Positions.Goalkeeper_2012,Positions.Sweeper_2012,Positions.Striker_2012,Positions.AttackingMidCentral_2012,Positions.AttackingMidLeft_2012,Positions.AttackingMidRight_2012,Positions.DefenderCentral_2012,Positions.DefenderLeft_2012, Positions.DefenderRight_2012,Positions.DefensiveMidfielder_2012,Positions.MidfielderCentral_2012,Positions.MidfielderLeft_2012,Positions.MidfielderRight_2012,Positions.WingBackLeft_2012,Positions.WingBackRight_2012,PPMVal_2012,PPM0_2012,PPM1_2012,PPM2_2012,PPM3_2012,PPM4_2012,PPM5_2012,PPM6_2012,PPM7_2012,PPM8_2012,PPM9_2012,PPM10_2012,PPM11_2012,PPM12_2012,PPM13_2012,PPM14_2012,PPM15_2012,PPM16_2012,PPM17_2012,PPM18_2012,PPM19_2012,PPM20_2012,PPM21_2012,PPM22_2012,PPM23_2012,PPM24_2012,PPM25_2012,PPM26_2012,PPM27_2012,PPM28_2012,PPM29_2012,PPM30_2012,PPM31_2012,PPM32_2012,PPM33_2012,PPM34_2012,PPM35_2012,PPM36_2012,PPM37_2012,PPM38_2012,PPM39_2012,PPM40_2012,PPM41_2012,PPM42_2012,PPM43_2012,PPM44_2012,PPM45_2012,PPM46_2012,PPM47_2012,name_2012,Market Value_2012,age_2012,height_2012,position_2012,foot_2012,current club_2012,10/11 games_2012,10/11 goals/conceded_2012,10/11 assists/clean_2012,10/11 minutes_2012,11/12 games_2012,11/12 goals/conceded_2012,11/12 assists/clean_2012,11/12 minutes_2012,12/13 games_2012,12/13 goals/conceded_2012,12/13 assists/clean_2012,12/13 minutes_2012,13/14 games_2012,13/14 goals/conceded_2012,13/14 assists/clean_2012,13/14 minutes_2012,14/15 games_2012,14/15 goals/conceded_2012,14/15 assists/clean_2012,14/15 minutes_2012,15/16 games_2012,15/16 goals/conceded_2012,15/16 assists/clean_2012,15/16 minutes_2012,16/17 games_2012,16/17 goals/conceded_2012,16/17 assists/clean_2012,16/17 minutes_2012,17/18 games_2012,17/18 goals/conceded_2012,17/18 assists/clean_2012,17/18 minutes_2012,18/19 games_2012,18/19 goals/conceded_2012,18/19 assists/clean_2012,18/19 minutes_2012,current league_2012,19/20 games_2012,19/20 goals/conceded_2012,19/20 assists/clean_2012,19/20 minutes_2012,20/21 games_2012,20/21 goals/conceded_2012,20/21 assists/clean_2012,20/21 minutes_2012,GameDate_2011,Name_2011,UID_2011,NationID_2011,Born_2011,Age_2011,IntCaps_2011,IntGoals_2011,U21Caps_2011,U21Goals_2011,WorldReputation_2011,HomeReputation_2011,CurrentReputation_2011,PA_2011,CA_2011,Price_2011,Height_2011,Weight_2011,PositionsString_2011,GK.AerialAbility_2011,GK.CommandOfArea_2011,GK.Communication_2011,GK.Eccentricity_2011,GK.Handling_2011,GK.Kicking_2011,GK.OneOnOnes_2011,GK.Reflexes_2011,GK.RushingOut_2011,GK.TendencyToPunch_2011,GK.Throwing_2011,Tech.Corners_2011,Tech.Crossing_2011,Tech.Dribbling_2011,Tech.Finishing_2011,Tech.FirstTouch_2011,Tech.Freekicks_2011,Tech.Heading_2011,Tech.LongShots_2011,Tech.Longthrows_2011,Tech.Marking_2011,Tech.Passing_2011,Tech.PenaltyTaking_2011,Tech.Tackling_2011,Tech.Technique_2011,Mental.Aggression_2011,Mental.Anticipation_2011,Mental.Bravery_2011,Mental.Composure_2011,Mental.Concentration_2011,Mental.Vision_2011,Mental.Decisions_2011,Mental.Determination_2011,Mental.Flair_2011,Mental.Leadership_2011,Mental.OffTheBall_2011,Mental.Positioning_2011,Mental.Teamwork_2011,Mental.Workrate_2011,Phy.Acceleration_2011,Phy.Agility_2011,Phy.Balance_2011,Phy.Jumping_2011,Phy.LeftFoot_2011,Phy.NaturalFitness_2011,Phy.Pace_2011,Phy.RightFoot_2011,Phy.Stamina_2011,Phy.Strength_2011,Hidden.Consistency_2011,Hidden.Dirtiness_2011,Hidden.ImportantMatches_2011,Hidden.InjuryProness_2011,Hidden.Versatility_2011,Personality.Adaptability_2011,Personality.Ambition_2011,Personality.Loyalty_2011,Personality.Pressure_2011,Personality.Professional_2011,Personality.Sportsmanship_2011,Personality.Temperament_2011,Personality.Controversy_2011,name_2011,Market Value_2011,current league_2011,GameDate_2018,FMRTEVersion_2018,Name_2018,UID_2018,NationID_2018,Born_2018,Age_2018,IntCaps_2018,IntGoals_2018,U21Caps_2018,U21Goals_2018,WorldReputation_2018,HomeReputation_2018,CurrentReputation_2018,PA_2018,CA_2018,Price_2018,Height_2018,Weight_2018,PositionsString_2018,GK.AerialAbility_2018,GK.CommandOfArea_2018,GK.Communication_2018,GK.Eccentricity_2018,GK.Handling_2018,GK.Kicking_2018,GK.OneOnOnes_2018,GK.Reflexes_2018,GK.RushingOut_2018,GK.TendencyToPunch_2018,GK.Throwing_2018,Tech.Corners_2018,Tech.Crossing_2018,Tech.Dribbling_2018,Tech.Finishing_2018,Tech.FirstTouch_2018,Tech.Freekicks_2018,Tech.Heading_2018,Tech.LongShots_2018,Tech.Longthrows_2018,Tech.Marking_2018,Tech.Passing_2018,Tech.PenaltyTaking_2018,Tech.Tackling_2018,Tech.Technique_2018,Mental.Aggression_2018,Mental.Anticipation_2018,Mental.Bravery_2018,Mental.Composure_2018,Mental.Concentration_2018,Mental.Vision_2018,Mental.Decisions_2018,Mental.Determination_2018,Mental.Flair_2018,Mental.Leadership_2018,Mental.OffTheBall_2018,Mental.Positioning_2018,Mental.Teamwork_2018,Mental.Workrate_2018,Phy.Acceleration_2018,Phy.Agility_2018,Phy.Balance_2018,Phy.Jumping_2018,Phy.LeftFoot_2018,Phy.NaturalFitness_2018,Phy.Pace_2018,Phy.RightFoot_2018,Phy.Stamina_2018,Phy.Strength_2018,Hidden.Consistency_2018,Hidden.Dirtiness_2018,Hidden.ImportantMatches_2018,Hidden.InjuryProness_2018,Hidden.Versatility_2018,Personality.Adaptability_2018,Personality.Ambition_2018,Personality.Loyalty_2018,Personality.Pressure_2018,Personality.Professional_2018,Personality.Sportsmanship_2018,Personality.Temperament_2018,Personality.Controversy_2018,Positions.Defender_2018,Positions.WingBack_2018,Positions.Midfielder_2018,Positions.AttackingMidfielder_2018,Positions.Right_2018,Positions.Left_2018,Positions.Centre_2018,Positions.PositionsDesc_2018,Positions.PositionsDescVal_2018,Positions.Goalkeeper_2018,Positions.Sweeper_2018,Positions.Striker_2018,Positions.AttackingMidCentral_2018,Positions.AttackingMidLeft_2018,Positions.AttackingMidRight_2018,Positions.DefenderCentral_2018,Positions.DefenderLeft_2018,Positions.DefenderRight_2018,Positions.DefensiveMidfielder_2018,Positions.MidfielderCentral_2018,Positions.MidfielderLeft_2018,Positions.MidfielderRight_2018,Positions.WingBackLeft_2018,Positions.WingBackRight_2018,PPMVal_2018,PPM0_2018,PPM1_2018,PPM2_2018,PPM3_2018,PPM4_2018,PPM5_2018,PPM6_2018,PPM7_2018,PPM8_2018,PPM9_2018,PPM10_2018,PPM11_2018,PPM12_2018,PPM13_2018,PPM14_2018,PPM15_2018,PPM16_2018,PPM17_2018,PPM18_2018,PPM19_2018,PPM20_2018,PPM21_2018,PPM22_2018,PPM23_2018,PPM24_2018,PPM25_2018,PPM26_2018,PPM27_2018,PPM28_2018,PPM29_2018,PPM30_2018,PPM31_2018,PPM32_2018,PPM33_2018,PPM34_2018,PPM35_2018,PPM36_2018,PPM37_2018,PPM38_2018,PPM39_2018,PPM40_2018,PPM41_2018,PPM42_2018,PPM43_2018,PPM44_2018,PPM45_2018,PPM46_2018,PPM47_2018,name_2018,Market Value_2018,age_2018,height_2018,position_2018,foot_2018,current club_2018,16/17 games_2018,16/17 goals/conceded_2018,16/17 assists/clean_2018,16/17 minutes_2018,17/18 games_2018,17/18 goals/conceded_2018,17/18 assists/clean_2018,17/18 minutes_2018,18/19 games_2018,18/19 goals/conceded_2018,18/19 assists/clean_2018,18/19 minutes_2018,19/20 games_2018,19/20 goals/conceded_2018,19/20 assists/clean_2018,19/20 minutes_2018,20/21 games_2018,20/21 goals/conceded_2018,20/21 assists/clean_2018,20/21 minutes_2018,current league_2018,GameDate_2017,FMRTEVersion_2017,Name_2017,UID_2017,NationID_2017,Born_2017,Age_2017,IntCaps_2017,IntGoals_2017,U21Caps_2017,U21Goals_2017,WorldReputation_2017,HomeReputation_2017,CurrentReputation_2017,PA_2017,CA_2017,Price_2017,Height_2017,Weight_2017,PositionsString_2017,GK.AerialAbility_2017,GK.CommandOfArea_2017,GK.Communication_2017,GK.Eccentricity_2017,GK.Handling_2017,GK.Kicking_2017,GK.OneOnOnes_2017,GK.Reflexes_2017,GK.RushingOut_2017,GK.TendencyToPunch_2017,GK.Throwing_2017,Tech.Corners_2017,Tech.Crossing_2017,Tech.Dribbling_2017,Tech.Finishing_2017,Tech.FirstTouch_2017,Tech.Freekicks_2017,Tech.Heading_2017,Tech.LongShots_2017,Tech.Longthrows_2017,Tech.Marking_2017,Tech.Passing_2017,Tech.PenaltyTaking_2017,Tech.Tackling_2017,Tech.Technique_2017,Mental.Aggression_2017,Mental.Anticipation_2017,Mental.Bravery_2017,Mental.Composure_2017,Mental.Concentration_2017,Mental.Vision_2017,Mental.Decisions_2017,Mental.Determination_2017,Mental.Flair_2017,Mental.Leadership_2017,Mental.OffTheBall_2017,Mental.Positioning_2017,Mental.Teamwork_2017,Mental.Workrate_2017,Phy.Acceleration_2017,Phy.Agility_2017,Phy.Balance_2017,Phy.Jumping_2017,Phy.LeftFoot_2017,Phy.NaturalFitness_2017,Phy.Pace_2017,Phy.RightFoot_2017,Phy.Stamina_2017,Phy.Strength_2017,Hidden.Consistency_2017,Hidden.Dirtiness_2017,Hidden.ImportantMatches_2017,Hidden.InjuryProness_2017,Hidden.Versatility_2017,Personality.Adaptability_2017,Personality.Ambition_2017,Personality.Loyalty_2017,Personality.Pressure_2017,Personality.Professional_2017,Personality.Sportsmanship_2017,Personality.Temperament_2017,Personality.Controversy_2017,name_2017,Market Value_2017,current league_2017
19/6/2011,Eric Dier,55032265,765,1/15/1994,17,0,0,0,0,1700,3250,3250,136,68,161759,188,63,D C,2,2,2,2,2,3,1,5,2,2,1,2,1,3,1,5,1,13,6,1,6,6,2,12,2,17,3,11,6,7,2,8,10,3,9,2,9,8,10,11,11,8,14,9,14,11,20,6,12,10,17,7,11,10,7,4,12,11,6,9,10,9,20,1,1,1,1,1,20,D C,101,1,1,1,1,1,1,20,1,1,1,1,1,1,1,1,0.0,0,0,0,0,0,0,0,0,0,0,0,0,0,0,0,0,0,0,0,0,0,0,0,0,0,0,0,0,0,0,0,0,0,0,0,0,0,0,0,0,0,0,0,0,0,0,0,0,nan,nan,nan,nan,nan,nan,nan,nan,nan,nan,nan,nan,nan,nan,nan,nan,nan,nan,nan,nan,nan,nan,nan,nan,nan,nan,nan,nan,nan,nan,nan,nan,nan,nan,nan,nan,nan,nan,nan,nan,nan,nan,nan,nan,nan,nan,nan,nan,nan,nan,nan,nan,nan,nan,nan,nan,nan,nan,nan,nan,nan,nan,nan,nan,nan,nan,nan,nan,nan,nan,nan,nan,nan,nan,nan,nan,nan,nan,nan,nan,nan,nan,nan,nan,nan,nan,nan,nan,nan,nan,nan,nan,nan,nan,nan,nan,nan,nan,nan,nan,nan,nan,nan,nan,nan,nan,nan,nan,nan,nan,nan,nan,nan,nan,nan,nan,nan,nan,nan,nan,nan,nan,nan,nan,nan,nan,nan,nan,nan,nan,nan,nan,nan,nan,nan,nan,19-06-17,18.3.4.28,Eric Dier,55032265,765,15-Jan-94,23,19,2,9,0,6650,7750,7750,167,156,184982123,188,90,D/DM/M C,1,3,2,1,3,3,1,1,1,2,3,7,14,9,9,13,11,15,9,5,14,14,8,15,12,15,14,16,13,13,12,14,16,5,12,12,16,16,15,12,11,10,13,14,14,17,20,16,15,15,5,12,6,17,17,14,14,13,16,14,12,5,20,1,18,1,13,8,20,D/DM/M C,121,1,1,1,1,1,1,20,8,13,20,18,1,1,1,1,4294967296.0,0,0,0,0,0,0,0,0,0,0,0,0,0,0,0,0,0,0,0,0,0,0,0,0,0,0,0,0,0,0,0,0,1,0,0,0,0,0,0,0,0,0,0,0,0,0,0,0,Eric Dier,ÃÂ£36.00m ,26.0,188.0,Defender - Centre-Back,right,Tottenham Hotspur,48.0,2.0,2.0,4091.0,47.0,0.0,3.0,3902.0,28.0,3.0,0.0,1928.0,30.0,0.0,2.0,2130.0,6.0,0.0,0.0,540.0,Premier League,15-07-16,17.3.2.23,Eric Dier,55032265.0,765.0,15-Jan-94,22.0,11.0,2.0,9.0,0.0,6500.0,7750.0,7750.0,168.0,156.0,157346434.0,188.0,86.0,D/DM/M RC,2.0,3.0,3.0,1.0,2.0,1.0,2.0,3.0,2.0,1.0,1.0,3.0,13.0,8.0,7.0,14.0,12.0,15.0,9.0,5.0,15.0,13.0,8.0,15.0,13.0,13.0,15.0,16.0,15.0,14.0,11.0,14.0,15.0,5.0,12.0,10.0,17.0,14.0,15.0,16.0,12.0,12.0,13.0,8.0,14.0,15.0,20.0,13.0,13.0,17.0,5.0,10.0,10.0,17.0,16.0,13.0,17.0,14.0,16.0,14.0,14.0,5.0,Eric Dier,ÃÂ£22.50m ,Premier League
19/6/2011,Danny da Costa,92028423,771,7/13/1993,17,0,0,0,0,1518,5284,5284,149,105,371324,186,81,D RC,1,2,2,3,1,2,2,5,2,3,3,3,6,7,2,9,3,10,7,5,9,8,9,13,7,14,10,11,6,13,9,14,9,3,11,6,14,10,13,14,13,14,10,11,10,14,20,11,8,10,3,10,17,10,5,17,11,13,13,14,14,15,20,6,1,1,20,9,17,D RC,103,1,1,1,1,1,1,17,9,20,1,1,1,1,1,6,0.0,0,0,0,0,0,0,0,0,0,0,0,0,0,0,0,0,0,0,0,0,0,0,0,0,0,0,0,0,0,0,0,0,0,0,0,0,0,0,0,0,0,0,0,0,0,0,0,0,Danny da Costa,ÃÂ£900Th. ,27.0,187.0,Defender - Right-Back,right,Eintracht Frankfurt,28.0,2.0,2.0,2381.0,13.0,0.0,1.0,779.0,28.0,0.0,1.0,2445.0,30.0,0.0,2.0,2648.0,13.0,0.0,1.0,1121.0,23.0,0.0,4.0,1792.0,4.0,0.0,1.0,198.0,21.0,1.0,5.0,1417.0,50.0,4.0,5.0,4472.0,Bundesliga,37.0,4.0,10.0,2496.0,4.0,0.0,0.0,178.0,nan,nan,nan,nan,nan,nan,nan,nan,nan,nan,nan,nan,nan,nan,nan,nan,nan,nan,nan,nan,nan,nan,nan,nan,nan,nan,nan,nan,nan,nan,nan,nan,nan,nan,nan,nan,nan,nan,nan,nan,nan,nan,nan,nan,nan,nan,nan,nan,nan,nan,nan,nan,nan,nan,nan,nan,nan,nan,nan,nan,nan,nan,nan,nan,nan,nan,nan,nan,nan,nan,nan,nan,nan,nan,nan,nan,nan,nan,nan,nan,nan,nan,nan,nan,19-06-17,18.3.4.28,Danny da Costa,92028423,771,13-Jul-93,23,0,0,5,1,3200,6200,6200,131,124,6695799,187,85,D/WB R,1,2,2,3,1,2,1,3,2,3,1,6,11,12,6,11,7,10,6,15,13,10,8,13,11,15,10,15,9,11,8,9,15,8,7,11,10,12,15,14,13,15,13,10,16,18,20,14,13,13,8,11,10,14,10,13,11,12,15,14,14,4,20,20,12,12,20,1,14,D/WB R,112,1,1,1,1,1,12,14,1,20,1,1,1,12,1,20,0.0,0,0,0,0,0,0,0,0,0,0,0,0,0,0,0,0,0,0,0,0,0,0,0,0,0,0,0,0,0,0,0,0,0,0,0,0,0,0,0,0,0,0,0,0,0,0,0,0,Danny da Costa,ÃÂ£3.15m ,27.0,187.0,Defender - Right-Back,right,Eintracht Frankfurt,4.0,0.0,1.0,198.0,21.0,1.0,5.0,1417.0,50.0,4.0,5.0,4472.0,37.0,4.0,10.0,2496.0,4.0,0.0,0.0,178.0,Bundesliga,15-07-16,17.3.2.23,Danny da Costa,92028423.0,771.0,13-Jul-93,23.0,0.0,0.0,5.0,1.0,3297.0,6297.0,6297.0,138.0,126.0,4841569.0,186.0,84.0,D/WB R,1.0,1.0,4.0,1.0,2.0,1.0,3.0,2.0,3.0,2.0,1.0,6.0,11.0,12.0,7.0,11.0,7.0,10.0,6.0,15.0,13.0,10.0,9.0,14.0,11.0,15.0,10.0,15.0,10.0,11.0,9.0,9.0,15.0,8.0,7.0,11.0,10.0,13.0,15.0,14.0,13.0,15.0,13.0,10.0,16.0,18.0,20.0,14.0,13.0,13.0,8.0,11.0,10.0,14.0,10.0,13.0,11.0,12.0,15.0,14.0,14.0,4.0,Danny da Costa,ÃÂ£900Th. ,Bundesliga
19/6/2011,Alessandro Manes,43093086,776,1/25/1994,17,0,0,0,0,148,1900,2000,67,40,536,184,80,D C,2,2,2,1,1,2,2,1,3,3,2,2,1,7,1,7,3,8,4,1,9,4,4,10,3,9,5,9,4,4,4,9,10,3,10,2,8,9,11,12,10,13,8,7,10,12,20,7,4,6,6,8,14,9,11,16,13,8,11,10,12,13,20,1,1,1,1,1,20,D C,101,1,1,1,1,1,1,20,1,1,1,1,1,1,1,1,0.0,0,0,0,0,0,0,0,0,0,0,0,0,0,0,0,0,0,0,0,0,0,0,0,0,0,0,0,0,0,0,0,0,0,0,0,0,0,0,0,0,0,0,0,0,0,0,0,0,Alessandro Nesta,ÃÂ£900Th. ,44.0,187.0,Defender - Centre-Back,right,Retired,35.0,0.0,0.0,3028.0,34.0,1.0,0.0,2834.0,24.0,0.0,0.0,2029.0,5.0,0.0,0.0,372.0,nan,nan,nan,nan,nan,nan,nan,nan,nan,nan,nan,nan,nan,nan,nan,nan,nan,nan,nan,nan,Serie A,nan,nan,nan,nan,nan,nan,nan,nan,nan,nan,nan,nan,nan,nan,nan,nan,nan,nan,nan,nan,nan,nan,nan,nan,nan,nan,nan,nan,nan,nan,nan,nan,nan,nan,nan,nan,nan,nan,nan,nan,nan,nan,nan,nan,nan,nan,nan,nan,nan,nan,nan,nan,nan,nan,nan,nan,nan,nan,nan,nan,nan,nan,nan,nan,nan,nan,nan,nan,nan,nan,nan,nan,nan,nan,nan,nan,nan,nan,nan,nan,nan,nan,nan,nan,nan,nan,nan,nan,nan,nan,nan,nan
19/6/2011,Willi Orban,91011532,771,11/3/1992,18,0,0,0,0,50,4600,4600,135,95,190795,185,84,D RLC,3,3,2,3,3,1,3,4,3,1,3,4,7,2,3,9,4,14,4,3,10,9,10,14,9,4,12,6,9,9,9,12,10,14,8,5,12,10,14,14,11,11,13,15,11,11,20,10,6,10,7,10,9,10,10,3,14,9,13,12,12,12,20,1,1,1,17,17,20,D RLC,106,1,1,1,1,1,1,20,17,17,1,1,1,1,1,1,0.0,0,0,0,0,0,0,0,0,0,0,0,0,0,0,0,0,0,0,0,0,0,0,0,0,0,0,0,0,0,0,0,0,0,0,0,0,0,0,0,0,0,0,0,0,0,0,0,0,Willi Orban,ÃÂ£225Th. ,27.0,186.0,Defender - Centre-Back,right,RB Leipzig,29.0,5.0,0.0,2610.0,25.0,3.0,3.0,2163.0,21.0,5.0,0.0,1652.0,32.0,3.0,2.0,2468.0,34.0,4.0,1.0,3006.0,33.0,1.0,1.0,2934.0,29.0,3.0,1.0,2638.0,37.0,4.0,1.0,3038.0,39.0,4.0,1.0,3382.0,Bundesliga,18.0,1.0,1.0,1247.0,5.0,1.0,1.0,332.0,nan,nan,nan,nan,nan,nan,nan,nan,nan,nan,nan,nan,nan,nan,nan,nan,nan,nan,nan,nan,nan,nan,nan,nan,nan,nan,nan,nan,nan,nan,nan,nan,nan,nan,nan,nan,nan,nan,nan,nan,nan,nan,nan,nan,nan,nan,nan,nan,nan,nan,nan,nan,nan,nan,nan,nan,nan,nan,nan,nan,nan,nan,nan,nan,nan,nan,nan,nan,nan,nan,nan,nan,nan,nan,nan,nan,nan,nan,nan,nan,nan,nan,nan,nan,19-06-17,18.3.4.28,Willi Orban,91011532,771,03-Nov-92,24,0,0,2,0,6100,6850,7100,150,142,27872986,186,82,D C,1,3,1,1,1,2,1,1,3,3,4,5,7,7,8,11,5,16,8,10,15,12,8,17,10,11,14,17,12,15,9,12,12,6,14,6,15,16,12,11,11,15,14,14,16,13,20,13,14,16,10,15,8,10,10,14,13,16,17,13,15,5,20,8,12,1,10,10,20,D C,101,1,1,1,1,1,1,20,10,10,12,12,1,1,8,8,0.0,0,0,0,0,0,0,0,0,0,0,0,0,0,0,0,0,0,0,0,0,0,0,0,0,0,0,0,0,0,0,0,0,0,0,0,0,0,0,0,0,0,0,0,0,0,0,0,0,Willi Orban,ÃÂ£13.50m ,27.0,186.0,Defender - Centre-Back,right,RB Leipzig,29.0,3.0,1.0,2638.0,37.0,4.0,1.0,3038.0,39.0,4.0,1.0,3382.0,18.0,1.0,1.0,1247.0,5.0,1.0,1.0,332.0,Bundesliga,15-07-16,17.3.2.23,Willi Orban,91011532.0,771.0,03-Nov-92,23.0,0.0,0.0,2.0,0.0,5400.0,6900.0,6900.0,150.0,138.0,6501354.0,186.0,83.0,D C,3.0,2.0,1.0,1.0,2.0,3.0,3.0,2.0,1.0,2.0,2.0,5.0,7.0,7.0,8.0,11.0,5.0,16.0,8.0,10.0,15.0,10.0,8.0,17.0,11.0,11.0,13.0,17.0,11.0,15.0,9.0,12.0,15.0,6.0,13.0,6.0,14.0,17.0,12.0,11.0,11.0,15.0,14.0,14.0,16.0,13.0,20.0,12.0,14.0,15.0,10.0,15.0,8.0,14.0,9.0,14.0,13.0,12.0,16.0,13.0,15.0,5.0,Willi Orban,ÃÂ£7.20m ,Bundesliga
19/6/2011,RaphaÃÂ«l Varane,85075627,769,4/25/1993,18,0,0,3,0,4883,6623,6623,169,134,0,190,85,D/DM C,3,2,2,2,2,1,2,2,2,3,3,5,8,9,6,13,6,15,8,7,13,13,6,12,13,9,13,13,15,11,11,13,15,7,11,8,14,14,14,15,13,16,15,8,14,14,20,14,15,16,9,14,6,10,5,15,14,17,16,16,16,5,20,10,1,1,10,1,20,D/DM C,111,1,1,1,1,1,1,20,1,10,17,1,1,1,1,10,274878000000.0,0,0,0,0,0,0,0,0,0,0,0,0,0,0,0,0,0,0,0,0,0,0,0,0,0,0,0,0,0,0,0,0,0,0,0,0,0,0,1,0,0,0,0,0,0,0,0,0,RaphaÃÂ«l Varane,ÃÂ£7.20m ,27.0,191.0,Defender - Centre-Back,right,Real Madrid,24.0,2.0,0.0,2066.0,15.0,2.0,1.0,1220.0,33.0,2.0,0.0,2623.0,23.0,0.0,1.0,1597.0,46.0,2.0,0.0,3419.0,33.0,0.0,0.0,2619.0,39.0,4.0,2.0,3381.0,44.0,0.0,2.0,3801.0,43.0,2.0,0.0,3775.0,LaLiga,43.0,3.0,1.0,3843.0,7.0,0.0,0.0,630.0,29/6/2010,RaphaÃÂ«l Varane,85075627.0,769.0,4/25/1993,17.0,0.0,0.0,0.0,0.0,1400.0,4589.0,2800.0,153.0,102.0,2056370.0,190.0,85.0,D C,1.0,2.0,1.0,1.0,3.0,1.0,2.0,2.0,3.0,2.0,3.0,5.0,5.0,7.0,6.0,12.0,6.0,14.0,7.0,7.0,12.0,11.0,6.0,9.0,12.0,10.0,13.0,13.0,14.0,11.0,10.0,12.0,14.0,5.0,6.0,6.0,11.0,13.0,13.0,10.0,8.0,15.0,15.0,5.0,14.0,9.0,20.0,14.0,15.0,16.0,10.0,10.0,6.0,10.0,12.0,13.0,14.0,13.0,15.0,17.0,17.0,5.0,RaphaÃÂÃÂ«l Varane,ÃÂÃÂ£3.60m ,Ligue 1,19-06-17,18.3.4.28,RaphaÃÂ«l Varane,85075627,769,25-Apr-93,24,37,2,15,3,8000,8250,8250,172,164,111638837,191,82,D C,1,1,2,1,2,1,1,2,3,2,3,5,9,11,6,13,8,15,9,10,17,14,10,17,14,11,15,13,14,17,11,14,12,11,9,8,17,14,14,15,13,11,17,8,16,16,20,14,15,15,6,15,14,14,12,16,13,17,14,17,16,8,20,1,1,1,10,1,20,D C,101,1,9,1,1,1,1,20,1,10,6,1,1,1,1,1,274878000000.0,0,0,0,0,0,0,0,0,0,0,0,0,0,0,0,0,0,0,0,0,0,0,0,0,0,0,0,0,0,0,0,0,0,0,0,0,0,0,1,0,0,0,0,0,0,0,0,0,RaphaÃÂ«l Varane,ÃÂ£63.00m ,27.0,191.0,Defender - Centre-Back,right,Real Madrid,39.0,4.0,2.0,3381.0,44.0,0.0,2.0,3801.0,43.0,2.0,0.0,3775.0,43.0,3.0,1.0,3843.0,7.0,0.0,0.0,630.0,LaLiga,15-07-16,17.3.2.23,RaphaÃÂ«l Varane,85075627.0,769.0,25-Apr-93,23.0,28.0,2.0,15.0,3.0,8000.0,8250.0,8200.0,174.0,163.0,51952733.0,191.0,83.0,D C,1.0,3.0,2.0,2.0,3.0,4.0,3.0,2.0,2.0,3.0,3.0,5.0,9.0,11.0,6.0,13.0,8.0,15.0,9.0,10.0,17.0,14.0,10.0,17.0,14.0,11.0,15.0,13.0,14.0,18.0,11.0,14.0,12.0,11.0,9.0,8.0,17.0,14.0,14.0,15.0,13.0,11.0,17.0,8.0,16.0,16.0,20.0,14.0,14.0,17.0,6.0,15.0,14.0,14.0,12.0,16.0,13.0,17.0,14.0,17.0,16.0,8.0,RaphaÃÂ«l Varane,ÃÂ£31.50m ,LaLiga
19/6/2011,Steven Caulker,28028360,765,12/29/1991,19,0,0,1,0,3000,5600,6000,151,123,1240021,191,77,D C,1,3,3,2,1,3,2,1,3,2,1,5,6,7,1,10,3,15,4,1,14,10,5,15,11,11,12,13,15,12,5,10,14,5,12,10,14,12,14,12,7,10,10,11,13,13,20,11,14,15,6,14,17,7,11,14,13,15,14,12,15,7,20,1,1,1,1,1,20,D C,101,1,1,1,1,1,1,20,1,1,1,1,1,1,1,1,0.0,0,0,0,0,0,0,0,0,0,0,0,0,0,0,0,0,0,0,0,0,0,0,0,0,0,0,0,0,0,0,0,0,0,0,0,0,0,0,0,0,0,0,0,0,0,0,0,0,Steven Caulker,ÃÂ£3.60m ,28.0,191.0,Defender - Centre-Back,right,Alanyaspor,31.0,2.0,2.0,2607.0,26.0,0.0,1.0,2340.0,30.0,2.0,2.0,2590.0,39.0,5.0,0.0,3510.0,36.0,1.0,1.0,3075.0,15.0,0.0,0.0,922.0,14.0,2.0,0.0,1224.0,16.0,1.0,3.0,1391.0,16.0,1.0,0.0,1312.0,Premier League,37.0,1.0,6.0,3205.0,7.0,1.0,1.0,630.0,nan,nan,nan,nan,nan,nan,nan,nan,nan,nan,nan,nan,nan,nan,nan,nan,nan,nan,nan,nan,nan,nan,nan,nan,nan,nan,nan,nan,nan,nan,nan,nan,nan,nan,nan,nan,nan,nan,nan,nan,nan,nan,nan,nan,nan,nan,nan,nan,nan,nan,nan,nan,nan,nan,nan,nan,nan,nan,nan,nan,nan,nan,nan,nan,nan,nan,nan,nan,nan,nan,nan,nan,nan,nan,nan,nan,nan,nan,nan,nan,nan,nan,nan,nan
19/6/2011,Phil Jones,28027433,765,2/21/1992,19,0,0,9,0,5500,7400,7400,170,145,14653081,181,71,D/DM C,1,2,1,2,2,3,1,1,2,1,2,2,5,8,5,14,6,13,4,10,15,12,8,16,10,15,15,16,14,13,11,14,18,14,15,9,14,13,13,14,12,11,13,12,18,14,20,15,17,15,10,18,6,14,18,18,8,18,18,14,16,8,20,1,15,1,14,1,20,D/DM C,111,1,1,1,1,1,1,20,1,14,18,15,1,1,1,1,143074000000000.0,0,0,1,0,0,1,0,0,0,0,0,0,0,0,0,0,0,0,0,0,0,0,0,0,0,0,0,0,0,0,0,0,0,0,0,0,0,1,0,0,0,1,0,0,0,0,0,1,Phil Jones,ÃÂ£16.20m ,28.0,185.0,Defender - Centre-Back,right,Manchester United,29.0,0.0,0.0,2339.0,42.0,2.0,4.0,3076.0,24.0,0.0,2.0,1788.0,39.0,3.0,2.0,3099.0,25.0,0.0,2.0,2074.0,18.0,0.0,0.0,1045.0,26.0,0.0,0.0,2222.0,25.0,0.0,0.0,2152.0,24.0,0.0,1.0,1713.0,Premier League,8.0,1.0,0.0,562.0,nan,nan,nan,nan,29/6/2010,Phil Jones,28027433.0,765.0,2/21/1992,18.0,0.0,0.0,1.0,0.0,3100.0,6350.0,6350.0,168.0,116.0,11793468.0,186.0,71.0,D C,3.0,1.0,2.0,2.0,2.0,1.0,2.0,5.0,1.0,2.0,3.0,2.0,5.0,8.0,5.0,11.0,6.0,13.0,2.0,10.0,11.0,9.0,8.0,13.0,9.0,17.0,14.0,17.0,13.0,13.0,7.0,11.0,17.0,4.0,12.0,7.0,13.0,14.0,16.0,14.0,11.0,12.0,13.0,10.0,16.0,14.0,20.0,13.0,14.0,16.0,11.0,18.0,3.0,16.0,5.0,14.0,15.0,17.0,18.0,15.0,16.0,4.0,Phil Jones,ÃÂÃÂ£3.15m ,Premier League
19/6/2011,Nicolas Isimat-Mirin,85042905,769,11/15/1991,19,0,0,0,0,4100,5129,5100,149,114,932632,188,83,D RC,2,3,2,2,2,3,2,3,2,3,3,5,5,8,6,10,6,14,7,7,13,7,6,10,10,12,14,13,11,11,11,10,15,7,8,6,12,13,14,15,10,16,14,5,13,14,20,13,16,12,12,14,7,10,13,13,12,9,17,14,14,6,20,1,1,1,15,10,20,D RC,103,1,1,1,1,1,1,20,10,15,1,1,1,1,1,1,274878000000.0,0,0,0,0,0,0,0,0,0,0,0,0,0,0,0,0,0,0,0,0,0,0,0,0,0,0,0,0,0,0,0,0,0,0,0,0,0,0,1,0,0,0,0,0,0,0,0,0,Nicolas Isimat-Mirin,ÃÂ£2.25m ,28.0,187.0,Defender - Centre-Back,right,Besiktas JK,13.0,0.0,0.0,838.0,36.0,2.0,1.0,3068.0,31.0,0.0,1.0,2697.0,11.0,0.0,0.0,959.0,25.0,1.0,0.0,1639.0,26.0,0.0,0.0,1703.0,37.0,2.0,0.0,3186.0,37.0,2.0,1.0,3356.0,20.0,1.0,0.0,1558.0,Ligue 1,16.0,1.0,0.0,1440.0,nan,nan,nan,nan,nan,nan,nan,nan,nan,nan,nan,nan,nan,nan,nan,nan,nan,nan,nan,nan,nan,nan,nan,nan,nan,nan,nan,nan,nan,nan,nan,nan,nan,nan,nan,nan,nan,nan,nan,nan,nan,nan,nan,nan,nan,nan,nan,nan,nan,nan,nan,nan,nan,nan,nan,nan,nan,nan,nan,nan,nan,nan,nan,nan,nan,nan,nan,nan,nan,nan,nan,nan,nan,nan,nan,nan,nan,nan,nan,nan,nan,nan,nan,nan,nan,nan,nan,nan
19/6/2011,Lucas,92035693,1651,7/14/1991,19,0,0,0,0,1200,4000,5250,140,110,225877,194,82,D C,1,1,3,3,2,1,2,9,3,1,1,3,5,8,9,11,4,13,8,8,12,11,6,13,11,7,11,10,10,12,8,10,12,9,7,11,14,13,14,12,11,14,15,5,14,12,20,13,13,10,7,10,6,5,12,11,11,11,13,14,7,7,20,1,1,1,1,1,20,D C,101,1,1,1,1,1,1,20,1,1,1,1,1,1,1,1,0.0,0,0,0,0,0,0,0,0,0,0,0,0,0,0,0,0,0,0,0,0,0,0,0,0,0,0,0,0,0,0,0,0,0,0,0,0,0,0,0,0,0,0,0,0,0,0,0,0,nan,nan,nan,nan,nan,nan,nan,nan,nan,nan,nan,nan,nan,nan,nan,nan,nan,nan,nan,nan,nan,nan,nan,nan,nan,nan,nan,nan,nan,nan,nan,nan,nan,nan,nan,nan,nan,nan,nan,nan,nan,nan,nan,nan,nan,nan,nan,nan,nan,nan,nan,nan,nan,nan,nan,nan,nan,nan,nan,nan,nan,nan,nan,nan,nan,nan,nan,nan,nan,nan,nan,nan,nan,nan,nan,nan,nan,nan,nan,nan,nan,nan,nan,nan,nan,nan,nan,nan,nan,nan,nan,nan,nan,nan,nan,nan,nan,nan,nan,nan,nan,nan,nan,nan,nan,nan,nan,nan,nan,nan,nan,nan,nan,nan,nan,nan,nan,nan,nan,nan,nan,nan,nan,nan,nan,nan,nan,nan,nan,nan,nan,nan,nan,nan,nan,nan
19/6/2011,Kyriakos Papadopoulos,36017184,772,2/23/1992,19,2,1,13,2,6000,6250,6900,166,132,10986072,182,79,D/DM C,2,1,1,2,2,3,3,2,1,2,2,4,6,7,5,7,4,13,5,15,19,9,6,18,8,20,12,20,7,10,7,9,19,3,13,6,10,18,19,15,8,18,14,9,10,15,20,16,17,14,12,15,3,6,5,16,12,15,14,9,7,10,20,1,10,1,5,1,20,D/DM C,111,1,5,1,1,1,1,20,1,5,17,10,1,1,1,1,137439000000.0,0,0,0,0,0,0,1,0,0,0,0,0,0,0,0,1,0,0,0,0,0,0,0,0,0,0,0,0,0,0,0,0,0,0,0,0,0,1,0,0,0,0,0,0,0,0,0,0,Kyriakos Papadopoulos,ÃÂ£10.80m ,28.0,185.0,Defender - Centre-Back,right,Without Club,31.0,0.0,1.0,1865.0,46.0,5.0,1.0,4077.0,16.0,2.0,0.0,1237.0,6.0,0.0,0.0,203.0,20.0,4.0,1.0,1180.0,31.0,1.0,0.0,2011.0,18.0,2.0,0.0,1416.0,30.0,1.0,1.0,2700.0,2.0,0.0,0.0,180.0,Bundesliga,4.0,0.0,0.0,284.0,nan,nan,nan,nan,nan,nan,nan,nan,nan,nan,nan,nan,nan,nan,nan,nan,nan,nan,nan,nan,nan,nan,nan,nan,nan,nan,nan,nan,nan,nan,nan,nan,nan,nan,nan,nan,nan,nan,nan,nan,nan,nan,nan,nan,nan,nan,nan,nan,nan,nan,nan,nan,nan,nan,nan,nan,nan,nan,nan,nan,nan,nan,nan,nan,nan,nan,nan,nan,nan,nan,nan,nan,nan,nan,nan,nan,nan,nan,nan,nan,nan,nan,nan,nan,nan,nan,nan,nan,19-06-17,18.3.4.28,Kyriakos Papadopoulos,36017184,772,23-Feb-92,25,25,4,7,2,6200,6500,6700,138,134,13311450,182,79,D C,2,1,3,3,1,3,2,2,3,1,4,4,7,7,5,8,4,15,6,12,18,10,4,18,8,14,12,20,8,11,7,10,20,4,13,6,12,10,15,15,9,18,13,9,12,14,20,14,17,13,12,16,14,6,12,17,13,13,12,8,5,10,20,5,12,1,5,1,20,D C,101,1,5,1,1,1,1,20,1,5,14,12,1,1,1,5,32832.0,0,0,0,0,0,0,1,0,0,0,0,0,0,0,0,1,0,0,0,0,0,0,0,0,0,0,0,0,0,0,0,0,0,0,0,0,0,0,0,0,0,0,0,0,0,0,0,0,Kyriakos Papadopoulos,ÃÂ£4.50m ,28.0,185.0,Defender - Centre-Back,right,Without Club,18.0,2.0,0.0,1416.0,30.0,1.0,1.0,2700.0,2.0,0.0,0.0,180.0,4.0,0.0,0.0,284.0,nan,nan,nan,nan,Bundesliga,15-07-16,17.3.2.23,Kyriakos Papadopoulos,36017184.0,772.0,23-Feb-92,24.0,20.0,4.0,7.0,2.0,5700.0,6500.0,6700.0,146.0,134.0,12147420.0,182.0,79.0,D C,2.0,1.0,1.0,2.0,2.0,1.0,2.0,3.0,2.0,1.0,2.0,4.0,7.0,7.0,5.0,8.0,4.0,15.0,6.0,12.0,18.0,10.0,4.0,18.0,8.0,14.0,12.0,20.0,8.0,11.0,7.0,10.0,20.0,4.0,13.0,6.0,12.0,10.0,15.0,15.0,9.0,18.0,13.0,9.0,12.0,14.0,20.0,14.0,17.0,13.0,12.0,14.0,14.0,6.0,12.0,17.0,13.0,13.0,12.0,10.0,5.0,10.0,Kyriakos Papadopoulos,ÃÂ£6.30m ,Bundesliga
19/6/2011,Jordi Amat,67064765,796,3/21/1992,19,0,0,0,0,4000,6250,6250,155,130,3608773,184,78,D C,2,2,1,3,1,1,1,4,1,1,1,9,7,2,4,12,7,12,6,1,14,12,8,14,11,13,14,15,10,13,9,13,10,7,14,9,13,12,13,13,13,13,12,8,14,12,20,13,13,11,9,10,4,10,7,11,14,10,11,12,8,4,20,1,1,1,10,1,20,D C,101,1,1,1,1,1,1,20,1,10,1,1,1,1,1,1,0.0,0,0,0,0,0,0,0,0,0,0,0,0,0,0,0,0,0,0,0,0,0,0,0,0,0,0,0,0,0,0,0,0,0,0,0,0,0,0,0,0,0,0,0,0,0,0,0,0,Jordi Amat,ÃÂ£1.80m ,28.0,184.0,Defender - Centre-Back,right,KAS Eupen,27.0,0.0,0.0,2241.0,13.0,0.0,0.0,977.0,27.0,1.0,0.0,2197.0,30.0,0.0,0.0,2344.0,12.0,0.0,0.0,765.0,11.0,0.0,0.0,731.0,19.0,0.0,0.0,1542.0,26.0,0.0,0.0,2142.0,31.0,0.0,0.0,2764.0,LaLiga,25.0,2.0,0.0,2046.0,9.0,0.0,0.0,810.0,nan,nan,nan,nan,nan,nan,nan,nan,nan,nan,nan,nan,nan,nan,nan,nan,nan,nan,nan,nan,nan,nan,nan,nan,nan,nan,nan,nan,nan,nan,nan,nan,nan,nan,nan,nan,nan,nan,nan,nan,nan,nan,nan,nan,nan,nan,nan,nan,nan,nan,nan,nan,nan,nan,nan,nan,nan,nan,nan,nan,nan,nan,nan,nan,nan,nan,nan,nan,nan,nan,nan,nan,nan,nan,nan,nan,nan,nan,nan,nan,nan,nan,nan,nan,19-06-17,18.3.4.28,Jordi Amat,67064765,796,21-Mar-92,25,0,0,15,0,5250,6250,6400,135,128,18027023,184,83,D C,3,3,3,1,2,3,1,1,3,1,3,7,8,10,6,12,6,12,9,8,13,11,6,14,11,18,14,17,13,12,10,11,15,9,12,9,15,14,17,12,11,13,12,14,15,12,20,14,14,13,15,14,13,6,18,13,16,15,18,11,7,3,20,1,1,1,7,6,20,D C,101,1,1,1,1,1,1,20,6,7,5,1,1,1,1,1,32768.0,0,0,0,0,0,0,0,0,0,0,0,0,0,0,0,1,0,0,0,0,0,0,0,0,0,0,0,0,0,0,0,0,0,0,0,0,0,0,0,0,0,0,0,0,0,0,0,0,Jordi Amat,ÃÂ£4.50m ,28.0,184.0,Defender - Centre-Back,right,KAS Eupen,19.0,0.0,0.0,1542.0,26.0,0.0,0.0,2142.0,31.0,0.0,0.0,2764.0,25.0,2.0,0.0,2046.0,9.0,0.0,0.0,810.0,LaLiga,15-07-16,17.3.2.23,Jordi Amat,67064765.0,796.0,21-Mar-92,24.0,0.0,0.0,15.0,0.0,5250.0,6250.0,6500.0,141.0,134.0,21043549.0,184.0,83.0,D C,2.0,2.0,2.0,2.0,4.0,3.0,2.0,2.0,2.0,3.0,2.0,7.0,8.0,10.0,6.0,12.0,6.0,13.0,9.0,8.0,14.0,11.0,6.0,15.0,11.0,18.0,14.0,17.0,13.0,12.0,10.0,11.0,15.0,9.0,12.0,9.0,15.0,14.0,18.0,12.0,11.0,13.0,13.0,14.0,16.0,12.0,20.0,14.0,15.0,15.0,15.0,14.0,13.0,6.0,18.0,13.0,16.0,15.0,18.0,11.0,7.0,3.0,Jordi Amat,ÃÂ£2.25m ,Premier League
19/6/2011,Jon Aurtenetxe,67088158,796,1/3/1992,19,0,0,0,0,4100,6100,6100,133,125,4233638,182,82,D LC,1,3,1,1,3,2,2,2,2,2,2,5,9,8,6,8,4,12,6,10,15,10,3,13,11,15,12,13,12,13,10,11,11,9,10,8,14,14,14,11,12,13,12,20,10,13,13,14,14,13,14,9,8,7,14,13,15,11,7,7,12,9,20,11,1,1,1,18,20,D LC,104,1,1,1,1,1,1,20,18,1,1,1,1,1,11,1,32768.0,0,0,0,0,0,0,0,0,0,0,0,0,0,0,0,1,0,0,0,0,0,0,0,0,0,0,0,0,0,0,0,0,0,0,0,0,0,0,0,0,0,0,0,0,0,0,0,0,Jon Aurtenetxe,ÃÂ£2.70m ,28.0,183.0,Defender - Centre-Back,left,Without Club,15.0,0.0,1.0,1153.0,54.0,4.0,1.0,4429.0,31.0,1.0,3.0,2336.0,20.0,0.0,1.0,1560.0,7.0,0.0,0.0,523.0,24.0,0.0,4.0,1838.0,18.0,2.0,1.0,1440.0,19.0,0.0,1.0,1556.0,16.0,2.0,0.0,1440.0,LaLiga,23.0,0.0,0.0,1758.0,nan,nan,nan,nan,nan,nan,nan,nan,nan,nan,nan,nan,nan,nan,nan,nan,nan,nan,nan,nan,nan,nan,nan,nan,nan,nan,nan,nan,nan,nan,nan,nan,nan,nan,nan,nan,nan,nan,nan,nan,nan,nan,nan,nan,nan,nan,nan,nan,nan,nan,nan,nan,nan,nan,nan,nan,nan,nan,nan,nan,nan,nan,nan,nan,nan,nan,nan,nan,nan,nan,nan,nan,nan,nan,nan,nan,nan,nan,nan,nan,nan,nan,nan,nan,nan,nan,nan,nan
19/6/2011,JoÃÂ«l Matip,91018389,11,8/8/1991,19,7,0,0,0,5400,6750,6900,141,128,7183847,193,88,D/DM C,1,1,2,3,2,3,3,4,2,1,1,4,10,8,7,9,5,15,6,13,15,9,7,16,10,10,15,14,7,12,10,7,10,5,7,8,16,17,13,12,9,11,18,12,14,16,20,15,13,10,6,11,5,15,13,5,14,12,9,7,12,9,20,1,11,1,8,10,20,D/DM C,111,1,1,1,1,1,1,20,8,8,16,11,10,1,1,1,1048576.0,0,0,0,0,0,0,0,0,0,0,0,0,0,0,0,0,0,0,0,0,1,0,0,0,0,0,0,0,0,0,0,0,0,0,0,0,0,0,0,0,0,0,0,0,0,0,0,0,Joel Matip,ÃÂ£9.00m ,29.0,195.0,Defender - Centre-Back,right,Liverpool FC,43.0,1.0,1.0,2400.0,47.0,5.0,5.0,4117.0,39.0,3.0,1.0,3457.0,42.0,4.0,2.0,3688.0,25.0,3.0,0.0,1904.0,41.0,4.0,5.0,3690.0,32.0,1.0,0.0,2725.0,35.0,1.0,0.0,2819.0,31.0,1.0,1.0,2342.0,Bundesliga,13.0,2.0,0.0,1075.0,2.0,0.0,0.0,91.0,29/6/2010,JoÃÂ«l Matip,91018389.0,11.0,8/8/1991,18.0,5.0,0.0,0.0,0.0,3250.0,6750.0,6750.0,153.0,125.0,18995757.0,193.0,88.0,D/DM C,2.0,3.0,2.0,1.0,1.0,1.0,3.0,4.0,3.0,1.0,3.0,4.0,9.0,9.0,6.0,12.0,5.0,15.0,6.0,13.0,15.0,9.0,7.0,16.0,13.0,10.0,14.0,15.0,9.0,11.0,12.0,8.0,10.0,7.0,6.0,7.0,16.0,17.0,13.0,12.0,8.0,12.0,18.0,12.0,14.0,15.0,20.0,14.0,13.0,13.0,6.0,11.0,5.0,16.0,6.0,7.0,6.0,13.0,14.0,11.0,9.0,14.0,Joel Matip,ÃÂÃÂ£2.70m ,Bundesliga
19/6/2011,Jeffrey Bruma,37001807,784,11/13/1991,19,2,0,5,0,5200,6050,6250,132,115,1411391,188,83,D C,1,1,1,2,3,1,3,3,1,3,3,5,10,12,8,15,13,8,14,6,12,13,7,13,15,11,12,10,14,7,13,9,13,14,8,12,9,10,7,15,10,13,14,10,13,17,20,13,15,10,10,14,5,12,15,15,12,5,16,14,9,4,20,1,12,1,13,1,20,D C,101,1,1,1,1,1,1,20,1,13,14,12,1,1,1,1,8800390000000.0,0,0,1,1,0,0,0,0,0,0,0,0,0,0,0,0,0,0,0,0,1,0,0,0,0,0,0,0,0,0,0,0,1,0,0,0,0,0,0,0,0,0,0,1,0,0,0,0,Jeffrey Bruma,ÃÂ£3.15m ,28.0,189.0,Defender - Centre-Back,right,VfL Wolfsburg,22.0,2.0,0.0,1563.0,23.0,2.0,1.0,2055.0,22.0,2.0,1.0,1347.0,42.0,4.0,2.0,3712.0,43.0,3.0,1.0,3752.0,44.0,0.0,2.0,3738.0,22.0,1.0,0.0,1898.0,13.0,0.0,0.0,1200.0,12.0,0.0,0.0,893.0,Bundesliga,23.0,0.0,0.0,1955.0,nan,nan,nan,nan,nan,nan,nan,nan,nan,nan,nan,nan,nan,nan,nan,nan,nan,nan,nan,nan,nan,nan,nan,nan,nan,nan,nan,nan,nan,nan,nan,nan,nan,nan,nan,nan,nan,nan,nan,nan,nan,nan,nan,nan,nan,nan,nan,nan,nan,nan,nan,nan,nan,nan,nan,nan,nan,nan,nan,nan,nan,nan,nan,nan,nan,nan,nan,nan,nan,nan,nan,nan,nan,nan,nan,nan,nan,nan,nan,nan,nan,nan,nan,nan,nan,nan,nan,nan,19-06-17,18.3.4.28,Jeffrey Bruma,37001807,784,13-Nov-91,25,25,1,19,0,5850,6850,6850,145,137,15379348,190,88,D C,3,3,3,2,1,3,3,4,2,3,4,5,10,11,8,12,11,12,13,10,15,13,9,16,12,12,14,16,14,10,13,10,12,11,13,9,12,12,8,13,11,17,16,10,14,16,20,13,17,12,9,14,8,9,13,15,10,9,16,13,9,8,20,12,10,1,14,1,20,D C,101,1,1,1,1,1,1,20,1,14,10,10,1,1,1,12,1.15306e+18,0,0,0,0,0,0,0,0,0,0,0,0,0,0,0,0,0,0,0,0,0,0,0,0,0,0,0,0,0,0,0,0,1,0,0,0,0,0,0,0,0,0,0,0,0,0,0,1,Jeffrey Bruma,ÃÂ£5.40m ,28.0,189.0,Defender - Centre-Back,right,VfL Wolfsburg,22.0,1.0,0.0,1898.0,13.0,0.0,0.0,1200.0,12.0,0.0,0.0,893.0,23.0,0.0,0.0,1955.0,nan,nan,nan,nan,Bundesliga,15-07-16,17.3.2.23,Jeffrey Bruma,37001807.0,784.0,13-Nov-91,24.0,19.0,1.0,19.0,0.0,5900.0,6900.0,6900.0,147.0,138.0,18691393.0,190.0,88.0,D C,2.0,3.0,2.0,3.0,1.0,3.0,3.0,3.0,3.0,3.0,2.0,5.0,10.0,11.0,8.0,13.0,11.0,12.0,13.0,10.0,15.0,13.0,9.0,16.0,12.0,12.0,14.0,16.0,14.0,10.0,13.0,10.0,12.0,11.0,13.0,9.0,12.0,12.0,8.0,13.0,11.0,18.0,16.0,10.0,14.0,16.0,20.0,13.0,17.0,12.0,9.0,14.0,5.0,9.0,13.0,15.0,10.0,9.0,16.0,13.0,9.0,8.0,Jeffrey Bruma,ÃÂ£9.00m ,Bundesliga
19/6/2011,Grant Hanley,28027432,793,11/20/1991,19,2,0,1,0,2400,6000,6250,140,114,1223515,188,77,D C,3,3,1,3,1,2,2,3,3,2,1,4,5,8,5,12,5,14,5,8,13,11,5,15,9,15,11,14,8,10,8,8,12,3,8,12,12,12,12,14,10,11,14,10,15,13,20,12,15,8,12,5,4,10,12,10,15,14,14,14,14,5,20,1,1,1,12,1,20,D C,101,1,1,1,1,1,1,20,1,12,1,1,1,1,1,1,137439000000.0,0,0,0,0,0,0,0,0,0,0,0,0,0,0,0,0,0,0,0,0,0,0,0,0,0,0,0,0,0,0,0,0,0,0,0,0,0,1,0,0,0,0,0,0,0,0,0,0,Grant Hanley,ÃÂ£1.80m ,28.0,188.0,Defender - Centre-Back,right,Norwich City,15.0,1.0,0.0,1143.0,32.0,1.0,1.0,2529.0,45.0,3.0,2.0,3900.0,40.0,1.0,2.0,3461.0,32.0,1.0,0.0,2790.0,46.0,2.0,1.0,4089.0,16.0,1.0,0.0,1066.0,36.0,1.0,1.0,2858.0,12.0,1.0,0.0,766.0,Premier League,18.0,1.0,0.0,1494.0,3.0,0.0,0.0,270.0,nan,nan,nan,nan,nan,nan,nan,nan,nan,nan,nan,nan,nan,nan,nan,nan,nan,nan,nan,nan,nan,nan,nan,nan,nan,nan,nan,nan,nan,nan,nan,nan,nan,nan,nan,nan,nan,nan,nan,nan,nan,nan,nan,nan,nan,nan,nan,nan,nan,nan,nan,nan,nan,nan,nan,nan,nan,nan,nan,nan,nan,nan,nan,nan,nan,nan,nan,nan,nan,nan,nan,nan,nan,nan,nan,nan,nan,nan,nan,nan,nan,nan,nan,nan
19/6/2011,Frederik SÃÂ¸rensen,27020708,764,4/14/1992,19,0,0,0,0,3271,5198,5535,141,114,374057,193,71,D RC,3,2,2,1,3,1,2,5,1,1,3,5,7,4,4,6,5,13,5,14,12,9,5,15,6,8,12,14,12,12,6,8,13,5,10,6,15,13,14,12,8,13,16,10,14,13,20,14,13,12,5,13,8,14,17,12,12,17,14,15,14,5,20,1,1,1,16,1,20,D RC,103,1,1,1,1,1,1,20,1,16,1,1,1,1,1,1,4503740000000000.0,0,0,0,0,0,0,1,0,0,0,0,0,0,0,0,1,0,0,0,0,0,0,0,0,0,0,0,0,0,0,0,0,1,0,0,0,0,1,0,0,0,0,0,0,0,0,0,0,Frederik SÃÂ¶rensen,ÃÂ£2.25m ,28.0,194.0,Defender - Centre-Back,right,1. FC KÃÂ¶ln,26.0,0.0,1.0,1947.0,6.0,1.0,0.0,490.0,27.0,1.0,1.0,2034.0,16.0,0.0,0.0,1217.0,11.0,0.0,1.0,729.0,24.0,0.0,2.0,1854.0,33.0,0.0,3.0,2890.0,35.0,3.0,2.0,2632.0,6.0,0.0,0.0,136.0,Serie A,25.0,1.0,1.0,1976.0,3.0,0.0,0.0,97.0,29/6/2010,Frederik SÃÂ¸rensen,27020708.0,764.0,4/14/1992,18.0,0.0,0.0,0.0,0.0,1482.0,3750.0,3750.0,123.0,77.0,425984.0,192.0,71.0,D C,1.0,3.0,3.0,2.0,3.0,1.0,3.0,3.0,3.0,2.0,2.0,5.0,5.0,4.0,4.0,6.0,5.0,10.0,5.0,7.0,7.0,8.0,5.0,10.0,6.0,13.0,6.0,11.0,10.0,9.0,6.0,9.0,8.0,5.0,9.0,6.0,11.0,13.0,13.0,11.0,5.0,11.0,15.0,10.0,13.0,14.0,20.0,13.0,11.0,5.0,17.0,7.0,8.0,9.0,8.0,5.0,12.0,8.0,10.0,15.0,6.0,19.0,Frederik SÃÂÃÂ¶rensen,ÃÂÃÂ£2.70m ,Serie A,19-06-17,18.3.4.28,Frederik SÃÂrensen,27020708,764,14-Apr-92,25,1,0,17,0,5500,6250,6500,138,130,7489782,194,88,D RC,1,3,2,2,3,2,1,2,3,1,2,5,8,6,6,8,6,12,9,17,13,10,5,13,8,10,16,13,15,15,9,12,12,6,10,7,15,17,10,11,7,14,18,9,13,15,20,13,16,14,7,14,10,13,16,15,10,17,14,14,18,5,20,12,1,1,18,7,20,D RC,103,1,10,1,1,1,1,20,7,18,1,1,1,1,1,12,279173000000.0,0,0,0,0,0,0,0,0,0,0,0,0,0,0,0,0,0,0,0,0,0,0,0,0,0,0,0,0,0,0,0,0,1,0,0,0,0,0,1,0,0,0,0,0,0,0,0,0,Frederik SÃÂ¶rensen,ÃÂ£4.05m ,28.0,194.0,Defender - Centre-Back,right,1. FC KÃÂ¶ln,33.0,0.0,3.0,2890.0,35.0,3.0,2.0,2632.0,6.0,0.0,0.0,136.0,25.0,1.0,1.0,1976.0,3.0,0.0,0.0,97.0,Bundesliga,15-07-16,17.3.2.23,Frederik SÃÂrensen,27020708.0,764.0,14-Apr-92,24.0,0.0,0.0,17.0,0.0,5735.0,5937.0,6700.0,138.0,134.0,12147420.0,194.0,88.0,D RC,3.0,3.0,3.0,2.0,1.0,3.0,2.0,1.0,1.0,2.0,2.0,5.0,8.0,6.0,6.0,8.0,6.0,12.0,9.0,17.0,14.0,10.0,5.0,14.0,8.0,9.0,16.0,13.0,15.0,16.0,11.0,13.0,12.0,6.0,10.0,6.0,15.0,17.0,10.0,11.0,7.0,14.0,18.0,9.0,13.0,15.0,20.0,13.0,16.0,15.0,7.0,14.0,10.0,13.0,16.0,15.0,10.0,17.0,14.0,14.0,18.0,5.0,Frederik SÃÂ¶rensen,ÃÂ£6.75m ,Bundesliga
19/6/2011,Darnel Situ,85014008,769,3/18/1992,19,0,0,0,0,2250,4500,4500,139,100,272933,187,77,D C,1,3,1,1,1,2,3,1,2,1,2,4,6,8,7,10,5,14,7,5,13,8,8,10,10,13,13,15,11,12,8,11,12,9,10,7,12,14,13,7,9,15,14,5,9,13,20,12,14,12,13,10,8,10,12,16,14,11,15,15,17,9,20,1,1,1,1,1,20,D C,101,1,1,7,1,1,1,20,1,1,12,1,1,1,1,1,274878000000.0,0,0,0,0,0,0,0,0,0,0,0,0,0,0,0,0,0,0,0,0,0,0,0,0,0,0,0,0,0,0,0,0,0,0,0,0,0,0,1,0,0,0,0,0,0,0,0,0,Darnel Situ,ÃÂ£225Th. ,28.0,187.0,Defender - Centre-Back,right,Istres Football Club,1.0,0.0,0.0,11.0,9.0,1.0,0.0,750.0,0.0,0.0,0.0,0.0,nan,nan,nan,nan,7.0,0.0,0.0,436.0,3.0,0.0,0.0,254.0,1.0,0.0,0.0,23.0,nan,nan,nan,nan,nan,nan,nan,nan,Premier League,nan,nan,nan,nan,nan,nan,nan,nan,nan,nan,nan,nan,nan,nan,nan,nan,nan,nan,nan,nan,nan,nan,nan,nan,nan,nan,nan,nan,nan,nan,nan,nan,nan,nan,nan,nan,nan,nan,nan,nan,nan,nan,nan,nan,nan,nan,nan,nan,nan,nan,nan,nan,nan,nan,nan,nan,nan,nan,nan,nan,nan,nan,nan,nan,nan,nan,nan,nan,nan,nan,nan,nan,nan,nan,nan,nan,nan,nan,nan,nan,nan,nan,nan,nan,nan,nan,nan,nan,nan,nan,nan,nan
19/6/2011,Christopher Avevor,92025554,771,2/11/1992,19,0,0,0,0,2000,5100,5250,128,102,255766,184,81,D RC,2,1,2,3,1,3,2,1,1,3,1,5,7,7,6,11,5,12,6,12,13,10,8,13,11,12,11,14,10,11,7,12,10,6,6,7,11,14,11,10,12,14,12,8,14,12,20,12,14,11,9,10,8,12,6,13,12,14,12,15,11,9,20,14,1,1,15,1,20,D RC,103,1,1,1,1,1,1,20,1,15,10,1,1,1,1,14,0.0,0,0,0,0,0,0,0,0,0,0,0,0,0,0,0,0,0,0,0,0,0,0,0,0,0,0,0,0,0,0,0,0,0,0,0,0,0,0,0,0,0,0,0,0,0,0,0,0,Christopher Avevor,ÃÂ£270Th. ,28.0,184.0,Defender - Centre-Back,right,FC St. Pauli,17.0,1.0,0.0,1307.0,24.0,0.0,0.0,1998.0,30.0,1.0,1.0,2590.0,13.0,0.0,0.0,1165.0,15.0,0.0,0.0,1203.0,9.0,0.0,0.0,651.0,14.0,0.0,0.0,988.0,33.0,1.0,0.0,2858.0,26.0,1.0,0.0,2370.0,Bundesliga,4.0,0.0,0.0,143.0,5.0,0.0,0.0,414.0,nan,nan,nan,nan,nan,nan,nan,nan,nan,nan,nan,nan,nan,nan,nan,nan,nan,nan,nan,nan,nan,nan,nan,nan,nan,nan,nan,nan,nan,nan,nan,nan,nan,nan,nan,nan,nan,nan,nan,nan,nan,nan,nan,nan,nan,nan,nan,nan,nan,nan,nan,nan,nan,nan,nan,nan,nan,nan,nan,nan,nan,nan,nan,nan,nan,nan,nan,nan,nan,nan,nan,nan,nan,nan,nan,nan,nan,nan,nan,nan,nan,nan,nan,nan
19/6/2011,Alexander Callens,77012995,1656,5/4/1992,19,0,0,9,1,1387,5400,5400,154,108,796983,184,76,D RC,1,3,3,3,1,3,3,1,2,1,1,6,7,8,8,9,8,13,8,13,13,13,13,13,12,14,9,13,9,8,8,9,9,9,10,13,14,15,15,13,13,14,14,5,13,14,20,13,13,13,12,12,7,13,12,13,11,9,9,8,13,6,20,1,1,1,17,1,20,D RC,103,1,13,1,1,1,1,20,1,17,1,1,1,1,1,1,0.0,0,0,0,0,0,0,0,0,0,0,0,0,0,0,0,0,0,0,0,0,0,0,0,0,0,0,0,0,0,0,0,0,0,0,0,0,0,0,0,0,0,0,0,0,0,0,0,0,nan,nan,nan,nan,nan,nan,nan,nan,nan,nan,nan,nan,nan,nan,nan,nan,nan,nan,nan,nan,nan,nan,nan,nan,nan,nan,nan,nan,nan,nan,nan,nan,nan,nan,nan,nan,nan,nan,nan,nan,nan,nan,nan,nan,nan,nan,nan,nan,nan,nan,nan,nan,nan,nan,nan,nan,nan,nan,nan,nan,nan,nan,nan,nan,nan,nan,nan,nan,nan,nan,nan,nan,nan,nan,nan,nan,nan,nan,nan,nan,nan,nan,nan,nan,nan,nan,nan,nan,nan,nan,nan,nan,nan,nan,nan,nan,nan,nan,nan,nan,nan,nan,nan,nan,nan,nan,nan,nan,nan,nan,nan,nan,nan,nan,nan,nan,nan,nan,nan,nan,nan,nan,nan,nan,nan,nan,nan,nan,nan,nan,nan,nan,nan,nan,nan,nan
19/6/2011,Willy Boly,85009974,769,2/3/1991,20,0,0,0,0,2651,5302,5302,150,117,382686,191,81,D C,3,2,2,3,1,2,1,7,2,2,2,5,5,7,6,9,5,15,11,5,12,8,6,11,9,16,14,15,12,11,7,11,12,7,8,7,13,13,11,14,11,16,16,5,14,13,20,14,16,12,13,13,5,6,11,14,14,14,14,14,14,7,20,1,1,1,1,1,20,D C,101,1,1,1,1,1,1,20,1,1,12,1,1,1,1,1,274878000000.0,0,0,0,0,0,0,0,0,0,0,0,0,0,0,0,0,0,0,0,0,0,0,0,0,0,0,0,0,0,0,0,0,0,0,0,0,0,0,1,0,0,0,0,0,0,0,0,0,Willy Boly,ÃÂ£2.25m ,29.0,195.0,Defender - Centre-Back,right,Wolverhampton Wanderers,8.0,1.0,0.0,720.0,37.0,1.0,0.0,3136.0,27.0,1.0,1.0,2302.0,37.0,0.0,0.0,3296.0,20.0,1.0,0.0,1779.0,40.0,2.0,1.0,3311.0,12.0,0.0,0.0,1032.0,37.0,3.0,2.0,3290.0,41.0,4.0,0.0,3649.0,Ligue 1,35.0,1.0,1.0,3150.0,7.0,0.0,0.0,630.0,nan,nan,nan,nan,nan,nan,nan,nan,nan,nan,nan,nan,nan,nan,nan,nan,nan,nan,nan,nan,nan,nan,nan,nan,nan,nan,nan,nan,nan,nan,nan,nan,nan,nan,nan,nan,nan,nan,nan,nan,nan,nan,nan,nan,nan,nan,nan,nan,nan,nan,nan,nan,nan,nan,nan,nan,nan,nan,nan,nan,nan,nan,nan,nan,nan,nan,nan,nan,nan,nan,nan,nan,nan,nan,nan,nan,nan,nan,nan,nan,nan,nan,nan,nan
19/6/2011,Vujadin Savic,62028022,802,7/1/1990,20,0,0,13,1,4350,6000,5422,145,120,496373,194,82,D C,2,1,2,1,3,1,3,2,1,3,3,5,9,8,6,11,7,14,9,8,13,10,10,12,11,13,14,12,13,11,11,12,18,7,8,8,13,14,14,9,8,16,17,8,14,13,20,13,14,12,13,13,8,8,7,15,13,14,13,13,11,5,20,1,1,1,1,1,20,D C,101,1,1,1,1,1,1,20,1,1,1,1,1,1,1,1,8.0,0,0,0,1,0,0,0,0,0,0,0,0,0,0,0,0,0,0,0,0,0,0,0,0,0,0,0,0,0,0,0,0,0,0,0,0,0,0,0,0,0,0,0,0,0,0,0,0,Vujadin Savic,ÃÂ£900Th. ,30.0,194.0,Defender - Centre-Back,right,APOEL Nicosia,8.0,1.0,0.0,643.0,13.0,0.0,0.0,1020.0,23.0,0.0,0.0,1993.0,11.0,0.0,0.0,534.0,0.0,0.0,0.0,0.0,18.0,1.0,0.0,1533.0,18.0,3.0,0.0,1417.0,34.0,0.0,0.0,2905.0,31.0,1.0,0.0,2640.0,Ligue 1,25.0,2.0,0.0,2108.0,nan,nan,nan,nan,29/6/2010,Vujadin Savic,62028022.0,802.0,7/1/1990,19.0,0.0,0.0,8.0,0.0,3364.0,5800.0,5400.0,150.0,116.0,10029464.0,194.0,82.0,D C,3.0,1.0,3.0,2.0,1.0,1.0,3.0,1.0,2.0,3.0,2.0,9.0,11.0,9.0,5.0,11.0,9.0,13.0,9.0,12.0,12.0,9.0,12.0,12.0,11.0,14.0,13.0,12.0,13.0,13.0,12.0,14.0,12.0,8.0,12.0,9.0,13.0,14.0,14.0,9.0,8.0,13.0,17.0,8.0,13.0,10.0,20.0,12.0,13.0,12.0,9.0,10.0,8.0,8.0,9.0,15.0,13.0,14.0,12.0,13.0,11.0,5.0,Vujadin Savic,ÃÂÃÂ£900Th. ,Ligue 1
19/6/2011,Thanos Petsos,91014707,772,6/5/1991,20,0,0,2,0,500,6100,6300,152,126,783088,184,80,D/DM RLC,1,3,1,2,1,2,3,3,2,1,3,7,12,12,9,12,7,12,11,11,13,13,7,13,12,10,11,13,10,11,10,10,13,12,7,8,14,13,13,13,13,13,11,10,12,13,20,14,13,11,9,10,6,13,12,12,12,11,11,12,10,10,20,8,13,1,20,17,17,D/DM RLC,116,1,1,1,1,1,1,17,17,20,20,13,1,1,1,8,0.0,0,0,0,0,0,0,0,0,0,0,0,0,0,0,0,0,0,0,0,0,0,0,0,0,0,0,0,0,0,0,0,0,0,0,0,0,0,0,0,0,0,0,0,0,0,0,0,0,Thanos Petsos,ÃÂ£1.13m ,29.0,184.0,Midfielder - Defensive Midfield,right,WSG Tirol,28.0,1.0,1.0,2085.0,21.0,1.0,0.0,948.0,16.0,1.0,0.0,936.0,37.0,4.0,2.0,3100.0,31.0,1.0,1.0,2599.0,33.0,2.0,3.0,2733.0,4.0,0.0,0.0,150.0,21.0,0.0,1.0,1450.0,nan,nan,nan,nan,Bundesliga,15.0,1.0,2.0,1336.0,7.0,0.0,2.0,591.0,29/6/2010,Thanos Petsos,91014707.0,772.0,6/5/1991,19.0,0.0,0.0,1.0,0.0,500.0,4000.0,4000.0,125.0,85.0,376639.0,184.0,80.0,D RLC,3.0,1.0,1.0,3.0,3.0,3.0,3.0,1.0,2.0,2.0,3.0,10.0,8.0,8.0,10.0,7.0,5.0,14.0,4.0,4.0,11.0,8.0,5.0,14.0,12.0,9.0,12.0,14.0,9.0,13.0,4.0,6.0,10.0,4.0,11.0,5.0,9.0,11.0,13.0,9.0,8.0,7.0,12.0,20.0,10.0,13.0,9.0,9.0,8.0,4.0,9.0,10.0,11.0,10.0,8.0,13.0,10.0,16.0,7.0,9.0,7.0,9.0,Thanos Petsos,ÃÂÃÂ£1.35m ,Bundesliga
19/6/2011,Stefan Savic,62012567,62002127,1/8/1991,20,6,0,4,0,4350,6875,6400,160,125,4862918,186,74,D RC,2,1,2,3,1,3,3,7,1,2,3,7,10,8,11,10,6,16,9,10,15,10,10,13,11,13,15,12,14,15,11,10,15,8,12,8,15,11,10,10,15,14,14,8,13,10,20,13,11,12,7,13,8,6,8,14,14,16,12,12,10,7,20,1,1,1,15,10,20,D RC,103,1,1,1,1,1,1,20,10,15,1,1,1,1,1,1,32.0,0,0,0,0,0,1,0,0,0,0,0,0,0,0,0,0,0,0,0,0,0,0,0,0,0,0,0,0,0,0,0,0,0,0,0,0,0,0,0,0,0,0,0,0,0,0,0,0,Stefan Savic,ÃÂ£7.20m ,29.0,187.0,Defender - Centre-Back,right,AtlÃÂ©tico Madrid,31.0,1.0,0.0,2567.0,20.0,1.0,0.0,1263.0,28.0,2.0,0.0,2383.0,40.0,0.0,1.0,3571.0,41.0,2.0,2.0,3461.0,24.0,0.0,0.0,1855.0,49.0,1.0,1.0,4186.0,37.0,0.0,0.0,3032.0,22.0,0.0,2.0,1781.0,Premier League,28.0,1.0,0.0,2482.0,5.0,0.0,0.0,450.0,nan,nan,nan,nan,nan,nan,nan,nan,nan,nan,nan,nan,nan,nan,nan,nan,nan,nan,nan,nan,nan,nan,nan,nan,nan,nan,nan,nan,nan,nan,nan,nan,nan,nan,nan,nan,nan,nan,nan,nan,nan,nan,nan,nan,nan,nan,nan,nan,nan,nan,nan,nan,nan,nan,nan,nan,nan,nan,nan,nan,nan,nan,nan,nan,nan,nan,nan,nan,nan,nan,nan,nan,nan,nan,nan,nan,nan,nan,nan,nan,nan,nan,nan,nan,19-06-17,18.3.4.28,Stefan Savic,62012567,62002127,08-Jan-91,26,43,3,7,0,6800,7650,7650,158,153,47875242,187,80,D C,3,3,1,3,2,2,2,4,2,3,1,7,9,9,9,11,6,14,8,10,16,12,9,14,11,13,17,14,15,15,12,14,15,8,12,8,15,15,15,13,14,11,13,12,13,14,20,15,15,14,9,13,8,13,14,14,14,15,14,12,11,7,20,1,1,1,13,7,20,D C,101,1,1,1,1,1,1,20,7,13,1,1,1,1,1,1,0.0,0,0,0,0,0,0,0,0,0,0,0,0,0,0,0,0,0,0,0,0,0,0,0,0,0,0,0,0,0,0,0,0,0,0,0,0,0,0,0,0,0,0,0,0,0,0,0,0,Stefan Savic,ÃÂ£36.00m ,29.0,187.0,Defender - Centre-Back,right,AtlÃÂ©tico Madrid,49.0,1.0,1.0,4186.0,37.0,0.0,0.0,3032.0,22.0,0.0,2.0,1781.0,28.0,1.0,0.0,2482.0,5.0,0.0,0.0,450.0,LaLiga,15-07-16,17.3.2.23,Stefan Savic,62012567.0,62002127.0,08-Jan-91,25.0,36.0,3.0,7.0,0.0,6800.0,7600.0,7600.0,158.0,153.0,30081642.0,186.0,73.0,D C,1.0,3.0,3.0,1.0,3.0,3.0,1.0,3.0,2.0,3.0,1.0,7.0,9.0,9.0,9.0,11.0,6.0,14.0,8.0,10.0,16.0,12.0,9.0,14.0,11.0,13.0,17.0,14.0,15.0,15.0,12.0,14.0,15.0,8.0,12.0,8.0,15.0,15.0,15.0,13.0,14.0,11.0,13.0,12.0,13.0,14.0,20.0,15.0,15.0,14.0,9.0,13.0,8.0,13.0,14.0,14.0,14.0,15.0,14.0,12.0,11.0,7.0,Stefan Savic,ÃÂ£27.00m ,LaLiga
19/6/2011,SebastiÃÂ¡n Coates,78016342,1657,10/7/1990,20,5,0,11,0,5382,7422,7422,158,140,4482721,196,85,D C,3,1,3,3,3,2,2,1,3,3,3,10,11,12,11,13,7,16,5,7,12,12,9,13,13,14,13,14,14,13,13,12,15,13,15,12,12,12,13,11,12,14,18,9,14,14,20,15,15,14,10,14,5,10,8,14,16,14,12,13,12,6,20,1,1,1,1,1,20,D C,101,1,1,1,1,1,1,20,1,1,1,1,1,1,1,1,141734000000.0,0,0,0,0,0,0,0,0,0,0,0,0,0,0,0,0,0,0,0,0,0,0,0,0,0,0,0,0,0,0,0,0,1,0,0,0,0,1,0,0,0,0,0,0,0,0,0,0,SebastiÃÂ¡n Coates,ÃÂ£4.50m ,30.0,196.0,Defender - Centre-Back,right,Sporting CP,33.0,1.0,4.0,2931.0,15.0,2.0,0.0,1115.0,12.0,1.0,1.0,863.0,7.0,0.0,0.0,578.0,14.0,0.0,0.0,1137.0,33.0,0.0,2.0,2670.0,43.0,3.0,1.0,3870.0,54.0,5.0,5.0,4890.0,49.0,2.0,3.0,4440.0,Premier League,40.0,6.0,1.0,3559.0,6.0,1.0,0.0,513.0,nan,nan,nan,nan,nan,nan,nan,nan,nan,nan,nan,nan,nan,nan,nan,nan,nan,nan,nan,nan,nan,nan,nan,nan,nan,nan,nan,nan,nan,nan,nan,nan,nan,nan,nan,nan,nan,nan,nan,nan,nan,nan,nan,nan,nan,nan,nan,nan,nan,nan,nan,nan,nan,nan,nan,nan,nan,nan,nan,nan,nan,nan,nan,nan,nan,nan,nan,nan,nan,nan,nan,nan,nan,nan,nan,nan,nan,nan,nan,nan,nan,nan,nan,nan,19-06-17,18.3.4.28,SebastiÃÂ¡n Coates,78016342,1657,07-Oct-90,26,29,1,11,0,4600,7200,7200,149,144,28748725,196,92,D C,2,3,2,1,2,1,2,1,1,2,1,6,10,12,11,12,7,16,6,5,15,12,10,15,12,13,14,15,14,16,10,13,9,13,13,12,13,14,14,11,11,16,16,9,15,12,20,14,16,15,10,14,7,5,13,12,13,11,12,13,12,6,20,1,1,1,1,1,20,D C,101,1,1,1,1,1,1,20,1,1,1,1,1,1,1,1,141734000000.0,0,0,0,0,0,0,0,0,0,0,0,0,0,0,0,0,0,0,0,0,0,0,0,0,0,0,0,0,0,0,0,0,1,0,0,0,0,1,0,0,0,0,0,0,0,0,0,0,SebastiÃÂ¡n Coates,ÃÂ£9.00m ,30.0,196.0,Defender - Centre-Back,right,Sporting CP,43.0,3.0,1.0,3870.0,54.0,5.0,5.0,4890.0,49.0,2.0,3.0,4440.0,40.0,6.0,1.0,3559.0,6.0,1.0,0.0,513.0,Liga NOS,15-07-16,17.3.2.23,SebastiÃÂ¡n Coates,78016342.0,1657.0,07-Oct-90,25.0,22.0,1.0,11.0,0.0,4600.0,7200.0,7200.0,149.0,144.0,26234773.0,196.0,92.0,D C,3.0,2.0,3.0,1.0,2.0,3.0,3.0,3.0,2.0,1.0,1.0,6.0,10.0,12.0,11.0,12.0,7.0,16.0,6.0,5.0,15.0,12.0,10.0,15.0,12.0,13.0,14.0,15.0,14.0,16.0,10.0,13.0,9.0,13.0,13.0,12.0,13.0,14.0,14.0,11.0,12.0,16.0,16.0,8.0,15.0,13.0,20.0,14.0,16.0,15.0,10.0,14.0,7.0,5.0,10.0,12.0,13.0,11.0,12.0,13.0,12.0,6.0,SebastiÃÂ¡n Coates,ÃÂ£6.30m ,Liga NOS
19/6/2011,Salif SanÃÂ©,85049933,41,8/25/1990,20,0,0,0,0,4100,5174,5150,140,115,170420,195,84,D RC,1,3,3,1,3,2,1,3,1,3,3,5,11,9,6,11,6,15,12,15,12,9,7,11,11,15,13,13,10,12,8,11,13,8,7,6,12,13,14,9,7,16,17,20,14,11,10,14,17,14,15,13,6,12,14,15,14,14,12,13,13,8,20,1,10,5,15,10,20,D RC,103,1,1,1,5,1,1,20,10,15,15,10,1,1,1,1,8796090000000.0,0,0,0,0,0,0,0,0,0,0,0,0,0,0,0,1,0,0,0,0,0,0,0,0,0,0,0,0,0,0,0,0,0,0,0,0,0,0,0,0,0,0,0,1,0,0,0,0,Salif SanÃÂ©,ÃÂ£1.80m ,30.0,196.0,Defender - Centre-Back,right,FC Schalke 04,5.0,0.0,0.0,360.0,33.0,2.0,0.0,2781.0,37.0,2.0,4.0,3360.0,21.0,2.0,0.0,1584.0,30.0,4.0,0.0,2515.0,33.0,3.0,0.0,2932.0,31.0,3.0,2.0,2542.0,34.0,4.0,1.0,3060.0,40.0,4.0,1.0,3543.0,Ligue 1,16.0,2.0,1.0,1215.0,4.0,0.0,0.0,314.0,29/6/2010,Salif SanÃÂ©,85049933.0,769.0,8/25/1990,19.0,0.0,0.0,0.0,0.0,1200.0,2450.0,2450.0,132.0,99.0,3461302.0,194.0,84.0,D C,2.0,1.0,2.0,2.0,1.0,3.0,1.0,4.0,3.0,2.0,2.0,5.0,5.0,9.0,6.0,11.0,5.0,14.0,11.0,5.0,13.0,8.0,6.0,8.0,11.0,15.0,10.0,13.0,10.0,10.0,8.0,11.0,13.0,7.0,2.0,6.0,11.0,12.0,14.0,9.0,6.0,15.0,17.0,5.0,14.0,10.0,20.0,14.0,15.0,14.0,10.0,8.0,3.0,10.0,12.0,15.0,14.0,13.0,12.0,13.0,13.0,8.0,Salif SanÃÂÃÂ©,ÃÂÃÂ£315Th. ,Ligue 1,19-06-17,18.3.4.28,Salif SanÃÂ©,85049933,41,25-Aug-90,26,14,0,0,0,5700,6700,6700,137,134,13311450,195,84,D/DM/M C,1,3,2,1,3,2,3,1,1,4,3,5,9,10,7,12,6,12,8,14,14,13,7,17,13,12,10,14,16,9,12,10,8,13,7,9,11,8,9,12,12,16,18,12,13,15,20,14,17,12,14,12,6,10,9,14,10,14,7,10,12,18,20,8,18,5,12,10,20,D/DM/M C,121,1,1,1,5,1,1,20,10,12,18,18,1,1,6,8,0.0,0,0,0,0,0,0,0,0,0,0,0,0,0,0,0,0,0,0,0,0,0,0,0,0,0,0,0,0,0,0,0,0,0,0,0,0,0,0,0,0,0,0,0,0,0,0,0,0,Salif SanÃÂ©,ÃÂ£16.20m ,30.0,196.0,Defender - Centre-Back,right,FC Schalke 04,31.0,3.0,2.0,2542.0,34.0,4.0,1.0,3060.0,40.0,4.0,1.0,3543.0,16.0,2.0,1.0,1215.0,4.0,0.0,0.0,314.0,Bundesliga,nan,nan,nan,nan,nan,nan,nan,nan,nan,nan,nan,nan,nan,nan,nan,nan,nan,nan,nan,nan,nan,nan,nan,nan,nan,nan,nan,nan,nan,nan,nan,nan,nan,nan,nan,nan,nan,nan,nan,nan,nan,nan,nan,nan,nan,nan,nan,nan,nan,nan,nan,nan,nan,nan,nan,nan,nan,nan,nan,nan,nan,nan,nan,nan,nan,nan,nan,nan,nan,nan,nan,nan,nan,nan,nan,nan,nan,nan,nan,nan,nan,nan,nan,nan,nan
19/6/2011,Rolf Feltscher,69003383,798,10/6/1990,20,1,0,11,0,3036,5784,5281,135,110,644918,183,78,D/WB RC,2,3,1,3,2,3,1,6,3,1,1,6,9,8,7,9,9,12,10,9,12,10,8,13,8,13,11,7,9,12,8,12,10,3,9,8,13,14,14,13,12,11,14,11,15,13,20,13,15,12,12,9,6,6,5,1,11,12,19,13,9,12,20,19,1,1,20,6,15,D/WB RC,113,1,1,1,1,1,1,15,6,20,1,1,1,1,1,19,0.0,0,0,0,0,0,0,0,0,0,0,0,0,0,0,0,0,0,0,0,0,0,0,0,0,0,0,0,0,0,0,0,0,0,0,0,0,0,0,0,0,0,0,0,0,0,0,0,0,Rolf Feltscher,ÃÂ£270Th. ,30.0,184.0,Defender - Right-Back,right,Los Angeles Galaxy,7.0,0.0,0.0,583.0,5.0,0.0,0.0,327.0,21.0,0.0,2.0,1693.0,10.0,0.0,1.0,598.0,28.0,0.0,5.0,2290.0,29.0,2.0,4.0,2468.0,16.0,0.0,1.0,1202.0,15.0,1.0,3.0,1295.0,26.0,2.0,3.0,2201.0,Serie A,12.0,0.0,2.0,977.0,nan,nan,nan,nan,29/6/2010,Rolf Feltscher,69003383.0,798.0,10/6/1990,19.0,0.0,0.0,10.0,0.0,3000.0,5750.0,5750.0,129.0,114.0,7673430.0,183.0,78.0,D/WB R,2.0,2.0,1.0,3.0,3.0,2.0,2.0,3.0,3.0,3.0,2.0,9.0,11.0,10.0,7.0,14.0,5.0,10.0,8.0,10.0,14.0,11.0,5.0,14.0,13.0,6.0,12.0,10.0,12.0,14.0,12.0,11.0,9.0,4.0,10.0,10.0,12.0,17.0,14.0,11.0,10.0,13.0,16.0,11.0,15.0,13.0,20.0,9.0,9.0,10.0,6.0,6.0,9.0,10.0,14.0,17.0,11.0,9.0,9.0,7.0,5.0,13.0,Rolf Feltscher,ÃÂÃÂ£450Th. ,Serie A
19/6/2011,RÃÂ©dah Atassi,85057616,34,3/16/1991,20,0,0,0,0,1250,5000,2500,119,100,100447,187,78,D LC,2,1,2,2,3,3,1,6,2,3,3,5,8,9,7,9,6,14,9,7,13,9,5,10,12,14,12,15,9,11,7,10,14,5,9,7,10,14,13,11,9,14,14,20,13,14,5,12,13,13,14,10,9,8,11,14,17,13,13,11,11,8,20,15,1,1,1,15,20,D LC,104,1,1,1,1,1,1,20,15,1,1,1,1,1,15,1,32776.0,0,0,0,1,0,0,0,0,0,0,0,0,0,0,0,1,0,0,0,0,0,0,0,0,0,0,0,0,0,0,0,0,0,0,0,0,0,0,0,0,0,0,0,0,0,0,0,0,nan,nan,nan,nan,nan,nan,nan,nan,nan,nan,nan,nan,nan,nan,nan,nan,nan,nan,nan,nan,nan,nan,nan,nan,nan,nan,nan,nan,nan,nan,nan,nan,nan,nan,nan,nan,nan,nan,nan,nan,nan,nan,nan,nan,nan,nan,nan,nan,nan,nan,nan,nan,29/6/2010,RÃÂ©dah Atassi,85057616.0,769.0,3/16/1991,19.0,0.0,0.0,0.0,0.0,50.0,2250.0,2250.0,110.0,99.0,3092122.0,187.0,78.0,D LC,2.0,1.0,2.0,2.0,3.0,3.0,1.0,1.0,1.0,3.0,2.0,5.0,7.0,6.0,7.0,9.0,6.0,14.0,6.0,7.0,13.0,8.0,5.0,10.0,9.0,14.0,12.0,15.0,11.0,11.0,7.0,10.0,14.0,5.0,9.0,6.0,11.0,14.0,13.0,12.0,9.0,14.0,13.0,20.0,9.0,11.0,5.0,14.0,14.0,14.0,14.0,10.0,7.0,10.0,6.0,14.0,16.0,6.0,13.0,11.0,11.0,8.0,RÃÂÃÂ©dah Atassi, ,Ligue 1
19/6/2011,Mouhammadou N'Diaye,12029964,41,7/21/1990,20,0,0,0,0,2000,5000,5150,137,106,90073,186,75,D C,1,3,1,1,3,3,1,3,2,1,1,5,5,6,5,7,6,17,10,10,10,8,6,14,8,16,14,15,10,7,5,6,12,4,12,8,8,10,12,11,11,16,15,10,16,10,20,14,16,7,16,10,5,5,13,14,12,13,12,10,10,9,20,1,1,1,1,1,20,D C,101,1,1,1,1,1,1,20,1,1,1,1,1,1,1,1,137439000000.0,0,0,0,0,0,0,0,0,0,0,0,0,0,0,0,1,0,0,0,0,0,0,0,0,0,0,0,0,0,0,0,0,0,0,0,0,0,1,0,0,0,0,0,0,0,0,0,0,Mahamadou N'Diaye,ÃÂ£900Th. ,30.0,185.0,Defender - Centre-Back,right,Without Club,12.0,0.0,0.0,1067.0,25.0,3.0,0.0,2191.0,18.0,1.0,1.0,1425.0,26.0,1.0,0.0,2326.0,5.0,0.0,0.0,376.0,1.0,0.0,0.0,12.0,7.0,0.0,0.0,233.0,25.0,4.0,2.0,2089.0,1.0,0.0,0.0,105.0,Liga NOS,7.0,0.0,0.0,273.0,nan,nan,nan,nan,29/6/2010,Mouhammadou N'Diaye,12029964.0,41.0,6/21/1990,20.0,0.0,0.0,0.0,0.0,1000.0,4049.0,4000.0,128.0,90.0,2107876.0,185.0,75.0,D C,1.0,1.0,1.0,3.0,2.0,2.0,3.0,2.0,3.0,3.0,1.0,7.0,5.0,2.0,5.0,12.0,8.0,13.0,5.0,6.0,12.0,7.0,9.0,11.0,7.0,15.0,13.0,15.0,10.0,10.0,1.0,10.0,10.0,3.0,12.0,6.0,8.0,7.0,10.0,10.0,10.0,13.0,13.0,9.0,14.0,10.0,20.0,10.0,12.0,8.0,6.0,10.0,9.0,10.0,8.0,15.0,11.0,12.0,16.0,8.0,12.0,5.0,Mahamadou N'Diaye,ÃÂÃÂ£450Th. ,Liga NOS
19/6/2011,Milan Milanovic,62015184,802,3/31/1991,20,0,0,10,2,2500,5500,4522,143,100,53255,194,83,D C,2,1,3,2,1,3,3,3,2,2,1,4,7,6,5,9,5,14,3,3,12,6,10,12,10,15,11,8,8,14,9,9,12,9,5,8,11,12,13,11,9,10,17,10,12,10,20,10,13,12,8,11,9,8,14,15,13,14,13,13,11,5,20,1,1,1,1,1,20,D C,101,1,1,1,1,1,1,20,1,1,1,1,1,1,1,1,0.0,0,0,0,0,0,0,0,0,0,0,0,0,0,0,0,0,0,0,0,0,0,0,0,0,0,0,0,0,0,0,0,0,0,0,0,0,0,0,0,0,0,0,0,0,0,0,0,0,Milan Milanovic,ÃÂ£540Th. ,29.0,194.0,Defender - Centre-Back,both,Unknown,0.0,0.0,0.0,0.0,10.0,0.0,0.0,818.0,15.0,0.0,1.0,1305.0,19.0,1.0,0.0,1303.0,1.0,0.0,0.0,82.0,34.0,1.0,0.0,2793.0,11.0,0.0,0.0,917.0,nan,nan,nan,nan,13.0,3.0,0.0,1170.0,Serie A,26.0,7.0,2.0,2292.0,nan,nan,nan,nan,nan,nan,nan,nan,nan,nan,nan,nan,nan,nan,nan,nan,nan,nan,nan,nan,nan,nan,nan,nan,nan,nan,nan,nan,nan,nan,nan,nan,nan,nan,nan,nan,nan,nan,nan,nan,nan,nan,nan,nan,nan,nan,nan,nan,nan,nan,nan,nan,nan,nan,nan,nan,nan,nan,nan,nan,nan,nan,nan,nan,nan,nan,nan,nan,nan,nan,nan,nan,nan,nan,nan,nan,nan,nan,nan,nan,nan,nan,nan,nan,nan,nan,nan,nan
19/6/2011,MickaÃÂ«l Firmin,8448718,769,9/21/1990,20,0,0,0,0,1250,2500,2500,135,101,40459,185,72,D/DM C,1,1,1,2,2,1,1,3,1,3,2,5,9,8,6,11,6,12,7,7,11,10,6,9,11,10,13,14,13,13,9,12,15,6,8,6,12,14,16,9,12,13,12,5,15,12,20,17,13,14,10,10,5,15,5,12,14,12,16,14,14,6,18,12,14,1,12,10,18,D/DM C,321,1,1,1,1,1,1,18,10,12,20,14,1,1,10,12,0.0,0,0,0,0,0,0,0,0,0,0,0,0,0,0,0,0,0,0,0,0,0,0,0,0,0,0,0,0,0,0,0,0,0,0,0,0,0,0,0,0,0,0,0,0,0,0,0,0,MickaÃÂ«l Firmin,ÃÂ£540Th. ,30.0,179.0,Defender - Centre-Back,right,Without Club,0.0,0.0,0.0,0.0,8.0,0.0,0.0,437.0,15.0,0.0,0.0,1108.0,7.0,0.0,0.0,538.0,2.0,0.0,0.0,43.0,nan,nan,nan,nan,nan,nan,nan,nan,32.0,0.0,0.0,2811.0,nan,nan,nan,nan,Ligue 1,nan,nan,nan,nan,nan,nan,nan,nan,nan,nan,nan,nan,nan,nan,nan,nan,nan,nan,nan,nan,nan,nan,nan,nan,nan,nan,nan,nan,nan,nan,nan,nan,nan,nan,nan,nan,nan,nan,nan,nan,nan,nan,nan,nan,nan,nan,nan,nan,nan,nan,nan,nan,nan,nan,nan,nan,nan,nan,nan,nan,nan,nan,nan,nan,nan,nan,nan,nan,nan,nan,nan,nan,nan,nan,nan,nan,nan,nan,nan,nan,nan,nan,nan,nan,nan,nan,nan,nan,nan,nan,nan,nan
19/6/2011,Michelangelo Albertazzi,43009778,776,1/7/1991,20,0,0,0,0,740,3911,3911,125,85,19640,186,73,D C,3,2,3,2,3,1,2,1,2,1,2,2,5,4,3,10,2,13,4,12,13,8,4,11,9,9,11,8,8,9,7,10,13,4,9,7,13,13,10,11,12,10,13,20,12,13,5,11,9,12,11,8,6,14,9,14,15,11,14,16,15,5,20,8,1,1,1,12,20,D C,101,1,14,1,1,1,1,20,12,1,1,1,1,1,8,1,0.0,0,0,0,0,0,0,0,0,0,0,0,0,0,0,0,0,0,0,0,0,0,0,0,0,0,0,0,0,0,0,0,0,0,0,0,0,0,0,0,0,0,0,0,0,0,0,0,0,Michelangelo Albertazzi,ÃÂ£315Th. ,29.0,186.0,Defender - Left-Back,left,Without Club,30.0,2.0,0.0,2730.0,8.0,1.0,0.0,684.0,14.0,1.0,0.0,934.0,17.0,0.0,1.0,1392.0,1.0,0.0,0.0,80.0,10.0,0.0,0.0,708.0,nan,nan,nan,nan,nan,nan,nan,nan,6.0,0.0,0.0,567.0,LaLiga,nan,nan,nan,nan,nan,nan,nan,nan,nan,nan,nan,nan,nan,nan,nan,nan,nan,nan,nan,nan,nan,nan,nan,nan,nan,nan,nan,nan,nan,nan,nan,nan,nan,nan,nan,nan,nan,nan,nan,nan,nan,nan,nan,nan,nan,nan,nan,nan,nan,nan,nan,nan,nan,nan,nan,nan,nan,nan,nan,nan,nan,nan,nan,nan,nan,nan,nan,nan,nan,nan,nan,nan,nan,nan,nan,nan,nan,nan,nan,nan,nan,nan,nan,nan,nan,nan,nan,nan,nan,nan,nan,nan
19/6/2011,Matthew Briggs,28010395,765,3/6/1991,20,0,0,12,1,3200,5500,5500,151,105,1283797,186,75,D LC,3,3,1,2,2,3,1,5,2,3,1,5,11,9,7,13,4,11,12,7,12,12,7,12,11,13,10,13,10,12,9,10,13,10,9,12,12,14,13,12,10,10,13,20,13,12,5,15,12,10,8,10,7,13,18,6,12,13,14,13,12,4,20,15,15,1,3,20,17,D LC,104,1,1,1,1,1,1,17,20,3,1,1,15,1,15,1,0.0,0,0,0,0,0,0,0,0,0,0,0,0,0,0,0,0,0,0,0,0,0,0,0,0,0,0,0,0,0,0,0,0,0,0,0,0,0,0,0,0,0,0,0,0,0,0,0,0,Matthew Briggs,ÃÂ£1.35m ,29.0,183.0,Defender - Centre-Back,left,Vejle Boldklub,4.0,0.0,1.0,254.0,25.0,1.0,1.0,2033.0,27.0,1.0,1.0,2020.0,6.0,0.0,0.0,274.0,30.0,1.0,4.0,2464.0,32.0,0.0,2.0,2676.0,15.0,0.0,0.0,1135.0,13.0,0.0,1.0,846.0,nan,nan,nan,nan,Premier League,17.0,0.0,0.0,1466.0,1.0,0.0,1.0,90.0,nan,nan,nan,nan,nan,nan,nan,nan,nan,nan,nan,nan,nan,nan,nan,nan,nan,nan,nan,nan,nan,nan,nan,nan,nan,nan,nan,nan,nan,nan,nan,nan,nan,nan,nan,nan,nan,nan,nan,nan,nan,nan,nan,nan,nan,nan,nan,nan,nan,nan,nan,nan,nan,nan,nan,nan,nan,nan,nan,nan,nan,nan,nan,nan,nan,nan,nan,nan,nan,nan,nan,nan,nan,nan,nan,nan,nan,nan,nan,nan,nan,nan,nan,nan
19/6/2011,Mathieu Peybernes,34009939,769,10/21/1990,20,0,0,3,0,4150,5219,5200,138,116,427211,184,80,D C,2,1,2,2,1,1,1,8,3,3,3,5,8,7,5,9,6,11,6,6,13,7,6,12,9,11,14,13,12,11,7,11,14,8,10,6,13,13,12,16,12,14,12,20,15,15,8,14,14,14,11,14,5,10,10,13,15,15,14,14,14,6,20,13,1,1,13,10,20,D C,101,1,1,1,1,1,1,20,10,13,1,1,1,1,10,13,0.0,0,0,0,0,0,0,0,0,0,0,0,0,0,0,0,0,0,0,0,0,0,0,0,0,0,0,0,0,0,0,0,0,0,0,0,0,0,0,0,0,0,0,0,0,0,0,0,0,Mathieu Peybernes,ÃÂ£1.80m ,30.0,187.0,Defender - Centre-Back,right,UD AlmerÃÂ­a,8.0,0.0,0.0,406.0,29.0,1.0,0.0,2131.0,26.0,0.0,1.0,1871.0,19.0,0.0,0.0,1391.0,34.0,0.0,2.0,2683.0,27.0,0.0,0.0,2222.0,41.0,0.0,0.0,3561.0,19.0,0.0,0.0,1616.0,29.0,1.0,0.0,2542.0,Ligue 1,30.0,1.0,0.0,2655.0,2.0,0.0,0.0,94.0,29/6/2010,Mathieu Peybernes,34009939.0,769.0,10/21/1990,19.0,0.0,0.0,0.0,0.0,900.0,4500.0,4500.0,150.0,100.0,1314281.0,184.0,80.0,D C,1.0,1.0,2.0,1.0,3.0,3.0,1.0,3.0,1.0,3.0,1.0,5.0,6.0,9.0,4.0,8.0,4.0,14.0,10.0,5.0,11.0,7.0,2.0,10.0,8.0,10.0,14.0,12.0,12.0,12.0,7.0,11.0,11.0,5.0,9.0,5.0,13.0,14.0,16.0,9.0,9.0,14.0,12.0,8.0,10.0,11.0,20.0,14.0,14.0,14.0,10.0,10.0,6.0,10.0,13.0,6.0,11.0,14.0,9.0,5.0,8.0,8.0,Mathieu Peybernes,ÃÂÃÂ£270Th. ,Ligue 1
19/6/2011,Mateo Musacchio,14000745,1649,8/26/1990,20,2,0,3,0,5300,7100,7000,162,141,5284923,180,73,D C,3,3,2,2,2,1,1,5,2,1,1,7,8,11,8,11,6,14,8,10,16,12,10,15,12,17,14,16,13,13,10,12,11,8,12,6,16,17,15,12,13,12,11,13,15,14,20,14,12,14,14,12,6,12,13,8,10,14,9,7,5,2,20,1,1,1,12,1,20,D C,101,1,15,1,1,1,1,20,1,12,10,1,1,1,1,1,0.0,0,0,0,0,0,0,0,0,0,0,0,0,0,0,0,0,0,0,0,0,0,0,0,0,0,0,0,0,0,0,0,0,0,0,0,0,0,0,0,0,0,0,0,0,0,0,0,0,Mateo Musacchio,ÃÂ£6.30m ,30.0,182.0,Defender - Centre-Back,right,AC Milan,52.0,0.0,2.0,4192.0,39.0,0.0,1.0,3459.0,40.0,2.0,3.0,3580.0,35.0,1.0,2.0,3112.0,24.0,3.0,1.0,2022.0,21.0,1.0,0.0,1642.0,30.0,0.0,2.0,2646.0,22.0,1.0,1.0,1754.0,33.0,1.0,1.0,2992.0,LaLiga,18.0,0.0,0.0,1466.0,nan,nan,nan,nan,29/6/2010,Mateo Musacchio,14000745.0,1649.0,8/26/1990,19.0,0.0,0.0,3.0,0.0,4489.0,6700.0,6700.0,154.0,134.0,24194402.0,180.0,73.0,D C,1.0,1.0,2.0,2.0,1.0,3.0,3.0,4.0,2.0,3.0,2.0,5.0,8.0,11.0,6.0,11.0,4.0,14.0,6.0,10.0,14.0,12.0,10.0,16.0,12.0,17.0,17.0,13.0,12.0,14.0,11.0,12.0,10.0,8.0,11.0,6.0,15.0,14.0,14.0,14.0,13.0,12.0,11.0,6.0,14.0,15.0,20.0,16.0,10.0,15.0,14.0,12.0,6.0,12.0,14.0,9.0,12.0,5.0,9.0,1.0,6.0,12.0,Mateo Musacchio,ÃÂÃÂ£4.50m ,LaLiga,19-06-17,18.3.4.28,Mateo Musacchio,14000745,1649,26-Aug-90,26,6,0,3,0,6300,7200,7550,162,151,86081768,180,75,D C,3,2,2,3,3,1,2,3,3,3,2,6,7,11,8,13,6,16,8,9,16,14,10,17,14,17,15,16,17,13,10,14,16,8,14,6,16,16,15,13,12,10,12,10,13,13,20,12,14,13,10,13,12,10,13,15,12,14,15,11,12,8,20,1,1,1,1,1,20,D C,101,1,11,1,1,1,1,20,1,1,9,1,1,1,1,1,137439000000.0,0,0,0,0,0,0,0,0,0,0,0,0,0,0,0,0,0,0,0,0,0,0,0,0,0,0,0,0,0,0,0,0,0,0,0,0,0,1,0,0,0,0,0,0,0,0,0,0,Mateo Musacchio,ÃÂ£11.25m ,30.0,182.0,Defender - Centre-Back,right,AC Milan,30.0,0.0,2.0,2646.0,22.0,1.0,1.0,1754.0,33.0,1.0,1.0,2992.0,18.0,0.0,0.0,1466.0,nan,nan,nan,nan,Serie A,15-07-16,17.3.2.23,Mateo Musacchio,14000745.0,1649.0,26-Aug-90,25.0,3.0,0.0,3.0,0.0,6250.0,7200.0,7450.0,160.0,151.0,27141447.0,182.0,80.0,D C,3.0,4.0,3.0,3.0,2.0,4.0,1.0,4.0,1.0,2.0,1.0,6.0,7.0,11.0,8.0,13.0,6.0,15.0,8.0,9.0,16.0,15.0,10.0,17.0,14.0,17.0,16.0,16.0,17.0,13.0,10.0,14.0,16.0,8.0,14.0,6.0,17.0,16.0,15.0,13.0,12.0,10.0,12.0,9.0,13.0,13.0,20.0,12.0,13.0,13.0,10.0,13.0,10.0,10.0,13.0,15.0,12.0,14.0,15.0,11.0,12.0,8.0,Mateo Musacchio,ÃÂ£16.20m ,LaLiga
19/6/2011,Marc Hornschuh,35011184,771,3/2/1991,20,0,0,3,0,2800,5250,5250,122,105,225945,188,71,D/DM/M RC,3,1,3,3,1,1,2,2,2,1,3,5,6,6,5,10,5,11,6,12,14,9,8,14,9,12,13,13,11,9,7,11,11,5,7,6,13,14,12,10,12,13,14,10,12,12,20,14,13,12,9,11,8,13,6,14,12,18,12,11,12,5,20,15,16,1,17,5,20,D/DM/M RC,123,1,1,1,1,1,1,20,5,17,19,16,5,5,5,15,0.0,0,0,0,0,0,0,0,0,0,0,0,0,0,0,0,0,0,0,0,0,0,0,0,0,0,0,0,0,0,0,0,0,0,0,0,0,0,0,0,0,0,0,0,0,0,0,0,0,Marc Hornschuh,ÃÂ£225Th. ,29.0,188.0,Defender - Centre-Back,right,Hamburger SV II,25.0,1.0,0.0,2241.0,17.0,1.0,0.0,1440.0,31.0,0.0,3.0,2466.0,36.0,2.0,1.0,3240.0,33.0,1.0,0.0,2832.0,27.0,2.0,2.0,2280.0,22.0,0.0,1.0,1908.0,7.0,0.0,0.0,609.0,4.0,0.0,0.0,341.0,Bundesliga,7.0,0.0,0.0,571.0,9.0,0.0,0.0,781.0,nan,nan,nan,nan,nan,nan,nan,nan,nan,nan,nan,nan,nan,nan,nan,nan,nan,nan,nan,nan,nan,nan,nan,nan,nan,nan,nan,nan,nan,nan,nan,nan,nan,nan,nan,nan,nan,nan,nan,nan,nan,nan,nan,nan,nan,nan,nan,nan,nan,nan,nan,nan,nan,nan,nan,nan,nan,nan,nan,nan,nan,nan,nan,nan,nan,nan,nan,nan,nan,nan,nan,nan,nan,nan,nan,nan,nan,nan,nan,nan,nan,nan,nan,nan
19/6/2011,Marc Bartra,67063004,796,1/15/1991,20,0,0,0,0,4766,6461,6461,160,129,1550862,181,70,D RC,2,3,3,3,3,1,2,3,2,2,1,5,8,9,5,12,7,13,7,11,14,12,8,13,13,8,13,14,13,14,10,13,10,7,12,8,14,14,13,13,12,13,11,7,14,14,20,14,12,14,10,13,7,13,6,2,10,9,11,11,13,11,20,1,1,1,16,10,20,D RC,103,1,1,1,1,1,1,20,10,16,1,1,1,1,1,1,0.0,0,0,0,0,0,0,0,0,0,0,0,0,0,0,0,0,0,0,0,0,0,0,0,0,0,0,0,0,0,0,0,0,0,0,0,0,0,0,0,0,0,0,0,0,0,0,0,0,Marc Bartra,ÃÂ£2.25m ,29.0,184.0,Defender - Centre-Back,right,Real Betis BalompiÃÂ©,33.0,3.0,0.0,2891.0,25.0,0.0,0.0,2167.0,16.0,0.0,0.0,899.0,30.0,2.0,1.0,2302.0,25.0,1.0,4.0,1848.0,24.0,2.0,1.0,1196.0,31.0,1.0,4.0,2606.0,36.0,5.0,1.0,2912.0,46.0,1.0,0.0,3960.0,LaLiga,33.0,3.0,1.0,2780.0,7.0,0.0,0.0,630.0,29/6/2010,Marc Bartra,67063004.0,796.0,1/15/1991,19.0,0.0,0.0,0.0,0.0,2500.0,5250.0,5250.0,132.0,105.0,1978902.0,184.0,82.0,D RC,2.0,3.0,3.0,3.0,1.0,2.0,3.0,4.0,3.0,3.0,1.0,5.0,8.0,8.0,5.0,10.0,5.0,11.0,4.0,9.0,13.0,12.0,9.0,12.0,10.0,8.0,11.0,13.0,8.0,12.0,8.0,10.0,8.0,7.0,11.0,8.0,14.0,14.0,13.0,13.0,10.0,12.0,11.0,7.0,11.0,13.0,20.0,14.0,10.0,12.0,10.0,10.0,7.0,12.0,11.0,12.0,11.0,13.0,15.0,13.0,7.0,13.0,Marc Bartra,ÃÂÃÂ£1.35m ,LaLiga,19-06-17,18.3.4.28,Marc Bartra,67063004,796,15-Jan-91,26,12,0,16,2,6400,7400,7400,152,148,29918771,184,73,D C,3,1,1,2,3,1,1,3,1,2,2,7,10,12,9,14,7,15,8,12,16,13,9,17,14,15,18,14,18,15,12,13,14,10,11,10,12,10,14,14,14,11,13,10,13,12,20,14,11,15,8,13,7,8,10,12,16,13,17,14,12,7,20,10,1,1,14,8,20,D C,101,1,14,1,1,1,1,20,8,14,1,1,1,1,5,10,1.15306e+18,0,0,0,0,0,0,0,0,0,0,0,0,0,0,0,0,0,0,0,0,0,0,0,0,0,0,0,0,0,0,0,0,1,0,0,0,0,0,0,0,0,0,0,0,0,0,0,1,Marc Bartra,ÃÂ£15.75m ,29.0,184.0,Defender - Centre-Back,right,Real Betis BalompiÃÂ©,31.0,1.0,4.0,2606.0,36.0,5.0,1.0,2912.0,46.0,1.0,0.0,3960.0,33.0,3.0,1.0,2780.0,7.0,0.0,0.0,630.0,LaLiga,15-07-16,17.3.2.23,Marc Bartra,67063004.0,796.0,15-Jan-91,25.0,10.0,0.0,16.0,2.0,5500.0,7500.0,7500.0,154.0,150.0,63011179.0,184.0,73.0,D C,1.0,3.0,1.0,3.0,1.0,1.0,3.0,1.0,2.0,2.0,3.0,7.0,10.0,12.0,9.0,14.0,7.0,15.0,8.0,12.0,17.0,13.0,9.0,17.0,14.0,15.0,18.0,14.0,18.0,15.0,12.0,13.0,14.0,10.0,11.0,10.0,12.0,10.0,15.0,14.0,14.0,11.0,13.0,10.0,13.0,12.0,20.0,14.0,11.0,15.0,8.0,13.0,7.0,8.0,10.0,12.0,16.0,13.0,16.0,14.0,12.0,7.0,Marc Bartra,ÃÂ£9.00m ,Bundesliga
19/6/2011,JosÃÂ© Carlos TerrÃÂ³n,67024161,796,2/16/1991,20,0,0,0,0,2400,2900,2900,99,68,29203,174,73,D LC,2,3,2,2,1,2,1,1,3,2,3,5,7,6,5,9,5,9,6,9,9,11,2,10,9,10,12,10,11,9,7,10,10,11,7,6,11,10,9,11,10,7,8,20,12,12,8,9,5,9,5,10,4,9,11,9,14,15,8,6,6,6,20,13,1,1,3,20,18,D LC,104,1,1,1,1,1,1,18,20,3,1,1,1,1,13,1,0.0,0,0,0,0,0,0,0,0,0,0,0,0,0,0,0,0,0,0,0,0,0,0,0,0,0,0,0,0,0,0,0,0,0,0,0,0,0,0,0,0,0,0,0,0,0,0,0,0,nan,nan,nan,nan,nan,nan,nan,nan,nan,nan,nan,nan,nan,nan,nan,nan,nan,nan,nan,nan,nan,nan,nan,nan,nan,nan,nan,nan,nan,nan,nan,nan,nan,nan,nan,nan,nan,nan,nan,nan,nan,nan,nan,nan,nan,nan,nan,nan,nan,nan,nan,nan,nan,nan,nan,nan,nan,nan,nan,nan,nan,nan,nan,nan,nan,nan,nan,nan,nan,nan,nan,nan,nan,nan,nan,nan,nan,nan,nan,nan,nan,nan,nan,nan,nan,nan,nan,nan,nan,nan,nan,nan,nan,nan,nan,nan,nan,nan,nan,nan,nan,nan,nan,nan,nan,nan,nan,nan,nan,nan,nan,nan,nan,nan,nan,nan,nan,nan,nan,nan,nan,nan,nan,nan,nan,nan,nan,nan,nan,nan,nan,nan,nan,nan,nan,nan
19/6/2011,JosÃÂ© AlcaÃÂ±iz,67060843,796,7/12/1990,20,0,0,0,0,1800,3550,3550,110,93,142796,178,76,D C,1,3,2,3,2,3,2,2,2,3,2,6,2,1,4,12,4,14,3,2,13,8,6,11,8,7,10,13,9,14,4,12,8,7,3,5,14,11,13,11,14,14,10,20,12,13,5,10,11,9,6,10,10,10,14,13,8,14,17,9,8,6,20,1,1,1,1,12,20,D C,101,1,10,1,1,1,1,20,12,1,1,1,1,1,1,1,0.0,0,0,0,0,0,0,0,0,0,0,0,0,0,0,0,0,0,0,0,0,0,0,0,0,0,0,0,0,0,0,0,0,0,0,0,0,0,0,0,0,0,0,0,0,0,0,0,0,JosÃÂ© AlcaÃÂ±iz, ,30.0,183.0,Defender - Centre-Back,left,CD Quintanar del Rey,33.0,0.0,0.0,2882.0,34.0,2.0,0.0,3014.0,32.0,1.0,0.0,2799.0,33.0,0.0,1.0,2947.0,33.0,0.0,0.0,2970.0,23.0,2.0,0.0,1982.0,26.0,1.0,0.0,2116.0,nan,nan,nan,nan,nan,nan,nan,nan,LaLiga,1.0,0.0,0.0,90.0,nan,nan,nan,nan,nan,nan,nan,nan,nan,nan,nan,nan,nan,nan,nan,nan,nan,nan,nan,nan,nan,nan,nan,nan,nan,nan,nan,nan,nan,nan,nan,nan,nan,nan,nan,nan,nan,nan,nan,nan,nan,nan,nan,nan,nan,nan,nan,nan,nan,nan,nan,nan,nan,nan,nan,nan,nan,nan,nan,nan,nan,nan,nan,nan,nan,nan,nan,nan,nan,nan,nan,nan,nan,nan,nan,nan,nan,nan,nan,nan,nan,nan,nan,nan,nan,nan,nan,nan
19/6/2011,Jonathan Mensah,65002338,21,7/13/1990,20,11,1,0,0,6000,7040,5750,150,128,3442232,188,83,D/DM C,2,3,1,3,3,1,3,3,2,3,2,10,11,7,3,10,5,13,6,2,13,10,10,14,10,9,12,15,12,12,14,12,16,7,12,7,12,14,15,14,14,14,14,11,15,14,20,15,14,10,8,16,11,18,15,12,9,14,16,5,6,13,20,13,10,1,13,13,20,D/DM C,111,1,3,1,1,1,1,20,13,13,18,10,1,1,13,13,16777216.0,0,0,0,0,0,0,0,0,0,0,0,0,0,0,0,0,0,0,0,0,0,0,0,0,1,0,0,0,0,0,0,0,0,0,0,0,0,0,0,0,0,0,0,0,0,0,0,0,Jonathan Mensah,ÃÂ£540Th. ,30.0,188.0,Defender - Centre-Back,right,Columbus Crew SC,15.0,1.0,0.0,1202.0,1.0,0.0,0.0,90.0,6.0,0.0,0.0,481.0,27.0,1.0,0.0,1916.0,12.0,1.0,0.0,1006.0,15.0,0.0,1.0,1088.0,42.0,2.0,1.0,3429.0,30.0,1.0,0.0,2647.0,24.0,0.0,0.0,2151.0,Ligue 1,20.0,0.0,0.0,1800.0,nan,nan,nan,nan,nan,nan,nan,nan,nan,nan,nan,nan,nan,nan,nan,nan,nan,nan,nan,nan,nan,nan,nan,nan,nan,nan,nan,nan,nan,nan,nan,nan,nan,nan,nan,nan,nan,nan,nan,nan,nan,nan,nan,nan,nan,nan,nan,nan,nan,nan,nan,nan,nan,nan,nan,nan,nan,nan,nan,nan,nan,nan,nan,nan,nan,nan,nan,nan,nan,nan,nan,nan,nan,nan,nan,nan,nan,nan,nan,nan,nan,nan,nan,nan,nan,nan,nan,nan
19/6/2011,Johan Martial,85038920,769,5/30/1991,20,0,0,0,0,3500,5309,5300,160,118,273761,184,76,D C,1,2,1,1,1,1,2,7,3,2,1,5,7,7,6,9,5,15,7,5,14,10,6,12,9,13,14,14,12,12,8,11,12,6,9,7,13,12,12,14,11,15,13,20,14,12,5,13,14,13,13,15,8,6,5,14,13,15,13,14,14,6,20,1,1,1,10,10,20,D C,101,1,1,1,1,1,1,20,10,10,1,1,1,1,1,1,0.0,0,0,0,0,0,0,0,0,0,0,0,0,0,0,0,0,0,0,0,0,0,0,0,0,0,0,0,0,0,0,0,0,0,0,0,0,0,0,0,0,0,0,0,0,0,0,0,0,Johan Martial,ÃÂ£1.35m ,29.0,184.0,Defender - Centre-Back,right,FC Sochaux-MontbÃÂ©liard,9.0,2.0,0.0,782.0,24.0,0.0,0.0,2070.0,20.0,1.0,0.0,1686.0,4.0,0.0,0.0,259.0,13.0,1.0,0.0,970.0,8.0,0.0,0.0,570.0,19.0,3.0,1.0,1330.0,29.0,2.0,0.0,2492.0,9.0,0.0,0.0,654.0,Ligue 1,20.0,1.0,0.0,1620.0,nan,nan,nan,nan,29/6/2010,Johan Martial,85038920.0,769.0,5/30/1991,19.0,0.0,0.0,0.0,0.0,2300.0,3550.0,3550.0,150.0,108.0,934787.0,184.0,82.0,D C,3.0,2.0,2.0,2.0,1.0,3.0,3.0,1.0,3.0,2.0,2.0,5.0,7.0,7.0,6.0,9.0,5.0,14.0,7.0,6.0,13.0,7.0,6.0,12.0,9.0,10.0,14.0,14.0,12.0,12.0,6.0,11.0,9.0,6.0,10.0,7.0,12.0,12.0,13.0,12.0,10.0,14.0,13.0,20.0,14.0,10.0,5.0,14.0,14.0,13.0,10.0,14.0,8.0,6.0,14.0,14.0,10.0,11.0,14.0,14.0,14.0,8.0,Johan Martial,ÃÂÃÂ£720Th. ,Ligue 1
19/6/2011,Jan Kirchhoff,35017380,771,10/1/1990,20,0,0,8,2,3750,5624,5750,131,125,1848252,195,82,D C,2,1,2,3,3,3,1,2,2,1,3,5,9,8,5,8,4,14,11,12,14,14,11,11,11,13,13,13,14,15,9,12,10,8,11,12,11,12,13,12,11,16,15,10,12,13,20,14,12,13,10,10,6,5,5,13,9,14,14,11,7,14,20,1,7,1,1,1,20,D C,101,1,1,1,1,1,1,20,1,1,13,7,1,1,1,1,0.0,0,0,0,0,0,0,0,0,0,0,0,0,0,0,0,0,0,0,0,0,0,0,0,0,0,0,0,0,0,0,0,0,0,0,0,0,0,0,0,0,0,0,0,0,0,0,0,0,Jan Kirchhoff,ÃÂ£2.70m ,30.0,195.0,Defender - Centre-Back,right,KFC Uerdingen 05,22.0,1.0,1.0,1795.0,32.0,0.0,0.0,2361.0,21.0,0.0,2.0,1278.0,13.0,0.0,0.0,177.0,18.0,0.0,0.0,1061.0,17.0,0.0,0.0,1174.0,11.0,1.0,1.0,770.0,4.0,0.0,0.0,184.0,10.0,0.0,1.0,848.0,Bundesliga,22.0,2.0,1.0,1790.0,nan,nan,nan,nan,29/6/2010,Jan Kirchhoff,35017380.0,771.0,10/1/1990,19.0,0.0,0.0,0.0,0.0,2250.0,5500.0,5500.0,118.0,110.0,3648573.0,195.0,82.0,DM C,2.0,1.0,1.0,3.0,3.0,3.0,2.0,2.0,1.0,1.0,2.0,5.0,9.0,8.0,5.0,5.0,4.0,14.0,11.0,14.0,14.0,14.0,11.0,14.0,11.0,11.0,8.0,16.0,14.0,15.0,9.0,7.0,10.0,8.0,11.0,12.0,13.0,14.0,14.0,13.0,11.0,15.0,18.0,10.0,12.0,13.0,20.0,11.0,12.0,12.0,10.0,10.0,3.0,5.0,5.0,13.0,9.0,14.0,14.0,11.0,7.0,14.0,Jan Kirchhoff,ÃÂÃÂ£900Th. ,Bundesliga
19/6/2011,IÃÂ±igo MartÃÂ­nez,67104772,796,5/17/1991,20,0,0,0,0,3250,6000,6000,131,122,430868,176,75,D C,2,1,1,1,1,3,1,1,3,3,3,2,2,4,4,9,4,13,9,7,15,12,3,15,12,14,13,15,15,14,11,13,12,9,13,5,14,13,13,13,12,13,9,20,10,13,10,12,11,12,12,11,6,10,14,13,11,13,10,13,7,11,20,1,11,1,1,8,20,D C,101,1,1,1,1,1,1,20,8,1,13,11,1,1,1,1,0.0,0,0,0,0,0,0,0,0,0,0,0,0,0,0,0,0,0,0,0,0,0,0,0,0,0,0,0,0,0,0,0,0,0,0,0,0,0,0,0,0,0,0,0,0,0,0,0,0,IÃÂ±igo MartÃÂ­nez,ÃÂ£2.25m ,29.0,182.0,Defender - Centre-Back,left,Athletic Bilbao,31.0,1.0,0.0,2508.0,28.0,3.0,0.0,2387.0,36.0,4.0,0.0,3240.0,47.0,2.0,0.0,4154.0,41.0,2.0,1.0,3658.0,31.0,1.0,0.0,2790.0,40.0,4.0,4.0,3539.0,32.0,1.0,1.0,2856.0,35.0,0.0,2.0,3084.0,LaLiga,40.0,1.0,3.0,3660.0,6.0,0.0,0.0,540.0,29/6/2010,IÃÂ±igo MartÃÂ­nez,67104772.0,796.0,5/17/1991,19.0,0.0,0.0,0.0,0.0,1482.0,3550.0,3550.0,143.0,77.0,1308726.0,186.0,83.0,D/DM C,1.0,3.0,2.0,2.0,1.0,3.0,2.0,1.0,3.0,1.0,1.0,2.0,2.0,3.0,5.0,4.0,4.0,8.0,9.0,7.0,10.0,8.0,3.0,12.0,9.0,12.0,13.0,11.0,12.0,12.0,9.0,11.0,7.0,11.0,13.0,5.0,11.0,12.0,11.0,11.0,13.0,12.0,10.0,20.0,17.0,10.0,9.0,11.0,12.0,10.0,12.0,11.0,8.0,10.0,7.0,11.0,9.0,10.0,13.0,7.0,8.0,8.0,Igor MartÃÂÃÂ­nez,ÃÂÃÂ£1.35m ,LaLiga,19-06-17,18.3.4.28,IÃÂigo MartÃÂ­nez,67104772,796,17-May-91,26,2,0,4,0,5500,7400,7400,159,148,44015115,181,77,D C,3,2,1,3,1,1,4,1,3,2,2,5,6,9,8,12,14,14,16,5,15,15,3,16,15,17,17,16,14,14,13,13,16,13,15,7,16,15,15,14,12,13,12,20,12,13,9,13,15,14,14,13,6,5,14,14,16,13,14,14,11,10,20,1,1,1,1,10,20,D C,101,1,1,1,1,1,1,20,10,1,1,1,1,1,1,1,44049200000000.0,0,0,0,0,0,0,0,0,1,0,0,0,0,0,0,0,0,0,0,0,0,0,0,0,0,0,0,0,0,0,0,0,0,0,0,0,1,0,0,0,0,0,0,1,0,1,0,0,IÃÂ±igo MartÃÂ­nez,ÃÂ£28.80m ,29.0,182.0,Defender - Centre-Back,left,Athletic Bilbao,40.0,4.0,4.0,3539.0,32.0,1.0,1.0,2856.0,35.0,0.0,2.0,3084.0,40.0,1.0,3.0,3660.0,6.0,0.0,0.0,540.0,LaLiga,15-07-16,17.3.2.23,IÃÂigo MartÃÂ­nez,67104772.0,796.0,17-May-91,25.0,2.0,0.0,4.0,0.0,5500.0,7300.0,7300.0,159.0,148.0,25113499.0,181.0,77.0,D C,4.0,3.0,1.0,1.0,4.0,3.0,2.0,2.0,1.0,2.0,2.0,5.0,6.0,9.0,8.0,12.0,14.0,14.0,16.0,5.0,15.0,15.0,3.0,16.0,14.0,17.0,17.0,16.0,14.0,12.0,13.0,13.0,16.0,13.0,15.0,7.0,16.0,15.0,15.0,14.0,12.0,13.0,12.0,20.0,12.0,13.0,11.0,13.0,15.0,14.0,14.0,13.0,6.0,5.0,14.0,14.0,16.0,13.0,13.0,14.0,11.0,10.0,IÃÂ±igo MartÃÂ­nez,ÃÂ£18.00m ,LaLiga
19/6/2011,HÃÂ¥vard Nordtveit,53000623,786,6/21/1990,20,1,0,15,1,4850,5849,6450,142,130,5376676,188,72,D/DM/M C,3,2,1,3,1,2,2,1,2,3,1,5,11,9,6,14,7,12,7,19,12,15,5,14,13,11,15,12,14,9,13,15,14,7,13,7,12,17,12,12,9,10,14,12,13,17,20,13,12,11,8,14,9,10,14,14,16,16,15,12,16,7,18,10,17,1,12,1,18,D/DM/M C,331,1,12,1,1,1,1,18,1,12,20,17,1,1,1,10,8796180000000.0,0,0,0,0,0,0,0,0,0,0,0,0,0,0,0,0,0,0,0,1,0,0,1,0,1,0,1,0,0,0,0,0,0,0,0,0,0,0,0,0,0,0,0,1,0,0,0,0,Havard Nordtveit,ÃÂ£4.95m ,30.0,188.0,Defender - Centre-Back,right,TSG 1899 Hoffenheim,25.0,2.0,1.0,2196.0,36.0,1.0,0.0,2872.0,42.0,2.0,6.0,3563.0,22.0,1.0,2.0,1285.0,30.0,3.0,1.0,1550.0,39.0,4.0,1.0,2996.0,22.0,0.0,1.0,1420.0,23.0,0.0,1.0,1502.0,16.0,1.0,1.0,1011.0,Bundesliga,12.0,0.0,1.0,818.0,nan,nan,nan,nan,nan,nan,nan,nan,nan,nan,nan,nan,nan,nan,nan,nan,nan,nan,nan,nan,nan,nan,nan,nan,nan,nan,nan,nan,nan,nan,nan,nan,nan,nan,nan,nan,nan,nan,nan,nan,nan,nan,nan,nan,nan,nan,nan,nan,nan,nan,nan,nan,nan,nan,nan,nan,nan,nan,nan,nan,nan,nan,nan,nan,nan,nan,nan,nan,nan,nan,nan,nan,nan,nan,nan,nan,nan,nan,nan,nan,nan,nan,nan,nan,nan,nan,nan,nan,19-06-17,18.3.4.28,HÃÂºvard Nordtveit,53000623,786,21-Jun-90,26,32,2,24,1,5650,6650,6650,137,133,10770670,188,85,D/DM/M C,3,1,2,2,3,3,1,3,2,2,1,11,11,9,8,10,12,10,13,18,13,13,8,14,10,15,14,16,10,16,10,12,15,7,13,11,12,18,15,11,9,12,14,12,17,14,20,17,14,15,10,15,9,15,17,14,13,13,17,14,16,6,20,8,18,1,12,1,20,D/DM/M C,121,1,12,1,1,1,1,20,1,12,18,18,1,1,1,8,0.0,0,0,0,0,0,0,0,0,0,0,0,0,0,0,0,0,0,0,0,0,0,0,0,0,0,0,0,0,0,0,0,0,0,0,0,0,0,0,0,0,0,0,0,0,0,0,0,0,Havard Nordtveit,ÃÂ£3.60m ,30.0,188.0,Defender - Centre-Back,right,TSG 1899 Hoffenheim,22.0,0.0,1.0,1420.0,23.0,0.0,1.0,1502.0,16.0,1.0,1.0,1011.0,12.0,0.0,1.0,818.0,nan,nan,nan,nan,Bundesliga,15-07-16,17.3.2.23,HÃÂºvard Nordtveit,53000623.0,786.0,21-Jun-90,26.0,28.0,2.0,24.0,1.0,5845.0,6345.0,6845.0,140.0,132.0,23096766.0,188.0,85.0,D/DM/M C,2.0,2.0,1.0,2.0,1.0,1.0,2.0,2.0,2.0,1.0,3.0,10.0,11.0,9.0,8.0,11.0,12.0,11.0,12.0,18.0,14.0,11.0,8.0,14.0,10.0,17.0,14.0,16.0,10.0,14.0,10.0,12.0,15.0,7.0,13.0,11.0,12.0,18.0,17.0,11.0,10.0,12.0,14.0,12.0,17.0,12.0,20.0,17.0,14.0,14.0,10.0,14.0,9.0,15.0,17.0,14.0,13.0,13.0,17.0,14.0,16.0,8.0,Havard Nordtveit,ÃÂ£4.50m ,Premier League
19/6/2011,Ezequiel MuÃÂ±oz,14000741,1649,10/8/1990,20,0,0,1,0,4500,6000,6400,162,131,4635676,185,82,D C,3,3,2,2,1,1,3,1,2,1,1,5,7,8,9,10,5,15,7,9,16,11,10,15,11,15,12,15,11,11,8,11,15,7,9,8,14,13,14,12,14,16,14,6,17,13,20,14,15,11,14,14,15,10,11,15,14,15,15,16,10,11,20,1,1,1,11,1,20,D C,101,1,1,1,1,1,1,20,1,11,1,1,1,1,1,1,32768.0,0,0,0,0,0,0,0,0,0,0,0,0,0,0,0,1,0,0,0,0,0,0,0,0,0,0,0,0,0,0,0,0,0,0,0,0,0,0,0,0,0,0,0,0,0,0,0,0,Ezequiel MuÃÂ±oz,ÃÂ£3.60m ,30.0,186.0,Defender - Centre-Back,right,Club AtlÃÂ©tico Independiente,42.0,2.0,0.0,3408.0,21.0,1.0,1.0,1795.0,32.0,0.0,1.0,2628.0,33.0,3.0,0.0,2914.0,18.0,1.0,0.0,1480.0,18.0,0.0,0.0,1405.0,32.0,0.0,0.0,2463.0,20.0,0.0,1.0,1497.0,7.0,0.0,0.0,569.0,Serie A,25.0,1.0,1.0,2250.0,nan,nan,nan,nan,29/6/2010,Ezequiel MuÃÂ±oz,14000741.0,1649.0,10/8/1990,19.0,0.0,0.0,1.0,0.0,4160.0,5804.0,5500.0,165.0,129.0,8471140.0,185.0,82.0,D C,3.0,3.0,2.0,2.0,1.0,3.0,3.0,2.0,1.0,2.0,2.0,5.0,7.0,8.0,9.0,10.0,5.0,15.0,7.0,9.0,16.0,11.0,10.0,15.0,11.0,15.0,12.0,15.0,11.0,11.0,6.0,10.0,15.0,7.0,9.0,6.0,14.0,13.0,14.0,12.0,14.0,16.0,14.0,6.0,17.0,13.0,20.0,14.0,15.0,13.0,14.0,12.0,15.0,10.0,11.0,15.0,14.0,15.0,15.0,16.0,10.0,11.0,Ezequiel MuÃÂÃÂ±oz,ÃÂÃÂ£5.40m ,Serie A,19-06-17,18.3.4.28,Ezequiel MuÃÂoz,14000741,1649,08-Oct-90,26,0,0,1,0,4250,6450,6450,138,129,5303862,185,82,D C,2,3,3,3,1,2,3,3,1,2,1,5,6,8,7,12,5,16,7,9,13,12,5,15,11,17,14,16,12,11,8,13,15,7,12,8,14,14,15,12,10,14,14,8,16,11,20,14,16,15,13,15,12,9,14,14,10,13,16,16,12,6,20,1,1,1,12,1,20,D C,101,1,1,1,1,1,1,20,1,12,1,1,1,1,1,1,32832.0,0,0,0,0,0,0,1,0,0,0,0,0,0,0,0,1,0,0,0,0,0,0,0,0,0,0,0,0,0,0,0,0,0,0,0,0,0,0,0,0,0,0,0,0,0,0,0,0,Ezequiel MuÃÂ±oz,ÃÂ£1.35m ,30.0,186.0,Defender - Centre-Back,right,Club AtlÃÂ©tico Independiente,32.0,0.0,0.0,2463.0,20.0,0.0,1.0,1497.0,7.0,0.0,0.0,569.0,25.0,1.0,1.0,2250.0,nan,nan,nan,nan,LaLiga,15-07-16,17.3.2.23,Ezequiel MuÃÂoz,14000741.0,1649.0,08-Oct-90,25.0,0.0,0.0,1.0,0.0,4250.0,6750.0,6650.0,145.0,133.0,9885624.0,185.0,82.0,D C,2.0,3.0,2.0,2.0,3.0,4.0,4.0,3.0,2.0,2.0,1.0,5.0,6.0,8.0,7.0,12.0,5.0,16.0,7.0,9.0,14.0,12.0,5.0,15.0,11.0,17.0,15.0,16.0,12.0,12.0,8.0,13.0,15.0,7.0,12.0,8.0,14.0,14.0,15.0,12.0,10.0,14.0,14.0,8.0,17.0,12.0,20.0,14.0,16.0,15.0,13.0,15.0,12.0,10.0,14.0,14.0,10.0,13.0,16.0,16.0,12.0,6.0,Ezequiel MuÃÂ±oz,ÃÂ£2.70m ,Serie A
19/6/2011,Eridson,55023788,23,6/25/1990,20,0,0,0,0,500,4184,1000,113,93,97242,187,76,D C,3,1,3,2,2,2,1,1,3,1,2,8,8,7,7,8,9,12,7,9,11,6,9,10,8,13,11,11,9,9,6,7,12,6,9,6,10,10,10,10,10,13,13,8,14,10,20,12,14,10,10,10,7,7,13,11,5,11,18,13,13,7,20,1,5,1,5,1,20,D C,101,1,7,1,1,1,1,20,1,5,5,5,1,5,1,1,0.0,0,0,0,0,0,0,0,0,0,0,0,0,0,0,0,0,0,0,0,0,0,0,0,0,0,0,0,0,0,0,0,0,0,0,0,0,0,0,0,0,0,0,0,0,0,0,0,0,Eridson,ÃÂ£630Th. ,30.0,187.0,Defender - Centre-Back,right,Valadares Gaia FC,nan,nan,nan,nan,19.0,2.0,1.0,1584.0,3.0,0.0,0.0,270.0,25.0,0.0,0.0,2181.0,38.0,1.0,2.0,3334.0,9.0,0.0,1.0,614.0,23.0,0.0,1.0,1960.0,2.0,0.0,0.0,151.0,0.0,0.0,0.0,0.0,Liga NOS,0.0,0.0,0.0,0.0,nan,nan,nan,nan,nan,nan,nan,nan,nan,nan,nan,nan,nan,nan,nan,nan,nan,nan,nan,nan,nan,nan,nan,nan,nan,nan,nan,nan,nan,nan,nan,nan,nan,nan,nan,nan,nan,nan,nan,nan,nan,nan,nan,nan,nan,nan,nan,nan,nan,nan,nan,nan,nan,nan,nan,nan,nan,nan,nan,nan,nan,nan,nan,nan,nan,nan,nan,nan,nan,nan,nan,nan,nan,nan,nan,nan,nan,nan,nan,nan,nan,nan,nan,nan,nan,nan,nan,nan
19/6/2011,Eliaquim Mangala,18031822,769,2/13/1991,20,0,0,9,0,4000,6000,6000,132,123,2213439,187,84,D/DM/M C,3,1,3,2,2,2,1,5,3,2,2,7,7,9,10,10,8,15,8,12,15,7,10,13,10,14,14,15,8,14,8,7,14,10,7,8,10,15,17,14,14,18,17,8,15,14,20,10,17,11,12,7,12,10,13,14,14,11,9,10,8,5,20,14,18,1,14,14,20,D/DM/M C,121,1,1,1,1,1,1,20,14,14,19,18,12,14,14,14,0.0,0,0,0,0,0,0,0,0,0,0,0,0,0,0,0,0,0,0,0,0,0,0,0,0,0,0,0,0,0,0,0,0,0,0,0,0,0,0,0,0,0,0,0,0,0,0,0,0,Eliaquim Mangala,ÃÂ£4.50m ,29.0,187.0,Defender - Centre-Back,left,Valencia CF,41.0,2.0,2.0,3356.0,14.0,1.0,0.0,1160.0,40.0,7.0,2.0,3363.0,42.0,5.0,2.0,3725.0,31.0,0.0,2.0,2728.0,33.0,0.0,1.0,2848.0,33.0,2.0,0.0,2886.0,17.0,0.0,0.0,1178.0,5.0,0.0,0.0,251.0,Liga NOS,11.0,0.0,0.0,884.0,1.0,0.0,0.0,17.0,nan,nan,nan,nan,nan,nan,nan,nan,nan,nan,nan,nan,nan,nan,nan,nan,nan,nan,nan,nan,nan,nan,nan,nan,nan,nan,nan,nan,nan,nan,nan,nan,nan,nan,nan,nan,nan,nan,nan,nan,nan,nan,nan,nan,nan,nan,nan,nan,nan,nan,nan,nan,nan,nan,nan,nan,nan,nan,nan,nan,nan,nan,nan,nan,nan,nan,nan,nan,nan,nan,nan,nan,nan,nan,nan,nan,nan,nan,nan,nan,nan,nan,nan,nan
19/6/2011,Dedryck Boyata,28019224,757,11/28/1990,20,1,0,5,0,3600,5900,6250,165,118,1530180,188,85,D C,3,1,1,3,2,2,2,8,1,1,3,4,5,6,5,7,5,15,5,10,12,7,5,14,6,15,10,14,12,12,3,12,16,5,8,5,14,10,10,13,11,13,15,7,13,13,20,13,15,10,6,9,4,9,16,17,15,18,18,17,17,8,20,1,1,1,1,1,20,D C,101,1,1,1,1,1,1,20,1,1,1,1,1,1,1,1,0.0,0,0,0,0,0,0,0,0,0,0,0,0,0,0,0,0,0,0,0,0,0,0,0,0,0,0,0,0,0,0,0,0,0,0,0,0,0,0,0,0,0,0,0,0,0,0,0,0,Dedryck Boyata,ÃÂ£1.80m ,29.0,188.0,Defender - Centre-Back,right,Hertha BSC,17.0,1.0,0.0,957.0,18.0,1.0,0.0,1470.0,22.0,2.0,0.0,1563.0,7.0,0.0,0.0,608.0,6.0,0.0,0.0,381.0,42.0,6.0,1.0,3561.0,22.0,5.0,2.0,1949.0,39.0,3.0,3.0,3316.0,32.0,1.0,3.0,2794.0,Premier League,29.0,4.0,1.0,2559.0,5.0,0.0,0.0,450.0,nan,nan,nan,nan,nan,nan,nan,nan,nan,nan,nan,nan,nan,nan,nan,nan,nan,nan,nan,nan,nan,nan,nan,nan,nan,nan,nan,nan,nan,nan,nan,nan,nan,nan,nan,nan,nan,nan,nan,nan,nan,nan,nan,nan,nan,nan,nan,nan,nan,nan,nan,nan,nan,nan,nan,nan,nan,nan,nan,nan,nan,nan,nan,nan,nan,nan,nan,nan,nan,nan,nan,nan,nan,nan,nan,nan,nan,nan,nan,nan,nan,nan,nan,nan
19/6/2011,Daniel Ayala,28018268,796,11/7/1990,20,0,0,1,0,3750,5250,5250,144,105,290909,191,84,D C,1,3,2,1,2,3,3,2,2,1,2,2,3,3,4,9,5,13,4,6,13,10,3,15,11,14,12,14,10,11,9,10,14,7,10,12,14,14,12,10,7,9,15,6,10,11,20,14,14,11,6,12,3,9,13,13,8,14,10,7,10,8,20,1,1,1,1,1,20,D C,101,1,1,10,1,1,1,20,1,1,1,1,1,1,1,1,0.0,0,0,0,0,0,0,0,0,0,0,0,0,0,0,0,0,0,0,0,0,0,0,0,0,0,0,0,0,0,0,0,0,0,0,0,0,0,0,0,0,0,0,0,0,0,0,0,0,Daniel Ayala,ÃÂ£450Th. ,29.0,190.0,Defender - Centre-Back,right,Blackburn Rovers,29.0,1.0,2.0,2523.0,13.0,0.0,0.0,989.0,14.0,1.0,0.0,1089.0,21.0,3.0,1.0,1752.0,38.0,5.0,0.0,3240.0,39.0,3.0,2.0,3424.0,18.0,1.0,0.0,1230.0,39.0,7.0,2.0,3399.0,39.0,2.0,2.0,3188.0,Premier League,25.0,2.0,0.0,2080.0,4.0,0.0,0.0,307.0,nan,nan,nan,nan,nan,nan,nan,nan,nan,nan,nan,nan,nan,nan,nan,nan,nan,nan,nan,nan,nan,nan,nan,nan,nan,nan,nan,nan,nan,nan,nan,nan,nan,nan,nan,nan,nan,nan,nan,nan,nan,nan,nan,nan,nan,nan,nan,nan,nan,nan,nan,nan,nan,nan,nan,nan,nan,nan,nan,nan,nan,nan,nan,nan,nan,nan,nan,nan,nan,nan,nan,nan,nan,nan,nan,nan,nan,nan,nan,nan,nan,nan,nan,nan
19/6/2011,Chris Mavinga,85039430,769,5/26/1991,20,0,0,0,0,2500,5800,5500,129,116,972350,185,70,D LC,3,2,3,2,1,3,1,4,1,3,1,6,8,10,5,10,5,10,7,8,13,7,6,14,10,15,11,13,13,13,9,12,10,5,7,7,11,14,11,15,11,11,14,20,14,16,6,14,10,14,10,15,6,8,15,14,7,10,18,12,6,5,20,14,1,1,11,20,19,D LC,104,1,1,1,1,1,1,19,20,11,1,1,1,1,14,1,0.0,0,0,0,0,0,0,0,0,0,0,0,0,0,0,0,0,0,0,0,0,0,0,0,0,0,0,0,0,0,0,0,0,0,0,0,0,0,0,0,0,0,0,0,0,0,0,0,0,Chris Mavinga,ÃÂ£1.13m ,29.0,183.0,Defender - Centre-Back,left,Toronto FC,13.0,0.0,0.0,991.0,22.0,0.0,0.0,1654.0,31.0,0.0,1.0,2684.0,15.0,0.0,2.0,1190.0,11.0,0.0,1.0,848.0,23.0,0.0,1.0,1834.0,34.0,0.0,2.0,2699.0,19.0,0.0,0.0,1307.0,33.0,0.0,1.0,2753.0,Ligue 1,18.0,0.0,0.0,1425.0,nan,nan,nan,nan,nan,nan,nan,nan,nan,nan,nan,nan,nan,nan,nan,nan,nan,nan,nan,nan,nan,nan,nan,nan,nan,nan,nan,nan,nan,nan,nan,nan,nan,nan,nan,nan,nan,nan,nan,nan,nan,nan,nan,nan,nan,nan,nan,nan,nan,nan,nan,nan,nan,nan,nan,nan,nan,nan,nan,nan,nan,nan,nan,nan,nan,nan,nan,nan,nan,nan,nan,nan,nan,nan,nan,nan,nan,nan,nan,nan,nan,nan,nan,nan,nan,nan,nan,nan
19/6/2011,Carlos LabrÃÂ­n,75003180,1652,12/2/1990,20,1,0,0,0,2250,5700,5700,139,114,412393,185,81,D RC,3,2,1,2,3,3,3,6,2,1,1,8,8,10,2,14,8,14,4,6,11,14,10,14,13,10,11,12,12,12,8,14,10,4,9,4,12,10,14,14,12,13,14,11,13,12,20,9,7,10,3,1,15,10,8,20,10,13,11,12,12,7,20,1,1,1,16,1,20,D RC,103,1,18,1,1,1,1,20,1,16,1,1,1,1,1,1,32768.0,0,0,0,0,0,0,0,0,0,0,0,0,0,0,0,1,0,0,0,0,0,0,0,0,0,0,0,0,0,0,0,0,0,0,0,0,0,0,0,0,0,0,0,0,0,0,0,0,Carlos LabrÃÂ­n,ÃÂ£675Th. ,29.0,182.0,Defender - Centre-Back,right,Audax Italiano,14.0,0.0,0.0,1260.0,12.0,0.0,0.0,1001.0,21.0,0.0,0.0,1670.0,2.0,0.0,0.0,121.0,34.0,0.0,2.0,3120.0,29.0,0.0,0.0,2610.0,17.0,0.0,0.0,1302.0,20.0,0.0,0.0,1737.0,16.0,0.0,0.0,1308.0,Serie A,9.0,0.0,0.0,810.0,nan,nan,nan,nan,nan,nan,nan,nan,nan,nan,nan,nan,nan,nan,nan,nan,nan,nan,nan,nan,nan,nan,nan,nan,nan,nan,nan,nan,nan,nan,nan,nan,nan,nan,nan,nan,nan,nan,nan,nan,nan,nan,nan,nan,nan,nan,nan,nan,nan,nan,nan,nan,nan,nan,nan,nan,nan,nan,nan,nan,nan,nan,nan,nan,nan,nan,nan,nan,nan,nan,nan,nan,nan,nan,nan,nan,nan,nan,nan,nan,nan,nan,nan,nan,nan,nan,nan,nan
19/6/2011,Amara KallÃÂ©,85042570,31,9/19/1990,20,1,0,4,0,1361,5000,2722,140,100,86453,184,80,D C,2,1,3,1,2,2,1,4,2,2,3,4,5,6,7,7,6,14,7,8,13,7,6,12,7,15,13,15,11,8,8,11,14,6,7,6,11,13,11,13,9,15,12,5,15,11,20,14,15,11,15,7,7,8,11,14,12,12,14,14,16,5,20,10,1,1,12,1,20,D C,101,1,1,1,1,1,1,20,1,12,1,1,1,1,1,10,32768.0,0,0,0,0,0,0,0,0,0,0,0,0,0,0,0,1,0,0,0,0,0,0,0,0,0,0,0,0,0,0,0,0,0,0,0,0,0,0,0,0,0,0,0,0,0,0,0,0,Amara KallÃÂ©,ÃÂ£45Th. ,30.0,184.0,Defender - Centre-Back,right,Unknown,0.0,0.0,0.0,0.0,nan,nan,nan,nan,nan,nan,nan,nan,nan,nan,nan,nan,nan,nan,nan,nan,nan,nan,nan,nan,nan,nan,nan,nan,nan,nan,nan,nan,nan,nan,nan,nan,Ligue 1,nan,nan,nan,nan,nan,nan,nan,nan,29/6/2010,MorikÃÂ© KallÃÂ©,85042570.0,31.0,9/19/1990,19.0,1.0,0.0,4.0,0.0,2100.0,5500.0,2750.0,145.0,110.0,1892779.0,184.0,78.0,D C,1.0,3.0,3.0,2.0,2.0,2.0,1.0,3.0,2.0,3.0,1.0,5.0,5.0,6.0,7.0,8.0,6.0,13.0,7.0,8.0,14.0,7.0,6.0,12.0,8.0,13.0,13.0,17.0,11.0,13.0,8.0,12.0,14.0,6.0,10.0,6.0,11.0,15.0,13.0,13.0,9.0,14.0,12.0,5.0,13.0,11.0,20.0,14.0,14.0,13.0,13.0,5.0,7.0,8.0,11.0,14.0,12.0,12.0,14.0,14.0,16.0,5.0,nan,nan,nan
19/6/2011,Abdoulaye,55024504,41,1/1/1991,20,0,0,0,0,2029,5039,5250,144,112,113393,197,79,D C,1,3,3,2,2,2,3,6,1,1,3,7,7,6,9,10,8,14,7,8,11,9,11,10,10,13,13,12,10,8,8,10,13,7,14,8,11,11,11,13,12,12,15,12,14,12,20,10,11,12,13,10,8,11,14,18,12,15,15,14,12,5,20,1,1,1,1,1,20,D C,101,1,1,1,1,1,1,20,1,1,1,1,1,1,1,1,0.0,0,0,0,0,0,0,0,0,0,0,0,0,0,0,0,0,0,0,0,0,0,0,0,0,0,0,0,0,0,0,0,0,0,0,0,0,0,0,0,0,0,0,0,0,0,0,0,0,Abdoulaye Ba,ÃÂ£540Th. ,29.0,197.0,Defender - Centre-Back,right,Dinamo Bucharest,28.0,9.0,0.0,2429.0,26.0,2.0,0.0,2309.0,23.0,2.0,0.0,1660.0,23.0,1.0,0.0,1921.0,20.0,0.0,0.0,1621.0,18.0,1.0,0.0,1452.0,28.0,4.0,0.0,2490.0,18.0,0.0,0.0,1413.0,27.0,1.0,0.0,2202.0,Liga NOS,4.0,0.0,0.0,244.0,1.0,0.0,0.0,16.0,nan,nan,nan,nan,nan,nan,nan,nan,nan,nan,nan,nan,nan,nan,nan,nan,nan,nan,nan,nan,nan,nan,nan,nan,nan,nan,nan,nan,nan,nan,nan,nan,nan,nan,nan,nan,nan,nan,nan,nan,nan,nan,nan,nan,nan,nan,nan,nan,nan,nan,nan,nan,nan,nan,nan,nan,nan,nan,nan,nan,nan,nan,nan,nan,nan,nan,nan,nan,nan,nan,nan,nan,nan,nan,nan,nan,nan,nan,nan,nan,nan,nan,nan,nan
19/6/2011,Zarko Tomasevic,62055352,62002127,2/22/1990,21,2,0,7,0,1750,5775,5250,133,105,142876,190,78,D C,2,1,1,1,2,1,2,1,2,2,1,8,9,7,8,9,8,13,7,10,13,8,10,12,9,13,12,10,13,12,7,9,13,6,12,9,12,11,11,11,9,8,15,20,14,11,10,11,14,11,9,10,8,12,13,12,11,14,14,14,14,5,20,1,1,1,10,10,20,D C,101,1,10,1,1,1,1,20,10,10,5,1,1,1,1,1,0.0,0,0,0,0,0,0,0,0,0,0,0,0,0,0,0,0,0,0,0,0,0,0,0,0,0,0,0,0,0,0,0,0,0,0,0,0,0,0,0,0,0,0,0,0,0,0,0,0,Zarko Tomasevic,ÃÂ£675Th. ,30.0,190.0,Defender - Centre-Back,left,FC Astana,11.0,0.0,0.0,605.0,13.0,1.0,0.0,978.0,0.0,0.0,0.0,0.0,35.0,1.0,2.0,3060.0,40.0,4.0,2.0,3427.0,35.0,5.0,3.0,2971.0,25.0,0.0,1.0,1974.0,36.0,2.0,0.0,3088.0,23.0,1.0,2.0,1968.0,Liga NOS,10.0,1.0,0.0,700.0,nan,nan,nan,nan,29/6/2010,Zarko Tomasevic,62055352.0,62002127.0,2/22/1990,20.0,1.0,0.0,3.0,0.0,1750.0,5650.0,5250.0,133.0,106.0,1099293.0,190.0,78.0,D C,3.0,1.0,3.0,1.0,1.0,3.0,2.0,2.0,2.0,1.0,3.0,8.0,9.0,7.0,8.0,9.0,8.0,13.0,7.0,10.0,13.0,8.0,10.0,12.0,9.0,13.0,12.0,10.0,13.0,12.0,7.0,9.0,13.0,6.0,12.0,9.0,12.0,11.0,11.0,11.0,9.0,8.0,15.0,20.0,14.0,11.0,10.0,11.0,14.0,11.0,9.0,10.0,8.0,12.0,13.0,12.0,14.0,14.0,14.0,14.0,14.0,5.0,Zarko Tomasevic,ÃÂÃÂ£720Th. ,Liga NOS
19/6/2011,Yvan Erichot,34001053,769,3/25/1990,21,0,0,0,0,1655,4454,3355,135,99,45326,190,80,D C,3,2,2,1,3,1,3,3,3,1,2,5,9,7,5,8,6,14,7,8,12,7,6,10,8,13,13,13,8,8,7,9,9,6,7,6,11,13,12,15,12,15,16,5,11,14,20,11,15,11,13,13,7,6,14,3,13,5,16,15,14,14,20,14,1,1,14,1,20,D C,101,1,1,1,1,1,1,20,1,14,1,1,1,1,1,14,0.0,0,0,0,0,0,0,0,0,0,0,0,0,0,0,0,0,0,0,0,0,0,0,0,0,0,0,0,0,0,0,0,0,0,0,0,0,0,0,0,0,0,0,0,0,0,0,0,0,Yvan Erichot,ÃÂ£180Th. ,30.0,188.0,Defender - Centre-Back,right,Without Club,10.0,0.0,0.0,624.0,2.0,0.0,0.0,180.0,7.0,0.0,0.0,630.0,25.0,1.0,0.0,2119.0,28.0,3.0,0.0,2520.0,31.0,0.0,0.0,2732.0,20.0,0.0,0.0,1684.0,21.0,0.0,0.0,1851.0,1.0,0.0,0.0,16.0,Liga NOS,1.0,0.0,0.0,90.0,nan,nan,nan,nan,nan,nan,nan,nan,nan,nan,nan,nan,nan,nan,nan,nan,nan,nan,nan,nan,nan,nan,nan,nan,nan,nan,nan,nan,nan,nan,nan,nan,nan,nan,nan,nan,nan,nan,nan,nan,nan,nan,nan,nan,nan,nan,nan,nan,nan,nan,nan,nan,nan,nan,nan,nan,nan,nan,nan,nan,nan,nan,nan,nan,nan,nan,nan,nan,nan,nan,nan,nan,nan,nan,nan,nan,nan,nan,nan,nan,nan,nan,nan,nan,nan,nan,nan,nan
19/6/2011,Thiago Veras,19055328,1651,3/1/1990,21,0,0,0,0,880,4750,4750,119,95,67803,184,79,D C,1,3,1,1,2,1,3,1,3,2,2,5,5,6,10,9,14,11,14,5,13,9,12,12,8,17,10,15,7,11,7,9,14,5,13,7,11,15,13,10,8,13,12,10,14,9,20,14,14,13,13,9,8,7,10,12,11,11,12,10,9,13,20,1,5,1,1,7,20,D C,101,1,11,1,1,1,1,20,7,1,14,5,1,1,1,1,68719477504.0,0,0,0,0,0,0,0,0,1,1,0,0,0,0,0,0,0,0,0,0,0,0,0,0,0,0,0,0,0,0,0,0,0,0,0,0,1,0,0,0,0,0,0,0,0,0,0,0,Thiago Veras,ÃÂ£180Th. ,30.0,184.0,Defender - Centre-Back,right,Without Club,nan,nan,nan,nan,5.0,0.0,0.0,302.0,nan,nan,nan,nan,nan,nan,nan,nan,nan,nan,nan,nan,nan,nan,nan,nan,nan,nan,nan,nan,nan,nan,nan,nan,nan,nan,nan,nan,Liga NOS,nan,nan,nan,nan,nan,nan,nan,nan,nan,nan,nan,nan,nan,nan,nan,nan,nan,nan,nan,nan,nan,nan,nan,nan,nan,nan,nan,nan,nan,nan,nan,nan,nan,nan,nan,nan,nan,nan,nan,nan,nan,nan,nan,nan,nan,nan,nan,nan,nan,nan,nan,nan,nan,nan,nan,nan,nan,nan,nan,nan,nan,nan,nan,nan,nan,nan,nan,nan,nan,nan,nan,nan,nan,nan,nan,nan,nan,nan,nan,nan,nan,nan,nan,nan,nan,nan,nan,nan,nan,nan,nan,nan
19/6/2011,TamÃÂ¡s KÃÂ¡dÃÂ¡r,38001846,773,3/14/1990,21,1,0,7,0,3000,5500,5600,143,110,1058008,188,72,D LC,3,3,3,2,1,3,1,2,2,2,2,5,8,10,5,13,5,11,8,10,12,8,8,14,11,16,10,16,11,10,8,12,13,10,7,8,13,10,11,14,14,11,12,20,10,12,7,13,13,12,12,10,15,9,12,16,10,12,12,8,13,5,20,10,1,1,1,19,20,D LC,104,1,1,1,1,1,1,20,19,1,1,1,1,1,10,1,0.0,0,0,0,0,0,0,0,0,0,0,0,0,0,0,0,0,0,0,0,0,0,0,0,0,0,0,0,0,0,0,0,0,0,0,0,0,0,0,0,0,0,0,0,0,0,0,0,0,TamÃÂ¡s KÃÂ¡dÃÂ¡r,ÃÂ£450Th. ,30.0,188.0,Defender - Centre-Back,left,Shandong Luneng Taishan,5.0,0.0,0.0,401.0,9.0,0.0,0.0,765.0,26.0,1.0,0.0,2123.0,32.0,1.0,1.0,2765.0,34.0,0.0,1.0,2729.0,44.0,0.0,2.0,3631.0,32.0,1.0,0.0,2793.0,36.0,0.0,3.0,3195.0,35.0,0.0,1.0,2933.0,Premier League,33.0,0.0,1.0,2683.0,nan,nan,nan,nan,29/6/2010,TamÃÂ¡s KÃÂ¡dÃÂ¡r,38001846.0,773.0,3/14/1990,20.0,0.0,0.0,1.0,0.0,3000.0,4949.0,5600.0,150.0,110.0,8221322.0,188.0,72.0,D LC,1.0,3.0,3.0,2.0,3.0,1.0,1.0,2.0,2.0,3.0,2.0,5.0,8.0,10.0,5.0,13.0,5.0,11.0,8.0,10.0,12.0,8.0,8.0,14.0,11.0,16.0,10.0,16.0,11.0,10.0,8.0,12.0,13.0,10.0,7.0,8.0,13.0,10.0,11.0,14.0,14.0,11.0,12.0,20.0,10.0,12.0,7.0,13.0,13.0,12.0,12.0,10.0,12.0,9.0,12.0,16.0,10.0,12.0,12.0,8.0,13.0,5.0,nan,nan,nan
19/6/2011,Pape SouarÃÂ©,85032332,41,6/6/1990,21,0,0,0,0,4300,6000,5416,145,120,972852,178,68,D/WB LC,2,3,1,3,2,3,3,2,3,2,3,5,9,8,10,11,5,14,7,7,11,8,8,11,11,11,15,14,13,13,7,12,17,7,9,8,13,13,14,15,12,13,9,8,15,15,20,14,10,14,11,12,7,10,13,15,13,13,14,17,17,5,20,16,1,1,10,20,15,D/WB LC,114,1,1,1,1,1,1,15,20,10,1,1,1,1,16,10,0.0,0,0,0,0,0,0,0,0,0,0,0,0,0,0,0,0,0,0,0,0,0,0,0,0,0,0,0,0,0,0,0,0,0,0,0,0,0,0,0,0,0,0,0,0,0,0,0,0,Pape SouarÃÂ©,ÃÂ£720Th. ,30.0,178.0,Defender - Left-Back,left,Without Club,5.0,0.0,0.0,210.0,8.0,0.0,0.0,378.0,25.0,0.0,1.0,1897.0,36.0,3.0,0.0,3168.0,32.0,0.0,0.0,2449.0,41.0,0.0,3.0,3659.0,4.0,0.0,0.0,360.0,4.0,0.0,0.0,155.0,4.0,0.0,0.0,126.0,Ligue 1,17.0,0.0,0.0,1359.0,nan,nan,nan,nan,29/6/2010,Pape SouarÃÂ©,85032332.0,41.0,6/6/1990,20.0,0.0,0.0,0.0,0.0,1400.0,5600.0,2800.0,145.0,112.0,6583628.0,178.0,68.0,D/WB L,1.0,3.0,1.0,2.0,3.0,2.0,2.0,2.0,3.0,1.0,2.0,5.0,8.0,8.0,10.0,11.0,5.0,14.0,7.0,7.0,10.0,8.0,8.0,11.0,11.0,11.0,15.0,14.0,13.0,13.0,7.0,12.0,17.0,7.0,9.0,8.0,13.0,14.0,13.0,15.0,12.0,13.0,9.0,8.0,15.0,13.0,20.0,14.0,9.0,14.0,11.0,12.0,7.0,10.0,13.0,15.0,13.0,13.0,14.0,17.0,17.0,5.0,Pape SouarÃÂÃÂ©,ÃÂÃÂ£225Th. ,Ligue 1,19-06-17,18.3.4.28,Pape SouarÃÂ©,85032332,41,06-Jun-90,27,21,1,4,0,5300,6350,6500,142,130,22135292,178,68,D/WB L,3,1,3,3,2,1,1,1,1,1,2,9,13,13,8,12,7,16,9,9,15,12,10,13,12,14,13,12,13,13,12,13,16,6,10,14,13,12,14,11,14,14,11,20,13,12,10,14,14,15,12,12,3,13,13,15,13,13,14,17,17,5,20,20,10,10,10,20,1,D/WB L,113,1,1,1,1,10,1,1,20,10,1,1,10,1,20,5,0.0,0,0,0,0,0,0,0,0,0,0,0,0,0,0,0,0,0,0,0,0,0,0,0,0,0,0,0,0,0,0,0,0,0,0,0,0,0,0,0,0,0,0,0,0,0,0,0,0,Pape SouarÃÂ©,ÃÂ£3.15m ,30.0,178.0,Defender - Left-Back,left,Without Club,4.0,0.0,0.0,360.0,4.0,0.0,0.0,155.0,4.0,0.0,0.0,126.0,17.0,0.0,0.0,1359.0,nan,nan,nan,nan,Premier League,15-07-16,17.3.2.23,Pape SouarÃÂ©,85032332.0,41.0,06-Jun-90,26.0,22.0,1.0,4.0,0.0,5295.0,6345.0,6795.0,142.0,136.0,25718091.0,178.0,68.0,D/WB L,2.0,2.0,1.0,2.0,2.0,1.0,3.0,2.0,1.0,3.0,2.0,9.0,13.0,13.0,8.0,12.0,7.0,16.0,9.0,9.0,15.0,12.0,10.0,13.0,13.0,14.0,13.0,12.0,13.0,13.0,12.0,13.0,16.0,6.0,10.0,14.0,13.0,12.0,14.0,13.0,15.0,14.0,11.0,20.0,13.0,13.0,10.0,14.0,14.0,15.0,12.0,12.0,3.0,13.0,13.0,15.0,13.0,13.0,14.0,17.0,17.0,5.0,Pape SouarÃÂ©,ÃÂ£5.40m ,Premier League
19/6/2011,ÃÂmer Toprak,91000354,771,7/21/1989,21,0,0,3,1,4800,6350,6750,162,127,1061640,186,83,D C,1,2,1,1,1,1,2,1,1,3,2,7,7,8,10,10,8,15,7,8,14,13,8,14,10,12,10,8,12,12,12,10,17,12,10,11,11,12,13,14,15,15,14,10,10,15,20,14,13,13,5,11,12,6,12,17,14,13,15,14,7,12,20,1,1,1,14,12,20,D C,101,1,1,1,1,1,1,20,12,14,8,1,1,1,1,1,8800390000000.0,0,0,0,0,0,0,0,0,0,0,0,0,0,0,0,0,0,0,0,0,0,0,0,0,0,0,0,0,0,0,0,0,1,0,0,0,0,0,0,0,0,0,0,1,0,0,0,0,ÃÂmer Toprak,ÃÂ£4.50m ,31.0,187.0,Defender - Centre-Back,right,SV Werder Bremen,25.0,0.0,0.0,1672.0,34.0,0.0,1.0,2939.0,32.0,1.0,3.0,2757.0,39.0,3.0,1.0,3469.0,41.0,1.0,0.0,3641.0,25.0,1.0,0.0,1884.0,32.0,1.0,0.0,2732.0,36.0,0.0,2.0,2715.0,14.0,0.0,0.0,770.0,Bundesliga,13.0,0.0,0.0,898.0,2.0,0.0,0.0,103.0,29/6/2010,ÃÂmer Toprak,91000354.0,771.0,7/21/1989,20.0,0.0,0.0,0.0,0.0,2750.0,6000.0,6000.0,166.0,130.0,8369107.0,186.0,81.0,D C,2.0,3.0,1.0,2.0,2.0,3.0,2.0,3.0,1.0,3.0,2.0,7.0,7.0,8.0,10.0,10.0,8.0,15.0,7.0,8.0,15.0,13.0,8.0,14.0,10.0,12.0,10.0,10.0,12.0,12.0,12.0,11.0,17.0,12.0,10.0,11.0,12.0,12.0,13.0,14.0,15.0,15.0,14.0,10.0,10.0,15.0,20.0,14.0,13.0,15.0,5.0,11.0,12.0,6.0,12.0,17.0,14.0,13.0,15.0,14.0,7.0,12.0,ÃÂÃÂmer Toprak,ÃÂÃÂ£3.60m ,Bundesliga,19-06-17,18.3.4.28,ÃÂmer Toprak,91000354,799,21-Jul-89,27,26,2,0,0,5350,6750,7350,147,147,66621437,186,83,D C,1,1,1,3,3,2,2,3,2,2,1,5,8,8,10,11,5,13,5,9,16,10,7,15,11,12,17,14,12,15,8,12,11,6,14,7,16,15,12,14,12,15,13,12,14,16,20,13,14,15,6,13,8,10,8,13,13,10,16,16,12,5,20,8,11,1,12,10,20,D C,101,1,1,1,1,1,1,20,10,12,11,11,1,1,8,8,279173000000.0,0,0,0,0,0,0,0,0,0,0,0,0,0,0,0,0,0,0,0,0,0,0,0,0,0,0,0,0,0,0,0,0,1,0,0,0,0,0,1,0,0,0,0,0,0,0,0,0,ÃÂmer Toprak,ÃÂ£10.80m ,31.0,187.0,Defender - Centre-Back,right,SV Werder Bremen,32.0,1.0,0.0,2732.0,36.0,0.0,2.0,2715.0,14.0,0.0,0.0,770.0,13.0,0.0,0.0,898.0,2.0,0.0,0.0,103.0,Bundesliga,15-07-16,17.3.2.23,ÃÂmer Toprak,91000354.0,799.0,21-Jul-89,26.0,23.0,2.0,0.0,0.0,5689.0,6347.0,7595.0,147.0,147.0,12000000.0,186.0,83.0,D C,1.0,1.0,2.0,1.0,1.0,1.0,2.0,2.0,3.0,3.0,4.0,5.0,9.0,8.0,10.0,11.0,5.0,13.0,5.0,10.0,16.0,11.0,7.0,16.0,12.0,12.0,16.0,14.0,12.0,12.0,8.0,13.0,11.0,8.0,14.0,7.0,15.0,17.0,12.0,14.0,12.0,15.0,13.0,12.0,14.0,17.0,20.0,13.0,14.0,14.0,6.0,12.0,8.0,10.0,8.0,13.0,13.0,10.0,16.0,16.0,12.0,5.0,ÃÂmer Toprak,ÃÂ£14.40m ,Bundesliga
19/6/2011,Nicolas Nkoulou,12007662,11,3/27/1990,21,28,0,3,0,5450,6800,6100,165,136,1091533,180,77,D/DM C,3,1,3,1,2,3,3,7,2,3,2,5,7,11,6,13,6,13,9,8,16,12,7,13,13,12,14,15,14,13,11,11,15,9,13,7,15,15,14,15,13,16,11,5,15,14,20,15,16,13,14,16,7,12,9,15,14,13,17,9,15,7,20,12,10,1,12,1,20,D/DM C,111,5,1,7,1,1,1,20,1,12,16,10,1,1,1,12,274878000000.0,0,0,0,0,0,0,0,0,0,0,0,0,0,0,0,0,0,0,0,0,0,0,0,0,0,0,0,0,0,0,0,0,0,0,0,0,0,0,1,0,0,0,0,0,0,0,0,0,Nicolas N'Koulou,ÃÂ£7.20m ,30.0,184.0,Defender - Centre-Back,right,Torino FC,33.0,0.0,0.0,2737.0,46.0,0.0,0.0,4116.0,48.0,1.0,0.0,4297.0,46.0,2.0,0.0,4170.0,26.0,2.0,0.0,2322.0,41.0,0.0,0.0,3691.0,22.0,0.0,1.0,2040.0,39.0,2.0,0.0,3439.0,38.0,2.0,0.0,3370.0,Ligue 1,38.0,1.0,0.0,3275.0,4.0,0.0,0.0,286.0,29/6/2010,Nicolas Nkoulou,12007662.0,11.0,3/27/1990,20.0,20.0,0.0,4.0,0.0,4225.0,6500.0,5850.0,170.0,130.0,9285899.0,180.0,77.0,D/DM C,2.0,3.0,2.0,3.0,2.0,3.0,1.0,1.0,3.0,3.0,3.0,5.0,7.0,11.0,6.0,13.0,6.0,11.0,9.0,6.0,16.0,12.0,7.0,13.0,13.0,12.0,15.0,15.0,12.0,12.0,13.0,12.0,16.0,9.0,10.0,7.0,14.0,15.0,13.0,15.0,13.0,15.0,10.0,5.0,15.0,14.0,20.0,14.0,15.0,13.0,12.0,16.0,7.0,12.0,9.0,15.0,14.0,13.0,15.0,14.0,14.0,7.0,Nicolas N'Koulou,ÃÂÃÂ£4.50m ,Ligue 1,19-06-17,18.3.4.28,Nicolas Nkoulou,12007662,11,27-Mar-90,27,75,2,3,0,5750,7000,6750,141,136,13518229,184,77,D C,2,2,2,2,1,3,3,3,1,1,1,5,7,9,6,13,6,14,7,8,14,13,7,14,12,12,15,15,14,13,11,13,15,9,14,7,14,15,14,13,13,15,11,8,11,13,20,14,16,12,11,14,9,11,12,15,15,13,16,10,15,7,20,1,1,1,12,1,20,D C,101,1,1,1,1,1,1,20,1,12,12,1,1,1,1,1,274878000000.0,0,0,0,0,0,0,0,0,0,0,0,0,0,0,0,0,0,0,0,0,0,0,0,0,0,0,0,0,0,0,0,0,0,0,0,0,0,0,1,0,0,0,0,0,0,0,0,0,Nicolas N'Koulou,ÃÂ£9.00m ,30.0,184.0,Defender - Centre-Back,right,Torino FC,22.0,0.0,1.0,2040.0,39.0,2.0,0.0,3439.0,38.0,2.0,0.0,3370.0,38.0,1.0,0.0,3275.0,4.0,0.0,0.0,286.0,Serie A,15-07-16,17.3.2.23,Nicolas Nkoulou,12007662.0,11.0,27-Mar-90,26.0,69.0,1.0,3.0,0.0,5997.0,6997.0,6797.0,141.0,134.0,21118027.0,180.0,77.0,D C,3.0,1.0,2.0,1.0,2.0,3.0,1.0,1.0,3.0,3.0,2.0,5.0,8.0,10.0,6.0,13.0,6.0,14.0,9.0,8.0,14.0,12.0,7.0,14.0,12.0,12.0,15.0,15.0,14.0,13.0,11.0,13.0,15.0,9.0,14.0,7.0,14.0,15.0,13.0,14.0,13.0,16.0,11.0,8.0,12.0,14.0,20.0,13.0,14.0,13.0,14.0,14.0,9.0,12.0,9.0,15.0,15.0,13.0,16.0,9.0,15.0,7.0,Nicolas N'Koulou,ÃÂ£6.75m ,Ligue 1
19/6/2011,Neuton,19054771,1651,3/14/1990,21,0,0,0,0,3250,6750,6750,153,135,1338587,182,79,D LC,3,3,2,2,1,3,1,4,1,3,2,6,7,10,8,12,8,14,9,7,13,12,10,13,12,15,12,15,12,12,8,12,17,11,11,10,14,12,14,15,12,13,12,20,13,15,10,14,14,12,10,15,6,15,10,13,10,15,13,8,15,10,20,1,1,1,1,19,20,D LC,104,1,1,1,1,1,1,20,19,1,10,1,1,1,1,1,0.0,0,0,0,0,0,0,0,0,0,0,0,0,0,0,0,0,0,0,0,0,0,0,0,0,0,0,0,0,0,0,0,0,0,0,0,0,0,0,0,0,0,0,0,0,0,0,0,0,Neuton,ÃÂ£1.80m ,30.0,182.0,Defender - Centre-Back,left,Unknown,9.0,0.0,0.0,720.0,10.0,0.0,1.0,585.0,9.0,0.0,0.0,677.0,10.0,1.0,0.0,867.0,0.0,0.0,0.0,0.0,2.0,0.0,0.0,180.0,24.0,0.0,0.0,2098.0,31.0,0.0,4.0,2330.0,0.0,0.0,0.0,0.0,Serie A,nan,nan,nan,nan,nan,nan,nan,nan,nan,nan,nan,nan,nan,nan,nan,nan,nan,nan,nan,nan,nan,nan,nan,nan,nan,nan,nan,nan,nan,nan,nan,nan,nan,nan,nan,nan,nan,nan,nan,nan,nan,nan,nan,nan,nan,nan,nan,nan,nan,nan,nan,nan,nan,nan,nan,nan,nan,nan,nan,nan,nan,nan,nan,nan,nan,nan,nan,nan,nan,nan,nan,nan,nan,nan,nan,nan,nan,nan,nan,nan,nan,nan,nan,nan,nan,nan,nan,nan,nan,nan,nan,nan
19/6/2011,MoisÃÂ©s,67086924,796,10/31/1989,21,0,0,0,0,1777,4250,4250,119,87,118570,183,78,D C,2,1,3,1,3,2,1,5,3,1,3,3,3,2,3,11,3,10,6,4,14,11,3,14,7,6,6,13,8,12,3,11,9,6,5,7,14,11,12,8,11,7,11,9,14,10,20,11,5,9,5,4,4,10,12,9,8,6,10,14,7,14,20,1,1,1,1,1,20,D C,101,1,1,1,1,1,1,20,1,1,1,1,1,1,1,1,0.0,0,0,0,0,0,0,0,0,0,0,0,0,0,0,0,0,0,0,0,0,0,0,0,0,0,0,0,0,0,0,0,0,0,0,0,0,0,0,0,0,0,0,0,0,0,0,0,0,nan,nan,nan,nan,nan,nan,nan,nan,nan,nan,nan,nan,nan,nan,nan,nan,nan,nan,nan,nan,nan,nan,nan,nan,nan,nan,nan,nan,nan,nan,nan,nan,nan,nan,nan,nan,nan,nan,nan,nan,nan,nan,nan,nan,nan,nan,nan,nan,nan,nan,nan,nan,nan,nan,nan,nan,nan,nan,nan,nan,nan,nan,nan,nan,nan,nan,nan,nan,nan,nan,nan,nan,nan,nan,nan,nan,nan,nan,nan,nan,nan,nan,nan,nan,nan,nan,nan,nan,nan,nan,nan,nan,nan,nan,nan,nan,nan,nan,nan,nan,nan,nan,nan,nan,nan,nan,nan,nan,nan,nan,nan,nan,nan,nan,nan,nan,nan,nan,nan,nan,nan,nan,nan,nan,nan,nan,nan,nan,nan,nan,nan,nan,nan,nan,nan,nan
19/6/2011,Miguel VÃÂ­tor,55004194,788,6/30/1989,21,0,0,13,1,3500,5850,5850,138,117,577884,183,73,D RC,3,3,1,1,2,1,1,3,3,3,1,7,10,11,10,10,9,14,9,10,13,9,10,13,11,11,13,14,15,11,10,12,17,10,9,10,14,12,15,11,12,9,13,7,14,11,20,13,12,11,9,14,10,10,12,17,18,16,17,15,17,5,20,5,1,1,15,5,20,D RC,103,1,5,1,1,1,1,20,5,15,5,1,1,1,1,5,0.0,0,0,0,0,0,0,0,0,0,0,0,0,0,0,0,0,0,0,0,0,0,0,0,0,0,0,0,0,0,0,0,0,0,0,0,0,0,0,0,0,0,0,0,0,0,0,0,0,Miguel VÃÂ­tor,ÃÂ£1.35m ,31.0,184.0,Defender - Centre-Back,right,Hapoel Beer Sheva,17.0,3.0,0.0,1275.0,10.0,0.0,0.0,455.0,12.0,3.0,0.0,998.0,36.0,5.0,0.0,2938.0,41.0,2.0,0.0,3648.0,39.0,2.0,2.0,3264.0,30.0,3.0,1.0,2387.0,14.0,2.0,1.0,1041.0,10.0,1.0,0.0,760.0,Liga NOS,39.0,4.0,2.0,3296.0,7.0,1.0,0.0,619.0,nan,nan,nan,nan,nan,nan,nan,nan,nan,nan,nan,nan,nan,nan,nan,nan,nan,nan,nan,nan,nan,nan,nan,nan,nan,nan,nan,nan,nan,nan,nan,nan,nan,nan,nan,nan,nan,nan,nan,nan,nan,nan,nan,nan,nan,nan,nan,nan,nan,nan,nan,nan,nan,nan,nan,nan,nan,nan,nan,nan,nan,nan,nan,nan,nan,nan,nan,nan,nan,nan,nan,nan,nan,nan,nan,nan,nan,nan,nan,nan,nan,nan,nan,nan
19/6/2011,Martin Kelly,28010835,765,4/27/1990,21,0,0,2,1,4900,6500,6500,155,130,3728157,191,78,D RC,1,1,3,2,2,3,2,7,1,3,3,4,11,9,5,13,5,14,6,7,13,12,4,15,13,11,13,15,15,15,10,12,14,4,9,9,13,12,12,9,10,12,15,11,11,15,20,15,13,14,9,14,14,15,20,12,14,10,14,14,10,5,20,14,1,1,19,10,20,D RC,103,1,1,1,1,1,1,20,10,19,1,1,1,1,1,14,0.0,0,0,0,0,0,0,0,0,0,0,0,0,0,0,0,0,0,0,0,0,0,0,0,0,0,0,0,0,0,0,0,0,0,0,0,0,0,0,0,0,0,0,0,0,0,0,0,0,Martin Kelly,ÃÂ£4.50m ,30.0,191.0,Defender - Right-Back,right,Crystal Palace,23.0,0.0,1.0,1925.0,20.0,1.0,1.0,1621.0,7.0,0.0,1.0,560.0,13.0,0.0,1.0,699.0,34.0,0.0,1.0,2741.0,17.0,1.0,0.0,1462.0,34.0,0.0,2.0,2559.0,19.0,0.0,0.0,1554.0,20.0,0.0,0.0,1712.0,Premier League,21.0,0.0,1.0,1685.0,2.0,0.0,0.0,151.0,nan,nan,nan,nan,nan,nan,nan,nan,nan,nan,nan,nan,nan,nan,nan,nan,nan,nan,nan,nan,nan,nan,nan,nan,nan,nan,nan,nan,nan,nan,nan,nan,nan,nan,nan,nan,nan,nan,nan,nan,nan,nan,nan,nan,nan,nan,nan,nan,nan,nan,nan,nan,nan,nan,nan,nan,nan,nan,nan,nan,nan,nan,nan,nan,nan,nan,nan,nan,nan,nan,nan,nan,nan,nan,nan,nan,nan,nan,nan,nan,nan,nan,nan,nan,19-06-17,18.3.4.28,Martin Kelly,28010835,765,27-Apr-90,27,1,0,8,3,4900,6500,6250,130,125,13042350,191,78,D RC,2,2,1,3,2,1,1,2,3,2,2,4,8,8,10,12,5,12,2,6,11,12,5,14,12,13,12,16,12,14,13,13,14,5,10,10,14,11,16,12,13,13,13,11,10,13,20,15,14,7,17,11,14,13,16,12,14,12,14,14,12,5,20,14,1,1,20,10,16,D RC,103,1,1,1,1,1,1,16,10,20,1,1,1,1,1,14,0.0,0,0,0,0,0,0,0,0,0,0,0,0,0,0,0,0,0,0,0,0,0,0,0,0,0,0,0,0,0,0,0,0,0,0,0,0,0,0,0,0,0,0,0,0,0,0,0,0,Martin Kelly,ÃÂ£2.70m ,30.0,191.0,Defender - Right-Back,right,Crystal Palace,34.0,0.0,2.0,2559.0,19.0,0.0,0.0,1554.0,20.0,0.0,0.0,1712.0,21.0,0.0,1.0,1685.0,2.0,0.0,0.0,151.0,Premier League,15-07-16,17.3.2.23,Martin Kelly,28010835.0,765.0,27-Apr-90,26.0,1.0,0.0,8.0,3.0,4900.0,6500.0,6500.0,130.0,125.0,11053229.0,191.0,78.0,D RC,1.0,3.0,3.0,1.0,1.0,3.0,1.0,3.0,3.0,3.0,2.0,4.0,8.0,8.0,10.0,12.0,5.0,12.0,2.0,6.0,11.0,12.0,5.0,14.0,12.0,13.0,12.0,16.0,12.0,14.0,13.0,13.0,14.0,5.0,10.0,10.0,14.0,11.0,16.0,12.0,13.0,13.0,13.0,11.0,10.0,13.0,20.0,15.0,14.0,7.0,17.0,11.0,14.0,13.0,19.0,12.0,14.0,12.0,14.0,14.0,12.0,5.0,Martin Kelly,ÃÂ£2.70m ,Premier League
19/6/2011,Mamadou Sakho,34000070,769,2/13/1990,21,4,0,17,1,5950,7350,6600,170,147,5045989,187,83,D C,3,3,2,3,1,2,2,3,3,2,1,4,7,8,7,11,6,16,8,10,17,9,7,15,11,13,14,17,16,12,8,13,16,11,17,8,14,14,15,13,12,18,14,20,15,11,8,16,18,15,13,16,9,6,5,18,14,15,15,13,12,7,20,1,1,1,1,14,20,D C,101,1,1,1,1,1,1,20,14,1,1,1,1,1,1,1,141734000000.0,0,0,0,0,0,0,0,0,0,0,0,0,0,0,0,1,0,0,0,0,0,0,0,0,0,0,0,0,0,0,0,0,1,0,0,0,0,1,0,0,0,0,0,0,0,0,0,0,Mamadou Sakho,ÃÂ£14.40m ,30.0,187.0,Defender - Centre-Back,left,Crystal Palace,50.0,4.0,1.0,4387.0,26.0,0.0,0.0,2117.0,34.0,2.0,0.0,2746.0,20.0,1.0,0.0,1640.0,28.0,0.0,0.0,2342.0,34.0,2.0,0.0,2823.0,14.0,1.0,0.0,1227.0,20.0,1.0,2.0,1690.0,27.0,0.0,0.0,2417.0,Ligue 1,14.0,0.0,0.0,931.0,5.0,0.0,0.0,304.0,29/6/2010,Mamadou Sakho,34000070.0,769.0,2/13/1990,20.0,0.0,0.0,17.0,1.0,4556.0,6074.0,6050.0,168.0,135.0,25472539.0,187.0,83.0,D LC,2.0,3.0,3.0,3.0,2.0,1.0,1.0,1.0,3.0,3.0,1.0,5.0,7.0,9.0,6.0,11.0,6.0,16.0,8.0,10.0,15.0,8.0,7.0,14.0,11.0,13.0,14.0,16.0,15.0,11.0,9.0,12.0,16.0,11.0,16.0,8.0,14.0,14.0,15.0,12.0,11.0,17.0,14.0,20.0,15.0,11.0,8.0,15.0,17.0,13.0,13.0,14.0,8.0,7.0,12.0,17.0,14.0,17.0,15.0,13.0,13.0,7.0,Mamadou Sakho,ÃÂÃÂ£14.40m ,Ligue 1
19/6/2011,Kyle Walker,28009441,765,5/28/1990,21,0,0,7,0,5000,6700,6750,165,132,4925404,178,74,D RC,1,3,3,3,2,1,2,1,2,1,2,2,13,14,7,13,4,12,10,16,10,11,1,14,12,11,13,15,14,10,11,12,12,10,7,12,10,12,15,17,15,14,10,8,12,18,20,16,14,11,5,12,6,18,9,15,10,10,11,8,10,2,20,5,10,10,20,2,15,D RC,103,1,1,10,1,1,10,15,2,20,1,1,1,10,1,5,134217760.0,0,0,0,0,0,1,0,0,0,0,0,0,0,0,0,0,0,0,0,0,0,0,0,0,0,0,0,1,0,0,0,0,0,0,0,0,0,0,0,0,0,0,0,0,0,0,0,0,Kyle Walker,ÃÂ£14.40m ,30.0,183.0,Defender - Right-Back,right,Manchester City,39.0,2.0,7.0,3328.0,47.0,2.0,2.0,4027.0,50.0,0.0,6.0,4349.0,34.0,1.0,4.0,2991.0,22.0,0.0,0.0,1824.0,35.0,1.0,3.0,3123.0,39.0,0.0,5.0,3176.0,48.0,0.0,7.0,3842.0,52.0,2.0,1.0,4301.0,Premier League,42.0,1.0,6.0,3454.0,8.0,0.0,0.0,684.0,nan,nan,nan,nan,nan,nan,nan,nan,nan,nan,nan,nan,nan,nan,nan,nan,nan,nan,nan,nan,nan,nan,nan,nan,nan,nan,nan,nan,nan,nan,nan,nan,nan,nan,nan,nan,nan,nan,nan,nan,nan,nan,nan,nan,nan,nan,nan,nan,nan,nan,nan,nan,nan,nan,nan,nan,nan,nan,nan,nan,nan,nan,nan,nan,nan,nan,nan,nan,nan,nan,nan,nan,nan,nan,nan,nan,nan,nan,nan,nan,nan,nan,nan,nan,19-06-17,18.3.4.28,Kyle Walker,28009441,765,28-May-90,27,27,0,7,0,7000,7750,7750,157,154,72250405,182,80,D/WB R,1,2,1,3,2,1,2,3,1,2,3,11,13,13,7,12,12,14,7,13,12,13,6,13,13,12,13,15,13,13,11,9,13,10,12,13,12,15,16,18,15,15,12,10,13,18,20,15,15,14,5,12,6,14,19,15,14,7,8,12,11,7,20,18,5,5,20,10,12,D/WB R,112,1,1,1,1,1,5,12,10,20,1,1,1,5,1,18,134217760.0,0,0,0,0,0,1,0,0,0,0,0,0,0,0,0,0,0,0,0,0,0,0,0,0,0,0,0,1,0,0,0,0,0,0,0,0,0,0,0,0,0,0,0,0,0,0,0,0,Kyle Walker,ÃÂ£45.00m ,30.0,183.0,Defender - Right-Back,right,Manchester City,39.0,0.0,5.0,3176.0,48.0,0.0,7.0,3842.0,52.0,2.0,1.0,4301.0,42.0,1.0,6.0,3454.0,8.0,0.0,0.0,684.0,Premier League,15-07-16,17.3.2.23,Kyle Walker,28009441.0,765.0,28-May-90,26.0,19.0,0.0,7.0,0.0,6000.0,7500.0,7500.0,151.0,148.0,76525627.0,183.0,74.0,D/WB R,1.0,2.0,3.0,3.0,3.0,1.0,2.0,2.0,2.0,4.0,2.0,13.0,13.0,14.0,7.0,12.0,12.0,15.0,7.0,14.0,12.0,12.0,6.0,13.0,12.0,11.0,13.0,15.0,13.0,13.0,11.0,9.0,13.0,10.0,12.0,12.0,12.0,15.0,16.0,18.0,15.0,15.0,12.0,10.0,13.0,18.0,20.0,15.0,15.0,13.0,5.0,12.0,6.0,14.0,10.0,15.0,14.0,7.0,8.0,12.0,11.0,7.0,Kyle Walker,ÃÂ£27.00m ,Premier League
19/6/2011,Jean-Armel Kana-Biyik,34011545,11,7/3/1989,21,0,0,0,0,4600,5804,5800,165,129,647616,183,86,D C,2,3,3,3,1,1,2,1,1,2,3,5,10,9,6,11,7,13,8,8,14,9,6,15,11,14,14,16,12,12,7,11,15,7,8,7,14,13,14,15,12,16,11,5,15,14,20,14,16,13,14,16,5,10,12,16,13,15,8,14,14,12,20,10,1,1,10,10,20,D C,101,1,1,1,1,1,1,20,10,10,1,1,1,1,10,10,0.0,0,0,0,0,0,0,0,0,0,0,0,0,0,0,0,0,0,0,0,0,0,0,0,0,0,0,0,0,0,0,0,0,0,0,0,0,0,0,0,0,0,0,0,0,0,0,0,0,Jean-Armel Kana-Biyik,ÃÂ£5.85m ,31.0,184.0,Defender - Centre-Back,right,Gaziantep FK,32.0,1.0,0.0,2845.0,45.0,1.0,2.0,3843.0,34.0,0.0,0.0,2944.0,27.0,1.0,0.0,2337.0,13.0,1.0,0.0,1078.0,19.0,2.0,0.0,1576.0,29.0,0.0,0.0,2238.0,33.0,1.0,1.0,2589.0,30.0,0.0,0.0,2475.0,Ligue 1,33.0,1.0,0.0,2959.0,6.0,1.0,0.0,540.0,29/6/2010,Jean-Armel Kana-Biyik,34011545.0,769.0,7/3/1989,20.0,0.0,0.0,5.0,1.0,3450.0,5309.0,5300.0,160.0,118.0,3999999.0,183.0,86.0,D LC,3.0,2.0,2.0,1.0,2.0,2.0,3.0,6.0,1.0,2.0,2.0,5.0,10.0,9.0,6.0,11.0,7.0,13.0,8.0,8.0,13.0,7.0,6.0,15.0,11.0,11.0,12.0,13.0,12.0,12.0,6.0,11.0,15.0,8.0,8.0,7.0,12.0,13.0,13.0,15.0,9.0,15.0,11.0,5.0,15.0,14.0,20.0,14.0,15.0,14.0,11.0,16.0,5.0,10.0,9.0,16.0,13.0,15.0,13.0,14.0,14.0,7.0,Jean-Armel Kana-Biyik,ÃÂÃÂ£4.05m ,Ligue 1
19/6/2011,Ignacio Fideleff,14008463,1649,7/4/1989,21,0,0,9,1,3000,5174,5000,142,115,467800,188,82,D C,3,1,2,2,2,1,1,2,2,2,3,4,6,8,8,8,4,15,9,8,14,9,9,13,7,15,12,13,11,11,8,10,12,6,8,9,12,10,12,12,11,14,15,20,12,12,6,14,15,11,13,10,14,12,9,16,10,11,15,13,11,9,20,1,1,1,1,10,20,D C,101,1,1,1,1,1,1,20,10,1,1,1,1,1,1,1,2251800000000000.0,0,0,0,0,0,0,0,0,1,0,0,0,0,0,0,0,0,0,0,0,0,0,0,0,0,0,0,0,0,0,0,0,0,0,0,0,0,0,0,0,0,0,0,0,0,0,0,0,Ignacio Fideleff,ÃÂ£1.80m ,31.0,188.0,Defender - Centre-Back,left,Retired,13.0,2.0,0.0,993.0,9.0,0.0,0.0,728.0,8.0,0.0,0.0,433.0,17.0,0.0,0.0,1379.0,7.0,1.0,0.0,630.0,nan,nan,nan,nan,nan,nan,nan,nan,nan,nan,nan,nan,nan,nan,nan,nan,Serie A,nan,nan,nan,nan,nan,nan,nan,nan,nan,nan,nan,nan,nan,nan,nan,nan,nan,nan,nan,nan,nan,nan,nan,nan,nan,nan,nan,nan,nan,nan,nan,nan,nan,nan,nan,nan,nan,nan,nan,nan,nan,nan,nan,nan,nan,nan,nan,nan,nan,nan,nan,nan,nan,nan,nan,nan,nan,nan,nan,nan,nan,nan,nan,nan,nan,nan,nan,nan,nan,nan,nan,nan,nan,nan,nan,nan,nan,nan,nan,nan,nan,nan,nan,nan,nan,nan,nan,nan,nan,nan,nan,nan
19/6/2011,Grzegorz Krychowiak,34012402,787,1/29/1990,21,1,0,3,0,3400,5800,3800,140,116,140567,186,83,DM C,3,2,3,1,1,1,2,3,3,1,3,5,9,9,7,12,11,15,13,6,12,13,7,11,12,14,13,17,10,13,11,11,15,8,11,9,13,14,15,10,11,16,13,5,15,12,20,15,16,15,14,14,5,10,11,14,14,14,16,13,13,5,15,1,13,10,1,1,15,DM C,301,1,1,1,10,1,1,15,1,1,20,13,1,1,1,1,0.0,0,0,0,0,0,0,0,0,0,0,0,0,0,0,0,0,0,0,0,0,0,0,0,0,0,0,0,0,0,0,0,0,0,0,0,0,0,0,0,0,0,0,0,0,0,0,0,0,Grzegorz Krychowiak,ÃÂ£900Th. ,30.0,187.0,Midfielder - Defensive Midfield,right,Lokomotiv Moscow,40.0,2.0,1.0,3496.0,23.0,0.0,0.0,1958.0,36.0,4.0,1.0,3134.0,36.0,4.0,1.0,2914.0,48.0,4.0,1.0,4101.0,42.0,1.0,5.0,3655.0,19.0,0.0,0.0,1025.0,31.0,0.0,3.0,1989.0,39.0,2.0,4.0,3497.0,Ligue 1,33.0,10.0,5.0,2896.0,12.0,2.0,0.0,1012.0,nan,nan,nan,nan,nan,nan,nan,nan,nan,nan,nan,nan,nan,nan,nan,nan,nan,nan,nan,nan,nan,nan,nan,nan,nan,nan,nan,nan,nan,nan,nan,nan,nan,nan,nan,nan,nan,nan,nan,nan,nan,nan,nan,nan,nan,nan,nan,nan,nan,nan,nan,nan,nan,nan,nan,nan,nan,nan,nan,nan,nan,nan,nan,nan,nan,nan,nan,nan,nan,nan,nan,nan,nan,nan,nan,nan,nan,nan,nan,nan,nan,nan,nan,nan,19-06-17,18.3.4.28,Grzegorz Krychowiak,34012402,787,29-Jan-90,27,45,2,7,3,6246,7496,7000,152,136,14598286,186,83,DM/M C,3,2,3,3,1,3,1,3,1,3,2,4,6,8,8,12,8,14,12,6,15,13,13,15,12,17,15,17,13,15,12,12,15,7,16,10,14,16,15,11,11,16,13,10,16,12,20,17,14,14,14,14,5,10,18,14,16,14,13,11,12,5,15,1,17,1,1,1,17,DM/M C,311,1,1,1,1,1,1,15,1,1,20,17,1,1,1,1,140746000000000.0,0,0,0,0,0,0,0,0,0,0,0,0,0,0,0,0,0,0,0,1,0,0,0,0,0,0,0,0,0,0,0,0,0,1,0,0,0,0,0,0,0,0,0,0,0,0,0,1,Grzegorz Krychowiak,ÃÂ£16.20m ,30.0,187.0,Midfielder - Defensive Midfield,right,Lokomotiv Moscow,19.0,0.0,0.0,1025.0,31.0,0.0,3.0,1989.0,39.0,2.0,4.0,3497.0,33.0,10.0,5.0,2896.0,12.0,2.0,0.0,1012.0,Premier League,15-07-16,17.3.2.23,Grzegorz Krychowiak,34012402.0,787.0,29-Jan-90,26.0,39.0,2.0,7.0,3.0,6248.0,7498.0,7048.0,156.0,148.0,19801155.0,186.0,83.0,DM/M C,2.0,2.0,3.0,1.0,3.0,3.0,2.0,2.0,3.0,2.0,3.0,4.0,6.0,8.0,8.0,12.0,8.0,15.0,13.0,6.0,15.0,13.0,13.0,15.0,12.0,17.0,15.0,19.0,13.0,15.0,11.0,12.0,16.0,7.0,16.0,10.0,16.0,18.0,18.0,11.0,11.0,16.0,15.0,10.0,16.0,14.0,20.0,17.0,17.0,16.0,14.0,14.0,5.0,10.0,18.0,13.0,16.0,14.0,16.0,11.0,11.0,5.0,Grzegorz Krychowiak,ÃÂ£22.50m ,Ligue 1
19/6/2011,Giuseppe Bellusci,43000005,776,8/21/1989,21,0,0,6,0,4000,5850,5850,150,117,287761,185,81,D RC,2,3,2,3,3,2,2,1,1,3,3,5,10,8,5,5,5,15,5,11,15,10,5,15,10,16,13,12,10,12,10,13,16,5,8,9,15,11,11,12,13,11,13,5,18,10,20,11,15,10,16,10,2,12,7,15,13,10,16,11,9,7,20,1,1,1,15,1,20,D RC,103,1,1,1,1,1,1,20,1,15,1,1,1,1,1,1,32768.0,0,0,0,0,0,0,0,0,0,0,0,0,0,0,0,1,0,0,0,0,0,0,0,0,0,0,0,0,0,0,0,0,0,0,0,0,0,0,0,0,0,0,0,0,0,0,0,0,Giuseppe Bellusci,ÃÂ£1.98m ,31.0,184.0,Defender - Centre-Back,right,AC Monza,10.0,0.0,0.0,616.0,33.0,0.0,0.0,2794.0,29.0,0.0,1.0,2410.0,20.0,0.0,0.0,1554.0,30.0,2.0,0.0,2577.0,31.0,0.0,0.0,2631.0,33.0,1.0,0.0,2970.0,27.0,0.0,0.0,2263.0,32.0,1.0,0.0,2885.0,Serie A,22.0,1.0,0.0,1960.0,4.0,0.0,0.0,360.0,29/6/2010,Giuseppe Bellusci,43000005.0,776.0,8/21/1989,20.0,0.0,0.0,5.0,0.0,3422.0,5750.0,5750.0,148.0,117.0,4267935.0,185.0,81.0,D RC,1.0,2.0,3.0,1.0,3.0,2.0,3.0,2.0,2.0,3.0,3.0,5.0,10.0,8.0,5.0,5.0,5.0,15.0,5.0,11.0,15.0,10.0,5.0,15.0,10.0,16.0,13.0,12.0,10.0,14.0,10.0,14.0,16.0,5.0,8.0,9.0,15.0,11.0,11.0,13.0,10.0,11.0,13.0,5.0,18.0,10.0,20.0,10.0,15.0,10.0,16.0,10.0,2.0,12.0,9.0,15.0,13.0,10.0,16.0,11.0,9.0,7.0,Giuseppe Bellusci,ÃÂÃÂ£1.08m ,Serie A
19/6/2011,Freire,19081578,1651,8/21/1989,21,0,0,0,0,1380,5650,5650,127,113,153152,186,73,D C,3,2,2,1,2,1,1,4,2,1,1,6,7,7,8,8,7,13,9,6,12,9,9,12,9,16,13,14,10,12,8,10,14,8,10,9,11,13,13,10,13,13,14,8,14,11,20,14,14,11,14,10,7,8,13,14,5,11,11,9,10,14,20,1,1,1,1,1,20,D C,101,1,11,1,1,1,1,20,1,1,1,1,1,1,1,1,0.0,0,0,0,0,0,0,0,0,0,0,0,0,0,0,0,0,0,0,0,0,0,0,0,0,0,0,0,0,0,0,0,0,0,0,0,0,0,0,0,0,0,0,0,0,0,0,0,0,Freire,ÃÂ£270Th. ,31.0,187.0,Defender - Centre-Back,right,V-Varen Nagasaki,19.0,0.0,0.0,1490.0,9.0,1.0,0.0,591.0,19.0,2.0,1.0,1675.0,36.0,1.0,3.0,3137.0,9.0,0.0,0.0,646.0,38.0,3.0,0.0,3420.0,36.0,0.0,0.0,2544.0,32.0,0.0,0.0,2791.0,20.0,2.0,0.0,1781.0,Liga NOS,13.0,1.0,0.0,808.0,nan,nan,nan,nan,29/6/2010,Freire,19081578.0,1651.0,8/21/1989,20.0,0.0,0.0,0.0,0.0,1250.0,5650.0,5650.0,132.0,113.0,1957186.0,186.0,73.0,D C,3.0,3.0,2.0,3.0,3.0,2.0,2.0,1.0,3.0,2.0,3.0,6.0,7.0,7.0,8.0,8.0,7.0,13.0,9.0,6.0,12.0,9.0,9.0,12.0,9.0,16.0,13.0,14.0,10.0,12.0,8.0,10.0,14.0,8.0,10.0,9.0,11.0,13.0,13.0,13.0,13.0,13.0,14.0,8.0,14.0,13.0,20.0,14.0,13.0,11.0,14.0,10.0,7.0,8.0,13.0,14.0,5.0,11.0,11.0,9.0,10.0,14.0,Freire,ÃÂÃÂ£270Th. ,Liga NOS
19/6/2011,Dejan Lovren,24000971,761,7/5/1989,21,0,0,21,1,4800,6029,6000,165,134,1766630,188,84,D RC,3,3,2,2,1,3,2,8,2,3,3,5,8,11,7,13,9,14,10,14,13,12,10,15,13,14,14,16,11,9,10,10,17,9,13,8,12,15,15,12,13,14,15,16,15,14,20,15,14,13,14,13,7,14,11,18,15,15,14,11,12,8,20,13,1,1,18,13,20,D RC,103,1,14,1,1,1,1,20,13,18,1,1,1,1,10,13,35184400000000.0,0,0,0,0,0,0,0,0,0,0,0,0,0,0,0,0,0,1,0,0,0,0,0,0,0,0,0,0,0,0,0,0,0,0,0,0,0,0,0,0,0,0,0,0,0,1,0,0,Dejan Lovren,ÃÂ£7.20m ,31.0,188.0,Defender - Centre-Back,right,Zenit St. Petersburg,37.0,1.0,0.0,3194.0,31.0,1.0,1.0,2671.0,24.0,1.0,1.0,2019.0,31.0,2.0,1.0,2788.0,38.0,1.0,0.0,2987.0,39.0,1.0,0.0,3250.0,33.0,2.0,1.0,2899.0,43.0,2.0,2.0,3354.0,18.0,1.0,1.0,1261.0,Ligue 1,15.0,1.0,1.0,1190.0,14.0,1.0,1.0,1215.0,29/6/2010,Dejan Lovren,24000971.0,761.0,7/5/1989,20.0,0.0,0.0,21.0,1.0,4489.0,6029.0,6000.0,165.0,134.0,32887462.0,188.0,84.0,D RC,1.0,1.0,1.0,1.0,3.0,3.0,3.0,1.0,2.0,2.0,1.0,5.0,8.0,11.0,7.0,13.0,9.0,14.0,10.0,14.0,13.0,12.0,10.0,15.0,13.0,14.0,14.0,16.0,11.0,9.0,10.0,10.0,17.0,9.0,13.0,8.0,12.0,15.0,15.0,12.0,13.0,14.0,15.0,16.0,15.0,14.0,20.0,15.0,14.0,13.0,14.0,13.0,7.0,14.0,12.0,18.0,15.0,15.0,14.0,11.0,12.0,8.0,Dejan Lovren,ÃÂÃÂ£6.53m ,Ligue 1
19/6/2011,Craig Dawson,90000708,765,5/6/1990,21,0,0,0,0,3350,6000,6000,131,121,639105,188,83,D C,1,3,1,3,1,1,1,6,3,2,3,2,6,3,11,10,2,16,6,4,14,13,2,14,11,11,10,12,12,10,11,11,18,3,12,5,14,12,13,12,9,11,15,20,18,11,10,15,14,12,4,16,2,8,6,18,7,11,9,9,8,3,20,1,1,1,1,10,20,D C,101,1,1,1,1,1,1,20,10,1,1,1,1,1,1,1,149534000000000.0,0,0,0,0,0,0,0,0,0,0,0,0,0,0,0,0,0,0,0,0,0,0,0,0,0,0,0,0,0,0,0,0,0,0,0,0,0,0,0,0,0,0,0,1,0,0,0,1,Craig Dawson,ÃÂ£1.35m ,30.0,188.0,Defender - Centre-Back,right,West Ham United,48.0,11.0,0.0,4245.0,17.0,1.0,1.0,1245.0,22.0,4.0,1.0,1869.0,15.0,0.0,3.0,1220.0,35.0,2.0,1.0,3161.0,43.0,4.0,2.0,3789.0,39.0,4.0,1.0,3488.0,32.0,2.0,1.0,2869.0,45.0,3.0,3.0,3831.0,Premier League,30.0,2.0,0.0,2449.0,1.0,0.0,0.0,90.0,nan,nan,nan,nan,nan,nan,nan,nan,nan,nan,nan,nan,nan,nan,nan,nan,nan,nan,nan,nan,nan,nan,nan,nan,nan,nan,nan,nan,nan,nan,nan,nan,nan,nan,nan,nan,nan,nan,nan,nan,nan,nan,nan,nan,nan,nan,nan,nan,nan,nan,nan,nan,nan,nan,nan,nan,nan,nan,nan,nan,nan,nan,nan,nan,nan,nan,nan,nan,nan,nan,nan,nan,nan,nan,nan,nan,nan,nan,nan,nan,nan,nan,nan,nan,19-06-17,18.3.4.28,Craig Dawson,90000708,765,06-May-90,27,0,0,15,7,5200,6750,6800,140,136,31122834,188,83,D RC,2,2,3,1,3,1,3,2,1,2,2,2,12,9,9,12,2,17,6,4,14,11,10,14,11,15,13,17,11,12,10,11,17,7,12,6,15,15,13,12,10,11,17,12,18,13,20,15,15,14,4,14,2,8,6,18,7,10,9,9,8,3,20,1,1,1,20,10,20,D RC,103,1,1,1,1,1,1,20,10,20,1,1,1,1,1,1,33792.0,0,0,0,0,0,0,0,0,0,0,1,0,0,0,0,1,0,0,0,0,0,0,0,0,0,0,0,0,0,0,0,0,0,0,0,0,0,0,0,0,0,0,0,0,0,0,0,0,Craig Dawson,ÃÂ£7.20m ,30.0,188.0,Defender - Centre-Back,right,West Ham United,39.0,4.0,1.0,3488.0,32.0,2.0,1.0,2869.0,45.0,3.0,3.0,3831.0,30.0,2.0,0.0,2449.0,1.0,0.0,0.0,90.0,Premier League,15-07-16,17.3.2.23,Craig Dawson,90000708.0,765.0,06-May-90,26.0,0.0,0.0,15.0,7.0,4500.0,6600.0,6600.0,140.0,132.0,17681812.0,188.0,83.0,D RC,2.0,1.0,1.0,1.0,3.0,3.0,2.0,2.0,1.0,2.0,2.0,2.0,12.0,9.0,9.0,12.0,2.0,15.0,6.0,4.0,14.0,11.0,12.0,14.0,11.0,13.0,13.0,17.0,11.0,12.0,10.0,11.0,17.0,7.0,12.0,6.0,14.0,15.0,13.0,13.0,10.0,11.0,16.0,14.0,18.0,13.0,20.0,15.0,14.0,14.0,4.0,14.0,2.0,8.0,6.0,18.0,7.0,10.0,9.0,9.0,8.0,3.0,Craig Dawson,ÃÂ£5.40m ,Premier League
19/6/2011,Ciaran Clark,29000029,789,9/26/1989,21,2,0,0,0,4750,6500,6500,158,124,1009855,188,77,D LC,3,2,3,1,3,1,2,1,1,2,1,4,4,12,8,13,3,13,5,4,11,13,5,14,12,10,14,10,13,13,10,12,15,2,14,7,15,11,14,12,12,12,15,20,12,14,9,12,11,12,4,10,7,16,15,14,14,14,16,15,13,3,20,1,10,1,1,15,20,D LC,104,1,12,1,1,1,1,20,15,1,12,10,1,1,1,1,0.0,0,0,0,0,0,0,0,0,0,0,0,0,0,0,0,0,0,0,0,0,0,0,0,0,0,0,0,0,0,0,0,0,0,0,0,0,0,0,0,0,0,0,0,0,0,0,0,0,Ciaran Clark,ÃÂ£3.15m ,31.0,188.0,Defender - Centre-Back,left,Newcastle United,30.0,5.0,2.0,2572.0,23.0,2.0,2.0,1868.0,35.0,1.0,1.0,3068.0,28.0,0.0,0.0,2292.0,29.0,1.0,2.0,2352.0,23.0,2.0,0.0,1890.0,36.0,3.0,2.0,3244.0,22.0,2.0,1.0,1925.0,14.0,3.0,0.0,1082.0,Premier League,17.0,2.0,0.0,1392.0,3.0,0.0,0.0,196.0,nan,nan,nan,nan,nan,nan,nan,nan,nan,nan,nan,nan,nan,nan,nan,nan,nan,nan,nan,nan,nan,nan,nan,nan,nan,nan,nan,nan,nan,nan,nan,nan,nan,nan,nan,nan,nan,nan,nan,nan,nan,nan,nan,nan,nan,nan,nan,nan,nan,nan,nan,nan,nan,nan,nan,nan,nan,nan,nan,nan,nan,nan,nan,nan,nan,nan,nan,nan,nan,nan,nan,nan,nan,nan,nan,nan,nan,nan,nan,nan,nan,nan,nan,nan,19-06-17,18.3.4.28,Ciaran Clark,29000029,789,26-Sep-89,27,24,2,0,0,4600,6750,6750,136,135,28004006,188,77,D LC,2,2,2,1,2,2,1,3,2,4,1,4,4,11,8,12,3,14,6,9,14,12,5,14,12,14,15,14,14,13,11,14,15,6,13,7,15,13,14,12,12,11,14,20,12,13,9,14,14,14,4,12,12,16,14,14,11,13,16,15,13,3,20,1,1,1,1,15,20,D LC,104,1,12,1,1,1,1,20,15,1,10,1,1,1,1,1,4294967296.0,0,0,0,0,0,0,0,0,0,0,0,0,0,0,0,0,0,0,0,0,0,0,0,0,0,0,0,0,0,0,0,0,1,0,0,0,0,0,0,0,0,0,0,0,0,0,0,0,Ciaran Clark,ÃÂ£5.40m ,31.0,188.0,Defender - Centre-Back,left,Newcastle United,36.0,3.0,2.0,3244.0,22.0,2.0,1.0,1925.0,14.0,3.0,0.0,1082.0,17.0,2.0,0.0,1392.0,3.0,0.0,0.0,196.0,Premier League,nan,nan,nan,nan,nan,nan,nan,nan,nan,nan,nan,nan,nan,nan,nan,nan,nan,nan,nan,nan,nan,nan,nan,nan,nan,nan,nan,nan,nan,nan,nan,nan,nan,nan,nan,nan,nan,nan,nan,nan,nan,nan,nan,nan,nan,nan,nan,nan,nan,nan,nan,nan,nan,nan,nan,nan,nan,nan,nan,nan,nan,nan,nan,nan,nan,nan,nan,nan,nan,nan,nan,nan,nan,nan,nan,nan,nan,nan,nan,nan,nan,nan,nan,nan,nan
19/6/2011,Chris Smalling,30022142,765,11/22/1989,21,0,0,14,1,5050,7400,7250,166,144,5421067,192,81,D RC,1,3,1,2,3,1,3,9,1,3,3,8,8,7,6,12,5,15,5,8,13,13,5,14,12,14,15,16,13,13,9,12,14,5,12,8,15,15,15,12,12,13,17,11,12,14,20,16,15,12,8,13,6,8,13,14,13,13,15,15,17,11,20,1,1,1,19,1,20,D RC,103,1,1,1,1,1,1,20,1,19,1,1,1,1,1,1,0.0,0,0,0,0,0,0,0,0,0,0,0,0,0,0,0,0,0,0,0,0,0,0,0,0,0,0,0,0,0,0,0,0,0,0,0,0,0,0,0,0,0,0,0,0,0,0,0,0,Chris Smalling,ÃÂ£13.50m ,30.0,194.0,Defender - Centre-Back,right,AS Roma,33.0,1.0,2.0,2262.0,31.0,3.0,0.0,2223.0,23.0,0.0,0.0,1724.0,38.0,2.0,0.0,3001.0,29.0,4.0,0.0,2238.0,55.0,2.0,0.0,4975.0,36.0,2.0,2.0,2609.0,46.0,4.0,0.0,3975.0,34.0,1.0,0.0,3028.0,Premier League,37.0,3.0,2.0,3196.0,nan,nan,nan,nan,nan,nan,nan,nan,nan,nan,nan,nan,nan,nan,nan,nan,nan,nan,nan,nan,nan,nan,nan,nan,nan,nan,nan,nan,nan,nan,nan,nan,nan,nan,nan,nan,nan,nan,nan,nan,nan,nan,nan,nan,nan,nan,nan,nan,nan,nan,nan,nan,nan,nan,nan,nan,nan,nan,nan,nan,nan,nan,nan,nan,nan,nan,nan,nan,nan,nan,nan,nan,nan,nan,nan,nan,nan,nan,nan,nan,nan,nan,nan,nan,nan,nan,nan,nan
19/6/2011,CÃÂ©dric Mongongu,8432567,53,6/22/1989,21,4,0,0,0,5050,6250,5600,150,125,750296,189,78,D RC,1,1,2,2,1,3,1,3,2,3,1,5,9,8,6,11,6,16,8,7,15,12,10,12,11,13,15,14,12,8,9,12,10,6,11,7,14,14,14,14,9,16,14,7,16,11,20,14,16,14,13,10,7,10,12,6,9,14,17,2,5,5,20,15,1,1,15,1,20,D RC,103,1,1,1,1,1,1,20,1,15,14,1,1,1,1,15,0.0,0,0,0,0,0,0,0,0,0,0,0,0,0,0,0,0,0,0,0,0,0,0,0,0,0,0,0,0,0,0,0,0,0,0,0,0,0,0,0,0,0,0,0,0,0,0,0,0,CÃÂ©dric Mongongu,ÃÂ£1.58m ,31.0,189.0,Defender - Centre-Back,right,Without Club,22.0,0.0,0.0,1500.0,15.0,3.0,0.0,1202.0,21.0,1.0,0.0,1871.0,37.0,4.0,1.0,3183.0,25.0,0.0,0.0,1860.0,5.0,0.0,0.0,365.0,4.0,0.0,0.0,71.0,nan,nan,nan,nan,nan,nan,nan,nan,Ligue 1,nan,nan,nan,nan,nan,nan,nan,nan,29/6/2010,CÃÂ©dric Mongongu,8432567.0,53.0,6/22/1989,21.0,4.0,0.0,0.0,0.0,3350.0,6500.0,5850.0,165.0,130.0,5608290.0,189.0,78.0,D RC,3.0,1.0,3.0,2.0,3.0,3.0,2.0,5.0,3.0,2.0,3.0,5.0,9.0,9.0,6.0,12.0,6.0,17.0,8.0,5.0,16.0,13.0,8.0,13.0,11.0,13.0,15.0,14.0,13.0,8.0,9.0,13.0,10.0,6.0,11.0,7.0,15.0,15.0,14.0,15.0,10.0,17.0,14.0,7.0,16.0,12.0,20.0,14.0,17.0,14.0,13.0,10.0,7.0,10.0,3.0,15.0,11.0,12.0,7.0,12.0,10.0,8.0,CÃÂÃÂ©dric Mongongu,ÃÂÃÂ£4.05m ,Ligue 1
19/6/2011,Breno,2115209,1651,10/13/1989,21,0,0,0,0,6000,7250,7000,160,140,2636167,187,83,D C,2,2,3,2,1,2,3,5,1,1,2,4,7,9,6,11,6,13,7,9,14,11,8,15,11,13,16,13,12,14,8,12,16,9,7,9,17,13,13,12,10,14,16,11,15,14,20,15,15,13,11,15,14,4,3,16,15,15,15,13,9,6,20,6,1,1,11,1,20,D C,101,1,10,1,1,1,1,20,1,11,12,1,1,1,1,6,8796090000000.0,0,0,0,0,0,1,0,0,0,0,0,0,0,0,0,0,0,0,0,0,0,0,0,0,0,0,0,0,0,0,0,0,0,0,0,0,0,0,0,0,0,0,0,1,0,0,0,0,Breno,ÃÂ£900Th. ,31.0,191.0,Defender - Centre-Back,both,Club de Regatas Vasco da Gama,18.0,0.0,0.0,1143.0,0.0,0.0,0.0,0.0,nan,nan,nan,nan,nan,nan,nan,nan,5.0,1.0,0.0,268.0,1.0,0.0,0.0,90.0,26.0,1.0,0.0,2211.0,7.0,0.0,0.0,585.0,0.0,0.0,0.0,0.0,Bundesliga,nan,nan,nan,nan,nan,nan,nan,nan,29/6/2010,Breno,2115209.0,1651.0,10/13/1989,20.0,0.0,0.0,0.0,0.0,4000.0,7250.0,6650.0,164.0,136.0,24822305.0,187.0,83.0,D C,1.0,1.0,2.0,1.0,1.0,1.0,1.0,7.0,3.0,1.0,3.0,4.0,7.0,11.0,6.0,11.0,6.0,15.0,7.0,9.0,14.0,12.0,8.0,15.0,13.0,10.0,12.0,10.0,13.0,15.0,8.0,12.0,16.0,9.0,7.0,10.0,14.0,13.0,14.0,11.0,7.0,14.0,16.0,13.0,15.0,14.0,20.0,15.0,15.0,16.0,6.0,15.0,3.0,4.0,3.0,16.0,15.0,15.0,15.0,13.0,9.0,6.0,Breno,ÃÂÃÂ£4.95m ,Bundesliga
19/6/2011,Bernardo,67010361,1653,7/11/1989,21,0,0,0,0,3000,5000,5250,135,110,84610,192,85,D C,2,3,1,1,3,3,2,3,1,3,2,3,4,3,3,9,4,14,4,10,12,9,5,12,5,16,11,15,11,11,5,11,10,5,14,7,14,11,13,11,7,15,15,7,4,11,20,14,15,13,14,10,7,5,11,13,13,9,7,13,6,9,20,1,1,1,1,1,20,D C,101,1,1,1,1,1,1,20,1,1,1,1,1,1,1,1,0.0,0,0,0,0,0,0,0,0,0,0,0,0,0,0,0,0,0,0,0,0,0,0,0,0,0,0,0,0,0,0,0,0,0,0,0,0,0,0,0,0,0,0,0,0,0,0,0,0,nan,nan,nan,nan,nan,nan,nan,nan,nan,nan,nan,nan,nan,nan,nan,nan,nan,nan,nan,nan,nan,nan,nan,nan,nan,nan,nan,nan,nan,nan,nan,nan,nan,nan,nan,nan,nan,nan,nan,nan,nan,nan,nan,nan,nan,nan,nan,nan,nan,nan,nan,nan,nan,nan,nan,nan,nan,nan,nan,nan,nan,nan,nan,nan,nan,nan,nan,nan,nan,nan,nan,nan,nan,nan,nan,nan,nan,nan,nan,nan,nan,nan,nan,nan,nan,nan,nan,nan,nan,nan,nan,nan,nan,nan,nan,nan,nan,nan,nan,nan,nan,nan,nan,nan,nan,nan,nan,nan,nan,nan,nan,nan,nan,nan,nan,nan,nan,nan,nan,nan,nan,nan,nan,nan,nan,nan,nan,nan,nan,nan,nan,nan,nan,nan,nan,nan,19-06-17,18.3.4.28,Bernardo,67010361,1653,11-Jul-89,27,0,0,0,0,5650,6150,6250,134,125,2949580,192,85,D C,1,3,2,2,1,2,3,2,3,3,2,3,3,3,5,10,4,16,5,6,13,10,5,15,12,14,14,14,12,12,11,12,12,9,11,8,13,13,14,9,11,10,16,10,15,11,20,16,17,14,10,11,7,8,7,11,12,12,14,12,13,9,20,1,1,1,1,1,20,D C,101,1,1,1,1,1,1,20,1,1,1,1,1,1,1,1,0.0,0,0,0,0,0,0,0,0,0,0,0,0,0,0,0,0,0,0,0,0,0,0,0,0,0,0,0,0,0,0,0,0,0,0,0,0,0,0,0,0,0,0,0,0,0,0,0,0,Bernardo,ÃÂ£5.40m ,25.0,186.0,Defender - Left-Back,left,Brighton & Hove Albion,32.0,3.0,1.0,2820.0,27.0,1.0,1.0,1846.0,27.0,0.0,1.0,2260.0,16.0,0.0,0.0,784.0,3.0,1.0,2.0,270.0,Bundesliga,15-07-16,17.3.2.23,Bernardo,67010361.0,1653.0,11-Jul-89,27.0,0.0,0.0,0.0,0.0,5650.0,6150.0,6650.0,134.0,133.0,20786222.0,192.0,85.0,D C,1.0,2.0,3.0,3.0,3.0,1.0,2.0,1.0,3.0,1.0,1.0,4.0,5.0,5.0,8.0,10.0,4.0,18.0,5.0,8.0,15.0,12.0,5.0,14.0,11.0,14.0,14.0,13.0,13.0,12.0,9.0,11.0,11.0,14.0,11.0,7.0,14.0,15.0,14.0,11.0,11.0,5.0,16.0,9.0,15.0,10.0,20.0,17.0,18.0,16.0,12.0,12.0,7.0,5.0,16.0,11.0,12.0,10.0,11.0,3.0,8.0,3.0,Bernardo,ÃÂ£4.50m ,Bundesliga
19/6/2011,Aymen Abdennour,12014167,51,8/6/1989,21,6,1,10,1,2800,5800,5300,145,118,346873,187,84,D/WB LC,3,2,1,2,3,1,1,5,2,1,2,10,12,9,6,12,8,14,10,5,13,10,8,13,11,18,7,18,13,11,7,9,15,8,11,10,8,13,13,15,13,15,15,20,14,17,4,14,13,13,14,12,7,12,12,14,13,12,12,8,9,7,20,17,12,1,1,17,20,D/WB LC,114,1,1,1,1,1,1,20,17,1,14,12,12,1,17,1,0.0,0,0,0,0,0,0,0,0,0,0,0,0,0,0,0,0,0,0,0,0,0,0,0,0,0,0,0,0,0,0,0,0,0,0,0,0,0,0,0,0,0,0,0,0,0,0,0,0,Aymen Abdennour,ÃÂ£3.15m ,31.0,187.0,Defender - Centre-Back,left,Umm Salal SC,20.0,4.0,0.0,1699.0,32.0,2.0,0.0,2880.0,33.0,1.0,2.0,3000.0,23.0,0.0,0.0,2044.0,26.0,1.0,0.0,2276.0,29.0,0.0,0.0,2452.0,14.0,0.0,0.0,967.0,14.0,0.0,0.0,1069.0,6.0,0.0,0.0,445.0,Ligue 1,12.0,0.0,0.0,902.0,1.0,0.0,0.0,90.0,nan,nan,nan,nan,nan,nan,nan,nan,nan,nan,nan,nan,nan,nan,nan,nan,nan,nan,nan,nan,nan,nan,nan,nan,nan,nan,nan,nan,nan,nan,nan,nan,nan,nan,nan,nan,nan,nan,nan,nan,nan,nan,nan,nan,nan,nan,nan,nan,nan,nan,nan,nan,nan,nan,nan,nan,nan,nan,nan,nan,nan,nan,nan,nan,nan,nan,nan,nan,nan,nan,nan,nan,nan,nan,nan,nan,nan,nan,nan,nan,nan,nan,nan,nan,19-06-17,18.3.4.28,Aymen Abdennour,12014167,51,06-Aug-89,27,49,1,10,1,5250,7000,6250,150,131,2565387,187,88,D C,1,3,1,1,4,2,2,1,2,3,1,5,9,10,6,7,7,16,12,12,16,10,8,16,10,18,12,17,10,15,9,12,16,8,12,8,13,15,16,8,9,18,14,20,13,10,8,15,18,10,15,13,14,11,12,15,11,13,14,11,11,8,20,8,4,1,1,10,20,D C,101,1,1,1,1,1,1,20,10,1,10,1,4,1,8,1,4503890000000000.0,0,0,0,0,0,0,1,0,0,0,0,0,0,0,0,1,0,0,0,0,0,0,0,0,0,0,0,0,0,0,0,0,0,0,1,0,0,0,1,0,0,0,0,0,0,0,0,0,Aymen Abdennour,ÃÂ£3.60m ,31.0,187.0,Defender - Centre-Back,left,Umm Salal SC,14.0,0.0,0.0,967.0,14.0,0.0,0.0,1069.0,6.0,0.0,0.0,445.0,12.0,0.0,0.0,902.0,1.0,0.0,0.0,90.0,Ligue 1,15-07-16,17.3.2.23,Aymen Abdennour,12014167.0,51.0,06-Aug-89,26.0,49.0,1.0,10.0,1.0,6000.0,7350.0,7250.0,155.0,141.0,21735846.0,187.0,88.0,D C,3.0,3.0,3.0,1.0,1.0,1.0,4.0,1.0,2.0,1.0,3.0,5.0,9.0,10.0,6.0,7.0,7.0,16.0,12.0,12.0,16.0,10.0,8.0,16.0,11.0,18.0,13.0,17.0,10.0,13.0,9.0,10.0,16.0,8.0,13.0,10.0,13.0,16.0,17.0,13.0,11.0,18.0,14.0,20.0,13.0,15.0,7.0,14.0,18.0,12.0,15.0,13.0,15.0,11.0,12.0,15.0,11.0,13.0,14.0,11.0,11.0,8.0,Aymen Abdennour,ÃÂ£5.40m ,LaLiga
19/6/2011,Andreu FontÃÂ s,67038644,796,11/14/1989,21,0,0,0,0,4000,6250,6250,145,128,475612,186,89,D/DM C,3,1,3,1,2,3,1,1,1,1,3,5,6,8,5,14,7,13,7,7,14,13,10,13,13,8,13,10,13,14,13,13,10,8,11,7,15,15,14,12,10,15,13,20,11,12,7,14,14,15,9,10,6,9,9,11,6,1,7,7,7,14,20,1,9,1,1,13,20,D/DM C,111,1,1,1,1,1,1,20,13,1,17,9,1,1,1,1,0.0,0,0,0,0,0,0,0,0,0,0,0,0,0,0,0,0,0,0,0,0,0,0,0,0,0,0,0,0,0,0,0,0,0,0,0,0,0,0,0,0,0,0,0,0,0,0,0,0,Andreu FontÃÂ s,ÃÂ£3.15m ,30.0,186.0,Defender - Centre-Back,left,Sporting Kansas City,33.0,2.0,1.0,2844.0,6.0,0.0,0.0,369.0,13.0,0.0,0.0,730.0,35.0,0.0,0.0,3092.0,36.0,0.0,0.0,3164.0,7.0,1.0,0.0,540.0,27.0,2.0,1.0,2220.0,18.0,0.0,1.0,1335.0,18.0,0.0,0.0,1381.0,LaLiga,2.0,1.0,0.0,180.0,nan,nan,nan,nan,29/6/2010,Andreu FontÃÂ s,67038644.0,796.0,11/14/1989,20.0,0.0,0.0,0.0,0.0,3906.0,6250.0,6250.0,160.0,125.0,5637399.0,186.0,84.0,D/DM C,3.0,3.0,1.0,3.0,3.0,3.0,2.0,1.0,1.0,1.0,1.0,5.0,6.0,7.0,5.0,13.0,7.0,13.0,7.0,7.0,13.0,13.0,10.0,12.0,11.0,8.0,13.0,11.0,12.0,14.0,12.0,13.0,10.0,8.0,12.0,7.0,15.0,15.0,14.0,12.0,9.0,15.0,13.0,20.0,11.0,13.0,7.0,14.0,14.0,15.0,9.0,10.0,6.0,9.0,14.0,11.0,8.0,14.0,13.0,8.0,10.0,9.0,Andreu FontÃÂÃÂ s,ÃÂÃÂ£2.25m ,LaLiga,19-06-17,18.3.4.28,Andreu FontÃÂs,67038644,796,14-Nov-89,27,0,0,14,0,5500,6850,6850,145,137,11325317,186,72,D/DM C,3,3,3,1,2,4,2,1,2,3,2,7,11,9,8,14,8,12,11,10,13,17,11,16,14,13,14,13,15,15,13,14,12,9,12,7,14,14,13,11,10,8,13,20,11,13,7,14,17,14,8,11,8,13,9,13,14,12,13,12,12,4,20,7,9,1,1,10,20,D/DM C,111,1,13,1,1,1,1,20,10,1,18,9,1,1,7,1,141017000000000.0,0,0,0,0,0,0,0,0,0,0,0,0,0,0,0,0,0,0,0,0,0,0,0,0,0,0,0,0,0,0,0,0,1,0,0,0,0,0,1,0,0,0,0,0,0,0,0,1,Andreu FontÃÂ s,ÃÂ£2.70m ,30.0,186.0,Defender - Centre-Back,left,Sporting Kansas City,27.0,2.0,1.0,2220.0,18.0,0.0,1.0,1335.0,18.0,0.0,0.0,1381.0,2.0,1.0,0.0,180.0,nan,nan,nan,nan,LaLiga,15-07-16,17.3.2.23,Andreu FontÃÂs,67038644.0,796.0,14-Nov-89,26.0,0.0,0.0,14.0,0.0,5500.0,7000.0,7000.0,145.0,140.0,15033044.0,186.0,72.0,D/DM C,1.0,2.0,1.0,3.0,2.0,2.0,1.0,2.0,2.0,3.0,1.0,7.0,11.0,9.0,8.0,14.0,8.0,12.0,11.0,10.0,13.0,17.0,11.0,16.0,14.0,13.0,16.0,13.0,15.0,15.0,13.0,14.0,12.0,9.0,12.0,7.0,16.0,14.0,13.0,11.0,10.0,8.0,13.0,20.0,11.0,13.0,7.0,14.0,17.0,14.0,8.0,11.0,8.0,13.0,13.0,13.0,14.0,12.0,13.0,12.0,12.0,4.0,Andreu FontÃÂ s,ÃÂ£2.25m ,LaLiga
19/6/2011,AndrÃÂ© Pinto,55009586,788,10/5/1989,21,0,0,0,0,1250,5250,5250,124,105,70807,192,86,D C,1,1,1,3,1,1,2,2,2,2,1,7,7,7,10,10,15,13,16,13,12,10,12,11,10,14,12,13,10,10,8,10,16,6,10,11,12,12,12,12,12,16,14,8,14,11,20,13,14,12,10,10,10,8,12,12,15,13,14,13,13,7,20,1,1,1,1,1,20,D C,101,1,1,1,1,1,1,20,1,1,1,1,1,1,1,1,0.0,0,0,0,0,0,0,0,0,0,0,0,0,0,0,0,0,0,0,0,0,0,0,0,0,0,0,0,0,0,0,0,0,0,0,0,0,0,0,0,0,0,0,0,0,0,0,0,0,AndrÃÂ© Pinto,ÃÂ£900Th. ,31.0,194.0,Defender - Centre-Back,right,Without Club,29.0,2.0,0.0,2599.0,26.0,2.0,0.0,2358.0,22.0,0.0,0.0,1876.0,5.0,0.0,1.0,403.0,40.0,1.0,1.0,3618.0,36.0,0.0,0.0,2920.0,15.0,3.0,0.0,1307.0,17.0,0.0,1.0,1357.0,24.0,0.0,0.0,1645.0,Liga NOS,14.0,0.0,0.0,1165.0,nan,nan,nan,nan,29/6/2010,AndrÃÂ© Pinto,55009586.0,788.0,10/5/1989,20.0,0.0,0.0,0.0,0.0,1250.0,4500.0,4500.0,113.0,94.0,21585.0,192.0,86.0,D C,1.0,2.0,1.0,3.0,3.0,2.0,2.0,1.0,1.0,3.0,2.0,6.0,6.0,6.0,9.0,9.0,14.0,12.0,15.0,12.0,11.0,9.0,11.0,10.0,9.0,14.0,11.0,13.0,9.0,9.0,7.0,9.0,16.0,6.0,10.0,10.0,11.0,11.0,11.0,11.0,11.0,15.0,13.0,8.0,14.0,10.0,20.0,12.0,13.0,12.0,10.0,10.0,10.0,8.0,12.0,12.0,15.0,13.0,14.0,13.0,13.0,7.0,AndrÃÂÃÂ© Pinto,ÃÂÃÂ£810Th. ,Liga NOS,19-06-17,18.3.4.28,AndrÃÂ© Pinto,55009586,788,05-Oct-89,27,1,0,12,0,5000,6600,6600,138,132,3939997,192,86,D C,2,1,2,2,1,1,3,3,2,1,2,6,7,7,9,11,14,12,13,13,15,12,12,14,11,12,11,13,13,13,11,14,12,6,15,11,14,12,12,9,10,16,16,10,13,10,20,14,15,15,10,13,8,8,11,14,8,9,14,13,12,6,20,1,1,1,1,1,20,D C,101,1,1,1,1,1,1,20,1,1,1,1,1,1,1,1,35184400000000.0,0,0,0,0,0,0,0,0,0,1,0,0,0,0,0,0,0,0,0,0,0,0,0,0,0,0,0,0,0,0,0,0,0,0,0,0,0,0,0,0,0,0,0,0,0,1,0,0,AndrÃÂ© Pinto,ÃÂ£2.48m ,31.0,194.0,Defender - Centre-Back,right,Without Club,15.0,3.0,0.0,1307.0,17.0,0.0,1.0,1357.0,24.0,0.0,0.0,1645.0,14.0,0.0,0.0,1165.0,nan,nan,nan,nan,Liga NOS,15-07-16,17.3.2.23,AndrÃÂ© Pinto,55009586.0,788.0,05-Oct-89,26.0,1.0,0.0,12.0,0.0,5000.0,6600.0,6600.0,138.0,132.0,2980789.0,192.0,86.0,D C,3.0,3.0,2.0,3.0,3.0,3.0,1.0,2.0,2.0,3.0,3.0,6.0,7.0,7.0,9.0,11.0,14.0,11.0,13.0,13.0,15.0,13.0,12.0,14.0,11.0,12.0,11.0,13.0,13.0,13.0,11.0,14.0,12.0,6.0,15.0,11.0,14.0,12.0,12.0,9.0,10.0,16.0,16.0,10.0,13.0,10.0,20.0,14.0,15.0,15.0,10.0,13.0,8.0,8.0,9.0,14.0,8.0,9.0,14.0,13.0,12.0,6.0,AndrÃÂ© Pinto,ÃÂ£2.70m ,Liga NOS
19/6/2011,ÃÂlvaro,67093060,796,1/8/1990,21,0,0,0,0,3750,6000,6000,145,130,815925,180,68,D RC,1,2,3,1,1,2,2,2,3,2,2,4,4,5,5,7,5,15,6,13,15,9,7,14,7,17,14,19,9,14,6,12,15,7,14,5,13,15,17,14,16,14,12,6,15,14,20,14,13,14,12,15,6,11,10,12,15,15,15,10,8,8,20,1,1,1,19,7,20,D RC,103,1,1,1,1,1,1,20,7,19,1,1,1,1,1,1,8589967360.0,0,0,0,0,0,0,0,0,0,0,0,0,0,0,0,1,0,0,0,0,0,0,0,0,0,0,0,0,0,0,0,0,0,1,0,0,0,0,0,0,0,0,0,0,0,0,0,0,nan,nan,nan,nan,nan,nan,nan,nan,nan,nan,nan,nan,nan,nan,nan,nan,nan,nan,nan,nan,nan,nan,nan,nan,nan,nan,nan,nan,nan,nan,nan,nan,nan,nan,nan,nan,nan,nan,nan,nan,nan,nan,nan,nan,nan,nan,nan,nan,nan,nan,nan,nan,nan,nan,nan,nan,nan,nan,nan,nan,nan,nan,nan,nan,nan,nan,nan,nan,nan,nan,nan,nan,nan,nan,nan,nan,nan,nan,nan,nan,nan,nan,nan,nan,nan,nan,nan,nan,nan,nan,nan,nan,nan,nan,nan,nan,nan,nan,nan,nan,nan,nan,nan,nan,nan,nan,nan,nan,nan,nan,nan,nan,nan,nan,nan,nan,nan,nan,nan,nan,nan,nan,nan,nan,nan,nan,nan,nan,nan,nan,nan,nan,nan,nan,nan,nan,19-06-17,18.3.4.28,ÃÂlvaro,67093060,796,08-Jan-90,27,0,0,0,0,4500,7000,7000,145,141,23553068,183,76,D RC,1,4,2,1,3,3,3,1,1,2,3,5,7,10,6,12,6,14,9,13,16,12,8,14,11,14,14,15,14,15,11,14,14,7,14,7,14,12,14,13,11,13,13,12,12,13,20,14,13,13,12,13,6,12,10,16,11,13,13,10,7,9,20,1,1,1,15,1,20,D RC,103,1,1,1,1,1,1,20,1,15,9,1,1,1,1,1,32768.0,0,0,0,0,0,0,0,0,0,0,0,0,0,0,0,1,0,0,0,0,0,0,0,0,0,0,0,0,0,0,0,0,0,0,0,0,0,0,0,0,0,0,0,0,0,0,0,0,nan,nan,nan,nan,nan,nan,nan,nan,nan,nan,nan,nan,nan,nan,nan,nan,nan,nan,nan,nan,nan,nan,nan,nan,nan,nan,nan,nan,15-07-16,17.3.2.23,ÃÂlvaro,67093060.0,796.0,08-Jan-90,26.0,0.0,0.0,0.0,0.0,4750.0,6750.0,6750.0,140.0,135.0,8943688.0,183.0,76.0,D RC,1.0,1.0,2.0,3.0,2.0,1.0,2.0,3.0,2.0,3.0,4.0,5.0,7.0,10.0,6.0,11.0,5.0,14.0,8.0,13.0,16.0,11.0,8.0,14.0,11.0,14.0,14.0,15.0,14.0,15.0,10.0,14.0,14.0,7.0,13.0,7.0,14.0,12.0,14.0,13.0,11.0,13.0,13.0,9.0,12.0,13.0,20.0,14.0,13.0,13.0,12.0,13.0,6.0,12.0,10.0,16.0,11.0,13.0,13.0,10.0,7.0,9.0,nan,nan,nan
19/6/2011,Abdel El Kaoutari,34008676,34,3/17/1990,21,0,0,0,0,4400,5585,5559,160,124,617721,180,73,D/WB LC,1,1,1,3,3,3,2,8,2,1,2,7,12,8,6,11,11,13,11,10,14,9,7,13,11,12,13,14,10,13,9,11,16,8,11,7,14,13,14,14,12,13,10,20,15,13,5,15,13,13,12,16,6,8,17,14,15,15,13,13,13,6,20,17,1,1,1,17,20,D/WB LC,114,5,1,1,1,1,1,20,17,1,1,1,1,1,17,1,0.0,0,0,0,0,0,0,0,0,0,0,0,0,0,0,0,0,0,0,0,0,0,0,0,0,0,0,0,0,0,0,0,0,0,0,0,0,0,0,0,0,0,0,0,0,0,0,0,0,Abdelhamid El Kaoutari,ÃÂ£1.35m ,30.0,180.0,Defender - Centre-Back,left,AS Nancy-Lorraine,30.0,1.0,0.0,2276.0,8.0,0.0,0.0,559.0,25.0,0.0,2.0,2215.0,34.0,0.0,0.0,2918.0,38.0,0.0,1.0,3420.0,17.0,1.0,0.0,1454.0,18.0,0.0,0.0,1352.0,5.0,0.0,0.0,262.0,16.0,0.0,0.0,1359.0,Ligue 1,26.0,0.0,2.0,2194.0,7.0,0.0,0.0,630.0,29/6/2010,Abdel El Kaoutari,34008676.0,769.0,3/17/1990,20.0,0.0,0.0,0.0,0.0,1300.0,5579.0,5550.0,160.0,124.0,8396710.0,180.0,73.0,D/WB LC,3.0,3.0,3.0,1.0,3.0,1.0,2.0,3.0,2.0,3.0,1.0,7.0,12.0,8.0,6.0,11.0,11.0,13.0,11.0,10.0,14.0,9.0,7.0,13.0,11.0,12.0,13.0,14.0,10.0,13.0,9.0,11.0,16.0,8.0,11.0,7.0,14.0,13.0,14.0,14.0,12.0,13.0,10.0,20.0,15.0,13.0,5.0,15.0,13.0,13.0,12.0,16.0,6.0,8.0,7.0,14.0,15.0,15.0,13.0,13.0,13.0,6.0,Abdelhamid El Kaoutari,ÃÂÃÂ£1.71m ,Ligue 1
19/6/2011,VÃÂ­ctor Ruiz,67046591,796,1/25/1989,22,0,0,0,0,5750,6750,6900,158,138,2549826,184,73,D C,2,3,1,3,3,2,1,6,3,2,2,7,6,6,7,9,8,14,8,11,14,13,10,15,11,14,12,15,13,13,10,12,10,8,11,7,14,18,15,14,13,15,13,20,12,14,6,16,13,12,11,12,7,11,12,8,15,9,15,8,15,9,20,12,1,1,1,12,20,D C,101,1,1,1,1,1,1,20,12,1,1,1,1,1,12,1,0.0,0,0,0,0,0,0,0,0,0,0,0,0,0,0,0,0,0,0,0,0,0,0,0,0,0,0,0,0,0,0,0,0,0,0,0,0,0,0,0,0,0,0,0,0,0,0,0,0,VÃÂ­ctor Ruiz,ÃÂ£8.10m ,31.0,184.0,Defender - Centre-Back,left,Real Betis BalompiÃÂ©,25.0,0.0,0.0,2226.0,37.0,2.0,0.0,3251.0,33.0,0.0,1.0,2291.0,19.0,1.0,2.0,1433.0,36.0,0.0,2.0,3162.0,51.0,0.0,0.0,4330.0,36.0,1.0,1.0,3077.0,34.0,2.0,1.0,3047.0,33.0,0.0,0.0,2966.0,LaLiga,26.0,0.0,1.0,2302.0,1.0,0.0,0.0,10.0,29/6/2010,VÃÂ­ctor Ruiz,67046591.0,796.0,1/25/1989,21.0,0.0,0.0,0.0,0.0,4500.0,6500.0,6500.0,155.0,138.0,9010175.0,184.0,73.0,D C,3.0,3.0,1.0,2.0,3.0,3.0,2.0,3.0,2.0,1.0,2.0,7.0,6.0,6.0,7.0,9.0,8.0,14.0,8.0,11.0,14.0,13.0,5.0,15.0,11.0,14.0,12.0,15.0,13.0,13.0,10.0,12.0,10.0,8.0,11.0,7.0,14.0,18.0,15.0,14.0,13.0,15.0,13.0,20.0,12.0,14.0,6.0,15.0,13.0,12.0,11.0,12.0,7.0,11.0,8.0,13.0,13.0,7.0,9.0,20.0,5.0,8.0,VÃÂÃÂ­ctor Ruiz,ÃÂÃÂ£7.20m ,Serie A,19-06-17,18.3.4.28,VÃÂ­ctor Ruiz,67046591,796,25-Jan-89,28,0,0,5,0,6000,7200,7200,153,145,20698920,184,80,D C,3,3,4,3,3,3,2,2,3,1,2,7,9,10,7,12,8,15,10,13,16,14,9,15,12,12,14,16,14,14,11,14,12,8,12,8,16,14,15,11,10,9,13,20,11,14,9,13,16,15,11,12,12,11,8,10,9,11,10,10,11,7,20,8,1,1,1,10,20,D C,101,1,9,1,1,1,1,20,10,1,11,1,1,1,8,1,33554432.0,0,0,0,0,0,0,0,0,0,0,0,0,0,0,0,0,0,0,0,0,0,0,0,0,0,1,0,0,0,0,0,0,0,0,0,0,0,0,0,0,0,0,0,0,0,0,0,0,VÃÂ­ctor Ruiz,ÃÂ£10.80m ,31.0,184.0,Defender - Centre-Back,left,Real Betis BalompiÃÂ©,36.0,1.0,1.0,3077.0,34.0,2.0,1.0,3047.0,33.0,0.0,0.0,2966.0,26.0,0.0,1.0,2302.0,1.0,0.0,0.0,10.0,LaLiga,15-07-16,17.3.2.23,VÃÂ­ctor Ruiz,67046591.0,796.0,25-Jan-89,27.0,0.0,0.0,5.0,0.0,5600.0,7250.0,7250.0,153.0,147.0,20930180.0,184.0,80.0,D C,2.0,3.0,4.0,1.0,1.0,1.0,1.0,3.0,1.0,4.0,1.0,7.0,9.0,10.0,7.0,13.0,8.0,16.0,10.0,13.0,16.0,14.0,9.0,15.0,12.0,12.0,14.0,16.0,14.0,14.0,11.0,14.0,12.0,8.0,12.0,8.0,16.0,15.0,16.0,11.0,10.0,9.0,13.0,20.0,11.0,15.0,9.0,13.0,16.0,15.0,11.0,12.0,12.0,11.0,8.0,10.0,9.0,11.0,10.0,10.0,11.0,7.0,VÃÂ­ctor Ruiz,ÃÂ£12.60m ,LaLiga
19/6/2011,Thomas Heurtaux,34003995,769,7/3/1988,22,0,0,4,0,4450,5579,5568,140,124,388751,183,78,D C,2,1,3,3,1,2,2,6,3,1,1,5,5,7,6,10,7,14,8,11,14,8,6,13,10,14,14,15,13,13,9,13,14,6,13,7,14,13,14,12,9,14,12,8,11,11,20,15,15,14,13,10,9,13,6,14,14,14,14,14,14,5,20,1,10,8,13,10,20,D C,101,1,1,1,8,1,1,20,10,13,10,10,1,1,1,1,0.0,0,0,0,0,0,0,0,0,0,0,0,0,0,0,0,0,0,0,0,0,0,0,0,0,0,0,0,0,0,0,0,0,0,0,0,0,0,0,0,0,0,0,0,0,0,0,0,0,Thomas Heurtaux,ÃÂ£2.48m ,32.0,183.0,Defender - Centre-Back,right,Without Club,34.0,0.0,0.0,2726.0,37.0,5.0,0.0,3138.0,20.0,0.0,0.0,1525.0,39.0,4.0,1.0,3298.0,28.0,1.0,1.0,2401.0,16.0,0.0,0.0,1163.0,13.0,0.0,1.0,614.0,19.0,0.0,0.0,1603.0,5.0,0.0,0.0,144.0,Ligue 1,9.0,0.0,1.0,565.0,nan,nan,nan,nan,29/6/2010,Thomas Heurtaux,34003995.0,769.0,7/3/1988,21.0,0.0,0.0,4.0,0.0,150.0,4000.0,4000.0,140.0,120.0,1732810.0,183.0,75.0,D C,3.0,1.0,3.0,3.0,2.0,3.0,3.0,3.0,2.0,1.0,2.0,5.0,5.0,7.0,6.0,10.0,7.0,14.0,8.0,11.0,13.0,8.0,6.0,13.0,10.0,13.0,14.0,15.0,13.0,13.0,9.0,13.0,14.0,6.0,13.0,7.0,14.0,13.0,14.0,12.0,9.0,14.0,12.0,5.0,8.0,11.0,20.0,15.0,15.0,14.0,13.0,7.0,6.0,13.0,14.0,14.0,14.0,14.0,14.0,14.0,14.0,5.0,Thomas Heurtaux,ÃÂÃÂ£1.80m ,Ligue 1,19-06-17,18.3.4.28,Thomas Heurtaux,34003995,769,03-Jul-88,28,0,0,3,0,4500,6250,6250,137,125,7270047,183,78,D C,1,3,2,4,3,3,2,3,1,2,2,3,5,9,8,11,7,14,10,11,14,10,6,14,12,13,12,12,13,12,10,13,13,9,14,8,14,13,14,13,9,15,12,10,14,13,20,15,14,12,13,12,9,13,15,14,13,14,14,14,14,5,20,1,1,1,13,1,20,D C,101,1,1,1,1,1,1,20,1,13,1,1,1,1,1,1,137439000000.0,0,0,0,0,0,0,0,0,0,0,0,0,0,0,0,0,0,0,0,0,0,0,0,0,0,0,0,0,0,0,0,0,0,0,0,0,0,1,0,0,0,0,0,0,0,0,0,0,Thomas Heurtaux,ÃÂ£1.62m ,32.0,183.0,Defender - Centre-Back,right,Without Club,13.0,0.0,1.0,614.0,19.0,0.0,0.0,1603.0,5.0,0.0,0.0,144.0,9.0,0.0,1.0,565.0,nan,nan,nan,nan,Serie A,15-07-16,17.3.2.23,Thomas Heurtaux,34003995.0,769.0,03-Jul-88,28.0,0.0,0.0,3.0,0.0,4850.0,6500.0,6500.0,140.0,129.0,4735842.0,183.0,78.0,D C,1.0,2.0,4.0,2.0,1.0,1.0,3.0,1.0,3.0,3.0,1.0,3.0,5.0,9.0,8.0,11.0,7.0,14.0,10.0,11.0,14.0,10.0,6.0,15.0,12.0,14.0,13.0,14.0,14.0,14.0,10.0,13.0,13.0,9.0,14.0,8.0,14.0,13.0,14.0,13.0,9.0,15.0,13.0,10.0,14.0,13.0,20.0,15.0,15.0,14.0,13.0,14.0,9.0,13.0,15.0,14.0,13.0,14.0,14.0,14.0,14.0,5.0,Thomas Heurtaux,ÃÂ£2.43m ,Serie A
19/6/2011,Tengarrinha,55009697,788,2/17/1989,22,0,0,4,0,1500,4500,4500,109,100,96882,184,77,D/DM C,2,1,2,3,3,3,2,3,3,2,3,15,15,13,12,14,13,11,12,9,9,15,12,9,14,6,14,10,15,13,15,12,11,13,10,13,10,11,11,11,11,11,10,8,14,11,20,11,11,10,7,10,9,10,14,12,12,12,14,14,14,6,20,1,10,1,10,5,20,D/DM C,111,1,1,1,1,1,1,20,1,1,20,10,5,10,1,1,0.0,0,0,0,0,0,0,0,0,0,0,0,0,0,0,0,0,0,0,0,0,0,0,0,0,0,0,0,0,0,0,0,0,0,0,0,0,0,0,0,0,0,0,0,0,0,0,0,0,Tengarrinha,ÃÂ£720Th. ,31.0,187.0,Midfielder - Defensive Midfield,right,Retired,17.0,0.0,0.0,813.0,18.0,0.0,0.0,1056.0,19.0,0.0,1.0,1294.0,22.0,0.0,0.0,1675.0,30.0,1.0,3.0,2353.0,18.0,1.0,0.0,1299.0,12.0,0.0,0.0,562.0,nan,nan,nan,nan,nan,nan,nan,nan,Liga NOS,nan,nan,nan,nan,nan,nan,nan,nan,nan,nan,nan,nan,nan,nan,nan,nan,nan,nan,nan,nan,nan,nan,nan,nan,nan,nan,nan,nan,nan,nan,nan,nan,nan,nan,nan,nan,nan,nan,nan,nan,nan,nan,nan,nan,nan,nan,nan,nan,nan,nan,nan,nan,nan,nan,nan,nan,nan,nan,nan,nan,nan,nan,nan,nan,nan,nan,nan,nan,nan,nan,nan,nan,nan,nan,nan,nan,nan,nan,nan,nan,nan,nan,nan,nan,nan,nan,nan,nan,nan,nan,nan,nan
19/6/2011,Stefan Reinartz,35008899,771,1/1/1989,22,1,0,6,0,4850,6900,6900,158,135,1390062,189,83,D/DM C,1,2,3,3,3,2,3,4,1,2,2,4,8,10,8,11,6,15,6,10,14,13,8,15,11,11,14,13,13,13,12,12,13,5,9,8,14,16,12,13,9,16,16,10,15,14,20,14,15,13,3,11,14,10,7,14,13,13,14,15,18,5,20,1,1,1,1,1,20,D/DM C,111,1,1,1,1,1,1,20,1,1,16,1,1,1,1,1,0.0,0,0,0,0,0,0,0,0,0,0,0,0,0,0,0,0,0,0,0,0,0,0,0,0,0,0,0,0,0,0,0,0,0,0,0,0,0,0,0,0,0,0,0,0,0,0,0,0,Stefan Reisinger,ÃÂ£900Th. ,39.0,185.0,Forward - Centre-Forward,right,Retired,23.0,4.0,5.0,751.0,26.0,4.0,0.0,879.0,26.0,8.0,0.0,1575.0,24.0,4.0,2.0,1458.0,9.0,6.0,0.0,734.0,nan,nan,nan,nan,nan,nan,nan,nan,nan,nan,nan,nan,nan,nan,nan,nan,Bundesliga,nan,nan,nan,nan,nan,nan,nan,nan,29/6/2010,Stefan Reinartz,35008899.0,771.0,1/1/1989,21.0,1.0,0.0,5.0,0.0,4000.0,6750.0,6750.0,158.0,135.0,8485056.0,189.0,84.0,D/DM C,3.0,3.0,1.0,1.0,2.0,3.0,3.0,2.0,1.0,1.0,2.0,4.0,8.0,10.0,8.0,11.0,6.0,15.0,6.0,10.0,14.0,13.0,8.0,14.0,11.0,11.0,14.0,13.0,13.0,13.0,12.0,12.0,13.0,5.0,9.0,8.0,14.0,16.0,12.0,13.0,12.0,16.0,16.0,10.0,15.0,14.0,20.0,14.0,15.0,13.0,3.0,11.0,9.0,10.0,6.0,14.0,13.0,13.0,14.0,15.0,18.0,5.0,Stefan Reinartz,ÃÂÃÂ£6.75m ,Bundesliga
19/6/2011,Slobodan Rajkovic,5779098,802,2/3/1989,22,7,0,8,0,5500,6250,6650,160,133,7648374,191,88,D C,3,1,3,3,2,1,3,4,3,3,1,5,7,4,8,10,5,12,6,9,17,10,10,15,9,17,14,18,11,13,8,10,17,5,15,7,13,16,15,9,10,15,17,20,6,14,12,13,17,11,14,12,4,13,12,11,10,13,14,13,15,6,20,11,1,1,14,13,20,D C,101,1,1,1,1,1,1,20,13,14,1,1,1,1,10,11,137439000000.0,0,0,0,0,0,0,0,0,0,0,0,0,0,0,0,1,0,1,0,0,0,0,0,0,0,0,0,0,0,0,0,0,0,0,0,0,0,1,0,0,0,0,0,0,0,0,0,0,Slobodan Rajkovic,ÃÂ£2.25m ,31.0,191.0,Defender - Centre-Back,left,Lokomotiv Moscow,27.0,0.0,0.0,2430.0,17.0,1.0,0.0,1267.0,17.0,1.0,0.0,993.0,2.0,0.0,0.0,158.0,14.0,1.0,0.0,1279.0,17.0,1.0,1.0,1098.0,5.0,0.0,0.0,419.0,16.0,1.0,0.0,1420.0,32.0,4.0,1.0,2869.0,Bundesliga,12.0,0.0,0.0,728.0,1.0,0.0,0.0,0.0,nan,nan,nan,nan,nan,nan,nan,nan,nan,nan,nan,nan,nan,nan,nan,nan,nan,nan,nan,nan,nan,nan,nan,nan,nan,nan,nan,nan,nan,nan,nan,nan,nan,nan,nan,nan,nan,nan,nan,nan,nan,nan,nan,nan,nan,nan,nan,nan,nan,nan,nan,nan,nan,nan,nan,nan,nan,nan,nan,nan,nan,nan,nan,nan,nan,nan,nan,nan,nan,nan,nan,nan,nan,nan,nan,nan,nan,nan,nan,nan,nan,nan,nan,nan
19/6/2011,Simon KjÃÂ¦r,947424,764,3/26/1989,22,17,0,2,0,6750,7400,7400,163,138,1782934,189,82,D C,1,3,3,3,1,3,3,1,3,3,1,3,2,5,3,11,5,15,9,13,17,11,3,17,10,7,15,16,16,8,13,9,15,4,12,9,14,15,12,10,13,12,16,14,14,15,20,13,14,8,6,15,5,12,14,12,12,7,16,16,14,3,20,1,1,1,12,1,20,D C,101,1,1,1,1,1,1,20,1,12,1,1,1,1,1,1,9070970000000.0,0,0,0,0,0,0,0,0,0,0,0,0,0,0,0,0,0,0,0,0,0,0,0,0,0,0,0,0,0,0,0,0,0,0,0,0,0,0,1,0,0,0,0,1,0,0,0,0,Simon Kjaer,ÃÂ£7.20m ,31.0,191.0,Defender - Centre-Back,right,AC Milan,34.0,1.0,0.0,3011.0,28.0,0.0,0.0,2216.0,25.0,2.0,2.0,1863.0,37.0,1.0,1.0,3305.0,42.0,3.0,0.0,3700.0,45.0,2.0,0.0,4029.0,43.0,3.0,1.0,3665.0,27.0,3.0,1.0,2201.0,37.0,0.0,0.0,3035.0,Serie A,25.0,0.0,0.0,2006.0,8.0,0.0,0.0,732.0,29/6/2010,Simon KjÃÂ¦r,947424.0,764.0,3/26/1989,21.0,11.0,0.0,2.0,0.0,5700.0,8300.0,8000.0,172.0,151.0,37960589.0,189.0,82.0,D C,1.0,3.0,3.0,2.0,2.0,1.0,1.0,7.0,2.0,3.0,3.0,3.0,2.0,5.0,3.0,14.0,13.0,15.0,9.0,13.0,17.0,15.0,3.0,16.0,13.0,5.0,15.0,16.0,16.0,14.0,9.0,14.0,15.0,9.0,14.0,13.0,14.0,10.0,13.0,10.0,13.0,12.0,15.0,14.0,14.0,13.0,20.0,12.0,14.0,18.0,6.0,15.0,5.0,12.0,14.0,12.0,12.0,16.0,16.0,16.0,14.0,3.0,Simon Kjaer,ÃÂÃÂ£9.00m ,Bundesliga,19-06-17,18.3.4.28,Simon KjÃÂr,947424,764,26-Mar-89,28,68,3,2,0,6500,7500,7250,155,150,21095489,189,90,D C,2,2,4,1,4,3,2,1,1,1,1,3,7,6,7,8,14,13,10,12,18,10,17,16,8,17,15,20,8,16,7,14,18,5,16,7,16,14,13,11,9,15,16,8,15,13,20,13,17,17,13,15,8,12,14,18,7,15,16,14,14,10,20,1,1,1,10,1,20,D C,101,1,1,1,1,1,1,20,1,10,8,1,1,1,1,1,9070970000000.0,0,0,0,0,0,0,0,0,0,0,0,0,0,0,0,0,0,0,0,0,0,0,0,0,0,0,0,0,0,0,0,0,0,0,0,0,0,0,1,0,0,0,0,1,0,0,0,0,Simon Kjaer,ÃÂ£9.00m ,31.0,191.0,Defender - Centre-Back,right,AC Milan,43.0,3.0,1.0,3665.0,27.0,3.0,1.0,2201.0,37.0,0.0,0.0,3035.0,25.0,0.0,0.0,2006.0,9.0,0.0,0.0,822.0,LaLiga,nan,nan,nan,nan,nan,nan,nan,nan,nan,nan,nan,nan,nan,nan,nan,nan,nan,nan,nan,nan,nan,nan,nan,nan,nan,nan,nan,nan,nan,nan,nan,nan,nan,nan,nan,nan,nan,nan,nan,nan,nan,nan,nan,nan,nan,nan,nan,nan,nan,nan,nan,nan,nan,nan,nan,nan,nan,nan,nan,nan,nan,nan,nan,nan,nan,nan,nan,nan,nan,nan,nan,nan,nan,nan,nan,nan,nan,nan,nan,nan,nan,nan,nan,nan,nan
19/6/2011,Samuel Souprayen,34009619,769,2/18/1989,22,0,0,4,0,4200,5300,5300,140,118,467800,187,70,D LC,2,1,2,2,1,1,2,7,2,1,1,6,10,10,7,9,7,14,8,12,14,11,6,12,10,12,12,13,11,12,9,10,14,7,8,7,12,14,14,15,11,15,14,20,15,14,5,14,13,13,12,14,6,10,15,14,13,11,15,15,15,6,20,15,1,1,9,20,15,D LC,104,1,1,1,1,1,1,15,20,9,1,1,1,1,15,1,0.0,0,0,0,0,0,0,0,0,0,0,0,0,0,0,0,0,0,0,0,0,0,0,0,0,0,0,0,0,0,0,0,0,0,0,0,0,0,0,0,0,0,0,0,0,0,0,0,0,Samuel Souprayen,ÃÂ£1.58m ,31.0,187.0,Defender - Centre-Back,left,AJ Auxerre,20.0,0.0,0.0,1469.0,38.0,0.0,1.0,3228.0,28.0,0.0,0.0,2419.0,35.0,1.0,1.0,3127.0,31.0,1.0,0.0,2803.0,22.0,0.0,0.0,1722.0,42.0,0.0,3.0,3760.0,25.0,0.0,0.0,1881.0,31.0,1.0,1.0,2768.0,Ligue 1,23.0,0.0,1.0,2043.0,0.0,0.0,0.0,0.0,29/6/2010,Samuel Souprayen,34009619.0,769.0,2/18/1989,21.0,0.0,0.0,4.0,0.0,2500.0,3750.0,3750.0,140.0,115.0,1631148.0,187.0,70.0,D/WB L,2.0,3.0,3.0,3.0,1.0,2.0,2.0,3.0,2.0,2.0,1.0,7.0,11.0,10.0,7.0,10.0,7.0,14.0,8.0,12.0,14.0,11.0,6.0,12.0,10.0,11.0,12.0,13.0,14.0,12.0,9.0,12.0,14.0,7.0,12.0,7.0,13.0,13.0,15.0,13.0,11.0,15.0,14.0,20.0,15.0,12.0,5.0,14.0,12.0,13.0,11.0,15.0,6.0,10.0,5.0,14.0,13.0,12.0,15.0,15.0,15.0,6.0,Samuel Souprayen,ÃÂÃÂ£1.35m ,Ligue 1,19-06-17,18.3.4.28,Samuel Souprayen,34009619,769,18-Feb-89,28,0,0,3,0,4150,6250,6250,135,125,6866155,187,70,D LC,2,2,3,1,2,1,3,2,1,3,1,6,10,10,6,10,7,14,8,12,15,12,6,13,10,13,13,14,12,12,10,11,14,7,8,9,12,14,14,15,12,15,14,20,15,14,6,14,14,13,12,14,6,11,9,14,13,11,15,15,15,6,20,15,1,1,1,20,17,D LC,104,1,1,1,1,1,1,17,20,1,1,1,1,1,15,1,0.0,0,0,0,0,0,0,0,0,0,0,0,0,0,0,0,0,0,0,0,0,0,0,0,0,0,0,0,0,0,0,0,0,0,0,0,0,0,0,0,0,0,0,0,0,0,0,0,0,Samuel Souprayen,ÃÂ£630Th. ,31.0,187.0,Defender - Centre-Back,left,AJ Auxerre,42.0,0.0,3.0,3760.0,25.0,0.0,0.0,1881.0,31.0,1.0,1.0,2768.0,23.0,0.0,1.0,2043.0,0.0,0.0,0.0,0.0,Serie A,nan,nan,nan,nan,nan,nan,nan,nan,nan,nan,nan,nan,nan,nan,nan,nan,nan,nan,nan,nan,nan,nan,nan,nan,nan,nan,nan,nan,nan,nan,nan,nan,nan,nan,nan,nan,nan,nan,nan,nan,nan,nan,nan,nan,nan,nan,nan,nan,nan,nan,nan,nan,nan,nan,nan,nan,nan,nan,nan,nan,nan,nan,nan,nan,nan,nan,nan,nan,nan,nan,nan,nan,nan,nan,nan,nan,nan,nan,nan,nan,nan,nan,nan,nan,nan
19/6/2011,Ryan Shotton,5129388,765,9/30/1988,22,0,0,0,0,3000,5550,5900,138,111,1272614,191,85,D RC,2,3,1,1,3,2,3,5,2,3,3,3,12,11,10,9,4,13,8,17,12,8,4,13,10,15,12,14,12,11,9,11,12,5,10,11,13,13,14,11,11,12,13,12,12,11,20,12,12,11,10,11,3,11,12,14,17,8,16,13,3,4,20,1,1,1,18,1,20,D RC,103,1,1,10,1,1,1,20,1,18,1,1,1,1,1,1,1125900000000000.0,0,0,0,0,0,0,0,0,0,0,0,0,0,0,0,0,0,0,0,0,0,0,0,0,0,0,0,0,0,0,0,0,0,0,0,0,0,0,0,0,0,0,0,0,0,0,0,0,Ryan Shotton,ÃÂ£2.25m ,32.0,189.0,Defender - Centre-Back,right,Without Club,4.0,0.0,0.0,260.0,38.0,2.0,3.0,2293.0,27.0,0.0,1.0,2152.0,14.0,1.0,0.0,1075.0,30.0,2.0,3.0,2489.0,16.0,1.0,0.0,1109.0,45.0,2.0,1.0,4005.0,31.0,1.0,2.0,2658.0,35.0,0.0,1.0,2949.0,Premier League,22.0,0.0,0.0,1799.0,nan,nan,nan,nan,29/6/2010,Ryan Shotton,5129388.0,765.0,9/30/1988,21.0,0.0,0.0,0.0,0.0,2200.0,5100.0,5100.0,120.0,106.0,4371474.0,191.0,85.0,D RC,2.0,2.0,1.0,2.0,2.0,2.0,2.0,6.0,2.0,2.0,1.0,2.0,11.0,10.0,9.0,8.0,3.0,13.0,7.0,12.0,11.0,7.0,3.0,14.0,9.0,14.0,11.0,13.0,11.0,10.0,8.0,10.0,12.0,4.0,8.0,11.0,14.0,12.0,13.0,11.0,11.0,12.0,13.0,12.0,12.0,11.0,20.0,12.0,14.0,10.0,10.0,10.0,3.0,10.0,8.0,14.0,17.0,8.0,16.0,13.0,3.0,4.0,Ryan Shotton,ÃÂÃÂ£45Th. ,Premier League
19/6/2011,Ritchie De Laet,8189806,757,11/28/1988,22,2,0,4,0,3750,6000,5950,140,119,274565,186,78,D RLC,3,3,2,1,2,3,2,3,2,2,2,2,6,9,4,11,2,15,4,8,13,8,8,15,11,14,12,12,9,11,5,9,17,6,12,6,12,14,14,14,11,12,14,11,14,15,20,12,14,14,10,10,5,15,15,10,10,13,14,15,14,5,20,12,1,1,18,17,20,D RLC,106,1,12,1,1,1,1,20,17,18,6,1,1,1,10,12,137439000000.0,0,0,0,0,0,0,0,0,0,0,0,0,0,0,0,0,0,0,0,0,0,0,0,0,0,0,0,0,0,0,0,0,0,0,0,0,0,1,0,0,0,0,0,0,0,0,0,0,Ritchie De Laet,ÃÂ£1.13m ,31.0,186.0,Defender - Right-Back,right,Royal Antwerp FC,36.0,0.0,0.0,3050.0,19.0,3.0,3.0,1563.0,48.0,2.0,3.0,3975.0,38.0,2.0,6.0,3196.0,28.0,0.0,1.0,2062.0,25.0,1.0,1.0,1741.0,4.0,0.0,0.0,317.0,24.0,0.0,2.0,1512.0,28.0,7.0,1.0,2310.0,Premier League,28.0,1.0,0.0,2325.0,11.0,0.0,0.0,934.0,nan,nan,nan,nan,nan,nan,nan,nan,nan,nan,nan,nan,nan,nan,nan,nan,nan,nan,nan,nan,nan,nan,nan,nan,nan,nan,nan,nan,nan,nan,nan,nan,nan,nan,nan,nan,nan,nan,nan,nan,nan,nan,nan,nan,nan,nan,nan,nan,nan,nan,nan,nan,nan,nan,nan,nan,nan,nan,nan,nan,nan,nan,nan,nan,nan,nan,nan,nan,nan,nan,nan,nan,nan,nan,nan,nan,nan,nan,nan,nan,nan,nan,nan,nan
19/6/2011,Philipp Wollscheid,92021286,771,3/6/1989,22,0,0,0,0,5300,6700,6700,152,134,690151,194,84,D C,2,1,3,2,2,2,2,4,3,1,2,3,5,7,7,11,5,16,5,8,14,10,8,15,11,11,14,15,11,13,6,13,14,5,7,14,14,15,12,9,8,16,17,12,12,12,20,14,14,14,6,10,6,5,4,12,16,15,15,11,14,11,20,1,1,1,1,1,20,D C,101,1,1,1,1,1,1,20,1,1,1,1,1,1,1,1,0.0,0,0,0,0,0,0,0,0,0,0,0,0,0,0,0,0,0,0,0,0,0,0,0,0,0,0,0,0,0,0,0,0,0,0,0,0,0,0,0,0,0,0,0,0,0,0,0,0,Philipp Wollscheid,ÃÂ£6.75m ,31.0,194.0,Defender - Centre-Back,right,Retired,34.0,3.0,0.0,3029.0,36.0,2.0,0.0,3183.0,40.0,3.0,0.0,3600.0,27.0,0.0,0.0,1685.0,19.0,0.0,1.0,1395.0,39.0,0.0,0.0,3494.0,13.0,0.0,0.0,1081.0,2.0,0.0,0.0,180.0,nan,nan,nan,nan,Bundesliga,nan,nan,nan,nan,nan,nan,nan,nan,29/6/2010,Phillipp Wollscheid,92021286.0,771.0,3/6/1989,21.0,0.0,0.0,0.0,0.0,150.0,3550.0,3550.0,123.0,100.0,1676601.0,181.0,81.0,D C,2.0,3.0,2.0,1.0,2.0,3.0,2.0,3.0,2.0,2.0,3.0,4.0,9.0,5.0,9.0,12.0,4.0,14.0,4.0,2.0,14.0,9.0,10.0,14.0,10.0,13.0,13.0,13.0,11.0,11.0,10.0,14.0,10.0,8.0,12.0,5.0,12.0,7.0,12.0,7.0,10.0,14.0,9.0,12.0,11.0,9.0,20.0,8.0,10.0,10.0,7.0,10.0,10.0,10.0,8.0,17.0,11.0,14.0,14.0,11.0,7.0,6.0,Philipp Wollscheid,ÃÂÃÂ£3.15m ,Bundesliga
19/6/2011,Neven Subotic,35013755,802,12/10/1988,22,24,1,0,0,6700,7300,7300,159,143,6857213,193,88,D C,2,3,2,1,2,3,2,4,3,2,2,3,4,8,11,12,11,17,12,11,16,11,11,16,11,13,15,16,12,8,12,12,14,8,12,9,14,15,9,9,10,15,17,11,17,14,20,13,17,15,8,11,2,2,18,13,11,12,15,12,9,3,20,1,1,1,1,1,20,D C,101,1,1,1,1,1,1,20,1,1,1,1,1,1,1,1,43980500000000.0,0,0,0,0,0,0,0,0,0,1,0,0,0,0,0,0,0,0,0,0,0,0,0,0,0,0,0,0,0,0,0,0,0,0,0,0,0,0,0,0,0,0,0,1,0,1,0,0,Neven Subotic,ÃÂ£16.20m ,31.0,193.0,Defender - Centre-Back,right,Denizlispor,41.0,3.0,0.0,3703.0,34.0,0.0,1.0,3045.0,41.0,3.0,1.0,3682.0,16.0,0.0,0.0,1396.0,40.0,3.0,0.0,3411.0,11.0,0.0,1.0,809.0,14.0,1.0,0.0,1059.0,21.0,2.0,0.0,1800.0,28.0,1.0,0.0,2362.0,Bundesliga,23.0,1.0,0.0,1971.0,2.0,1.0,0.0,180.0,29/6/2010,Neven Subotic,35013755.0,802.0,12/10/1988,21.0,15.0,1.0,0.0,0.0,5112.0,6900.0,7150.0,166.0,143.0,23703262.0,193.0,87.0,D C,1.0,3.0,2.0,3.0,3.0,1.0,1.0,6.0,1.0,1.0,1.0,3.0,7.0,6.0,13.0,12.0,11.0,18.0,12.0,9.0,15.0,13.0,5.0,16.0,13.0,12.0,14.0,13.0,12.0,9.0,12.0,13.0,15.0,8.0,8.0,7.0,13.0,15.0,11.0,8.0,13.0,14.0,17.0,14.0,12.0,14.0,20.0,12.0,16.0,14.0,8.0,9.0,5.0,4.0,18.0,13.0,10.0,14.0,17.0,16.0,15.0,3.0,Neven Subotic,ÃÂÃÂ£16.20m ,Bundesliga,19-06-17,18.3.4.28,Neven Subotic,35013755,802,10-Dec-88,28,36,2,0,0,4250,6250,6750,148,135,15029734,193,88,D C,3,2,1,2,1,1,2,2,3,3,1,3,6,6,8,10,11,15,11,8,16,10,9,16,9,10,14,17,12,11,10,13,11,6,11,7,16,14,8,9,8,10,18,10,12,11,20,12,16,15,10,13,14,2,18,12,16,12,17,11,8,6,20,1,1,1,1,1,20,D C,101,1,1,1,1,1,1,20,1,1,1,1,1,1,1,1,0.0,0,0,0,0,0,0,0,0,0,0,0,0,0,0,0,0,0,0,0,0,0,0,0,0,0,0,0,0,0,0,0,0,0,0,0,0,0,0,0,0,0,0,0,0,0,0,0,0,Neven Subotic,ÃÂ£4.50m ,31.0,193.0,Defender - Centre-Back,right,Denizlispor,14.0,1.0,0.0,1059.0,21.0,2.0,0.0,1800.0,28.0,1.0,0.0,2362.0,23.0,1.0,0.0,1971.0,3.0,1.0,0.0,270.0,Bundesliga,15-07-16,17.3.2.23,Neven Subotic,35013755.0,802.0,10-Dec-88,27.0,36.0,2.0,0.0,0.0,4400.0,6900.0,6900.0,148.0,138.0,16903522.0,193.0,88.0,D C,3.0,2.0,3.0,1.0,3.0,1.0,3.0,1.0,2.0,3.0,3.0,3.0,6.0,6.0,8.0,10.0,11.0,16.0,11.0,7.0,17.0,10.0,9.0,17.0,9.0,10.0,14.0,17.0,12.0,10.0,10.0,12.0,11.0,6.0,11.0,7.0,16.0,14.0,8.0,9.0,8.0,10.0,18.0,10.0,12.0,12.0,20.0,11.0,16.0,15.0,10.0,13.0,14.0,2.0,18.0,12.0,16.0,12.0,17.0,11.0,8.0,6.0,Neven Subotic,ÃÂ£4.50m ,Bundesliga
19/6/2011,Mikel San JosÃÂ©,67037571,796,5/30/1989,22,0,0,3,0,5000,7000,7000,155,140,1089234,186,77,D C,3,2,2,3,2,2,3,7,1,2,3,5,8,10,8,12,8,16,5,8,14,12,16,15,13,9,12,14,13,14,12,13,13,10,12,9,14,13,13,10,13,15,14,10,12,13,20,14,15,13,5,12,7,5,14,14,10,14,17,10,10,5,20,1,1,1,1,1,20,D C,101,1,1,1,1,1,1,20,1,1,10,1,1,1,1,1,0.0,0,0,0,0,0,0,0,0,0,0,0,0,0,0,0,0,0,0,0,0,0,0,0,0,0,0,0,0,0,0,0,0,0,0,0,0,0,0,0,0,0,0,0,0,0,0,0,0,Mikel San JosÃÂ©,ÃÂ£4.05m ,31.0,187.0,Midfielder - Defensive Midfield,right,Birmingham City,34.0,2.0,0.0,2943.0,38.0,3.0,1.0,2294.0,40.0,6.0,0.0,2771.0,30.0,5.0,1.0,2250.0,43.0,8.0,1.0,3290.0,51.0,4.0,4.0,3911.0,44.0,4.0,2.0,3349.0,38.0,1.0,1.0,2892.0,37.0,1.0,1.0,1992.0,LaLiga,12.0,0.0,0.0,463.0,2.0,0.0,0.0,90.0,29/6/2010,Mikel San JosÃÂ©,67037571.0,796.0,5/30/1989,21.0,0.0,0.0,3.0,0.0,4556.0,6250.0,6250.0,155.0,135.0,11881979.0,186.0,77.0,D C,1.0,2.0,2.0,1.0,2.0,3.0,1.0,4.0,2.0,2.0,2.0,3.0,8.0,8.0,8.0,12.0,5.0,16.0,5.0,8.0,14.0,12.0,13.0,15.0,12.0,9.0,11.0,14.0,13.0,13.0,12.0,12.0,12.0,7.0,12.0,7.0,14.0,14.0,12.0,9.0,13.0,14.0,14.0,12.0,12.0,12.0,20.0,14.0,14.0,13.0,5.0,12.0,7.0,5.0,14.0,14.0,7.0,14.0,17.0,10.0,10.0,5.0,Mikel San JosÃÂÃÂ©,ÃÂÃÂ£4.50m ,LaLiga,19-06-17,18.3.4.28,Mikel San JosÃÂ©,67037571,796,30-May-89,28,1,0,3,0,6500,7450,7450,152,150,36223113,186,77,D/DM/M C,3,2,4,2,2,1,2,2,2,1,3,5,8,10,13,12,9,18,8,8,16,14,14,15,13,12,13,15,14,13,12,14,12,8,13,13,16,16,14,11,8,10,15,12,12,12,20,15,16,14,11,13,8,5,14,12,11,12,17,10,10,5,18,1,16,1,1,1,18,D/DM/M C,331,1,1,1,1,1,1,18,1,1,20,16,1,1,1,1,33554432.0,0,0,0,0,0,0,0,0,0,0,0,0,0,0,0,0,0,0,0,0,0,0,0,0,0,1,0,0,0,0,0,0,0,0,0,0,0,0,0,0,0,0,0,0,0,0,0,0,Mikel San JosÃÂ©,ÃÂ£8.10m ,31.0,187.0,Midfielder - Defensive Midfield,right,Birmingham City,44.0,4.0,2.0,3349.0,38.0,1.0,1.0,2892.0,37.0,1.0,1.0,1992.0,12.0,0.0,0.0,463.0,2.0,0.0,0.0,90.0,LaLiga,15-07-16,17.3.2.23,Mikel San JosÃÂ©,67037571.0,796.0,30-May-89,27.0,1.0,0.0,3.0,0.0,6500.0,7450.0,7450.0,152.0,149.0,34999999.0,186.0,77.0,D/DM/M C,4.0,2.0,2.0,3.0,1.0,1.0,1.0,2.0,3.0,3.0,2.0,5.0,8.0,10.0,14.0,13.0,9.0,18.0,8.0,8.0,16.0,14.0,14.0,15.0,13.0,12.0,13.0,15.0,14.0,12.0,13.0,14.0,12.0,8.0,13.0,14.0,16.0,16.0,14.0,11.0,8.0,10.0,15.0,12.0,12.0,12.0,20.0,15.0,16.0,14.0,11.0,13.0,8.0,5.0,14.0,12.0,11.0,12.0,17.0,10.0,10.0,5.0,Mikel San JosÃÂ©,ÃÂ£10.80m ,LaLiga
19/6/2011,Micah Richards,5005673,765,6/24/1988,22,12,1,15,3,5600,7150,7300,158,146,6180167,181,83,D RC,2,2,3,2,1,2,1,1,3,2,3,3,7,8,7,8,5,18,4,15,14,8,6,15,7,15,11,19,9,12,6,13,11,4,11,7,11,17,17,19,13,9,14,8,17,18,20,19,18,10,8,12,12,16,5,16,18,14,10,13,11,8,20,12,10,1,20,5,18,D RC,103,1,1,5,1,1,1,18,5,20,10,10,1,1,1,12,32808.0,0,0,0,1,0,1,0,0,0,0,0,0,0,0,0,1,0,0,0,0,0,0,0,0,0,0,0,0,0,0,0,0,0,0,0,0,0,0,0,0,0,0,0,0,0,0,0,0,Micah Richards,ÃÂ£16.65m ,32.0,180.0,Defender - Right-Back,right,Retired,31.0,3.0,2.0,2482.0,37.0,1.0,6.0,2760.0,10.0,0.0,0.0,843.0,10.0,0.0,2.0,742.0,20.0,0.0,1.0,1236.0,28.0,2.0,1.0,2398.0,3.0,0.0,0.0,218.0,0.0,0.0,0.0,0.0,nan,nan,nan,nan,Premier League,nan,nan,nan,nan,nan,nan,nan,nan,29/6/2010,Micah Richards,5005673.0,765.0,6/24/1988,22.0,11.0,1.0,14.0,3.0,4692.0,7150.0,7150.0,152.0,137.0,29235593.0,181.0,83.0,D RC,2.0,3.0,3.0,3.0,1.0,1.0,2.0,6.0,1.0,3.0,3.0,3.0,6.0,8.0,7.0,8.0,5.0,15.0,4.0,15.0,14.0,7.0,6.0,15.0,7.0,15.0,10.0,19.0,9.0,12.0,6.0,12.0,11.0,4.0,11.0,7.0,8.0,17.0,17.0,19.0,13.0,9.0,14.0,8.0,17.0,18.0,20.0,19.0,18.0,10.0,8.0,12.0,6.0,16.0,17.0,16.0,18.0,14.0,10.0,13.0,11.0,8.0,Micah Richards,ÃÂÃÂ£9.00m ,Premier League
19/6/2011,Mexer,12013851,35,9/8/1988,22,6,0,0,0,2500,5885,5250,124,107,97142,181,75,D C,1,3,3,1,3,1,3,1,1,2,1,6,6,7,7,10,9,13,8,8,13,9,9,12,10,13,11,12,11,11,7,10,13,6,9,7,12,11,11,13,12,12,13,8,14,13,20,11,12,12,9,11,7,9,13,13,13,13,14,13,13,4,20,1,7,1,7,1,20,D C,101,1,1,1,1,1,1,20,1,7,10,7,1,1,1,1,0.0,0,0,0,0,0,0,0,0,0,0,0,0,0,0,0,0,0,0,0,0,0,0,0,0,0,0,0,0,0,0,0,0,0,0,0,0,0,0,0,0,0,0,0,0,0,0,0,0,Mexer,ÃÂ£810Th. ,32.0,188.0,Defender - Centre-Back,right,FC Girondins Bordeaux,22.0,0.0,1.0,1574.0,27.0,0.0,0.0,2374.0,31.0,2.0,0.0,2689.0,30.0,0.0,0.0,2692.0,39.0,4.0,0.0,3430.0,16.0,0.0,0.0,1308.0,25.0,2.0,1.0,1998.0,20.0,0.0,0.0,1294.0,43.0,2.0,0.0,3814.0,Liga NOS,21.0,0.0,2.0,1699.0,0.0,0.0,0.0,0.0,29/6/2010,Mexer,12013851.0,35.0,9/8/1987,22.0,6.0,0.0,0.0,0.0,2500.0,5885.0,5250.0,130.0,107.0,599999.0,181.0,75.0,D C,2.0,3.0,1.0,3.0,3.0,2.0,3.0,1.0,3.0,3.0,3.0,5.0,8.0,5.0,4.0,14.0,3.0,14.0,10.0,4.0,14.0,12.0,4.0,14.0,10.0,7.0,14.0,8.0,9.0,11.0,4.0,12.0,13.0,7.0,8.0,9.0,12.0,6.0,10.0,14.0,14.0,14.0,9.0,8.0,14.0,14.0,20.0,6.0,6.0,9.0,15.0,9.0,8.0,10.0,10.0,13.0,14.0,13.0,14.0,13.0,13.0,4.0,Mexer,ÃÂÃÂ£180Th. ,Liga NOS,19-06-17,18.3.4.28,Edson Mexer,12013851,35,08-Sep-88,28,36,1,0,0,4800,6550,6550,138,131,11391915,188,79,D C,2,1,1,1,3,2,1,2,4,2,2,7,7,8,8,11,10,15,9,9,14,11,10,15,11,15,14,14,12,14,8,11,13,6,10,8,14,12,12,14,13,15,14,8,14,13,20,15,14,13,9,13,12,9,13,13,13,13,14,13,13,4,20,1,1,1,10,1,20,D C,101,1,1,1,1,1,1,20,1,10,10,1,1,1,1,1,274878000000.0,0,0,0,0,0,0,0,0,0,0,0,0,0,0,0,0,0,0,0,0,0,0,0,0,0,0,0,0,0,0,0,0,0,0,0,0,0,0,1,0,0,0,0,0,0,0,0,0,nan,nan,nan,nan,nan,nan,nan,nan,nan,nan,nan,nan,nan,nan,nan,nan,nan,nan,nan,nan,nan,nan,nan,nan,nan,nan,nan,nan,15-07-16,17.3.2.23,Edson Mexer,12013851.0,35.0,08-Sep-88,27.0,39.0,1.0,0.0,0.0,4800.0,6600.0,6650.0,138.0,134.0,10826603.0,188.0,79.0,D C,1.0,3.0,4.0,1.0,1.0,3.0,3.0,2.0,2.0,3.0,3.0,7.0,7.0,8.0,8.0,11.0,10.0,15.0,9.0,9.0,14.0,11.0,10.0,15.0,11.0,13.0,14.0,12.0,12.0,14.0,8.0,11.0,13.0,6.0,10.0,8.0,15.0,12.0,12.0,14.0,13.0,15.0,14.0,8.0,14.0,14.0,20.0,15.0,14.0,13.0,9.0,13.0,7.0,9.0,13.0,13.0,13.0,13.0,14.0,13.0,13.0,4.0,nan,nan,nan
19/6/2011,Maxime Le Borgne,85012664,769,7/18/1988,22,0,0,0,0,1385,4557,2771,120,101,10296,179,75,D C,2,2,2,3,3,2,3,1,3,3,1,5,8,7,6,9,7,13,8,6,12,9,10,11,9,11,13,13,8,11,11,9,13,8,8,7,12,12,13,14,11,13,10,20,13,13,5,15,12,14,11,13,8,10,8,11,14,13,14,14,15,6,20,12,1,1,1,12,20,D C,101,1,1,7,1,1,1,20,12,1,1,1,1,1,12,1,0.0,0,0,0,0,0,0,0,0,0,0,0,0,0,0,0,0,0,0,0,0,0,0,0,0,0,0,0,0,0,0,0,0,0,0,0,0,0,0,0,0,0,0,0,0,0,0,0,0,nan,nan,nan,nan,nan,nan,nan,nan,nan,nan,nan,nan,nan,nan,nan,nan,nan,nan,nan,nan,nan,nan,nan,nan,nan,nan,nan,nan,nan,nan,nan,nan,nan,nan,nan,nan,nan,nan,nan,nan,nan,nan,nan,nan,nan,nan,nan,nan,nan,nan,nan,nan,nan,nan,nan,nan,nan,nan,nan,nan,nan,nan,nan,nan,nan,nan,nan,nan,nan,nan,nan,nan,nan,nan,nan,nan,nan,nan,nan,nan,nan,nan,nan,nan,nan,nan,nan,nan,nan,nan,nan,nan,nan,nan,nan,nan,nan,nan,nan,nan,nan,nan,nan,nan,nan,nan,nan,nan,nan,nan,nan,nan,nan,nan,nan,nan,nan,nan,nan,nan,nan,nan,nan,nan,nan,nan,nan,nan,nan,nan,nan,nan,nan,nan,nan,nan
19/6/2011,Mats Hummels,35007944,771,12/16/1988,22,7,0,21,5,6600,7800,7800,172,156,7414823,192,90,D C,1,2,1,1,3,3,2,6,2,2,1,3,7,8,10,13,9,15,6,11,17,12,8,17,13,12,17,13,18,16,12,14,15,9,14,12,15,17,14,10,12,14,16,14,15,12,20,13,15,18,8,10,14,9,15,14,12,13,15,12,13,9,20,1,1,1,12,1,20,D C,101,1,1,1,1,1,1,20,1,12,15,1,1,1,1,1,8933530000000.0,0,0,0,0,0,0,0,0,0,0,0,0,0,0,0,0,0,0,0,0,0,0,0,0,0,0,0,0,0,0,0,0,0,0,0,0,0,1,0,0,0,0,0,1,0,0,0,0,Mats Hummels,ÃÂ£21.60m ,31.0,191.0,Defender - Centre-Back,right,Borussia Dortmund,42.0,6.0,1.0,3764.0,46.0,3.0,2.0,4210.0,42.0,3.0,4.0,3485.0,34.0,2.0,2.0,2967.0,32.0,2.0,0.0,2678.0,50.0,3.0,4.0,4210.0,42.0,3.0,3.0,3260.0,41.0,3.0,4.0,3491.0,33.0,2.0,2.0,2849.0,Bundesliga,41.0,1.0,3.0,3483.0,8.0,1.0,0.0,706.0,29/6/2010,Mats Hummels,35007944.0,771.0,12/16/1988,21.0,1.0,0.0,20.0,5.0,4500.0,7350.0,7350.0,172.0,147.0,24462238.0,192.0,88.0,D C,1.0,1.0,3.0,2.0,3.0,3.0,3.0,2.0,3.0,2.0,3.0,4.0,7.0,9.0,10.0,13.0,5.0,14.0,6.0,11.0,16.0,11.0,8.0,17.0,12.0,15.0,14.0,16.0,17.0,14.0,12.0,14.0,13.0,8.0,13.0,12.0,15.0,17.0,14.0,9.0,14.0,12.0,16.0,13.0,15.0,12.0,20.0,14.0,14.0,11.0,8.0,10.0,14.0,15.0,15.0,14.0,12.0,13.0,14.0,12.0,12.0,8.0,Mats Hummels,ÃÂÃÂ£16.20m ,Bundesliga,19-06-17,18.3.4.28,Mats Hummels,35007944,771,16-Dec-88,28,57,4,21,5,8550,8550,8550,171,171,230711557,191,92,D C,3,1,3,3,2,3,3,1,3,3,1,5,9,12,10,14,8,15,9,8,17,15,11,17,15,12,18,14,19,13,14,17,14,9,14,10,18,16,12,9,11,17,16,14,15,12,20,14,16,16,9,14,6,7,8,13,16,14,17,18,16,10,20,6,1,1,10,1,20,D C,101,1,1,1,1,1,1,20,1,10,12,1,1,1,1,6,1.15292e+18,0,0,0,0,0,0,0,0,0,0,0,0,0,0,1,0,0,0,0,0,0,0,0,0,0,0,0,0,0,0,0,0,1,0,0,0,0,0,0,0,0,0,0,0,0,0,0,0,Mats Hummels,ÃÂ£54.00m ,31.0,191.0,Defender - Centre-Back,right,Borussia Dortmund,42.0,3.0,3.0,3260.0,41.0,3.0,4.0,3491.0,33.0,2.0,2.0,2849.0,41.0,1.0,3.0,3483.0,8.0,1.0,0.0,706.0,Bundesliga,15-07-16,17.3.2.23,Mats Hummels,35007944.0,771.0,16-Dec-88,27.0,50.0,4.0,21.0,5.0,8550.0,8550.0,8550.0,171.0,171.0,159242989.0,191.0,92.0,D C,2.0,3.0,1.0,3.0,2.0,4.0,1.0,1.0,3.0,3.0,1.0,5.0,9.0,12.0,10.0,14.0,8.0,15.0,9.0,8.0,17.0,15.0,11.0,17.0,15.0,12.0,18.0,14.0,19.0,13.0,14.0,17.0,14.0,9.0,14.0,10.0,18.0,16.0,12.0,9.0,11.0,17.0,16.0,14.0,15.0,12.0,20.0,14.0,16.0,16.0,9.0,14.0,6.0,7.0,8.0,13.0,16.0,14.0,17.0,18.0,16.0,10.0,Mats Hummels,ÃÂ£36.00m ,Bundesliga
19/6/2011,Mapou Yanga Mbiwa,34000001,769,5/15/1989,22,0,0,4,0,4950,6200,6200,165,138,1366250,184,77,D/WB RLC,3,2,2,2,2,2,2,4,3,2,2,5,11,9,5,9,6,15,8,12,15,8,7,14,9,13,15,15,12,12,6,12,17,9,9,7,14,14,16,14,11,15,13,10,14,13,20,16,15,14,13,15,7,12,10,14,14,14,16,14,14,6,20,17,1,1,17,17,20,D/WB RLC,116,1,1,1,1,1,1,20,17,17,1,1,1,1,17,17,0.0,0,0,0,0,0,0,0,0,0,0,0,0,0,0,0,0,0,0,0,0,0,0,0,0,0,0,0,0,0,0,0,0,0,0,0,0,0,0,0,0,0,0,0,0,0,0,0,0,Mapou Yanga-Mbiwa,ÃÂ£8.10m ,31.0,184.0,Defender - Centre-Back,right,Without Club,42.0,1.0,0.0,3799.0,38.0,1.0,1.0,3440.0,46.0,0.0,0.0,3946.0,26.0,0.0,0.0,1797.0,38.0,1.0,1.0,2914.0,35.0,2.0,0.0,3027.0,34.0,0.0,0.0,2865.0,3.0,0.0,0.0,217.0,5.0,0.0,0.0,378.0,Ligue 1,2.0,0.0,0.0,180.0,nan,nan,nan,nan,29/6/2010,Mapou Yanga Mbiwa,34000001.0,769.0,5/15/1989,21.0,0.0,0.0,4.0,0.0,4761.0,6209.0,6200.0,165.0,138.0,12611678.0,184.0,77.0,D/WB RLC,2.0,2.0,1.0,3.0,2.0,1.0,1.0,6.0,3.0,1.0,2.0,5.0,11.0,9.0,5.0,9.0,6.0,15.0,8.0,12.0,15.0,8.0,7.0,14.0,9.0,13.0,15.0,15.0,12.0,12.0,6.0,12.0,17.0,9.0,9.0,7.0,14.0,14.0,16.0,14.0,11.0,15.0,13.0,10.0,14.0,13.0,20.0,16.0,15.0,14.0,13.0,15.0,7.0,12.0,12.0,14.0,14.0,14.0,16.0,14.0,14.0,6.0,Mapou Yanga-Mbiwa,ÃÂÃÂ£4.05m ,Ligue 1
19/6/2011,Maicon,19017908,1651,9/14/1988,22,0,0,0,0,4500,5350,6650,155,133,568724,190,74,D C,2,1,3,2,3,1,2,3,1,2,2,7,7,7,10,11,7,16,8,8,15,11,10,13,11,13,12,14,11,10,8,10,12,7,10,8,14,14,12,12,13,17,16,10,16,12,20,15,17,13,12,12,8,8,14,13,13,13,14,14,14,5,20,1,1,1,1,1,20,D C,101,1,7,1,1,1,1,20,1,1,4,1,1,1,1,1,0.0,0,0,0,0,0,0,0,0,0,0,0,0,0,0,0,0,0,0,0,0,0,0,0,0,0,0,0,0,0,0,0,0,0,0,0,0,0,0,0,0,0,0,0,0,0,0,0,0,Maicon,ÃÂ£13.05m ,39.0,185.0,Defender - Right-Back,right,Villa Nova AtlÃÂ©tico Clube (MG),43.0,1.0,10.0,3835.0,29.0,3.0,5.0,2542.0,16.0,0.0,0.0,1041.0,31.0,2.0,2.0,2549.0,19.0,2.0,1.0,1440.0,19.0,1.0,2.0,1246.0,9.0,1.0,0.0,627.0,nan,nan,nan,nan,13.0,0.0,0.0,939.0,Serie A,nan,nan,nan,nan,nan,nan,nan,nan,29/6/2010,Maicon,19017908.0,1651.0,9/14/1988,21.0,0.0,0.0,0.0,0.0,2250.0,5714.0,6500.0,155.0,127.0,9211332.0,190.0,74.0,D C,3.0,3.0,1.0,1.0,2.0,2.0,2.0,1.0,2.0,2.0,2.0,7.0,7.0,7.0,10.0,11.0,7.0,15.0,8.0,8.0,14.0,11.0,10.0,13.0,11.0,12.0,13.0,13.0,13.0,13.0,8.0,11.0,12.0,7.0,10.0,8.0,14.0,13.0,11.0,13.0,12.0,15.0,16.0,8.0,14.0,12.0,20.0,12.0,15.0,12.0,10.0,12.0,8.0,8.0,14.0,13.0,13.0,13.0,14.0,14.0,14.0,5.0,Maicon,ÃÂÃÂ£22.05m ,Serie A
19/6/2011,Lorenzo Ariaudo,43006766,776,6/11/1989,22,0,0,10,1,2532,6000,6000,145,122,271010,186,71,D LC,2,2,3,1,1,3,2,4,1,3,3,4,5,6,8,9,3,14,7,12,14,10,2,13,10,16,14,14,12,11,10,13,16,7,8,8,14,11,12,12,14,15,13,20,14,12,6,16,15,13,7,11,8,15,10,16,15,12,12,14,10,4,20,1,1,1,12,16,20,D LC,104,1,10,1,1,1,1,20,16,12,1,1,1,1,1,1,0.0,0,0,0,0,0,0,0,0,0,0,0,0,0,0,0,0,0,0,0,0,0,0,0,0,0,0,0,0,0,0,0,0,0,0,0,0,0,0,0,0,0,0,0,0,0,0,0,0,Lorenzo Ariaudo,ÃÂ£1.62m ,31.0,186.0,Defender - Centre-Back,left,Frosinone Calcio,17.0,0.0,0.0,1157.0,26.0,1.0,0.0,1705.0,17.0,0.0,0.0,1414.0,16.0,0.0,0.0,1305.0,3.0,0.0,0.0,270.0,10.0,0.0,0.0,745.0,38.0,4.0,1.0,3209.0,36.0,1.0,0.0,3091.0,19.0,0.0,0.0,1684.0,Serie A,41.0,1.0,0.0,3687.0,4.0,0.0,0.0,343.0,29/6/2010,Lorenzo Ariaudo,43006766.0,776.0,6/11/1989,21.0,0.0,0.0,6.0,1.0,1450.0,6000.0,6000.0,143.0,119.0,1847450.0,186.0,71.0,D LC,2.0,1.0,3.0,3.0,3.0,1.0,1.0,2.0,1.0,2.0,1.0,2.0,3.0,5.0,5.0,9.0,3.0,13.0,5.0,7.0,12.0,10.0,2.0,12.0,10.0,16.0,14.0,13.0,12.0,11.0,11.0,13.0,16.0,7.0,7.0,7.0,14.0,11.0,14.0,12.0,13.0,14.0,12.0,20.0,14.0,11.0,6.0,15.0,14.0,13.0,7.0,11.0,8.0,8.0,5.0,15.0,15.0,11.0,15.0,13.0,11.0,4.0,Lorenzo Ariaudo,ÃÂÃÂ£1.08m ,Serie A
19/6/2011,LoÃÂ¯c Poujol,8442422,769,2/27/1989,22,0,0,4,0,4050,5129,5117,145,114,101575,188,86,D/DM C,1,2,3,1,3,2,2,1,2,2,1,5,6,8,5,11,7,14,13,6,12,9,10,11,12,13,12,13,13,13,9,11,13,8,11,7,12,12,16,14,9,17,14,8,14,10,20,14,17,14,13,11,8,11,17,12,14,14,15,15,15,6,16,1,10,1,1,1,16,D/DM C,321,1,1,1,1,1,1,16,1,1,20,10,1,1,1,1,512.0,0,0,0,0,0,0,0,0,0,1,0,0,0,0,0,0,0,0,0,0,0,0,0,0,0,0,0,0,0,0,0,0,0,0,0,0,0,0,0,0,0,0,0,0,0,0,0,0,LoÃÂ¯c Poujol,ÃÂ£1.13m ,31.0,187.0,Midfielder - Defensive Midfield,right,Rodez AF,9.0,0.0,0.0,172.0,20.0,1.0,1.0,1345.0,25.0,2.0,0.0,2050.0,5.0,0.0,0.0,291.0,30.0,0.0,0.0,2188.0,6.0,0.0,0.0,246.0,nan,nan,nan,nan,21.0,2.0,0.0,1734.0,24.0,2.0,0.0,1534.0,Ligue 1,15.0,0.0,0.0,1109.0,3.0,0.0,0.0,167.0,29/6/2010,LoÃÂ¯c Poujol,8442422.0,769.0,2/27/1989,21.0,0.0,0.0,4.0,0.0,1000.0,5129.0,5100.0,150.0,114.0,1529424.0,188.0,86.0,D/DM C,3.0,1.0,3.0,1.0,1.0,2.0,2.0,1.0,1.0,3.0,1.0,5.0,6.0,8.0,5.0,11.0,7.0,14.0,13.0,6.0,12.0,9.0,10.0,11.0,12.0,13.0,12.0,13.0,13.0,13.0,9.0,11.0,13.0,8.0,11.0,7.0,12.0,12.0,16.0,14.0,9.0,16.0,14.0,8.0,14.0,10.0,20.0,14.0,17.0,14.0,13.0,5.0,8.0,11.0,8.0,12.0,14.0,5.0,15.0,15.0,15.0,6.0,LoÃÂÃÂ¯c Poujol,ÃÂÃÂ£495Th. ,Ligue 1
19/6/2011,Leon Balogun,92002651,771,6/28/1988,22,0,0,0,0,3000,5050,5250,117,103,475048,190,81,D RC,1,2,2,3,2,3,3,3,2,3,2,3,6,5,5,9,5,11,7,14,13,9,7,14,9,12,13,14,8,9,5,11,10,5,8,6,12,14,10,9,8,13,14,10,12,13,20,15,14,12,11,9,8,6,13,13,11,13,14,6,15,10,20,15,1,1,16,1,20,D RC,103,1,1,1,1,1,1,20,1,16,1,1,1,1,1,15,0.0,0,0,0,0,0,0,0,0,0,0,0,0,0,0,0,0,0,0,0,0,0,0,0,0,0,0,0,0,0,0,0,0,0,0,0,0,0,0,0,0,0,0,0,0,0,0,0,0,Leon Balogun,ÃÂ£135Th. ,32.0,190.0,Defender - Centre-Back,right,Rangers FC,32.0,1.0,0.0,2624.0,20.0,3.0,0.0,1752.0,20.0,1.0,2.0,1728.0,14.0,0.0,0.0,1016.0,21.0,4.0,0.0,1681.0,23.0,1.0,0.0,1611.0,21.0,0.0,0.0,1317.0,15.0,0.0,0.0,1198.0,10.0,1.0,0.0,801.0,Bundesliga,13.0,0.0,0.0,944.0,6.0,0.0,0.0,435.0,nan,nan,nan,nan,nan,nan,nan,nan,nan,nan,nan,nan,nan,nan,nan,nan,nan,nan,nan,nan,nan,nan,nan,nan,nan,nan,nan,nan,nan,nan,nan,nan,nan,nan,nan,nan,nan,nan,nan,nan,nan,nan,nan,nan,nan,nan,nan,nan,nan,nan,nan,nan,nan,nan,nan,nan,nan,nan,nan,nan,nan,nan,nan,nan,nan,nan,nan,nan,nan,nan,nan,nan,nan,nan,nan,nan,nan,nan,nan,nan,nan,nan,nan,nan,19-06-17,18.3.4.28,Leon Balogun,92002651,38,28-Jun-88,28,10,0,0,0,4200,6450,6200,126,124,4213024,190,81,D/WB RC,1,3,2,3,1,1,3,3,1,2,2,5,11,9,6,10,5,14,7,18,12,9,6,13,9,14,10,15,9,14,7,10,14,7,11,9,12,13,14,12,10,17,16,13,12,16,20,14,15,16,12,12,12,12,8,14,8,13,12,13,13,7,20,16,9,1,18,1,20,D/WB RC,113,1,1,1,1,1,1,20,1,18,10,9,1,1,1,16,0.0,0,0,0,0,0,0,0,0,0,0,0,0,0,0,0,0,0,0,0,0,0,0,0,0,0,0,0,0,0,0,0,0,0,0,0,0,0,0,0,0,0,0,0,0,0,0,0,0,Leon Balogun,ÃÂ£1.80m ,32.0,190.0,Defender - Centre-Back,right,Rangers FC,21.0,0.0,0.0,1317.0,15.0,0.0,0.0,1198.0,10.0,1.0,0.0,801.0,13.0,0.0,0.0,944.0,6.0,0.0,0.0,435.0,Bundesliga,15-07-16,17.3.2.23,Leon Balogun,92002651.0,38.0,28-Jun-88,28.0,7.0,0.0,0.0,0.0,4350.0,6350.0,6350.0,127.0,127.0,5686753.0,190.0,81.0,D/WB RC,3.0,2.0,1.0,2.0,3.0,3.0,2.0,2.0,3.0,2.0,2.0,5.0,11.0,9.0,6.0,10.0,5.0,14.0,7.0,18.0,13.0,9.0,6.0,13.0,9.0,14.0,11.0,15.0,9.0,14.0,7.0,10.0,14.0,7.0,10.0,9.0,12.0,13.0,14.0,12.0,10.0,17.0,16.0,13.0,12.0,16.0,20.0,15.0,15.0,16.0,12.0,12.0,12.0,12.0,8.0,14.0,8.0,13.0,12.0,13.0,13.0,7.0,Leon Balogun,ÃÂ£1.80m ,Bundesliga
19/6/2011,Lamine KonÃÂ©,34000665,769,2/1/1989,22,0,0,3,0,2519,5219,3959,150,116,311866,186,83,D RC,3,1,3,2,3,3,3,6,3,2,3,5,7,8,6,9,6,14,8,6,14,8,6,11,9,14,14,15,13,13,6,12,14,8,9,9,13,13,14,11,9,16,14,20,13,13,8,16,16,14,14,14,10,8,12,13,14,13,15,15,15,6,20,14,1,1,20,14,18,D RC,103,1,1,1,1,1,1,18,14,20,1,1,1,1,14,14,32.0,0,0,0,0,0,1,0,0,0,0,0,0,0,0,0,0,0,0,0,0,0,0,0,0,0,0,0,0,0,0,0,0,0,0,0,0,0,0,0,0,0,0,0,0,0,0,0,0,Lamine KonÃÂÃÂ©,ÃÂ£1.35m ,31.0,189.0,Defender - Centre-Back,right,RC Strasbourg Alsace,9.0,1.0,0.0,683.0,26.0,1.0,0.0,2247.0,34.0,3.0,1.0,2895.0,19.0,1.0,0.0,1370.0,31.0,1.0,1.0,2790.0,35.0,2.0,1.0,3076.0,31.0,1.0,0.0,2635.0,26.0,0.0,0.0,2221.0,32.0,2.0,1.0,2545.0,Ligue 1,27.0,1.0,0.0,2263.0,4.0,0.0,0.0,234.0,29/6/2010,Lamine KonÃÂ©,34000665.0,769.0,2/1/1989,21.0,0.0,0.0,3.0,0.0,2500.0,3800.0,3800.0,150.0,116.0,2932393.0,186.0,83.0,D RC,2.0,2.0,1.0,1.0,2.0,2.0,2.0,3.0,1.0,1.0,2.0,5.0,7.0,8.0,6.0,9.0,6.0,14.0,8.0,6.0,14.0,8.0,6.0,11.0,9.0,14.0,14.0,15.0,13.0,13.0,6.0,12.0,14.0,8.0,9.0,9.0,13.0,13.0,14.0,11.0,9.0,16.0,14.0,20.0,13.0,13.0,8.0,16.0,16.0,14.0,14.0,14.0,10.0,8.0,5.0,13.0,14.0,13.0,15.0,15.0,15.0,6.0,Lamine KonÃÂÃÂÃÂÃÂ©,ÃÂÃÂ£900Th. ,Ligue 1
19/6/2011,Kevin Pezzoni,28000488,771,3/22/1989,22,0,0,2,0,3850,6100,6100,135,120,292890,193,91,DM C,2,3,1,3,1,1,1,1,3,2,2,5,7,8,7,9,6,15,11,15,13,11,7,13,7,12,12,14,14,11,8,12,8,8,8,8,14,17,16,9,7,11,16,20,15,11,15,14,18,12,12,10,6,12,10,8,12,8,10,13,13,4,15,5,7,1,5,5,15,DM C,301,1,10,4,1,1,1,15,5,5,20,7,1,1,5,5,0.0,0,0,0,0,0,0,0,0,0,0,0,0,0,0,0,0,0,0,0,0,0,0,0,0,0,0,0,0,0,0,0,0,0,0,0,0,0,0,0,0,0,0,0,0,0,0,0,0,Kevin Pezzoni,ÃÂ£900Th. ,31.0,194.0,Defender - Centre-Back,left,SG Bad Soden,22.0,0.0,1.0,1585.0,18.0,1.0,1.0,887.0,16.0,1.0,0.0,1198.0,24.0,0.0,0.0,1974.0,32.0,2.0,2.0,2691.0,34.0,0.0,3.0,2783.0,37.0,4.0,2.0,3175.0,10.0,1.0,0.0,562.0,21.0,1.0,2.0,1692.0,Bundesliga,17.0,0.0,1.0,1466.0,7.0,1.0,0.0,630.0,29/6/2010,Kevin Pezzoni,28000488.0,771.0,3/22/1989,21.0,0.0,0.0,2.0,0.0,3250.0,6050.0,6050.0,135.0,121.0,944273.0,193.0,91.0,D/DM C,1.0,3.0,1.0,2.0,2.0,2.0,1.0,2.0,2.0,2.0,3.0,5.0,6.0,8.0,7.0,10.0,6.0,15.0,11.0,13.0,13.0,11.0,7.0,13.0,9.0,12.0,12.0,14.0,14.0,11.0,8.0,12.0,8.0,8.0,8.0,8.0,13.0,15.0,16.0,10.0,9.0,9.0,16.0,20.0,15.0,11.0,17.0,14.0,15.0,12.0,12.0,10.0,6.0,12.0,10.0,4.0,5.0,14.0,7.0,5.0,13.0,11.0,Kevin Pezzoni,ÃÂÃÂ£1.58m ,Bundesliga
19/6/2011,Jukka Raitala,33000888,768,9/15/1988,22,2,0,25,0,3500,5500,5900,137,118,122000,180,77,D/WB RLC,2,3,1,3,1,2,3,1,2,1,3,7,12,10,5,11,5,13,4,16,13,10,6,14,11,12,11,14,10,12,8,10,12,8,10,8,12,12,14,13,13,13,12,10,13,13,20,11,11,12,7,11,8,6,17,17,10,13,14,14,10,10,20,17,5,1,18,20,16,D/WB RLC,116,1,1,1,1,1,1,16,20,18,5,4,5,5,16,17,4294967296.0,0,0,0,0,0,0,0,0,0,0,0,0,0,0,0,0,0,0,0,0,0,0,0,0,0,0,0,0,0,0,0,0,1,0,0,0,0,0,0,0,0,0,0,0,0,0,0,0,Jukka Raitala,ÃÂ£1.08m ,32.0,181.0,Defender - Left-Back,both,Montreal Impact,31.0,0.0,0.0,2711.0,20.0,0.0,0.0,1258.0,31.0,0.0,1.0,2514.0,16.0,1.0,1.0,1354.0,35.0,1.0,0.0,2840.0,34.0,1.0,6.0,2822.0,30.0,0.0,1.0,2057.0,30.0,1.0,2.0,2432.0,31.0,0.0,0.0,2452.0,LaLiga,16.0,0.0,0.0,1349.0,nan,nan,nan,nan,nan,nan,nan,nan,nan,nan,nan,nan,nan,nan,nan,nan,nan,nan,nan,nan,nan,nan,nan,nan,nan,nan,nan,nan,nan,nan,nan,nan,nan,nan,nan,nan,nan,nan,nan,nan,nan,nan,nan,nan,nan,nan,nan,nan,nan,nan,nan,nan,nan,nan,nan,nan,nan,nan,nan,nan,nan,nan,nan,nan,nan,nan,nan,nan,nan,nan,nan,nan,nan,nan,nan,nan,nan,nan,nan,nan,nan,nan,nan,nan,nan,nan,nan,nan
19/6/2011,JÃÂ©rÃÂ´me Boateng,35002579,771,9/3/1988,22,13,0,15,1,6900,7500,7500,175,147,36363636,192,90,D/WB RLC,2,2,3,3,2,3,2,5,2,3,3,8,16,11,4,14,6,9,8,18,12,13,7,12,14,8,14,9,17,7,15,13,9,11,10,6,12,13,5,13,12,16,17,18,10,18,20,13,17,8,6,13,7,19,4,13,7,14,10,12,8,11,20,17,10,8,18,16,20,D/WB RLC,116,1,1,3,1,8,8,20,16,18,12,10,10,10,15,17,149813000000000.0,0,0,0,0,0,0,0,0,0,0,0,0,0,0,0,0,0,0,0,0,0,0,0,0,0,0,0,0,0,0,0,0,1,0,0,0,0,0,1,0,0,0,0,1,0,0,0,1,JÃÂ©rÃÂ´me Boateng,ÃÂ£13.50m ,32.0,192.0,Defender - Centre-Back,right,Bayern Munich,24.0,0.0,0.0,1952.0,48.0,0.0,2.0,4136.0,40.0,2.0,2.0,3341.0,43.0,1.0,4.0,3691.0,44.0,3.0,3.0,3726.0,31.0,0.0,4.0,2400.0,21.0,0.0,1.0,1465.0,31.0,2.0,4.0,2621.0,28.0,0.0,2.0,2419.0,Bundesliga,38.0,0.0,2.0,2806.0,6.0,0.0,0.0,441.0,29/6/2010,JÃÂ©rÃÂ´me Boateng,35002579.0,771.0,9/3/1988,21.0,10.0,0.0,15.0,1.0,4750.0,7200.0,7200.0,174.0,144.0,34339299.0,192.0,90.0,D/WB RLC,3.0,2.0,1.0,1.0,1.0,3.0,2.0,3.0,3.0,3.0,2.0,9.0,15.0,11.0,4.0,15.0,6.0,8.0,9.0,18.0,12.0,13.0,8.0,12.0,14.0,6.0,14.0,10.0,17.0,6.0,15.0,13.0,9.0,11.0,10.0,4.0,12.0,13.0,4.0,12.0,11.0,15.0,17.0,18.0,10.0,18.0,20.0,12.0,17.0,8.0,6.0,14.0,7.0,20.0,12.0,13.0,5.0,14.0,10.0,12.0,8.0,11.0,JÃÂÃÂ©rÃÂÃÂ´me Boateng,ÃÂÃÂ£13.50m ,Premier League,19-06-17,18.3.4.28,JÃÂ©rÃÂ´me Boateng,35002579,771,03-Sep-88,28,67,1,15,1,8750,8750,8750,175,175,232186002,192,90,D C,2,1,1,2,3,1,1,1,2,3,2,7,14,11,6,13,5,10,7,16,18,15,7,18,13,10,17,13,16,12,14,15,11,11,11,6,15,12,9,14,13,17,17,18,14,18,20,14,18,16,8,16,8,16,6,14,7,15,11,15,9,13,20,10,8,1,12,12,20,D C,101,1,1,1,1,1,1,20,12,12,8,8,1,1,10,10,1.15306e+18,0,0,0,0,0,0,0,0,0,0,0,0,0,0,0,0,0,0,0,0,0,0,0,0,0,0,0,0,0,0,0,0,0,0,0,0,0,0,0,0,0,0,0,0,0,0,0,1,JÃÂ©rÃÂ´me Boateng,ÃÂ£40.50m ,32.0,192.0,Defender - Centre-Back,right,Bayern Munich,21.0,0.0,1.0,1465.0,31.0,2.0,4.0,2621.0,28.0,0.0,2.0,2419.0,38.0,0.0,2.0,2806.0,6.0,0.0,0.0,441.0,Bundesliga,15-07-16,17.3.2.23,JÃÂ©rÃÂ´me Boateng,35002579.0,771.0,03-Sep-88,27.0,65.0,1.0,15.0,1.0,8750.0,8750.0,8750.0,175.0,175.0,174626236.0,192.0,90.0,D C,3.0,2.0,2.0,2.0,2.0,2.0,4.0,2.0,3.0,1.0,2.0,7.0,14.0,11.0,6.0,13.0,5.0,10.0,7.0,16.0,18.0,15.0,7.0,18.0,13.0,10.0,17.0,13.0,16.0,12.0,14.0,15.0,11.0,11.0,11.0,7.0,15.0,12.0,9.0,14.0,13.0,17.0,17.0,18.0,14.0,18.0,20.0,14.0,18.0,16.0,8.0,16.0,6.0,16.0,6.0,14.0,7.0,15.0,11.0,15.0,9.0,13.0,JÃÂ©rÃÂ´me Boateng,ÃÂ£34.20m ,Bundesliga
19/6/2011,Jaime,55012323,788,6/11/1989,22,0,0,0,0,506,3869,3521,99,86,21067,187,80,D C,2,2,3,3,3,3,2,1,2,3,2,8,8,8,7,9,9,11,7,9,11,9,9,11,10,10,13,10,12,11,9,9,10,6,10,7,12,11,9,10,10,11,11,6,11,10,20,10,11,11,9,10,9,12,13,11,15,13,8,9,13,5,20,1,1,1,7,1,20,D C,101,1,1,1,1,1,1,20,1,7,13,1,1,1,1,1,0.0,0,0,0,0,0,0,0,0,0,0,0,0,0,0,0,0,0,0,0,0,0,0,0,0,0,0,0,0,0,0,0,0,0,0,0,0,0,0,0,0,0,0,0,0,0,0,0,0,nan,nan,nan,nan,nan,nan,nan,nan,nan,nan,nan,nan,nan,nan,nan,nan,nan,nan,nan,nan,nan,nan,nan,nan,nan,nan,nan,nan,nan,nan,nan,nan,nan,nan,nan,nan,nan,nan,nan,nan,nan,nan,nan,nan,nan,nan,nan,nan,nan,nan,nan,nan,nan,nan,nan,nan,nan,nan,nan,nan,nan,nan,nan,nan,nan,nan,nan,nan,nan,nan,nan,nan,nan,nan,nan,nan,nan,nan,nan,nan,nan,nan,nan,nan,nan,nan,nan,nan,nan,nan,nan,nan,nan,nan,nan,nan,nan,nan,nan,nan,nan,nan,nan,nan,nan,nan,nan,nan,nan,nan,nan,nan,nan,nan,nan,nan,nan,nan,nan,nan,nan,nan,nan,nan,nan,nan,nan,nan,nan,nan,nan,nan,nan,nan,nan,nan
19/6/2011,Isaac Vorsah,12010808,21,6/21/1988,22,23,1,0,0,5750,7000,6700,152,138,633249,192,85,D C,3,2,3,1,3,1,3,5,3,3,1,4,6,5,5,7,4,11,6,14,17,7,5,14,7,15,16,18,8,12,7,9,13,4,10,6,15,17,14,15,8,16,18,10,11,18,20,15,18,10,14,10,12,12,13,14,7,12,9,16,8,20,20,1,10,1,1,1,20,D C,101,1,1,1,1,1,1,20,1,1,14,10,1,1,1,1,0.0,0,0,0,0,0,0,0,0,0,0,0,0,0,0,0,0,0,0,0,0,0,0,0,0,0,0,0,0,0,0,0,0,0,0,0,0,0,0,0,0,0,0,0,0,0,0,0,0,Isaac Vorsah,ÃÂ£4.50m ,32.0,192.0,Defender - Centre-Back,right,Without Club,33.0,3.0,0.0,2800.0,23.0,0.0,0.0,1931.0,18.0,1.0,0.0,1246.0,nan,nan,nan,nan,nan,nan,nan,nan,4.0,0.0,0.0,174.0,nan,nan,nan,nan,20.0,1.0,1.0,1748.0,nan,nan,nan,nan,Bundesliga,nan,nan,nan,nan,nan,nan,nan,nan,29/6/2010,Isaac Vorsah,12010808.0,21.0,6/21/1988,22.0,4.0,0.0,0.0,0.0,4000.0,7000.0,6700.0,152.0,134.0,3916459.0,192.0,85.0,D C,3.0,2.0,2.0,3.0,3.0,1.0,1.0,7.0,3.0,2.0,3.0,4.0,6.0,5.0,5.0,8.0,5.0,11.0,6.0,14.0,16.0,7.0,5.0,15.0,7.0,15.0,13.0,18.0,8.0,12.0,7.0,9.0,13.0,4.0,10.0,6.0,14.0,16.0,17.0,14.0,8.0,16.0,18.0,9.0,11.0,18.0,20.0,15.0,18.0,10.0,14.0,10.0,12.0,12.0,13.0,14.0,12.0,12.0,8.0,15.0,16.0,6.0,Isaac Vorsah,ÃÂÃÂ£5.85m ,Bundesliga
19/6/2011,Igor,19089312,1651,3/10/1989,22,0,0,0,0,750,4850,4850,123,97,10368,189,77,D LC,2,1,1,2,1,3,1,2,1,2,1,5,9,9,7,14,4,14,10,7,14,13,7,10,14,11,7,11,14,13,7,10,10,4,12,10,4,17,15,12,10,6,16,20,10,11,10,11,6,10,11,10,12,10,6,8,6,10,5,5,9,2,20,14,1,1,1,15,20,D LC,104,1,1,1,1,1,1,20,15,1,1,1,1,1,14,1,4194304.0,0,0,0,0,0,0,0,0,0,0,0,0,0,0,0,0,0,0,0,0,0,0,1,0,0,0,0,0,0,0,0,0,0,0,0,0,0,0,0,0,0,0,0,0,0,0,0,0,nan,nan,nan,nan,nan,nan,nan,nan,nan,nan,nan,nan,nan,nan,nan,nan,nan,nan,nan,nan,nan,nan,nan,nan,nan,nan,nan,nan,nan,nan,nan,nan,nan,nan,nan,nan,nan,nan,nan,nan,nan,nan,nan,nan,nan,nan,nan,nan,nan,nan,nan,nan,29/6/2010,Igor,19089312.0,1651.0,3/10/1989,21.0,0.0,0.0,0.0,0.0,750.0,4850.0,4850.0,125.0,97.0,43993.0,189.0,77.0,D LC,3.0,1.0,1.0,3.0,3.0,3.0,2.0,6.0,2.0,3.0,2.0,7.0,9.0,10.0,4.0,11.0,3.0,14.0,5.0,10.0,13.0,12.0,10.0,12.0,14.0,14.0,9.0,10.0,13.0,14.0,9.0,10.0,10.0,13.0,15.0,10.0,8.0,15.0,15.0,14.0,14.0,14.0,10.0,20.0,17.0,14.0,10.0,11.0,5.0,10.0,5.0,10.0,6.0,10.0,9.0,5.0,5.0,7.0,9.0,4.0,4.0,5.0,nan,nan,nan
19/6/2011,Holger Badstuber,35016427,771,3/13/1989,22,13,1,8,2,6700,7865,8000,160,143,36363636,189,78,D C,3,3,3,2,3,3,1,6,3,1,3,14,13,5,5,11,14,10,7,14,15,13,11,15,12,10,15,12,14,16,11,17,14,4,8,5,17,18,9,9,8,14,15,20,17,15,9,16,13,13,8,9,6,15,9,11,16,13,16,16,16,5,20,10,2,1,6,14,20,D C,101,1,3,1,1,1,1,20,14,6,12,1,2,1,10,3,300648000000.0,0,0,0,0,0,0,1,0,0,0,0,0,0,0,0,0,0,0,0,0,0,0,0,0,0,0,0,0,0,0,0,0,0,1,1,0,0,0,1,0,0,0,0,0,0,0,0,0,Holger Badstuber,ÃÂ£19.80m ,31.0,190.0,Defender - Centre-Back,left,VfB Stuttgart II,32.0,0.0,2.0,2584.0,50.0,0.0,3.0,4473.0,18.0,0.0,2.0,1439.0,nan,nan,nan,nan,16.0,1.0,1.0,1043.0,9.0,0.0,0.0,602.0,16.0,0.0,0.0,1206.0,28.0,2.0,0.0,2225.0,12.0,0.0,0.0,697.0,Bundesliga,21.0,2.0,0.0,1825.0,6.0,0.0,0.0,526.0,29/6/2010,Holger Badstuber,35016427.0,771.0,3/13/1989,21.0,4.0,0.0,8.0,2.0,4500.0,7750.0,7750.0,163.0,143.0,22251810.0,189.0,78.0,D C,3.0,2.0,1.0,2.0,1.0,1.0,2.0,4.0,2.0,3.0,3.0,14.0,13.0,5.0,6.0,11.0,14.0,10.0,7.0,12.0,16.0,13.0,12.0,16.0,9.0,17.0,14.0,16.0,15.0,17.0,8.0,14.0,14.0,4.0,8.0,6.0,17.0,18.0,10.0,9.0,7.0,14.0,16.0,20.0,17.0,17.0,8.0,15.0,12.0,16.0,14.0,9.0,6.0,15.0,7.0,5.0,15.0,13.0,16.0,16.0,16.0,5.0,Holger Badstuber,ÃÂÃÂ£7.65m ,Bundesliga,19-06-17,18.3.4.28,Holger Badstuber,35016427,771,13-Mar-89,28,31,1,8,2,5900,7150,6900,158,143,15932666,190,84,D C,2,3,2,2,3,3,1,3,1,3,2,13,12,7,5,11,13,10,7,12,15,14,11,14,12,10,16,11,19,14,12,18,10,6,11,5,16,18,8,10,8,13,16,20,15,12,9,11,14,17,6,14,18,10,9,14,16,12,18,17,12,3,20,8,8,1,1,14,20,D C,101,1,5,1,1,1,1,20,14,1,10,8,1,1,8,1,141017000000000.0,0,0,0,0,0,0,0,0,0,0,0,0,0,0,0,0,0,0,0,0,0,0,0,0,0,0,0,0,0,0,0,0,1,0,0,0,0,0,1,0,0,0,0,0,0,0,0,1,Holger Badstuber,ÃÂ£4.50m ,31.0,190.0,Defender - Centre-Back,left,VfB Stuttgart II,16.0,0.0,0.0,1206.0,28.0,2.0,0.0,2225.0,12.0,0.0,0.0,697.0,21.0,2.0,0.0,1825.0,6.0,0.0,0.0,526.0,Bundesliga,15-07-16,17.3.2.23,Holger Badstuber,35016427.0,771.0,13-Mar-89,27.0,31.0,1.0,8.0,2.0,6550.0,7800.0,7550.0,158.0,151.0,31829415.0,190.0,84.0,D C,2.0,3.0,2.0,2.0,3.0,3.0,1.0,2.0,2.0,1.0,3.0,14.0,13.0,7.0,5.0,12.0,13.0,10.0,7.0,12.0,15.0,14.0,11.0,14.0,12.0,9.0,17.0,11.0,19.0,16.0,12.0,18.0,10.0,6.0,10.0,5.0,17.0,18.0,8.0,10.0,8.0,13.0,17.0,20.0,15.0,14.0,9.0,12.0,14.0,17.0,6.0,14.0,18.0,10.0,7.0,14.0,16.0,12.0,18.0,17.0,12.0,3.0,Holger Badstuber,ÃÂ£2.25m ,Bundesliga
19/6/2011,Gabriele Angella,1414164,776,4/28/1989,22,0,0,4,0,3500,5650,5650,142,118,72254,190,87,D C,1,2,3,3,3,2,1,2,3,1,1,5,6,7,7,10,4,15,8,10,13,13,9,13,12,9,14,14,12,10,11,11,12,6,12,9,9,12,13,11,12,13,16,10,12,12,20,12,13,13,14,11,12,12,12,12,9,8,11,13,14,8,20,1,3,1,1,1,20,D C,101,1,1,1,1,1,1,20,1,1,9,3,1,1,1,1,0.0,0,0,0,0,0,0,0,0,0,0,0,0,0,0,0,0,0,0,0,0,0,0,0,0,0,0,0,0,0,0,0,0,0,0,0,0,0,0,0,0,0,0,0,0,0,0,0,0,Gabriele Angella,ÃÂ£765Th. ,31.0,193.0,Defender - Centre-Back,right,AC Perugia Calcio,14.0,2.0,0.0,743.0,22.0,1.0,0.0,1827.0,15.0,4.0,0.0,1161.0,45.0,9.0,3.0,3849.0,36.0,2.0,4.0,2914.0,19.0,1.0,1.0,1636.0,14.0,1.0,0.0,1013.0,12.0,0.0,0.0,891.0,25.0,2.0,2.0,1956.0,Serie A,16.0,0.0,2.0,1188.0,7.0,0.0,0.0,630.0,nan,nan,nan,nan,nan,nan,nan,nan,nan,nan,nan,nan,nan,nan,nan,nan,nan,nan,nan,nan,nan,nan,nan,nan,nan,nan,nan,nan,nan,nan,nan,nan,nan,nan,nan,nan,nan,nan,nan,nan,nan,nan,nan,nan,nan,nan,nan,nan,nan,nan,nan,nan,nan,nan,nan,nan,nan,nan,nan,nan,nan,nan,nan,nan,nan,nan,nan,nan,nan,nan,nan,nan,nan,nan,nan,nan,nan,nan,nan,nan,nan,nan,nan,nan,19-06-17,18.3.4.28,Gabriele Angella,1414164,776,28-Apr-89,28,0,0,4,0,4100,6200,6200,135,124,5978012,189,82,D C,2,2,3,2,4,3,3,2,2,2,3,5,8,9,9,10,4,14,7,10,13,13,8,14,12,13,14,15,13,12,14,10,13,7,13,11,15,11,13,8,12,13,16,11,12,11,20,14,14,13,12,10,6,8,12,13,12,12,11,13,15,6,20,1,1,1,13,1,20,D C,101,1,1,1,1,1,1,20,1,13,1,1,1,1,1,1,8796090000000.0,0,0,0,0,0,0,0,0,0,0,0,0,0,0,0,0,0,0,0,0,0,0,0,0,0,0,0,0,0,0,0,0,0,0,0,0,0,0,0,0,0,0,0,1,0,0,0,0,Gabriele Angella,ÃÂ£900Th. ,31.0,193.0,Defender - Centre-Back,right,AC Perugia Calcio,14.0,1.0,0.0,1013.0,12.0,0.0,0.0,891.0,25.0,2.0,2.0,1956.0,16.0,0.0,2.0,1188.0,7.0,0.0,0.0,630.0,Serie A,15-07-16,17.3.2.23,Gabriele Angella,1414164.0,776.0,28-Apr-89,27.0,0.0,0.0,4.0,0.0,4500.0,6250.0,6300.0,135.0,126.0,5093281.0,192.0,82.0,D C,2.0,3.0,1.0,3.0,1.0,2.0,2.0,2.0,2.0,2.0,2.0,5.0,8.0,9.0,9.0,10.0,4.0,15.0,7.0,10.0,13.0,13.0,8.0,14.0,12.0,13.0,14.0,15.0,13.0,12.0,14.0,10.0,13.0,7.0,13.0,11.0,15.0,11.0,13.0,8.0,12.0,13.0,16.0,12.0,12.0,11.0,20.0,14.0,14.0,12.0,12.0,10.0,6.0,8.0,12.0,13.0,12.0,12.0,11.0,13.0,15.0,6.0,Gabriele Angella,ÃÂ£1.35m ,Serie A
19/6/2011,Federico FernÃÂ¡ndez,14011214,1649,2/21/1989,22,2,1,7,0,3000,4500,5500,150,119,935599,190,83,D RC,1,2,1,2,1,1,1,5,1,3,1,4,5,4,5,6,5,16,4,10,15,11,5,17,8,12,14,12,8,13,6,12,7,6,9,9,15,12,12,12,9,12,15,5,14,11,20,13,15,13,12,8,3,12,13,10,5,11,10,10,12,2,20,1,1,1,17,1,20,D RC,103,1,1,1,1,1,1,20,1,17,1,1,1,1,1,1,0.0,0,0,0,0,0,0,0,0,0,0,0,0,0,0,0,0,0,0,0,0,0,0,0,0,0,0,0,0,0,0,0,0,0,0,0,0,0,0,0,0,0,0,0,0,0,0,0,0,Federico FernÃÂ¡ndez,ÃÂ£2.70m ,31.0,190.0,Defender - Centre-Back,right,Newcastle United,41.0,2.0,0.0,3526.0,19.0,2.0,0.0,1175.0,23.0,1.0,1.0,1859.0,36.0,0.0,1.0,3110.0,32.0,0.0,0.0,2825.0,32.0,1.0,1.0,2880.0,30.0,0.0,2.0,2654.0,34.0,1.0,1.0,2933.0,23.0,0.0,1.0,1842.0,Serie A,35.0,2.0,2.0,2918.0,7.0,0.0,0.0,630.0,nan,nan,nan,nan,nan,nan,nan,nan,nan,nan,nan,nan,nan,nan,nan,nan,nan,nan,nan,nan,nan,nan,nan,nan,nan,nan,nan,nan,nan,nan,nan,nan,nan,nan,nan,nan,nan,nan,nan,nan,nan,nan,nan,nan,nan,nan,nan,nan,nan,nan,nan,nan,nan,nan,nan,nan,nan,nan,nan,nan,nan,nan,nan,nan,nan,nan,nan,nan,nan,nan,nan,nan,nan,nan,nan,nan,nan,nan,nan,nan,nan,nan,nan,nan
19/6/2011,FÃÂ¡bio Faria,55003770,788,4/24/1989,22,0,0,8,0,2500,5500,5500,130,107,516497,186,75,D LC,3,1,1,3,1,3,3,3,2,2,3,9,8,9,9,10,12,13,9,10,14,9,10,14,11,14,13,13,12,11,9,11,16,7,10,7,13,13,13,10,11,14,14,20,15,10,5,12,13,14,9,10,8,10,12,15,16,12,15,14,14,6,20,5,1,1,1,15,20,D LC,104,1,1,1,1,1,1,20,15,1,5,1,1,1,5,1,32768.0,0,0,0,0,0,0,0,0,0,0,0,0,0,0,0,1,0,0,0,0,0,0,0,0,0,0,0,0,0,0,0,0,0,0,0,0,0,0,0,0,0,0,0,0,0,0,0,0,FÃÂ¡bio Faria,ÃÂ£900Th. ,31.0,189.0,Defender - Centre-Back,left,Retired,5.0,0.0,0.0,405.0,10.0,0.0,0.0,801.0,nan,nan,nan,nan,nan,nan,nan,nan,nan,nan,nan,nan,nan,nan,nan,nan,nan,nan,nan,nan,nan,nan,nan,nan,nan,nan,nan,nan,Liga NOS,nan,nan,nan,nan,nan,nan,nan,nan,29/6/2010,FÃÂ¡bio Faria,55003770.0,788.0,4/24/1989,21.0,0.0,0.0,8.0,0.0,2500.0,5500.0,5500.0,159.0,109.0,5807748.0,186.0,75.0,D LC,3.0,3.0,2.0,1.0,2.0,3.0,1.0,6.0,3.0,3.0,2.0,8.0,7.0,8.0,8.0,11.0,11.0,13.0,10.0,9.0,14.0,8.0,9.0,13.0,10.0,14.0,14.0,13.0,13.0,15.0,10.0,10.0,16.0,7.0,13.0,11.0,13.0,13.0,13.0,11.0,11.0,13.0,13.0,20.0,15.0,10.0,6.0,11.0,12.0,14.0,9.0,10.0,8.0,10.0,12.0,15.0,16.0,12.0,15.0,14.0,14.0,6.0,FÃÂÃÂ¡bio Faria,ÃÂÃÂ£900Th. ,Liga NOS
19/6/2011,Ewerton,19047410,1651,3/23/1989,22,0,0,0,0,1250,5350,5350,135,112,59378,188,81,D C,3,1,2,1,1,2,1,7,2,1,2,3,5,6,7,7,6,13,9,7,13,8,7,13,10,13,11,13,11,12,6,11,14,5,5,9,13,13,12,13,10,13,14,20,14,13,10,13,13,12,12,11,5,7,5,13,11,12,12,7,11,12,20,1,1,1,1,1,20,D C,101,1,11,1,1,1,1,20,1,1,1,1,1,1,1,1,0.0,0,0,0,0,0,0,0,0,0,0,0,0,0,0,0,0,0,0,0,0,0,0,0,0,0,0,0,0,0,0,0,0,0,0,0,0,0,0,0,0,0,0,0,0,0,0,0,0,Ewerton,ÃÂ£2.70m ,31.0,188.0,Defender - Centre-Back,left,WÃÂ¼rzburger Kickers,nan,nan,nan,nan,32.0,2.0,0.0,2880.0,13.0,0.0,0.0,1145.0,20.0,2.0,0.0,1316.0,19.0,2.0,0.0,1414.0,18.0,1.0,0.0,1504.0,24.0,0.0,0.0,2033.0,30.0,1.0,0.0,2516.0,20.0,0.0,0.0,1527.0,Liga NOS,6.0,0.0,0.0,289.0,2.0,0.0,0.0,135.0,nan,nan,nan,nan,nan,nan,nan,nan,nan,nan,nan,nan,nan,nan,nan,nan,nan,nan,nan,nan,nan,nan,nan,nan,nan,nan,nan,nan,nan,nan,nan,nan,nan,nan,nan,nan,nan,nan,nan,nan,nan,nan,nan,nan,nan,nan,nan,nan,nan,nan,nan,nan,nan,nan,nan,nan,nan,nan,nan,nan,nan,nan,nan,nan,nan,nan,nan,nan,nan,nan,nan,nan,nan,nan,nan,nan,nan,nan,nan,nan,nan,nan,nan,nan
19/6/2011,Daniel Schwaab,35008048,771,8/23/1988,22,0,0,24,1,4600,6650,6650,150,133,271378,186,76,D/WB RC,3,2,1,2,1,2,2,3,2,1,3,10,9,12,4,13,6,13,6,14,12,13,15,12,13,6,13,13,11,11,14,12,17,8,9,11,13,14,14,14,12,12,13,12,14,13,20,17,11,11,3,13,6,15,11,18,15,10,19,19,14,4,20,16,1,1,20,12,19,D/WB RC,113,1,1,1,1,1,1,19,12,20,7,1,1,1,10,16,0.0,0,0,0,0,0,0,0,0,0,0,0,0,0,0,0,0,0,0,0,0,0,0,0,0,0,0,0,0,0,0,0,0,0,0,0,0,0,0,0,0,0,0,0,0,0,0,0,0,Daniel Schwaab,ÃÂ£3.15m ,32.0,186.0,Defender - Centre-Back,right,Retired,40.0,0.0,4.0,3322.0,28.0,0.0,0.0,2234.0,22.0,0.0,2.0,1284.0,38.0,0.0,1.0,3412.0,32.0,1.0,1.0,2436.0,32.0,0.0,1.0,2598.0,31.0,0.0,0.0,2020.0,36.0,2.0,4.0,3249.0,39.0,1.0,0.0,3530.0,Bundesliga,24.0,2.0,2.0,2011.0,nan,nan,nan,nan,29/6/2010,Daniel Schwaab,35008048.0,771.0,8/23/1988,21.0,0.0,0.0,23.0,1.0,3900.0,6600.0,6600.0,165.0,132.0,5682984.0,186.0,75.0,D/WB R,3.0,3.0,2.0,2.0,1.0,2.0,1.0,5.0,2.0,2.0,1.0,10.0,13.0,12.0,4.0,13.0,6.0,10.0,6.0,14.0,12.0,13.0,15.0,12.0,13.0,6.0,12.0,13.0,11.0,11.0,14.0,12.0,17.0,8.0,9.0,11.0,13.0,14.0,14.0,14.0,12.0,12.0,12.0,10.0,14.0,15.0,20.0,17.0,11.0,13.0,3.0,13.0,6.0,15.0,11.0,18.0,15.0,10.0,19.0,19.0,14.0,4.0,Daniel Schwaab,ÃÂÃÂ£4.50m ,Bundesliga
19/6/2011,Daniel CarriÃÂ§o,55000931,788,8/4/1988,22,0,0,15,0,4560,6342,6694,140,127,539353,181,74,D C,3,3,3,2,2,3,1,3,1,1,2,7,7,8,8,10,11,14,10,10,15,10,12,15,13,17,16,15,10,15,9,10,14,7,15,11,13,14,14,12,13,11,13,10,13,12,20,12,11,14,15,12,8,12,12,14,15,14,17,16,17,8,20,1,7,1,1,1,20,D C,101,1,10,1,1,1,1,20,1,1,13,7,1,1,1,1,0.0,0,0,0,0,0,0,0,0,0,0,0,0,0,0,0,0,0,0,0,0,0,0,0,0,0,0,0,0,0,0,0,0,0,0,0,0,0,0,0,0,0,0,0,0,0,0,0,0,Daniel CarriÃÂ§o,ÃÂ£7.47m ,32.0,183.0,Defender - Centre-Back,right,Wuhan Zall,39.0,1.0,0.0,3414.0,39.0,2.0,1.0,2389.0,6.0,0.0,0.0,145.0,31.0,3.0,1.0,2778.0,45.0,2.0,0.0,4047.0,25.0,1.0,2.0,1902.0,10.0,0.0,0.0,627.0,6.0,0.0,0.0,459.0,38.0,1.0,1.0,3303.0,Liga NOS,19.0,0.0,0.0,1432.0,nan,nan,nan,nan,29/6/2010,Daniel CarriÃÂ§o,55000931.0,788.0,8/4/1988,21.0,0.0,0.0,15.0,0.0,4970.0,7050.0,7050.0,151.0,141.0,42802261.0,181.0,74.0,D C,2.0,1.0,3.0,3.0,2.0,3.0,2.0,3.0,3.0,1.0,2.0,8.0,9.0,9.0,9.0,12.0,11.0,14.0,10.0,10.0,15.0,10.0,12.0,15.0,13.0,17.0,16.0,15.0,10.0,15.0,10.0,14.0,14.0,7.0,15.0,11.0,15.0,14.0,17.0,15.0,15.0,12.0,13.0,10.0,14.0,14.0,20.0,12.0,11.0,14.0,14.0,12.0,9.0,12.0,12.0,14.0,15.0,14.0,17.0,16.0,17.0,8.0,Daniel CarriÃÂÃÂ§o,ÃÂÃÂ£8.37m ,Liga NOS,19-06-17,18.3.4.28,Daniel CarriÃÂ§o,55000931,788,04-Aug-88,28,1,0,16,0,5500,7400,7400,153,144,20432869,182,74,D C,3,2,2,3,2,1,3,4,3,3,1,7,7,8,8,10,11,15,11,10,15,12,12,16,13,18,17,17,12,15,9,13,14,7,19,11,15,15,15,12,13,12,13,8,12,11,20,11,14,14,15,14,18,12,12,14,15,14,17,16,17,8,20,1,10,1,1,1,20,D C,101,1,5,1,1,1,1,20,1,1,15,10,1,1,1,1,32768.0,0,0,0,0,0,0,0,0,0,0,0,0,0,0,0,1,0,0,0,0,0,0,0,0,0,0,0,0,0,0,0,0,0,0,0,0,0,0,0,0,0,0,0,0,0,0,0,0,Daniel CarriÃÂ§o,ÃÂ£900Th. ,32.0,183.0,Defender - Centre-Back,right,Wuhan Zall,10.0,0.0,0.0,627.0,6.0,0.0,0.0,459.0,38.0,1.0,1.0,3303.0,19.0,0.0,0.0,1432.0,nan,nan,nan,nan,LaLiga,15-07-16,17.3.2.23,Daniel CarriÃÂ§o,55000931.0,788.0,04-Aug-88,27.0,1.0,0.0,16.0,0.0,5500.0,7400.0,7400.0,153.0,147.0,23501044.0,182.0,74.0,D C,1.0,2.0,1.0,3.0,1.0,3.0,2.0,3.0,3.0,3.0,1.0,7.0,7.0,8.0,8.0,10.0,11.0,15.0,11.0,10.0,15.0,12.0,12.0,16.0,13.0,18.0,18.0,17.0,12.0,15.0,9.0,13.0,14.0,7.0,19.0,11.0,15.0,15.0,15.0,12.0,13.0,12.0,13.0,8.0,12.0,13.0,20.0,11.0,14.0,14.0,15.0,14.0,16.0,12.0,12.0,14.0,15.0,14.0,17.0,16.0,17.0,8.0,Daniel CarriÃÂ§o,ÃÂ£1.80m ,LaLiga
19/6/2011,CÃÂ©sar,67037262,796,1/30/1989,22,0,0,0,0,2000,4750,4750,125,95,219184,182,75,D RC,3,2,2,2,2,3,1,1,2,3,2,6,8,7,5,9,5,14,3,14,11,9,5,12,10,13,11,15,10,11,12,13,12,5,10,5,9,14,13,10,10,12,14,5,13,13,20,13,12,14,8,12,7,13,7,12,10,13,12,6,14,20,20,8,5,1,20,5,20,D RC,103,1,14,1,1,1,1,20,5,20,10,5,1,1,1,8,32768.0,0,0,0,0,0,0,0,0,0,0,0,0,0,0,0,1,0,0,0,0,0,0,0,0,0,0,0,0,0,0,0,0,0,0,0,0,0,0,0,0,0,0,0,0,0,0,0,0,nan,nan,nan,nan,nan,nan,nan,nan,nan,nan,nan,nan,nan,nan,nan,nan,nan,nan,nan,nan,nan,nan,nan,nan,nan,nan,nan,nan,nan,nan,nan,nan,nan,nan,nan,nan,nan,nan,nan,nan,nan,nan,nan,nan,nan,nan,nan,nan,nan,nan,nan,nan,nan,nan,nan,nan,nan,nan,nan,nan,nan,nan,nan,nan,nan,nan,nan,nan,nan,nan,nan,nan,nan,nan,nan,nan,nan,nan,nan,nan,nan,nan,nan,nan,nan,nan,nan,nan,nan,nan,nan,nan,nan,nan,nan,nan,nan,nan,nan,nan,nan,nan,nan,nan,nan,nan,nan,nan,nan,nan,nan,nan,nan,nan,nan,nan,nan,nan,nan,nan,nan,nan,nan,nan,nan,nan,nan,nan,nan,nan,nan,nan,nan,nan,nan,nan
19/6/2011,Bura,55003092,788,12/17/1988,22,0,0,13,2,1594,4724,4560,120,105,27782,190,82,D C,1,3,1,3,2,3,3,1,2,2,1,6,6,7,8,10,8,14,7,7,13,7,10,12,10,12,11,11,12,11,8,11,14,6,10,7,11,11,11,10,11,16,14,7,15,10,20,13,15,12,12,11,7,7,9,14,14,13,14,13,13,7,20,1,1,1,10,1,20,D C,101,1,1,1,1,1,1,20,1,10,1,1,1,1,1,1,0.0,0,0,0,0,0,0,0,0,0,0,0,0,0,0,0,0,0,0,0,0,0,0,0,0,0,0,0,0,0,0,0,0,0,0,0,0,0,0,0,0,0,0,0,0,0,0,0,0,Bura,ÃÂ£450Th. ,31.0,191.0,Defender - Centre-Back,right,GD Chaves,17.0,0.0,0.0,1218.0,15.0,0.0,0.0,1110.0,20.0,1.0,0.0,1576.0,26.0,4.0,0.0,2340.0,12.0,0.0,1.0,842.0,40.0,5.0,0.0,3646.0,40.0,11.0,1.0,3563.0,34.0,6.0,0.0,3090.0,35.0,3.0,2.0,3109.0,Liga NOS,27.0,2.0,1.0,2269.0,6.0,0.0,1.0,537.0,29/6/2010,Bura,55003092.0,788.0,12/17/1988,21.0,0.0,0.0,13.0,2.0,1000.0,2000.0,2000.0,135.0,100.0,43107.0,190.0,82.0,D C,1.0,2.0,3.0,1.0,1.0,1.0,1.0,7.0,2.0,2.0,2.0,3.0,5.0,5.0,8.0,7.0,4.0,13.0,3.0,1.0,13.0,12.0,7.0,13.0,4.0,9.0,12.0,12.0,10.0,10.0,3.0,12.0,14.0,3.0,14.0,7.0,11.0,10.0,11.0,13.0,13.0,15.0,12.0,7.0,15.0,13.0,20.0,7.0,8.0,10.0,7.0,3.0,15.0,10.0,5.0,14.0,14.0,13.0,14.0,13.0,13.0,7.0,Bura,ÃÂÃÂ£360Th. ,Liga NOS
19/6/2011,Bruno EcuÃÂ©lÃÂ© Manga,34010356,19,7/16/1988,22,15,2,0,0,3825,6471,4278,165,130,627407,186,76,D C,2,2,3,1,1,2,2,2,2,1,3,5,5,5,7,8,6,13,8,7,15,7,10,12,8,10,14,14,13,13,9,14,14,5,12,6,14,13,13,15,8,15,13,5,15,14,20,16,15,15,10,15,5,10,12,15,13,14,14,16,16,5,20,1,1,1,1,1,20,D C,101,1,1,1,1,1,1,20,1,1,1,1,1,1,1,1,32768.0,0,0,0,0,0,0,0,0,0,0,0,0,0,0,0,1,0,0,0,0,0,0,0,0,0,0,0,0,0,0,0,0,0,0,0,0,0,0,0,0,0,0,0,0,0,0,0,0,Bruno Ecuele Manga,ÃÂ£5.40m ,32.0,186.0,Defender - Centre-Back,right,Dijon FCO,36.0,1.0,0.0,3243.0,34.0,2.0,0.0,2968.0,20.0,1.0,0.0,1755.0,36.0,1.0,0.0,3176.0,32.0,3.0,0.0,2880.0,26.0,2.0,0.0,2084.0,22.0,0.0,0.0,1643.0,43.0,1.0,2.0,3661.0,40.0,1.0,1.0,3555.0,Ligue 1,31.0,1.0,0.0,2790.0,8.0,1.0,0.0,720.0,29/6/2010,Bruno EcuÃÂ©lÃÂ© Manga,34010356.0,19.0,7/16/1988,21.0,15.0,2.0,0.0,0.0,3800.0,6450.0,4250.0,165.0,129.0,5000000.0,186.0,76.0,D C,1.0,2.0,3.0,3.0,3.0,2.0,2.0,4.0,3.0,3.0,2.0,5.0,5.0,5.0,7.0,8.0,6.0,13.0,8.0,7.0,15.0,7.0,10.0,12.0,8.0,10.0,14.0,14.0,13.0,13.0,9.0,14.0,14.0,5.0,12.0,6.0,14.0,13.0,13.0,15.0,8.0,15.0,13.0,5.0,15.0,14.0,20.0,16.0,15.0,15.0,10.0,15.0,5.0,10.0,12.0,15.0,13.0,14.0,14.0,16.0,16.0,5.0,Bruno Ecuele Manga,ÃÂÃÂ£4.05m ,Ligue 1
19/6/2011,AndrÃÂ© Micael,744129,788,2/4/1989,22,0,0,0,0,1000,4500,4500,120,102,45455,187,80,D C,3,3,3,1,2,3,2,1,3,1,1,6,6,7,6,10,9,13,8,9,12,7,10,11,10,11,11,11,11,12,7,10,10,7,9,8,12,12,11,13,10,13,14,7,13,13,20,13,14,12,10,10,7,7,13,14,13,12,14,14,14,14,20,1,1,1,1,1,20,D C,101,1,1,1,1,1,1,20,1,1,1,1,1,1,1,1,0.0,0,0,0,0,0,0,0,0,0,0,0,0,0,0,0,0,0,0,0,0,0,0,0,0,0,0,0,0,0,0,0,0,0,0,0,0,0,0,0,0,0,0,0,0,0,0,0,0,AndrÃÂ© Micael,ÃÂ£180Th. ,31.0,188.0,Defender - Centre-Back,right,Varzim SC,25.0,0.0,0.0,2189.0,3.0,0.0,0.0,106.0,27.0,1.0,0.0,2322.0,37.0,0.0,0.0,3272.0,37.0,2.0,1.0,3152.0,25.0,0.0,0.0,2196.0,23.0,1.0,0.0,2070.0,16.0,1.0,1.0,1305.0,12.0,0.0,0.0,907.0,Liga NOS,11.0,1.0,0.0,927.0,7.0,0.0,0.0,630.0,nan,nan,nan,nan,nan,nan,nan,nan,nan,nan,nan,nan,nan,nan,nan,nan,nan,nan,nan,nan,nan,nan,nan,nan,nan,nan,nan,nan,nan,nan,nan,nan,nan,nan,nan,nan,nan,nan,nan,nan,nan,nan,nan,nan,nan,nan,nan,nan,nan,nan,nan,nan,nan,nan,nan,nan,nan,nan,nan,nan,nan,nan,nan,nan,nan,nan,nan,nan,nan,nan,nan,nan,nan,nan,nan,nan,nan,nan,nan,nan,nan,nan,nan,nan,19-06-17,18.3.4.28,AndrÃÂ© Micael,744129,788,04-Feb-89,28,0,0,0,0,2750,5450,5450,116,109,110575,188,83,D C,3,1,3,1,2,3,1,2,1,1,2,6,6,7,6,10,9,12,8,9,14,7,10,11,10,12,13,11,13,12,7,11,12,7,12,8,13,12,12,11,10,12,14,7,13,12,20,13,14,11,10,12,7,7,10,10,14,12,14,14,14,6,20,1,1,1,1,1,20,D C,101,1,1,1,1,1,1,20,1,1,1,1,1,1,1,1,0.0,0,0,0,0,0,0,0,0,0,0,0,0,0,0,0,0,0,0,0,0,0,0,0,0,0,0,0,0,0,0,0,0,0,0,0,0,0,0,0,0,0,0,0,0,0,0,0,0,AndrÃÂ© Micael,ÃÂ£540Th. ,31.0,188.0,Defender - Centre-Back,right,Varzim SC,23.0,1.0,0.0,2070.0,16.0,1.0,1.0,1305.0,12.0,0.0,0.0,907.0,11.0,1.0,0.0,927.0,7.0,0.0,0.0,630.0,Liga NOS,15-07-16,17.3.2.23,AndrÃÂ© Micael,744129.0,788.0,04-Feb-89,27.0,0.0,0.0,0.0,0.0,2250.0,5400.0,5400.0,116.0,108.0,111294.0,188.0,83.0,D C,3.0,3.0,2.0,1.0,3.0,3.0,2.0,3.0,3.0,1.0,1.0,6.0,6.0,7.0,6.0,10.0,9.0,12.0,8.0,9.0,14.0,7.0,10.0,10.0,10.0,11.0,13.0,11.0,13.0,12.0,7.0,11.0,12.0,7.0,12.0,8.0,13.0,12.0,12.0,11.0,10.0,12.0,14.0,7.0,13.0,12.0,20.0,13.0,14.0,11.0,10.0,12.0,7.0,7.0,10.0,10.0,13.0,12.0,14.0,14.0,14.0,7.0,AndrÃÂ© Micael,ÃÂ£630Th. ,Liga NOS
19/6/2011,ÃÂlvaro DomÃÂ­nguez,67037294,796,5/15/1989,22,0,0,1,0,4750,6800,6800,163,142,1436866,189,83,D LC,1,1,3,2,3,2,1,3,1,3,1,5,9,7,5,10,6,15,8,10,15,11,3,15,9,15,13,16,12,13,7,13,16,5,11,6,16,13,16,14,15,13,15,20,12,12,9,14,15,14,10,15,7,9,11,14,16,7,16,12,9,7,20,1,1,1,1,15,20,D LC,104,1,10,1,1,1,1,20,15,1,5,1,1,1,1,1,32768.0,0,0,0,0,0,0,0,0,0,0,0,0,0,0,0,1,0,0,0,0,0,0,0,0,0,0,0,0,0,0,0,0,0,0,0,0,0,0,0,0,0,0,0,0,0,0,0,0,nan,nan,nan,nan,nan,nan,nan,nan,nan,nan,nan,nan,nan,nan,nan,nan,nan,nan,nan,nan,nan,nan,nan,nan,nan,nan,nan,nan,nan,nan,nan,nan,nan,nan,nan,nan,nan,nan,nan,nan,nan,nan,nan,nan,nan,nan,nan,nan,nan,nan,nan,nan,29/6/2010,ÃÂlvaro DomÃÂ­nguez,67037294.0,796.0,5/15/1989,21.0,0.0,0.0,1.0,0.0,4750.0,6299.0,5500.0,160.0,140.0,91453172.0,189.0,83.0,D LC,3.0,2.0,2.0,3.0,2.0,1.0,3.0,9.0,3.0,3.0,3.0,2.0,10.0,8.0,5.0,10.0,3.0,15.0,2.0,10.0,17.0,11.0,3.0,15.0,10.0,13.0,13.0,12.0,12.0,12.0,4.0,15.0,17.0,7.0,8.0,6.0,16.0,13.0,13.0,14.0,16.0,12.0,15.0,20.0,12.0,12.0,8.0,10.0,16.0,14.0,10.0,15.0,7.0,9.0,11.0,12.0,15.0,12.0,16.0,14.0,10.0,7.0,ÃÂÃÂlvaro DomÃÂÃÂ­nguez,ÃÂÃÂ£8.10m ,LaLiga
19/6/2011,Alejandro Arribas,67030522,796,5/1/1989,22,0,0,0,0,3800,5600,5600,138,116,141821,182,75,D C,1,1,2,3,3,3,2,8,1,3,3,3,4,7,3,9,5,14,5,5,13,7,2,14,9,13,15,14,13,15,6,11,14,10,6,6,14,13,14,9,10,15,13,8,14,11,20,14,14,12,7,14,5,5,6,13,15,13,16,12,12,7,20,1,1,1,5,1,20,D C,101,1,10,1,1,1,1,20,1,5,10,1,1,1,1,1,0.0,0,0,0,0,0,0,0,0,0,0,0,0,0,0,0,0,0,0,0,0,0,0,0,0,0,0,0,0,0,0,0,0,0,0,0,0,0,0,0,0,0,0,0,0,0,0,0,0,Alejandro Arribas,ÃÂ£1.80m ,31.0,182.0,Defender - Centre-Back,right,Real Oviedo,38.0,0.0,0.0,3415.0,36.0,1.0,1.0,3175.0,35.0,2.0,0.0,2843.0,38.0,1.0,1.0,3377.0,18.0,0.0,1.0,1433.0,31.0,2.0,0.0,2740.0,26.0,2.0,1.0,2177.0,23.0,1.0,0.0,1945.0,27.0,1.0,1.0,2311.0,LaLiga,27.0,0.0,0.0,2277.0,6.0,1.0,0.0,470.0,nan,nan,nan,nan,nan,nan,nan,nan,nan,nan,nan,nan,nan,nan,nan,nan,nan,nan,nan,nan,nan,nan,nan,nan,nan,nan,nan,nan,nan,nan,nan,nan,nan,nan,nan,nan,nan,nan,nan,nan,nan,nan,nan,nan,nan,nan,nan,nan,nan,nan,nan,nan,nan,nan,nan,nan,nan,nan,nan,nan,nan,nan,nan,nan,nan,nan,nan,nan,nan,nan,nan,nan,nan,nan,nan,nan,nan,nan,nan,nan,nan,nan,nan,nan
19/6/2011,Alberto BotÃÂ­a,67024158,796,1/27/1989,22,0,0,1,0,4900,6850,6850,163,138,1529730,187,80,D C,3,2,3,3,2,2,2,3,2,2,1,4,8,7,5,11,5,15,9,10,14,12,5,14,10,16,15,14,13,14,9,14,12,5,7,5,16,15,14,14,12,15,15,5,13,14,20,15,12,13,12,11,14,10,14,12,15,10,15,12,10,4,20,1,1,1,10,1,20,D C,101,1,1,1,1,1,1,20,1,10,10,1,1,1,1,1,0.0,0,0,0,0,0,0,0,0,0,0,0,0,0,0,0,0,0,0,0,0,0,0,0,0,0,0,0,0,0,0,0,0,0,0,0,0,0,0,0,0,0,0,0,0,0,0,0,0,Alberto BotÃÂ­a,ÃÂ£5.40m ,31.0,188.0,Defender - Centre-Back,right,Al-Wahda Mekka,29.0,1.0,0.0,2528.0,36.0,1.0,2.0,3142.0,25.0,2.0,0.0,1746.0,35.0,0.0,2.0,3036.0,26.0,2.0,0.0,2083.0,27.0,4.0,0.0,2222.0,36.0,2.0,2.0,3157.0,17.0,2.0,0.0,1352.0,30.0,2.0,0.0,2651.0,LaLiga,26.0,1.0,0.0,2322.0,2.0,0.0,0.0,180.0,29/6/2010,Alberto BotÃÂ­a,67024158.0,796.0,1/27/1989,21.0,0.0,0.0,1.0,0.0,3750.0,6209.0,5750.0,162.0,138.0,4475459.0,187.0,80.0,D RC,3.0,1.0,2.0,1.0,3.0,3.0,2.0,1.0,3.0,1.0,1.0,4.0,9.0,7.0,8.0,11.0,5.0,15.0,9.0,10.0,14.0,12.0,5.0,15.0,10.0,12.0,15.0,14.0,13.0,15.0,9.0,14.0,12.0,5.0,7.0,5.0,15.0,15.0,14.0,14.0,13.0,15.0,15.0,2.0,13.0,14.0,20.0,15.0,12.0,13.0,9.0,11.0,14.0,10.0,14.0,12.0,15.0,10.0,15.0,12.0,10.0,4.0,Alberto BotÃÂÃÂ­a,ÃÂÃÂ£2.70m ,LaLiga
19/6/2011,Yohan TavarÃÂ¨s,34012957,769,3/2/1988,23,0,0,0,0,1250,3500,4500,125,106,72712,188,79,D C,3,2,1,1,2,3,1,4,3,2,2,6,6,6,6,8,6,14,8,10,12,7,8,8,8,3,11,12,12,12,6,12,13,5,10,8,10,14,11,11,7,16,15,10,10,11,20,13,15,13,6,10,6,10,14,13,6,11,13,13,13,6,20,1,1,1,10,7,20,D C,101,1,1,1,1,1,1,20,7,10,1,1,1,1,1,1,0.0,0,0,0,0,0,0,0,0,0,0,0,0,0,0,0,0,0,0,0,0,0,0,0,0,0,0,0,0,0,0,0,0,0,0,0,0,0,0,0,0,0,0,0,0,0,0,0,0,Yohan Tavares,ÃÂ£1.62m ,32.0,188.0,Defender - Centre-Back,right,CD Tondela,26.0,1.0,0.0,1956.0,25.0,0.0,0.0,2172.0,14.0,0.0,0.0,1133.0,44.0,1.0,2.0,3890.0,39.0,1.0,0.0,3450.0,35.0,0.0,1.0,3158.0,31.0,1.0,0.0,2548.0,15.0,1.0,1.0,1350.0,37.0,1.0,0.0,3360.0,Liga NOS,30.0,3.0,0.0,2603.0,5.0,0.0,0.0,413.0,29/6/2010,Yohan TavarÃÂ¨s,34012957.0,769.0,3/2/1988,22.0,0.0,0.0,0.0,0.0,500.0,2100.0,2100.0,125.0,93.0,95386.0,188.0,79.0,D C,3.0,2.0,2.0,1.0,1.0,3.0,3.0,5.0,2.0,2.0,2.0,6.0,6.0,6.0,6.0,8.0,6.0,14.0,8.0,10.0,12.0,7.0,11.0,8.0,8.0,9.0,11.0,12.0,12.0,12.0,6.0,12.0,13.0,5.0,10.0,8.0,10.0,14.0,11.0,11.0,7.0,16.0,15.0,10.0,13.0,11.0,20.0,6.0,15.0,13.0,10.0,9.0,8.0,10.0,14.0,13.0,14.0,12.0,13.0,13.0,13.0,6.0,Yohan Tavares,ÃÂÃÂ£270Th. ,Liga NOS,19-06-17,18.3.4.28,Yohan Tavares,34012957,788,02-Mar-88,29,0,0,0,0,4750,6150,6150,128,120,404250,188,82,D C,2,1,3,2,1,4,3,2,1,3,2,5,5,7,6,11,7,13,10,9,13,11,12,14,11,14,14,14,12,14,7,12,13,5,15,7,14,14,13,12,8,14,14,8,13,13,20,15,13,13,7,10,8,7,14,13,13,13,14,13,13,6,20,1,1,1,10,7,20,D C,101,1,1,1,1,1,1,20,7,10,1,1,1,1,1,1,0.0,0,0,0,0,0,0,0,0,0,0,0,0,0,0,0,0,0,0,0,0,0,0,0,0,0,0,0,0,0,0,0,0,0,0,0,0,0,0,0,0,0,0,0,0,0,0,0,0,Yohan Tavares,ÃÂ£540Th. ,32.0,188.0,Defender - Centre-Back,right,CD Tondela,31.0,1.0,0.0,2548.0,15.0,1.0,1.0,1350.0,37.0,1.0,0.0,3360.0,30.0,3.0,0.0,2603.0,5.0,0.0,0.0,413.0,Liga NOS,nan,nan,nan,nan,nan,nan,nan,nan,nan,nan,nan,nan,nan,nan,nan,nan,nan,nan,nan,nan,nan,nan,nan,nan,nan,nan,nan,nan,nan,nan,nan,nan,nan,nan,nan,nan,nan,nan,nan,nan,nan,nan,nan,nan,nan,nan,nan,nan,nan,nan,nan,nan,nan,nan,nan,nan,nan,nan,nan,nan,nan,nan,nan,nan,nan,nan,nan,nan,nan,nan,nan,nan,nan,nan,nan,nan,nan,nan,nan,nan,nan,nan,nan,nan,nan
19/6/2011,Varela,55005547,12,11/26/1987,23,3,0,0,0,1500,5200,5200,120,104,85088,181,85,D C,3,2,3,1,2,1,3,2,3,3,1,5,4,5,1,14,2,13,4,7,14,13,7,14,10,8,12,13,13,5,7,14,10,6,2,5,14,14,14,14,12,13,14,5,15,14,20,10,6,10,8,10,10,10,9,14,14,8,14,7,11,8,20,1,1,1,10,1,20,D C,101,1,1,1,1,1,1,20,1,10,1,1,1,1,1,1,0.0,0,0,0,0,0,0,0,0,0,0,0,0,0,0,0,0,0,0,0,0,0,0,0,0,0,0,0,0,0,0,0,0,0,0,0,0,0,0,0,0,0,0,0,0,0,0,0,0,nan,nan,nan,nan,nan,nan,nan,nan,nan,nan,nan,nan,nan,nan,nan,nan,nan,nan,nan,nan,nan,nan,nan,nan,nan,nan,nan,nan,nan,nan,nan,nan,nan,nan,nan,nan,nan,nan,nan,nan,nan,nan,nan,nan,nan,nan,nan,nan,nan,nan,nan,nan,nan,nan,nan,nan,nan,nan,nan,nan,nan,nan,nan,nan,nan,nan,nan,nan,nan,nan,nan,nan,nan,nan,nan,nan,nan,nan,nan,nan,nan,nan,nan,nan,nan,nan,nan,nan,nan,nan,nan,nan,nan,nan,nan,nan,nan,nan,nan,nan,nan,nan,nan,nan,nan,nan,nan,nan,nan,nan,nan,nan,nan,nan,nan,nan,nan,nan,nan,nan,nan,nan,nan,nan,nan,nan,nan,nan,nan,nan,nan,nan,nan,nan,nan,nan
19/6/2011,Timm Klose,98003380,798,5/9/1988,23,0,0,12,0,5000,6250,6250,136,121,285630,193,87,D C,1,2,2,3,3,3,1,1,1,2,3,4,6,7,5,9,4,15,5,8,13,8,4,14,6,12,12,13,10,16,6,11,14,4,8,14,15,13,12,11,8,17,17,6,13,10,20,14,16,11,5,10,5,5,14,5,13,11,15,1,10,14,20,1,1,1,1,14,20,D C,101,1,1,1,1,1,1,20,14,1,1,1,1,1,1,1,0.0,0,0,0,0,0,0,0,0,0,0,0,0,0,0,0,0,0,0,0,0,0,0,0,0,0,0,0,0,0,0,0,0,0,0,0,0,0,0,0,0,0,0,0,0,0,0,0,0,Timm Klose,ÃÂ£1.35m ,32.0,195.0,Defender - Centre-Back,right,FC Basel 1893,34.0,4.0,1.0,2955.0,22.0,1.0,0.0,1896.0,33.0,2.0,1.0,2920.0,12.0,1.0,0.0,541.0,19.0,3.0,0.0,1535.0,22.0,2.0,0.0,1795.0,35.0,1.0,0.0,2994.0,41.0,4.0,2.0,3651.0,33.0,4.0,1.0,2043.0,Bundesliga,9.0,0.0,0.0,701.0,1.0,0.0,0.0,59.0,nan,nan,nan,nan,nan,nan,nan,nan,nan,nan,nan,nan,nan,nan,nan,nan,nan,nan,nan,nan,nan,nan,nan,nan,nan,nan,nan,nan,nan,nan,nan,nan,nan,nan,nan,nan,nan,nan,nan,nan,nan,nan,nan,nan,nan,nan,nan,nan,nan,nan,nan,nan,nan,nan,nan,nan,nan,nan,nan,nan,nan,nan,nan,nan,nan,nan,nan,nan,nan,nan,nan,nan,nan,nan,nan,nan,nan,nan,nan,nan,nan,nan,nan,nan
19/6/2011,Tim Heubach,91003893,771,5/12/1988,23,0,0,0,0,1000,4250,4250,100,85,22730,192,78,D/WB LC,3,1,1,2,2,2,1,3,1,2,3,3,4,4,1,10,3,9,9,5,11,8,3,14,10,11,13,10,7,12,5,12,10,3,1,10,14,14,13,9,12,12,14,20,9,8,8,8,7,10,3,6,11,10,12,15,14,13,14,9,17,12,20,16,1,1,1,18,20,D/WB LC,114,1,1,1,1,1,1,20,18,1,1,1,1,1,16,1,0.0,0,0,0,0,0,0,0,0,0,0,0,0,0,0,0,0,0,0,0,0,0,0,0,0,0,0,0,0,0,0,0,0,0,0,0,0,0,0,0,0,0,0,0,0,0,0,0,0,nan,nan,nan,nan,nan,nan,nan,nan,nan,nan,nan,nan,nan,nan,nan,nan,nan,nan,nan,nan,nan,nan,nan,nan,nan,nan,nan,nan,nan,nan,nan,nan,nan,nan,nan,nan,nan,nan,nan,nan,nan,nan,nan,nan,nan,nan,nan,nan,nan,nan,nan,nan,nan,nan,nan,nan,nan,nan,nan,nan,nan,nan,nan,nan,nan,nan,nan,nan,nan,nan,nan,nan,nan,nan,nan,nan,nan,nan,nan,nan,nan,nan,nan,nan,nan,nan,nan,nan,nan,nan,nan,nan,nan,nan,nan,nan,nan,nan,nan,nan,nan,nan,nan,nan,nan,nan,nan,nan,nan,nan,nan,nan,nan,nan,nan,nan,nan,nan,nan,nan,nan,nan,nan,nan,nan,nan,nan,nan,nan,nan,nan,nan,nan,nan,nan,nan
19/6/2011,Sokratis Papastathopoulos,1804808,772,6/9/1988,23,20,0,8,2,6500,7000,6950,161,139,1412490,185,82,D RC,1,2,2,1,3,3,2,7,1,2,1,5,9,12,4,9,4,13,5,16,18,10,6,18,11,17,14,18,12,10,7,11,16,4,14,9,11,16,17,13,9,18,15,8,17,17,20,16,15,13,14,8,5,14,14,15,12,11,13,15,7,5,20,13,9,1,16,3,20,D RC,103,1,10,1,1,1,1,20,3,16,12,1,1,9,1,13,1236950000000.0,0,1,0,0,0,0,1,0,0,0,0,0,0,0,0,1,0,0,0,0,0,0,0,0,0,0,0,0,0,0,0,0,0,0,0,0,0,1,0,0,1,0,0,0,0,0,0,0,nan,nan,nan,nan,nan,nan,nan,nan,nan,nan,nan,nan,nan,nan,nan,nan,nan,nan,nan,nan,nan,nan,nan,nan,nan,nan,nan,nan,nan,nan,nan,nan,nan,nan,nan,nan,nan,nan,nan,nan,nan,nan,nan,nan,nan,nan,nan,nan,nan,nan,nan,nan,29/6/2010,Sokratis Papastathopoulos,1804808.0,772.0,6/9/1988,22.0,12.0,0.0,9.0,2.0,4970.0,7000.0,7000.0,165.0,141.0,24000000.0,183.0,80.0,D RC,2.0,1.0,3.0,2.0,3.0,2.0,3.0,7.0,3.0,3.0,2.0,3.0,4.0,9.0,8.0,7.0,4.0,15.0,6.0,12.0,16.0,10.0,4.0,15.0,12.0,16.0,15.0,15.0,10.0,12.0,8.0,14.0,16.0,7.0,13.0,11.0,14.0,13.0,15.0,13.0,12.0,16.0,13.0,8.0,14.0,13.0,20.0,15.0,16.0,14.0,16.0,13.0,5.0,8.0,14.0,15.0,12.0,14.0,13.0,12.0,13.0,5.0,nan,nan,nan,19-06-17,18.3.4.28,Sokratis Papastathopoulos,1804808,772,09-Jun-88,29,73,2,9,2,6700,7250,7700,154,154,116583681,186,85,D C,3,1,2,2,3,3,3,3,1,2,2,5,8,11,4,11,4,12,5,15,19,10,6,19,10,16,14,18,10,16,7,12,16,4,13,8,13,12,14,14,12,18,14,8,17,18,20,15,16,17,10,15,2,14,14,17,8,11,13,12,7,5,20,10,10,1,14,1,20,D C,101,1,10,1,1,1,1,20,1,14,12,10,1,1,1,10,0.0,0,0,0,0,0,0,0,0,0,0,0,0,0,0,0,0,0,0,0,0,0,0,0,0,0,0,0,0,0,0,0,0,0,0,0,0,0,0,0,0,0,0,0,0,0,0,0,0,nan,nan,nan,nan,nan,nan,nan,nan,nan,nan,nan,nan,nan,nan,nan,nan,nan,nan,nan,nan,nan,nan,nan,nan,nan,nan,nan,nan,15-07-16,17.3.2.23,Sokratis Papastathopoulos,1804808.0,772.0,09-Jun-88,28.0,65.0,2.0,9.0,2.0,5550.0,7250.0,7550.0,151.0,151.0,59228524.0,186.0,85.0,D C,3.0,1.0,1.0,3.0,3.0,4.0,1.0,4.0,2.0,2.0,3.0,5.0,9.0,11.0,4.0,11.0,4.0,12.0,5.0,15.0,19.0,10.0,6.0,19.0,10.0,17.0,14.0,18.0,10.0,14.0,7.0,11.0,16.0,4.0,14.0,9.0,13.0,12.0,16.0,14.0,11.0,18.0,14.0,8.0,17.0,18.0,20.0,15.0,16.0,13.0,12.0,12.0,2.0,14.0,14.0,17.0,8.0,11.0,13.0,12.0,7.0,5.0,nan,nan,nan
19/6/2011,Sebastian PrÃÂ¶dl,5610074,755,6/21/1987,23,29,3,0,0,6000,6750,6350,135,127,470737,194,90,D C,3,3,3,2,3,1,1,5,3,1,2,4,7,6,8,7,6,17,10,14,14,7,8,13,7,13,15,14,9,14,7,8,16,6,12,7,14,16,14,9,7,16,18,8,12,14,20,12,17,11,6,12,13,3,12,14,16,9,14,15,16,3,20,1,1,1,12,1,20,D C,101,1,1,1,1,1,1,20,1,12,1,1,1,1,1,1,8796090000000.0,0,0,0,1,0,0,0,0,0,0,0,0,0,0,0,0,0,0,0,0,0,0,0,0,0,0,0,0,0,0,0,0,0,0,0,0,0,0,0,0,0,0,0,1,0,0,0,0,Sebastian PrÃÂ¶dl,ÃÂ£3.15m ,33.0,194.0,Defender - Centre-Back,right,Udinese Calcio,35.0,2.0,4.0,3180.0,16.0,2.0,1.0,1061.0,29.0,1.0,0.0,2051.0,28.0,3.0,1.0,2424.0,24.0,3.0,1.0,1922.0,24.0,2.0,0.0,2046.0,34.0,1.0,2.0,2846.0,22.0,0.0,0.0,1658.0,2.0,0.0,0.0,103.0,Bundesliga,3.0,0.0,0.0,212.0,0.0,0.0,0.0,0.0,29/6/2010,Sebastian PrÃÂ¶dl,5610074.0,755.0,6/21/1987,23.0,20.0,2.0,0.0,0.0,4000.0,6750.0,6750.0,135.0,127.0,5369551.0,194.0,90.0,D C,2.0,3.0,3.0,1.0,3.0,3.0,1.0,1.0,1.0,3.0,2.0,4.0,7.0,6.0,8.0,7.0,6.0,17.0,10.0,14.0,14.0,7.0,8.0,13.0,7.0,13.0,15.0,14.0,9.0,14.0,7.0,8.0,16.0,6.0,12.0,7.0,14.0,16.0,14.0,9.0,7.0,16.0,18.0,8.0,12.0,14.0,20.0,12.0,17.0,11.0,6.0,12.0,10.0,3.0,12.0,14.0,16.0,9.0,14.0,15.0,16.0,3.0,Sebastian PrÃÂÃÂ¶dl,ÃÂÃÂ£3.15m ,Bundesliga
19/6/2011,Sebastian Langkamp,35016452,771,1/15/1988,23,0,0,5,0,3800,5900,5900,138,121,111367,190,85,D C,1,2,3,2,1,1,1,6,1,3,2,3,3,4,5,6,5,16,5,6,16,10,4,14,9,14,13,9,10,12,4,12,12,5,12,6,15,13,12,12,10,13,16,4,12,12,20,12,14,12,10,10,6,5,11,13,11,14,13,15,14,9,20,1,1,1,5,10,20,D C,101,1,1,1,1,1,1,20,10,5,1,1,1,1,1,1,32832.0,0,0,0,0,0,0,1,0,0,0,0,0,0,0,0,1,0,0,0,0,0,0,0,0,0,0,0,0,0,0,0,0,0,0,0,0,0,0,0,0,0,0,0,0,0,0,0,0,Sebastian Langkamp,ÃÂ£2.25m ,32.0,191.0,Defender - Centre-Back,right,Without Club,22.0,1.0,1.0,1879.0,27.0,4.0,1.0,2198.0,13.0,0.0,0.0,1170.0,30.0,0.0,0.0,2629.0,17.0,1.0,0.0,1446.0,26.0,0.0,1.0,2270.0,32.0,0.0,0.0,2794.0,26.0,0.0,0.0,1701.0,23.0,0.0,0.0,1533.0,Bundesliga,7.0,0.0,0.0,425.0,nan,nan,nan,nan,nan,nan,nan,nan,nan,nan,nan,nan,nan,nan,nan,nan,nan,nan,nan,nan,nan,nan,nan,nan,nan,nan,nan,nan,nan,nan,nan,nan,nan,nan,nan,nan,nan,nan,nan,nan,nan,nan,nan,nan,nan,nan,nan,nan,nan,nan,nan,nan,nan,nan,nan,nan,nan,nan,nan,nan,nan,nan,nan,nan,nan,nan,nan,nan,nan,nan,nan,nan,nan,nan,nan,nan,nan,nan,nan,nan,nan,nan,nan,nan,nan,nan,nan,nan,19-06-17,18.3.4.28,Sebastian Langkamp,35016452,771,15-Jan-88,29,0,0,5,0,4350,6350,6350,128,127,6231688,190,85,D C,2,3,1,3,2,3,4,3,3,2,2,4,7,6,6,8,4,14,4,10,15,10,5,14,8,10,14,13,10,16,7,12,12,5,13,6,15,17,11,10,9,14,16,8,14,12,20,13,16,15,6,15,6,7,8,13,14,13,17,14,16,5,20,8,1,1,5,10,20,D C,101,1,1,1,1,1,1,20,10,5,1,1,1,1,8,3,0.0,0,0,0,0,0,0,0,0,0,0,0,0,0,0,0,0,0,0,0,0,0,0,0,0,0,0,0,0,0,0,0,0,0,0,0,0,0,0,0,0,0,0,0,0,0,0,0,0,Sebastian Langkamp,ÃÂ£2.25m ,32.0,191.0,Defender - Centre-Back,right,Without Club,32.0,0.0,0.0,2794.0,26.0,0.0,0.0,1701.0,23.0,0.0,0.0,1533.0,7.0,0.0,0.0,425.0,nan,nan,nan,nan,Bundesliga,15-07-16,17.3.2.23,Sebastian Langkamp,35016452.0,771.0,15-Jan-88,28.0,0.0,0.0,5.0,0.0,4350.0,6350.0,6350.0,128.0,127.0,5118080.0,190.0,85.0,D C,2.0,1.0,4.0,1.0,3.0,2.0,2.0,1.0,4.0,2.0,3.0,4.0,7.0,6.0,6.0,8.0,4.0,14.0,4.0,10.0,15.0,9.0,5.0,15.0,8.0,10.0,13.0,14.0,10.0,16.0,7.0,12.0,12.0,5.0,13.0,6.0,15.0,17.0,12.0,10.0,9.0,14.0,16.0,8.0,14.0,12.0,20.0,13.0,16.0,17.0,6.0,15.0,6.0,7.0,8.0,13.0,12.0,14.0,17.0,16.0,14.0,5.0,Sebastian Langkamp,ÃÂ£2.70m ,Bundesliga
19/6/2011,Samuel Bouhours,34010135,769,6/26/1987,23,0,0,2,0,4250,5318,5310,132,118,345368,182,75,D LC,2,3,2,3,3,2,2,2,3,1,2,6,11,8,5,9,6,12,8,11,13,8,7,13,9,15,13,14,11,13,9,11,15,6,10,8,13,16,14,13,11,14,12,20,13,11,8,15,13,13,15,16,12,12,11,15,15,12,13,11,11,9,20,15,1,1,10,20,18,D LC,104,1,1,1,1,1,1,18,20,10,1,1,1,1,15,10,0.0,0,0,0,0,0,0,0,0,0,0,0,0,0,0,0,0,0,0,0,0,0,0,0,0,0,0,0,0,0,0,0,0,0,0,0,0,0,0,0,0,0,0,0,0,0,0,0,0,Samuel Bouhours,ÃÂ£810Th. ,33.0,182.0,Defender - Left-Back,left,JS Coulaines,28.0,0.0,0.0,2340.0,26.0,0.0,1.0,2106.0,31.0,0.0,1.0,2800.0,29.0,0.0,1.0,2562.0,38.0,0.0,0.0,3378.0,36.0,0.0,1.0,3229.0,30.0,1.0,0.0,2443.0,11.0,0.0,0.0,863.0,7.0,0.0,1.0,474.0,Ligue 1,nan,nan,nan,nan,nan,nan,nan,nan,nan,nan,nan,nan,nan,nan,nan,nan,nan,nan,nan,nan,nan,nan,nan,nan,nan,nan,nan,nan,nan,nan,nan,nan,nan,nan,nan,nan,nan,nan,nan,nan,nan,nan,nan,nan,nan,nan,nan,nan,nan,nan,nan,nan,nan,nan,nan,nan,nan,nan,nan,nan,nan,nan,nan,nan,nan,nan,nan,nan,nan,nan,nan,nan,nan,nan,nan,nan,nan,nan,nan,nan,nan,nan,nan,nan,nan,nan,nan,nan,nan,nan,nan,nan
19/6/2011,Ryan Shawcross,5116920,765,10/4/1987,23,0,0,1,0,5500,7050,7250,165,147,2608789,196,77,D C,2,1,3,3,3,2,2,3,2,3,2,3,7,7,4,11,3,16,3,3,16,12,4,15,12,13,14,15,13,14,9,14,16,9,15,10,14,15,15,12,13,13,16,8,15,13,20,15,15,13,6,13,4,7,6,15,16,13,15,13,9,3,20,1,1,1,10,1,20,D C,101,1,1,1,1,1,1,20,1,10,1,1,1,1,1,1,137439000000.0,0,0,0,0,0,0,0,0,0,0,0,0,0,0,0,1,0,0,0,0,0,0,0,0,0,0,0,0,0,0,0,0,0,0,0,0,0,1,0,0,0,0,0,0,0,0,0,0,Ryan Shawcross,ÃÂ£7.20m ,33.0,191.0,Defender - Centre-Back,right,Stoke City,44.0,2.0,0.0,3947.0,49.0,2.0,4.0,4339.0,40.0,1.0,4.0,3630.0,43.0,1.0,0.0,3848.0,37.0,2.0,1.0,3282.0,24.0,0.0,0.0,2087.0,38.0,1.0,2.0,3404.0,27.0,1.0,1.0,2372.0,36.0,1.0,0.0,2937.0,Premier League,7.0,0.0,0.0,447.0,1.0,0.0,0.0,67.0,29/6/2010,Ryan Shawcross,5116920.0,765.0,10/4/1987,22.0,0.0,0.0,1.0,0.0,5000.0,7000.0,7000.0,165.0,148.0,14421208.0,196.0,77.0,D C,3.0,2.0,1.0,3.0,1.0,3.0,3.0,2.0,2.0,1.0,1.0,3.0,7.0,7.0,4.0,12.0,3.0,16.0,3.0,3.0,16.0,13.0,4.0,15.0,12.0,13.0,14.0,15.0,13.0,14.0,9.0,14.0,15.0,9.0,15.0,10.0,14.0,15.0,15.0,12.0,13.0,13.0,16.0,8.0,15.0,13.0,20.0,15.0,15.0,13.0,6.0,13.0,4.0,7.0,6.0,15.0,16.0,13.0,15.0,13.0,9.0,6.0,Ryan Shawcross,ÃÂÃÂ£7.65m ,Premier League
19/6/2011,Roman NeustÃÂ¤dter,91002404,771,2/18/1988,23,0,0,2,1,3750,6300,6300,137,116,264449,190,83,D/DM/M C,1,3,3,3,2,3,3,4,2,3,3,5,8,11,6,7,5,13,6,14,16,8,5,17,9,15,13,17,7,10,10,7,13,5,12,8,15,16,18,8,13,14,17,10,11,14,20,18,15,11,5,11,5,14,13,1,11,9,11,11,10,8,16,1,18,1,1,1,18,D/DM/M C,331,1,1,1,1,1,1,16,1,1,20,18,1,1,1,1,0.0,0,0,0,0,0,0,0,0,0,0,0,0,0,0,0,0,0,0,0,0,0,0,0,0,0,0,0,0,0,0,0,0,0,0,0,0,0,0,0,0,0,0,0,0,0,0,0,0,Roman NeustÃÂ¤dter,ÃÂ£3.15m ,32.0,188.0,Midfielder - Defensive Midfield,right,Dynamo Moscow,28.0,1.0,1.0,2058.0,38.0,0.0,2.0,3429.0,41.0,4.0,2.0,3503.0,44.0,2.0,5.0,3553.0,38.0,2.0,0.0,3192.0,38.0,0.0,1.0,3034.0,33.0,0.0,1.0,2019.0,44.0,5.0,0.0,3884.0,31.0,2.0,0.0,2685.0,Bundesliga,21.0,0.0,1.0,1742.0,2.0,0.0,0.0,102.0,29/6/2010,Roman NeustÃÂ¤dter,91002404.0,771.0,2/18/1988,22.0,0.0,0.0,2.0,1.0,1650.0,5500.0,5500.0,135.0,107.0,2028538.0,190.0,83.0,D/DM C,3.0,1.0,3.0,3.0,2.0,2.0,3.0,3.0,1.0,2.0,3.0,5.0,4.0,6.0,11.0,6.0,4.0,15.0,7.0,12.0,13.0,11.0,5.0,13.0,12.0,8.0,11.0,12.0,10.0,12.0,5.0,13.0,10.0,4.0,14.0,5.0,13.0,10.0,9.0,12.0,12.0,14.0,17.0,5.0,11.0,11.0,20.0,13.0,14.0,11.0,5.0,11.0,5.0,7.0,9.0,17.0,18.0,6.0,12.0,17.0,13.0,8.0,Roman NeustÃÂÃÂ¤dter,ÃÂÃÂ£1.13m ,Bundesliga
19/6/2011,Rico Schlimpert,35026135,771,2/23/1988,23,0,0,0,0,371,3500,3500,80,70,12107,188,68,D RC,2,3,3,3,2,3,2,1,1,1,2,5,5,5,2,11,2,10,9,4,14,11,3,11,8,11,12,11,8,11,6,10,6,6,3,10,9,8,11,10,12,13,14,3,12,14,20,7,6,8,7,7,5,10,7,13,10,11,13,13,7,13,20,14,1,1,15,1,20,D RC,103,1,1,1,1,1,1,20,1,15,1,1,1,1,1,14,0.0,0,0,0,0,0,0,0,0,0,0,0,0,0,0,0,0,0,0,0,0,0,0,0,0,0,0,0,0,0,0,0,0,0,0,0,0,0,0,0,0,0,0,0,0,0,0,0,0,nan,nan,nan,nan,nan,nan,nan,nan,nan,nan,nan,nan,nan,nan,nan,nan,nan,nan,nan,nan,nan,nan,nan,nan,nan,nan,nan,nan,nan,nan,nan,nan,nan,nan,nan,nan,nan,nan,nan,nan,nan,nan,nan,nan,nan,nan,nan,nan,nan,nan,nan,nan,nan,nan,nan,nan,nan,nan,nan,nan,nan,nan,nan,nan,nan,nan,nan,nan,nan,nan,nan,nan,nan,nan,nan,nan,nan,nan,nan,nan,nan,nan,nan,nan,nan,nan,nan,nan,nan,nan,nan,nan,nan,nan,nan,nan,nan,nan,nan,nan,nan,nan,nan,nan,nan,nan,nan,nan,nan,nan,nan,nan,nan,nan,nan,nan,nan,nan,nan,nan,nan,nan,nan,nan,nan,nan,nan,nan,nan,nan,nan,nan,nan,nan,nan,nan
19/6/2011,Richard Stearman,5112614,765,8/19/1987,23,0,0,4,0,3650,6000,6250,144,125,777237,188,78,D RC,3,1,2,3,2,1,1,5,1,3,3,4,9,11,11,11,5,13,4,13,11,13,8,15,11,10,11,12,12,10,9,10,16,14,11,4,12,12,15,16,11,13,12,9,14,16,20,14,14,11,4,13,4,13,12,10,15,15,13,13,16,5,20,10,10,1,18,1,20,D RC,103,1,1,12,1,1,1,20,1,18,1,9,1,10,1,10,137439000000.0,0,0,1,0,0,0,0,0,0,0,0,0,0,0,0,0,0,0,0,0,0,0,0,0,0,0,0,0,0,0,0,0,0,0,0,0,0,1,0,0,0,0,0,0,0,0,0,0,Richard Stearman,ÃÂ£2.25m ,33.0,191.0,Defender - Centre-Back,right,Huddersfield Town,36.0,1.0,0.0,3007.0,34.0,0.0,0.0,2765.0,31.0,1.0,0.0,2373.0,44.0,2.0,1.0,3824.0,45.0,0.0,1.0,3801.0,35.0,0.0,0.0,3015.0,21.0,1.0,0.0,1920.0,30.0,2.0,0.0,2566.0,17.0,1.0,0.0,526.0,Premier League,20.0,1.0,0.0,1662.0,7.0,0.0,1.0,622.0,nan,nan,nan,nan,nan,nan,nan,nan,nan,nan,nan,nan,nan,nan,nan,nan,nan,nan,nan,nan,nan,nan,nan,nan,nan,nan,nan,nan,nan,nan,nan,nan,nan,nan,nan,nan,nan,nan,nan,nan,nan,nan,nan,nan,nan,nan,nan,nan,nan,nan,nan,nan,nan,nan,nan,nan,nan,nan,nan,nan,nan,nan,nan,nan,nan,nan,nan,nan,nan,nan,nan,nan,nan,nan,nan,nan,nan,nan,nan,nan,nan,nan,nan,nan
19/6/2011,Reinaldo Lobo,19010362,1651,4/5/1988,23,0,0,0,0,500,4049,3500,105,90,24842,186,80,D C,1,1,1,3,1,3,3,1,2,3,2,6,1,10,2,11,9,14,7,7,13,13,3,12,12,15,10,6,11,13,6,14,10,6,1,7,11,10,13,14,9,11,14,8,11,12,20,8,6,10,14,10,12,10,14,13,10,10,7,13,12,8,20,1,1,1,1,1,20,D C,101,1,20,1,1,1,1,20,1,1,1,1,1,1,1,1,0.0,0,0,0,0,0,0,0,0,0,0,0,0,0,0,0,0,0,0,0,0,0,0,0,0,0,0,0,0,0,0,0,0,0,0,0,0,0,0,0,0,0,0,0,0,0,0,0,0,Reinaldo Lobo,ÃÂ£135Th. ,32.0,186.0,Defender - Centre-Back,both,Associacao AtlÃÂ©tica de Altos (PI),nan,nan,nan,nan,3.0,0.0,0.0,180.0,nan,nan,nan,nan,nan,nan,nan,nan,nan,nan,nan,nan,nan,nan,nan,nan,11.0,2.0,0.0,997.0,28.0,3.0,0.0,2340.0,nan,nan,nan,nan,Liga NOS,nan,nan,nan,nan,nan,nan,nan,nan,nan,nan,nan,nan,nan,nan,nan,nan,nan,nan,nan,nan,nan,nan,nan,nan,nan,nan,nan,nan,nan,nan,nan,nan,nan,nan,nan,nan,nan,nan,nan,nan,nan,nan,nan,nan,nan,nan,nan,nan,nan,nan,nan,nan,nan,nan,nan,nan,nan,nan,nan,nan,nan,nan,nan,nan,nan,nan,nan,nan,nan,nan,nan,nan,nan,nan,nan,nan,nan,nan,nan,nan,nan,nan,nan,nan,nan,nan,nan,nan,nan,nan,nan,nan
19/6/2011,RaÃÂºl RodrÃÂ­guez,67039611,796,9/22/1987,23,0,0,0,0,2500,5000,5000,120,105,183010,183,70,D C,2,2,2,2,2,1,3,1,3,1,2,6,5,5,4,8,5,13,5,7,12,9,4,13,8,7,9,13,9,12,8,9,9,6,11,8,12,13,14,11,9,14,12,6,15,13,20,15,13,9,12,9,8,8,10,13,10,9,15,6,8,7,20,1,1,1,1,1,20,D C,101,1,1,1,1,1,1,20,1,1,1,1,1,1,1,1,0.0,0,0,0,0,0,0,0,0,0,0,0,0,0,0,0,0,0,0,0,0,0,0,0,0,0,0,0,0,0,0,0,0,0,0,0,0,0,0,0,0,0,0,0,0,0,0,0,0,RaÃÂºl RodrÃÂ­guez,ÃÂ£1.35m ,33.0,185.0,Defender - Centre-Back,nan,Al-Arabi Sporting Club,9.0,0.0,0.0,661.0,32.0,0.0,0.0,2796.0,24.0,0.0,0.0,1717.0,24.0,0.0,0.0,1471.0,31.0,2.0,0.0,2636.0,27.0,2.0,0.0,2261.0,32.0,3.0,0.0,2866.0,3.0,0.0,0.0,270.0,nan,nan,nan,nan,LaLiga,nan,nan,nan,nan,nan,nan,nan,nan,nan,nan,nan,nan,nan,nan,nan,nan,nan,nan,nan,nan,nan,nan,nan,nan,nan,nan,nan,nan,nan,nan,nan,nan,nan,nan,nan,nan,nan,nan,nan,nan,nan,nan,nan,nan,nan,nan,nan,nan,nan,nan,nan,nan,nan,nan,nan,nan,nan,nan,nan,nan,nan,nan,nan,nan,nan,nan,nan,nan,nan,nan,nan,nan,nan,nan,nan,nan,nan,nan,nan,nan,nan,nan,nan,nan,nan,nan,nan,nan,nan,nan,nan,nan
19/6/2011,Paul Baysse,8448625,769,5/18/1988,23,0,0,9,1,4600,5773,5773,145,128,531058,184,85,D RC,2,3,1,3,2,1,2,1,1,1,3,5,10,7,7,11,6,16,13,11,13,9,7,12,11,14,13,16,12,15,10,13,14,6,12,7,15,12,14,12,9,15,13,6,13,11,20,15,15,15,14,14,8,6,9,15,12,14,14,14,14,5,20,15,1,1,20,12,18,D RC,103,1,1,1,1,1,1,18,12,20,1,1,1,1,1,15,32.0,0,0,0,0,0,1,0,0,0,0,0,0,0,0,0,0,0,0,0,0,0,0,0,0,0,0,0,0,0,0,0,0,0,0,0,0,0,0,0,0,0,0,0,0,0,0,0,0,Paul Baysse,ÃÂ£2.70m ,32.0,185.0,Defender - Centre-Back,right,FC Girondins Bordeaux,39.0,3.0,1.0,3508.0,36.0,1.0,0.0,3166.0,19.0,2.0,0.0,1710.0,0.0,0.0,0.0,0.0,14.0,1.0,0.0,1058.0,33.0,0.0,0.0,2914.0,25.0,2.0,1.0,2126.0,24.0,1.0,0.0,1896.0,26.0,0.0,0.0,2273.0,Ligue 1,0.0,0.0,0.0,0.0,7.0,0.0,0.0,512.0,29/6/2010,Paul Baysse,8448625.0,769.0,5/18/1988,22.0,0.0,0.0,7.0,0.0,2650.0,4050.0,4050.0,145.0,124.0,2832981.0,184.0,85.0,D C,3.0,2.0,2.0,2.0,2.0,2.0,1.0,7.0,2.0,3.0,2.0,5.0,7.0,7.0,7.0,11.0,6.0,14.0,13.0,11.0,13.0,9.0,7.0,11.0,11.0,14.0,13.0,16.0,12.0,15.0,10.0,13.0,14.0,6.0,12.0,7.0,15.0,12.0,13.0,12.0,8.0,15.0,12.0,6.0,13.0,11.0,20.0,15.0,15.0,15.0,14.0,14.0,8.0,6.0,16.0,15.0,12.0,14.0,14.0,14.0,14.0,5.0,Paul Baysse,ÃÂÃÂ£1.62m ,Ligue 1,19-06-17,18.3.4.28,Paul Baysse,8448625,769,18-May-88,29,0,0,6,1,4500,6550,6550,144,131,10187001,185,82,D RC,1,2,2,2,3,1,2,3,4,3,2,4,12,7,7,11,6,15,9,13,14,13,6,14,11,15,14,17,13,14,11,13,13,7,12,8,14,16,15,12,12,8,13,8,12,11,20,14,15,13,6,15,10,8,12,15,12,12,13,14,14,5,20,10,1,1,16,8,20,D RC,103,1,1,1,1,1,1,20,8,16,1,1,1,1,8,10,0.0,0,0,0,0,0,0,0,0,0,0,0,0,0,0,0,0,0,0,0,0,0,0,0,0,0,0,0,0,0,0,0,0,0,0,0,0,0,0,0,0,0,0,0,0,0,0,0,0,Paul Baysse,ÃÂ£2.25m ,32.0,185.0,Defender - Centre-Back,right,FC Girondins Bordeaux,25.0,2.0,1.0,2126.0,24.0,1.0,0.0,1896.0,26.0,0.0,0.0,2273.0,0.0,0.0,0.0,0.0,7.0,0.0,0.0,512.0,LaLiga,15-07-16,17.3.2.23,Paul Baysse,8448625.0,769.0,18-May-88,28.0,0.0,0.0,9.0,1.0,4395.0,6345.0,6545.0,134.0,132.0,6479320.0,187.0,85.0,D RC,2.0,3.0,2.0,1.0,1.0,2.0,2.0,1.0,2.0,3.0,4.0,4.0,10.0,7.0,7.0,11.0,8.0,16.0,11.0,13.0,14.0,10.0,6.0,14.0,11.0,14.0,14.0,17.0,11.0,14.0,8.0,13.0,14.0,7.0,12.0,7.0,13.0,16.0,15.0,12.0,12.0,15.0,13.0,8.0,14.0,11.0,20.0,14.0,15.0,15.0,6.0,15.0,8.0,8.0,20.0,15.0,12.0,12.0,13.0,14.0,14.0,5.0,Paul Baysse,ÃÂ£3.15m ,Ligue 1
19/6/2011,Osmar,67062727,796,6/8/1988,23,0,0,0,0,3026,5273,5273,124,112,195603,192,84,D C,1,2,3,1,3,1,2,6,3,3,3,7,7,5,9,9,11,14,7,11,13,11,7,12,9,12,11,14,10,12,5,11,12,6,8,5,12,15,15,9,9,17,16,20,14,9,7,13,16,12,11,12,8,8,10,12,13,9,15,10,9,8,20,1,1,1,1,8,20,D C,101,1,1,1,1,1,1,20,8,1,1,1,1,1,1,1,0.0,0,0,0,0,0,0,0,0,0,0,0,0,0,0,0,0,0,0,0,0,0,0,0,0,0,0,0,0,0,0,0,0,0,0,0,0,0,0,0,0,0,0,0,0,0,0,0,0,Osmar,ÃÂ£270Th. ,32.0,192.0,Midfielder - Defensive Midfield,left,FC Seoul,4.0,0.0,0.0,256.0,11.0,0.0,0.0,826.0,43.0,11.0,0.0,3880.0,49.0,3.0,0.0,4382.0,48.0,4.0,2.0,4320.0,54.0,4.0,4.0,4905.0,39.0,4.0,0.0,3460.0,24.0,2.0,0.0,2098.0,32.0,4.0,5.0,2744.0,LaLiga,17.0,2.0,1.0,1426.0,nan,nan,nan,nan,29/6/2010,ÃÂsmar,67062727.0,796.0,6/8/1988,22.0,0.0,0.0,0.0,0.0,3080.0,5000.0,5000.0,139.0,111.0,1043646.0,192.0,84.0,D C,1.0,3.0,1.0,2.0,3.0,1.0,3.0,1.0,1.0,2.0,2.0,5.0,5.0,5.0,5.0,5.0,5.0,14.0,5.0,11.0,13.0,11.0,7.0,12.0,9.0,12.0,11.0,14.0,10.0,12.0,5.0,11.0,12.0,6.0,8.0,5.0,12.0,15.0,15.0,9.0,9.0,17.0,16.0,20.0,14.0,11.0,7.0,13.0,16.0,12.0,11.0,12.0,8.0,8.0,10.0,12.0,13.0,9.0,15.0,10.0,9.0,8.0,Osmar,ÃÂÃÂ£90Th. ,LaLiga
19/6/2011,NicolÃÂ¡s Otamendi,14004589,1649,2/12/1988,23,11,0,0,0,6000,7000,7350,170,147,2371542,178,75,D C,1,1,2,2,1,3,3,5,2,3,2,5,6,7,7,11,5,14,5,7,16,11,9,16,10,16,16,16,13,15,8,14,18,6,11,8,15,16,15,14,14,12,12,7,14,13,20,16,13,16,8,17,3,8,14,14,16,19,16,13,12,9,20,1,1,1,13,1,20,D C,101,1,1,1,1,1,1,20,1,13,7,1,1,1,1,1,137439000000.0,0,0,0,0,0,0,0,0,0,0,0,0,0,0,0,1,0,0,0,0,0,0,0,0,0,0,0,0,0,0,0,0,0,0,0,0,0,1,0,0,0,0,0,0,0,0,0,0,NicolÃÂ¡s Otamendi,ÃÂ£8.55m ,32.0,183.0,Defender - Centre-Back,right,SL Benfica,34.0,6.0,1.0,2852.0,30.0,2.0,0.0,2607.0,43.0,1.0,2.0,3824.0,32.0,1.0,3.0,2880.0,38.0,6.0,0.0,3362.0,49.0,1.0,0.0,4268.0,43.0,1.0,3.0,3792.0,46.0,5.0,0.0,4048.0,33.0,1.0,1.0,2478.0,Liga NOS,39.0,3.0,0.0,2910.0,3.0,0.0,0.0,270.0,29/6/2010,NicolÃÂ¡s Otamendi,14004589.0,1649.0,2/12/1988,22.0,10.0,0.0,0.0,0.0,5256.0,7000.0,7000.0,177.0,145.0,48209291.0,178.0,75.0,D C,3.0,1.0,3.0,2.0,1.0,2.0,1.0,7.0,1.0,2.0,2.0,2.0,4.0,7.0,2.0,4.0,3.0,15.0,3.0,5.0,17.0,10.0,2.0,18.0,10.0,16.0,19.0,18.0,14.0,10.0,5.0,13.0,18.0,4.0,10.0,9.0,15.0,17.0,16.0,15.0,17.0,13.0,11.0,7.0,13.0,13.0,20.0,17.0,15.0,14.0,8.0,17.0,3.0,3.0,14.0,14.0,16.0,19.0,16.0,13.0,12.0,9.0,NicolÃÂÃÂ¡s Otamendi,ÃÂÃÂ£6.30m ,Liga NOS
19/6/2011,Neto,55002114,788,5/26/1988,23,0,0,0,0,1588,5026,5012,125,101,127351,185,74,D C,1,2,3,1,3,1,2,1,3,2,2,7,7,8,9,11,8,12,8,9,12,10,12,11,11,11,13,11,12,11,10,11,12,6,10,10,12,13,11,11,11,12,13,8,11,11,20,11,11,12,7,11,7,7,5,15,14,12,13,14,14,6,20,1,1,1,10,1,20,D C,101,1,1,1,1,1,1,20,1,10,8,1,1,1,1,1,0.0,0,0,0,0,0,0,0,0,0,0,0,0,0,0,0,0,0,0,0,0,0,0,0,0,0,0,0,0,0,0,0,0,0,0,0,0,0,0,0,0,0,0,0,0,0,0,0,0,Neto,ÃÂ£2.25m ,31.0,190.0,Goalkeeper,right,FC Barcelona,0.0,0.0,0.0,0.0,4.0,6.0,1.0,360.0,10.0,10.0,4.0,930.0,49.0,51.0,16.0,4410.0,38.0,46.0,13.0,3420.0,8.0,6.0,5.0,780.0,14.0,9.0,8.0,1214.0,33.0,33.0,10.0,2970.0,47.0,49.0,14.0,4230.0,Serie A,5.0,7.0,1.0,450.0,6.0,6.0,2.0,540.0,nan,nan,nan,nan,nan,nan,nan,nan,nan,nan,nan,nan,nan,nan,nan,nan,nan,nan,nan,nan,nan,nan,nan,nan,nan,nan,nan,nan,nan,nan,nan,nan,nan,nan,nan,nan,nan,nan,nan,nan,nan,nan,nan,nan,nan,nan,nan,nan,nan,nan,nan,nan,nan,nan,nan,nan,nan,nan,nan,nan,nan,nan,nan,nan,nan,nan,nan,nan,nan,nan,nan,nan,nan,nan,nan,nan,nan,nan,nan,nan,nan,nan,nan,nan
19/6/2011,Nenad Tomovic,5768029,802,8/30/1987,23,5,0,20,1,4750,6106,6550,147,131,287378,184,74,D RC,2,2,1,3,3,2,1,4,1,3,3,8,12,10,8,14,11,12,9,10,14,14,13,14,13,16,10,12,16,11,11,13,13,13,11,14,13,14,16,14,13,13,12,5,15,15,20,13,15,13,9,13,7,16,13,15,15,14,11,11,13,6,20,15,15,1,20,9,18,D RC,103,1,1,1,1,1,1,18,9,20,1,1,1,15,1,15,8796090000000.0,0,0,0,0,0,1,0,0,0,0,0,0,0,0,0,0,0,0,0,0,0,0,0,0,0,0,0,0,0,0,0,0,0,0,0,0,0,0,0,0,0,0,0,1,0,0,0,0,Nenad TomoviÃÂ,ÃÂ£1.17m ,33.0,184.0,Defender - Centre-Back,right,SPAL,19.0,0.0,0.0,1770.0,34.0,1.0,0.0,2978.0,30.0,0.0,1.0,2470.0,35.0,0.0,1.0,2779.0,37.0,1.0,2.0,3006.0,33.0,0.0,0.0,2380.0,35.0,0.0,1.0,2559.0,29.0,0.0,0.0,2437.0,11.0,1.0,0.0,831.0,Serie A,25.0,0.0,1.0,1911.0,5.0,0.0,1.0,434.0,29/6/2010,Nenad Tomovic,5768029.0,802.0,8/30/1987,22.0,2.0,0.0,20.0,1.0,4250.0,6050.0,6150.0,158.0,133.0,6207536.0,184.0,74.0,D RC,2.0,3.0,3.0,2.0,3.0,1.0,2.0,2.0,3.0,3.0,3.0,8.0,12.0,10.0,8.0,15.0,11.0,10.0,9.0,10.0,14.0,14.0,13.0,14.0,14.0,16.0,10.0,12.0,16.0,11.0,11.0,13.0,13.0,13.0,11.0,14.0,13.0,14.0,16.0,14.0,13.0,13.0,12.0,5.0,15.0,14.0,20.0,13.0,14.0,11.0,9.0,13.0,7.0,15.0,12.0,15.0,13.0,14.0,11.0,11.0,13.0,6.0,Nenad TomoviÃÂÃÂ,ÃÂÃÂ£1.62m ,Serie A,19-06-17,18.3.4.28,Nenad Tomovic,5768029,802,30-Aug-87,29,22,0,9,1,5100,6350,6700,145,134,15509107,184,79,D/WB RC,3,2,3,2,1,3,2,3,1,1,2,6,11,10,8,12,7,13,8,12,14,12,8,13,11,16,12,15,13,10,11,13,14,10,11,10,15,15,14,14,13,13,11,9,15,14,20,14,15,14,14,13,7,13,13,13,14,12,13,12,15,6,20,17,5,1,19,10,20,D/WB RC,113,1,1,1,1,1,1,20,10,19,1,1,1,5,1,17,0.0,0,0,0,0,0,0,0,0,0,0,0,0,0,0,0,0,0,0,0,0,0,0,0,0,0,0,0,0,0,0,0,0,0,0,0,0,0,0,0,0,0,0,0,0,0,0,0,0,Nenad TomoviÃÂ,ÃÂ£1.35m ,33.0,184.0,Defender - Centre-Back,right,SPAL,35.0,0.0,1.0,2559.0,29.0,0.0,0.0,2437.0,11.0,1.0,0.0,831.0,25.0,0.0,1.0,1911.0,6.0,0.0,1.0,524.0,Serie A,15-07-16,17.3.2.23,Nenad Tomovic,5768029.0,802.0,30-Aug-87,28.0,22.0,0.0,9.0,1.0,5250.0,6600.0,6800.0,145.0,135.0,15401695.0,184.0,79.0,D RC,2.0,1.0,1.0,4.0,2.0,3.0,3.0,2.0,1.0,1.0,3.0,6.0,12.0,11.0,8.0,13.0,7.0,13.0,8.0,12.0,14.0,12.0,8.0,13.0,12.0,15.0,14.0,15.0,15.0,13.0,11.0,13.0,14.0,10.0,11.0,10.0,15.0,15.0,15.0,14.0,13.0,14.0,12.0,9.0,15.0,14.0,20.0,15.0,15.0,14.0,13.0,13.0,7.0,13.0,13.0,14.0,15.0,14.0,13.0,11.0,13.0,6.0,Nenad TomoviÃÂ,ÃÂ£2.97m ,Serie A
19/6/2011,Nemanja Pejcinovic,5779333,802,11/4/1987,23,1,0,10,0,4929,6209,6186,150,138,613765,184,71,D LC,1,2,1,1,1,3,1,1,1,2,1,5,12,9,6,11,6,15,8,10,15,11,9,14,11,13,14,16,12,12,10,11,15,8,12,7,14,13,12,15,11,14,13,15,15,12,20,14,13,14,13,11,8,9,15,15,13,14,14,13,13,6,20,1,1,1,12,15,20,D LC,104,1,1,1,1,1,1,20,15,12,1,1,1,1,1,1,137439000000.0,0,0,0,0,0,0,0,0,0,0,0,0,0,0,0,0,0,0,0,0,0,0,0,0,0,0,0,0,0,0,0,0,0,0,0,0,0,1,0,0,0,0,0,0,0,0,0,0,Nemanja Pejcinovic,ÃÂ£1.80m ,32.0,185.0,Defender - Centre-Back,right,Fakel Voronezh,38.0,1.0,2.0,3462.0,26.0,1.0,0.0,2172.0,31.0,3.0,2.0,2756.0,16.0,2.0,0.0,1346.0,19.0,0.0,1.0,1505.0,28.0,1.0,4.0,2446.0,32.0,2.0,1.0,2732.0,48.0,2.0,2.0,4091.0,nan,nan,nan,nan,Ligue 1,6.0,0.0,0.0,402.0,4.0,0.0,0.0,276.0,29/6/2010,Nemanja Pejcinovic,5779333.0,802.0,11/4/1987,22.0,1.0,0.0,10.0,0.0,3481.0,5400.0,5400.0,148.0,118.0,525016.0,185.0,84.0,D LC,3.0,2.0,3.0,3.0,1.0,2.0,1.0,3.0,1.0,1.0,1.0,10.0,14.0,10.0,9.0,11.0,6.0,16.0,8.0,12.0,16.0,9.0,11.0,17.0,9.0,16.0,8.0,17.0,11.0,11.0,11.0,4.0,12.0,10.0,12.0,10.0,11.0,10.0,10.0,12.0,11.0,10.0,14.0,15.0,14.0,12.0,20.0,14.0,13.0,15.0,9.0,11.0,8.0,9.0,14.0,15.0,13.0,14.0,14.0,12.0,13.0,6.0,Nemanja Pejcinovic,ÃÂÃÂ£1.44m ,Ligue 1
19/6/2011,Michael Mancienne,5006675,765,1/8/1988,23,0,0,30,1,4750,6000,6350,150,126,952813,184,74,D C,3,1,2,1,1,2,3,3,2,1,3,3,8,9,5,13,3,12,5,8,14,11,4,15,13,10,15,10,14,11,7,13,13,6,10,6,13,12,10,15,14,10,13,10,15,17,20,14,10,14,8,14,8,15,14,17,15,14,15,14,13,7,20,1,12,1,14,10,20,D C,101,1,10,1,1,1,1,20,10,14,14,12,1,1,1,1,274878000000.0,0,0,0,0,0,0,1,0,0,0,0,0,0,0,0,1,0,0,0,0,0,0,0,0,0,0,0,0,0,0,0,0,0,0,0,0,0,0,1,0,0,0,0,0,0,0,0,0,Michael Mancienne,ÃÂ£2.03m ,32.0,184.0,Defender - Centre-Back,right,New England Revolution,20.0,0.0,0.0,1462.0,18.0,0.0,0.0,1425.0,22.0,0.0,0.0,1847.0,17.0,0.0,0.0,1502.0,39.0,0.0,2.0,3333.0,33.0,0.0,0.0,2714.0,30.0,0.0,1.0,2407.0,43.0,0.0,0.0,3723.0,16.0,1.0,0.0,1189.0,Bundesliga,5.0,0.0,0.0,316.0,nan,nan,nan,nan,29/6/2010,Michael Mancienne,5006675.0,765.0,1/8/1988,22.0,0.0,0.0,21.0,1.0,3969.0,6000.0,6000.0,160.0,126.0,3027181.0,184.0,80.0,D RC,2.0,3.0,1.0,3.0,1.0,1.0,2.0,1.0,1.0,1.0,3.0,1.0,8.0,12.0,6.0,13.0,3.0,13.0,6.0,8.0,14.0,11.0,4.0,13.0,12.0,10.0,14.0,10.0,14.0,11.0,9.0,12.0,13.0,8.0,10.0,8.0,14.0,12.0,11.0,14.0,14.0,12.0,13.0,10.0,15.0,15.0,20.0,14.0,10.0,14.0,8.0,14.0,8.0,8.0,14.0,17.0,15.0,14.0,15.0,14.0,13.0,7.0,Michael Mancienne,ÃÂÃÂ£3.15m ,Premier League
19/6/2011,Matthias Jaissle,35015818,771,4/5/1988,23,0,0,1,0,4250,6400,6400,143,121,348441,186,83,D LC,2,1,2,3,1,1,1,8,2,1,3,5,7,6,7,11,6,11,6,10,14,8,7,14,11,9,16,9,16,14,9,10,12,5,10,7,15,15,10,13,10,13,15,8,5,13,20,12,13,12,5,12,17,13,7,13,12,10,15,14,16,6,20,1,1,1,12,15,20,D LC,104,1,1,1,1,1,1,20,15,12,12,1,1,1,1,1,0.0,0,0,0,0,0,0,0,0,0,0,0,0,0,0,0,0,0,0,0,0,0,0,0,0,0,0,0,0,0,0,0,0,0,0,0,0,0,0,0,0,0,0,0,0,0,0,0,0,Matthias Jaissle,ÃÂ£270Th. ,32.0,186.0,Defender - Centre-Back,right,Retired,15.0,0.0,0.0,758.0,nan,nan,nan,nan,4.0,0.0,0.0,55.0,nan,nan,nan,nan,nan,nan,nan,nan,nan,nan,nan,nan,nan,nan,nan,nan,nan,nan,nan,nan,nan,nan,nan,nan,Bundesliga,nan,nan,nan,nan,nan,nan,nan,nan,29/6/2010,Matthias Jaissle,35015818.0,771.0,4/5/1988,22.0,0.0,0.0,1.0,0.0,3400.0,6800.0,6800.0,148.0,126.0,1920346.0,186.0,83.0,D LC,1.0,3.0,3.0,2.0,1.0,1.0,1.0,1.0,1.0,1.0,1.0,5.0,7.0,6.0,7.0,12.0,6.0,11.0,6.0,10.0,14.0,8.0,7.0,14.0,12.0,9.0,16.0,9.0,16.0,14.0,9.0,10.0,12.0,5.0,10.0,7.0,15.0,15.0,10.0,14.0,11.0,13.0,16.0,8.0,13.0,14.0,20.0,12.0,13.0,12.0,5.0,12.0,7.0,13.0,13.0,13.0,12.0,10.0,15.0,14.0,16.0,6.0,Matthias Jaissle,ÃÂÃÂ£900Th. ,Bundesliga
19/6/2011,Matthew Connolly,5119972,765,9/24/1987,23,0,0,0,0,3500,6000,6000,142,128,595968,189,84,D RLC,3,2,2,3,3,1,1,3,2,2,1,2,9,10,5,12,6,16,8,3,15,14,5,15,13,11,14,14,15,13,9,13,15,7,14,11,17,13,12,10,8,10,15,10,12,11,20,10,13,13,7,10,10,12,16,13,10,12,14,14,16,3,20,1,1,1,15,15,20,D RLC,106,1,1,1,1,1,1,20,15,15,8,1,1,1,1,1,4294967552.0,0,0,0,0,0,0,0,0,1,0,0,0,0,0,0,0,0,0,0,0,0,0,0,0,0,0,0,0,0,0,0,0,1,0,0,0,0,0,0,0,0,0,0,0,0,0,0,0,Matthew Connolly,ÃÂ£1.35m ,33.0,188.0,Defender - Centre-Back,right,Without Club,37.0,0.0,2.0,3060.0,13.0,0.0,1.0,1052.0,36.0,5.0,2.0,3160.0,4.0,0.0,0.0,360.0,32.0,1.0,2.0,2427.0,45.0,1.0,1.0,4025.0,29.0,1.0,1.0,2434.0,5.0,0.0,0.0,450.0,1.0,0.0,0.0,90.0,Premier League,nan,nan,nan,nan,nan,nan,nan,nan,nan,nan,nan,nan,nan,nan,nan,nan,nan,nan,nan,nan,nan,nan,nan,nan,nan,nan,nan,nan,nan,nan,nan,nan,nan,nan,nan,nan,nan,nan,nan,nan,nan,nan,nan,nan,nan,nan,nan,nan,nan,nan,nan,nan,nan,nan,nan,nan,nan,nan,nan,nan,nan,nan,nan,nan,nan,nan,nan,nan,nan,nan,nan,nan,nan,nan,nan,nan,nan,nan,nan,nan,nan,nan,nan,nan,nan,nan,nan,nan,nan,nan,nan,nan
19/6/2011,Marco Rossi,1400704,776,9/30/1987,23,0,0,3,0,4269,5826,5826,143,124,149171,188,78,D C,3,1,3,2,2,2,3,1,2,2,1,5,6,7,4,9,6,15,7,10,14,8,7,13,8,13,13,12,10,13,7,12,12,7,10,7,15,14,14,12,11,15,15,20,15,12,5,14,14,14,10,12,12,10,14,11,16,11,13,12,14,9,20,1,1,1,1,14,20,D C,101,1,1,1,1,1,1,20,14,1,1,1,1,1,1,1,137439000000.0,0,0,0,0,0,0,0,0,0,0,0,0,0,0,0,0,0,0,0,0,0,0,0,0,0,0,0,0,0,0,0,0,0,0,0,0,0,1,0,0,0,0,0,0,0,0,0,0,Marco Rossi,ÃÂ£810Th. ,42.0,179.0,Midfielder - Right Midfield,right,Retired,32.0,2.0,0.0,2812.0,31.0,4.0,2.0,2579.0,15.0,0.0,0.0,818.0,nan,nan,nan,nan,nan,nan,nan,nan,nan,nan,nan,nan,nan,nan,nan,nan,nan,nan,nan,nan,nan,nan,nan,nan,Serie A,nan,nan,nan,nan,nan,nan,nan,nan,29/6/2010,Marco Rossi,1400704.0,776.0,9/30/1987,22.0,0.0,0.0,3.0,0.0,4032.0,6000.0,6000.0,156.0,127.0,770238.0,188.0,78.0,D C,1.0,2.0,2.0,3.0,2.0,1.0,1.0,6.0,2.0,3.0,2.0,5.0,6.0,7.0,4.0,9.0,6.0,15.0,7.0,10.0,14.0,10.0,7.0,13.0,8.0,13.0,12.0,12.0,12.0,15.0,7.0,11.0,12.0,7.0,10.0,9.0,16.0,14.0,14.0,12.0,12.0,16.0,15.0,20.0,15.0,12.0,5.0,16.0,15.0,14.0,10.0,12.0,12.0,10.0,14.0,11.0,16.0,11.0,13.0,12.0,14.0,9.0,Marco Rossi,ÃÂÃÂ£1.44m ,Serie A
19/6/2011,Marc Wilson,5114764,789,8/17/1987,23,1,0,0,0,4417,6275,6650,146,130,1636364,188,80,DM/M RC,2,1,1,2,3,3,1,2,1,1,1,12,15,11,8,13,14,12,8,6,8,14,16,12,12,14,12,12,15,12,14,13,16,10,13,10,12,10,14,11,10,14,14,17,14,12,20,14,13,14,8,11,7,12,14,12,15,10,12,9,9,14,15,8,18,1,15,12,18,DM/M RC,313,1,1,1,1,1,1,15,12,15,20,18,8,8,8,8,149538000000000.0,0,0,0,0,0,0,0,0,0,0,0,0,0,0,0,0,0,0,0,0,0,0,1,0,0,0,0,0,0,0,0,0,1,0,0,0,0,0,0,0,0,0,0,1,0,0,0,1,Marc Wilson,ÃÂ£4.50m ,33.0,188.0,Defender - Centre-Back,both,Retired,41.0,1.0,2.0,2942.0,45.0,0.0,1.0,3801.0,20.0,0.0,0.0,1611.0,38.0,0.0,0.0,3121.0,30.0,0.0,1.0,2394.0,11.0,1.0,0.0,929.0,8.0,1.0,0.0,526.0,22.0,0.0,0.0,1779.0,17.0,0.0,0.0,1267.0,Premier League,nan,nan,nan,nan,nan,nan,nan,nan,29/6/2010,Marc Wilson,5114764.0,789.0,8/17/1987,22.0,0.0,0.0,0.0,0.0,3844.0,6000.0,6350.0,146.0,124.0,10350000.0,188.0,80.0,DM/M C,2.0,3.0,3.0,2.0,1.0,3.0,1.0,1.0,2.0,2.0,3.0,12.0,15.0,11.0,8.0,13.0,14.0,12.0,8.0,6.0,8.0,15.0,16.0,10.0,11.0,14.0,12.0,12.0,15.0,12.0,13.0,13.0,16.0,10.0,13.0,10.0,12.0,9.0,14.0,11.0,10.0,14.0,14.0,17.0,14.0,12.0,20.0,14.0,13.0,12.0,8.0,11.0,7.0,12.0,14.0,12.0,15.0,10.0,12.0,9.0,9.0,14.0,Marc Wilson,ÃÂÃÂ£2.70m ,Premier League
19/6/2011,Larrys Mabiala,8444104,53,10/8/1987,23,8,0,0,0,4700,5850,5250,140,117,212185,189,84,D RC,2,1,2,2,2,3,1,1,1,2,1,6,10,7,6,9,8,15,11,8,13,8,6,14,9,10,14,15,11,11,7,11,14,7,7,7,12,13,14,8,11,16,14,10,10,11,20,15,16,12,10,13,14,8,11,13,14,9,12,15,15,7,20,1,1,1,15,1,20,D RC,103,1,1,5,1,1,1,20,1,15,1,1,1,1,1,1,0.0,0,0,0,0,0,0,0,0,0,0,0,0,0,0,0,0,0,0,0,0,0,0,0,0,0,0,0,0,0,0,0,0,0,0,0,0,0,0,0,0,0,0,0,0,0,0,0,0,Larrys Mabiala,ÃÂ£1.53m ,33.0,189.0,Defender - Centre-Back,right,Portland Timbers,12.0,0.0,0.0,838.0,26.0,2.0,2.0,2294.0,29.0,0.0,0.0,2538.0,32.0,1.0,3.0,2820.0,38.0,0.0,1.0,3510.0,34.0,1.0,0.0,2757.0,47.0,3.0,0.0,4065.0,36.0,5.0,1.0,3122.0,27.0,2.0,0.0,2354.0,Ligue 1,17.0,2.0,0.0,1399.0,nan,nan,nan,nan,29/6/2010,Larrys Mabiala,8444104.0,53.0,10/8/1987,22.0,8.0,0.0,0.0,0.0,3306.0,6000.0,5150.0,140.0,115.0,1563462.0,189.0,84.0,D RC,3.0,2.0,3.0,1.0,1.0,2.0,1.0,5.0,1.0,1.0,3.0,6.0,10.0,7.0,6.0,9.0,8.0,15.0,11.0,8.0,13.0,8.0,6.0,14.0,9.0,10.0,13.0,14.0,11.0,11.0,7.0,11.0,14.0,7.0,7.0,7.0,12.0,13.0,14.0,8.0,11.0,16.0,14.0,10.0,10.0,11.0,20.0,14.0,16.0,12.0,10.0,13.0,14.0,8.0,11.0,13.0,14.0,9.0,12.0,15.0,15.0,7.0,Larrys Mabiala,ÃÂÃÂ£1.17m ,Ligue 1
19/6/2011,KÃÂ©vin Malaga,34008875,769,6/24/1987,23,0,0,0,0,2450,4950,4950,130,111,103034,189,81,D C,3,2,2,3,3,2,2,1,2,2,1,4,5,6,6,8,6,15,7,6,13,9,7,13,8,12,13,14,9,12,5,11,17,5,11,6,12,14,13,11,9,15,14,5,14,10,20,14,16,15,12,13,7,5,13,12,15,14,14,13,13,7,20,1,1,1,1,1,20,D C,101,1,1,1,1,1,1,20,1,1,1,1,1,1,1,1,0.0,0,0,0,0,0,0,0,0,0,0,0,0,0,0,0,0,0,0,0,0,0,0,0,0,0,0,0,0,0,0,0,0,0,0,0,0,0,0,0,0,0,0,0,0,0,0,0,0,KÃÂ©vin Malaga,ÃÂ£135Th. ,33.0,189.0,Defender - Centre-Back,right,C'Chartres Football,1.0,0.0,0.0,44.0,1.0,0.0,0.0,29.0,7.0,0.0,0.0,630.0,nan,nan,nan,nan,nan,nan,nan,nan,nan,nan,nan,nan,29.0,0.0,0.0,2418.0,28.0,0.0,0.0,2462.0,31.0,0.0,1.0,2708.0,Ligue 1,7.0,0.0,0.0,630.0,9.0,2.0,0.0,810.0,nan,nan,nan,nan,nan,nan,nan,nan,nan,nan,nan,nan,nan,nan,nan,nan,nan,nan,nan,nan,nan,nan,nan,nan,nan,nan,nan,nan,nan,nan,nan,nan,nan,nan,nan,nan,nan,nan,nan,nan,nan,nan,nan,nan,nan,nan,nan,nan,nan,nan,nan,nan,nan,nan,nan,nan,nan,nan,nan,nan,nan,nan,nan,nan,nan,nan,nan,nan,nan,nan,nan,nan,nan,nan,nan,nan,nan,nan,nan,nan,nan,nan,nan,nan
19/6/2011,Juan ForlÃÂ­n,962963,1649,1/10/1988,23,0,0,11,0,4800,6264,6750,150,136,1118009,180,72,D/DM C,2,1,2,1,2,1,1,4,2,3,3,4,9,8,8,13,8,14,9,10,14,13,12,15,14,17,12,16,14,13,12,11,17,8,12,8,15,14,14,15,14,14,12,6,8,14,20,15,13,13,15,13,13,12,14,15,14,16,14,14,13,11,20,1,11,1,1,1,20,D/DM C,111,1,14,1,1,1,1,20,1,1,18,11,1,1,1,1,0.0,0,0,0,0,0,0,0,0,0,0,0,0,0,0,0,0,0,0,0,0,0,0,0,0,0,0,0,0,0,0,0,0,0,0,0,0,0,0,0,0,0,0,0,0,0,0,0,0,Juan ForlÃÂ­n,ÃÂ£3.60m ,32.0,180.0,Defender - Centre-Back,right,JÃÂºbilo Iwata,25.0,0.0,0.0,2055.0,33.0,0.0,1.0,2691.0,35.0,0.0,1.0,2947.0,31.0,1.0,0.0,2741.0,5.0,0.0,0.0,404.0,24.0,1.0,0.0,2011.0,25.0,1.0,1.0,2225.0,34.0,2.0,1.0,2828.0,14.0,0.0,1.0,1147.0,LaLiga,0.0,0.0,0.0,0.0,nan,nan,nan,nan,29/6/2010,Juan ForlÃÂ­n,962963.0,1649.0,1/10/1988,22.0,0.0,0.0,11.0,0.0,4500.0,6250.0,6750.0,160.0,136.0,8000000.0,180.0,72.0,D/DM C,3.0,3.0,2.0,1.0,3.0,2.0,1.0,6.0,3.0,3.0,2.0,4.0,9.0,8.0,8.0,12.0,8.0,14.0,9.0,10.0,14.0,13.0,12.0,15.0,14.0,14.0,12.0,15.0,14.0,13.0,12.0,11.0,17.0,8.0,12.0,8.0,15.0,14.0,14.0,15.0,14.0,13.0,12.0,6.0,12.0,14.0,20.0,16.0,13.0,13.0,10.0,13.0,12.0,11.0,14.0,15.0,14.0,16.0,14.0,14.0,13.0,11.0,Juan ForlÃÂÃÂ­n,ÃÂÃÂ£3.15m ,LaLiga
19/6/2011,JosÃÂ© PicÃÂ³n,67053078,796,3/13/1988,23,0,0,0,0,2045,4634,4315,135,103,80551,182,74,D RC,2,2,1,1,3,1,2,2,1,3,3,3,5,4,4,7,4,13,3,10,13,8,6,11,7,12,11,12,11,13,5,12,13,8,9,7,12,11,12,13,13,13,12,6,13,13,20,13,13,11,12,10,7,10,13,13,13,11,15,9,9,9,20,5,1,1,20,2,18,D RC,103,1,1,1,1,1,1,18,2,20,1,1,1,1,1,5,0.0,0,0,0,0,0,0,0,0,0,0,0,0,0,0,0,0,0,0,0,0,0,0,0,0,0,0,0,0,0,0,0,0,0,0,0,0,0,0,0,0,0,0,0,0,0,0,0,0,JosÃÂ© PicÃÂ³n,ÃÂ£180Th. ,32.0,184.0,Defender - Centre-Back,right,Barakaldo CF,25.0,0.0,0.0,1938.0,5.0,0.0,0.0,286.0,7.0,0.0,0.0,577.0,23.0,1.0,0.0,1962.0,23.0,0.0,0.0,1818.0,24.0,1.0,0.0,2022.0,29.0,3.0,0.0,2279.0,26.0,0.0,0.0,2172.0,32.0,1.0,0.0,2860.0,LaLiga,3.0,0.0,0.0,225.0,0.0,0.0,0.0,0.0,nan,nan,nan,nan,nan,nan,nan,nan,nan,nan,nan,nan,nan,nan,nan,nan,nan,nan,nan,nan,nan,nan,nan,nan,nan,nan,nan,nan,nan,nan,nan,nan,nan,nan,nan,nan,nan,nan,nan,nan,nan,nan,nan,nan,nan,nan,nan,nan,nan,nan,nan,nan,nan,nan,nan,nan,nan,nan,nan,nan,nan,nan,nan,nan,nan,nan,nan,nan,nan,nan,nan,nan,nan,nan,nan,nan,nan,nan,nan,nan,nan,nan,nan,nan
19/6/2011,Jonny Evans,5005078,785,1/3/1988,23,26,1,3,0,5775,7516,7115,166,145,1949962,188,78,D C,3,1,3,3,1,3,1,1,1,1,3,4,5,7,4,14,4,16,3,9,14,13,5,15,13,12,16,12,12,14,8,12,15,3,12,6,15,15,14,14,14,14,15,14,15,12,20,14,14,16,8,14,3,10,8,14,16,14,17,16,18,6,20,1,1,1,11,14,20,D C,101,1,1,1,1,1,1,20,14,11,1,1,1,1,1,1,274878000000.0,0,0,0,0,0,0,0,0,0,0,0,0,0,0,0,0,0,0,0,0,0,0,0,0,0,0,0,0,0,0,0,0,0,0,0,0,0,0,1,0,0,0,0,0,0,0,0,0,Jonny Evans,ÃÂ£8.55m ,32.0,188.0,Defender - Centre-Back,both,Leicester City,21.0,0.0,0.0,1626.0,40.0,1.0,3.0,3222.0,31.0,4.0,2.0,2580.0,27.0,2.0,0.0,2253.0,19.0,0.0,0.0,1495.0,34.0,1.0,2.0,2953.0,31.0,2.0,1.0,2638.0,31.0,2.0,1.0,2542.0,28.0,1.0,0.0,2355.0,Premier League,46.0,2.0,2.0,4049.0,5.0,0.0,0.0,432.0,29/6/2010,Jonny Evans,5005078.0,785.0,1/3/1988,22.0,20.0,1.0,3.0,0.0,5700.0,7500.0,7500.0,174.0,151.0,20739481.0,188.0,78.0,D C,1.0,1.0,2.0,3.0,3.0,1.0,1.0,2.0,1.0,1.0,2.0,4.0,5.0,7.0,4.0,14.0,4.0,16.0,3.0,9.0,14.0,13.0,5.0,15.0,13.0,12.0,16.0,13.0,13.0,15.0,8.0,14.0,15.0,3.0,12.0,6.0,15.0,15.0,14.0,14.0,14.0,14.0,15.0,14.0,15.0,12.0,20.0,14.0,14.0,16.0,3.0,14.0,3.0,10.0,13.0,14.0,16.0,15.0,17.0,16.0,18.0,6.0,Jonny Evans,ÃÂÃÂ£8.10m ,Premier League
19/6/2011,HÃÂ©ctor Rodas,67010170,796,3/7/1988,23,0,0,0,0,3750,6050,6050,140,120,230219,190,80,D C,1,3,3,1,2,2,2,2,1,2,3,6,7,7,7,9,7,14,8,8,13,9,9,14,9,14,13,14,11,13,8,11,13,9,9,7,12,15,14,12,10,14,15,6,14,13,20,14,14,15,12,14,7,8,14,15,17,12,16,13,12,6,20,1,1,1,5,1,20,D C,101,1,8,1,1,1,1,20,1,5,1,1,1,1,1,1,0.0,0,0,0,0,0,0,0,0,0,0,0,0,0,0,0,0,0,0,0,0,0,0,0,0,0,0,0,0,0,0,0,0,0,0,0,0,0,0,0,0,0,0,0,0,0,0,0,0,HÃÂ©ctor Rodas,ÃÂ£360Th. ,32.0,191.0,Defender - Centre-Back,right,Cultural Leonesa,6.0,0.0,0.0,499.0,16.0,2.0,0.0,1342.0,21.0,0.0,0.0,1460.0,17.0,0.0,0.0,1234.0,15.0,0.0,0.0,1121.0,35.0,0.0,1.0,3084.0,31.0,2.0,1.0,2464.0,5.0,2.0,0.0,450.0,14.0,0.0,0.0,622.0,LaLiga,26.0,2.0,0.0,2365.0,1.0,0.0,0.0,90.0,29/6/2010,HÃÂ©ctor Rodas,67010170.0,796.0,3/7/1988,22.0,0.0,0.0,0.0,0.0,3721.0,5600.0,5600.0,142.0,122.0,1440191.0,190.0,80.0,D C,2.0,2.0,1.0,1.0,1.0,1.0,3.0,1.0,3.0,1.0,3.0,5.0,6.0,7.0,6.0,8.0,7.0,14.0,8.0,7.0,13.0,9.0,8.0,14.0,8.0,14.0,15.0,16.0,13.0,13.0,8.0,11.0,13.0,9.0,12.0,8.0,13.0,14.0,13.0,11.0,10.0,13.0,15.0,4.0,14.0,12.0,20.0,14.0,13.0,15.0,12.0,14.0,6.0,8.0,14.0,15.0,16.0,12.0,15.0,13.0,12.0,12.0,HÃÂÃÂ©ctor Rodas,ÃÂÃÂ£720Th. ,LaLiga
19/6/2011,HÃÂ©ctor Moreno,51000042,379,1/17/1988,23,12,0,3,1,5500,7315,6750,155,133,1412490,182,80,D C,1,3,3,2,2,1,1,6,3,1,3,8,7,7,5,11,8,14,7,11,14,10,6,14,11,16,13,14,14,14,10,13,13,14,10,7,14,14,17,12,11,17,11,20,17,11,10,15,15,15,10,16,5,10,6,14,9,12,15,8,11,5,20,7,1,1,5,11,20,D C,101,1,1,1,1,1,1,20,11,5,10,1,1,1,7,1,8796090000000.0,0,0,0,0,0,0,0,0,0,0,0,0,0,0,0,0,0,0,0,0,0,0,0,0,0,0,0,0,0,0,0,0,0,0,0,0,0,0,0,0,0,0,0,1,0,0,0,0,HÃÂ©ctor Moreno,ÃÂ£5.40m ,32.0,184.0,Defender - Centre-Back,left,Al-Gharafa SC,35.0,1.0,2.0,3008.0,40.0,3.0,1.0,3564.0,33.0,2.0,2.0,2860.0,37.0,1.0,2.0,3166.0,26.0,1.0,1.0,2208.0,41.0,6.0,1.0,3691.0,39.0,7.0,1.0,3461.0,15.0,1.0,0.0,1113.0,29.0,1.0,1.0,2205.0,LaLiga,21.0,1.0,2.0,1791.0,3.0,0.0,0.0,270.0,nan,nan,nan,nan,nan,nan,nan,nan,nan,nan,nan,nan,nan,nan,nan,nan,nan,nan,nan,nan,nan,nan,nan,nan,nan,nan,nan,nan,nan,nan,nan,nan,nan,nan,nan,nan,nan,nan,nan,nan,nan,nan,nan,nan,nan,nan,nan,nan,nan,nan,nan,nan,nan,nan,nan,nan,nan,nan,nan,nan,nan,nan,nan,nan,nan,nan,nan,nan,nan,nan,nan,nan,nan,nan,nan,nan,nan,nan,nan,nan,nan,nan,nan,nan,19-06-17,18.3.4.28,HÃÂ©ctor Moreno,51000042,379,17-Jan-88,29,80,3,3,1,6250,7200,6800,148,136,10392346,182,80,D C,2,1,1,3,1,4,1,3,2,3,3,8,7,9,5,13,10,15,9,11,15,13,6,14,13,15,13,14,14,14,13,14,13,14,13,7,15,16,15,12,10,14,11,20,14,12,10,15,13,15,12,16,6,10,14,14,15,12,15,8,11,7,20,9,7,1,9,13,20,D C,101,1,1,1,1,1,1,20,13,9,10,7,1,1,9,6,8800390000000.0,0,0,0,0,0,0,0,0,0,0,0,0,0,0,0,0,0,0,0,0,0,0,0,0,0,0,0,0,0,0,0,0,1,0,0,0,0,0,0,0,0,0,0,1,0,0,0,0,HÃÂ©ctor Moreno,ÃÂ£3.60m ,32.0,184.0,Defender - Centre-Back,left,Al-Gharafa SC,39.0,7.0,1.0,3461.0,15.0,1.0,0.0,1113.0,29.0,1.0,1.0,2205.0,21.0,1.0,2.0,1791.0,4.0,0.0,0.0,360.0,Serie A,nan,nan,nan,nan,nan,nan,nan,nan,nan,nan,nan,nan,nan,nan,nan,nan,nan,nan,nan,nan,nan,nan,nan,nan,nan,nan,nan,nan,nan,nan,nan,nan,nan,nan,nan,nan,nan,nan,nan,nan,nan,nan,nan,nan,nan,nan,nan,nan,nan,nan,nan,nan,nan,nan,nan,nan,nan,nan,nan,nan,nan,nan,nan,nan,nan,nan,nan,nan,nan,nan,nan,nan,nan,nan,nan,nan,nan,nan,nan,nan,nan,nan,nan,nan,nan
19/6/2011,Gary Medel,75000560,1652,8/3/1987,23,31,3,0,0,5800,7250,7000,160,144,1441490,172,71,D/WB/DM/M RC,2,3,1,2,2,2,3,5,3,1,1,8,10,9,13,10,6,15,13,13,16,12,4,17,11,17,16,19,6,14,11,12,14,12,13,10,15,14,19,13,14,14,8,9,17,13,20,18,11,14,12,16,4,18,13,15,16,12,12,9,7,14,17,16,17,1,17,1,17,D/WB/DM/M RC,343,1,1,1,1,1,1,17,1,16,20,16,1,17,1,16,33088.0,0,0,0,0,0,0,1,0,1,0,0,0,0,0,0,1,0,0,0,0,0,0,0,0,0,0,0,0,0,0,0,0,0,0,0,0,0,0,0,0,0,0,0,0,0,0,0,0,Gary Medel,ÃÂ£5.40m ,33.0,171.0,Midfielder - Defensive Midfield,right,Bologna FC 1909,35.0,0.0,0.0,2866.0,37.0,2.0,0.0,3071.0,39.0,7.0,3.0,3226.0,35.0,0.0,1.0,2918.0,44.0,0.0,3.0,3739.0,34.0,1.0,3.0,2790.0,31.0,0.0,0.0,2576.0,40.0,1.0,2.0,3043.0,35.0,0.0,0.0,2826.0,LaLiga,26.0,0.0,0.0,2015.0,2.0,0.0,1.0,45.0,nan,nan,nan,nan,nan,nan,nan,nan,nan,nan,nan,nan,nan,nan,nan,nan,nan,nan,nan,nan,nan,nan,nan,nan,nan,nan,nan,nan,nan,nan,nan,nan,nan,nan,nan,nan,nan,nan,nan,nan,nan,nan,nan,nan,nan,nan,nan,nan,nan,nan,nan,nan,nan,nan,nan,nan,nan,nan,nan,nan,nan,nan,nan,nan,nan,nan,nan,nan,nan,nan,nan,nan,nan,nan,nan,nan,nan,nan,nan,nan,nan,nan,nan,nan
19/6/2011,Garry Bocaly,8439529,769,4/19/1988,23,0,0,14,0,4700,5900,5900,155,132,493470,180,74,D/WB RC,2,3,1,1,1,2,3,1,3,2,1,12,11,11,7,11,7,13,10,10,12,9,7,15,12,14,13,14,12,13,10,13,16,8,10,12,12,12,15,15,13,14,10,5,15,14,20,15,14,15,12,14,6,10,14,16,14,14,14,14,14,6,20,18,10,1,20,8,16,D/WB RC,113,1,1,1,1,1,1,16,8,20,12,8,1,10,8,18,32.0,0,0,0,0,0,1,0,0,0,0,0,0,0,0,0,0,0,0,0,0,0,0,0,0,0,0,0,0,0,0,0,0,0,0,0,0,0,0,0,0,0,0,0,0,0,0,0,0,Garry Bocaly,ÃÂ£4.50m ,32.0,180.0,Defender - Right-Back,right,L'Aiglon du Lamentin,31.0,3.0,0.0,2650.0,37.0,0.0,4.0,3232.0,10.0,0.0,0.0,800.0,3.0,0.0,0.0,234.0,14.0,0.0,0.0,1056.0,nan,nan,nan,nan,nan,nan,nan,nan,nan,nan,nan,nan,1.0,0.0,0.0,5.0,Ligue 1,nan,nan,nan,nan,nan,nan,nan,nan,29/6/2010,Garry Bocaly,8439529.0,769.0,4/19/1988,22.0,0.0,0.0,14.0,0.0,4356.0,5900.0,5900.0,155.0,132.0,1840000.0,180.0,74.0,D/WB RC,2.0,2.0,1.0,3.0,1.0,1.0,2.0,2.0,2.0,3.0,1.0,12.0,11.0,11.0,7.0,11.0,7.0,13.0,10.0,10.0,12.0,9.0,7.0,15.0,12.0,14.0,13.0,14.0,12.0,13.0,10.0,13.0,16.0,8.0,10.0,12.0,12.0,12.0,15.0,15.0,13.0,14.0,10.0,5.0,15.0,14.0,20.0,15.0,14.0,15.0,12.0,14.0,6.0,10.0,9.0,16.0,14.0,14.0,14.0,14.0,14.0,6.0,Garry Bocaly,ÃÂÃÂ£3.15m ,Ligue 1
19/6/2011,Francesco Acerbi,43017499,776,2/10/1988,23,0,0,0,0,3032,6182,6182,147,126,221798,185,77,D C,2,1,2,3,1,2,3,3,2,1,3,6,6,8,8,8,5,14,8,8,15,11,4,15,11,10,12,12,9,14,10,14,11,14,13,6,14,12,14,12,12,14,14,5,14,12,20,12,12,15,9,14,14,7,7,15,15,10,14,12,10,9,20,1,1,1,1,1,20,D C,101,1,1,1,1,1,1,20,1,1,1,1,1,1,1,1,0.0,0,0,0,0,0,0,0,0,0,0,0,0,0,0,0,0,0,0,0,0,0,0,0,0,0,0,0,0,0,0,0,0,0,0,0,0,0,0,0,0,0,0,0,0,0,0,0,0,Francesco Acerbi,ÃÂ£4.05m ,32.0,192.0,Defender - Centre-Back,left,SS Lazio,43.0,2.0,0.0,3724.0,22.0,1.0,0.0,1790.0,17.0,0.0,0.0,1208.0,13.0,0.0,0.0,1083.0,32.0,3.0,0.0,2878.0,38.0,4.0,0.0,3420.0,49.0,4.0,0.0,4410.0,41.0,0.0,1.0,3690.0,50.0,3.0,0.0,4510.0,Serie A,45.0,2.0,2.0,3976.0,6.0,0.0,1.0,540.0,nan,nan,nan,nan,nan,nan,nan,nan,nan,nan,nan,nan,nan,nan,nan,nan,nan,nan,nan,nan,nan,nan,nan,nan,nan,nan,nan,nan,nan,nan,nan,nan,nan,nan,nan,nan,nan,nan,nan,nan,nan,nan,nan,nan,nan,nan,nan,nan,nan,nan,nan,nan,nan,nan,nan,nan,nan,nan,nan,nan,nan,nan,nan,nan,nan,nan,nan,nan,nan,nan,nan,nan,nan,nan,nan,nan,nan,nan,nan,nan,nan,nan,nan,nan,19-06-17,18.3.4.28,Francesco Acerbi,43017499,776,10-Feb-88,29,2,0,0,0,4750,6900,7100,148,142,29277190,192,88,D C,2,1,1,3,3,4,3,1,1,3,2,6,6,9,6,11,4,15,8,6,16,12,4,15,11,12,16,14,12,15,11,14,18,10,13,7,16,14,14,9,8,15,16,20,14,12,10,15,17,14,9,15,12,7,10,15,15,12,14,12,10,2,20,1,1,1,1,1,20,D C,101,1,1,1,1,1,1,20,1,1,1,1,1,1,1,1,275952000000.0,0,0,0,0,0,0,0,0,0,0,0,0,0,0,0,0,0,0,0,0,0,0,0,0,0,0,0,0,0,0,1,0,0,0,0,0,0,0,1,0,0,0,0,0,0,0,0,0,Francesco Acerbi,ÃÂ£9.00m ,32.0,192.0,Defender - Centre-Back,left,SS Lazio,49.0,4.0,0.0,4410.0,41.0,0.0,1.0,3690.0,50.0,3.0,0.0,4510.0,45.0,2.0,2.0,3976.0,6.0,0.0,1.0,540.0,Serie A,15-07-16,17.3.2.23,Francesco Acerbi,43017499.0,776.0,10-Feb-88,28.0,2.0,0.0,0.0,0.0,4495.0,6995.0,7295.0,149.0,146.0,25696896.0,192.0,89.0,D C,2.0,1.0,2.0,2.0,3.0,3.0,1.0,2.0,3.0,1.0,3.0,6.0,6.0,10.0,6.0,11.0,4.0,14.0,9.0,8.0,16.0,12.0,4.0,15.0,12.0,12.0,17.0,14.0,12.0,16.0,12.0,14.0,18.0,10.0,13.0,7.0,15.0,14.0,14.0,10.0,10.0,15.0,16.0,20.0,14.0,13.0,10.0,15.0,16.0,14.0,9.0,15.0,12.0,7.0,10.0,15.0,15.0,12.0,14.0,12.0,10.0,2.0,Francesco Acerbi,ÃÂ£10.80m ,Serie A
19/6/2011,Felix Bastians,5006686,771,5/9/1988,23,0,0,9,0,5050,6650,6650,150,132,500781,188,84,D LC,1,3,1,2,3,1,2,4,1,2,2,8,12,10,10,11,7,12,8,6,13,12,9,14,11,13,10,12,13,12,11,8,14,12,8,10,12,14,15,14,13,13,12,20,14,14,16,14,12,12,8,10,7,13,12,13,11,10,14,13,8,8,20,15,15,15,9,20,16,D LC,104,1,1,1,1,15,1,16,20,9,1,1,15,1,15,1,536870912.0,0,0,0,0,0,0,0,0,0,0,0,0,0,0,0,0,0,0,0,0,0,0,0,0,0,0,0,0,0,1,0,0,0,0,0,0,0,0,0,0,0,0,0,0,0,0,0,0,Felix Bastians,ÃÂ£1.58m ,32.0,188.0,Defender - Centre-Back,left,Tianjin Teda,31.0,0.0,9.0,2790.0,32.0,0.0,3.0,2586.0,14.0,0.0,0.0,941.0,13.0,0.0,0.0,1099.0,15.0,0.0,0.0,1350.0,35.0,2.0,2.0,3029.0,31.0,3.0,2.0,2793.0,49.0,5.0,1.0,4243.0,16.0,0.0,0.0,1352.0,Bundesliga,14.0,1.0,1.0,1147.0,nan,nan,nan,nan,29/6/2010,Felix Bastians,5006686.0,771.0,5/9/1988,22.0,0.0,0.0,0.0,0.0,4250.0,6250.0,6250.0,137.0,132.0,3801102.0,188.0,84.0,D LC,2.0,1.0,1.0,1.0,2.0,1.0,3.0,6.0,2.0,2.0,3.0,8.0,12.0,10.0,10.0,12.0,7.0,12.0,8.0,6.0,13.0,12.0,9.0,14.0,12.0,13.0,10.0,12.0,15.0,12.0,11.0,8.0,14.0,12.0,8.0,10.0,12.0,14.0,15.0,14.0,13.0,13.0,12.0,20.0,14.0,14.0,16.0,13.0,12.0,12.0,8.0,10.0,7.0,13.0,12.0,13.0,11.0,10.0,14.0,13.0,8.0,8.0,Felix Bastians,ÃÂÃÂ£4.05m ,Bundesliga
19/6/2011,Felipe Lopes,316709,1651,8/7/1987,23,0,0,0,0,2500,4700,6000,140,122,628815,184,76,D C,3,1,2,2,3,2,1,1,2,1,1,7,7,7,6,10,9,12,9,10,12,11,10,11,12,14,12,12,12,12,10,11,16,6,12,9,13,12,12,12,13,11,14,10,6,14,20,13,14,12,12,13,9,9,11,15,11,13,13,12,13,11,20,1,1,1,1,1,20,D C,101,1,1,1,1,1,1,20,1,1,1,1,1,1,1,1,0.0,0,0,0,0,0,0,0,0,0,0,0,0,0,0,0,0,0,0,0,0,0,0,0,0,0,0,0,0,0,0,0,0,0,0,0,0,0,0,0,0,0,0,0,0,0,0,0,0,Felipe Lopes,ÃÂ£4.05m ,33.0,189.0,Defender - Centre-Back,right,Without Club,36.0,2.0,0.0,3240.0,34.0,0.0,0.0,3051.0,4.0,0.0,0.0,289.0,0.0,0.0,0.0,0.0,nan,nan,nan,nan,0.0,0.0,0.0,0.0,7.0,0.0,0.0,518.0,21.0,2.0,2.0,1787.0,15.0,0.0,0.0,1304.0,Bundesliga,nan,nan,nan,nan,nan,nan,nan,nan,29/6/2010,Felipe Lopes,316709.0,1651.0,8/7/1987,22.0,0.0,0.0,0.0,0.0,2500.0,4700.0,6000.0,144.0,122.0,2895047.0,184.0,76.0,D C,1.0,3.0,3.0,1.0,3.0,2.0,3.0,4.0,3.0,1.0,2.0,8.0,8.0,8.0,7.0,11.0,10.0,13.0,10.0,11.0,13.0,12.0,11.0,12.0,13.0,13.0,13.0,12.0,13.0,13.0,11.0,12.0,16.0,7.0,10.0,8.0,13.0,12.0,13.0,14.0,14.0,12.0,13.0,10.0,6.0,15.0,20.0,13.0,10.0,12.0,8.0,13.0,4.0,9.0,11.0,15.0,11.0,13.0,13.0,12.0,13.0,11.0,Felipe Lopes,ÃÂÃÂ£2.79m ,Liga NOS
19/6/2011,Edson,19010341,1651,7/6/1987,23,0,0,2,0,2522,5976,5600,127,112,286932,184,83,D C,3,2,3,3,3,1,1,2,1,1,1,5,10,11,7,11,11,12,11,11,13,12,10,13,12,14,11,10,11,12,11,12,14,10,9,5,12,13,13,13,12,10,13,20,16,14,4,12,14,11,4,10,7,10,15,10,8,12,7,8,15,9,20,1,1,1,1,14,20,D C,101,1,10,1,1,1,1,20,14,1,1,1,1,1,1,1,35201600000000.0,0,0,0,0,0,0,0,0,0,0,0,0,0,0,0,0,0,0,0,0,0,0,0,0,0,0,0,0,0,0,0,0,0,0,1,0,0,0,0,0,0,0,0,0,0,1,0,0,Eridson,ÃÂ£630Th. ,30.0,187.0,Defender - Centre-Back,right,Valadares Gaia FC,nan,nan,nan,nan,19.0,2.0,1.0,1584.0,3.0,0.0,0.0,270.0,25.0,0.0,0.0,2181.0,38.0,1.0,2.0,3334.0,9.0,0.0,1.0,614.0,23.0,0.0,1.0,1960.0,2.0,0.0,0.0,151.0,0.0,0.0,0.0,0.0,Liga NOS,0.0,0.0,0.0,0.0,nan,nan,nan,nan,nan,nan,nan,nan,nan,nan,nan,nan,nan,nan,nan,nan,nan,nan,nan,nan,nan,nan,nan,nan,nan,nan,nan,nan,nan,nan,nan,nan,nan,nan,nan,nan,nan,nan,nan,nan,nan,nan,nan,nan,nan,nan,nan,nan,nan,nan,nan,nan,nan,nan,nan,nan,nan,nan,nan,nan,nan,nan,nan,nan,nan,nan,nan,nan,nan,nan,nan,nan,nan,nan,nan,nan,nan,nan,nan,nan,nan,nan,nan,nan,nan,nan,nan,nan
19/6/2011,Borja Ekiza,67018263,796,3/6/1988,23,0,0,0,0,4350,6500,6500,156,132,662273,180,73,D C,3,2,2,3,1,1,2,1,1,1,1,7,8,7,5,8,6,11,8,8,14,13,7,14,13,8,14,13,13,17,11,14,13,6,11,6,14,12,13,13,14,12,11,10,15,13,20,13,12,13,5,12,12,11,15,11,15,12,15,14,16,2,20,5,1,1,9,1,20,D C,101,1,1,1,1,1,1,20,1,9,1,1,1,1,1,5,0.0,0,0,0,0,0,0,0,0,0,0,0,0,0,0,0,0,0,0,0,0,0,0,0,0,0,0,0,0,0,0,0,0,0,0,0,0,0,0,0,0,0,0,0,0,0,0,0,0,Borja Ekiza,ÃÂ£3.15m ,32.0,182.0,Defender - Centre-Back,right,Retired,35.0,0.0,0.0,3061.0,31.0,0.0,0.0,1779.0,28.0,0.0,0.0,2329.0,2.0,0.0,0.0,81.0,13.0,0.0,0.0,1111.0,7.0,1.0,0.0,504.0,11.0,1.0,0.0,909.0,6.0,1.0,0.0,437.0,1.0,0.0,0.0,90.0,LaLiga,nan,nan,nan,nan,nan,nan,nan,nan,nan,nan,nan,nan,nan,nan,nan,nan,nan,nan,nan,nan,nan,nan,nan,nan,nan,nan,nan,nan,nan,nan,nan,nan,nan,nan,nan,nan,nan,nan,nan,nan,nan,nan,nan,nan,nan,nan,nan,nan,nan,nan,nan,nan,nan,nan,nan,nan,nan,nan,nan,nan,nan,nan,nan,nan,nan,nan,nan,nan,nan,nan,nan,nan,nan,nan,nan,nan,nan,nan,nan,nan,nan,nan,nan,nan,nan,nan,nan,nan,nan,nan,nan,nan
19/6/2011,Benedikt HÃÂ¶wedes,35015879,771,2/29/1988,23,2,0,22,3,6550,7550,7550,164,151,4355921,187,78,D C,2,2,1,3,3,1,1,5,3,3,1,3,8,4,9,10,3,17,4,13,16,8,7,17,9,17,13,18,11,18,7,10,17,3,14,7,14,18,17,12,10,13,16,12,13,15,20,16,14,16,9,16,3,14,5,14,19,14,17,16,14,3,20,1,1,1,14,12,20,D C,101,1,1,1,1,1,1,20,12,14,8,1,1,1,1,1,137439000000.0,0,0,0,0,0,0,0,0,0,0,0,0,0,0,0,1,0,0,0,0,0,0,0,0,0,0,0,0,0,0,0,0,0,0,0,0,0,1,0,0,0,0,0,0,0,0,0,0,Benedikt HÃÂ¶wedes,ÃÂ£13.50m ,32.0,188.0,Defender - Centre-Back,right,Retired,47.0,4.0,1.0,4082.0,34.0,1.0,3.0,2920.0,43.0,2.0,2.0,3825.0,32.0,2.0,1.0,2588.0,34.0,3.0,0.0,3027.0,19.0,1.0,0.0,1245.0,46.0,2.0,4.0,4170.0,3.0,1.0,0.0,248.0,26.0,4.0,0.0,2000.0,Bundesliga,24.0,0.0,0.0,2104.0,nan,nan,nan,nan,29/6/2010,Benedikt HÃÂ¶wedes,35015879.0,771.0,2/29/1988,22.0,0.0,0.0,21.0,3.0,4500.0,7000.0,7000.0,164.0,149.0,26511837.0,187.0,78.0,D C,1.0,1.0,2.0,3.0,2.0,3.0,1.0,2.0,1.0,1.0,2.0,3.0,8.0,4.0,6.0,10.0,3.0,17.0,4.0,12.0,15.0,8.0,8.0,17.0,9.0,17.0,12.0,18.0,11.0,18.0,7.0,10.0,17.0,3.0,14.0,6.0,14.0,18.0,17.0,12.0,10.0,13.0,16.0,12.0,13.0,15.0,20.0,16.0,15.0,16.0,9.0,16.0,3.0,14.0,9.0,14.0,19.0,14.0,17.0,16.0,14.0,3.0,Benedikt HÃÂÃÂ¶wedes,ÃÂÃÂ£12.60m ,Bundesliga,19-06-17,18.3.4.28,Benedikt HÃÂ¶wedes,35015879,771,29-Feb-88,29,44,2,22,3,7000,7500,7500,154,150,47167208,188,77,D RC,1,2,1,1,1,1,1,1,4,1,2,4,8,6,8,10,4,16,5,12,18,10,8,18,9,16,14,17,10,18,8,12,17,3,14,8,15,18,12,11,10,15,15,12,16,13,20,16,14,17,10,17,12,14,10,13,17,15,18,16,13,3,20,10,8,1,16,13,20,D RC,103,1,1,1,1,1,1,20,13,16,8,8,1,1,10,10,137439000000.0,0,0,0,0,0,0,0,0,0,0,0,0,0,0,0,1,0,0,0,0,0,0,0,0,0,0,0,0,0,0,0,0,0,0,0,0,0,1,0,0,0,0,0,0,0,0,0,0,Benedikt HÃÂ¶wedes,ÃÂ£8.10m ,32.0,188.0,Defender - Centre-Back,right,Retired,46.0,2.0,4.0,4170.0,3.0,1.0,0.0,248.0,26.0,4.0,0.0,2000.0,24.0,0.0,0.0,2104.0,nan,nan,nan,nan,Serie A,15-07-16,17.3.2.23,Benedikt HÃÂ¶wedes,35015879.0,771.0,29-Feb-88,28.0,40.0,2.0,22.0,3.0,7000.0,7500.0,7500.0,150.0,150.0,17999999.0,187.0,82.0,D RC,3.0,3.0,3.0,1.0,1.0,3.0,3.0,3.0,3.0,2.0,3.0,4.0,8.0,6.0,8.0,10.0,4.0,16.0,5.0,12.0,18.0,10.0,8.0,18.0,9.0,16.0,14.0,17.0,10.0,18.0,8.0,12.0,17.0,3.0,14.0,8.0,15.0,18.0,12.0,11.0,10.0,15.0,15.0,12.0,16.0,13.0,20.0,16.0,14.0,17.0,10.0,17.0,12.0,14.0,10.0,13.0,17.0,15.0,18.0,16.0,13.0,3.0,Benedikt HÃÂ¶wedes,ÃÂ£16.20m ,Bundesliga
19/6/2011,Bakary KonÃÂ©,85000226,9,4/27/1988,23,18,0,1,0,4700,6550,5900,150,131,632411,188,80,D C,3,2,2,3,3,3,3,8,2,3,3,4,8,9,7,10,6,17,6,7,14,7,8,15,10,16,14,15,10,12,11,10,14,8,9,7,13,13,13,13,12,17,15,5,14,12,20,14,17,13,16,16,6,6,8,15,13,14,11,11,13,8,20,10,1,1,10,1,20,D C,101,1,1,1,1,1,1,20,1,10,1,1,1,1,1,10,137439000000.0,0,0,0,1,0,0,0,0,0,0,0,0,0,0,0,0,0,0,0,0,0,0,0,0,0,0,0,0,0,0,0,0,0,0,0,0,0,1,0,0,0,0,0,0,0,0,0,0,Bakary KonÃÂ©,ÃÂ£3.60m ,32.0,188.0,Defender - Centre-Back,right,Kerala Blasters FC,35.0,1.0,0.0,3147.0,45.0,5.0,0.0,3769.0,22.0,1.0,0.0,2031.0,44.0,2.0,1.0,3176.0,22.0,1.0,0.0,1715.0,12.0,0.0,0.0,893.0,7.0,0.0,0.0,603.0,33.0,1.0,1.0,2972.0,18.0,0.0,0.0,1340.0,Ligue 1,0.0,0.0,0.0,0.0,nan,nan,nan,nan,nan,nan,nan,nan,nan,nan,nan,nan,nan,nan,nan,nan,nan,nan,nan,nan,nan,nan,nan,nan,nan,nan,nan,nan,nan,nan,nan,nan,nan,nan,nan,nan,nan,nan,nan,nan,nan,nan,nan,nan,nan,nan,nan,nan,nan,nan,nan,nan,nan,nan,nan,nan,nan,nan,nan,nan,nan,nan,nan,nan,nan,nan,nan,nan,nan,nan,nan,nan,nan,nan,nan,nan,nan,nan,nan,nan,nan,nan,nan,nan,nan,nan,nan,nan,19-06-17,18.3.4.28,Bakary KonÃÂ©,85000226,9,27-Apr-88,29,73,0,0,0,3900,6200,6200,138,124,3794972,188,82,D C,3,2,3,1,2,1,2,1,2,3,1,4,6,8,6,11,7,15,7,7,13,12,10,17,11,15,14,15,10,12,7,10,14,7,9,8,14,13,14,12,13,10,16,6,12,12,20,13,15,12,16,16,6,6,14,15,13,12,11,11,13,8,20,1,1,1,1,1,20,D C,101,1,1,1,1,1,1,20,1,1,1,1,1,1,1,1,137439000000.0,0,0,0,0,0,1,0,0,0,0,0,0,0,0,0,0,0,0,0,0,0,0,0,0,0,0,0,0,0,0,0,0,0,0,0,0,0,1,0,0,0,0,0,0,0,0,0,0,Bakary KonÃÂ©,ÃÂ£1.35m ,32.0,188.0,Defender - Centre-Back,right,Kerala Blasters FC,7.0,0.0,0.0,603.0,33.0,1.0,1.0,2972.0,18.0,0.0,0.0,1340.0,0.0,0.0,0.0,0.0,nan,nan,nan,nan,Ligue 1,nan,nan,nan,nan,nan,nan,nan,nan,nan,nan,nan,nan,nan,nan,nan,nan,nan,nan,nan,nan,nan,nan,nan,nan,nan,nan,nan,nan,nan,nan,nan,nan,nan,nan,nan,nan,nan,nan,nan,nan,nan,nan,nan,nan,nan,nan,nan,nan,nan,nan,nan,nan,nan,nan,nan,nan,nan,nan,nan,nan,nan,nan,nan,nan,nan,nan,nan,nan,nan,nan,nan,nan,nan,nan,nan,nan,nan,nan,nan,nan,nan,nan,nan,nan,nan
19/6/2011,Andrea Ranocchia,7988517,776,2/16/1988,23,3,0,19,3,6500,7750,7350,172,147,4480555,195,82,D C,3,3,3,2,3,1,2,9,1,1,3,4,4,8,9,10,4,15,6,7,15,10,4,16,11,13,15,15,15,14,10,14,17,6,9,6,16,14,15,11,10,16,18,7,11,12,20,14,17,13,9,15,15,7,16,20,17,11,15,17,10,1,20,1,1,1,1,1,20,D C,101,1,1,1,1,1,1,20,1,1,1,1,1,1,1,1,0.0,0,0,0,0,0,0,0,0,0,0,0,0,0,0,0,0,0,0,0,0,0,0,0,0,0,0,0,0,0,0,0,0,0,0,0,0,0,0,0,0,0,0,0,0,0,0,0,0,Andrea Ranocchia,ÃÂ£12.15m ,32.0,195.0,Defender - Centre-Back,right,Inter Milan,43.0,3.0,1.0,3653.0,17.0,1.0,0.0,1443.0,45.0,3.0,3.0,3749.0,26.0,2.0,0.0,2277.0,42.0,2.0,0.0,3614.0,24.0,0.0,0.0,1351.0,25.0,2.0,2.0,2056.0,13.0,2.0,0.0,866.0,7.0,1.0,0.0,296.0,Serie A,12.0,1.0,0.0,887.0,1.0,0.0,1.0,90.0,29/6/2010,Andrea Ranocchia,7988517.0,776.0,2/16/1988,22.0,0.0,0.0,9.0,1.0,3100.0,7000.0,7000.0,165.0,145.0,6467680.0,195.0,82.0,D C,2.0,1.0,3.0,1.0,2.0,1.0,2.0,9.0,1.0,2.0,2.0,1.0,3.0,4.0,6.0,9.0,2.0,16.0,2.0,3.0,16.0,8.0,4.0,16.0,8.0,13.0,15.0,16.0,12.0,15.0,8.0,11.0,17.0,6.0,10.0,5.0,16.0,14.0,15.0,12.0,13.0,16.0,18.0,7.0,11.0,11.0,20.0,15.0,17.0,14.0,9.0,15.0,3.0,10.0,16.0,20.0,17.0,11.0,15.0,17.0,10.0,1.0,Andrea Ranocchia,ÃÂÃÂ£15.75m ,Serie A,19-06-17,18.3.4.28,Andrea Ranocchia,7988517,776,16-Feb-88,29,21,0,13,1,5500,6550,6750,150,135,14098292,195,81,D C,2,2,3,2,3,1,2,2,3,3,1,5,6,8,9,11,5,18,7,10,15,12,8,15,10,14,13,16,11,9,11,11,14,6,14,8,13,16,14,12,11,17,18,9,12,12,20,12,14,10,14,14,10,7,14,13,13,9,15,12,13,5,20,1,1,1,1,1,20,D C,101,1,1,1,1,1,1,20,1,1,1,1,1,1,1,1,0.0,0,0,0,0,0,0,0,0,0,0,0,0,0,0,0,0,0,0,0,0,0,0,0,0,0,0,0,0,0,0,0,0,0,0,0,0,0,0,0,0,0,0,0,0,0,0,0,0,Andrea Ranocchia,ÃÂ£4.50m ,32.0,195.0,Defender - Centre-Back,right,Inter Milan,25.0,2.0,2.0,2056.0,13.0,2.0,0.0,866.0,7.0,1.0,0.0,296.0,12.0,1.0,0.0,887.0,1.0,0.0,1.0,90.0,Serie A,15-07-16,17.3.2.23,Andrea Ranocchia,7988517.0,776.0,16-Feb-88,28.0,21.0,0.0,14.0,1.0,5500.0,6750.0,6550.0,152.0,130.0,5710647.0,195.0,81.0,D C,3.0,1.0,3.0,1.0,3.0,2.0,2.0,1.0,3.0,3.0,2.0,5.0,6.0,8.0,9.0,10.0,5.0,19.0,7.0,7.0,14.0,12.0,8.0,14.0,10.0,14.0,12.0,15.0,12.0,10.0,11.0,12.0,13.0,6.0,14.0,6.0,12.0,14.0,15.0,12.0,11.0,15.0,19.0,9.0,12.0,12.0,20.0,13.0,14.0,10.0,14.0,14.0,10.0,7.0,14.0,15.0,15.0,10.0,15.0,12.0,13.0,5.0,Andrea Ranocchia,ÃÂ£4.50m ,Premier League
19/6/2011,Alex Song,8428095,11,9/9/1987,23,24,0,0,0,6264,7867,7717,167,157,20148243,185,74,D/DM/M C,1,1,1,1,1,2,3,4,1,1,2,5,9,12,9,13,5,15,7,10,14,13,10,16,13,14,16,16,17,16,12,14,17,9,9,13,15,16,18,12,14,16,13,13,16,11,20,18,17,16,11,13,5,15,14,14,15,12,15,13,16,8,17,1,18,1,1,1,18,D/DM/M C,331,1,1,1,1,1,1,17,1,1,20,18,1,1,1,1,4.0,0,0,1,0,0,0,0,0,0,0,0,0,0,0,0,0,0,0,0,0,0,0,0,0,0,0,0,0,0,0,0,0,0,0,0,0,0,0,0,0,0,0,0,0,0,0,0,0,Alex Song,ÃÂ£25.65m ,33.0,185.0,Midfielder - Defensive Midfield,right,Without Club,42.0,5.0,4.0,3390.0,46.0,1.0,14.0,4079.0,34.0,1.0,1.0,2394.0,31.0,0.0,1.0,1720.0,31.0,0.0,3.0,2434.0,16.0,0.0,1.0,938.0,16.0,0.0,2.0,1075.0,7.0,1.0,0.0,319.0,16.0,0.0,0.0,1064.0,Premier League,12.0,1.0,0.0,584.0,nan,nan,nan,nan,29/6/2010,Alex Song,8428095.0,11.0,9/9/1987,22.0,24.0,0.0,0.0,0.0,6162.0,7850.0,7750.0,167.0,157.0,-1.0,185.0,74.0,D/DM/M C,1.0,3.0,2.0,3.0,1.0,3.0,1.0,6.0,2.0,3.0,3.0,5.0,9.0,12.0,6.0,13.0,5.0,14.0,8.0,10.0,14.0,13.0,10.0,16.0,13.0,12.0,16.0,15.0,17.0,16.0,12.0,14.0,17.0,9.0,9.0,13.0,15.0,16.0,17.0,12.0,14.0,16.0,13.0,13.0,16.0,11.0,20.0,18.0,17.0,16.0,11.0,13.0,7.0,15.0,14.0,14.0,15.0,12.0,15.0,13.0,16.0,8.0,Alex Song,ÃÂÃÂ£15.30m ,Premier League
19/6/2011,ÃÂdÃÂ¡m PintÃÂ©r,38001863,773,6/12/1988,23,5,0,7,0,3717,5726,5726,129,115,374240,190,76,D/DM C,2,1,2,3,1,2,1,7,1,2,2,7,10,9,8,11,12,16,8,10,14,11,8,13,10,12,11,14,9,13,8,10,10,6,10,7,12,16,14,8,10,14,16,13,12,12,20,13,13,14,10,11,10,11,8,12,9,13,6,15,7,8,20,1,15,1,1,1,20,D/DM C,111,1,9,1,1,1,1,20,1,1,19,15,1,1,1,1,0.0,0,0,0,0,0,0,0,0,0,0,0,0,0,0,0,0,0,0,0,0,0,0,0,0,0,0,0,0,0,0,0,0,0,0,0,0,0,0,0,0,0,0,0,0,0,0,0,0,ÃÂdÃÂ¡m PintÃÂ©r,ÃÂ£900Th. ,32.0,190.0,Defender - Centre-Back,right,MTK Budapest,15.0,1.0,0.0,847.0,17.0,0.0,0.0,1259.0,20.0,0.0,0.0,1466.0,13.0,0.0,0.0,548.0,17.0,0.0,0.0,1151.0,26.0,3.0,0.0,1698.0,29.0,0.0,0.0,1982.0,10.0,0.0,0.0,518.0,25.0,0.0,0.0,2059.0,LaLiga,24.0,0.0,1.0,2108.0,nan,nan,nan,nan,29/6/2010,ÃÂdÃÂ¡m PintÃÂ©r,38001863.0,773.0,6/12/1988,22.0,0.0,0.0,6.0,0.0,1000.0,5000.0,5000.0,133.0,110.0,933155.0,190.0,76.0,D/DM C,3.0,1.0,1.0,2.0,3.0,2.0,2.0,1.0,2.0,2.0,2.0,6.0,7.0,7.0,8.0,12.0,11.0,16.0,7.0,9.0,13.0,9.0,9.0,14.0,8.0,12.0,11.0,14.0,11.0,11.0,8.0,9.0,10.0,9.0,10.0,8.0,10.0,13.0,14.0,9.0,14.0,9.0,13.0,11.0,12.0,8.0,20.0,13.0,15.0,14.0,10.0,11.0,10.0,11.0,15.0,5.0,16.0,8.0,15.0,9.0,10.0,19.0,nan,nan,nan
19/6/2011,Yohan Benalouane,8434244,51,3/28/1987,24,0,0,0,0,1700,6350,6200,136,123,406145,185,79,D LC,3,3,1,2,2,2,1,1,2,2,1,5,8,9,6,12,6,15,8,6,12,8,8,12,12,13,15,13,11,7,8,13,14,9,12,7,14,13,13,14,11,15,15,8,15,13,20,15,16,10,13,14,7,8,6,16,13,13,16,14,13,9,20,1,1,1,1,15,20,D LC,104,1,1,1,1,1,1,20,15,1,12,1,1,1,1,1,8796090000000.0,0,0,0,0,0,1,0,0,0,0,0,0,0,0,0,0,0,0,0,0,0,0,0,0,0,0,0,0,0,0,0,0,0,0,0,0,0,0,0,0,0,0,0,1,0,0,0,0,Yohan Benalouane,ÃÂ£810Th. ,33.0,185.0,Defender - Centre-Back,right,Aris Thessaloniki,17.0,0.0,1.0,1168.0,14.0,1.0,0.0,988.0,24.0,1.0,0.0,1807.0,23.0,0.0,1.0,1826.0,29.0,1.0,0.0,2369.0,11.0,0.0,0.0,754.0,25.0,1.0,0.0,2061.0,10.0,2.0,0.0,819.0,19.0,1.0,1.0,1636.0,Serie A,2.0,0.0,0.0,49.0,nan,nan,nan,nan,29/6/2010,Yohan Benalouane,8434244.0,51.0,3/28/1987,23.0,0.0,0.0,0.0,0.0,4032.0,6350.0,5700.0,148.0,127.0,2199998.0,185.0,79.0,D LC,1.0,1.0,2.0,3.0,1.0,1.0,2.0,6.0,3.0,1.0,2.0,5.0,8.0,9.0,6.0,12.0,6.0,14.0,8.0,6.0,12.0,8.0,8.0,12.0,12.0,13.0,15.0,13.0,11.0,13.0,8.0,13.0,14.0,9.0,12.0,7.0,14.0,13.0,13.0,14.0,11.0,15.0,13.0,8.0,15.0,13.0,20.0,15.0,15.0,14.0,13.0,14.0,7.0,8.0,17.0,16.0,13.0,13.0,16.0,14.0,13.0,9.0,Yohan Benalouane,ÃÂÃÂ£1.26m ,Serie A,19-06-17,18.3.4.28,Yohan Benalouane,8434244,51,28-Mar-87,30,0,0,0,0,5096,5606,6250,138,134,13094595,187,85,D RC,2,2,4,2,1,1,1,2,2,2,3,5,9,11,6,12,6,15,8,6,14,10,8,15,13,17,15,16,13,8,9,13,13,9,12,7,14,13,14,12,11,15,15,9,15,13,20,15,16,12,16,14,7,8,12,13,11,11,16,12,6,14,20,1,1,1,16,10,20,D RC,103,1,1,1,1,1,1,20,10,16,1,1,1,1,1,1,1.15292e+18,0,0,0,0,0,1,0,0,0,0,0,0,0,0,0,0,0,0,0,0,0,0,0,0,0,0,0,0,0,0,0,0,0,0,0,0,0,0,0,0,0,0,0,0,0,0,0,0,Yohan Benalouane,ÃÂ£900Th. ,33.0,185.0,Defender - Centre-Back,right,Aris Thessaloniki,25.0,1.0,0.0,2061.0,10.0,2.0,0.0,819.0,19.0,1.0,1.0,1636.0,2.0,0.0,0.0,49.0,nan,nan,nan,nan,Premier League,15-07-16,17.3.2.23,Yohan Benalouane,8434244.0,51.0,28-Mar-87,29.0,0.0,0.0,0.0,0.0,5107.0,5690.0,6247.0,136.0,131.0,5535562.0,187.0,85.0,D RC,3.0,2.0,4.0,1.0,1.0,2.0,2.0,1.0,3.0,2.0,2.0,5.0,9.0,11.0,6.0,12.0,6.0,15.0,8.0,6.0,14.0,10.0,8.0,14.0,13.0,16.0,15.0,14.0,13.0,8.0,9.0,13.0,13.0,9.0,12.0,7.0,14.0,13.0,14.0,12.0,11.0,15.0,14.0,9.0,15.0,13.0,20.0,15.0,16.0,12.0,16.0,14.0,7.0,8.0,12.0,13.0,11.0,11.0,16.0,12.0,6.0,14.0,Yohan Benalouane,ÃÂ£900Th. ,Premier League
19/6/2011,Willian Alves,2114480,1651,4/29/1987,24,0,0,0,0,794,4500,4500,110,92,19198,185,78,D C,1,1,1,3,3,3,2,1,3,1,1,4,6,6,3,13,2,8,2,6,13,10,7,13,8,10,10,8,8,12,4,13,10,6,8,9,10,9,13,9,6,11,13,8,18,8,20,12,13,10,12,10,5,10,5,10,10,15,6,15,17,14,20,1,1,1,1,1,20,D C,101,1,1,1,1,1,1,20,1,1,1,1,1,1,1,1,0.0,0,0,0,0,0,0,0,0,0,0,0,0,0,0,0,0,0,0,0,0,0,0,0,0,0,0,0,0,0,0,0,0,0,0,0,0,0,0,0,0,0,0,0,0,0,0,0,0,William Alves,ÃÂ£180Th. ,33.0,189.0,Defender - Centre-Back,right,Santa Cruz Futebol Clube (PE),nan,nan,nan,nan,1.0,0.0,0.0,90.0,24.0,0.0,0.0,2011.0,23.0,2.0,1.0,1915.0,nan,nan,nan,nan,33.0,0.0,3.0,2752.0,42.0,1.0,1.0,3725.0,12.0,1.0,1.0,742.0,nan,nan,nan,nan,Liga NOS,10.0,1.0,0.0,891.0,nan,nan,nan,nan,nan,nan,nan,nan,nan,nan,nan,nan,nan,nan,nan,nan,nan,nan,nan,nan,nan,nan,nan,nan,nan,nan,nan,nan,nan,nan,nan,nan,nan,nan,nan,nan,nan,nan,nan,nan,nan,nan,nan,nan,nan,nan,nan,nan,nan,nan,nan,nan,nan,nan,nan,nan,nan,nan,nan,nan,nan,nan,nan,nan,nan,nan,nan,nan,nan,nan,nan,nan,nan,nan,nan,nan,nan,nan,nan,nan,nan,nan,nan,nan,nan,nan,nan,nan
19/6/2011,Vasco Fernandes,727458,788,11/12/1986,24,0,0,1,0,4000,5250,5250,120,106,117520,181,74,D RC,3,1,3,1,2,3,3,1,3,2,1,6,9,8,6,11,9,9,9,7,9,12,9,12,11,12,13,11,13,9,8,13,8,12,11,9,11,14,12,12,12,10,9,11,13,14,20,10,12,9,16,8,6,12,7,5,15,16,11,14,15,14,20,9,1,1,20,10,16,D RC,103,1,10,1,1,1,1,16,10,20,15,1,1,1,1,9,34.0,0,1,0,0,0,1,0,0,0,0,0,0,0,0,0,0,0,0,0,0,0,0,0,0,0,0,0,0,0,0,0,0,0,0,0,0,0,0,0,0,0,0,0,0,0,0,0,0,Gelson Fernandes,ÃÂ£3.15m ,34.0,180.0,Midfielder - Defensive Midfield,right,Retired,30.0,2.0,2.0,2365.0,35.0,2.0,3.0,2240.0,28.0,0.0,0.0,2211.0,38.0,1.0,2.0,2906.0,36.0,0.0,0.0,3002.0,37.0,1.0,1.0,3203.0,28.0,0.0,0.0,1881.0,22.0,0.0,0.0,1168.0,37.0,1.0,0.0,3056.0,Serie A,22.0,0.0,0.0,1356.0,nan,nan,nan,nan,nan,nan,nan,nan,nan,nan,nan,nan,nan,nan,nan,nan,nan,nan,nan,nan,nan,nan,nan,nan,nan,nan,nan,nan,nan,nan,nan,nan,nan,nan,nan,nan,nan,nan,nan,nan,nan,nan,nan,nan,nan,nan,nan,nan,nan,nan,nan,nan,nan,nan,nan,nan,nan,nan,nan,nan,nan,nan,nan,nan,nan,nan,nan,nan,nan,nan,nan,nan,nan,nan,nan,nan,nan,nan,nan,nan,nan,nan,nan,nan,nan,nan,nan,nan,19-06-17,18.3.4.28,Vasco Fernandes,727458,788,12-Nov-86,30,0,0,11,0,4400,5900,5900,123,118,232186002,182,79,D RC,4,2,2,2,2,1,2,1,3,1,2,7,9,9,6,10,8,10,9,8,13,11,10,14,11,12,15,14,11,10,8,12,15,12,15,10,12,14,13,13,13,13,12,8,16,14,20,14,12,12,14,12,6,12,13,14,10,12,15,14,15,6,20,1,1,1,18,1,20,D RC,103,1,1,1,1,1,1,20,1,18,14,1,1,1,1,1,34.0,0,1,0,0,0,1,0,0,0,0,0,0,0,0,0,0,0,0,0,0,0,0,0,0,0,0,0,0,0,0,0,0,0,0,0,0,0,0,0,0,0,0,0,0,0,0,0,0,Vasco Fernandes,ÃÂ£720Th. ,33.0,182.0,Defender - Centre-Back,right,ÃÂmraniyespor,34.0,2.0,0.0,2901.0,27.0,2.0,2.0,2366.0,37.0,1.0,1.0,3360.0,20.0,1.0,1.0,1770.0,5.0,1.0,0.0,377.0,Liga NOS,15-07-16,17.3.2.23,Vasco Fernandes,727458.0,788.0,12-Nov-86,29.0,0.0,0.0,11.0,0.0,5000.0,6050.0,6250.0,123.0,121.0,977142.0,182.0,79.0,D RC,3.0,1.0,1.0,3.0,1.0,3.0,3.0,2.0,3.0,1.0,3.0,7.0,9.0,8.0,6.0,10.0,8.0,10.0,9.0,8.0,13.0,11.0,10.0,15.0,11.0,12.0,15.0,14.0,12.0,10.0,8.0,13.0,15.0,12.0,11.0,8.0,13.0,14.0,13.0,13.0,13.0,13.0,12.0,8.0,16.0,14.0,20.0,15.0,12.0,12.0,14.0,12.0,6.0,12.0,13.0,14.0,10.0,12.0,15.0,14.0,15.0,7.0,Vasco Fernandes,ÃÂ£900Th. ,Liga NOS
19/6/2011,Valentin Roberge,34000442,769,6/9/1987,24,0,0,0,0,3600,4500,5450,122,113,382697,185,74,D C,1,2,3,3,3,3,2,2,2,3,2,5,11,7,5,9,5,13,9,8,11,12,6,11,9,12,11,13,10,12,8,11,12,7,9,6,12,14,15,11,8,14,13,20,14,10,8,15,14,14,12,12,5,10,11,13,12,12,14,14,14,5,20,1,1,1,10,12,20,D C,101,1,1,1,1,1,1,20,12,10,10,1,1,1,1,1,8796090000000.0,0,0,0,0,0,0,0,0,0,0,0,0,0,0,0,0,0,0,0,0,0,0,0,0,0,0,0,0,0,0,0,0,0,0,0,0,0,0,0,0,0,0,0,1,0,0,0,0,Valentin Roberge,ÃÂ£900Th. ,33.0,189.0,Defender - Centre-Back,both,Apollon Limassol,28.0,1.0,1.0,2390.0,33.0,0.0,0.0,2906.0,37.0,2.0,1.0,3247.0,13.0,1.0,1.0,969.0,14.0,0.0,0.0,1215.0,4.0,1.0,0.0,360.0,25.0,0.0,0.0,2145.0,44.0,1.0,0.0,3956.0,38.0,2.0,1.0,3266.0,Liga NOS,2.0,0.0,0.0,180.0,10.0,0.0,1.0,900.0,nan,nan,nan,nan,nan,nan,nan,nan,nan,nan,nan,nan,nan,nan,nan,nan,nan,nan,nan,nan,nan,nan,nan,nan,nan,nan,nan,nan,nan,nan,nan,nan,nan,nan,nan,nan,nan,nan,nan,nan,nan,nan,nan,nan,nan,nan,nan,nan,nan,nan,nan,nan,nan,nan,nan,nan,nan,nan,nan,nan,nan,nan,nan,nan,nan,nan,nan,nan,nan,nan,nan,nan,nan,nan,nan,nan,nan,nan,nan,nan,nan,nan,nan,nan
19/6/2011,Vadim Demidov,53010227,786,10/10/1986,24,1,0,13,2,4700,6500,6500,148,136,645204,185,73,D/DM/M C,2,3,1,2,2,3,2,5,1,1,1,4,8,10,8,14,5,14,10,5,14,11,8,16,13,14,16,17,13,13,11,13,15,5,16,10,15,14,13,13,11,12,14,10,15,13,20,13,14,14,12,18,8,16,15,17,12,15,15,12,8,18,20,1,17,1,1,1,20,D/DM/M C,121,1,1,1,1,1,1,20,1,1,18,17,1,1,1,1,137439000000.0,0,0,1,0,0,0,0,0,0,0,0,0,0,0,0,0,0,0,0,0,0,0,0,0,0,0,0,0,0,0,0,0,0,0,0,0,0,1,0,0,0,0,0,0,0,0,0,0,Vadim Demidov,ÃÂ£3.15m ,34.0,186.0,Defender - Centre-Back,right,Retired,25.0,1.0,1.0,2173.0,27.0,0.0,1.0,2194.0,19.0,0.0,0.0,1504.0,8.0,0.0,0.0,641.0,26.0,1.0,0.0,2070.0,26.0,1.0,1.0,2291.0,3.0,0.0,0.0,270.0,28.0,1.0,0.0,2397.0,15.0,0.0,2.0,1303.0,LaLiga,nan,nan,nan,nan,nan,nan,nan,nan,nan,nan,nan,nan,nan,nan,nan,nan,nan,nan,nan,nan,nan,nan,nan,nan,nan,nan,nan,nan,nan,nan,nan,nan,nan,nan,nan,nan,nan,nan,nan,nan,nan,nan,nan,nan,nan,nan,nan,nan,nan,nan,nan,nan,nan,nan,nan,nan,nan,nan,nan,nan,nan,nan,nan,nan,nan,nan,nan,nan,nan,nan,nan,nan,nan,nan,nan,nan,nan,nan,nan,nan,nan,nan,nan,nan,nan,nan,nan,nan,nan,nan,nan,nan
19/6/2011,Tomoaki Makino,784465,116,5/11/1987,24,5,0,9,1,3700,5709,5900,140,119,759236,182,76,D RLC,3,1,2,1,1,2,2,4,2,1,3,8,9,10,7,10,13,12,12,13,10,11,9,13,11,11,10,16,12,10,12,10,12,15,8,9,10,12,13,13,14,13,11,16,11,12,20,12,12,10,7,11,7,14,6,12,11,10,13,9,7,8,20,10,8,1,17,17,20,D RLC,106,1,10,1,1,1,1,20,17,17,15,8,4,4,10,10,32.0,0,0,0,0,0,1,0,0,0,0,0,0,0,0,0,0,0,0,0,0,0,0,0,0,0,0,0,0,0,0,0,0,0,0,0,0,0,0,0,0,0,0,0,0,0,0,0,0,Tomoaki Makino,ÃÂ£900Th. ,33.0,182.0,Defender - Centre-Back,right,Urawa Red Diamonds,5.0,0.0,0.0,133.0,44.0,6.0,1.0,3541.0,45.0,6.0,4.0,3900.0,39.0,6.0,0.0,3384.0,43.0,4.0,3.0,3930.0,39.0,3.0,1.0,3502.0,48.0,3.0,0.0,4202.0,42.0,5.0,1.0,3780.0,49.0,3.0,0.0,4365.0,Bundesliga,20.0,1.0,0.0,1665.0,nan,nan,nan,nan,nan,nan,nan,nan,nan,nan,nan,nan,nan,nan,nan,nan,nan,nan,nan,nan,nan,nan,nan,nan,nan,nan,nan,nan,nan,nan,nan,nan,nan,nan,nan,nan,nan,nan,nan,nan,nan,nan,nan,nan,nan,nan,nan,nan,nan,nan,nan,nan,nan,nan,nan,nan,nan,nan,nan,nan,nan,nan,nan,nan,nan,nan,nan,nan,nan,nan,nan,nan,nan,nan,nan,nan,nan,nan,nan,nan,nan,nan,nan,nan,nan,nan,nan,nan
19/6/2011,Thomas Mangani,919962,769,4/29/1987,24,0,0,0,0,4500,5600,5600,140,125,101703,183,78,D/DM C,1,2,2,2,1,3,2,1,1,2,3,6,8,9,6,12,6,13,10,12,11,12,8,13,12,12,15,13,13,13,11,13,15,6,12,7,13,16,18,12,11,14,12,20,14,11,8,16,14,14,12,14,6,12,12,12,9,17,15,15,15,5,17,14,12,5,1,14,17,D/DM C,321,1,1,1,5,1,1,17,14,1,20,8,12,1,14,1,137439000000.0,0,0,0,0,0,0,0,0,0,0,0,0,0,0,0,0,0,0,0,0,0,0,0,0,0,0,0,0,0,0,0,0,0,0,0,0,0,1,0,0,0,0,0,0,0,0,0,0,Thomas Mangani,ÃÂ£1.35m ,33.0,183.0,Midfielder - Central Midfield,left,SCO Angers,25.0,1.0,1.0,1794.0,29.0,1.0,3.0,1606.0,36.0,0.0,4.0,2766.0,37.0,1.0,5.0,3093.0,17.0,2.0,2.0,1364.0,33.0,5.0,4.0,2501.0,40.0,6.0,9.0,3394.0,38.0,2.0,6.0,3230.0,31.0,3.0,0.0,1735.0,Ligue 1,27.0,2.0,2.0,2128.0,8.0,1.0,0.0,537.0,29/6/2010,Thomas Mangani,919962.0,769.0,4/29/1987,23.0,0.0,0.0,0.0,0.0,3906.0,5600.0,5600.0,140.0,125.0,1902707.0,183.0,78.0,D/DM C,1.0,3.0,2.0,2.0,1.0,1.0,2.0,3.0,1.0,1.0,2.0,6.0,8.0,9.0,6.0,12.0,6.0,13.0,10.0,12.0,11.0,12.0,8.0,13.0,12.0,12.0,15.0,13.0,13.0,13.0,11.0,13.0,15.0,6.0,12.0,7.0,13.0,16.0,18.0,12.0,11.0,14.0,12.0,20.0,14.0,11.0,8.0,16.0,14.0,14.0,12.0,14.0,6.0,12.0,10.0,12.0,14.0,11.0,15.0,15.0,15.0,5.0,Thomas Mangani,ÃÂÃÂ£1.80m ,Ligue 1,19-06-17,18.3.4.28,Thomas Mangani,919962,769,29-Apr-87,30,0,0,0,0,3900,6400,6400,129,128,232186002,183,78,D/DM C,1,1,3,3,1,4,2,2,2,2,2,13,8,9,6,12,14,13,10,12,11,12,8,13,12,12,15,13,13,13,11,13,15,6,12,7,13,16,18,12,11,14,12,20,14,11,8,16,14,14,12,14,6,12,11,12,13,12,15,15,15,5,17,14,12,1,1,14,17,D/DM C,321,1,1,1,1,1,1,17,12,1,20,12,12,1,14,1,137439000000.0,0,0,0,0,0,0,0,0,0,0,0,0,0,0,0,0,0,0,0,0,0,0,0,0,0,0,0,0,0,0,0,0,0,0,0,0,0,1,0,0,0,0,0,0,0,0,0,0,Thomas Mangani,ÃÂ£3.15m ,33.0,183.0,Midfielder - Central Midfield,left,SCO Angers,40.0,6.0,9.0,3394.0,38.0,2.0,6.0,3230.0,31.0,3.0,0.0,1735.0,27.0,2.0,2.0,2128.0,8.0,1.0,0.0,537.0,Ligue 1,15-07-16,17.3.2.23,Thomas Mangani,919962.0,769.0,29-Apr-87,29.0,0.0,0.0,0.0,0.0,4293.0,6243.0,6443.0,134.0,128.0,7510580.0,183.0,78.0,D/DM C,3.0,2.0,1.0,1.0,1.0,3.0,3.0,3.0,1.0,3.0,2.0,13.0,8.0,9.0,6.0,12.0,14.0,13.0,10.0,12.0,11.0,12.0,8.0,13.0,12.0,12.0,15.0,13.0,13.0,13.0,11.0,13.0,15.0,6.0,12.0,7.0,13.0,16.0,18.0,12.0,11.0,14.0,12.0,20.0,14.0,11.0,8.0,16.0,14.0,14.0,12.0,14.0,6.0,12.0,8.0,12.0,13.0,12.0,15.0,15.0,15.0,5.0,Thomas Mangani,ÃÂ£3.15m ,Ligue 1
19/6/2011,Steven Mouyokolo,34000657,49,1/24/1987,24,1,0,0,0,4500,5669,5650,140,126,909091,190,86,D C,3,2,1,1,2,3,1,2,1,2,2,4,5,5,6,9,5,16,9,8,14,7,5,14,9,13,14,16,11,14,7,12,15,6,11,6,11,15,13,12,8,16,15,5,14,13,20,14,16,16,13,14,13,8,11,13,10,14,12,14,14,7,20,1,1,1,10,1,20,D C,101,1,1,1,1,1,1,20,1,10,1,1,1,1,1,1,32768.0,0,0,0,0,0,0,0,0,0,0,0,0,0,0,0,1,0,0,0,0,0,0,0,0,0,0,0,0,0,0,0,0,0,0,0,0,0,0,0,0,0,0,0,0,0,0,0,0,Steven Mouyokolo,ÃÂ£720Th. ,33.0,190.0,Defender - Centre-Back,right,Retired,16.0,0.0,0.0,1209.0,4.0,0.0,0.0,278.0,nan,nan,nan,nan,3.0,0.0,0.0,180.0,nan,nan,nan,nan,nan,nan,nan,nan,nan,nan,nan,nan,nan,nan,nan,nan,nan,nan,nan,nan,Ligue 1,nan,nan,nan,nan,nan,nan,nan,nan,29/6/2010,Steven Mouyokolo,34000657.0,49.0,1/24/1987,23.0,0.0,0.0,0.0,0.0,4225.0,5849.0,6250.0,150.0,130.0,5750000.0,190.0,86.0,D C,1.0,1.0,2.0,2.0,1.0,3.0,1.0,1.0,3.0,3.0,2.0,5.0,5.0,5.0,6.0,12.0,5.0,16.0,9.0,8.0,14.0,7.0,5.0,14.0,12.0,13.0,14.0,16.0,15.0,15.0,7.0,12.0,15.0,6.0,13.0,6.0,11.0,15.0,15.0,12.0,8.0,17.0,15.0,6.0,14.0,13.0,20.0,14.0,14.0,16.0,13.0,14.0,11.0,8.0,11.0,13.0,11.0,14.0,12.0,14.0,14.0,7.0,Steven Mouyokolo,ÃÂÃÂ£1.35m ,Premier League
19/6/2011,Stefan Radu,7545224,790,10/22/1986,24,9,0,3,1,6100,7000,6950,157,142,1223865,183,79,D LC,1,3,1,2,3,3,3,5,1,2,1,5,7,10,6,9,7,14,9,8,16,11,10,15,12,14,14,14,15,13,12,13,12,7,12,11,15,17,15,13,14,14,10,20,16,13,10,13,14,14,13,15,5,13,18,13,15,10,15,14,15,5,20,1,1,1,1,18,20,D LC,104,1,1,1,1,1,1,20,18,1,1,1,1,1,1,1,196672.0,0,0,0,0,0,0,1,0,0,0,0,0,0,0,0,0,1,1,0,0,0,0,0,0,0,0,0,0,0,0,0,0,0,0,0,0,0,0,0,0,0,0,0,0,0,0,0,0,Stefan Radu,ÃÂ£4.50m ,34.0,183.0,Defender - Centre-Back,left,SS Lazio,27.0,0.0,0.0,2356.0,26.0,0.0,2.0,2201.0,36.0,3.0,5.0,3020.0,32.0,1.0,1.0,2817.0,29.0,1.0,3.0,2544.0,25.0,0.0,2.0,2137.0,31.0,2.0,1.0,2560.0,41.0,0.0,2.0,3528.0,33.0,0.0,1.0,2698.0,Serie A,31.0,1.0,0.0,2474.0,3.0,0.0,0.0,163.0,29/6/2010,Stefan Radu,7545224.0,790.0,10/22/1986,23.0,8.0,0.0,0.0,0.0,5112.0,7000.0,6500.0,165.0,143.0,7991173.0,183.0,79.0,D LC,3.0,2.0,1.0,3.0,3.0,1.0,1.0,7.0,1.0,1.0,2.0,5.0,8.0,11.0,7.0,9.0,7.0,14.0,9.0,8.0,16.0,11.0,10.0,15.0,12.0,14.0,15.0,13.0,15.0,14.0,12.0,13.0,12.0,7.0,13.0,11.0,15.0,16.0,15.0,13.0,14.0,14.0,11.0,20.0,16.0,13.0,10.0,13.0,14.0,14.0,13.0,15.0,5.0,13.0,18.0,13.0,15.0,10.0,15.0,14.0,15.0,5.0,Stefan Radu,ÃÂÃÂ£4.95m ,Serie A,19-06-17,18.3.4.28,Stefan Radu,7545224,790,22-Oct-86,30,14,0,13,1,5400,7100,7100,149,142,31156399,183,79,D LC,1,1,2,3,1,4,2,3,1,1,3,3,12,9,8,11,3,15,11,3,15,12,10,16,13,18,17,15,14,13,12,13,17,8,16,11,14,16,14,13,12,15,12,20,16,13,9,13,14,13,10,14,14,13,19,14,17,12,19,9,8,6,20,11,8,1,1,20,19,D LC,104,1,1,1,1,1,1,19,20,1,1,1,8,1,11,1,2199020000000.0,0,0,0,0,0,0,0,0,0,0,0,0,0,0,0,0,0,0,0,0,0,0,0,0,0,0,0,0,0,0,0,0,0,0,0,0,0,0,0,0,0,1,0,0,0,0,0,0,Stefan Radu,ÃÂ£5.40m ,34.0,183.0,Defender - Centre-Back,left,SS Lazio,31.0,2.0,1.0,2560.0,41.0,0.0,2.0,3528.0,33.0,0.0,1.0,2698.0,31.0,1.0,0.0,2474.0,3.0,0.0,0.0,163.0,Serie A,15-07-16,17.3.2.23,Stefan Radu,7545224.0,790.0,22-Oct-86,29.0,14.0,0.0,13.0,1.0,5400.0,7000.0,7000.0,149.0,140.0,9858965.0,183.0,79.0,D LC,2.0,2.0,1.0,3.0,2.0,2.0,4.0,1.0,4.0,1.0,3.0,4.0,13.0,9.0,8.0,12.0,5.0,15.0,12.0,8.0,14.0,13.0,10.0,15.0,13.0,16.0,17.0,15.0,14.0,12.0,12.0,12.0,14.0,8.0,16.0,12.0,14.0,16.0,15.0,12.0,13.0,16.0,12.0,20.0,16.0,13.0,10.0,13.0,13.0,13.0,13.0,14.0,14.0,13.0,19.0,14.0,17.0,12.0,18.0,9.0,9.0,5.0,Stefan Radu,ÃÂ£5.40m ,Serie A
19/6/2011,Serdar TasÃÂ§i,8729311,771,4/24/1987,24,14,0,1,0,6550,7100,7100,158,142,2371542,186,80,D C,1,3,3,2,1,2,2,9,3,3,2,6,11,9,5,12,5,13,5,11,15,13,7,15,14,10,9,13,17,9,11,17,16,6,12,7,10,17,15,13,14,15,14,14,10,16,20,16,12,13,9,11,13,10,8,13,13,12,15,14,15,4,20,1,1,1,12,10,20,D C,101,1,1,1,1,1,1,20,10,12,1,1,1,1,1,1,137439000000.0,0,0,1,1,0,0,0,0,0,0,0,0,0,0,0,1,0,0,0,0,0,0,0,0,0,0,0,0,0,0,0,0,0,0,0,0,0,1,0,0,0,0,0,0,0,0,0,0,Serdar Tasci,ÃÂ£9.90m ,33.0,186.0,Defender - Centre-Back,right,Without Club,32.0,1.0,1.0,2833.0,30.0,3.0,1.0,2692.0,39.0,1.0,0.0,3383.0,8.0,0.0,0.0,604.0,23.0,1.0,1.0,1814.0,20.0,2.0,0.0,1738.0,19.0,0.0,0.0,1533.0,22.0,0.0,1.0,1753.0,5.0,0.0,0.0,376.0,Bundesliga,nan,nan,nan,nan,nan,nan,nan,nan,29/6/2010,Serdar TasÃÂ§i,8729311.0,771.0,4/24/1987,23.0,7.0,0.0,1.0,0.0,3650.0,7350.0,7350.0,162.0,145.0,17681722.0,186.0,80.0,D C,1.0,2.0,3.0,1.0,2.0,3.0,3.0,4.0,2.0,1.0,1.0,6.0,10.0,9.0,5.0,12.0,5.0,14.0,5.0,10.0,14.0,13.0,7.0,16.0,13.0,10.0,12.0,13.0,17.0,9.0,11.0,17.0,16.0,6.0,12.0,8.0,10.0,17.0,15.0,12.0,14.0,15.0,15.0,14.0,10.0,16.0,20.0,16.0,12.0,13.0,9.0,11.0,13.0,10.0,8.0,13.0,13.0,12.0,15.0,14.0,15.0,4.0,Serdar Tasci,ÃÂÃÂ£9.00m ,Bundesliga
19/6/2011,SÃÂ©bastien Bassong,8440183,11,7/9/1986,24,15,0,3,0,6012,6446,7264,165,143,2449113,188,73,D LC,2,2,2,1,1,3,3,4,3,2,2,8,9,8,5,9,5,17,7,11,14,11,7,16,9,15,15,15,14,13,9,10,15,6,12,8,15,14,15,14,12,16,16,20,16,15,5,16,14,14,14,13,7,12,14,17,10,13,14,14,12,7,20,10,1,1,10,15,20,D LC,104,1,1,1,1,1,1,20,15,10,1,1,1,1,10,1,274878000000.0,0,0,0,0,0,0,0,0,0,0,0,0,0,0,0,0,0,0,0,0,0,0,0,0,0,0,0,0,0,0,0,0,0,0,0,0,0,0,1,0,0,0,0,0,0,0,0,0,SÃÂ©bastien Bassong,ÃÂ£4.05m ,34.0,187.0,Defender - Centre-Back,left,Without Club,20.0,2.0,0.0,1494.0,22.0,0.0,0.0,1658.0,35.0,3.0,2.0,3052.0,32.0,0.0,0.0,2802.0,33.0,0.0,0.0,2833.0,36.0,2.0,0.0,3161.0,13.0,0.0,0.0,1117.0,nan,nan,nan,nan,1.0,0.0,0.0,90.0,Premier League,3.0,0.0,0.0,270.0,nan,nan,nan,nan,29/6/2010,SÃÂ©bastien Bassong,8440183.0,11.0,7/9/1986,23.0,9.0,0.0,3.0,0.0,5184.0,6479.0,7250.0,165.0,144.0,16746908.0,188.0,73.0,D LC,1.0,3.0,3.0,3.0,2.0,3.0,3.0,3.0,3.0,3.0,1.0,8.0,9.0,8.0,5.0,9.0,5.0,16.0,7.0,11.0,14.0,11.0,7.0,15.0,9.0,15.0,14.0,15.0,14.0,13.0,9.0,12.0,15.0,6.0,12.0,8.0,15.0,14.0,15.0,14.0,12.0,16.0,16.0,20.0,16.0,15.0,5.0,16.0,15.0,14.0,14.0,13.0,7.0,12.0,14.0,17.0,10.0,13.0,14.0,14.0,12.0,7.0,SÃÂÃÂ©bastien Bassong,ÃÂÃÂ£6.75m ,Premier League
19/6/2011,Scott Dann,5118396,765,2/14/1987,24,0,0,2,0,4400,6950,6950,158,140,2181818,188,77,D C,1,2,1,1,1,3,3,7,2,1,2,5,6,10,13,11,6,16,6,7,15,12,6,17,12,12,13,17,14,15,12,12,14,4,16,10,15,14,14,9,11,13,13,10,13,12,20,13,13,14,6,12,5,11,10,12,13,12,14,8,12,8,20,1,1,1,10,1,20,D C,101,1,1,10,1,1,1,20,1,10,5,1,1,1,1,1,0.0,0,0,0,0,0,0,0,0,0,0,0,0,0,0,0,0,0,0,0,0,0,0,0,0,0,0,0,0,0,0,0,0,0,0,0,0,0,0,0,0,0,0,0,0,0,0,0,0,Scott Dann,ÃÂ£3.60m ,33.0,194.0,Defender - Centre-Back,right,Crystal Palace,25.0,2.0,1.0,2235.0,28.0,1.0,1.0,2493.0,52.0,5.0,4.0,4600.0,40.0,2.0,3.0,3600.0,37.0,4.0,3.0,3192.0,42.0,5.0,1.0,3810.0,25.0,4.0,1.0,1852.0,18.0,1.0,0.0,1480.0,13.0,0.0,1.0,930.0,Premier League,17.0,0.0,1.0,1353.0,2.0,0.0,0.0,180.0,29/6/2010,Scott Dann,5118396.0,765.0,2/14/1987,23.0,0.0,0.0,2.0,0.0,4400.0,6550.0,6550.0,158.0,140.0,8050000.0,188.0,77.0,D C,1.0,2.0,2.0,2.0,2.0,2.0,3.0,3.0,2.0,1.0,2.0,5.0,6.0,10.0,13.0,11.0,6.0,16.0,6.0,7.0,15.0,12.0,6.0,17.0,12.0,12.0,13.0,17.0,14.0,15.0,12.0,12.0,14.0,4.0,16.0,10.0,15.0,14.0,14.0,9.0,11.0,13.0,13.0,10.0,13.0,12.0,20.0,13.0,13.0,17.0,6.0,12.0,5.0,11.0,10.0,12.0,13.0,12.0,14.0,8.0,12.0,8.0,Scott Dann,ÃÂÃÂ£4.05m ,Premier League
19/6/2011,Rafik Halliche,12004449,5,9/2/1986,24,21,1,10,0,3004,6875,5918,140,125,774177,187,77,D C,2,3,3,3,3,2,2,2,2,2,2,5,7,6,5,12,6,15,7,3,15,10,8,14,11,15,14,14,13,12,8,14,13,7,13,13,14,14,15,9,9,13,14,8,14,12,20,14,14,12,10,12,11,6,10,14,12,12,12,13,10,6,20,1,1,1,1,1,20,D C,101,1,17,1,1,1,1,20,1,1,1,1,1,1,1,1,0.0,0,0,0,0,0,0,0,0,0,0,0,0,0,0,0,0,0,0,0,0,0,0,0,0,0,0,0,0,0,0,0,0,0,0,0,0,0,0,0,0,0,0,0,0,0,0,0,0,Rafik Halliche,ÃÂ£675Th. ,34.0,187.0,Defender - Centre-Back,right,Without Club,3.0,0.0,0.0,33.0,7.0,1.0,0.0,554.0,14.0,0.0,0.0,1010.0,22.0,0.0,0.0,1764.0,21.0,2.0,0.0,1782.0,2.0,0.0,0.0,180.0,1.0,0.0,0.0,90.0,24.0,2.0,0.0,2101.0,23.0,1.0,1.0,1916.0,Premier League,11.0,0.0,1.0,806.0,nan,nan,nan,nan,29/6/2010,Rafik Halliche,12004449.0,5.0,9/2/1986,23.0,5.0,0.0,10.0,0.0,3000.0,6820.0,5750.0,140.0,124.0,7548654.0,187.0,77.0,D C,3.0,1.0,1.0,2.0,2.0,2.0,3.0,4.0,2.0,2.0,1.0,5.0,6.0,7.0,6.0,13.0,7.0,16.0,11.0,11.0,13.0,8.0,9.0,15.0,11.0,15.0,15.0,14.0,14.0,13.0,9.0,15.0,13.0,6.0,13.0,6.0,14.0,15.0,15.0,9.0,10.0,14.0,15.0,8.0,14.0,11.0,20.0,15.0,14.0,12.0,10.0,12.0,11.0,6.0,7.0,14.0,12.0,5.0,12.0,1.0,10.0,6.0,Rafik Halliche,ÃÂÃÂ£1.35m ,Premier League,19-06-17,18.3.4.28,Rafik Halliche,12004449,5,02-Sep-86,30,37,3,10,0,3342,6385,5750,115,115,232186002,186,84,D C,3,3,2,2,3,4,3,3,4,1,1,5,7,6,5,11,6,15,7,3,15,12,8,14,10,15,14,14,13,11,11,12,13,7,13,13,15,14,15,9,7,13,11,8,14,10,20,12,14,12,10,12,11,6,17,14,12,10,12,12,10,6,20,1,1,1,1,1,20,D C,101,1,17,1,1,1,1,20,1,1,1,1,1,1,1,1,0.0,0,0,0,0,0,0,0,0,0,0,0,0,0,0,0,0,0,0,0,0,0,0,0,0,0,0,0,0,0,0,0,0,0,0,0,0,0,0,0,0,0,0,0,0,0,0,0,0,Rafik Halliche,ÃÂ£405Th. ,34.0,187.0,Defender - Centre-Back,right,Without Club,1.0,0.0,0.0,90.0,24.0,2.0,0.0,2101.0,23.0,1.0,1.0,1916.0,11.0,0.0,1.0,806.0,nan,nan,nan,nan,Liga NOS,nan,nan,nan,nan,nan,nan,nan,nan,nan,nan,nan,nan,nan,nan,nan,nan,nan,nan,nan,nan,nan,nan,nan,nan,nan,nan,nan,nan,nan,nan,nan,nan,nan,nan,nan,nan,nan,nan,nan,nan,nan,nan,nan,nan,nan,nan,nan,nan,nan,nan,nan,nan,nan,nan,nan,nan,nan,nan,nan,nan,nan,nan,nan,nan,nan,nan,nan,nan,nan,nan,nan,nan,nan,nan,nan,nan,nan,nan,nan,nan,nan,nan,nan,nan,nan
19/6/2011,Piscu,67044333,796,2/25/1987,24,0,0,0,0,4250,6000,6400,142,123,741944,184,77,D C,1,2,2,3,1,1,3,3,1,2,3,5,6,4,5,11,7,15,7,6,14,10,8,13,9,12,16,13,7,12,7,11,15,6,5,4,12,11,12,13,9,11,13,12,8,15,20,13,12,10,11,10,7,8,13,15,6,6,6,12,11,15,20,1,1,1,5,1,20,D C,101,1,1,1,1,1,1,20,1,5,1,1,1,1,1,1,8589934592.0,0,0,0,0,0,0,0,0,0,0,0,0,0,0,0,0,0,0,0,0,0,0,0,0,0,0,0,0,0,0,0,0,0,1,0,0,0,0,0,0,0,0,0,0,0,0,0,0,nan,nan,nan,nan,nan,nan,nan,nan,nan,nan,nan,nan,nan,nan,nan,nan,nan,nan,nan,nan,nan,nan,nan,nan,nan,nan,nan,nan,nan,nan,nan,nan,nan,nan,nan,nan,nan,nan,nan,nan,nan,nan,nan,nan,nan,nan,nan,nan,nan,nan,nan,nan,nan,nan,nan,nan,nan,nan,nan,nan,nan,nan,nan,nan,nan,nan,nan,nan,nan,nan,nan,nan,nan,nan,nan,nan,nan,nan,nan,nan,nan,nan,nan,nan,nan,nan,nan,nan,nan,nan,nan,nan,nan,nan,nan,nan,nan,nan,nan,nan,nan,nan,nan,nan,nan,nan,nan,nan,nan,nan,nan,nan,nan,nan,nan,nan,nan,nan,nan,nan,nan,nan,nan,nan,nan,nan,nan,nan,nan,nan,nan,nan,nan,nan,nan,nan
19/6/2011,Onyekachi Apam,8632613,38,12/30/1986,24,12,0,10,1,5400,6700,6050,155,134,1270189,177,67,D RC,1,1,2,1,3,2,1,1,3,1,3,5,11,8,6,10,7,12,8,11,14,6,7,15,10,16,16,15,9,12,6,12,15,6,11,9,13,13,16,16,13,15,9,10,10,14,20,15,14,11,16,15,10,10,13,16,12,13,11,11,11,11,20,15,1,1,15,13,20,D RC,103,1,1,1,1,1,1,20,13,15,1,1,1,1,13,15,137439000000.0,0,0,0,0,0,0,0,0,0,0,0,0,0,0,0,1,0,0,0,0,0,0,0,0,0,0,0,0,0,0,0,0,0,0,0,0,0,1,0,0,0,0,0,0,0,0,0,0,Onyekachi Apam,ÃÂ£2.70m ,33.0,180.0,Defender - Centre-Back,right,Without Club,nan,nan,nan,nan,16.0,0.0,0.0,1307.0,15.0,0.0,0.0,1021.0,1.0,0.0,0.0,90.0,nan,nan,nan,nan,nan,nan,nan,nan,nan,nan,nan,nan,nan,nan,nan,nan,nan,nan,nan,nan,Ligue 1,nan,nan,nan,nan,nan,nan,nan,nan,29/6/2010,Onyekachi Apam,8632613.0,38.0,12/30/1986,23.0,12.0,0.0,10.0,1.0,4489.0,6700.0,6000.0,155.0,134.0,8999999.0,177.0,67.0,D RC,3.0,1.0,2.0,3.0,2.0,3.0,2.0,7.0,3.0,3.0,1.0,5.0,11.0,8.0,6.0,10.0,7.0,12.0,8.0,11.0,14.0,6.0,7.0,15.0,10.0,16.0,16.0,15.0,9.0,12.0,6.0,12.0,15.0,6.0,11.0,9.0,13.0,13.0,16.0,16.0,13.0,15.0,9.0,10.0,14.0,14.0,20.0,15.0,14.0,11.0,16.0,15.0,9.0,10.0,13.0,16.0,12.0,13.0,11.0,11.0,11.0,11.0,Onyekachi Apam,ÃÂÃÂ£3.60m ,Ligue 1
19/6/2011,Niko Bungert,8728048,771,10/24/1986,24,0,0,3,0,4150,6600,6600,135,132,21143,188,68,D RC,3,3,3,2,2,3,3,1,1,1,2,3,11,5,5,13,3,12,5,7,16,13,5,13,11,11,16,11,10,13,11,13,13,11,9,7,15,14,12,14,16,13,15,5,12,14,20,12,13,11,6,10,6,10,12,14,7,8,11,15,8,7,20,1,1,1,16,12,20,D RC,103,1,1,1,1,1,1,20,12,16,8,1,1,1,1,1,274878000000.0,0,0,0,0,0,0,0,0,0,0,0,0,0,0,0,0,0,0,0,0,0,0,0,0,0,0,0,0,0,0,0,0,0,0,0,0,0,0,1,0,0,0,0,0,0,0,0,0,Niko Bungert,ÃÂ£3.15m ,34.0,188.0,Defender - Centre-Back,right,Retired,29.0,1.0,1.0,2364.0,34.0,4.0,1.0,2963.0,11.0,0.0,0.0,859.0,10.0,1.0,0.0,500.0,27.0,2.0,1.0,2176.0,24.0,1.0,0.0,2008.0,14.0,2.0,0.0,1147.0,0.0,0.0,0.0,0.0,8.0,0.0,0.0,288.0,Bundesliga,nan,nan,nan,nan,nan,nan,nan,nan,29/6/2010,Niko Bungert,8728048.0,771.0,10/24/1986,23.0,0.0,0.0,3.0,0.0,3250.0,6250.0,6250.0,135.0,125.0,2755092.0,188.0,68.0,D RC,2.0,2.0,2.0,1.0,1.0,1.0,2.0,1.0,2.0,2.0,1.0,3.0,11.0,5.0,5.0,13.0,3.0,12.0,5.0,7.0,16.0,13.0,5.0,12.0,11.0,11.0,16.0,11.0,8.0,14.0,9.0,13.0,13.0,9.0,6.0,4.0,12.0,14.0,12.0,14.0,16.0,11.0,15.0,5.0,12.0,14.0,20.0,12.0,13.0,11.0,6.0,6.0,4.0,10.0,12.0,14.0,7.0,8.0,11.0,15.0,8.0,7.0,Niko Bungert,ÃÂÃÂ£2.25m ,Bundesliga,19-06-17,18.3.4.28,Niko Bungert,8728048,771,24-Oct-86,30,0,0,3,0,4300,6050,6300,129,121,4996827,188,77,D C,2,1,3,3,3,1,2,1,3,1,3,4,7,6,5,8,4,15,6,12,14,9,5,13,8,11,13,12,10,16,7,12,13,4,13,7,14,16,11,13,12,11,14,8,11,15,20,12,11,16,6,13,14,13,4,10,17,12,16,16,14,4,20,10,1,1,14,10,20,D C,101,1,1,1,1,1,1,20,10,14,8,1,1,1,6,10,274878000000.0,0,0,0,0,0,0,0,0,0,0,0,0,0,0,0,0,0,0,0,0,0,0,0,0,0,0,0,0,0,0,0,0,0,0,0,0,0,0,1,0,0,0,0,0,0,0,0,0,Niko Bungert,ÃÂ£450Th. ,34.0,188.0,Defender - Centre-Back,right,Retired,14.0,2.0,0.0,1147.0,0.0,0.0,0.0,0.0,8.0,0.0,0.0,288.0,nan,nan,nan,nan,nan,nan,nan,nan,Bundesliga,15-07-16,17.3.2.23,Niko Bungert,8728048.0,771.0,24-Oct-86,29.0,0.0,0.0,3.0,0.0,4151.0,6400.0,6650.0,129.0,128.0,6361765.0,188.0,77.0,D RC,3.0,2.0,3.0,3.0,1.0,1.0,2.0,1.0,1.0,2.0,1.0,4.0,7.0,6.0,5.0,8.0,4.0,15.0,6.0,12.0,16.0,9.0,5.0,15.0,8.0,12.0,14.0,12.0,9.0,15.0,7.0,11.0,12.0,4.0,10.0,7.0,14.0,18.0,12.0,14.0,12.0,11.0,14.0,8.0,12.0,16.0,20.0,15.0,11.0,16.0,6.0,13.0,12.0,13.0,6.0,10.0,17.0,9.0,15.0,16.0,14.0,4.0,Niko Bungert,ÃÂ£1.13m ,Bundesliga
19/6/2011,NicolÃÂ² Cherubin,1402118,776,12/2/1986,24,0,0,0,0,3250,5950,5950,138,121,356658,188,83,D RC,1,1,1,1,1,1,1,1,1,1,1,4,6,6,6,10,6,17,7,10,14,9,7,16,10,12,14,11,8,11,8,11,14,6,12,5,13,14,14,12,11,14,16,6,14,12,20,12,15,15,12,13,4,16,6,12,18,10,14,12,8,4,20,1,1,1,15,14,20,D RC,103,1,10,1,1,1,1,20,14,15,1,1,1,1,1,1,0.0,0,0,0,0,0,0,0,0,0,0,0,0,0,0,0,0,0,0,0,0,0,0,0,0,0,0,0,0,0,0,0,0,0,0,0,0,0,0,0,0,0,0,0,0,0,0,0,0,NicolÃÂ² Cherubin,ÃÂ£900Th. ,33.0,188.0,Defender - Centre-Back,left,SS Arezzo,15.0,0.0,2.0,1147.0,23.0,1.0,0.0,1650.0,30.0,1.0,1.0,2626.0,15.0,1.0,0.0,1134.0,13.0,0.0,0.0,1010.0,16.0,1.0,0.0,1208.0,5.0,0.0,1.0,450.0,10.0,0.0,0.0,809.0,15.0,0.0,0.0,1305.0,Serie A,5.0,0.0,0.0,229.0,1.0,0.0,0.0,90.0,29/6/2010,NicolÃÂ² Cherubin,1402118.0,776.0,12/2/1986,23.0,0.0,0.0,0.0,0.0,1750.0,5500.0,5500.0,135.0,111.0,1986151.0,188.0,83.0,D RC,1.0,1.0,1.0,1.0,1.0,1.0,1.0,1.0,1.0,1.0,1.0,2.0,4.0,4.0,4.0,8.0,4.0,15.0,5.0,8.0,13.0,7.0,5.0,14.0,8.0,12.0,14.0,11.0,8.0,11.0,8.0,11.0,14.0,6.0,14.0,5.0,13.0,14.0,14.0,12.0,11.0,14.0,16.0,6.0,14.0,12.0,20.0,12.0,15.0,15.0,12.0,13.0,4.0,14.0,5.0,12.0,18.0,10.0,14.0,12.0,8.0,4.0,NicolÃÂÃÂ² Cherubin,ÃÂÃÂ£1.17m ,Serie A
19/6/2011,Nicola Belmonte,7990575,776,4/15/1987,24,0,0,0,0,3000,6000,6000,137,120,409880,183,77,D RC,3,3,1,2,1,1,1,2,3,3,3,5,9,8,5,9,5,13,7,12,14,10,7,14,7,13,14,11,8,13,6,12,14,5,8,13,14,11,12,13,12,12,13,10,12,13,20,12,14,13,7,10,12,15,12,15,12,10,15,9,10,2,20,7,1,1,20,14,18,D RC,103,1,1,1,1,1,1,18,14,20,1,1,1,1,1,7,64.0,0,0,0,0,0,0,1,0,0,0,0,0,0,0,0,0,0,0,0,0,0,0,0,0,0,0,0,0,0,0,0,0,0,0,0,0,0,0,0,0,0,0,0,0,0,0,0,0,Nicola Belmonte,ÃÂ£540Th. ,33.0,183.0,Defender - Centre-Back,right,Retired,28.0,0.0,0.0,2263.0,7.0,0.0,0.0,422.0,8.0,0.0,0.0,587.0,21.0,1.0,0.0,1771.0,13.0,0.0,1.0,872.0,31.0,2.0,0.0,2632.0,28.0,1.0,2.0,2166.0,24.0,1.0,2.0,1906.0,3.0,0.0,0.0,270.0,Serie A,nan,nan,nan,nan,nan,nan,nan,nan,29/6/2010,Nicola Belmonte,7990575.0,776.0,4/15/1987,23.0,0.0,0.0,0.0,0.0,1000.0,5300.0,5300.0,130.0,121.0,2624222.0,183.0,77.0,D R,3.0,2.0,2.0,1.0,2.0,2.0,2.0,1.0,2.0,3.0,1.0,5.0,9.0,8.0,5.0,9.0,5.0,13.0,7.0,12.0,14.0,10.0,7.0,14.0,7.0,13.0,14.0,11.0,8.0,13.0,6.0,12.0,14.0,5.0,8.0,13.0,14.0,11.0,12.0,13.0,12.0,12.0,13.0,10.0,12.0,13.0,20.0,12.0,15.0,13.0,7.0,10.0,12.0,15.0,12.0,15.0,12.0,10.0,15.0,9.0,10.0,2.0,Nicola Belmonte,ÃÂÃÂ£720Th. ,Serie A
19/6/2011,Nedum Onuoha,5114013,765,11/30/1986,24,0,0,21,2,4500,6505,6505,152,135,1382297,183,93,D RC,3,3,2,1,2,1,3,1,2,1,3,4,4,7,4,7,4,15,5,13,14,7,5,15,8,12,10,13,10,13,8,10,12,4,11,7,14,13,10,20,14,12,12,7,16,18,20,17,14,11,2,8,16,12,11,14,15,13,18,16,15,2,20,10,1,1,18,10,20,D RC,103,1,1,1,1,1,1,20,10,18,1,1,1,1,1,10,0.0,0,0,0,0,0,0,0,0,0,0,0,0,0,0,0,0,0,0,0,0,0,0,0,0,0,0,0,0,0,0,0,0,0,0,0,0,0,0,0,0,0,0,0,0,0,0,0,0,Nedum Onuoha,ÃÂ£3.60m ,33.0,183.0,Defender - Centre-Back,right,Real Salt Lake City,32.0,1.0,2.0,2758.0,19.0,0.0,1.0,1629.0,26.0,0.0,0.0,1809.0,31.0,2.0,0.0,2616.0,25.0,0.0,0.0,2106.0,48.0,3.0,2.0,4320.0,47.0,3.0,2.0,4168.0,36.0,0.0,1.0,3040.0,30.0,1.0,0.0,2528.0,Premier League,12.0,0.0,0.0,1080.0,nan,nan,nan,nan,29/6/2010,Nedum Onuoha,5114013.0,765.0,11/30/1986,23.0,0.0,0.0,21.0,2.0,4500.0,6750.0,6750.0,152.0,135.0,4173096.0,183.0,93.0,D RC,1.0,3.0,1.0,1.0,2.0,3.0,1.0,6.0,2.0,2.0,1.0,4.0,4.0,7.0,4.0,7.0,4.0,15.0,5.0,13.0,14.0,7.0,5.0,15.0,8.0,12.0,10.0,13.0,10.0,12.0,8.0,10.0,14.0,4.0,13.0,7.0,14.0,13.0,10.0,20.0,14.0,12.0,12.0,7.0,16.0,18.0,20.0,17.0,15.0,13.0,2.0,12.0,16.0,12.0,11.0,14.0,15.0,13.0,18.0,15.0,14.0,2.0,Nedum Onuoha,ÃÂÃÂ£5.40m ,Premier League
19/6/2011,Modibo DiakitÃÂ©,1408579,769,3/2/1987,24,0,0,0,0,3000,5714,6350,146,127,318634,192,84,D RC,2,3,3,3,2,3,3,1,2,2,3,2,2,6,6,4,2,16,4,14,14,8,6,16,6,15,13,14,10,12,4,10,12,3,6,8,14,11,14,14,11,17,17,7,7,13,20,15,18,12,15,12,10,11,9,12,11,12,11,12,14,8,20,1,1,1,15,1,20,D RC,103,1,10,1,1,1,1,20,1,15,1,1,1,1,1,1,292058000000.0,0,0,0,0,0,0,1,0,0,0,0,0,0,0,0,1,0,0,0,0,0,0,0,0,0,0,0,0,0,0,0,0,0,0,1,0,0,0,1,0,0,0,0,0,0,0,0,0,Modibo DiakitÃÂ©,ÃÂ£4.50m ,33.0,192.0,Defender - Centre-Back,right,Ternana Calcio,10.0,0.0,0.0,513.0,36.0,1.0,3.0,2830.0,1.0,0.0,0.0,83.0,20.0,0.0,0.0,1744.0,12.0,0.0,1.0,985.0,27.0,1.0,0.0,2390.0,15.0,1.0,0.0,1182.0,11.0,0.0,0.0,717.0,28.0,2.0,0.0,2356.0,Serie A,14.0,0.0,0.0,844.0,5.0,0.0,0.0,427.0,29/6/2010,Modibo DiakitÃÂ©,1408579.0,769.0,3/2/1987,23.0,0.0,0.0,0.0,0.0,3000.0,5894.0,6500.0,153.0,131.0,4459425.0,192.0,84.0,D RC,1.0,1.0,2.0,3.0,1.0,3.0,2.0,1.0,1.0,3.0,1.0,2.0,2.0,6.0,6.0,4.0,2.0,17.0,4.0,15.0,14.0,8.0,6.0,15.0,6.0,15.0,13.0,14.0,10.0,12.0,4.0,10.0,12.0,3.0,6.0,8.0,14.0,11.0,14.0,15.0,11.0,17.0,18.0,7.0,7.0,13.0,20.0,15.0,18.0,12.0,15.0,12.0,10.0,11.0,10.0,12.0,11.0,12.0,11.0,12.0,14.0,8.0,Modibo DiakitÃÂÃÂ©,ÃÂÃÂ£1.35m ,Serie A
19/6/2011,Mehdi Benatia,8443128,34,4/17/1987,24,15,1,0,0,4267,6915,7200,160,143,1230480,189,84,D RC,3,3,3,2,3,1,2,8,3,1,1,4,8,8,8,11,6,15,8,7,17,12,7,14,12,14,16,16,14,14,10,12,16,8,14,8,13,13,15,13,12,16,15,8,13,12,20,15,15,14,13,16,11,10,13,17,10,13,14,14,11,12,20,8,1,1,16,1,20,D RC,103,1,13,1,1,1,1,20,1,16,5,1,1,1,1,8,0.0,0,0,0,0,0,0,0,0,0,0,0,0,0,0,0,0,0,0,0,0,0,0,0,0,0,0,0,0,0,0,0,0,0,0,0,0,0,0,0,0,0,0,0,0,0,0,0,0,Medhi Benatia,ÃÂ£12.15m ,33.0,190.0,Defender - Centre-Back,right,Al-Duhail SC,34.0,3.0,0.0,3043.0,38.0,2.0,0.0,3238.0,25.0,2.0,1.0,2114.0,37.0,5.0,0.0,3131.0,24.0,2.0,1.0,1860.0,22.0,1.0,2.0,1333.0,21.0,1.0,0.0,1456.0,32.0,4.0,0.0,2637.0,20.0,2.0,0.0,1604.0,Serie A,24.0,0.0,0.0,2033.0,3.0,0.0,0.0,225.0,29/6/2010,Medhi Benatia,8443128.0,34.0,4/17/1987,23.0,6.0,0.0,0.0,0.0,2600.0,6150.0,4050.0,150.0,123.0,30853893.0,190.0,80.0,D RC,1.0,3.0,3.0,3.0,2.0,2.0,2.0,1.0,2.0,1.0,3.0,5.0,8.0,8.0,6.0,11.0,7.0,14.0,9.0,7.0,16.0,10.0,7.0,12.0,11.0,12.0,14.0,15.0,13.0,12.0,10.0,12.0,14.0,8.0,12.0,7.0,13.0,13.0,14.0,13.0,8.0,16.0,15.0,8.0,13.0,10.0,20.0,15.0,16.0,14.0,12.0,16.0,11.0,8.0,14.0,17.0,8.0,13.0,14.0,14.0,11.0,12.0,Medhi Benatia,ÃÂÃÂ£4.50m ,Serie A,19-06-17,18.3.4.28,Medhi Benatia,8443128,34,17-Apr-87,30,49,1,4,0,6250,7600,8000,159,154,232186002,189,94,D C,2,3,1,3,1,1,2,2,3,1,3,4,8,11,9,13,4,15,9,10,17,12,7,16,12,12,17,15,13,14,8,13,16,7,12,8,15,12,12,11,12,18,16,9,13,15,20,14,17,14,8,16,14,6,15,15,8,13,14,13,11,13,20,1,1,1,1,1,20,D C,101,1,13,1,1,1,1,20,1,1,1,1,1,1,1,1,274878000000.0,0,0,0,0,0,0,0,0,0,0,0,0,0,0,0,1,0,0,0,0,0,0,0,0,0,0,0,0,0,0,0,0,0,0,0,0,0,0,1,0,0,0,0,0,0,0,0,0,Medhi Benatia,ÃÂ£20.70m ,33.0,190.0,Defender - Centre-Back,right,Al-Duhail SC,21.0,1.0,0.0,1456.0,32.0,4.0,0.0,2637.0,20.0,2.0,0.0,1604.0,24.0,0.0,0.0,2033.0,3.0,0.0,0.0,225.0,Serie A,15-07-16,17.3.2.23,Medhi Benatia,8443128.0,34.0,17-Apr-87,29.0,42.0,1.0,4.0,0.0,6300.0,7800.0,7850.0,159.0,157.0,63930105.0,190.0,92.0,D C,2.0,1.0,1.0,2.0,2.0,3.0,3.0,2.0,3.0,1.0,1.0,4.0,8.0,11.0,9.0,13.0,4.0,14.0,9.0,10.0,18.0,12.0,7.0,18.0,12.0,12.0,17.0,15.0,13.0,14.0,9.0,12.0,16.0,7.0,12.0,8.0,15.0,13.0,12.0,11.0,12.0,18.0,17.0,9.0,13.0,14.0,20.0,14.0,17.0,16.0,8.0,16.0,14.0,6.0,15.0,17.0,8.0,13.0,14.0,13.0,11.0,13.0,Medhi Benatia,ÃÂ£13.50m ,Serie A
19/6/2011,MartÃÂ­n CÃÂ¡ceres,78010878,1657,4/7/1987,24,33,1,11,0,6000,7550,7100,156,145,7905138,182,77,D RC,1,1,3,2,3,2,1,1,3,1,1,6,9,10,8,11,5,15,9,14,14,11,7,15,11,16,14,16,11,14,8,12,14,7,13,9,13,14,15,15,14,15,12,12,13,15,20,15,14,13,12,14,16,16,16,12,12,10,14,13,12,5,20,13,6,1,19,13,20,D RC,103,1,12,1,1,1,1,20,13,19,1,1,1,6,5,13,137439000000.0,0,0,0,0,0,0,0,0,0,0,0,0,0,0,0,0,0,0,0,0,0,0,0,0,0,0,0,0,0,0,0,0,0,0,0,0,0,1,0,0,0,0,0,0,0,0,0,0,MartÃÂ­n CÃÂ¡ceres,ÃÂ£8.55m ,33.0,180.0,Defender - Centre-Back,right,ACF Fiorentina,37.0,1.0,4.0,3132.0,32.0,4.0,2.0,2455.0,22.0,1.0,0.0,1494.0,30.0,1.0,1.0,2377.0,14.0,1.0,1.0,1047.0,9.0,0.0,0.0,719.0,4.0,0.0,0.0,360.0,25.0,4.0,1.0,2001.0,17.0,0.0,0.0,1278.0,Serie A,30.0,2.0,0.0,2480.0,5.0,0.0,0.0,450.0,29/6/2010,MartÃÂ­n CÃÂ¡ceres,78010878.0,1657.0,4/7/1987,23.0,20.0,0.0,11.0,0.0,5000.0,7550.0,7100.0,160.0,145.0,4986821.0,182.0,77.0,D C,2.0,1.0,3.0,1.0,1.0,3.0,1.0,1.0,3.0,1.0,1.0,6.0,9.0,8.0,8.0,11.0,5.0,14.0,9.0,14.0,14.0,11.0,7.0,15.0,12.0,16.0,13.0,14.0,11.0,14.0,8.0,12.0,12.0,7.0,13.0,9.0,12.0,14.0,15.0,15.0,14.0,15.0,12.0,12.0,13.0,15.0,20.0,15.0,14.0,13.0,9.0,14.0,16.0,16.0,16.0,12.0,12.0,10.0,14.0,13.0,12.0,5.0,MartÃÂÃÂ­n CÃÂÃÂ¡ceres,ÃÂÃÂ£6.30m ,LaLiga,19-06-17,18.3.4.28,MartÃÂ­n CÃÂ¡ceres,78010878,1657,07-Apr-87,30,69,3,11,0,5931,7958,6800,155,138,16734565,180,78,D/WB RC,3,3,3,3,3,2,3,1,1,1,3,3,10,10,7,11,2,14,9,12,13,10,5,15,11,16,14,18,13,14,9,12,15,10,11,11,15,14,15,11,13,16,13,12,6,11,20,15,15,14,12,14,17,16,17,12,12,13,10,13,12,5,20,17,8,1,20,13,18,D/WB RC,113,1,1,1,1,1,1,18,13,20,1,1,1,8,8,17,137439000000.0,0,0,0,0,0,0,0,0,0,0,0,0,0,0,0,0,0,0,0,0,0,0,0,0,0,0,0,0,0,0,0,0,0,0,0,0,0,1,0,0,0,0,0,0,0,0,0,0,MartÃÂ­n CÃÂ¡ceres,ÃÂ£2.25m ,33.0,180.0,Defender - Centre-Back,right,ACF Fiorentina,4.0,0.0,0.0,360.0,25.0,4.0,1.0,2001.0,17.0,0.0,0.0,1278.0,30.0,2.0,0.0,2480.0,5.0,0.0,0.0,450.0,Serie A,15-07-16,17.3.2.23,MartÃÂ­n CÃÂ¡ceres,78010878.0,1657.0,07-Apr-87,29.0,69.0,3.0,11.0,0.0,5915.0,7936.0,6800.0,155.0,136.0,12109777.0,180.0,78.0,D RC,2.0,4.0,3.0,3.0,1.0,3.0,1.0,3.0,2.0,1.0,2.0,2.0,11.0,10.0,6.0,10.0,1.0,14.0,8.0,11.0,13.0,10.0,4.0,15.0,10.0,16.0,14.0,18.0,11.0,13.0,8.0,11.0,15.0,10.0,11.0,10.0,14.0,13.0,15.0,10.0,12.0,15.0,12.0,12.0,6.0,13.0,20.0,14.0,14.0,14.0,12.0,14.0,17.0,16.0,17.0,12.0,12.0,13.0,10.0,13.0,12.0,5.0,MartÃÂ­n CÃÂ¡ceres,ÃÂ£3.60m ,Premier League
19/6/2011,MartÃÂ­ CrespÃÂ­,67006016,796,6/15/1987,24,0,0,0,0,3900,5750,5750,137,118,225744,180,71,D C,3,3,2,1,1,1,1,1,1,1,3,5,4,6,7,7,14,13,14,9,14,11,7,14,9,14,14,13,13,13,6,12,8,5,11,7,13,12,11,12,7,13,11,7,11,14,20,15,13,14,14,12,8,15,10,3,8,5,6,10,14,20,20,1,1,1,7,1,20,D C,101,1,8,1,1,1,1,20,1,7,10,1,1,1,1,1,8796090000000.0,0,0,0,0,0,0,0,0,0,1,0,0,0,0,0,0,0,0,0,0,0,0,0,0,0,0,0,0,0,0,0,0,0,0,0,0,0,0,0,0,0,0,0,1,0,0,0,0,MartÃÂ­ CrespÃÂ­,ÃÂ£900Th. ,33.0,185.0,Defender - Centre-Back,right,Without Club,9.0,0.0,0.0,633.0,12.0,0.0,0.0,862.0,17.0,0.0,0.0,1515.0,31.0,2.0,1.0,2364.0,26.0,0.0,0.0,1910.0,29.0,10.0,2.0,2610.0,29.0,3.0,2.0,2455.0,3.0,0.0,0.0,270.0,20.0,0.0,0.0,1713.0,LaLiga,8.0,1.0,0.0,720.0,nan,nan,nan,nan,29/6/2010,MartÃÂ­ CrespÃÂ­,67006016.0,796.0,6/15/1987,23.0,0.0,0.0,0.0,0.0,3250.0,5050.0,5050.0,139.0,117.0,623387.0,180.0,71.0,D C,3.0,1.0,3.0,1.0,1.0,2.0,1.0,5.0,2.0,3.0,1.0,5.0,4.0,6.0,7.0,7.0,14.0,13.0,14.0,9.0,14.0,11.0,7.0,14.0,9.0,14.0,14.0,13.0,13.0,13.0,6.0,14.0,8.0,5.0,11.0,7.0,13.0,12.0,11.0,12.0,7.0,13.0,11.0,7.0,11.0,14.0,20.0,16.0,13.0,14.0,14.0,12.0,8.0,15.0,13.0,14.0,12.0,6.0,10.0,16.0,10.0,1.0,MartÃÂÃÂ­ CrespÃÂÃÂ­,ÃÂÃÂ£1.08m ,LaLiga
19/6/2011,Leonardo Bonucci,1410956,776,5/1/1987,24,11,2,0,0,5750,7400,6900,153,138,1659824,190,81,D C,1,3,1,2,1,2,1,3,3,2,1,2,3,12,9,12,3,14,3,7,16,13,4,15,12,11,13,14,13,14,11,10,13,13,10,7,13,14,13,12,11,15,16,9,11,13,20,15,14,14,9,15,5,11,14,19,16,16,18,15,12,3,20,1,1,1,9,5,20,D C,101,1,10,1,1,1,1,20,5,9,1,1,1,1,1,1,8796090000000.0,0,0,0,0,0,0,0,0,0,0,0,0,0,0,0,0,0,0,0,0,0,0,0,0,0,0,0,0,0,0,0,0,0,0,0,0,0,0,0,0,0,0,0,1,0,0,0,0,Leonardo Bonucci,ÃÂ£12.15m ,33.0,190.0,Defender - Centre-Back,right,Juventus FC,44.0,3.0,1.0,3783.0,37.0,2.0,1.0,3147.0,48.0,1.0,0.0,4324.0,44.0,3.0,3.0,3797.0,52.0,4.0,0.0,4694.0,49.0,3.0,1.0,4386.0,45.0,5.0,1.0,3741.0,51.0,2.0,1.0,4501.0,41.0,3.0,3.0,3550.0,Serie A,47.0,4.0,0.0,4165.0,5.0,1.0,0.0,435.0,29/6/2010,Leonardo Bonucci,1410956.0,776.0,5/1/1987,23.0,2.0,1.0,0.0,0.0,5000.0,7000.0,7000.0,163.0,148.0,64012671.0,190.0,81.0,D C,1.0,2.0,1.0,3.0,1.0,3.0,3.0,1.0,3.0,3.0,1.0,4.0,7.0,9.0,9.0,10.0,4.0,15.0,4.0,7.0,16.0,10.0,4.0,16.0,12.0,11.0,13.0,15.0,13.0,14.0,11.0,13.0,17.0,4.0,10.0,7.0,15.0,14.0,14.0,12.0,11.0,15.0,16.0,10.0,11.0,13.0,20.0,15.0,14.0,14.0,9.0,15.0,11.0,11.0,14.0,19.0,16.0,17.0,18.0,15.0,12.0,3.0,Leonardo Bonucci,ÃÂÃÂ£12.15m ,Serie A,19-06-17,18.3.4.28,Leonardo Bonucci,1410956,776,01-May-87,30,70,5,0,0,8000,8550,8550,174,171,232186002,190,85,D C,2,1,1,1,2,1,2,1,3,1,3,9,9,12,12,13,12,14,12,8,17,17,13,16,13,11,20,17,14,15,15,12,18,13,19,7,20,16,14,11,13,16,14,9,15,14,20,16,15,18,11,13,5,11,14,16,10,14,18,14,9,3,20,1,1,1,1,1,20,D C,101,1,19,1,1,1,1,20,1,1,6,1,1,1,1,1,44256400000000.0,0,0,0,0,0,0,0,0,0,0,0,0,0,0,0,0,0,1,0,0,0,0,0,0,0,0,0,0,0,0,1,0,0,0,0,0,0,0,1,0,0,0,0,1,0,1,0,0,Leonardo Bonucci,ÃÂ£31.50m ,33.0,190.0,Defender - Centre-Back,right,Juventus FC,45.0,5.0,1.0,3741.0,51.0,2.0,1.0,4501.0,41.0,3.0,3.0,3550.0,47.0,4.0,0.0,4165.0,5.0,1.0,0.0,435.0,Serie A,15-07-16,17.3.2.23,Leonardo Bonucci,1410956.0,776.0,01-May-87,29.0,62.0,4.0,0.0,0.0,7500.0,8500.0,8650.0,174.0,173.0,105352460.0,190.0,86.0,D C,1.0,2.0,1.0,1.0,1.0,1.0,2.0,1.0,1.0,1.0,2.0,9.0,9.0,12.0,9.0,13.0,12.0,14.0,12.0,8.0,16.0,17.0,13.0,15.0,13.0,11.0,20.0,16.0,14.0,16.0,19.0,12.0,17.0,13.0,19.0,7.0,20.0,16.0,14.0,14.0,13.0,15.0,14.0,9.0,15.0,14.0,20.0,16.0,15.0,16.0,11.0,14.0,5.0,11.0,14.0,15.0,16.0,14.0,18.0,14.0,9.0,3.0,Leonardo Bonucci,ÃÂ£40.50m ,Serie A
19/6/2011,Lamine SanÃÂ©,85032367,41,3/22/1987,24,3,0,0,0,5050,6250,5600,145,125,505280,192,77,D/DM RC,3,3,2,1,2,3,3,8,2,2,1,5,7,8,6,8,5,15,10,11,14,7,7,13,9,14,14,15,12,10,9,11,16,6,9,7,12,13,16,15,11,16,17,5,14,14,20,15,16,13,14,14,7,8,15,14,11,13,12,14,14,7,20,10,10,1,15,1,20,D/DM RC,113,1,1,1,1,1,1,20,1,15,17,10,1,1,1,10,4503870000000000.0,0,0,0,0,0,0,0,0,0,0,0,0,0,0,0,0,0,0,0,0,0,0,0,0,0,0,0,0,0,0,0,0,0,0,0,0,0,0,1,0,0,0,0,0,0,0,0,0,Lamine SanÃÂ©,ÃÂ£4.05m ,33.0,192.0,Defender - Centre-Back,right,Without Club,37.0,2.0,2.0,3278.0,34.0,2.0,2.0,2933.0,48.0,2.0,0.0,4324.0,45.0,2.0,0.0,4080.0,25.0,1.0,1.0,2140.0,21.0,0.0,1.0,1562.0,28.0,1.0,1.0,2454.0,29.0,2.0,0.0,2368.0,30.0,0.0,0.0,2694.0,Ligue 1,1.0,0.0,0.0,1.0,nan,nan,nan,nan,29/6/2010,Ludovic SanÃÂ©,85032367.0,769.0,3/22/1987,23.0,0.0,0.0,0.0,0.0,4096.0,5759.0,5750.0,150.0,128.0,4353438.0,192.0,77.0,D RC,1.0,3.0,1.0,2.0,1.0,2.0,3.0,6.0,1.0,1.0,3.0,6.0,8.0,8.0,7.0,9.0,5.0,15.0,10.0,5.0,14.0,8.0,7.0,14.0,9.0,14.0,14.0,15.0,13.0,14.0,7.0,11.0,15.0,5.0,9.0,8.0,14.0,12.0,15.0,15.0,10.0,16.0,16.0,5.0,14.0,13.0,20.0,15.0,15.0,14.0,13.0,14.0,7.0,6.0,6.0,14.0,11.0,14.0,13.0,14.0,14.0,7.0,nan,nan,nan,19-06-17,18.3.4.28,Lamine SanÃÂ©,85032367,41,22-Mar-87,30,35,0,0,0,4950,5950,6450,134,129,6342269,192,77,D C,3,1,3,2,2,3,1,1,4,1,1,5,8,8,7,9,6,11,9,12,14,10,7,15,10,14,13,17,9,13,10,11,13,7,14,8,12,10,13,13,11,17,18,6,12,15,20,13,16,13,14,16,14,12,9,12,15,10,10,11,8,15,20,10,15,1,14,1,20,D C,101,1,1,1,1,1,1,20,1,14,15,15,1,1,1,10,0.0,0,0,0,0,0,0,0,0,0,0,0,0,0,0,0,0,0,0,0,0,0,0,0,0,0,0,0,0,0,0,0,0,0,0,0,0,0,0,0,0,0,0,0,0,0,0,0,0,Lamine SanÃÂ©,ÃÂ£1.80m ,33.0,192.0,Defender - Centre-Back,right,Without Club,28.0,1.0,1.0,2454.0,29.0,2.0,0.0,2368.0,30.0,0.0,0.0,2694.0,1.0,0.0,0.0,1.0,nan,nan,nan,nan,Bundesliga,15-07-16,17.3.2.23,Lamine SanÃÂ©,85032367.0,41.0,22-Mar-87,29.0,35.0,0.0,0.0,0.0,4950.0,6450.0,6450.0,134.0,129.0,4809840.0,192.0,77.0,D C,4.0,3.0,1.0,3.0,1.0,1.0,1.0,1.0,3.0,2.0,1.0,5.0,8.0,8.0,7.0,9.0,6.0,11.0,9.0,12.0,14.0,10.0,7.0,15.0,10.0,14.0,13.0,17.0,9.0,13.0,10.0,11.0,13.0,7.0,14.0,8.0,12.0,10.0,13.0,13.0,11.0,17.0,18.0,6.0,12.0,15.0,20.0,13.0,16.0,13.0,14.0,16.0,14.0,12.0,9.0,12.0,15.0,10.0,10.0,11.0,8.0,15.0,Lamine SanÃÂ©,ÃÂ£3.15m ,Bundesliga
19/6/2011,JosÃÂ© ÃÂngel Crespo,1507727,796,2/9/1987,24,0,0,4,0,4500,6250,6250,140,125,946524,185,72,D/WB RLC,2,3,2,1,2,2,2,3,1,1,2,9,9,10,7,11,6,15,6,14,13,10,5,12,7,14,14,15,11,12,7,11,13,7,10,7,13,15,15,14,15,13,14,8,14,13,20,14,13,11,11,13,12,13,13,12,13,11,13,12,12,7,20,16,1,1,20,18,15,D/WB RLC,116,1,1,1,1,1,1,15,18,20,1,1,1,1,15,16,0.0,0,0,0,0,0,0,0,0,0,0,0,0,0,0,0,0,0,0,0,0,0,0,0,0,0,0,0,0,0,0,0,0,0,0,0,0,0,0,0,0,0,0,0,0,0,0,0,0,JosÃÂ© Crespo,ÃÂ£900Th. ,33.0,183.0,Defender - Centre-Back,right,PAOK Thessaloniki,43.0,1.0,3.0,3555.0,10.0,0.0,0.0,622.0,17.0,0.0,0.0,1156.0,11.0,1.0,0.0,665.0,29.0,0.0,0.0,2298.0,14.0,0.0,0.0,1169.0,49.0,1.0,0.0,4108.0,32.0,2.0,3.0,2720.0,49.0,1.0,1.0,4249.0,Serie A,20.0,2.0,2.0,1731.0,6.0,0.0,0.0,339.0,nan,nan,nan,nan,nan,nan,nan,nan,nan,nan,nan,nan,nan,nan,nan,nan,nan,nan,nan,nan,nan,nan,nan,nan,nan,nan,nan,nan,nan,nan,nan,nan,nan,nan,nan,nan,nan,nan,nan,nan,nan,nan,nan,nan,nan,nan,nan,nan,nan,nan,nan,nan,nan,nan,nan,nan,nan,nan,nan,nan,nan,nan,nan,nan,nan,nan,nan,nan,nan,nan,nan,nan,nan,nan,nan,nan,nan,nan,nan,nan,nan,nan,nan,nan
19/6/2011,Jordi,67011219,796,5/16/1987,24,0,0,0,0,3250,6000,6000,135,119,242154,185,82,D C,2,1,3,2,2,1,1,2,1,3,1,5,8,10,5,11,7,15,9,9,13,12,5,12,12,12,12,13,11,12,7,11,10,8,12,5,14,13,12,13,7,13,14,20,10,14,5,14,14,11,8,10,6,6,11,15,11,11,9,11,5,16,20,1,1,1,1,13,20,D C,101,1,10,1,1,1,1,20,13,1,10,1,1,1,1,1,0.0,0,0,0,0,0,0,0,0,0,0,0,0,0,0,0,0,0,0,0,0,0,0,0,0,0,0,0,0,0,0,0,0,0,0,0,0,0,0,0,0,0,0,0,0,0,0,0,0,nan,nan,nan,nan,nan,nan,nan,nan,nan,nan,nan,nan,nan,nan,nan,nan,nan,nan,nan,nan,nan,nan,nan,nan,nan,nan,nan,nan,nan,nan,nan,nan,nan,nan,nan,nan,nan,nan,nan,nan,nan,nan,nan,nan,nan,nan,nan,nan,nan,nan,nan,nan,nan,nan,nan,nan,nan,nan,nan,nan,nan,nan,nan,nan,nan,nan,nan,nan,nan,nan,nan,nan,nan,nan,nan,nan,nan,nan,nan,nan,nan,nan,nan,nan,nan,nan,nan,nan,nan,nan,nan,nan,nan,nan,nan,nan,nan,nan,nan,nan,nan,nan,nan,nan,nan,nan,nan,nan,nan,nan,nan,nan,nan,nan,nan,nan,nan,nan,nan,nan,nan,nan,nan,nan,nan,nan,nan,nan,nan,nan,nan,nan,nan,nan,nan,nan
19/6/2011,Johan Djourou,5724377,798,1/18/1987,24,26,1,2,0,6250,7250,7100,155,142,3201653,192,90,D C,1,3,3,1,2,1,1,9,2,3,2,2,4,8,3,12,3,16,4,7,14,12,3,15,14,12,14,14,13,12,10,10,11,6,10,8,13,13,14,15,12,13,17,12,14,14,20,15,16,10,6,9,9,10,12,13,15,13,14,15,19,3,20,1,9,1,11,1,20,D C,101,1,1,1,1,1,1,20,1,11,13,9,1,1,1,1,0.0,0,0,0,0,0,0,0,0,0,0,0,0,0,0,0,0,0,0,0,0,0,0,0,0,0,0,0,0,0,0,0,0,0,0,0,0,0,0,0,0,0,0,0,0,0,0,0,0,Johan Djourou,ÃÂ£5.40m ,33.0,192.0,Defender - Centre-Back,right,FC Nordsjaelland,39.0,1.0,3.0,3354.0,28.0,0.0,1.0,1795.0,18.0,0.0,0.0,1595.0,26.0,0.0,0.0,2192.0,36.0,0.0,1.0,3204.0,26.0,2.0,1.0,2293.0,16.0,0.0,0.0,1322.0,18.0,1.0,0.0,1515.0,6.0,0.0,0.0,368.0,Premier League,7.0,0.0,0.0,393.0,3.0,0.0,0.0,186.0,29/6/2010,Johan Djourou,5724377.0,798.0,1/18/1987,23.0,24.0,1.0,2.0,0.0,4830.0,7100.0,6550.0,166.0,139.0,-1.0,191.0,89.0,D C,3.0,3.0,3.0,2.0,3.0,1.0,1.0,4.0,3.0,2.0,1.0,2.0,4.0,8.0,3.0,12.0,3.0,16.0,4.0,7.0,14.0,12.0,3.0,15.0,14.0,14.0,14.0,14.0,11.0,13.0,10.0,13.0,11.0,6.0,10.0,8.0,13.0,12.0,14.0,15.0,12.0,13.0,16.0,12.0,14.0,14.0,20.0,15.0,14.0,14.0,6.0,13.0,9.0,10.0,12.0,13.0,15.0,13.0,12.0,15.0,19.0,3.0,Johan Djourou,ÃÂÃÂ£5.85m ,Premier League
19/6/2011,JoÃÂ£o Dias,744082,788,12/23/1986,24,0,0,0,0,1585,4775,4775,105,98,115941,179,69,D RC,1,2,2,1,3,2,3,2,1,1,2,10,11,7,7,10,8,10,8,9,10,7,10,12,9,12,12,12,13,14,8,9,14,6,9,12,11,13,13,11,11,9,10,8,12,11,20,12,11,13,6,11,6,10,10,10,14,14,14,11,11,6,20,5,7,1,20,5,15,D RC,103,1,1,1,1,1,1,15,5,20,8,1,1,7,1,5,0.0,0,0,0,0,0,0,0,0,0,0,0,0,0,0,0,0,0,0,0,0,0,0,0,0,0,0,0,0,0,0,0,0,0,0,0,0,0,0,0,0,0,0,0,0,0,0,0,0,JoÃÂ£o Dias,ÃÂ£450Th. ,33.0,180.0,Defender - Right-Back,right,UniÃÂ£o de Leiria,30.0,1.0,0.0,2674.0,11.0,0.0,0.0,865.0,28.0,0.0,1.0,2354.0,8.0,0.0,0.0,595.0,26.0,0.0,0.0,2089.0,42.0,1.0,0.0,3755.0,25.0,1.0,0.0,2276.0,36.0,0.0,5.0,3270.0,6.0,0.0,0.0,490.0,Liga NOS,1.0,0.0,0.0,90.0,nan,nan,nan,nan,nan,nan,nan,nan,nan,nan,nan,nan,nan,nan,nan,nan,nan,nan,nan,nan,nan,nan,nan,nan,nan,nan,nan,nan,nan,nan,nan,nan,nan,nan,nan,nan,nan,nan,nan,nan,nan,nan,nan,nan,nan,nan,nan,nan,nan,nan,nan,nan,nan,nan,nan,nan,nan,nan,nan,nan,nan,nan,nan,nan,nan,nan,nan,nan,nan,nan,nan,nan,nan,nan,nan,nan,nan,nan,nan,nan,nan,nan,nan,nan,nan,nan,nan,nan
19/6/2011,Javier Cohene,79003177,1655,5/3/1987,24,0,0,0,0,1650,4814,5200,124,107,125658,187,84,D C,1,2,1,3,2,3,2,1,2,3,2,8,6,10,8,11,10,13,10,6,14,9,10,13,10,12,12,14,11,12,8,12,10,6,12,6,11,12,12,10,9,14,13,20,14,11,7,12,13,12,10,10,7,5,10,13,13,12,13,13,13,5,20,1,1,1,1,1,20,D C,101,1,10,1,1,1,1,20,1,1,1,1,1,1,1,1,0.0,0,0,0,0,0,0,0,0,0,0,0,0,0,0,0,0,0,0,0,0,0,0,0,0,0,0,0,0,0,0,0,0,0,0,0,0,0,0,0,0,0,0,0,0,0,0,0,0,Javier Cohene,ÃÂ£1.44m ,33.0,187.0,Defender - Centre-Back,right,Without Club,31.0,4.0,1.0,2662.0,29.0,2.0,1.0,2409.0,16.0,1.0,0.0,793.0,20.0,3.0,2.0,1560.0,6.0,0.0,0.0,540.0,2.0,0.0,0.0,144.0,nan,nan,nan,nan,nan,nan,nan,nan,nan,nan,nan,nan,Liga NOS,nan,nan,nan,nan,nan,nan,nan,nan,29/6/2010,Javier Cohene,79003177.0,1655.0,5/3/1987,23.0,0.0,0.0,0.0,0.0,1650.0,3500.0,5200.0,124.0,104.0,346879.0,187.0,84.0,D C,2.0,2.0,2.0,2.0,1.0,3.0,2.0,1.0,3.0,3.0,2.0,9.0,6.0,8.0,9.0,11.0,6.0,13.0,9.0,2.0,13.0,8.0,10.0,14.0,8.0,12.0,12.0,14.0,11.0,12.0,8.0,12.0,10.0,6.0,12.0,7.0,11.0,12.0,12.0,11.0,9.0,15.0,14.0,20.0,14.0,11.0,7.0,12.0,14.0,12.0,10.0,10.0,7.0,5.0,10.0,10.0,6.0,11.0,9.0,1.0,3.0,7.0,Javier Cohene,ÃÂÃÂ£450Th. ,Liga NOS
19/6/2011,Jan Simunek,5654057,763,2/20/1987,24,4,0,5,0,2750,6400,6350,142,127,416417,189,79,D C,2,3,1,2,3,3,3,5,1,1,2,3,7,5,5,11,2,15,5,7,15,10,3,14,11,8,14,10,13,12,6,12,13,6,10,6,14,14,12,13,13,15,15,4,12,13,20,14,14,12,3,11,5,5,15,10,12,10,16,15,15,4,20,1,1,1,1,1,20,D C,101,1,1,1,1,1,1,20,1,1,1,1,1,1,1,1,0.0,0,0,0,0,0,0,0,0,0,0,0,0,0,0,0,0,0,0,0,0,0,0,0,0,0,0,0,0,0,0,0,0,0,0,0,0,0,0,0,0,0,0,0,0,0,0,0,0,Jan Simunek,ÃÂ£900Th. ,33.0,187.0,Defender - Centre-Back,right,Retired,1.0,0.0,0.0,38.0,6.0,0.0,2.0,540.0,13.0,1.0,1.0,1125.0,22.0,1.0,0.0,1828.0,7.0,0.0,1.0,577.0,8.0,0.0,0.0,214.0,20.0,0.0,0.0,1564.0,2.0,0.0,0.0,139.0,nan,nan,nan,nan,Bundesliga,nan,nan,nan,nan,nan,nan,nan,nan,29/6/2010,Jan Simunek,5654057.0,763.0,2/20/1987,23.0,4.0,0.0,5.0,0.0,2750.0,6400.0,6350.0,142.0,126.0,1699999.0,187.0,75.0,D C,2.0,2.0,1.0,2.0,3.0,1.0,3.0,2.0,2.0,3.0,3.0,4.0,8.0,5.0,5.0,12.0,4.0,14.0,5.0,7.0,13.0,10.0,5.0,15.0,12.0,8.0,15.0,9.0,14.0,13.0,8.0,13.0,13.0,6.0,12.0,6.0,12.0,16.0,12.0,14.0,13.0,8.0,16.0,6.0,12.0,14.0,20.0,15.0,10.0,13.0,3.0,11.0,5.0,6.0,15.0,10.0,12.0,10.0,16.0,15.0,15.0,4.0,Jan Simunek,ÃÂÃÂ£1.35m ,Bundesliga
19/6/2011,Issam El Adoua,12006148,34,9/12/1986,24,1,0,4,0,4150,5800,5750,135,122,429636,189,74,D/DM C,1,1,2,3,2,3,2,2,3,3,3,5,8,8,6,10,5,15,9,10,13,11,5,13,10,12,14,13,13,14,8,12,14,6,10,9,15,15,15,12,10,16,15,8,13,10,20,15,13,12,12,14,8,5,11,15,13,11,14,14,15,6,20,1,7,1,10,1,20,D/DM C,111,1,1,1,1,1,1,20,1,10,17,7,1,1,1,1,0.0,0,0,0,0,0,0,0,0,0,0,0,0,0,0,0,0,0,0,0,0,0,0,0,0,0,0,0,0,0,0,0,0,0,0,0,0,0,0,0,0,0,0,0,0,0,0,0,0,Issam El Adoua,ÃÂ£900Th. ,33.0,190.0,Midfielder - Defensive Midfield,right,Al-Dhafra SCC,nan,nan,nan,nan,34.0,0.0,0.0,2878.0,31.0,1.0,2.0,2462.0,23.0,0.0,0.0,1455.0,37.0,2.0,3.0,3255.0,12.0,0.0,0.0,1080.0,21.0,0.0,0.0,1890.0,20.0,2.0,0.0,1744.0,26.0,0.0,0.0,2285.0,Liga NOS,17.0,1.0,1.0,1530.0,1.0,0.0,0.0,90.0,nan,nan,nan,nan,nan,nan,nan,nan,nan,nan,nan,nan,nan,nan,nan,nan,nan,nan,nan,nan,nan,nan,nan,nan,nan,nan,nan,nan,nan,nan,nan,nan,nan,nan,nan,nan,nan,nan,nan,nan,nan,nan,nan,nan,nan,nan,nan,nan,nan,nan,nan,nan,nan,nan,nan,nan,nan,nan,nan,nan,nan,nan,nan,nan,nan,nan,nan,nan,nan,nan,nan,nan,nan,nan,nan,nan,nan,nan,nan,nan,nan,nan,nan,nan
19/6/2011,Isidoro,67006172,796,8/1/1986,24,0,0,0,0,3250,6100,6100,133,122,382928,180,71,D/WB RLC,3,3,1,1,3,1,1,6,2,1,3,4,11,6,4,10,4,11,10,13,12,11,7,14,8,13,13,17,12,12,5,11,9,8,11,11,12,17,18,14,11,8,10,10,12,14,20,13,12,9,11,13,6,13,10,14,18,7,15,10,12,5,20,18,1,1,20,15,15,D/WB RLC,116,1,1,1,1,1,1,15,15,20,1,1,1,1,1,18,4294967296.0,0,0,0,0,0,0,0,0,0,0,0,0,0,0,0,0,0,0,0,0,0,0,0,0,0,0,0,0,0,0,0,0,1,0,0,0,0,0,0,0,0,0,0,0,0,0,0,0,Isidoro,ÃÂ£1.08m ,34.0,180.0,Defender - Right-Back,right,Retired,37.0,1.0,0.0,3172.0,11.0,0.0,0.0,892.0,13.0,0.0,0.0,834.0,17.0,0.0,0.0,1321.0,37.0,0.0,1.0,3235.0,25.0,0.0,0.0,1980.0,10.0,0.0,0.0,627.0,24.0,0.0,2.0,2036.0,5.0,1.0,0.0,318.0,LaLiga,nan,nan,nan,nan,nan,nan,nan,nan,nan,nan,nan,nan,nan,nan,nan,nan,nan,nan,nan,nan,nan,nan,nan,nan,nan,nan,nan,nan,nan,nan,nan,nan,nan,nan,nan,nan,nan,nan,nan,nan,nan,nan,nan,nan,nan,nan,nan,nan,nan,nan,nan,nan,nan,nan,nan,nan,nan,nan,nan,nan,nan,nan,nan,nan,nan,nan,nan,nan,nan,nan,nan,nan,nan,nan,nan,nan,nan,nan,nan,nan,nan,nan,nan,nan,nan,nan,nan,nan,nan,nan,nan,nan
19/6/2011,Henrique,55004803,788,10/19/1986,24,0,0,0,0,1500,5250,5250,124,109,74623,189,79,D C,2,3,3,1,2,3,3,6,3,3,2,4,3,1,1,9,3,13,6,3,10,11,5,13,10,12,12,10,9,13,8,13,11,3,8,3,13,15,15,11,8,8,14,10,7,12,20,13,13,10,10,7,4,10,12,3,10,10,12,13,11,14,20,1,1,1,1,1,20,D C,101,1,1,1,1,1,1,20,1,1,1,1,1,1,1,1,0.0,0,0,0,0,0,0,0,0,0,0,0,0,0,0,0,0,0,0,0,0,0,0,0,0,0,0,0,0,0,0,0,0,0,0,0,0,0,0,0,0,0,0,0,0,0,0,0,0,Henrique,ÃÂ£1.35m ,37.0,189.0,Defender - Centre-Back,right,Retired,2.0,0.0,0.0,88.0,25.0,2.0,0.0,2213.0,37.0,2.0,2.0,3041.0,50.0,4.0,0.0,4341.0,8.0,0.0,1.0,615.0,nan,nan,nan,nan,nan,nan,nan,nan,nan,nan,nan,nan,nan,nan,nan,nan,Ligue 1,nan,nan,nan,nan,nan,nan,nan,nan,nan,nan,nan,nan,nan,nan,nan,nan,nan,nan,nan,nan,nan,nan,nan,nan,nan,nan,nan,nan,nan,nan,nan,nan,nan,nan,nan,nan,nan,nan,nan,nan,nan,nan,nan,nan,nan,nan,nan,nan,nan,nan,nan,nan,nan,nan,nan,nan,nan,nan,nan,nan,nan,nan,nan,nan,nan,nan,nan,nan,nan,nan,nan,nan,nan,nan,nan,nan,nan,nan,nan,nan,nan,nan,nan,nan,nan,nan,nan,nan,nan,nan,nan,nan,19-06-17,18.3.4.28,Henrique,55004803,788,19-Oct-86,30,0,0,0,0,4500,6250,6250,130,125,232186002,187,77,D C,1,3,3,1,1,2,1,2,2,2,1,6,6,8,7,9,7,14,11,8,14,12,8,15,11,12,14,12,12,13,8,12,12,8,12,8,14,13,13,11,12,13,14,11,11,11,20,13,12,13,11,10,15,8,10,14,11,11,15,10,11,10,20,1,1,1,13,7,20,D C,101,1,1,1,1,1,1,20,7,13,1,1,1,1,1,1,0.0,0,0,0,0,0,0,0,0,0,0,0,0,0,0,0,0,0,0,0,0,0,0,0,0,0,0,0,0,0,0,0,0,0,0,0,0,0,0,0,0,0,0,0,0,0,0,0,0,Nuno Henrique,ÃÂ£180Th. ,34.0,186.0,Defender - Centre-Back,right,LusitÃÂÃÂ¢nia FC Lourosa,14.0,2.0,0.0,1122.0,14.0,1.0,0.0,1119.0,2.0,1.0,0.0,180.0,2.0,0.0,0.0,240.0,nan,nan,nan,nan,Liga NOS,15-07-16,17.3.2.23,Henrique,55004803.0,788.0,19-Oct-86,29.0,0.0,0.0,0.0,0.0,4300.0,6300.0,6300.0,130.0,126.0,323700.0,187.0,77.0,D C,1.0,1.0,3.0,2.0,1.0,2.0,1.0,2.0,3.0,1.0,1.0,6.0,6.0,8.0,7.0,9.0,7.0,14.0,11.0,8.0,14.0,12.0,8.0,15.0,12.0,12.0,15.0,12.0,12.0,13.0,8.0,12.0,12.0,8.0,12.0,8.0,14.0,13.0,13.0,11.0,12.0,13.0,14.0,11.0,11.0,11.0,20.0,13.0,12.0,13.0,11.0,10.0,15.0,8.0,8.0,14.0,11.0,11.0,15.0,10.0,11.0,10.0,Nuno Henrique,ÃÂ£360Th. ,Liga NOS
19/6/2011,GonÃÂ§alo BrandÃÂ£o,744606,788,10/9/1986,24,0,0,6,0,2310,5264,5850,137,117,84162,182,72,D C,3,3,3,2,3,1,2,4,3,3,1,12,11,8,5,10,12,14,8,9,15,10,10,15,10,14,13,12,13,14,8,11,13,6,11,11,13,12,13,13,10,13,11,20,11,10,5,11,12,13,6,10,11,11,10,14,14,9,12,12,15,5,20,1,1,1,1,10,20,D C,101,1,1,1,1,1,1,20,10,1,1,1,1,1,1,1,1116690000000.0,1,0,0,0,0,0,0,0,0,0,0,1,0,0,0,0,0,0,0,0,0,0,0,0,0,0,0,0,0,0,0,0,0,0,1,0,0,0,0,0,1,0,0,0,0,0,0,0,GonÃÂ§alo BrandÃÂ£o,ÃÂ£540Th. ,34.0,187.0,Defender - Centre-Back,left,FC Porto B,3.0,0.0,0.0,87.0,2.0,0.0,0.0,135.0,25.0,0.0,0.0,1694.0,12.0,0.0,0.0,882.0,34.0,0.0,0.0,3028.0,40.0,1.0,0.0,3401.0,21.0,0.0,0.0,1699.0,5.0,0.0,0.0,450.0,26.0,2.0,2.0,2195.0,Serie A,12.0,0.0,0.0,890.0,1.0,0.0,0.0,90.0,nan,nan,nan,nan,nan,nan,nan,nan,nan,nan,nan,nan,nan,nan,nan,nan,nan,nan,nan,nan,nan,nan,nan,nan,nan,nan,nan,nan,nan,nan,nan,nan,nan,nan,nan,nan,nan,nan,nan,nan,nan,nan,nan,nan,nan,nan,nan,nan,nan,nan,nan,nan,nan,nan,nan,nan,nan,nan,nan,nan,nan,nan,nan,nan,nan,nan,nan,nan,nan,nan,nan,nan,nan,nan,nan,nan,nan,nan,nan,nan,nan,nan,nan,nan,19-06-17,18.3.4.28,GonÃÂ§alo BrandÃÂo,744606,788,09-Oct-86,30,2,0,8,0,5000,5750,5750,115,115,161066,182,78,D C,2,1,3,2,1,2,1,2,4,3,1,12,11,11,5,11,10,12,8,10,14,11,10,13,12,11,14,12,13,14,8,11,13,6,15,9,14,15,12,10,10,13,14,20,12,12,4,14,12,14,6,12,11,11,12,14,14,13,15,14,15,5,20,1,1,1,1,14,20,D C,101,1,1,1,1,1,1,20,14,1,1,1,1,1,1,1,17179871232.0,0,0,0,0,0,0,0,0,0,0,0,1,0,0,0,0,0,0,0,0,0,0,0,0,0,0,0,0,0,0,0,0,0,0,1,0,0,0,0,0,0,0,0,0,0,0,0,0,GonÃÂ§alo BrandÃÂ£o,ÃÂ£135Th. ,34.0,187.0,Defender - Centre-Back,left,FC Porto B,21.0,0.0,0.0,1699.0,5.0,0.0,0.0,450.0,26.0,2.0,2.0,2195.0,12.0,0.0,0.0,890.0,1.0,0.0,0.0,90.0,Liga NOS,15-07-16,17.3.2.23,GonÃÂ§alo BrandÃÂo,744606.0,788.0,09-Oct-86,29.0,2.0,0.0,8.0,0.0,5000.0,6100.0,6100.0,128.0,119.0,195957.0,182.0,78.0,D C,2.0,1.0,3.0,3.0,4.0,1.0,3.0,3.0,1.0,2.0,1.0,12.0,11.0,9.0,5.0,11.0,12.0,13.0,8.0,10.0,14.0,12.0,10.0,13.0,13.0,11.0,14.0,12.0,13.0,14.0,8.0,11.0,13.0,6.0,16.0,9.0,14.0,15.0,12.0,11.0,11.0,13.0,14.0,20.0,12.0,12.0,4.0,14.0,12.0,14.0,6.0,12.0,11.0,11.0,10.0,14.0,17.0,9.0,12.0,12.0,15.0,5.0,GonÃÂ§alo BrandÃÂ£o,ÃÂ£810Th. ,Liga NOS
19/6/2011,Gojko Kacar,5779401,802,1/26/1987,24,22,0,15,8,6250,6808,6628,157,142,8304880,183,77,D/DM/M C,3,2,3,1,2,2,3,1,1,2,3,7,10,14,15,10,9,17,13,12,17,10,9,17,14,18,14,18,12,8,14,16,18,10,13,17,9,12,19,10,13,17,15,11,6,15,20,10,13,11,9,15,12,20,16,17,8,12,9,10,7,6,16,11,20,12,14,1,20,D/DM/M C,431,1,1,10,12,1,1,16,1,10,19,20,1,14,1,11,8933530000000.0,0,0,1,0,0,1,0,0,0,1,0,0,0,0,0,0,0,0,0,0,0,0,0,0,0,0,0,0,0,0,0,0,0,0,0,0,0,1,0,0,0,0,0,1,0,0,0,0,Gojko Kacar,ÃÂ£3.60m ,33.0,185.0,Midfielder - Defensive Midfield,right,Without Club,23.0,2.0,1.0,1592.0,23.0,1.0,1.0,1319.0,7.0,0.0,0.0,356.0,26.0,3.0,1.0,2114.0,15.0,3.0,0.0,829.0,19.0,1.0,0.0,1117.0,23.0,0.0,1.0,1184.0,6.0,1.0,0.0,225.0,6.0,0.0,0.0,275.0,Bundesliga,nan,nan,nan,nan,nan,nan,nan,nan,29/6/2010,Gojko Kacar,5779401.0,802.0,1/26/1987,23.0,18.0,0.0,15.0,8.0,5041.0,6900.0,6750.0,163.0,142.0,12432500.0,183.0,77.0,DM/M C,1.0,2.0,3.0,1.0,2.0,2.0,2.0,4.0,3.0,2.0,1.0,7.0,10.0,14.0,16.0,9.0,9.0,17.0,13.0,12.0,17.0,10.0,9.0,17.0,14.0,18.0,14.0,18.0,12.0,8.0,15.0,16.0,18.0,10.0,13.0,17.0,9.0,12.0,19.0,10.0,13.0,17.0,16.0,11.0,6.0,15.0,20.0,10.0,13.0,11.0,9.0,15.0,12.0,20.0,16.0,17.0,8.0,12.0,9.0,10.0,7.0,6.0,Gojko Kacar,ÃÂÃÂ£6.75m ,Bundesliga,19-06-17,18.3.4.28,Gojko Kacar,5779401,802,26-Jan-87,30,25,0,15,7,4750,5750,6250,140,125,4313612,185,85,DM/M C,1,2,3,3,2,1,3,3,2,3,2,8,10,12,15,10,9,16,14,12,14,12,10,15,11,17,13,18,10,11,11,11,18,11,12,16,10,12,17,9,12,16,14,10,10,12,20,10,13,10,12,15,16,20,16,8,6,14,10,10,7,12,15,10,20,12,11,1,20,DM/M C,311,1,1,14,12,1,11,15,1,10,20,20,1,11,1,10,137439000000.0,0,0,0,0,0,0,0,0,0,1,0,0,0,0,0,0,0,0,0,0,0,0,0,0,0,0,0,0,0,0,0,0,0,0,0,0,0,1,0,0,0,0,0,0,0,0,0,0,Gojko Kacar,ÃÂ£450Th. ,33.0,185.0,Midfielder - Defensive Midfield,right,Without Club,23.0,0.0,1.0,1184.0,6.0,1.0,0.0,225.0,6.0,0.0,0.0,275.0,nan,nan,nan,nan,nan,nan,nan,nan,Bundesliga,15-07-16,17.3.2.23,Gojko Kacar,5779401.0,802.0,26-Jan-87,29.0,25.0,0.0,15.0,7.0,3750.0,5900.0,6250.0,140.0,125.0,3978451.0,183.0,77.0,DM/M C,1.0,3.0,3.0,2.0,3.0,3.0,1.0,2.0,3.0,3.0,1.0,8.0,10.0,12.0,15.0,10.0,9.0,16.0,14.0,12.0,14.0,12.0,10.0,15.0,11.0,17.0,13.0,18.0,10.0,11.0,11.0,11.0,18.0,11.0,12.0,16.0,10.0,12.0,17.0,9.0,12.0,16.0,14.0,10.0,10.0,12.0,20.0,10.0,13.0,10.0,12.0,15.0,16.0,20.0,16.0,8.0,6.0,14.0,10.0,10.0,7.0,12.0,Gojko Kacar,ÃÂ£900Th. ,Bundesliga
19/6/2011,Gil,19053424,1651,6/12/1987,24,0,0,0,0,3750,6700,6050,146,134,948616,188,84,D C,2,2,1,2,2,1,1,6,3,1,1,4,8,10,9,11,8,14,9,7,13,12,10,14,10,15,12,16,11,12,9,12,15,12,10,12,14,14,14,13,12,15,14,9,15,13,20,15,15,13,15,12,6,7,12,14,10,11,13,11,13,6,20,1,1,1,10,1,20,D C,101,1,1,1,1,1,1,20,1,10,1,1,1,1,1,1,32832.0,0,0,0,0,0,0,1,0,0,0,0,0,0,0,0,1,0,0,0,0,0,0,0,0,0,0,0,0,0,0,0,0,0,0,0,0,0,0,0,0,0,0,0,0,0,0,0,0,Gil,ÃÂ£2.25m ,33.0,192.0,Defender - Centre-Back,right,Sport Club Corinthians Paulista,23.0,0.0,1.0,2070.0,28.0,1.0,0.0,2387.0,61.0,1.0,1.0,5451.0,34.0,4.0,0.0,3051.0,44.0,2.0,1.0,3915.0,39.0,0.0,0.0,3481.0,32.0,3.0,0.0,2880.0,37.0,6.0,0.0,3330.0,61.0,3.0,4.0,5459.0,Ligue 1,29.0,3.0,1.0,2610.0,nan,nan,nan,nan,nan,nan,nan,nan,nan,nan,nan,nan,nan,nan,nan,nan,nan,nan,nan,nan,nan,nan,nan,nan,nan,nan,nan,nan,nan,nan,nan,nan,nan,nan,nan,nan,nan,nan,nan,nan,nan,nan,nan,nan,nan,nan,nan,nan,nan,nan,nan,nan,nan,nan,nan,nan,nan,nan,nan,nan,nan,nan,nan,nan,nan,nan,nan,nan,nan,nan,nan,nan,nan,nan,nan,nan,nan,nan,nan,nan,nan,nan,nan,nan,nan,nan,nan,nan
19/6/2011,Gerard PiquÃÂ©,5124470,796,2/2/1987,24,33,4,12,1,8000,8700,8700,179,174,25447489,192,85,D C,1,3,3,1,1,1,2,10,1,1,2,8,8,9,8,15,7,16,7,8,19,16,11,16,15,14,16,14,15,17,14,15,16,9,16,9,18,15,16,11,11,18,16,9,15,15,20,17,16,15,11,15,6,9,15,18,14,15,14,9,10,12,20,1,1,1,8,1,20,D C,101,1,12,1,1,1,1,20,1,8,14,1,1,1,1,1,9075270000000.0,0,0,0,0,0,1,0,0,0,0,0,0,0,0,0,1,0,0,0,0,0,0,0,0,0,0,0,0,0,0,0,0,1,0,0,0,0,0,1,0,0,0,0,1,0,0,0,0,Gerard PiquÃÂ©,ÃÂ£34.20m ,33.0,192.0,Defender - Centre-Back,right,FC Barcelona,51.0,4.0,1.0,4381.0,38.0,2.0,2.0,2739.0,44.0,3.0,0.0,3627.0,39.0,4.0,0.0,3393.0,44.0,7.0,1.0,3899.0,46.0,5.0,1.0,3993.0,41.0,3.0,0.0,3563.0,49.0,5.0,0.0,4145.0,52.0,7.0,4.0,4680.0,LaLiga,45.0,1.0,0.0,3986.0,6.0,0.0,0.0,518.0,29/6/2010,Gerard PiquÃÂ©,5124470.0,796.0,2/2/1987,23.0,23.0,4.0,12.0,1.0,7310.0,8250.0,8250.0,179.0,171.0,125499005.0,192.0,85.0,D C,1.0,2.0,2.0,1.0,1.0,2.0,3.0,1.0,3.0,2.0,2.0,8.0,6.0,9.0,8.0,15.0,7.0,16.0,7.0,8.0,18.0,15.0,11.0,16.0,14.0,12.0,16.0,13.0,15.0,17.0,13.0,15.0,16.0,9.0,16.0,9.0,18.0,15.0,16.0,11.0,11.0,18.0,16.0,9.0,15.0,15.0,20.0,17.0,16.0,15.0,9.0,15.0,6.0,9.0,16.0,18.0,8.0,15.0,14.0,17.0,12.0,11.0,Gerard PiquÃÂÃÂ©,ÃÂÃÂ£31.50m ,LaLiga,19-06-17,18.3.4.28,Gerard PiquÃÂ©,5124470,796,02-Feb-87,30,80,5,12,1,8200,8450,8450,170,169,232186002,194,85,D C,3,1,3,3,1,3,3,3,1,2,2,8,10,13,10,15,7,16,8,8,16,16,13,15,16,14,16,15,18,15,15,17,14,11,16,9,18,15,15,11,10,9,16,12,15,13,20,15,15,16,12,18,8,9,16,15,16,17,14,10,10,16,20,1,1,1,1,1,20,D C,101,1,15,1,1,1,1,20,1,1,10,1,1,1,1,1,1.15292e+18,0,0,0,0,0,1,0,0,0,0,0,0,0,0,0,1,0,0,0,0,0,0,0,0,0,0,0,0,0,0,0,0,1,0,0,0,0,0,1,0,0,0,0,0,0,0,0,0,Gerard PiquÃÂ©,ÃÂ£45.00m ,33.0,192.0,Defender - Centre-Back,right,FC Barcelona,41.0,3.0,0.0,3563.0,49.0,5.0,0.0,4145.0,52.0,7.0,4.0,4680.0,45.0,1.0,0.0,3986.0,6.0,0.0,0.0,518.0,LaLiga,15-07-16,17.3.2.23,Gerard PiquÃÂ©,5124470.0,796.0,02-Feb-87,29.0,80.0,5.0,12.0,1.0,8200.0,8450.0,8450.0,170.0,169.0,80046423.0,193.0,85.0,D C,1.0,1.0,2.0,3.0,3.0,1.0,1.0,3.0,2.0,2.0,3.0,8.0,10.0,13.0,10.0,15.0,7.0,16.0,8.0,8.0,16.0,16.0,13.0,15.0,16.0,14.0,16.0,15.0,18.0,15.0,15.0,17.0,13.0,11.0,16.0,9.0,18.0,15.0,15.0,11.0,10.0,9.0,16.0,12.0,15.0,13.0,20.0,15.0,15.0,16.0,12.0,18.0,8.0,9.0,16.0,15.0,14.0,14.0,12.0,9.0,10.0,16.0,Gerard PiquÃÂ©,ÃÂ£36.00m ,LaLiga
19/6/2011,Federico Fazio,964847,1649,3/17/1987,24,2,0,16,1,5500,6709,6900,158,140,1084767,195,85,D/DM C,1,3,1,1,2,1,1,2,2,1,1,4,6,8,7,10,8,16,8,13,14,13,10,15,11,14,15,14,12,10,9,13,13,6,9,8,14,13,15,12,11,18,17,12,9,12,20,16,19,13,14,9,13,14,13,12,12,12,14,14,11,11,20,1,1,1,1,1,20,D/DM C,111,1,12,1,1,1,1,20,1,1,19,1,1,1,1,1,64.0,0,0,0,0,0,0,1,0,0,0,0,0,0,0,0,0,0,0,0,0,0,0,0,0,0,0,0,0,0,0,0,0,0,0,0,0,0,0,0,0,0,0,0,0,0,0,0,0,Federico Fazio,ÃÂ£3.60m ,33.0,195.0,Defender - Centre-Back,right,AS Roma,25.0,1.0,0.0,1954.0,33.0,1.0,0.0,2538.0,33.0,4.0,0.0,2743.0,41.0,3.0,2.0,3628.0,32.0,0.0,1.0,2856.0,7.0,0.0,0.0,553.0,48.0,4.0,1.0,3946.0,45.0,2.0,2.0,3842.0,42.0,5.0,0.0,3524.0,LaLiga,23.0,2.0,0.0,1765.0,1.0,0.0,0.0,90.0,29/6/2010,Federico Fazio,964847.0,1649.0,3/17/1987,23.0,0.0,0.0,16.0,1.0,4422.0,6500.0,6650.0,157.0,133.0,636645.0,195.0,85.0,D/DM C,2.0,2.0,2.0,2.0,1.0,1.0,1.0,1.0,2.0,3.0,3.0,4.0,6.0,7.0,6.0,10.0,8.0,16.0,8.0,13.0,13.0,12.0,10.0,15.0,11.0,14.0,13.0,13.0,10.0,11.0,8.0,12.0,13.0,4.0,9.0,8.0,13.0,13.0,15.0,12.0,10.0,18.0,17.0,12.0,16.0,12.0,20.0,16.0,19.0,12.0,14.0,9.0,7.0,13.0,13.0,12.0,12.0,12.0,14.0,14.0,11.0,11.0,Federico Fazio,ÃÂÃÂ£2.70m ,LaLiga,19-06-17,18.3.4.28,Federico Fazio,964847,1649,17-Mar-87,30,4,1,13,1,5750,7000,7350,152,147,232186002,195,90,D C,1,1,3,3,1,3,3,3,2,3,3,3,4,10,7,13,4,18,6,5,15,14,6,17,13,13,16,15,14,13,12,14,15,13,14,8,15,14,13,8,9,15,18,12,9,11,20,13,17,12,14,10,13,15,13,12,13,12,14,14,13,11,20,1,1,1,1,1,20,D C,101,1,15,1,1,1,1,20,1,1,10,1,1,1,1,1,1.15292e+18,0,0,0,0,0,0,0,0,0,0,0,0,0,0,0,0,0,0,0,0,0,0,0,0,0,0,0,0,0,0,0,0,0,0,0,0,0,0,1,0,0,0,0,0,0,0,0,0,Federico Fazio,ÃÂ£11.70m ,33.0,195.0,Defender - Centre-Back,right,AS Roma,48.0,4.0,1.0,3946.0,45.0,2.0,2.0,3842.0,42.0,5.0,0.0,3524.0,23.0,2.0,0.0,1765.0,1.0,0.0,0.0,90.0,Serie A,15-07-16,17.3.2.23,Federico Fazio,964847.0,1649.0,17-Mar-87,29.0,3.0,0.0,13.0,1.0,5900.0,7000.0,7300.0,150.0,148.0,50757164.0,195.0,85.0,D C,3.0,1.0,1.0,3.0,3.0,3.0,2.0,4.0,3.0,1.0,3.0,4.0,5.0,8.0,7.0,13.0,6.0,19.0,8.0,5.0,16.0,14.0,8.0,15.0,13.0,13.0,16.0,15.0,13.0,13.0,11.0,12.0,13.0,13.0,15.0,8.0,15.0,15.0,14.0,9.0,10.0,11.0,19.0,9.0,9.0,11.0,20.0,14.0,17.0,12.0,14.0,10.0,13.0,15.0,13.0,12.0,13.0,12.0,14.0,14.0,13.0,11.0,Federico Fazio,ÃÂ£8.10m ,Premier League
19/6/2011,Fabiano Santacroce,1400569,776,8/24/1986,24,0,0,6,0,4750,6500,6500,150,131,771165,181,72,D RC,2,3,2,2,1,2,2,6,1,3,3,4,11,11,4,11,4,14,4,14,16,8,6,16,12,14,16,15,12,11,8,14,15,9,6,9,12,12,11,15,16,12,12,7,8,14,20,14,12,13,15,16,18,10,14,14,15,16,14,12,5,3,20,1,1,1,15,1,20,D RC,103,1,1,1,1,1,1,20,1,15,1,1,1,1,1,1,140737000000000.0,0,0,0,0,0,0,0,0,0,0,0,0,0,0,0,0,0,0,0,0,0,0,0,0,0,0,0,0,0,0,0,0,0,0,0,0,0,0,0,0,0,0,0,0,0,0,0,1,Fabiano Santacroce,ÃÂ£720Th. ,34.0,181.0,Defender - Centre-Back,right,Without Club,14.0,0.0,0.0,1080.0,13.0,0.0,0.0,602.0,9.0,0.0,1.0,469.0,20.0,0.0,0.0,1667.0,17.0,0.0,1.0,1078.0,3.0,0.0,1.0,213.0,10.0,0.0,0.0,758.0,nan,nan,nan,nan,30.0,0.0,0.0,2413.0,Serie A,8.0,0.0,0.0,473.0,nan,nan,nan,nan,29/6/2010,Fabiano Santacroce,1400569.0,776.0,8/24/1986,23.0,0.0,0.0,6.0,0.0,3250.0,6700.0,6700.0,160.0,135.0,20621488.0,181.0,72.0,D RC,2.0,2.0,2.0,1.0,1.0,3.0,2.0,4.0,2.0,1.0,2.0,4.0,11.0,11.0,4.0,11.0,4.0,14.0,4.0,14.0,16.0,8.0,6.0,16.0,13.0,14.0,16.0,15.0,12.0,13.0,8.0,14.0,15.0,9.0,6.0,9.0,12.0,12.0,11.0,15.0,16.0,12.0,12.0,7.0,8.0,15.0,20.0,14.0,12.0,13.0,15.0,16.0,18.0,10.0,14.0,14.0,15.0,16.0,14.0,12.0,5.0,3.0,Fabiano Santacroce,ÃÂÃÂ£1.44m ,Serie A
19/6/2011,Fabian SchÃÂ¶nheim,8728128,771,2/14/1987,24,0,0,10,0,3250,5500,5500,130,110,249493,191,84,D LC,1,1,1,3,2,1,3,7,1,3,1,9,10,7,10,10,14,13,9,13,13,11,14,14,10,8,12,8,7,12,9,10,11,2,15,8,13,12,13,11,12,13,14,20,12,11,7,12,12,9,5,11,9,12,10,12,11,8,12,13,8,8,20,1,1,1,1,19,20,D LC,104,1,1,1,1,1,1,20,19,1,1,1,1,1,1,1,0.0,0,0,0,0,0,0,0,0,0,0,0,0,0,0,0,0,0,0,0,0,0,0,0,0,0,0,0,0,0,0,0,0,0,0,0,0,0,0,0,0,0,0,0,0,0,0,0,0,Fabian SchÃÂ¶nheim,ÃÂ£450Th. ,33.0,191.0,Defender - Centre-Back,left,Retired,37.0,3.0,4.0,3157.0,12.0,0.0,1.0,854.0,31.0,2.0,1.0,2618.0,33.0,1.0,0.0,2882.0,28.0,2.0,8.0,2440.0,8.0,1.0,1.0,623.0,13.0,0.0,1.0,905.0,11.0,1.0,1.0,922.0,nan,nan,nan,nan,Bundesliga,nan,nan,nan,nan,nan,nan,nan,nan,nan,nan,nan,nan,nan,nan,nan,nan,nan,nan,nan,nan,nan,nan,nan,nan,nan,nan,nan,nan,nan,nan,nan,nan,nan,nan,nan,nan,nan,nan,nan,nan,nan,nan,nan,nan,nan,nan,nan,nan,nan,nan,nan,nan,nan,nan,nan,nan,nan,nan,nan,nan,nan,nan,nan,nan,nan,nan,nan,nan,nan,nan,nan,nan,nan,nan,nan,nan,nan,nan,nan,nan,nan,nan,nan,nan,nan,nan,nan,nan,nan,nan,nan,nan
19/6/2011,Ezequiel Garay,956658,1649,10/10/1986,24,3,0,0,0,6250,7350,7350,158,147,6245503,185,80,D C,1,1,3,1,2,1,1,3,1,3,2,9,12,8,11,10,15,15,14,9,16,15,16,15,15,10,17,12,16,16,11,15,8,7,10,6,16,13,12,9,10,16,15,11,14,10,20,16,15,16,9,12,12,5,11,15,8,10,12,16,18,9,20,1,1,1,1,1,20,D C,101,1,10,1,1,1,1,20,1,1,1,1,1,1,1,1,274878000000.0,0,0,0,0,0,0,0,0,0,0,0,0,0,0,0,0,0,0,0,0,0,0,0,0,0,0,0,0,0,0,0,0,0,0,0,0,0,0,1,0,0,0,0,0,0,0,0,0,Ezequiel Garay,ÃÂ£10.80m ,34.0,188.0,Defender - Centre-Back,right,Without Club,8.0,0.0,0.0,435.0,41.0,2.0,0.0,3671.0,46.0,2.0,0.0,4158.0,49.0,8.0,0.0,4456.0,42.0,1.0,3.0,3604.0,28.0,2.0,1.0,2456.0,33.0,3.0,0.0,2880.0,28.0,0.0,0.0,2378.0,35.0,2.0,0.0,3009.0,Liga NOS,23.0,0.0,0.0,1891.0,nan,nan,nan,nan,29/6/2010,Ezequiel Garay,956658.0,1649.0,10/10/1986,23.0,1.0,0.0,0.0,0.0,5550.0,7200.0,7450.0,162.0,149.0,13920758.0,188.0,84.0,D C,2.0,1.0,2.0,1.0,2.0,2.0,3.0,5.0,2.0,1.0,3.0,9.0,12.0,8.0,11.0,10.0,15.0,15.0,14.0,9.0,16.0,15.0,16.0,15.0,15.0,10.0,17.0,12.0,16.0,16.0,11.0,14.0,8.0,8.0,10.0,6.0,16.0,13.0,12.0,7.0,10.0,16.0,15.0,11.0,14.0,11.0,20.0,16.0,15.0,16.0,9.0,12.0,12.0,5.0,11.0,15.0,8.0,10.0,12.0,16.0,18.0,9.0,Ezequiel Garay,ÃÂÃÂ£9.00m ,LaLiga,19-06-17,18.3.4.28,Ezequiel Garay,956658,1649,10-Oct-86,30,32,0,46,9,7000,7400,7400,160,147,232186002,189,90,D C,3,2,3,2,1,2,3,2,1,2,4,8,10,8,10,11,14,14,13,9,14,13,13,14,11,12,15,11,16,15,11,15,8,5,11,8,17,13,13,12,11,13,13,11,14,13,20,15,13,15,10,14,13,6,13,15,8,10,13,16,16,7,20,1,1,1,1,1,20,D C,101,1,10,1,1,1,1,20,1,1,1,1,1,1,1,1,274878000000.0,0,0,0,0,0,0,0,0,0,0,0,0,0,0,0,0,0,0,0,0,0,0,0,0,0,0,0,0,0,0,0,0,0,0,0,0,0,0,1,0,0,0,0,0,0,0,0,0,Ezequiel Garay,ÃÂ£10.80m ,34.0,188.0,Defender - Centre-Back,right,Without Club,33.0,3.0,0.0,2880.0,28.0,0.0,0.0,2378.0,35.0,2.0,0.0,3009.0,23.0,0.0,0.0,1891.0,nan,nan,nan,nan,LaLiga,15-07-16,17.3.2.23,Ezequiel Garay,956658.0,1649.0,10-Oct-86,29.0,23.0,0.0,46.0,9.0,7000.0,7400.0,7400.0,160.0,148.0,27379144.0,189.0,83.0,D C,2.0,3.0,2.0,1.0,3.0,1.0,1.0,1.0,3.0,2.0,2.0,8.0,11.0,8.0,10.0,11.0,14.0,14.0,13.0,9.0,15.0,14.0,13.0,14.0,11.0,14.0,16.0,13.0,16.0,15.0,10.0,15.0,8.0,5.0,11.0,8.0,17.0,13.0,13.0,12.0,10.0,13.0,15.0,11.0,14.0,12.0,20.0,15.0,13.0,18.0,10.0,14.0,13.0,6.0,13.0,15.0,8.0,10.0,11.0,16.0,15.0,7.0,Ezequiel Garay,ÃÂ£13.50m ,LaLiga
19/6/2011,Dominic Maroh,35007305,771,3/4/1987,24,0,0,0,0,5050,6350,6000,137,125,439369,186,83,D C,1,1,2,2,1,2,3,1,2,3,1,7,8,7,6,10,6,14,6,10,15,11,7,16,10,10,13,12,12,13,8,13,15,7,10,9,13,11,11,11,12,13,14,5,14,11,20,13,15,16,8,10,10,5,4,13,12,12,14,13,15,4,20,1,1,1,1,1,20,D C,101,1,1,1,1,1,1,20,1,1,1,1,1,1,1,1,0.0,0,0,0,0,0,0,0,0,0,0,0,0,0,0,0,0,0,0,0,0,0,0,0,0,0,0,0,0,0,0,0,0,0,0,0,0,0,0,0,0,0,0,0,0,0,0,0,0,Dominic Maroh,ÃÂ£1.80m ,33.0,186.0,Defender - Centre-Back,right,KFC Uerdingen 05,10.0,0.0,1.0,634.0,25.0,2.0,1.0,2098.0,35.0,2.0,2.0,3105.0,36.0,0.0,0.0,3200.0,31.0,1.0,2.0,2579.0,26.0,2.0,1.0,2212.0,15.0,1.0,0.0,844.0,15.0,1.0,0.0,1221.0,29.0,1.0,1.0,2595.0,Bundesliga,16.0,1.0,0.0,1224.0,nan,nan,nan,nan,29/6/2010,Dominic Maroh,35007305.0,771.0,3/4/1987,23.0,0.0,0.0,0.0,0.0,2750.0,6350.0,6350.0,149.0,127.0,5204891.0,186.0,75.0,D C,1.0,3.0,1.0,1.0,3.0,3.0,1.0,4.0,2.0,2.0,1.0,7.0,8.0,7.0,6.0,10.0,6.0,14.0,6.0,10.0,15.0,11.0,7.0,17.0,10.0,10.0,13.0,12.0,12.0,14.0,8.0,13.0,10.0,7.0,10.0,9.0,13.0,11.0,11.0,11.0,12.0,13.0,14.0,5.0,14.0,11.0,20.0,13.0,15.0,17.0,8.0,10.0,10.0,5.0,19.0,13.0,14.0,13.0,17.0,17.0,10.0,7.0,Dominic Maroh,ÃÂÃÂ£1.35m ,Bundesliga,19-06-17,18.3.4.28,Dominic Maroh,35007305,795,04-Mar-87,30,7,0,0,0,3900,5900,6400,130,128,4991080,186,85,D C,3,4,4,1,1,3,1,3,1,4,2,4,6,6,6,9,5,13,7,10,16,8,7,16,8,13,12,18,10,15,7,11,15,7,14,6,15,14,12,11,9,16,14,9,14,12,20,13,16,15,8,15,10,6,9,13,15,12,14,13,13,7,20,5,6,1,7,7,20,D C,101,1,13,1,1,1,1,20,7,7,7,6,1,1,5,5,0.0,0,0,0,0,0,0,0,0,0,0,0,0,0,0,0,0,0,0,0,0,0,0,0,0,0,0,0,0,0,0,0,0,0,0,0,0,0,0,0,0,0,0,0,0,0,0,0,0,Dominic Maroh,ÃÂ£900Th. ,33.0,186.0,Defender - Centre-Back,right,KFC Uerdingen 05,15.0,1.0,0.0,844.0,15.0,1.0,0.0,1221.0,29.0,1.0,1.0,2595.0,16.0,1.0,0.0,1224.0,nan,nan,nan,nan,Bundesliga,15-07-16,17.3.2.23,Dominic Maroh,35007305.0,795.0,04-Mar-87,29.0,7.0,0.0,0.0,0.0,6050.0,6050.0,6550.0,131.0,131.0,6434643.0,186.0,85.0,D C,3.0,3.0,1.0,3.0,2.0,1.0,2.0,3.0,1.0,1.0,3.0,4.0,6.0,6.0,6.0,9.0,5.0,13.0,7.0,10.0,16.0,8.0,7.0,16.0,8.0,14.0,12.0,18.0,10.0,15.0,7.0,11.0,15.0,7.0,14.0,6.0,15.0,14.0,12.0,11.0,9.0,16.0,14.0,9.0,14.0,13.0,20.0,13.0,17.0,15.0,8.0,15.0,10.0,6.0,9.0,13.0,15.0,12.0,14.0,13.0,13.0,7.0,Dominic Maroh,ÃÂ£1.80m ,Bundesliga
19/6/2011,DjikinÃÂ©,55012455,31,5/16/1987,24,0,0,0,0,2000,4049,4000,109,90,60967,188,82,DM C,2,1,3,2,2,3,2,3,1,3,3,7,7,8,8,10,10,13,9,10,11,10,10,12,10,12,10,13,11,10,10,8,13,7,11,11,11,14,12,12,12,15,14,20,15,12,5,13,15,10,10,10,7,12,14,14,13,13,14,14,14,5,15,1,10,1,1,1,15,DM C,301,1,1,1,1,1,1,15,1,1,20,10,1,1,1,1,0.0,0,0,0,0,0,0,0,0,0,0,0,0,0,0,0,0,0,0,0,0,0,0,0,0,0,0,0,0,0,0,0,0,0,0,0,0,0,0,0,0,0,0,0,0,0,0,0,0,nan,nan,nan,nan,nan,nan,nan,nan,nan,nan,nan,nan,nan,nan,nan,nan,nan,nan,nan,nan,nan,nan,nan,nan,nan,nan,nan,nan,nan,nan,nan,nan,nan,nan,nan,nan,nan,nan,nan,nan,nan,nan,nan,nan,nan,nan,nan,nan,nan,nan,nan,nan,29/6/2010,DjikinÃÂ©,55012455.0,31.0,5/16/1987,23.0,0.0,0.0,0.0,0.0,2000.0,4049.0,4000.0,116.0,90.0,226015.0,188.0,82.0,DM C,2.0,2.0,3.0,1.0,1.0,1.0,1.0,1.0,1.0,2.0,1.0,7.0,7.0,8.0,8.0,10.0,10.0,13.0,9.0,10.0,11.0,10.0,10.0,12.0,10.0,12.0,10.0,13.0,11.0,10.0,10.0,8.0,13.0,7.0,11.0,11.0,11.0,14.0,12.0,12.0,12.0,15.0,14.0,20.0,15.0,12.0,5.0,13.0,15.0,10.0,10.0,10.0,7.0,12.0,14.0,14.0,13.0,13.0,14.0,14.0,14.0,5.0,nan,nan,nan
19/6/2011,Davide Astori,7983992,776,1/7/1987,24,1,0,0,0,5750,7400,7200,162,145,1510499,188,80,D C,2,2,3,3,3,2,3,1,3,3,3,6,8,10,10,14,8,16,5,14,15,12,5,17,15,18,15,15,14,14,10,13,16,8,14,8,14,12,10,12,12,15,15,20,16,12,6,14,14,14,12,14,6,11,16,15,18,18,16,14,15,2,20,1,1,1,8,10,20,D C,101,1,1,1,1,1,1,20,10,8,1,1,1,1,1,1,8813270000000.0,0,0,0,0,0,0,0,0,0,0,0,0,0,0,0,1,0,0,0,0,0,0,0,0,0,0,0,0,0,0,0,0,0,0,1,0,0,0,0,0,0,0,0,1,0,0,0,0,Davide Astori,ÃÂ£9.00m ,nan,189.0,Defender - Centre-Back,left,---,36.0,0.0,2.0,3240.0,29.0,1.0,0.0,2541.0,34.0,0.0,0.0,2869.0,35.0,0.0,2.0,3135.0,30.0,1.0,0.0,2524.0,42.0,0.0,0.0,3689.0,40.0,2.0,2.0,3598.0,27.0,1.0,1.0,2408.0,nan,nan,nan,nan,Serie A,nan,nan,nan,nan,nan,nan,nan,nan,29/6/2010,Davide Astori,7983992.0,776.0,1/7/1987,23.0,0.0,0.0,0.0,0.0,500.0,6200.0,6200.0,160.0,137.0,2493884.0,188.0,80.0,D C,2.0,3.0,3.0,1.0,3.0,3.0,3.0,8.0,3.0,2.0,2.0,9.0,8.0,10.0,9.0,10.0,6.0,16.0,5.0,12.0,14.0,12.0,5.0,17.0,14.0,18.0,16.0,10.0,10.0,10.0,12.0,11.0,14.0,8.0,9.0,9.0,13.0,13.0,14.0,13.0,12.0,14.0,15.0,20.0,16.0,13.0,7.0,15.0,14.0,10.0,8.0,12.0,6.0,13.0,16.0,15.0,9.0,11.0,12.0,8.0,18.0,14.0,Davide Astori,ÃÂÃÂ£5.85m ,Serie A,19-06-17,18.3.4.28,Davide Astori,7983992,776,07-Jan-87,30,13,1,0,0,5400,7100,7100,148,142,232186002,188,80,D C,1,3,3,2,3,3,1,1,3,1,3,6,8,9,8,11,7,13,5,13,15,12,5,14,11,14,15,15,13,12,11,12,14,8,12,8,16,15,14,13,13,15,15,20,12,14,8,16,15,14,12,13,9,11,12,14,13,12,14,14,13,6,20,1,1,1,1,1,20,D C,101,1,1,1,1,1,1,20,1,1,1,1,1,1,1,1,8813270000000.0,0,0,0,0,0,0,0,0,0,0,0,0,0,0,0,1,0,0,0,0,0,0,0,0,0,0,0,0,0,0,0,0,0,0,1,0,0,0,0,0,0,0,0,1,0,0,0,0,Davide Astori,- ,nan,189.0,Defender - Centre-Back,left,---,40.0,2.0,2.0,3598.0,27.0,1.0,1.0,2408.0,nan,nan,nan,nan,nan,nan,nan,nan,nan,nan,nan,nan,Serie A,15-07-16,17.3.2.23,Davide Astori,7983992.0,776.0,07-Jan-87,29.0,11.0,1.0,0.0,0.0,5400.0,7150.0,7150.0,148.0,143.0,24593955.0,188.0,80.0,D C,2.0,1.0,2.0,3.0,1.0,4.0,2.0,1.0,2.0,3.0,1.0,6.0,8.0,9.0,8.0,11.0,7.0,13.0,5.0,13.0,15.0,12.0,5.0,14.0,11.0,14.0,16.0,15.0,13.0,12.0,12.0,12.0,14.0,8.0,12.0,8.0,16.0,15.0,14.0,13.0,13.0,15.0,15.0,20.0,12.0,14.0,8.0,16.0,15.0,14.0,12.0,13.0,9.0,11.0,12.0,14.0,13.0,12.0,14.0,14.0,13.0,6.0,Davide Astori,ÃÂ£7.65m ,Serie A
19/6/2011,David Wheater,5118407,765,2/14/1987,24,0,0,11,1,5000,6700,6700,148,131,929545,196,82,D C,3,1,2,3,3,3,2,1,2,3,1,3,5,6,8,8,4,16,8,14,13,9,4,14,10,14,13,19,13,12,9,12,14,5,15,11,13,14,16,10,8,15,18,9,17,12,20,16,14,11,10,10,6,14,15,14,16,14,12,12,10,5,20,1,1,1,12,1,20,D C,101,1,1,8,1,1,1,20,1,12,1,1,1,1,1,1,33536.0,0,0,0,0,0,0,0,0,1,1,0,0,0,0,0,1,0,0,0,0,0,0,0,0,0,0,0,0,0,0,0,0,0,0,0,0,0,0,0,0,0,0,0,0,0,0,0,0,David Wheater,ÃÂ£2.25m ,33.0,196.0,Defender - Centre-Back,right,Oldham Athletic,37.0,3.0,0.0,3236.0,31.0,3.0,2.0,2639.0,5.0,0.0,0.0,83.0,23.0,1.0,1.0,1858.0,24.0,1.0,0.0,1615.0,29.0,1.0,1.0,2491.0,49.0,9.0,0.0,4410.0,35.0,1.0,0.0,2999.0,34.0,0.0,2.0,2953.0,Premier League,35.0,4.0,0.0,3052.0,nan,nan,nan,nan,nan,nan,nan,nan,nan,nan,nan,nan,nan,nan,nan,nan,nan,nan,nan,nan,nan,nan,nan,nan,nan,nan,nan,nan,nan,nan,nan,nan,nan,nan,nan,nan,nan,nan,nan,nan,nan,nan,nan,nan,nan,nan,nan,nan,nan,nan,nan,nan,nan,nan,nan,nan,nan,nan,nan,nan,nan,nan,nan,nan,nan,nan,nan,nan,nan,nan,nan,nan,nan,nan,nan,nan,nan,nan,nan,nan,nan,nan,nan,nan,nan,nan,nan,nan
19/6/2011,David Mateos,67011234,796,4/22/1987,24,0,0,0,0,4050,6050,6050,138,121,0,191,82,D C,3,1,3,3,3,3,2,3,3,1,1,7,6,6,6,10,6,15,7,6,16,11,7,13,9,12,11,13,9,11,8,13,14,11,8,6,13,14,14,10,11,14,15,12,13,12,20,13,17,13,7,12,5,13,11,14,11,8,3,8,13,18,20,1,5,1,1,1,20,D C,101,1,1,1,1,1,1,20,1,1,12,5,1,1,1,1,32768.0,0,0,0,0,0,0,0,0,0,0,0,0,0,0,0,1,0,0,0,0,0,0,0,0,0,0,0,0,0,0,0,0,0,0,0,0,0,0,0,0,0,0,0,0,0,0,0,0,David Mateos,ÃÂ£900Th. ,33.0,191.0,Defender - Centre-Back,right,Hapoel Umm al-Fahm,14.0,0.0,0.0,956.0,15.0,0.0,1.0,1114.0,31.0,1.0,0.0,2602.0,23.0,2.0,1.0,2070.0,32.0,5.0,1.0,2837.0,23.0,1.0,0.0,1940.0,nan,nan,nan,nan,30.0,1.0,0.0,2164.0,30.0,1.0,1.0,2408.0,LaLiga,28.0,1.0,0.0,2401.0,2.0,0.0,0.0,180.0,nan,nan,nan,nan,nan,nan,nan,nan,nan,nan,nan,nan,nan,nan,nan,nan,nan,nan,nan,nan,nan,nan,nan,nan,nan,nan,nan,nan,nan,nan,nan,nan,nan,nan,nan,nan,nan,nan,nan,nan,nan,nan,nan,nan,nan,nan,nan,nan,nan,nan,nan,nan,nan,nan,nan,nan,nan,nan,nan,nan,nan,nan,nan,nan,nan,nan,nan,nan,nan,nan,nan,nan,nan,nan,nan,nan,nan,nan,nan,nan,nan,nan,nan,nan
19/6/2011,David Luiz,2114068,1651,4/22/1987,24,6,0,0,0,7000,7750,7750,167,152,36363636,188,78,D C,2,3,3,2,2,3,3,5,3,2,1,8,9,11,10,13,9,14,12,18,17,12,10,16,13,17,16,16,11,12,8,11,17,10,12,12,13,13,16,17,15,16,16,13,16,15,20,13,14,14,12,13,10,13,16,16,18,16,16,11,10,7,20,1,1,1,12,12,20,D C,101,1,1,1,1,1,1,20,12,12,10,1,1,1,1,1,1125900000000000.0,0,0,0,0,0,1,0,0,0,0,0,0,0,0,0,1,0,0,0,0,0,0,0,0,0,0,0,0,0,0,0,0,0,0,0,0,0,0,0,0,0,0,0,0,0,0,0,0,David Luiz,ÃÂ£20.70m ,33.0,189.0,Defender - Centre-Back,right,Arsenal FC,40.0,2.0,2.0,3473.0,40.0,3.0,2.0,3426.0,57.0,7.0,5.0,4914.0,34.0,0.0,3.0,2683.0,45.0,5.0,1.0,3829.0,40.0,3.0,3.0,3209.0,42.0,1.0,0.0,3754.0,17.0,2.0,0.0,1496.0,50.0,3.0,2.0,4339.0,Premier League,43.0,2.0,1.0,3644.0,8.0,1.0,0.0,590.0,29/6/2010,David Luiz,2114068.0,1651.0,4/22/1987,23.0,0.0,0.0,0.0,0.0,4500.0,7750.0,7350.0,167.0,147.0,26938113.0,188.0,78.0,D C,2.0,2.0,1.0,3.0,3.0,1.0,3.0,5.0,2.0,2.0,3.0,7.0,8.0,10.0,9.0,12.0,8.0,13.0,11.0,17.0,16.0,11.0,9.0,15.0,12.0,17.0,15.0,16.0,10.0,11.0,7.0,11.0,17.0,10.0,12.0,11.0,12.0,12.0,15.0,15.0,14.0,15.0,15.0,13.0,16.0,14.0,20.0,12.0,13.0,14.0,12.0,13.0,10.0,13.0,16.0,16.0,18.0,16.0,16.0,11.0,10.0,7.0,David Luiz,ÃÂÃÂ£18.00m ,Premier League,19-06-17,18.3.4.28,David Luiz,2114068,1651,22-Apr-87,30,57,3,0,0,7500,7900,7500,157,149,232186002,189,86,D/DM C,2,1,3,1,1,2,1,1,1,3,3,8,9,13,12,13,14,15,12,15,15,12,15,16,13,17,16,17,12,10,12,11,17,14,16,12,11,13,16,16,13,16,16,12,16,13,20,14,14,10,12,13,10,13,15,16,18,13,16,11,10,7,20,1,1,1,12,12,20,D/DM C,111,1,1,1,1,1,1,20,12,12,17,1,1,1,1,1,8864810000000.0,0,0,0,0,0,1,0,0,1,0,0,0,0,0,0,1,0,0,0,0,0,0,0,0,0,0,0,0,0,0,0,0,0,0,0,0,1,0,0,0,0,0,0,1,0,0,0,0,David Luiz,ÃÂ£22.50m ,33.0,189.0,Defender - Centre-Back,right,Arsenal FC,42.0,1.0,0.0,3754.0,17.0,2.0,0.0,1496.0,50.0,3.0,2.0,4339.0,43.0,2.0,1.0,3644.0,8.0,1.0,0.0,590.0,Premier League,15-07-16,17.3.2.23,David Luiz,2114068.0,1651.0,22-Apr-87,29.0,56.0,3.0,0.0,0.0,7500.0,8100.0,7750.0,157.0,155.0,74800273.0,189.0,84.0,D/DM C,3.0,2.0,2.0,1.0,1.0,1.0,2.0,2.0,1.0,2.0,1.0,8.0,9.0,13.0,12.0,13.0,14.0,14.0,12.0,18.0,17.0,12.0,15.0,16.0,13.0,17.0,16.0,16.0,12.0,10.0,10.0,11.0,17.0,12.0,15.0,12.0,11.0,13.0,16.0,17.0,15.0,16.0,16.0,10.0,16.0,15.0,20.0,14.0,13.0,10.0,12.0,13.0,10.0,13.0,15.0,16.0,18.0,13.0,16.0,11.0,10.0,7.0,David Luiz,ÃÂ£27.00m ,Premier League
19/6/2011,Daniele Capelli,7991195,776,6/20/1986,24,0,0,0,0,2779,6250,6250,139,125,765765,184,78,D/WB RC,2,2,3,1,1,2,2,2,2,2,3,7,11,7,5,9,7,14,7,10,16,11,7,15,11,15,13,12,6,13,9,12,16,6,15,7,14,13,12,12,12,13,13,8,14,13,20,12,14,14,7,14,5,9,5,15,20,17,18,19,7,9,20,16,1,1,19,1,20,D/WB RC,113,1,1,1,1,1,1,20,1,19,1,1,1,1,1,16,0.0,0,0,0,0,0,0,0,0,0,0,0,0,0,0,0,0,0,0,0,0,0,0,0,0,0,0,0,0,0,0,0,0,0,0,0,0,0,0,0,0,0,0,0,0,0,0,0,0,Daniele Capelli,ÃÂ£900Th. ,34.0,186.0,Defender - Centre-Back,both,Without Club,33.0,1.0,0.0,2772.0,11.0,0.0,1.0,879.0,4.0,0.0,0.0,314.0,34.0,1.0,0.0,2902.0,32.0,0.0,0.0,2710.0,26.0,0.0,0.0,1968.0,18.0,0.0,0.0,1556.0,19.0,0.0,0.0,912.0,19.0,1.0,2.0,1642.0,Serie A,3.0,0.0,0.0,51.0,nan,nan,nan,nan,nan,nan,nan,nan,nan,nan,nan,nan,nan,nan,nan,nan,nan,nan,nan,nan,nan,nan,nan,nan,nan,nan,nan,nan,nan,nan,nan,nan,nan,nan,nan,nan,nan,nan,nan,nan,nan,nan,nan,nan,nan,nan,nan,nan,nan,nan,nan,nan,nan,nan,nan,nan,nan,nan,nan,nan,nan,nan,nan,nan,nan,nan,nan,nan,nan,nan,nan,nan,nan,nan,nan,nan,nan,nan,nan,nan,nan,nan,nan,nan,nan,nan,nan,nan
19/6/2011,CristiÃÂ¡n Zapata,8825553,1653,9/30/1986,24,18,0,0,0,5350,7450,7000,162,149,2465039,187,79,D C,2,2,1,2,1,3,3,4,2,2,3,3,9,8,9,10,3,13,6,6,17,10,4,17,9,12,15,16,14,11,5,10,12,7,8,12,16,11,11,16,14,15,16,12,14,15,20,12,16,14,8,16,7,11,18,9,16,10,16,15,17,4,20,1,1,1,13,1,20,D C,101,1,1,1,1,1,1,20,1,13,1,1,1,1,1,1,137439000000.0,0,0,0,0,0,0,0,0,0,0,0,0,0,0,0,0,0,0,0,0,0,0,0,0,0,0,0,0,0,0,0,0,0,0,0,0,0,1,0,0,0,0,0,0,0,0,0,0,CristiÃÂ¡n Zapata,ÃÂ£6.30m ,34.0,187.0,Defender - Centre-Back,right,Genoa CFC,38.0,2.0,3.0,3389.0,36.0,0.0,1.0,3199.0,29.0,0.0,2.0,2391.0,29.0,2.0,2.0,2549.0,13.0,0.0,1.0,955.0,21.0,1.0,1.0,1844.0,16.0,1.0,0.0,1259.0,20.0,0.0,0.0,1713.0,20.0,1.0,0.0,1687.0,LaLiga,22.0,1.0,0.0,1860.0,3.0,0.0,0.0,270.0,29/6/2010,CristiÃÂ¡n Zapata,8825553.0,1653.0,9/30/1986,23.0,18.0,0.0,0.0,0.0,4900.0,7000.0,7200.0,167.0,143.0,40741318.0,187.0,79.0,D C,2.0,2.0,2.0,2.0,2.0,2.0,3.0,1.0,1.0,1.0,3.0,3.0,9.0,8.0,7.0,10.0,3.0,14.0,6.0,6.0,17.0,10.0,4.0,17.0,11.0,12.0,15.0,16.0,14.0,11.0,5.0,10.0,12.0,7.0,5.0,12.0,16.0,10.0,11.0,16.0,14.0,15.0,16.0,12.0,14.0,15.0,20.0,12.0,15.0,14.0,6.0,16.0,7.0,13.0,18.0,9.0,16.0,10.0,16.0,15.0,17.0,4.0,CristiÃÂÃÂ¡n Zapata,ÃÂÃÂ£8.10m ,Serie A,19-06-17,18.3.4.28,CristiÃÂ¡n Zapata,8825553,1653,30-Sep-86,30,44,1,4,0,5500,7250,6750,148,135,12251994,186,78,D C,3,2,3,1,1,1,3,2,2,1,1,1,5,8,5,9,2,15,3,12,16,10,4,15,9,15,13,15,12,9,7,11,13,4,12,8,15,16,13,13,13,18,15,9,14,14,20,16,16,13,15,13,15,8,18,13,16,11,14,16,15,4,20,1,1,1,10,1,20,D C,101,1,6,1,1,1,1,20,1,10,1,1,1,1,1,1,137439000000.0,0,0,0,0,0,0,0,0,0,0,0,0,0,0,0,0,0,0,0,0,0,0,0,0,0,0,0,0,0,0,0,0,0,0,0,0,0,1,0,0,0,0,0,0,0,0,0,0,CristiÃÂ¡n Zapata,ÃÂ£2.25m ,34.0,187.0,Defender - Centre-Back,right,Genoa CFC,16.0,1.0,0.0,1259.0,20.0,0.0,0.0,1713.0,20.0,1.0,0.0,1687.0,22.0,1.0,0.0,1860.0,3.0,0.0,0.0,270.0,Serie A,15-07-16,17.3.2.23,CristiÃÂ¡n Zapata,8825553.0,1653.0,30-Sep-86,29.0,44.0,1.0,4.0,0.0,5500.0,7000.0,6700.0,149.0,133.0,4311944.0,186.0,78.0,D C,3.0,1.0,1.0,1.0,2.0,1.0,4.0,2.0,3.0,4.0,2.0,1.0,5.0,8.0,4.0,9.0,2.0,15.0,3.0,11.0,16.0,10.0,4.0,15.0,9.0,14.0,13.0,15.0,12.0,10.0,7.0,11.0,13.0,4.0,9.0,8.0,15.0,16.0,13.0,13.0,12.0,18.0,15.0,9.0,14.0,14.0,20.0,16.0,16.0,13.0,15.0,13.0,15.0,8.0,18.0,13.0,16.0,11.0,14.0,16.0,15.0,4.0,CristiÃÂ¡n Zapata,ÃÂ£2.25m ,Serie A
19/6/2011,Chico,1507717,796,3/6/1987,24,0,0,3,0,4618,6362,6133,148,128,944548,186,77,D C,3,3,2,1,2,2,2,5,3,2,3,7,7,6,8,9,8,14,9,9,15,11,7,12,11,14,14,15,13,13,9,12,14,6,12,7,11,15,17,12,10,13,13,9,12,13,20,16,15,14,10,11,8,10,12,16,17,12,9,11,10,10,20,1,6,1,11,1,20,D C,101,1,1,1,1,1,1,20,1,11,11,6,1,1,1,1,8800390000000.0,0,0,0,0,0,0,0,0,0,0,0,0,0,0,0,0,0,0,0,0,0,0,0,0,0,0,0,0,0,0,0,0,1,0,0,0,0,0,0,0,0,0,0,1,0,0,0,0,Chico,ÃÂ£3.15m ,33.0,187.0,Defender - Centre-Back,right,Retired,16.0,0.0,0.0,744.0,34.0,0.0,2.0,2973.0,32.0,1.0,0.0,2748.0,43.0,3.0,1.0,3742.0,35.0,5.0,1.0,3128.0,24.0,2.0,1.0,2112.0,24.0,2.0,3.0,2160.0,29.0,0.0,0.0,2575.0,8.0,0.0,1.0,675.0,LaLiga,19.0,0.0,0.0,1432.0,nan,nan,nan,nan,29/6/2010,Chico,1507717.0,796.0,3/6/1987,23.0,0.0,0.0,3.0,0.0,4450.0,6100.0,6100.0,148.0,135.0,28814831.0,186.0,77.0,D C,1.0,3.0,1.0,1.0,1.0,3.0,1.0,5.0,1.0,2.0,1.0,7.0,7.0,6.0,8.0,10.0,8.0,15.0,9.0,9.0,15.0,11.0,7.0,13.0,11.0,14.0,14.0,15.0,13.0,13.0,9.0,12.0,14.0,6.0,12.0,7.0,13.0,15.0,17.0,12.0,11.0,13.0,13.0,9.0,12.0,13.0,20.0,16.0,15.0,14.0,10.0,11.0,8.0,10.0,12.0,16.0,17.0,12.0,9.0,11.0,10.0,10.0,Chico,ÃÂÃÂ£2.70m ,Serie A
19/6/2011,CÃÂ©dric Cambon,8428619,769,9/20/1986,24,0,0,2,0,3700,4650,4650,120,104,93913,183,76,D/DM C,1,2,2,1,3,3,3,1,1,1,3,5,8,8,6,10,6,13,7,7,10,11,6,13,10,13,13,13,12,12,9,12,12,6,9,6,13,15,15,12,10,13,11,20,15,8,8,16,13,13,13,14,5,10,10,14,14,10,14,14,14,7,20,1,10,1,1,10,20,D/DM C,111,1,12,1,1,1,1,20,10,1,17,10,1,1,1,1,0.0,0,0,0,0,0,0,0,0,0,0,0,0,0,0,0,0,0,0,0,0,0,0,0,0,0,0,0,0,0,0,0,0,0,0,0,0,0,0,0,0,0,0,0,0,0,0,0,0,CÃÂ©dric Cambon,ÃÂ£1.35m ,34.0,184.0,Defender - Centre-Back,right,Retired,30.0,3.0,0.0,2528.0,37.0,4.0,0.0,3250.0,25.0,1.0,0.0,2007.0,29.0,2.0,1.0,1859.0,28.0,1.0,0.0,2319.0,36.0,1.0,1.0,3073.0,31.0,0.0,0.0,2440.0,34.0,4.0,2.0,3019.0,33.0,0.0,0.0,2514.0,Ligue 1,20.0,0.0,0.0,1658.0,nan,nan,nan,nan,nan,nan,nan,nan,nan,nan,nan,nan,nan,nan,nan,nan,nan,nan,nan,nan,nan,nan,nan,nan,nan,nan,nan,nan,nan,nan,nan,nan,nan,nan,nan,nan,nan,nan,nan,nan,nan,nan,nan,nan,nan,nan,nan,nan,nan,nan,nan,nan,nan,nan,nan,nan,nan,nan,nan,nan,nan,nan,nan,nan,nan,nan,nan,nan,nan,nan,nan,nan,nan,nan,nan,nan,nan,nan,nan,nan,nan,nan,nan,nan,nan,nan,nan,nan
19/6/2011,Benjamin Angoua,38001740,24,11/28/1986,24,7,0,4,0,4917,6121,5469,140,122,378141,183,72,D/DM RC,1,3,1,2,1,3,3,1,2,1,1,5,9,6,6,7,5,14,7,10,13,8,6,14,7,13,15,14,15,13,9,12,13,9,6,8,13,15,13,11,12,14,12,10,13,14,20,15,13,14,13,12,8,10,14,12,13,13,14,11,11,7,20,15,10,1,15,12,20,D/DM RC,113,1,1,1,1,1,1,20,12,15,18,10,1,1,12,15,0.0,0,0,0,0,0,0,0,0,0,0,0,0,0,0,0,0,0,0,0,0,0,0,0,0,0,0,0,0,0,0,0,0,0,0,0,0,0,0,0,0,0,0,0,0,0,0,0,0,Benjamin Angoua,ÃÂ£2.25m ,33.0,183.0,Defender - Centre-Back,right,Stade Briochin,34.0,1.0,0.0,3010.0,22.0,0.0,0.0,1908.0,25.0,0.0,1.0,2228.0,17.0,1.0,0.0,1485.0,30.0,0.0,0.0,2326.0,20.0,1.0,0.0,1477.0,39.0,1.0,2.0,3434.0,nan,nan,nan,nan,7.0,0.0,0.0,532.0,Ligue 1,17.0,1.0,0.0,1487.0,9.0,1.0,0.0,810.0,29/6/2010,Benjamin Angoua,38001740.0,24.0,11/28/1986,23.0,7.0,1.0,4.0,1.0,3481.0,5900.0,5300.0,140.0,118.0,2686252.0,183.0,72.0,D/DM RC,2.0,2.0,3.0,2.0,2.0,1.0,3.0,8.0,2.0,1.0,1.0,5.0,9.0,6.0,6.0,7.0,5.0,14.0,7.0,10.0,13.0,8.0,6.0,13.0,7.0,13.0,15.0,14.0,15.0,13.0,10.0,12.0,13.0,9.0,6.0,8.0,13.0,15.0,13.0,10.0,12.0,14.0,12.0,10.0,13.0,14.0,20.0,15.0,13.0,15.0,13.0,13.0,8.0,10.0,14.0,12.0,13.0,13.0,14.0,11.0,11.0,7.0,Benjamin Angoua,ÃÂÃÂ£1.98m ,Ligue 1,19-06-17,18.3.4.28,Benjamin Angoua,38001740,24,28-Nov-86,30,17,1,4,0,3950,5550,5900,121,118,1883934,183,73,D RC,1,1,1,1,1,1,1,1,1,1,1,4,8,6,6,8,5,14,7,10,15,7,6,14,8,14,12,16,10,12,10,11,13,9,8,8,12,15,14,11,12,14,11,10,13,14,20,15,14,14,13,13,8,12,14,12,13,13,14,11,11,7,20,14,7,1,15,13,20,D RC,103,1,1,1,1,1,1,20,13,15,14,7,1,1,12,14,32832.0,0,0,0,0,0,0,1,0,0,0,0,0,0,0,0,1,0,0,0,0,0,0,0,0,0,0,0,0,0,0,0,0,0,0,0,0,0,0,0,0,0,0,0,0,0,0,0,0,Benjamin Angoua,ÃÂ£900Th. ,33.0,183.0,Defender - Centre-Back,right,Stade Briochin,39.0,1.0,2.0,3434.0,nan,nan,nan,nan,7.0,0.0,0.0,532.0,17.0,1.0,0.0,1487.0,9.0,1.0,0.0,810.0,Ligue 1,nan,nan,nan,nan,nan,nan,nan,nan,nan,nan,nan,nan,nan,nan,nan,nan,nan,nan,nan,nan,nan,nan,nan,nan,nan,nan,nan,nan,nan,nan,nan,nan,nan,nan,nan,nan,nan,nan,nan,nan,nan,nan,nan,nan,nan,nan,nan,nan,nan,nan,nan,nan,nan,nan,nan,nan,nan,nan,nan,nan,nan,nan,nan,nan,nan,nan,nan,nan,nan,nan,nan,nan,nan,nan,nan,nan,nan,nan,nan,nan,nan,nan,nan,nan,nan
19/6/2011,Ammar Jemal,12003008,51,4/20/1987,24,15,1,0,0,3900,5918,6250,136,125,248916,185,87,D LC,1,3,3,2,1,2,1,1,3,2,2,9,12,8,6,10,8,14,8,12,14,10,8,13,12,16,15,15,13,12,10,13,13,11,12,10,13,14,14,11,9,15,14,20,14,11,4,15,15,13,12,14,8,14,12,14,10,10,11,10,12,8,20,1,1,1,1,18,20,D LC,104,1,1,1,1,1,1,20,18,1,1,1,1,1,1,1,0.0,0,0,0,0,0,0,0,0,0,0,0,0,0,0,0,0,0,0,0,0,0,0,0,0,0,0,0,0,0,0,0,0,0,0,0,0,0,0,0,0,0,0,0,0,0,0,0,0,Ammar Jemal,ÃÂ£1.35m ,33.0,186.0,Defender - Centre-Back,left,Al-Sahel Club,39.0,7.0,1.0,3127.0,16.0,1.0,0.0,1234.0,6.0,0.0,0.0,239.0,17.0,0.0,0.0,1447.0,23.0,0.0,1.0,1864.0,31.0,2.0,2.0,2729.0,18.0,4.0,1.0,1623.0,31.0,4.0,1.0,2782.0,14.0,0.0,0.0,1115.0,Bundesliga,14.0,0.0,0.0,1077.0,nan,nan,nan,nan,nan,nan,nan,nan,nan,nan,nan,nan,nan,nan,nan,nan,nan,nan,nan,nan,nan,nan,nan,nan,nan,nan,nan,nan,nan,nan,nan,nan,nan,nan,nan,nan,nan,nan,nan,nan,nan,nan,nan,nan,nan,nan,nan,nan,nan,nan,nan,nan,nan,nan,nan,nan,nan,nan,nan,nan,nan,nan,nan,nan,nan,nan,nan,nan,nan,nan,nan,nan,nan,nan,nan,nan,nan,nan,nan,nan,nan,nan,nan,nan,nan,nan,nan,nan
19/6/2011,Younes Kaboul,918434,769,1/4/1986,25,2,1,20,1,5650,6696,7150,166,148,2552000,191,85,D RC,3,2,3,1,2,3,3,4,3,3,2,7,13,8,10,14,10,15,14,8,13,11,8,14,12,15,11,14,13,12,13,14,14,6,12,9,15,12,12,14,9,16,17,12,11,15,20,14,19,12,10,12,12,8,13,16,15,12,15,14,13,8,20,1,10,1,15,1,20,D RC,103,1,1,1,1,1,1,20,1,15,14,10,1,1,1,1,43984800000000.0,0,1,0,0,0,0,0,0,0,0,0,0,0,0,0,0,0,0,0,0,0,0,0,0,0,0,0,0,0,0,0,0,1,0,0,0,0,0,0,0,0,0,0,1,0,1,0,0,YounÃÂ¨s Kaboul,ÃÂ£13.50m ,34.0,192.0,Defender - Centre-Back,right,Retired,24.0,2.0,1.0,1902.0,41.0,1.0,1.0,3533.0,3.0,0.0,0.0,198.0,20.0,1.0,1.0,1583.0,15.0,0.0,0.0,1350.0,23.0,0.0,1.0,2009.0,25.0,2.0,0.0,2065.0,2.0,0.0,0.0,152.0,nan,nan,nan,nan,Premier League,nan,nan,nan,nan,nan,nan,nan,nan,29/6/2010,Younes Kaboul,918434.0,769.0,1/4/1986,24.0,0.0,0.0,20.0,1.0,5041.0,6400.0,6900.0,160.0,142.0,13800000.0,191.0,85.0,D RC,1.0,3.0,3.0,3.0,3.0,3.0,2.0,1.0,2.0,1.0,3.0,7.0,13.0,8.0,10.0,14.0,10.0,15.0,14.0,8.0,13.0,11.0,8.0,14.0,12.0,11.0,11.0,14.0,13.0,12.0,13.0,12.0,14.0,6.0,12.0,9.0,13.0,12.0,12.0,14.0,9.0,16.0,17.0,12.0,11.0,15.0,20.0,14.0,19.0,12.0,10.0,12.0,12.0,8.0,13.0,16.0,15.0,12.0,15.0,14.0,13.0,8.0,YounÃÂÃÂ¨s Kaboul,ÃÂÃÂ£6.75m ,Premier League
19/6/2011,Vincent Kompany,8152558,757,4/10/1986,25,39,1,0,0,7000,8250,8250,175,164,18181818,191,91,D/DM C,1,2,1,1,1,3,1,6,3,3,3,5,5,9,7,14,12,18,10,12,16,12,10,17,13,14,15,18,16,15,12,14,17,11,16,9,17,14,15,15,15,16,16,10,12,13,20,15,16,17,8,15,10,14,15,18,16,18,16,17,16,15,20,1,15,1,12,1,20,D/DM C,111,1,1,1,1,1,1,20,1,12,17,15,1,1,1,1,0.0,0,0,0,0,0,0,0,0,0,0,0,0,0,0,0,0,0,0,0,0,0,0,0,0,0,0,0,0,0,0,0,0,0,0,0,0,0,0,0,0,0,0,0,0,0,0,0,0,Vincent Kompany,ÃÂ£31.50m ,34.0,190.0,Defender - Centre-Back,right,Retired,50.0,0.0,2.0,4279.0,42.0,3.0,2.0,3608.0,37.0,1.0,0.0,3179.0,37.0,5.0,1.0,3129.0,33.0,0.0,0.0,2753.0,22.0,2.0,0.0,1661.0,15.0,3.0,0.0,1167.0,21.0,2.0,1.0,1756.0,26.0,1.0,1.0,1782.0,Premier League,18.0,1.0,1.0,1484.0,nan,nan,nan,nan,29/6/2010,Vincent Kompany,8152558.0,757.0,4/10/1986,24.0,31.0,1.0,0.0,0.0,5476.0,7750.0,7400.0,156.0,148.0,14692290.0,191.0,91.0,D/DM C,3.0,2.0,1.0,2.0,2.0,1.0,3.0,1.0,2.0,1.0,2.0,5.0,5.0,9.0,7.0,14.0,12.0,15.0,10.0,12.0,14.0,12.0,10.0,16.0,12.0,14.0,15.0,14.0,14.0,12.0,12.0,12.0,15.0,11.0,14.0,9.0,15.0,14.0,14.0,15.0,15.0,16.0,16.0,10.0,6.0,13.0,20.0,15.0,16.0,11.0,8.0,15.0,17.0,14.0,14.0,13.0,11.0,18.0,8.0,17.0,14.0,12.0,Vincent Kompany,ÃÂÃÂ£18.00m ,Premier League,19-06-17,18.3.4.28,Vincent Kompany,8152558,757,10-Apr-86,31,74,4,0,0,8000,8500,8500,168,159,232186002,193,85,D/DM C,3,2,3,1,2,1,3,3,2,2,1,5,5,10,7,14,6,16,7,10,16,13,8,16,14,14,16,17,15,15,11,14,17,11,18,7,16,17,15,13,12,15,16,9,10,13,20,13,16,17,8,16,18,14,13,19,16,18,18,17,16,15,20,1,12,1,12,1,20,D/DM C,111,1,1,1,1,1,1,20,1,12,17,12,1,1,1,1,4294967296.0,0,0,0,0,0,0,0,0,0,0,0,0,0,0,0,0,0,0,0,0,0,0,0,0,0,0,0,0,0,0,0,0,1,0,0,0,0,0,0,0,0,0,0,0,0,0,0,0,Vincent Kompany,ÃÂ£9.00m ,34.0,190.0,Defender - Centre-Back,right,Retired,15.0,3.0,0.0,1167.0,21.0,2.0,1.0,1756.0,26.0,1.0,1.0,1782.0,18.0,1.0,1.0,1484.0,nan,nan,nan,nan,Premier League,15-07-16,17.3.2.23,Vincent Kompany,8152558.0,757.0,10-Apr-86,30.0,71.0,4.0,0.0,0.0,8000.0,8500.0,8500.0,168.0,164.0,232186002.0,193.0,91.0,D/DM C,3.0,1.0,3.0,1.0,2.0,3.0,3.0,2.0,1.0,1.0,3.0,5.0,5.0,10.0,7.0,14.0,7.0,16.0,7.0,10.0,16.0,12.0,9.0,18.0,14.0,14.0,16.0,17.0,15.0,15.0,12.0,14.0,17.0,11.0,18.0,9.0,16.0,17.0,16.0,14.0,12.0,15.0,16.0,9.0,10.0,13.0,20.0,14.0,16.0,15.0,8.0,15.0,17.0,14.0,13.0,19.0,16.0,18.0,18.0,17.0,16.0,15.0,Vincent Kompany,ÃÂ£19.80m ,Premier League
19/6/2011,Vedran Corluka,126527,761,3/31/1986,25,36,1,0,0,6250,7810,7200,155,142,9071504,192,89,D RC,2,2,3,2,1,1,1,2,1,2,3,3,11,12,9,13,5,15,5,15,13,11,6,15,15,14,17,13,18,12,10,12,17,5,12,10,12,15,14,12,13,16,15,13,14,11,20,14,16,15,4,16,11,12,13,14,15,13,16,17,15,8,20,14,15,1,20,10,16,D RC,103,1,12,1,1,1,1,16,10,20,12,15,1,1,1,14,143881000000.0,0,0,0,1,0,1,0,0,0,0,0,0,0,0,0,0,0,0,0,0,0,0,0,0,0,0,0,0,0,0,0,1,1,0,0,0,0,1,0,0,0,0,0,0,0,0,0,0,Vedran Corluka,ÃÂ£6.75m ,34.0,192.0,Defender - Centre-Back,right,Lokomotiv Moscow,24.0,0.0,1.0,1933.0,16.0,0.0,2.0,1302.0,28.0,1.0,2.0,2493.0,28.0,1.0,1.0,2520.0,32.0,2.0,1.0,2921.0,29.0,3.0,0.0,2540.0,21.0,0.0,2.0,1688.0,8.0,0.0,0.0,662.0,30.0,1.0,1.0,2619.0,Premier League,34.0,0.0,0.0,2965.0,13.0,1.0,1.0,1071.0,29/6/2010,Vedran Corluka,126527.0,761.0,3/31/1986,24.0,36.0,1.0,0.0,0.0,5184.0,7920.0,7400.0,164.0,144.0,43486185.0,192.0,89.0,D RC,1.0,1.0,2.0,3.0,2.0,1.0,2.0,5.0,2.0,1.0,2.0,3.0,11.0,11.0,9.0,13.0,5.0,15.0,5.0,15.0,13.0,11.0,6.0,15.0,15.0,14.0,15.0,13.0,17.0,12.0,10.0,12.0,17.0,5.0,12.0,8.0,12.0,15.0,14.0,14.0,13.0,16.0,15.0,13.0,14.0,12.0,20.0,14.0,16.0,15.0,4.0,16.0,11.0,12.0,13.0,14.0,15.0,13.0,16.0,17.0,15.0,8.0,Vedran Corluka,ÃÂÃÂ£10.80m ,Premier League
19/6/2011,Thomas Vermaelen,8154103,757,11/14/1985,25,32,1,12,1,6700,8000,7750,167,157,20190211,183,73,D LC,3,3,1,1,1,2,2,3,1,1,1,7,8,10,11,13,8,17,13,2,15,13,9,16,13,16,17,18,15,14,12,13,18,7,15,11,16,14,14,12,13,14,15,20,14,14,10,14,14,15,7,14,10,13,18,14,15,13,16,13,13,3,20,10,1,1,5,17,20,D LC,104,1,1,1,1,1,1,20,17,5,10,1,1,1,10,1,8796090000000.0,0,0,0,0,0,0,0,0,0,0,0,0,0,0,0,0,0,0,0,0,0,0,0,0,0,0,0,0,0,0,0,0,0,0,0,0,0,0,0,0,0,0,0,1,0,0,0,0,Thomas Vermaelen,ÃÂ£16.65m ,34.0,183.0,Defender - Centre-Back,left,Vissel Kobe,6.0,0.0,1.0,540.0,40.0,6.0,2.0,3382.0,39.0,1.0,0.0,3164.0,21.0,0.0,1.0,1366.0,1.0,0.0,0.0,63.0,20.0,1.0,0.0,1271.0,12.0,0.0,0.0,609.0,20.0,0.0,1.0,1512.0,24.0,0.0,1.0,1829.0,Premier League,16.0,0.0,0.0,1333.0,nan,nan,nan,nan,29/6/2010,Thomas Vermaelen,8154103.0,757.0,11/14/1985,24.0,27.0,1.0,12.0,1.0,6162.0,8000.0,7850.0,164.0,157.0,-1.0,183.0,73.0,D LC,2.0,2.0,2.0,3.0,2.0,3.0,1.0,5.0,3.0,2.0,3.0,7.0,8.0,10.0,11.0,13.0,8.0,17.0,13.0,8.0,15.0,13.0,10.0,16.0,13.0,16.0,17.0,18.0,15.0,14.0,12.0,13.0,18.0,7.0,15.0,11.0,16.0,14.0,14.0,12.0,13.0,14.0,13.0,20.0,14.0,14.0,10.0,14.0,14.0,15.0,7.0,14.0,10.0,13.0,16.0,14.0,15.0,13.0,16.0,13.0,13.0,3.0,Thomas Vermaelen,ÃÂÃÂ£16.20m ,Premier League,19-06-17,18.3.4.28,Thomas Vermaelen,8154103,757,14-Nov-85,31,59,1,12,1,6900,7500,7500,160,149,19512353,183,80,D C,3,1,1,4,2,2,2,3,3,1,2,7,8,10,8,14,10,15,12,13,15,13,11,15,14,15,16,14,16,15,12,14,18,7,14,13,15,15,16,11,11,13,14,20,9,13,10,13,14,15,11,14,16,13,18,13,13,13,16,13,11,3,20,1,1,1,5,14,20,D C,101,1,1,1,1,1,1,20,14,5,1,1,1,1,1,1,43980500000000.0,0,0,0,0,0,1,0,0,0,1,0,0,0,0,0,0,0,0,0,0,0,0,0,0,0,0,0,0,0,0,0,0,0,0,0,0,0,0,0,0,0,0,0,1,0,1,0,0,Thomas Vermaelen,ÃÂ£4.50m ,34.0,183.0,Defender - Centre-Back,left,Vissel Kobe,12.0,0.0,0.0,609.0,20.0,0.0,1.0,1512.0,24.0,0.0,1.0,1829.0,16.0,0.0,0.0,1333.0,nan,nan,nan,nan,LaLiga,15-07-16,17.3.2.23,Thomas Vermaelen,8154103.0,757.0,14-Nov-85,30.0,57.0,1.0,12.0,1.0,6500.0,7500.0,7500.0,160.0,150.0,19451745.0,183.0,80.0,D C,2.0,1.0,1.0,4.0,1.0,3.0,4.0,3.0,3.0,3.0,2.0,7.0,8.0,10.0,9.0,13.0,10.0,17.0,13.0,13.0,15.0,13.0,11.0,16.0,14.0,15.0,15.0,14.0,15.0,13.0,11.0,14.0,18.0,7.0,14.0,13.0,14.0,15.0,16.0,11.0,11.0,13.0,16.0,20.0,9.0,13.0,10.0,14.0,14.0,14.0,11.0,14.0,15.0,13.0,18.0,14.0,15.0,13.0,16.0,13.0,11.0,3.0,Thomas Vermaelen,ÃÂ£2.70m ,Serie A
19/6/2011,Steven Taylor,5114243,765,1/23/1986,25,0,0,29,4,4750,6550,6550,144,131,1962746,188,81,D RC,1,2,2,3,2,1,3,1,2,1,3,5,8,9,9,9,3,18,3,8,14,10,5,15,9,17,15,18,10,9,8,8,18,5,14,9,13,11,18,13,11,14,16,8,11,15,20,15,16,13,14,16,12,10,10,15,9,14,12,6,9,7,20,1,1,1,18,10,20,D RC,103,1,1,1,1,1,1,20,10,18,1,1,1,1,1,1,2199020000000.0,0,0,0,0,0,1,0,0,0,0,0,0,0,0,0,1,1,0,0,0,0,0,0,0,0,0,0,0,0,0,0,0,0,0,0,0,0,0,0,0,0,1,0,0,0,0,0,0,Steven Taylor,ÃÂ£5.40m ,34.0,186.0,Defender - Centre-Back,right,Odisha FC,17.0,3.0,1.0,1202.0,15.0,0.0,1.0,1335.0,33.0,0.0,0.0,2724.0,12.0,1.0,0.0,910.0,12.0,1.0,0.0,861.0,21.0,2.0,0.0,1799.0,6.0,0.0,0.0,431.0,51.0,4.0,2.0,4544.0,23.0,2.0,1.0,2070.0,Premier League,27.0,1.0,0.0,2385.0,nan,nan,nan,nan,29/6/2010,Steven Taylor,5114243.0,765.0,1/23/1986,24.0,0.0,0.0,29.0,4.0,4422.0,6500.0,6500.0,150.0,133.0,3950340.0,188.0,81.0,D RC,2.0,1.0,3.0,1.0,3.0,1.0,3.0,6.0,1.0,3.0,1.0,5.0,8.0,9.0,10.0,9.0,3.0,16.0,3.0,8.0,14.0,10.0,5.0,15.0,9.0,17.0,14.0,18.0,9.0,11.0,8.0,9.0,18.0,5.0,14.0,10.0,13.0,11.0,18.0,13.0,11.0,12.0,16.0,8.0,11.0,15.0,20.0,15.0,16.0,11.0,16.0,16.0,9.0,10.0,10.0,15.0,9.0,14.0,12.0,7.0,9.0,5.0,Steven Taylor,ÃÂÃÂ£5.40m ,Premier League
19/6/2011,Steven Paulle,8446341,769,2/10/1986,25,0,0,0,0,2500,3750,3750,120,113,44558,187,82,D C,3,1,3,1,2,3,2,7,3,3,2,5,6,6,8,7,5,15,6,5,12,9,6,12,7,12,13,14,11,13,7,12,15,5,11,6,12,14,13,10,9,14,13,8,15,14,20,14,14,14,12,14,6,12,8,13,18,14,15,14,14,6,20,10,1,1,10,12,20,D C,101,1,1,1,1,1,1,20,12,10,1,1,1,1,10,10,137439000000.0,0,0,0,0,0,1,0,0,0,0,0,0,0,0,0,0,0,0,0,0,0,0,0,0,0,0,0,0,0,0,0,0,0,0,0,0,0,1,0,0,0,0,0,0,0,0,0,0,Steven Paulle,ÃÂ£810Th. ,34.0,187.0,Defender - Centre-Back,right,AS Cannes,34.0,2.0,1.0,3003.0,26.0,1.0,0.0,2080.0,15.0,0.0,1.0,1056.0,17.0,0.0,0.0,1352.0,16.0,0.0,0.0,1365.0,8.0,0.0,0.0,681.0,27.0,1.0,0.0,2400.0,31.0,1.0,0.0,2790.0,13.0,1.0,0.0,1052.0,Ligue 1,nan,nan,nan,nan,nan,nan,nan,nan,nan,nan,nan,nan,nan,nan,nan,nan,nan,nan,nan,nan,nan,nan,nan,nan,nan,nan,nan,nan,nan,nan,nan,nan,nan,nan,nan,nan,nan,nan,nan,nan,nan,nan,nan,nan,nan,nan,nan,nan,nan,nan,nan,nan,nan,nan,nan,nan,nan,nan,nan,nan,nan,nan,nan,nan,nan,nan,nan,nan,nan,nan,nan,nan,nan,nan,nan,nan,nan,nan,nan,nan,nan,nan,nan,nan,nan,nan,nan,nan,nan,nan,nan,nan
19/6/2011,StÃÂ©phane Mbia,8440903,11,5/20/1986,25,38,3,4,1,5960,7362,6649,165,147,1459951,189,82,D/DM C,2,3,2,2,3,2,2,3,3,1,3,6,10,11,7,11,10,17,12,8,15,12,8,13,12,15,17,16,14,11,8,12,16,9,11,10,16,14,14,16,11,18,14,8,15,14,20,17,17,15,15,16,10,14,14,20,8,13,6,8,8,16,20,12,12,1,12,1,20,D/DM C,111,1,1,1,1,1,1,20,1,12,16,12,1,1,1,12,279173000000.0,0,0,0,0,0,0,0,0,1,0,0,0,0,0,0,0,0,0,0,0,0,0,0,0,0,0,0,0,0,0,0,0,1,0,0,0,0,0,1,0,0,0,0,0,0,0,0,0,StÃÂ©phane Mbia,ÃÂ£9.90m ,34.0,189.0,Midfielder - Defensive Midfield,right,Shanghai Greenland Shenhua,37.0,1.0,2.0,2921.0,24.0,2.0,0.0,1888.0,36.0,0.0,4.0,2960.0,30.0,5.0,4.0,2387.0,36.0,7.0,2.0,2447.0,45.0,9.0,1.0,3848.0,14.0,3.0,0.0,1250.0,nan,nan,nan,nan,29.0,0.0,2.0,2475.0,Ligue 1,12.0,0.0,0.0,932.0,nan,nan,nan,nan,29/6/2010,StÃÂ©phane Mbia,8440903.0,11.0,5/20/1986,24.0,34.0,3.0,4.0,1.0,5476.0,7400.0,6650.0,165.0,148.0,28514819.0,189.0,82.0,D/DM C,1.0,3.0,3.0,2.0,2.0,1.0,1.0,2.0,3.0,1.0,2.0,7.0,10.0,12.0,7.0,11.0,11.0,16.0,12.0,8.0,14.0,12.0,8.0,15.0,12.0,15.0,16.0,16.0,15.0,12.0,8.0,12.0,16.0,9.0,11.0,10.0,16.0,14.0,17.0,15.0,10.0,18.0,14.0,8.0,15.0,14.0,20.0,17.0,17.0,14.0,16.0,16.0,10.0,14.0,14.0,20.0,8.0,13.0,6.0,8.0,8.0,16.0,StÃÂÃÂ©phane Mbia,ÃÂÃÂ£13.50m ,Ligue 1
19/6/2011,Simone Gozzi,1405446,776,2/21/1986,25,0,0,0,0,2059,5117,5117,125,104,17141,188,85,D C,2,1,3,1,2,2,1,4,1,2,3,5,5,6,7,8,5,15,6,4,13,11,7,13,9,14,12,10,10,11,8,10,11,13,5,10,12,10,10,11,9,11,14,11,12,12,20,13,14,12,10,12,10,12,12,12,13,10,12,11,8,8,20,1,1,1,14,14,20,D C,101,1,1,1,1,1,1,20,14,14,1,1,1,1,1,1,0.0,0,0,0,0,0,0,0,0,0,0,0,0,0,0,0,0,0,0,0,0,0,0,0,0,0,0,0,0,0,0,0,0,0,0,0,0,0,0,0,0,0,0,0,0,0,0,0,0,Simone Gozzi,ÃÂ£270Th. ,34.0,189.0,Defender - Centre-Back,right,Carpi FC 1909,39.0,0.0,3.0,3330.0,3.0,0.0,0.0,125.0,38.0,3.0,2.0,3005.0,36.0,0.0,2.0,3035.0,35.0,0.0,0.0,3210.0,32.0,0.0,1.0,2606.0,39.0,1.0,0.0,3422.0,36.0,0.0,2.0,3154.0,23.0,0.0,2.0,1688.0,Serie A,23.0,0.0,0.0,1914.0,3.0,0.0,0.0,174.0,nan,nan,nan,nan,nan,nan,nan,nan,nan,nan,nan,nan,nan,nan,nan,nan,nan,nan,nan,nan,nan,nan,nan,nan,nan,nan,nan,nan,nan,nan,nan,nan,nan,nan,nan,nan,nan,nan,nan,nan,nan,nan,nan,nan,nan,nan,nan,nan,nan,nan,nan,nan,nan,nan,nan,nan,nan,nan,nan,nan,nan,nan,nan,nan,nan,nan,nan,nan,nan,nan,nan,nan,nan,nan,nan,nan,nan,nan,nan,nan,nan,nan,nan,nan
19/6/2011,Sergio SÃÂ¡nchez,1507596,796,4/3/1986,25,0,0,4,0,4500,6900,6900,150,138,1492831,185,78,D RC,1,2,2,1,1,2,1,8,3,2,3,5,6,6,8,12,6,14,7,9,15,12,8,14,11,16,14,14,13,12,8,12,13,7,12,12,15,14,16,14,12,15,13,10,14,13,20,16,14,13,13,10,8,14,13,13,14,11,9,9,9,10,20,6,1,1,20,8,18,D RC,103,1,1,1,1,1,1,18,8,20,10,1,1,1,1,6,0.0,0,0,0,0,0,0,0,0,0,0,0,0,0,0,0,0,0,0,0,0,0,0,0,0,0,0,0,0,0,0,0,0,0,0,0,0,0,0,0,0,0,0,0,0,0,0,0,0,Sergio SÃÂ¡nchez,ÃÂ£3.60m ,34.0,185.0,Defender - Centre-Back,right,Without Club,12.0,0.0,1.0,896.0,21.0,1.0,2.0,1592.0,26.0,0.0,1.0,2046.0,28.0,1.0,1.0,2420.0,21.0,0.0,0.0,1706.0,14.0,0.0,0.0,997.0,20.0,0.0,0.0,1736.0,4.0,0.0,0.0,236.0,22.0,1.0,1.0,1918.0,LaLiga,2.0,0.0,0.0,180.0,nan,nan,nan,nan,29/6/2010,Sergio SÃÂ¡nchez,1507596.0,796.0,4/3/1986,24.0,0.0,0.0,4.0,0.0,4500.0,6600.0,6600.0,156.0,138.0,5999998.0,185.0,78.0,D RC,3.0,1.0,1.0,2.0,1.0,1.0,1.0,4.0,3.0,2.0,3.0,5.0,6.0,6.0,8.0,12.0,6.0,14.0,7.0,9.0,15.0,12.0,8.0,14.0,11.0,15.0,14.0,14.0,13.0,12.0,8.0,12.0,13.0,7.0,12.0,12.0,15.0,14.0,16.0,14.0,12.0,15.0,13.0,10.0,14.0,13.0,20.0,16.0,14.0,13.0,12.0,10.0,8.0,14.0,13.0,13.0,14.0,11.0,14.0,13.0,12.0,10.0,Sergio SÃÂÃÂ¡nchez,ÃÂÃÂ£3.60m ,LaLiga,19-06-17,18.3.4.28,Sergio SÃÂ¡nchez,1507596,796,03-Apr-86,31,0,0,4,0,4900,6250,6250,140,123,232186002,185,78,D RC,1,2,4,3,3,3,1,1,2,3,3,6,12,8,8,12,6,14,7,10,15,13,8,13,12,16,14,14,12,14,8,13,16,7,13,10,13,12,13,11,11,12,12,10,12,11,20,12,11,15,16,10,9,13,8,13,14,12,11,8,9,12,20,7,1,1,15,1,20,D RC,103,1,1,1,1,1,1,20,1,15,10,1,1,1,1,7,131072.0,0,0,0,0,0,0,0,0,0,0,0,0,0,0,0,0,0,1,0,0,0,0,0,0,0,0,0,0,0,0,0,0,0,0,0,0,0,0,0,0,0,0,0,0,0,0,0,0,Sergio SÃÂ¡nchez,ÃÂ£900Th. ,34.0,185.0,Defender - Centre-Back,right,Without Club,20.0,0.0,0.0,1736.0,4.0,0.0,0.0,236.0,22.0,1.0,1.0,1918.0,2.0,0.0,0.0,180.0,nan,nan,nan,nan,LaLiga,nan,nan,nan,nan,nan,nan,nan,nan,nan,nan,nan,nan,nan,nan,nan,nan,nan,nan,nan,nan,nan,nan,nan,nan,nan,nan,nan,nan,nan,nan,nan,nan,nan,nan,nan,nan,nan,nan,nan,nan,nan,nan,nan,nan,nan,nan,nan,nan,nan,nan,nan,nan,nan,nan,nan,nan,nan,nan,nan,nan,nan,nan,nan,nan,nan,nan,nan,nan,nan,nan,nan,nan,nan,nan,nan,nan,nan,nan,nan,nan,nan,nan,nan,nan,nan
19/6/2011,Sergio Ramos,7458272,796,3/30/1986,25,67,5,6,0,7500,7950,7950,168,161,0,183,75,D/WB RC,1,3,3,3,3,3,1,2,2,3,1,10,15,13,11,15,13,17,13,16,15,13,10,17,14,16,15,17,10,13,12,10,16,13,12,13,15,15,16,13,15,14,13,13,16,15,20,17,12,14,15,13,3,15,8,18,12,13,12,8,8,13,20,16,9,1,20,10,18,D/WB RC,113,1,12,1,1,1,1,18,10,20,13,9,1,9,6,16,35184400000000.0,0,0,0,0,0,1,0,0,0,0,0,0,0,0,0,0,0,0,0,0,0,0,0,0,0,0,0,0,0,0,0,0,0,0,0,0,0,0,0,0,0,0,0,0,0,1,0,0,Sergio Ramos,ÃÂ£30.60m ,34.0,184.0,Defender - Centre-Back,right,Real Madrid,46.0,4.0,3.0,4050.0,51.0,4.0,6.0,4497.0,40.0,5.0,2.0,3539.0,51.0,7.0,4.0,4352.0,42.0,7.0,1.0,3552.0,33.0,3.0,3.0,2842.0,44.0,10.0,2.0,3988.0,42.0,5.0,1.0,3731.0,42.0,11.0,2.0,3662.0,LaLiga,44.0,13.0,1.0,3828.0,6.0,2.0,0.0,495.0,29/6/2010,Sergio Ramos,7458272.0,796.0,3/30/1986,24.0,67.0,5.0,6.0,0.0,6642.0,8250.0,8250.0,173.0,163.0,165816446.0,183.0,81.0,D RC,1.0,1.0,2.0,1.0,3.0,2.0,1.0,5.0,1.0,1.0,3.0,10.0,15.0,13.0,11.0,15.0,13.0,17.0,13.0,16.0,15.0,13.0,10.0,17.0,15.0,16.0,15.0,17.0,10.0,13.0,12.0,10.0,16.0,13.0,12.0,13.0,15.0,15.0,16.0,13.0,15.0,14.0,13.0,13.0,16.0,15.0,20.0,17.0,12.0,14.0,15.0,13.0,3.0,15.0,15.0,18.0,12.0,13.0,12.0,11.0,13.0,11.0,Sergio Ramos,ÃÂÃÂ£27.00m ,LaLiga,19-06-17,18.3.4.28,Sergio Ramos,7458272,796,30-Mar-86,31,143,10,6,0,8600,8850,8850,174,174,232186002,184,83,D C,1,1,2,1,4,2,2,4,4,3,2,9,11,13,13,14,14,20,14,12,16,16,14,18,14,18,18,17,13,10,13,11,20,15,19,12,14,14,16,13,15,15,16,14,15,15,20,17,16,11,18,20,7,14,10,18,15,16,17,6,7,15,20,13,10,1,14,1,20,D C,101,1,9,1,1,1,1,20,1,14,12,10,1,1,1,13,184722000000000.0,0,0,0,0,0,1,0,0,0,0,0,0,0,0,0,0,0,0,0,0,0,0,0,0,0,0,0,0,0,0,0,0,1,0,0,0,0,0,0,0,0,0,0,1,0,1,0,1,Sergio Ramos,ÃÂ£40.50m ,34.0,184.0,Defender - Centre-Back,right,Real Madrid,44.0,10.0,2.0,3988.0,42.0,5.0,1.0,3731.0,42.0,11.0,2.0,3662.0,44.0,13.0,1.0,3828.0,6.0,2.0,0.0,495.0,LaLiga,15-07-16,17.3.2.23,Sergio Ramos,7458272.0,796.0,30-Mar-86,30.0,136.0,10.0,6.0,0.0,8600.0,8850.0,8850.0,174.0,174.0,232186002.0,183.0,81.0,D C,3.0,3.0,3.0,1.0,3.0,2.0,1.0,2.0,2.0,2.0,2.0,9.0,11.0,13.0,13.0,14.0,14.0,20.0,14.0,12.0,16.0,16.0,14.0,18.0,14.0,18.0,18.0,17.0,13.0,10.0,13.0,11.0,20.0,15.0,19.0,12.0,14.0,14.0,16.0,13.0,15.0,15.0,16.0,14.0,15.0,15.0,20.0,17.0,16.0,11.0,18.0,20.0,7.0,14.0,20.0,18.0,15.0,16.0,17.0,6.0,7.0,15.0,Sergio Ramos,ÃÂ£36.00m ,LaLiga
19/6/2011,Ronald Zubar,919995,769,9/20/1985,25,0,0,15,2,3763,5849,6021,145,130,637271,186,80,D RC,3,2,2,3,1,3,3,4,2,2,1,6,10,8,7,11,7,15,12,9,14,10,8,15,11,12,14,16,7,10,8,12,17,9,13,9,12,14,15,11,9,16,13,10,13,15,20,16,16,13,12,14,10,14,14,14,13,9,16,14,14,5,20,7,1,1,20,10,18,D RC,103,1,1,1,1,1,1,18,10,20,1,1,1,1,1,7,0.0,0,0,0,0,0,0,0,0,0,0,0,0,0,0,0,0,0,0,0,0,0,0,0,0,0,0,0,0,0,0,0,0,0,0,0,0,0,0,0,0,0,0,0,0,0,0,0,0,Ronald Zubar,ÃÂ£1.80m ,35.0,186.0,Defender - Centre-Back,right,Retired,19.0,1.0,1.0,1627.0,22.0,1.0,0.0,1691.0,29.0,2.0,1.0,2518.0,16.0,1.0,1.0,1343.0,26.0,2.0,0.0,1726.0,23.0,2.0,0.0,1694.0,nan,nan,nan,nan,nan,nan,nan,nan,nan,nan,nan,nan,Premier League,nan,nan,nan,nan,nan,nan,nan,nan,29/6/2010,Ronald Zubar,919995.0,769.0,9/20/1985,24.0,0.0,0.0,15.0,2.0,3750.0,5600.0,6100.0,145.0,130.0,5999998.0,186.0,80.0,D RC,3.0,3.0,3.0,3.0,1.0,3.0,2.0,1.0,2.0,3.0,1.0,6.0,10.0,8.0,7.0,11.0,7.0,15.0,12.0,9.0,14.0,10.0,8.0,15.0,11.0,12.0,14.0,16.0,7.0,9.0,8.0,12.0,17.0,9.0,13.0,9.0,12.0,14.0,14.0,11.0,9.0,16.0,13.0,10.0,13.0,14.0,20.0,16.0,16.0,13.0,12.0,14.0,10.0,14.0,14.0,14.0,13.0,9.0,16.0,14.0,14.0,5.0,Ronald Zubar,ÃÂÃÂ£2.25m ,Premier League
19/6/2011,Rolando,744475,788,8/31/1985,25,10,0,7,0,3500,7000,7000,151,140,3197189,189,77,D C,3,2,2,1,2,2,1,4,3,3,1,7,7,7,8,10,9,16,9,10,15,8,10,15,10,15,15,12,13,13,8,13,16,5,12,10,14,14,13,13,13,15,15,9,16,12,20,14,16,12,11,11,7,10,15,15,15,13,14,13,13,5,20,1,1,1,5,1,20,D C,101,1,5,1,1,1,1,20,1,5,5,1,1,1,1,1,32768.0,0,0,0,0,0,0,0,0,0,0,0,0,0,0,0,1,0,0,0,0,0,0,0,0,0,0,0,0,0,0,0,0,0,0,0,0,0,0,0,0,0,0,0,0,0,0,0,0,Rolando,ÃÂ£11.70m ,35.0,189.0,Defender - Centre-Back,right,SC Braga,51.0,4.0,1.0,4590.0,37.0,3.0,1.0,3079.0,10.0,0.0,0.0,575.0,29.0,4.0,0.0,2573.0,10.0,0.0,0.0,624.0,29.0,1.0,0.0,2442.0,35.0,4.0,0.0,3187.0,46.0,2.0,0.0,3819.0,14.0,0.0,0.0,1105.0,Liga NOS,3.0,0.0,0.0,84.0,0.0,0.0,0.0,0.0,29/6/2010,Rolando,744475.0,788.0,8/31/1985,24.0,8.0,0.0,7.0,0.0,3500.0,6650.0,6650.0,143.0,133.0,37938740.0,189.0,77.0,D C,1.0,3.0,1.0,3.0,2.0,2.0,2.0,4.0,2.0,3.0,3.0,7.0,7.0,7.0,8.0,10.0,9.0,16.0,9.0,10.0,15.0,8.0,10.0,14.0,10.0,15.0,14.0,12.0,13.0,13.0,8.0,11.0,16.0,5.0,12.0,10.0,13.0,14.0,13.0,12.0,13.0,15.0,15.0,9.0,16.0,12.0,20.0,14.0,16.0,12.0,11.0,11.0,7.0,10.0,15.0,15.0,15.0,13.0,14.0,13.0,13.0,5.0,Rolando,ÃÂÃÂ£12.60m ,Liga NOS,19-06-17,18.3.4.28,Rolando,744475,788,31-Aug-85,31,19,0,7,0,4750,6450,6750,140,129,232186002,189,77,D C,1,2,1,3,3,2,3,4,1,3,2,5,8,7,10,10,9,15,9,8,14,12,10,15,10,15,14,13,13,14,10,12,14,10,14,11,13,14,15,8,10,12,16,10,16,10,20,14,16,13,11,13,7,10,10,14,13,13,15,13,13,7,20,1,1,1,1,1,20,D C,101,1,5,1,1,1,1,20,1,1,5,1,1,1,1,1,32768.0,0,0,0,0,0,0,0,0,0,0,0,0,0,0,0,1,0,0,0,0,0,0,0,0,0,0,0,0,0,0,0,0,0,0,0,0,0,0,0,0,0,0,0,0,0,0,0,0,Rolando,ÃÂ£675Th. ,35.0,189.0,Defender - Centre-Back,right,SC Braga,35.0,4.0,0.0,3187.0,46.0,2.0,0.0,3819.0,14.0,0.0,0.0,1105.0,3.0,0.0,0.0,84.0,0.0,0.0,0.0,0.0,Ligue 1,15-07-16,17.3.2.23,Rolando,744475.0,788.0,31-Aug-85,30.0,19.0,0.0,7.0,0.0,4596.0,6396.0,6446.0,140.0,127.0,232186002.0,189.0,77.0,D C,1.0,3.0,1.0,2.0,3.0,3.0,2.0,1.0,1.0,4.0,1.0,5.0,8.0,7.0,10.0,10.0,9.0,15.0,9.0,8.0,14.0,12.0,10.0,15.0,10.0,15.0,14.0,13.0,13.0,14.0,10.0,12.0,14.0,10.0,14.0,11.0,12.0,14.0,14.0,8.0,10.0,12.0,16.0,10.0,16.0,10.0,20.0,13.0,16.0,13.0,11.0,13.0,7.0,10.0,6.0,14.0,12.0,13.0,14.0,13.0,13.0,7.0,Rolando,ÃÂ£1.35m ,Ligue 1
19/6/2011,Rodrigo Defendi,8834927,1651,6/17/1986,25,0,0,0,0,1260,5371,5350,124,107,161661,188,88,D C,2,3,1,2,1,1,2,1,3,2,3,7,8,9,9,9,13,14,12,11,11,9,10,13,11,13,11,14,11,10,9,9,11,11,8,10,12,12,13,10,9,15,14,20,12,10,10,12,16,11,10,9,12,13,10,5,10,8,16,13,15,1,20,1,1,1,1,8,20,D C,101,1,12,1,1,1,1,20,8,1,1,1,1,1,1,1,35184400000000.0,0,0,0,0,0,0,0,0,0,1,0,0,0,0,0,0,0,0,0,0,0,0,0,0,0,0,0,0,0,0,0,0,0,0,0,0,0,0,0,0,0,0,0,0,0,1,0,0,Rodrigo Defendi,ÃÂ£180Th. ,34.0,190.0,Defender - Centre-Back,right,Without Club,nan,nan,nan,nan,15.0,1.0,0.0,1324.0,11.0,0.0,0.0,1020.0,1.0,0.0,0.0,90.0,12.0,0.0,1.0,856.0,13.0,1.0,0.0,1200.0,34.0,0.0,0.0,2972.0,13.0,3.0,2.0,1022.0,17.0,2.0,2.0,1402.0,Liga NOS,2.0,0.0,0.0,132.0,nan,nan,nan,nan,nan,nan,nan,nan,nan,nan,nan,nan,nan,nan,nan,nan,nan,nan,nan,nan,nan,nan,nan,nan,nan,nan,nan,nan,nan,nan,nan,nan,nan,nan,nan,nan,nan,nan,nan,nan,nan,nan,nan,nan,nan,nan,nan,nan,nan,nan,nan,nan,nan,nan,nan,nan,nan,nan,nan,nan,nan,nan,nan,nan,nan,nan,nan,nan,nan,nan,nan,nan,nan,nan,nan,nan,nan,nan,nan,nan,nan,nan,nan,nan,nan,nan,nan,nan,19-06-17,18.3.4.28,Rodrigo Defendi,8834927,1651,17-Jun-86,31,0,0,0,0,3250,5550,5550,118,111,128184,190,80,D C,2,2,3,3,2,1,1,3,3,3,3,9,8,9,9,10,12,14,13,11,13,9,10,13,11,14,13,13,11,9,9,9,11,13,11,12,14,14,12,12,10,12,15,20,12,12,6,11,14,10,10,13,8,13,10,5,10,9,16,13,15,5,20,1,1,1,1,1,20,D C,101,1,12,1,1,1,1,20,1,1,1,1,1,1,1,1,35184400000000.0,0,0,0,0,0,0,0,0,0,1,0,0,0,0,0,0,0,0,0,0,0,0,0,0,0,0,0,0,0,0,0,0,0,0,0,0,0,0,0,0,0,0,0,0,0,1,0,0,Rodrigo Defendi,ÃÂ£90Th. ,34.0,190.0,Defender - Centre-Back,right,Without Club,34.0,0.0,0.0,2972.0,13.0,3.0,2.0,1022.0,17.0,2.0,2.0,1402.0,2.0,0.0,0.0,132.0,nan,nan,nan,nan,Liga NOS,nan,nan,nan,nan,nan,nan,nan,nan,nan,nan,nan,nan,nan,nan,nan,nan,nan,nan,nan,nan,nan,nan,nan,nan,nan,nan,nan,nan,nan,nan,nan,nan,nan,nan,nan,nan,nan,nan,nan,nan,nan,nan,nan,nan,nan,nan,nan,nan,nan,nan,nan,nan,nan,nan,nan,nan,nan,nan,nan,nan,nan,nan,nan,nan,nan,nan,nan,nan,nan,nan,nan,nan,nan,nan,nan,nan,nan,nan,nan,nan,nan,nan,nan,nan,nan
19/6/2011,Rodnei,19003707,1651,9/11/1985,25,0,0,0,0,2500,5750,6750,148,135,1379272,190,90,D LC,2,1,3,2,3,2,2,1,3,1,2,3,5,12,11,13,2,16,4,7,15,13,5,15,13,8,12,15,12,12,8,10,15,10,9,11,14,13,13,14,12,15,15,20,13,15,8,13,14,14,5,14,4,6,15,16,13,13,13,14,9,8,20,1,1,1,1,15,20,D LC,104,1,1,1,1,1,1,20,15,1,1,1,1,1,1,1,0.0,0,0,0,0,0,0,0,0,0,0,0,0,0,0,0,0,0,0,0,0,0,0,0,0,0,0,0,0,0,0,0,0,0,0,0,0,0,0,0,0,0,0,0,0,0,0,0,0,Rodnei,ÃÂ£1.80m ,35.0,194.0,Defender - Centre-Back,left,SV Anthering,29.0,2.0,2.0,2640.0,25.0,1.0,0.0,2115.0,18.0,0.0,0.0,1451.0,12.0,0.0,0.0,947.0,7.0,1.0,0.0,630.0,5.0,0.0,0.0,323.0,3.0,0.0,0.0,224.0,10.0,0.0,0.0,818.0,nan,nan,nan,nan,Bundesliga,nan,nan,nan,nan,nan,nan,nan,nan,29/6/2010,Rodnei,19003707.0,1651.0,9/11/1985,24.0,0.0,0.0,0.0,0.0,2500.0,5750.0,6650.0,142.0,133.0,3085434.0,190.0,91.0,D LC,2.0,2.0,3.0,3.0,2.0,3.0,3.0,7.0,1.0,1.0,2.0,2.0,7.0,10.0,12.0,12.0,5.0,14.0,6.0,8.0,13.0,13.0,4.0,14.0,13.0,12.0,12.0,15.0,8.0,11.0,7.0,8.0,15.0,12.0,9.0,11.0,11.0,11.0,14.0,12.0,12.0,14.0,16.0,16.0,14.0,15.0,20.0,13.0,16.0,15.0,9.0,14.0,4.0,8.0,15.0,16.0,13.0,13.0,13.0,14.0,9.0,8.0,Rodnei,ÃÂÃÂ£2.70m ,Bundesliga
19/6/2011,RaÃÂºl Albiol,7452450,796,9/4/1985,25,23,0,8,0,6700,7850,7850,164,154,0,190,80,D C,3,3,3,1,2,3,3,8,2,1,1,6,9,10,9,11,7,16,12,10,18,12,8,15,10,15,16,18,13,17,9,13,12,6,12,8,16,17,16,8,10,18,15,11,15,13,20,16,16,17,13,15,7,13,16,14,14,12,13,12,7,6,20,1,1,1,10,1,20,D C,101,1,9,1,1,1,1,20,1,10,12,1,1,1,1,1,32768.0,0,0,0,0,0,0,0,0,0,0,0,0,0,0,0,1,0,0,0,0,0,0,0,0,0,0,0,0,0,0,0,0,0,0,0,0,0,0,0,0,0,0,0,0,0,0,0,0,RaÃÂºl Albiol,ÃÂ£8.10m ,35.0,190.0,Defender - Centre-Back,right,Villarreal CF,32.0,0.0,0.0,2150.0,17.0,0.0,0.0,993.0,26.0,1.0,0.0,1873.0,46.0,1.0,2.0,3894.0,51.0,0.0,2.0,4560.0,39.0,1.0,2.0,3442.0,35.0,0.0,1.0,3028.0,39.0,3.0,2.0,3462.0,26.0,1.0,0.0,2207.0,LaLiga,38.0,1.0,0.0,3448.0,8.0,0.0,0.0,702.0,29/6/2010,RaÃÂºl Albiol,7452450.0,796.0,9/4/1985,24.0,23.0,0.0,8.0,0.0,6162.0,7850.0,7850.0,164.0,157.0,21801492.0,190.0,82.0,D C,3.0,1.0,3.0,1.0,1.0,3.0,3.0,9.0,3.0,3.0,3.0,6.0,9.0,10.0,9.0,11.0,7.0,16.0,12.0,10.0,18.0,12.0,8.0,15.0,10.0,15.0,16.0,18.0,13.0,19.0,9.0,13.0,12.0,6.0,12.0,8.0,16.0,17.0,16.0,8.0,10.0,18.0,15.0,11.0,15.0,13.0,20.0,16.0,16.0,17.0,13.0,15.0,7.0,13.0,16.0,14.0,14.0,12.0,13.0,12.0,7.0,6.0,RaÃÂÃÂºl Albiol,ÃÂÃÂ£13.50m ,LaLiga,19-06-17,18.3.4.28,RaÃÂºl Albiol,7452450,796,04-Sep-85,31,51,0,8,0,6000,7000,7400,156,148,232186002,190,82,D C,3,2,1,3,1,4,2,1,2,4,3,7,10,8,9,12,8,14,11,12,15,12,9,15,12,13,15,16,13,13,12,13,13,6,14,9,15,17,16,11,12,16,15,10,14,14,20,16,15,15,13,16,8,13,16,14,14,13,14,12,7,6,20,1,1,1,10,1,20,D C,101,1,9,1,1,1,1,20,1,10,10,1,1,1,1,1,1.15292e+18,0,0,0,0,0,0,0,0,0,0,0,0,0,0,0,1,0,0,0,0,0,0,0,0,0,0,0,0,0,0,0,0,0,0,0,0,0,0,0,0,0,0,0,0,0,0,0,0,RaÃÂºl Albiol,ÃÂ£7.20m ,35.0,190.0,Defender - Centre-Back,right,Villarreal CF,35.0,0.0,1.0,3028.0,39.0,3.0,2.0,3462.0,26.0,1.0,0.0,2207.0,38.0,1.0,0.0,3448.0,8.0,0.0,0.0,702.0,Serie A,15-07-16,17.3.2.23,RaÃÂºl Albiol,7452450.0,796.0,04-Sep-85,30.0,51.0,0.0,8.0,0.0,6000.0,7250.0,7350.0,156.0,147.0,232186002.0,190.0,82.0,D C,1.0,2.0,1.0,3.0,2.0,3.0,4.0,3.0,3.0,1.0,3.0,7.0,10.0,8.0,9.0,12.0,8.0,14.0,11.0,12.0,16.0,12.0,9.0,15.0,12.0,13.0,15.0,16.0,13.0,13.0,12.0,13.0,13.0,6.0,14.0,9.0,14.0,17.0,16.0,11.0,11.0,16.0,15.0,10.0,14.0,14.0,20.0,16.0,15.0,15.0,13.0,16.0,8.0,13.0,16.0,14.0,14.0,13.0,14.0,12.0,7.0,6.0,RaÃÂºl Albiol,ÃÂ£7.20m ,Serie A
19/6/2011,PaulÃÂ£o,19008149,1651,10/16/1985,25,0,0,0,0,864,4850,4850,115,97,38028,186,70,D LC,1,2,2,1,3,3,2,4,3,3,1,3,7,6,1,11,2,12,9,1,13,10,8,9,9,15,13,11,6,7,6,13,10,3,12,9,13,16,14,13,11,8,13,20,14,13,11,10,5,10,9,10,15,10,5,7,6,11,13,1,7,10,20,1,1,1,1,16,20,D LC,104,1,10,1,1,1,1,20,16,1,1,1,1,1,1,1,0.0,0,0,0,0,0,0,0,0,0,0,0,0,0,0,0,0,0,0,0,0,0,0,0,0,0,0,0,0,0,0,0,0,0,0,0,0,0,0,0,0,0,0,0,0,0,0,0,0,PaulÃÂ£o,ÃÂ£2.25m ,38.0,188.0,Defender - Centre-Back,right,Retired,35.0,3.0,0.0,2615.0,28.0,1.0,0.0,2363.0,27.0,2.0,0.0,2136.0,24.0,1.0,0.0,2039.0,10.0,2.0,0.0,824.0,nan,nan,nan,nan,6.0,1.0,0.0,390.0,nan,nan,nan,nan,nan,nan,nan,nan,LaLiga,nan,nan,nan,nan,nan,nan,nan,nan,nan,nan,nan,nan,nan,nan,nan,nan,nan,nan,nan,nan,nan,nan,nan,nan,nan,nan,nan,nan,nan,nan,nan,nan,nan,nan,nan,nan,nan,nan,nan,nan,nan,nan,nan,nan,nan,nan,nan,nan,nan,nan,nan,nan,nan,nan,nan,nan,nan,nan,nan,nan,nan,nan,nan,nan,nan,nan,nan,nan,nan,nan,nan,nan,nan,nan,nan,nan,nan,nan,nan,nan,nan,nan,nan,nan,nan,nan,nan,nan,nan,nan,nan,nan
19/6/2011,Pape Sow,8429994,41,12/2/1985,25,0,0,0,0,1510,4650,4766,110,103,76477,180,76,D/DM C,2,1,2,2,3,3,3,4,2,1,1,5,8,8,6,10,10,14,13,6,13,9,7,10,11,16,8,16,10,10,6,9,12,10,9,10,8,14,16,12,9,17,14,16,14,9,20,16,17,8,15,13,6,15,14,12,10,9,13,13,9,7,17,1,10,1,1,1,17,D/DM C,321,1,10,1,1,1,1,17,1,1,20,10,1,1,1,1,35184400000000.0,0,0,0,0,0,0,0,0,0,0,0,0,0,0,0,0,0,0,0,0,0,0,0,0,0,0,0,0,0,0,0,0,0,0,0,0,0,0,0,0,0,0,0,0,0,1,0,0,Pape Sow,ÃÂ£900Th. ,34.0,181.0,Defender - Centre-Back,right,Retired,20.0,0.0,0.0,1376.0,28.0,1.0,0.0,2340.0,20.0,4.0,1.0,1421.0,18.0,0.0,1.0,1539.0,8.0,0.0,0.0,527.0,12.0,0.0,0.0,1080.0,nan,nan,nan,nan,nan,nan,nan,nan,nan,nan,nan,nan,Liga NOS,nan,nan,nan,nan,nan,nan,nan,nan,29/6/2010,Pape Sow,8429994.0,41.0,12/2/1985,24.0,0.0,0.0,0.0,0.0,750.0,4229.0,4200.0,120.0,94.0,1185410.0,180.0,76.0,D/DM C,3.0,1.0,2.0,2.0,2.0,3.0,2.0,1.0,2.0,2.0,1.0,5.0,8.0,6.0,6.0,8.0,11.0,13.0,13.0,6.0,13.0,9.0,7.0,10.0,8.0,16.0,13.0,15.0,10.0,10.0,6.0,9.0,12.0,7.0,12.0,7.0,11.0,12.0,14.0,12.0,9.0,15.0,10.0,5.0,12.0,9.0,20.0,15.0,15.0,12.0,16.0,13.0,13.0,10.0,11.0,12.0,10.0,9.0,13.0,13.0,13.0,7.0,Pape Sow,ÃÂÃÂ£270Th. ,Liga NOS
19/6/2011,Nuno AndrÃÂ© Coelho,8874548,788,1/7/1986,25,0,0,0,0,3750,6400,6500,143,127,315296,190,78,D C,3,3,2,3,1,2,1,1,1,2,1,9,10,8,10,11,10,14,10,10,13,9,9,12,10,13,15,13,17,13,8,11,13,6,10,11,12,12,12,13,12,15,15,10,14,12,20,13,15,12,9,10,7,12,12,12,13,12,15,16,16,5,20,1,1,1,10,7,20,D C,101,1,5,1,1,1,1,20,7,10,13,1,1,1,1,1,0.0,0,0,0,0,0,0,0,0,0,0,0,0,0,0,0,0,0,0,0,0,0,0,0,0,0,0,0,0,0,0,0,0,0,0,0,0,0,0,0,0,0,0,0,0,0,0,0,0,Nuno AndrÃÂ© Coelho,ÃÂ£1.17m ,34.0,190.0,Defender - Centre-Back,right,Without Club,16.0,1.0,1.0,1024.0,14.0,1.0,0.0,1217.0,18.0,0.0,1.0,1408.0,27.0,1.0,1.0,2477.0,10.0,1.0,0.0,791.0,22.0,1.0,1.0,1618.0,17.0,1.0,0.0,1384.0,11.0,0.0,1.0,765.0,6.0,0.0,0.0,426.0,Liga NOS,nan,nan,nan,nan,nan,nan,nan,nan,29/6/2010,Nuno AndrÃÂ© Coelho,8874548.0,788.0,1/7/1986,24.0,0.0,0.0,0.0,0.0,3750.0,6600.0,6600.0,150.0,132.0,42182124.0,190.0,78.0,D C,3.0,1.0,1.0,3.0,3.0,2.0,2.0,1.0,1.0,1.0,2.0,9.0,10.0,8.0,10.0,11.0,10.0,14.0,10.0,10.0,13.0,9.0,9.0,12.0,10.0,13.0,15.0,13.0,17.0,13.0,8.0,11.0,13.0,6.0,10.0,11.0,12.0,12.0,12.0,13.0,12.0,15.0,15.0,10.0,14.0,12.0,20.0,13.0,15.0,12.0,9.0,10.0,7.0,12.0,12.0,12.0,13.0,12.0,15.0,16.0,16.0,5.0,Nuno AndrÃÂÃÂ© Coelho,ÃÂÃÂ£1.62m ,Liga NOS,19-06-17,18.3.4.28,Nuno AndrÃÂ© Coelho,8874548,788,07-Jan-86,31,0,0,14,2,4500,6000,6000,135,120,220133,190,82,D C,1,2,3,2,2,1,2,3,2,2,3,7,7,7,8,10,8,13,10,10,13,11,9,14,10,13,14,12,11,13,8,12,13,6,12,10,14,13,12,12,12,13,15,6,12,11,20,11,14,12,9,10,12,12,12,10,13,12,15,16,16,6,20,1,1,1,10,7,20,D C,101,1,5,1,1,1,1,20,7,10,13,1,1,1,1,1,0.0,0,0,0,0,0,0,0,0,0,0,0,0,0,0,0,0,0,0,0,0,0,0,0,0,0,0,0,0,0,0,0,0,0,0,0,0,0,0,0,0,0,0,0,0,0,0,0,0,Nuno AndrÃÂ© Coelho,ÃÂ£270Th. ,34.0,190.0,Defender - Centre-Back,right,Without Club,17.0,1.0,0.0,1384.0,11.0,0.0,1.0,765.0,6.0,0.0,0.0,426.0,nan,nan,nan,nan,nan,nan,nan,nan,Liga NOS,nan,nan,nan,nan,nan,nan,nan,nan,nan,nan,nan,nan,nan,nan,nan,nan,nan,nan,nan,nan,nan,nan,nan,nan,nan,nan,nan,nan,nan,nan,nan,nan,nan,nan,nan,nan,nan,nan,nan,nan,nan,nan,nan,nan,nan,nan,nan,nan,nan,nan,nan,nan,nan,nan,nan,nan,nan,nan,nan,nan,nan,nan,nan,nan,nan,nan,nan,nan,nan,nan,nan,nan,nan,nan,nan,nan,nan,nan,nan,nan,nan,nan,nan,nan,nan
19/6/2011,Moustapha Bayal,34010587,41,11/30/1985,25,16,1,0,0,5450,6700,6081,145,134,1054318,191,90,D/DM C,2,2,3,3,1,2,2,6,2,2,1,6,8,8,6,10,12,17,16,7,14,11,7,13,10,15,15,16,13,12,11,12,15,6,13,7,13,16,16,13,10,18,17,8,15,9,20,15,18,13,12,14,7,10,14,14,13,13,13,13,13,9,20,1,10,1,1,1,20,D/DM C,111,1,1,1,1,1,1,20,1,1,18,10,1,1,1,1,35184400000000.0,0,0,0,0,0,0,0,0,0,0,0,0,0,0,0,1,0,0,0,0,0,0,0,0,0,0,0,0,0,0,0,0,0,0,0,0,0,0,0,0,0,0,0,0,0,1,0,0,Moustapha Sall,ÃÂ£720Th. ,34.0,193.0,Defender - Centre-Back,right,Without Club,21.0,0.0,0.0,1883.0,2.0,0.0,0.0,103.0,30.0,0.0,0.0,2629.0,37.0,1.0,1.0,3324.0,33.0,2.0,0.0,2939.0,38.0,6.0,0.0,3187.0,13.0,0.0,1.0,1096.0,11.0,0.0,0.0,965.0,nan,nan,nan,nan,Ligue 1,24.0,4.0,0.0,2160.0,nan,nan,nan,nan,29/6/2010,Moustapha Bayal,34010587.0,41.0,11/30/1985,24.0,6.0,1.0,0.0,0.0,3600.0,6750.0,6050.0,158.0,135.0,4764847.0,191.0,90.0,D/DM C,3.0,1.0,2.0,2.0,1.0,1.0,1.0,1.0,2.0,2.0,2.0,6.0,8.0,8.0,6.0,10.0,12.0,17.0,16.0,7.0,14.0,11.0,7.0,13.0,10.0,15.0,15.0,16.0,13.0,12.0,11.0,12.0,15.0,6.0,13.0,7.0,13.0,16.0,16.0,13.0,10.0,18.0,17.0,8.0,15.0,9.0,20.0,15.0,18.0,13.0,12.0,14.0,13.0,10.0,14.0,14.0,13.0,13.0,13.0,13.0,13.0,9.0,Moustapha Sall,ÃÂÃÂ£1.80m ,Ligue 1
19/6/2011,Mikel GonzÃÂ¡lez,1507530,796,9/24/1985,25,0,0,0,0,4600,6500,6500,145,134,684221,186,74,D C,3,3,1,2,2,3,3,3,1,3,2,2,7,11,5,10,5,13,4,6,14,12,6,17,13,13,14,12,12,12,12,13,13,10,13,9,14,13,12,13,13,11,13,20,11,14,11,13,13,11,8,14,4,10,14,14,14,13,14,14,7,6,20,3,1,1,10,13,20,D C,101,1,1,1,1,1,1,20,13,10,11,1,1,1,3,1,137439000000.0,0,0,0,0,0,0,0,0,0,0,0,0,0,0,0,0,0,0,0,0,0,0,0,0,0,0,0,0,0,0,0,0,0,0,0,0,0,1,0,0,0,0,0,0,0,0,0,0,Mikel GonzÃÂ¡lez,ÃÂ£3.15m ,35.0,190.0,Defender - Centre-Back,right,AEK Larnaca,33.0,0.0,1.0,2793.0,30.0,1.0,0.0,2380.0,36.0,2.0,1.0,3240.0,32.0,2.0,0.0,2562.0,18.0,0.0,0.0,1405.0,19.0,0.0,0.0,1567.0,11.0,0.0,0.0,844.0,29.0,2.0,0.0,2055.0,34.0,2.0,1.0,2909.0,LaLiga,28.0,0.0,0.0,2520.0,6.0,0.0,0.0,495.0,29/6/2010,Mikel GonzÃÂ¡lez,1507530.0,796.0,9/24/1985,24.0,0.0,0.0,0.0,0.0,4160.0,6000.0,6000.0,145.0,129.0,4134827.0,186.0,74.0,D C,3.0,14.0,3.0,1.0,3.0,2.0,2.0,1.0,2.0,3.0,1.0,2.0,7.0,9.0,5.0,10.0,5.0,13.0,4.0,3.0,14.0,12.0,6.0,16.0,13.0,13.0,14.0,12.0,12.0,12.0,12.0,13.0,13.0,10.0,13.0,9.0,14.0,13.0,12.0,12.0,13.0,11.0,13.0,20.0,11.0,14.0,11.0,13.0,13.0,13.0,8.0,14.0,4.0,13.0,14.0,14.0,14.0,14.0,14.0,14.0,13.0,6.0,Mikel GonzÃÂÃÂ¡lez,ÃÂÃÂ£2.70m ,LaLiga
19/6/2011,Miguel Britos,78007927,1657,7/17/1985,25,0,0,0,0,808,5972,6600,141,132,815807,186,82,D C,1,3,3,1,1,2,3,6,1,3,2,14,11,12,8,14,13,14,11,13,13,11,9,12,13,15,11,13,12,12,8,12,12,9,7,13,13,13,13,15,11,14,14,20,14,14,9,14,14,12,14,12,7,10,12,4,10,11,13,14,9,7,20,9,1,1,1,13,20,D C,101,1,1,1,1,1,1,20,13,1,1,1,1,1,9,1,1099510000000.0,0,0,0,0,0,1,0,0,0,0,0,0,0,0,0,0,0,0,0,0,0,0,0,0,0,0,0,0,0,0,0,0,0,0,0,0,0,0,0,0,1,0,0,0,0,0,0,0,Miguel Britos,ÃÂ£5.40m ,35.0,189.0,Defender - Centre-Back,left,Retired,33.0,3.0,1.0,2915.0,14.0,1.0,0.0,797.0,27.0,0.0,0.0,2281.0,22.0,1.0,0.0,1771.0,37.0,1.0,0.0,3025.0,27.0,0.0,0.0,2331.0,29.0,1.0,2.0,2464.0,12.0,1.0,0.0,797.0,6.0,0.0,0.0,455.0,Serie A,nan,nan,nan,nan,nan,nan,nan,nan,29/6/2010,Miguel Britos,78007927.0,1657.0,7/17/1985,24.0,0.0,0.0,0.0,0.0,550.0,5984.0,5950.0,146.0,133.0,2420470.0,186.0,82.0,D C,3.0,1.0,3.0,2.0,1.0,3.0,2.0,6.0,3.0,3.0,1.0,14.0,11.0,12.0,8.0,13.0,12.0,14.0,10.0,13.0,13.0,11.0,8.0,12.0,13.0,15.0,11.0,13.0,12.0,12.0,8.0,12.0,12.0,9.0,6.0,13.0,13.0,13.0,13.0,15.0,11.0,14.0,14.0,20.0,14.0,14.0,9.0,14.0,14.0,12.0,14.0,12.0,7.0,9.0,11.0,9.0,13.0,14.0,13.0,14.0,11.0,5.0,Miguel Britos,ÃÂÃÂ£3.15m ,Serie A,19-06-17,18.3.4.28,Miguel Britos,78007927,1657,17-Jul-85,31,0,0,0,0,5000,6450,6700,140,134,15581443,188,82,D LC,2,1,3,3,2,4,2,1,4,2,2,7,7,8,8,12,11,14,12,13,14,10,10,15,13,15,15,14,11,12,11,13,12,9,8,10,14,13,13,12,11,14,14,20,15,14,9,13,15,13,14,13,10,10,14,11,13,11,13,14,15,8,20,9,1,1,1,15,20,D LC,104,1,1,1,1,1,1,20,15,1,1,1,1,1,9,1,2147483648.0,0,0,0,0,0,0,0,0,0,0,0,0,0,0,0,0,0,0,0,0,0,0,0,0,0,0,0,0,0,0,0,1,0,0,0,0,0,0,0,0,0,0,0,0,0,0,0,0,Miguel Britos,ÃÂ£3.15m ,35.0,189.0,Defender - Centre-Back,left,Retired,29.0,1.0,2.0,2464.0,12.0,1.0,0.0,797.0,6.0,0.0,0.0,455.0,nan,nan,nan,nan,nan,nan,nan,nan,Premier League,15-07-16,17.3.2.23,Miguel Britos,78007927.0,1657.0,17-Jul-85,30.0,0.0,0.0,0.0,0.0,5000.0,6450.0,6700.0,140.0,136.0,232186002.0,188.0,82.0,D LC,2.0,3.0,1.0,3.0,1.0,2.0,1.0,2.0,2.0,3.0,1.0,7.0,7.0,8.0,8.0,12.0,11.0,14.0,12.0,13.0,14.0,10.0,10.0,15.0,13.0,15.0,15.0,14.0,12.0,12.0,11.0,14.0,12.0,9.0,8.0,10.0,14.0,13.0,13.0,12.0,11.0,14.0,14.0,20.0,15.0,14.0,9.0,13.0,15.0,13.0,14.0,13.0,10.0,10.0,14.0,11.0,13.0,11.0,13.0,14.0,15.0,8.0,Miguel Britos,ÃÂ£3.15m ,Premier League
19/6/2011,Michael Kammermeyer,35021010,771,1/14/1986,25,0,0,0,0,1500,4500,4500,110,100,29108,180,77,D/DM C,2,3,2,1,2,3,1,1,2,3,2,4,2,8,7,7,6,13,2,4,12,8,3,12,9,11,10,13,12,11,10,11,8,7,14,12,12,14,12,11,7,10,12,16,12,13,20,13,13,10,8,8,9,3,11,15,16,9,14,11,9,5,20,1,1,1,1,1,20,D/DM C,111,1,1,1,1,1,1,20,1,1,17,1,1,1,1,1,0.0,0,0,0,0,0,0,0,0,0,0,0,0,0,0,0,0,0,0,0,0,0,0,0,0,0,0,0,0,0,0,0,0,0,0,0,0,0,0,0,0,0,0,0,0,0,0,0,0,nan,nan,nan,nan,nan,nan,nan,nan,nan,nan,nan,nan,nan,nan,nan,nan,nan,nan,nan,nan,nan,nan,nan,nan,nan,nan,nan,nan,nan,nan,nan,nan,nan,nan,nan,nan,nan,nan,nan,nan,nan,nan,nan,nan,nan,nan,nan,nan,nan,nan,nan,nan,29/6/2010,Michael Kammermeyer,35021010.0,771.0,1/14/1986,24.0,0.0,0.0,0.0,0.0,1000.0,4900.0,4900.0,120.0,103.0,151993.0,180.0,77.0,D C,2.0,2.0,1.0,3.0,3.0,1.0,3.0,6.0,2.0,1.0,1.0,3.0,3.0,2.0,3.0,8.0,2.0,9.0,7.0,5.0,13.0,9.0,5.0,13.0,9.0,8.0,11.0,14.0,10.0,13.0,6.0,13.0,10.0,7.0,13.0,3.0,13.0,10.0,13.0,13.0,11.0,10.0,11.0,6.0,14.0,13.0,20.0,13.0,9.0,10.0,13.0,10.0,6.0,10.0,13.0,20.0,6.0,9.0,8.0,16.0,13.0,6.0,nan,nan,nan
19/6/2011,Mehmet Topal,470897,799,3/3/1986,25,18,0,13,1,5500,6550,7000,155,142,440496,187,76,DM C,1,2,3,1,1,3,2,3,2,2,3,3,10,10,5,12,7,10,13,6,12,14,10,16,12,14,13,14,11,13,7,11,12,8,7,6,16,17,14,11,13,16,15,18,13,15,20,17,14,14,9,17,15,13,4,16,15,10,14,14,15,4,15,1,12,1,10,1,15,DM C,301,1,1,1,1,1,1,15,1,1,20,12,1,10,1,1,140737000000000.0,0,0,0,0,0,0,0,0,1,1,0,0,0,0,0,0,0,0,0,0,0,0,0,0,0,0,0,0,0,0,0,0,0,0,0,0,0,0,0,0,0,0,0,0,0,0,0,1,Mehmet Topal,ÃÂ£7.20m ,34.0,187.0,Midfielder - Defensive Midfield,right,Istanbul Basaksehir FK,29.0,1.0,2.0,2221.0,30.0,2.0,0.0,2105.0,51.0,4.0,3.0,3923.0,31.0,3.0,1.0,2631.0,41.0,4.0,4.0,3619.0,53.0,3.0,4.0,4234.0,45.0,4.0,5.0,3948.0,41.0,3.0,5.0,3314.0,36.0,3.0,3.0,2626.0,LaLiga,32.0,0.0,1.0,1764.0,5.0,0.0,0.0,275.0,29/6/2010,Mehmet Topal,470897.0,799.0,3/3/1986,24.0,16.0,0.0,13.0,1.0,4900.0,6900.0,6900.0,155.0,140.0,20699998.0,187.0,76.0,DM C,3.0,3.0,3.0,2.0,1.0,1.0,3.0,2.0,2.0,3.0,2.0,3.0,10.0,10.0,5.0,12.0,7.0,10.0,13.0,6.0,12.0,14.0,10.0,16.0,12.0,13.0,13.0,12.0,10.0,13.0,7.0,11.0,12.0,9.0,7.0,6.0,14.0,17.0,14.0,11.0,13.0,15.0,15.0,18.0,13.0,15.0,20.0,17.0,13.0,14.0,9.0,17.0,15.0,12.0,9.0,16.0,15.0,10.0,14.0,14.0,15.0,4.0,Mehmet Topal,ÃÂÃÂ£6.75m ,LaLiga
19/6/2011,Marco Russ,8718185,771,8/4/1985,25,0,0,0,0,4500,6650,6650,137,133,5436934,190,75,D C,3,2,1,1,3,2,2,3,3,2,2,6,6,7,11,11,8,15,13,11,14,10,7,15,9,8,12,14,8,12,8,11,10,3,10,9,13,12,14,15,13,10,16,9,10,14,20,16,15,12,7,7,4,8,6,10,15,10,11,9,9,8,20,1,1,1,1,1,20,D C,101,1,1,1,1,1,1,20,1,1,15,1,1,1,1,1,512.0,0,0,0,0,0,0,0,0,0,1,0,0,0,0,0,0,0,0,0,0,0,0,0,0,0,0,0,0,0,0,0,0,0,0,0,0,0,0,0,0,0,0,0,0,0,0,0,0,Marco Russ,ÃÂ£3.15m ,35.0,190.0,Defender - Centre-Back,right,Retired,33.0,1.0,1.0,2970.0,26.0,1.0,0.0,2153.0,10.0,1.0,0.0,618.0,40.0,4.0,3.0,3284.0,28.0,2.0,3.0,2404.0,31.0,3.0,2.0,2619.0,6.0,0.0,0.0,259.0,25.0,1.0,0.0,1638.0,9.0,0.0,0.0,670.0,Bundesliga,1.0,0.0,0.0,37.0,nan,nan,nan,nan,29/6/2010,Marco Russ,8718185.0,771.0,8/4/1985,24.0,0.0,0.0,0.0,0.0,3250.0,6500.0,6500.0,142.0,130.0,5820498.0,190.0,75.0,D C,2.0,3.0,1.0,2.0,1.0,1.0,2.0,6.0,2.0,3.0,3.0,6.0,6.0,7.0,10.0,10.0,8.0,15.0,12.0,11.0,14.0,9.0,7.0,15.0,9.0,8.0,12.0,14.0,8.0,12.0,8.0,11.0,9.0,3.0,10.0,9.0,13.0,12.0,14.0,15.0,13.0,10.0,16.0,8.0,10.0,14.0,20.0,16.0,15.0,12.0,5.0,7.0,7.0,8.0,6.0,13.0,13.0,6.0,8.0,11.0,14.0,11.0,Marco Russ,ÃÂÃÂ£2.48m ,Bundesliga,19-06-17,18.3.4.28,Marco Russ,8718185,771,04-Aug-85,31,0,0,0,0,3250,6250,6250,130,125,3466029,190,88,D C,3,1,1,3,2,1,2,4,3,2,1,5,6,9,7,8,8,14,10,12,15,10,7,15,8,14,12,17,9,14,8,10,17,5,14,10,13,15,13,10,8,16,16,10,14,12,20,13,17,13,12,13,4,12,8,10,15,16,14,8,7,13,20,1,12,1,1,1,20,D C,101,1,1,1,1,1,1,20,1,1,14,12,1,1,1,1,512.0,0,0,0,0,0,0,0,0,0,1,0,0,0,0,0,0,0,0,0,0,0,0,0,0,0,0,0,0,0,0,0,0,0,0,0,0,0,0,0,0,0,0,0,0,0,0,0,0,Marco Russ,ÃÂ£900Th. ,35.0,190.0,Defender - Centre-Back,right,Retired,6.0,0.0,0.0,259.0,25.0,1.0,0.0,1638.0,9.0,0.0,0.0,670.0,1.0,0.0,0.0,37.0,nan,nan,nan,nan,Bundesliga,15-07-16,17.3.2.23,Marco Russ,8718185.0,771.0,04-Aug-85,30.0,0.0,0.0,0.0,0.0,3950.0,6450.0,6450.0,130.0,129.0,232186002.0,190.0,75.0,D/DM C,3.0,2.0,3.0,3.0,2.0,2.0,2.0,2.0,1.0,3.0,3.0,5.0,6.0,9.0,7.0,8.0,8.0,14.0,10.0,12.0,15.0,10.0,7.0,16.0,8.0,14.0,12.0,17.0,8.0,14.0,8.0,11.0,17.0,5.0,14.0,10.0,13.0,16.0,14.0,10.0,8.0,15.0,16.0,10.0,14.0,12.0,20.0,14.0,17.0,13.0,15.0,13.0,4.0,12.0,8.0,10.0,15.0,16.0,14.0,8.0,7.0,13.0,Marco Russ,ÃÂ£1.80m ,Bundesliga
19/6/2011,Marco Andreolli,7984570,776,6/10/1986,25,0,0,22,0,4050,6400,6400,145,128,513374,187,81,D RC,2,3,3,3,1,2,1,3,3,2,3,5,12,8,8,10,8,15,9,11,15,11,6,14,9,10,14,12,12,13,10,15,15,5,8,10,13,14,13,13,13,11,14,5,15,13,20,15,12,13,13,10,15,14,14,15,10,10,10,10,10,10,20,1,1,1,16,10,20,D RC,103,1,1,1,1,1,1,20,10,16,10,1,1,1,1,1,0.0,0,0,0,0,0,0,0,0,0,0,0,0,0,0,0,0,0,0,0,0,0,0,0,0,0,0,0,0,0,0,0,0,0,0,0,0,0,0,0,0,0,0,0,0,0,0,0,0,Marco Andreolli,ÃÂ£3.15m ,34.0,187.0,Defender - Centre-Back,right,Without Club,29.0,0.0,0.0,2440.0,24.0,1.0,0.0,1977.0,28.0,2.0,0.0,2493.0,6.0,1.0,0.0,384.0,13.0,0.0,0.0,1023.0,9.0,0.0,0.0,734.0,9.0,1.0,0.0,559.0,24.0,0.0,0.0,1947.0,12.0,0.0,0.0,841.0,Serie A,nan,nan,nan,nan,nan,nan,nan,nan,29/6/2010,Marco Andreolli,7984570.0,776.0,6/10/1986,24.0,0.0,0.0,24.0,0.0,3500.0,6100.0,6100.0,148.0,125.0,3001521.0,187.0,81.0,D RC,3.0,1.0,1.0,2.0,1.0,2.0,1.0,1.0,3.0,3.0,2.0,4.0,13.0,8.0,8.0,10.0,8.0,15.0,9.0,11.0,15.0,11.0,6.0,15.0,8.0,9.0,14.0,13.0,12.0,13.0,10.0,17.0,15.0,5.0,8.0,10.0,13.0,14.0,14.0,13.0,13.0,13.0,14.0,5.0,15.0,13.0,20.0,12.0,12.0,13.0,13.0,10.0,15.0,14.0,19.0,15.0,13.0,8.0,7.0,11.0,12.0,11.0,Marco Andreolli,ÃÂÃÂ£2.70m ,Serie A,19-06-17,18.3.4.28,Marco Andreolli,7984570,776,10-Jun-86,31,0,0,22,0,5000,6500,6550,140,131,232186002,187,81,D C,2,1,2,2,2,2,2,3,3,2,1,5,8,8,8,10,8,13,9,14,14,11,6,14,9,11,13,13,12,14,8,14,12,5,12,8,14,14,14,13,12,14,14,8,15,13,20,13,14,13,13,10,13,13,14,13,14,12,14,13,12,10,20,1,1,1,1,1,20,D C,101,1,1,1,1,1,1,20,1,1,1,1,1,1,1,1,0.0,0,0,0,0,0,0,0,0,0,0,0,0,0,0,0,0,0,0,0,0,0,0,0,0,0,0,0,0,0,0,0,0,0,0,0,0,0,0,0,0,0,0,0,0,0,0,0,0,Marco Andreolli,ÃÂ£1.08m ,34.0,187.0,Defender - Centre-Back,right,Without Club,9.0,1.0,0.0,559.0,24.0,0.0,0.0,1947.0,12.0,0.0,0.0,841.0,nan,nan,nan,nan,nan,nan,nan,nan,Serie A,15-07-16,17.3.2.23,Marco Andreolli,7984570.0,776.0,10-Jun-86,30.0,0.0,0.0,22.0,0.0,4750.0,6500.0,6550.0,140.0,130.0,3423767.0,187.0,81.0,D C,3.0,3.0,2.0,1.0,1.0,2.0,4.0,1.0,1.0,3.0,1.0,5.0,8.0,8.0,8.0,10.0,8.0,13.0,9.0,14.0,14.0,11.0,6.0,14.0,9.0,11.0,13.0,13.0,12.0,14.0,8.0,14.0,12.0,5.0,12.0,8.0,14.0,14.0,14.0,13.0,13.0,14.0,14.0,9.0,15.0,13.0,20.0,15.0,14.0,13.0,13.0,10.0,15.0,13.0,14.0,12.0,13.0,10.0,14.0,13.0,12.0,10.0,Marco Andreolli,ÃÂ£1.80m ,Serie A
19/6/2011,Marc TorrejÃÂ³n,1509743,796,2/18/1986,25,0,0,8,0,4250,6500,6500,131,126,766706,186,85,D C,1,2,2,1,2,3,3,4,3,3,2,6,9,7,8,10,7,14,8,15,13,11,12,14,11,13,11,13,15,11,10,11,15,7,12,7,13,14,15,9,10,19,14,9,15,9,20,16,19,10,14,13,11,12,13,16,11,14,15,7,7,7,20,1,1,1,1,1,20,D C,101,1,1,1,1,1,1,20,1,1,7,1,1,1,1,1,8796090000000.0,0,0,0,0,0,0,0,0,0,0,0,0,0,0,0,0,0,0,0,0,0,0,0,0,0,0,0,0,0,0,0,0,0,0,0,0,0,0,0,0,0,0,0,1,0,0,0,0,Marc TorrejÃÂ³n,ÃÂ£2.70m ,34.0,187.0,Defender - Centre-Back,right,Without Club,36.0,1.0,2.0,3150.0,32.0,1.0,0.0,2646.0,30.0,1.0,0.0,2700.0,28.0,0.0,3.0,2509.0,26.0,0.0,0.0,2165.0,21.0,1.0,4.0,1772.0,13.0,0.0,0.0,989.0,25.0,0.0,1.0,2139.0,0.0,0.0,0.0,0.0,LaLiga,nan,nan,nan,nan,nan,nan,nan,nan,29/6/2010,Marc TorrejÃÂ³n,1509743.0,796.0,2/18/1986,24.0,0.0,0.0,8.0,0.0,4225.0,6500.0,6500.0,142.0,130.0,3654194.0,186.0,85.0,D C,1.0,1.0,2.0,1.0,3.0,2.0,1.0,4.0,3.0,3.0,1.0,6.0,9.0,7.0,8.0,10.0,7.0,16.0,8.0,15.0,15.0,11.0,12.0,14.0,11.0,14.0,12.0,17.0,11.0,14.0,7.0,12.0,15.0,7.0,12.0,7.0,14.0,12.0,15.0,10.0,10.0,18.0,13.0,5.0,15.0,10.0,20.0,15.0,18.0,14.0,14.0,13.0,11.0,10.0,13.0,16.0,11.0,14.0,15.0,7.0,7.0,7.0,Marc TorrejÃÂÃÂ³n,ÃÂÃÂ£3.15m ,LaLiga
19/6/2011,Leyti N'Diaye,8434552,41,8/19/1985,25,0,0,0,0,4150,5229,5212,130,116,66206,188,84,D/DM C,3,2,3,2,1,1,2,4,2,3,1,5,6,7,7,9,7,16,12,6,13,9,6,11,9,14,15,15,13,12,8,12,14,5,11,7,13,13,14,13,7,17,14,8,12,10,20,15,16,13,14,13,12,6,7,13,13,12,14,13,13,6,20,8,10,1,8,1,20,D/DM C,111,1,1,1,1,1,1,20,1,8,16,10,1,1,1,8,32768.0,0,0,0,0,0,0,0,0,0,0,0,0,0,0,0,1,0,0,0,0,0,0,0,0,0,0,0,0,0,0,0,0,0,0,0,0,0,0,0,0,0,0,0,0,0,0,0,0,Leyti N'Diaye,ÃÂ£630Th. ,35.0,188.0,Defender - Centre-Back,left,Retired,7.0,0.0,1.0,554.0,9.0,0.0,0.0,674.0,3.0,0.0,0.0,222.0,nan,nan,nan,nan,14.0,0.0,0.0,1024.0,nan,nan,nan,nan,nan,nan,nan,nan,nan,nan,nan,nan,nan,nan,nan,nan,Ligue 1,nan,nan,nan,nan,nan,nan,nan,nan,29/6/2010,Leyti N'Diaye,8434552.0,41.0,8/19/1985,24.0,0.0,0.0,0.0,0.0,3364.0,5219.0,5200.0,132.0,116.0,5546543.0,188.0,84.0,D C,2.0,2.0,3.0,2.0,2.0,2.0,2.0,6.0,3.0,1.0,2.0,5.0,6.0,7.0,7.0,9.0,7.0,16.0,12.0,6.0,13.0,9.0,6.0,11.0,9.0,14.0,15.0,15.0,13.0,12.0,8.0,12.0,15.0,5.0,11.0,7.0,13.0,13.0,14.0,13.0,7.0,17.0,14.0,5.0,12.0,11.0,20.0,14.0,16.0,14.0,14.0,14.0,11.0,6.0,7.0,13.0,13.0,12.0,14.0,13.0,13.0,6.0,Leyti N'Diaye,ÃÂÃÂ£900Th. ,Ligue 1
19/6/2011,Leon Barnett,5112981,765,11/30/1985,25,0,0,0,0,3000,5750,5750,132,115,401134,186,72,D C,3,2,2,2,1,2,1,1,3,2,1,2,4,7,5,9,3,14,4,1,13,9,1,11,9,11,11,16,8,8,9,10,13,6,9,10,12,10,14,12,13,11,14,20,13,14,13,15,14,10,7,13,8,9,10,13,14,10,13,14,13,4,20,1,1,1,11,5,20,D C,101,1,10,4,1,1,1,20,5,11,7,1,1,1,1,1,32768.0,0,0,0,0,0,0,0,0,0,0,0,0,0,0,0,1,0,0,0,0,0,0,0,0,0,0,0,0,0,0,0,0,0,0,0,0,0,0,0,0,0,0,0,0,0,0,0,0,Leon Barnett,ÃÂ£2.25m ,34.0,185.0,Defender - Centre-Back,right,Retired,27.0,1.0,0.0,2419.0,22.0,1.0,1.0,1678.0,21.0,0.0,0.0,1731.0,53.0,5.0,0.0,4557.0,21.0,0.0,1.0,1661.0,24.0,2.0,0.0,1929.0,26.0,1.0,1.0,2273.0,18.0,1.0,0.0,1477.0,6.0,0.0,0.0,540.0,Premier League,nan,nan,nan,nan,nan,nan,nan,nan,nan,nan,nan,nan,nan,nan,nan,nan,nan,nan,nan,nan,nan,nan,nan,nan,nan,nan,nan,nan,nan,nan,nan,nan,nan,nan,nan,nan,nan,nan,nan,nan,nan,nan,nan,nan,nan,nan,nan,nan,nan,nan,nan,nan,nan,nan,nan,nan,nan,nan,nan,nan,nan,nan,nan,nan,nan,nan,nan,nan,nan,nan,nan,nan,nan,nan,nan,nan,nan,nan,nan,nan,nan,nan,nan,nan,nan,nan,nan,nan,nan,nan,nan,nan
19/6/2011,Laurent Koscielny,8442484,769,9/10/1985,25,0,0,0,0,5800,7400,7350,165,148,3692200,186,75,D C,3,3,3,3,1,3,1,2,3,3,3,5,7,10,9,11,5,15,7,6,13,9,7,18,11,12,16,15,15,15,11,13,16,5,11,11,15,14,16,14,12,15,14,8,15,13,20,15,14,17,12,14,6,8,14,15,13,14,15,15,15,6,20,1,1,1,10,12,20,D C,101,1,1,1,1,1,1,20,12,10,1,1,1,1,1,1,274878000000.0,0,0,0,0,0,1,0,0,0,0,0,0,0,0,0,0,0,0,0,0,0,0,0,0,0,0,0,0,0,0,0,0,0,0,0,0,0,0,1,0,0,0,0,0,0,0,0,0,Laurent Koscielny,ÃÂ£16.20m ,35.0,185.0,Defender - Centre-Back,right,FC Girondins Bordeaux,43.0,3.0,1.0,3819.0,42.0,3.0,2.0,3630.0,34.0,4.0,1.0,2511.0,46.0,3.0,0.0,3974.0,39.0,3.0,0.0,3353.0,44.0,4.0,0.0,3803.0,43.0,2.0,1.0,3675.0,33.0,2.0,0.0,2790.0,31.0,3.0,0.0,2406.0,Premier League,28.0,0.0,0.0,2484.0,6.0,0.0,1.0,540.0,29/6/2010,Laurent Koscielny,8442484.0,769.0,9/10/1985,24.0,0.0,0.0,0.0,0.0,5200.0,6569.0,7300.0,165.0,146.0,-1.0,186.0,75.0,D C,1.0,1.0,2.0,3.0,1.0,3.0,3.0,3.0,3.0,3.0,3.0,5.0,7.0,9.0,10.0,11.0,5.0,15.0,7.0,6.0,15.0,9.0,7.0,13.0,11.0,12.0,17.0,15.0,15.0,15.0,11.0,14.0,16.0,5.0,11.0,11.0,16.0,14.0,16.0,14.0,12.0,16.0,14.0,8.0,15.0,13.0,20.0,15.0,14.0,17.0,12.0,14.0,6.0,8.0,10.0,15.0,13.0,14.0,15.0,15.0,15.0,6.0,Laurent Koscielny,ÃÂÃÂ£9.00m ,Premier League
19/6/2011,Kris Stadsgaard,931999,764,8/1/1985,25,2,0,0,0,4917,6271,6271,138,128,829658,185,78,D C,1,1,2,3,2,3,3,2,3,3,2,2,7,11,4,11,4,13,10,4,14,12,7,13,12,7,15,9,14,15,12,13,14,4,4,11,15,11,11,14,12,13,13,7,11,14,20,13,13,14,2,15,15,8,10,15,12,14,15,15,10,5,20,1,1,1,12,1,20,D C,101,1,1,1,1,1,1,20,1,12,1,1,1,1,1,1,279173000000.0,0,0,0,0,0,0,0,0,0,0,0,0,0,0,0,0,0,0,0,0,0,0,0,0,0,0,0,0,0,0,0,0,1,0,0,0,0,0,1,0,0,0,0,0,0,0,0,0,Kris Stadsgaard,ÃÂ£1.35m ,35.0,185.0,Defender - Centre-Back,right,Retired,32.0,1.0,1.0,2730.0,14.0,0.0,0.0,1198.0,38.0,2.0,1.0,3435.0,22.0,0.0,0.0,1900.0,nan,nan,nan,nan,0.0,0.0,0.0,0.0,nan,nan,nan,nan,nan,nan,nan,nan,nan,nan,nan,nan,LaLiga,nan,nan,nan,nan,nan,nan,nan,nan,29/6/2010,Kris Stadsgaard,931999.0,764.0,8/1/1985,24.0,1.0,0.0,0.0,0.0,4225.0,5849.0,6750.0,135.0,130.0,3847359.0,185.0,78.0,D C,3.0,3.0,1.0,2.0,3.0,1.0,2.0,7.0,2.0,1.0,2.0,2.0,7.0,11.0,4.0,11.0,4.0,13.0,10.0,1.0,14.0,12.0,7.0,13.0,12.0,7.0,15.0,9.0,16.0,16.0,12.0,14.0,14.0,4.0,4.0,9.0,14.0,11.0,11.0,16.0,12.0,13.0,13.0,7.0,11.0,16.0,20.0,13.0,13.0,16.0,2.0,15.0,15.0,8.0,10.0,15.0,12.0,14.0,15.0,15.0,10.0,5.0,Kris Stadsgaard,ÃÂÃÂ£1.35m ,LaLiga
19/6/2011,JoÃÂ£o Guilherme,317299,1651,4/21/1986,25,0,0,0,0,3250,5489,5950,139,122,332714,185,77,D C,2,1,1,3,2,2,3,2,3,2,2,9,9,11,11,11,15,15,15,11,13,11,11,13,13,12,12,9,12,9,10,11,14,12,10,11,13,11,10,14,13,15,16,6,17,13,20,16,15,11,9,11,7,7,13,18,12,10,9,13,15,12,20,1,1,1,4,3,20,D C,101,1,7,1,1,1,1,20,3,4,15,1,1,1,1,1,35184400000000.0,0,0,0,0,0,0,0,0,0,0,0,0,0,0,0,0,0,0,0,0,0,0,0,0,0,0,0,0,0,0,0,0,0,0,0,0,0,0,0,0,0,0,0,0,0,1,0,0,JoÃÂ£o Guilherme,ÃÂ£1.17m ,34.0,184.0,Defender - Centre-Back,right,Without Club,21.0,1.0,0.0,1508.0,31.0,2.0,2.0,2581.0,24.0,2.0,0.0,1960.0,36.0,3.0,1.0,3159.0,35.0,0.0,0.0,2992.0,26.0,1.0,0.0,1792.0,7.0,0.0,0.0,660.0,nan,nan,nan,nan,nan,nan,nan,nan,Liga NOS,nan,nan,nan,nan,nan,nan,nan,nan,29/6/2010,JoÃÂ£o Guilherme,317299.0,1651.0,4/21/1986,24.0,0.0,0.0,0.0,0.0,3250.0,5150.0,5950.0,139.0,119.0,1030690.0,185.0,77.0,D C,2.0,2.0,3.0,2.0,3.0,2.0,2.0,2.0,3.0,1.0,3.0,9.0,9.0,11.0,11.0,11.0,15.0,15.0,15.0,11.0,13.0,11.0,11.0,13.0,13.0,7.0,12.0,9.0,12.0,9.0,10.0,11.0,14.0,12.0,10.0,11.0,13.0,11.0,10.0,14.0,13.0,15.0,16.0,6.0,17.0,13.0,20.0,16.0,15.0,11.0,9.0,11.0,7.0,7.0,13.0,18.0,12.0,10.0,9.0,13.0,15.0,12.0,JoÃÂÃÂ£o Guilherme,ÃÂÃÂ£1.53m ,Liga NOS
19/6/2011,JÃÂ©ferson,19108563,1651,1/15/1986,25,0,0,0,0,500,3700,4250,100,90,61257,188,74,D C,3,1,1,3,2,1,3,1,1,2,2,7,7,6,7,9,10,13,10,10,11,7,10,10,10,11,10,9,10,9,7,8,10,6,8,6,10,10,10,9,9,16,15,20,12,8,9,13,16,9,10,7,7,6,4,8,8,9,15,7,8,10,20,1,1,1,1,1,20,D C,101,1,1,1,1,1,1,20,1,1,1,1,1,1,1,1,0.0,0,0,0,0,0,0,0,0,0,0,0,0,0,0,0,0,0,0,0,0,0,0,0,0,0,0,0,0,0,0,0,0,0,0,0,0,0,0,0,0,0,0,0,0,0,0,0,0,Jeferson,ÃÂ£1.35m ,34.0,189.0,Defender - Centre-Back,right,Bravos de Nuevo Laredo,25.0,0.0,1.0,2271.0,23.0,1.0,0.0,2100.0,5.0,0.0,0.0,480.0,0.0,0.0,0.0,0.0,nan,nan,nan,nan,nan,nan,nan,nan,nan,nan,nan,nan,nan,nan,nan,nan,nan,nan,nan,nan,Liga NOS,nan,nan,nan,nan,nan,nan,nan,nan,29/6/2010,JÃÂ©ferson,19108563.0,1651.0,1/15/1986,24.0,0.0,0.0,0.0,0.0,50.0,3700.0,3700.0,100.0,83.0,477330.0,188.0,74.0,D C,1.0,1.0,2.0,2.0,1.0,2.0,1.0,1.0,1.0,1.0,1.0,8.0,4.0,4.0,6.0,8.0,6.0,12.0,4.0,7.0,12.0,6.0,4.0,12.0,6.0,15.0,8.0,9.0,10.0,11.0,4.0,11.0,10.0,4.0,12.0,1.0,7.0,15.0,12.0,12.0,12.0,12.0,10.0,20.0,14.0,12.0,9.0,8.0,8.0,10.0,5.0,10.0,6.0,10.0,13.0,12.0,5.0,10.0,7.0,7.0,3.0,10.0,Jeferson,ÃÂÃÂ£450Th. ,Liga NOS
19/6/2011,JÃÂ©ferson Baiano,2114080,1651,1/20/1986,25,0,0,0,0,1034,4950,4950,106,99,41510,184,78,D/DM C,2,1,2,2,3,1,3,1,1,3,1,2,7,8,8,9,2,11,10,6,13,9,9,12,8,15,12,14,8,10,8,10,14,7,10,10,11,13,12,10,12,12,11,8,14,11,20,14,12,12,11,11,8,14,10,11,14,11,14,12,13,10,20,1,13,1,1,1,20,D/DM C,111,1,12,1,1,1,1,20,1,1,17,13,1,1,1,1,1073741824.0,0,0,0,0,0,0,0,0,0,0,0,0,0,0,0,0,0,0,0,0,0,0,0,0,0,0,0,0,0,0,1,0,0,0,0,0,0,0,0,0,0,0,0,0,0,0,0,0,nan,nan,nan,nan,nan,nan,nan,nan,nan,nan,nan,nan,nan,nan,nan,nan,nan,nan,nan,nan,nan,nan,nan,nan,nan,nan,nan,nan,nan,nan,nan,nan,nan,nan,nan,nan,nan,nan,nan,nan,nan,nan,nan,nan,nan,nan,nan,nan,nan,nan,nan,nan,nan,nan,nan,nan,nan,nan,nan,nan,nan,nan,nan,nan,nan,nan,nan,nan,nan,nan,nan,nan,nan,nan,nan,nan,nan,nan,nan,nan,nan,nan,nan,nan,nan,nan,nan,nan,nan,nan,nan,nan,nan,nan,nan,nan,nan,nan,nan,nan,nan,nan,nan,nan,nan,nan,nan,nan,nan,nan,nan,nan,nan,nan,nan,nan,nan,nan,nan,nan,nan,nan,nan,nan,nan,nan,nan,nan,nan,nan,nan,nan,nan,nan,nan,nan
19/6/2011,Jardel,2114077,1651,3/29/1986,25,0,0,0,0,3000,5950,5750,131,119,615703,191,84,D C,1,3,2,1,2,3,1,4,3,3,2,4,6,5,7,11,6,15,6,9,13,12,3,11,7,15,12,13,8,13,3,12,14,11,13,9,14,12,12,7,7,11,16,10,15,9,20,14,14,14,13,12,6,8,13,12,7,11,14,13,13,7,20,1,1,1,1,1,20,D C,101,1,5,1,1,1,1,20,1,1,8,1,1,1,1,1,8589934592.0,0,0,0,0,0,0,0,0,0,0,0,0,0,0,0,0,0,0,0,0,0,0,0,0,0,0,0,0,0,0,0,0,0,1,0,0,0,0,0,0,0,0,0,0,0,0,0,0,Jardel,ÃÂ£2.70m ,34.0,192.0,Defender - Centre-Back,right,SL Benfica,36.0,2.0,1.0,2945.0,18.0,0.0,0.0,1620.0,37.0,2.0,4.0,2877.0,18.0,0.0,0.0,1544.0,43.0,4.0,1.0,3900.0,44.0,5.0,5.0,3979.0,8.0,0.0,0.0,720.0,34.0,2.0,4.0,3015.0,37.0,3.0,1.0,3175.0,Liga NOS,19.0,0.0,0.0,1583.0,2.0,0.0,0.0,77.0,29/6/2010,Jardel,2114077.0,1651.0,3/29/1986,24.0,0.0,0.0,0.0,0.0,2000.0,5250.0,5250.0,122.0,107.0,69842.0,191.0,84.0,D C,3.0,2.0,1.0,3.0,2.0,3.0,2.0,4.0,3.0,2.0,2.0,4.0,6.0,5.0,7.0,11.0,3.0,15.0,6.0,9.0,13.0,12.0,7.0,11.0,7.0,15.0,11.0,13.0,10.0,8.0,5.0,12.0,14.0,10.0,13.0,9.0,14.0,12.0,12.0,6.0,7.0,5.0,16.0,10.0,15.0,9.0,20.0,14.0,14.0,14.0,13.0,12.0,6.0,8.0,13.0,12.0,7.0,11.0,17.0,1.0,2.0,7.0,Jardel,ÃÂÃÂ£2.16m ,Liga NOS,19-06-17,18.3.4.28,Jardel,2114077,1651,29-Mar-86,31,0,0,0,0,6152,5896,7200,153,144,232186002,192,88,D C,1,3,2,2,3,3,3,1,2,1,2,4,4,8,9,9,6,15,6,7,15,10,11,16,9,18,17,17,11,15,6,14,16,6,16,10,16,15,15,11,11,14,16,8,15,12,20,12,15,15,12,15,12,7,14,12,18,12,18,17,13,8,20,1,1,1,1,1,20,D C,101,1,1,1,1,1,1,20,1,1,1,1,1,1,1,1,0.0,0,0,0,0,0,0,0,0,0,0,0,0,0,0,0,0,0,0,0,0,0,0,0,0,0,0,0,0,0,0,0,0,0,0,0,0,0,0,0,0,0,0,0,0,0,0,0,0,Jardel,ÃÂ£3.15m ,34.0,192.0,Defender - Centre-Back,right,SL Benfica,8.0,0.0,0.0,720.0,34.0,2.0,4.0,3015.0,37.0,3.0,1.0,3175.0,19.0,0.0,0.0,1583.0,2.0,0.0,0.0,77.0,Liga NOS,15-07-16,17.3.2.23,Jardel,2114077.0,1651.0,29-Mar-86,30.0,0.0,0.0,0.0,0.0,6208.0,5950.0,7500.0,153.0,150.0,232186002.0,192.0,88.0,D C,3.0,2.0,3.0,2.0,1.0,3.0,2.0,4.0,1.0,1.0,2.0,4.0,4.0,8.0,9.0,10.0,6.0,15.0,6.0,7.0,16.0,9.0,11.0,17.0,9.0,18.0,17.0,18.0,11.0,15.0,6.0,13.0,16.0,6.0,15.0,10.0,16.0,15.0,15.0,13.0,11.0,16.0,17.0,5.0,16.0,13.0,20.0,12.0,17.0,16.0,12.0,15.0,8.0,7.0,14.0,12.0,18.0,12.0,18.0,17.0,13.0,7.0,Jardel,ÃÂ£3.60m ,Liga NOS
19/6/2011,Halisson,142332,1651,6/28/1985,25,0,0,0,0,2267,5900,5900,128,118,587503,188,74,D C,1,3,1,2,1,3,2,2,2,3,1,3,7,12,8,9,2,14,9,6,11,12,9,13,13,10,11,14,13,9,6,10,17,14,11,7,12,13,16,12,12,14,15,7,18,12,20,15,14,11,10,11,8,6,11,8,10,12,11,10,1,16,20,1,1,1,1,1,20,D C,101,1,1,1,1,1,1,20,1,1,1,1,1,1,1,1,4294967296.0,0,0,0,0,0,0,0,0,0,0,0,0,0,0,0,0,0,0,0,0,0,0,0,0,0,0,0,0,0,0,0,0,1,0,0,0,0,0,0,0,0,0,0,0,0,0,0,0,Halisson,ÃÂ£540Th. ,35.0,189.0,Defender - Centre-Back,right,Without Club,nan,nan,nan,nan,32.0,0.0,0.0,2860.0,27.0,1.0,0.0,2327.0,41.0,1.0,0.0,3486.0,20.0,0.0,1.0,1782.0,nan,nan,nan,nan,5.0,0.0,0.0,361.0,nan,nan,nan,nan,nan,nan,nan,nan,Liga NOS,nan,nan,nan,nan,nan,nan,nan,nan,nan,nan,nan,nan,nan,nan,nan,nan,nan,nan,nan,nan,nan,nan,nan,nan,nan,nan,nan,nan,nan,nan,nan,nan,nan,nan,nan,nan,nan,nan,nan,nan,nan,nan,nan,nan,nan,nan,nan,nan,nan,nan,nan,nan,nan,nan,nan,nan,nan,nan,nan,nan,nan,nan,nan,nan,nan,nan,nan,nan,nan,nan,nan,nan,nan,nan,nan,nan,nan,nan,nan,nan,nan,nan,nan,nan,nan,nan,nan,nan,nan,nan,nan,nan
19/6/2011,Gustavo Cabral,958132,1649,10/14/1985,25,0,0,6,0,2500,5250,5250,137,124,47950,182,81,D C,3,1,1,1,3,2,3,8,3,1,2,4,7,7,5,7,6,15,4,9,14,11,8,14,7,16,14,16,14,14,11,12,15,2,14,5,13,14,15,11,11,15,12,8,16,10,20,14,16,12,16,14,6,10,14,15,13,14,13,7,9,11,20,1,1,1,1,1,20,D C,101,1,14,1,1,1,1,20,1,1,1,1,1,1,1,1,32768.0,0,0,0,0,0,0,0,0,0,0,0,0,0,0,0,1,0,0,0,0,0,0,0,0,0,0,0,0,0,0,0,0,0,0,0,0,0,0,0,0,0,0,0,0,0,0,0,0,Gustavo Cabral,ÃÂ£720Th. ,35.0,182.0,Defender - Centre-Back,right,CF Pachuca,30.0,1.0,0.0,2599.0,22.0,1.0,1.0,1905.0,31.0,1.0,1.0,2582.0,25.0,1.0,0.0,2134.0,38.0,1.0,0.0,3353.0,37.0,0.0,0.0,3172.0,45.0,3.0,2.0,3992.0,29.0,2.0,1.0,2082.0,25.0,0.0,1.0,1986.0,LaLiga,28.0,2.0,0.0,2334.0,14.0,0.0,0.0,1260.0,nan,nan,nan,nan,nan,nan,nan,nan,nan,nan,nan,nan,nan,nan,nan,nan,nan,nan,nan,nan,nan,nan,nan,nan,nan,nan,nan,nan,nan,nan,nan,nan,nan,nan,nan,nan,nan,nan,nan,nan,nan,nan,nan,nan,nan,nan,nan,nan,nan,nan,nan,nan,nan,nan,nan,nan,nan,nan,nan,nan,nan,nan,nan,nan,nan,nan,nan,nan,nan,nan,nan,nan,nan,nan,nan,nan,nan,nan,nan,nan,nan,nan,nan,nan,19-06-17,18.3.4.28,Gustavo Cabral,958132,1649,14-Oct-85,31,0,0,6,0,6000,7250,7250,149,145,232186002,183,81,D C,3,2,1,4,1,2,2,4,3,1,1,5,7,7,5,9,7,15,6,9,17,11,8,16,8,17,15,16,12,13,9,13,15,6,16,6,17,16,16,12,11,9,13,8,15,14,20,13,16,14,16,15,6,12,14,15,13,14,13,7,9,11,20,1,1,1,1,1,20,D C,101,1,10,1,1,1,1,20,1,1,11,1,1,1,1,1,32768.0,0,0,0,0,0,0,0,0,0,0,0,0,0,0,0,1,0,0,0,0,0,0,0,0,0,0,0,0,0,0,0,0,0,0,0,0,0,0,0,0,0,0,0,0,0,0,0,0,Gustavo Cabral,ÃÂ£2.25m ,35.0,182.0,Defender - Centre-Back,right,CF Pachuca,45.0,3.0,2.0,3992.0,29.0,2.0,1.0,2082.0,25.0,0.0,1.0,1986.0,28.0,2.0,0.0,2334.0,14.0,0.0,0.0,1260.0,LaLiga,15-07-16,17.3.2.23,Gustavo Cabral,958132.0,1649.0,14-Oct-85,30.0,0.0,0.0,6.0,0.0,6000.0,6850.0,7150.0,149.0,146.0,232186002.0,183.0,81.0,D C,2.0,3.0,2.0,1.0,3.0,3.0,3.0,2.0,2.0,1.0,2.0,5.0,7.0,7.0,5.0,9.0,7.0,15.0,6.0,9.0,17.0,11.0,8.0,16.0,8.0,17.0,15.0,18.0,12.0,13.0,9.0,15.0,15.0,6.0,16.0,6.0,17.0,16.0,16.0,12.0,11.0,9.0,13.0,8.0,16.0,14.0,20.0,13.0,16.0,14.0,17.0,15.0,6.0,12.0,14.0,15.0,13.0,14.0,13.0,7.0,9.0,11.0,Gustavo Cabral,ÃÂ£3.60m ,LaLiga
19/6/2011,Geromel,8878850,1651,9/21/1985,25,0,0,0,0,5516,6524,7200,156,144,1687508,190,84,D C,3,1,3,2,3,2,2,4,3,3,1,6,9,8,6,12,5,12,6,10,17,11,6,12,14,7,18,9,16,13,9,13,13,6,9,6,18,17,7,15,14,12,16,10,11,15,20,14,10,16,3,12,7,11,16,12,14,15,16,17,13,6,20,3,5,1,8,5,20,D C,101,1,14,1,1,1,1,20,5,8,10,5,1,1,3,3,279173000000.0,0,0,0,0,0,0,1,0,0,0,0,0,0,0,0,0,0,0,0,0,0,0,0,0,0,0,0,0,0,0,0,0,1,0,0,0,0,0,1,0,0,0,0,0,0,0,0,0,nan,nan,nan,nan,nan,nan,nan,nan,nan,nan,nan,nan,nan,nan,nan,nan,nan,nan,nan,nan,nan,nan,nan,nan,nan,nan,nan,nan,nan,nan,nan,nan,nan,nan,nan,nan,nan,nan,nan,nan,nan,nan,nan,nan,nan,nan,nan,nan,nan,nan,nan,nan,29/6/2010,Geromel,8878850.0,1651.0,9/21/1985,24.0,0.0,0.0,0.0,0.0,4200.0,6524.0,7250.0,162.0,145.0,10447835.0,190.0,84.0,D C,3.0,2.0,1.0,1.0,1.0,2.0,3.0,8.0,3.0,3.0,2.0,6.0,10.0,9.0,6.0,13.0,5.0,10.0,6.0,10.0,17.0,12.0,6.0,12.0,14.0,7.0,18.0,9.0,17.0,14.0,8.0,12.0,13.0,6.0,9.0,6.0,18.0,17.0,7.0,15.0,14.0,12.0,16.0,10.0,11.0,16.0,20.0,14.0,10.0,16.0,3.0,12.0,7.0,12.0,16.0,12.0,14.0,15.0,16.0,18.0,17.0,2.0,nan,nan,nan
19/6/2011,Georg Niedermeier,8728397,771,2/26/1986,25,0,0,0,0,4500,6050,6550,128,121,702440,189,75,D C,3,2,2,2,2,2,3,1,1,3,3,4,4,5,12,7,4,17,8,6,13,9,8,14,7,13,10,18,10,9,7,10,10,3,11,14,13,15,16,10,8,15,16,7,11,14,20,17,14,12,5,9,11,4,8,9,13,9,11,10,9,5,20,8,1,1,10,1,20,D C,101,1,1,1,1,1,1,20,1,10,1,1,1,1,1,8,0.0,0,0,0,0,0,0,0,0,0,0,0,0,0,0,0,0,0,0,0,0,0,0,0,0,0,0,0,0,0,0,0,0,0,0,0,0,0,0,0,0,0,0,0,0,0,0,0,0,Georg Niedermeier,ÃÂ£3.15m ,34.0,190.0,Defender - Centre-Back,right,Without Club,42.0,5.0,0.0,3262.0,19.0,0.0,3.0,1423.0,40.0,2.0,2.0,3370.0,20.0,1.0,0.0,1751.0,22.0,1.0,2.0,1680.0,20.0,4.0,1.0,1642.0,7.0,0.0,0.0,209.0,4.0,1.0,0.0,360.0,19.0,2.0,0.0,1266.0,Bundesliga,nan,nan,nan,nan,nan,nan,nan,nan,29/6/2010,Georg Niedermeier,8728397.0,771.0,2/26/1986,24.0,0.0,0.0,0.0,0.0,1250.0,4000.0,4000.0,120.0,110.0,3231858.0,189.0,75.0,D C,3.0,2.0,3.0,1.0,2.0,1.0,3.0,1.0,3.0,3.0,2.0,8.0,7.0,8.0,1.0,9.0,5.0,13.0,3.0,3.0,13.0,13.0,4.0,13.0,7.0,14.0,13.0,14.0,8.0,13.0,4.0,13.0,11.0,3.0,8.0,5.0,13.0,15.0,15.0,13.0,12.0,13.0,15.0,5.0,8.0,13.0,20.0,13.0,13.0,10.0,7.0,10.0,8.0,10.0,10.0,8.0,11.0,7.0,9.0,9.0,12.0,12.0,Georg Niedermeier,ÃÂÃÂ£2.70m ,Bundesliga
19/6/2011,Gary Cahill,5112583,765,12/19/1985,25,3,0,1,0,6761,7663,7513,155,148,2464292,188,71,D C,3,2,3,1,2,3,3,7,3,3,3,3,5,10,9,13,4,15,8,6,15,14,6,16,16,14,15,15,15,14,13,14,15,14,15,13,14,12,14,13,13,12,14,8,14,14,20,14,14,13,9,12,7,7,7,16,12,16,14,12,13,5,20,1,1,1,1,1,20,D C,101,1,1,1,1,1,1,20,1,1,1,1,1,1,1,1,2252080000000000.0,0,0,0,0,0,0,0,0,0,0,0,0,0,0,0,1,0,0,0,0,0,0,0,0,0,0,0,0,0,0,0,0,1,0,0,0,0,0,1,0,0,0,0,0,0,0,0,0,Gary Cahill,ÃÂ£14.85m ,34.0,193.0,Defender - Centre-Back,right,Crystal Palace,41.0,3.0,0.0,3664.0,40.0,4.0,0.0,3346.0,45.0,6.0,2.0,3958.0,47.0,2.0,2.0,4213.0,48.0,3.0,2.0,4123.0,37.0,4.0,0.0,3155.0,43.0,8.0,0.0,3835.0,43.0,0.0,1.0,3391.0,8.0,0.0,0.0,592.0,Premier League,27.0,0.0,1.0,2302.0,1.0,0.0,0.0,90.0,29/6/2010,Gary Cahill,5112583.0,765.0,12/19/1985,24.0,0.0,0.0,4.0,0.0,5000.0,7000.0,7000.0,155.0,145.0,6787709.0,188.0,79.0,D C,2.0,1.0,3.0,2.0,3.0,3.0,3.0,4.0,1.0,3.0,2.0,3.0,5.0,11.0,10.0,14.0,4.0,16.0,10.0,8.0,14.0,15.0,8.0,15.0,16.0,12.0,15.0,15.0,15.0,14.0,12.0,14.0,15.0,13.0,15.0,12.0,13.0,12.0,13.0,13.0,13.0,12.0,14.0,8.0,13.0,14.0,20.0,14.0,14.0,13.0,9.0,12.0,7.0,8.0,7.0,16.0,12.0,16.0,14.0,12.0,13.0,5.0,Gary Cahill,ÃÂÃÂ£8.55m ,Premier League
19/6/2011,Gabriel Paletta,8441078,1649,2/15/1986,25,0,0,8,0,3020,6021,6271,141,128,688003,190,80,D C,2,2,2,2,3,2,1,4,1,3,2,4,6,8,4,9,4,14,6,7,17,11,6,14,10,18,14,14,12,11,7,11,16,7,8,11,14,14,12,12,12,14,15,9,14,11,20,13,15,8,14,12,7,9,14,14,15,15,13,14,11,8,20,1,1,1,1,1,20,D C,101,1,1,1,1,1,1,20,1,1,1,1,1,1,1,1,0.0,0,0,0,0,0,0,0,0,0,0,0,0,0,0,0,0,0,0,0,0,0,0,0,0,0,0,0,0,0,0,0,0,0,0,0,0,0,0,0,0,0,0,0,0,0,0,0,0,Gabriel Paletta,ÃÂ£3.42m ,34.0,190.0,Defender - Centre-Back,right,AC Monza,28.0,0.0,1.0,2399.0,35.0,4.0,1.0,3150.0,36.0,1.0,1.0,3208.0,23.0,0.0,0.0,1716.0,23.0,1.0,0.0,1891.0,24.0,1.0,0.0,2014.0,32.0,2.0,2.0,2804.0,31.0,1.0,0.0,2820.0,19.0,0.0,2.0,1661.0,Serie A,7.0,1.0,0.0,630.0,3.0,0.0,0.0,270.0,29/6/2010,Gabriel Paletta,8441078.0,1649.0,2/15/1986,24.0,0.0,0.0,8.0,0.0,3000.0,6000.0,6000.0,133.0,123.0,2782053.0,190.0,80.0,D C,2.0,2.0,1.0,2.0,2.0,1.0,1.0,4.0,2.0,1.0,3.0,4.0,6.0,8.0,4.0,9.0,4.0,14.0,6.0,7.0,15.0,11.0,6.0,14.0,10.0,18.0,14.0,14.0,12.0,10.0,7.0,11.0,16.0,7.0,8.0,11.0,13.0,14.0,12.0,12.0,12.0,14.0,15.0,9.0,14.0,11.0,20.0,13.0,15.0,8.0,14.0,12.0,7.0,9.0,14.0,14.0,15.0,15.0,13.0,14.0,11.0,8.0,Gabriel Paletta,ÃÂÃÂ£2.25m ,Serie A
19/6/2011,Felipe Santana,2107819,1651,3/17/1986,25,0,0,0,0,4500,6000,6750,141,135,1254801,194,80,D C,1,1,2,3,3,1,1,3,1,1,2,4,6,9,10,9,7,16,7,11,14,6,4,15,7,13,14,15,14,9,6,11,13,5,13,12,13,16,13,12,10,13,18,8,13,16,20,13,16,13,10,12,7,3,14,8,15,13,17,16,10,6,20,1,1,1,5,1,20,D C,101,1,10,8,1,1,1,20,1,5,1,1,1,1,1,1,8.0,0,0,0,1,0,0,0,0,0,0,0,0,0,0,0,0,0,0,0,0,0,0,0,0,0,0,0,0,0,0,0,0,0,0,0,0,0,0,0,0,0,0,0,0,0,0,0,0,Felipe Santana,ÃÂ£4.50m ,34.0,194.0,Defender - Centre-Back,right,AssociaÃÂ§ÃÂ£o Chapecoense de Futebol,13.0,0.0,0.0,522.0,17.0,1.0,0.0,1249.0,31.0,3.0,0.0,2144.0,26.0,1.0,1.0,1679.0,14.0,0.0,1.0,1127.0,12.0,0.0,0.0,1110.0,14.0,1.0,1.0,1227.0,0.0,0.0,0.0,0.0,nan,nan,nan,nan,Bundesliga,0.0,0.0,0.0,0.0,nan,nan,nan,nan,29/6/2010,Felipe Santana,2107819.0,1651.0,3/17/1986,24.0,0.0,0.0,0.0,0.0,3500.0,6600.0,6750.0,149.0,135.0,4478475.0,194.0,82.0,D C,3.0,2.0,1.0,3.0,2.0,2.0,3.0,4.0,3.0,2.0,1.0,4.0,6.0,9.0,10.0,10.0,7.0,17.0,7.0,11.0,14.0,6.0,4.0,15.0,7.0,14.0,15.0,13.0,14.0,10.0,6.0,10.0,16.0,5.0,15.0,12.0,13.0,15.0,13.0,12.0,10.0,12.0,18.0,8.0,13.0,15.0,20.0,12.0,16.0,13.0,13.0,12.0,7.0,9.0,10.0,12.0,14.0,15.0,17.0,16.0,11.0,8.0,Felipe Santana,ÃÂÃÂ£3.60m ,Bundesliga
19/6/2011,Ernesto GalÃÂ¡n,1512134,796,6/17/1986,25,0,0,0,0,3029,6271,6271,136,131,293027,181,79,D RC,2,2,1,3,2,3,1,7,3,3,1,9,11,11,7,10,8,11,7,11,13,11,10,13,9,12,12,14,12,13,9,12,10,11,9,12,14,15,14,15,15,13,11,7,13,13,20,15,12,12,8,13,15,13,12,13,9,10,10,14,10,9,20,15,1,1,19,1,20,D RC,103,1,1,1,1,1,1,20,1,19,1,1,1,1,1,15,0.0,0,0,0,0,0,0,0,0,0,0,0,0,0,0,0,0,0,0,0,0,0,0,0,0,0,0,0,0,0,0,0,0,0,0,0,0,0,0,0,0,0,0,0,0,0,0,0,0,Ernesto GalÃÂ¡n,ÃÂ£1.35m ,34.0,181.0,Defender - Right-Back,right,Without Club,21.0,1.0,0.0,1743.0,14.0,0.0,0.0,1221.0,14.0,0.0,0.0,1181.0,9.0,0.0,0.0,698.0,16.0,1.0,1.0,1309.0,37.0,4.0,1.0,3048.0,24.0,2.0,0.0,1953.0,8.0,0.0,0.0,604.0,29.0,0.0,0.0,2316.0,LaLiga,nan,nan,nan,nan,nan,nan,nan,nan,29/6/2010,Ernesto GalÃÂ¡n,1512134.0,796.0,6/17/1986,24.0,0.0,0.0,0.0,0.0,2000.0,5000.0,5000.0,125.0,110.0,1604909.0,181.0,79.0,D RC,3.0,3.0,2.0,1.0,3.0,1.0,2.0,1.0,2.0,3.0,3.0,9.0,14.0,12.0,11.0,10.0,8.0,11.0,10.0,11.0,13.0,11.0,10.0,11.0,11.0,12.0,12.0,11.0,10.0,7.0,13.0,9.0,10.0,11.0,8.0,14.0,14.0,15.0,14.0,15.0,15.0,13.0,11.0,7.0,13.0,11.0,20.0,14.0,12.0,11.0,8.0,13.0,15.0,11.0,12.0,13.0,9.0,10.0,10.0,14.0,10.0,9.0,Ernesto GalÃÂÃÂ¡n,ÃÂÃÂ£900Th. ,LaLiga
19/6/2011,DouglÃÂ£o,2115532,1651,5/18/1986,25,0,0,0,0,3000,6000,6000,130,120,403060,193,84,D C,2,1,3,1,3,1,1,2,3,2,3,5,8,8,6,10,6,15,11,11,14,8,6,12,12,16,13,14,8,10,6,12,16,11,8,8,13,12,16,11,6,17,17,8,14,9,20,14,18,13,12,12,6,10,12,17,13,10,12,7,6,16,20,1,1,1,10,1,20,D C,101,1,1,5,1,1,1,20,1,10,10,1,1,1,1,1,32.0,0,0,0,0,0,1,0,0,0,0,0,0,0,0,0,0,0,0,0,0,0,0,0,0,0,0,0,0,0,0,0,0,0,0,0,0,0,0,0,0,0,0,0,0,0,0,0,0,DouglÃÂ£o,ÃÂ£1.62m ,34.0,195.0,Defender - Centre-Back,right,Without Club,26.0,1.0,1.0,2283.0,29.0,3.0,0.0,2492.0,22.0,3.0,0.0,1841.0,24.0,4.0,0.0,2113.0,33.0,1.0,0.0,2949.0,31.0,6.0,2.0,2750.0,14.0,0.0,1.0,989.0,29.0,4.0,0.0,2537.0,18.0,3.0,1.0,1481.0,Liga NOS,nan,nan,nan,nan,nan,nan,nan,nan,nan,nan,nan,nan,nan,nan,nan,nan,nan,nan,nan,nan,nan,nan,nan,nan,nan,nan,nan,nan,nan,nan,nan,nan,nan,nan,nan,nan,nan,nan,nan,nan,nan,nan,nan,nan,nan,nan,nan,nan,nan,nan,nan,nan,nan,nan,nan,nan,nan,nan,nan,nan,nan,nan,nan,nan,nan,nan,nan,nan,nan,nan,nan,nan,nan,nan,nan,nan,nan,nan,nan,nan,nan,nan,nan,nan,nan,nan,nan,nan,nan,nan,nan,nan
19/6/2011,Diego GodÃÂ­n,8826848,1657,2/16/1986,25,43,3,9,0,6250,7750,7250,156,148,20982549,185,73,D C,3,2,3,3,3,2,1,5,3,1,1,4,5,8,10,11,5,15,7,9,15,11,12,15,11,16,14,16,13,14,8,14,14,6,15,7,15,15,16,14,11,17,14,9,14,13,20,16,15,14,14,15,6,5,16,13,12,13,14,11,10,6,20,1,1,1,7,2,20,D C,101,1,13,1,1,1,1,20,2,7,5,1,1,1,1,1,0.0,0,0,0,0,0,0,0,0,0,0,0,0,0,0,0,0,0,0,0,0,0,0,0,0,0,0,0,0,0,0,0,0,0,0,0,0,0,0,0,0,0,0,0,0,0,0,0,0,Diego GodÃÂ­n,ÃÂ£10.80m ,34.0,187.0,Defender - Centre-Back,right,Cagliari Calcio,30.0,2.0,0.0,2653.0,41.0,3.0,3.0,3516.0,42.0,1.0,2.0,3730.0,51.0,8.0,0.0,4620.0,48.0,4.0,2.0,4320.0,46.0,1.0,2.0,4029.0,47.0,3.0,2.0,4028.0,45.0,1.0,0.0,3903.0,39.0,4.0,3.0,3347.0,LaLiga,36.0,2.0,1.0,2800.0,3.0,1.0,0.0,265.0,29/6/2010,Diego GodÃÂ­n,8826848.0,1657.0,2/16/1986,24.0,43.0,3.0,9.0,0.0,5329.0,7950.0,7000.0,156.0,146.0,91453172.0,185.0,73.0,D C,2.0,2.0,3.0,1.0,2.0,1.0,1.0,2.0,3.0,1.0,3.0,4.0,5.0,8.0,10.0,11.0,5.0,14.0,7.0,9.0,15.0,11.0,12.0,15.0,12.0,16.0,14.0,16.0,13.0,14.0,8.0,14.0,14.0,7.0,15.0,7.0,15.0,15.0,16.0,14.0,11.0,17.0,13.0,9.0,14.0,13.0,20.0,16.0,15.0,14.0,10.0,15.0,6.0,5.0,16.0,13.0,12.0,13.0,14.0,11.0,10.0,6.0,Diego GodÃÂÃÂ­n,ÃÂÃÂ£10.80m ,LaLiga,19-06-17,18.3.4.28,Diego GodÃÂ­n,8826848,1657,16-Feb-86,31,108,8,9,0,7850,8900,8300,169,166,232186002,187,79,D C,1,3,2,1,2,1,3,1,1,1,3,4,5,8,10,11,5,18,7,9,17,11,11,16,11,14,16,18,16,16,8,17,16,6,15,7,16,16,16,11,12,11,16,11,15,14,20,15,14,16,14,15,6,5,16,13,12,13,14,11,10,6,20,1,1,1,1,1,20,D C,101,1,9,1,1,1,1,20,1,1,1,1,1,1,1,1,137473000000.0,0,0,0,0,0,0,0,0,0,0,0,0,0,0,0,0,0,0,0,0,0,0,0,0,0,1,0,0,0,0,0,0,0,0,0,0,0,1,0,0,0,0,0,0,0,0,0,0,Diego GodÃÂ­n,ÃÂ£31.50m ,34.0,187.0,Defender - Centre-Back,right,Cagliari Calcio,47.0,3.0,2.0,4028.0,45.0,1.0,0.0,3903.0,39.0,4.0,3.0,3347.0,36.0,2.0,1.0,2800.0,3.0,1.0,0.0,265.0,LaLiga,15-07-16,17.3.2.23,Diego GodÃÂ­n,8826848.0,1657.0,16-Feb-86,30.0,91.0,4.0,9.0,0.0,7850.0,8900.0,8300.0,169.0,166.0,232186002.0,185.0,73.0,D C,3.0,1.0,3.0,1.0,3.0,3.0,2.0,1.0,2.0,3.0,3.0,4.0,5.0,8.0,10.0,11.0,5.0,18.0,7.0,9.0,17.0,11.0,11.0,16.0,11.0,14.0,16.0,18.0,16.0,16.0,8.0,17.0,16.0,6.0,15.0,7.0,16.0,16.0,16.0,11.0,12.0,11.0,16.0,11.0,15.0,14.0,20.0,15.0,14.0,16.0,14.0,15.0,6.0,5.0,16.0,13.0,12.0,13.0,14.0,11.0,10.0,6.0,Diego GodÃÂ­n,ÃÂ£34.20m ,LaLiga
19/6/2011,Daniele Magliocchetti,7984091,776,5/11/1986,25,0,0,0,0,1362,4900,4900,110,100,261478,184,74,D LC,1,3,3,1,2,3,2,1,3,2,3,3,4,7,7,9,4,14,5,12,12,9,3,12,10,13,12,11,11,11,9,10,17,4,7,9,13,13,10,12,12,12,12,20,13,12,7,13,12,11,9,8,11,10,7,16,17,15,16,12,15,1,20,8,1,1,1,18,20,D LC,104,1,1,1,1,1,1,20,18,1,1,1,1,1,8,1,0.0,0,0,0,0,0,0,0,0,0,0,0,0,0,0,0,0,0,0,0,0,0,0,0,0,0,0,0,0,0,0,0,0,0,0,0,0,0,0,0,0,0,0,0,0,0,0,0,0,nan,nan,nan,nan,nan,nan,nan,nan,nan,nan,nan,nan,nan,nan,nan,nan,nan,nan,nan,nan,nan,nan,nan,nan,nan,nan,nan,nan,nan,nan,nan,nan,nan,nan,nan,nan,nan,nan,nan,nan,nan,nan,nan,nan,nan,nan,nan,nan,nan,nan,nan,nan,nan,nan,nan,nan,nan,nan,nan,nan,nan,nan,nan,nan,nan,nan,nan,nan,nan,nan,nan,nan,nan,nan,nan,nan,nan,nan,nan,nan,nan,nan,nan,nan,nan,nan,nan,nan,nan,nan,nan,nan,nan,nan,nan,nan,nan,nan,nan,nan,nan,nan,nan,nan,nan,nan,nan,nan,nan,nan,nan,nan,nan,nan,nan,nan,nan,nan,nan,nan,nan,nan,nan,nan,nan,nan,nan,nan,nan,nan,nan,nan,nan,nan,nan,nan
19/6/2011,Christian,7450671,796,10/15/1985,25,0,0,0,0,4250,6250,6250,140,132,610828,182,77,D/WB LC,2,3,1,2,2,2,1,2,3,1,1,9,11,9,8,8,7,19,9,18,14,9,7,15,7,18,13,19,7,11,7,9,13,8,8,9,13,13,17,15,17,15,13,20,18,15,5,16,16,13,9,12,12,12,15,12,14,11,12,10,7,12,20,18,13,11,5,20,15,D/WB LC,114,1,1,1,1,11,1,15,20,5,1,1,13,1,18,1,154619000000.0,0,0,0,0,0,0,0,0,0,0,0,0,0,0,0,0,0,0,0,0,0,0,0,0,0,0,0,0,0,0,0,0,0,0,1,0,0,1,0,0,0,0,0,0,0,0,0,0,Cristiano,- ,37.0,174.0,Forward - Left Winger,left,Without Club,14.0,0.0,1.0,579.0,12.0,2.0,3.0,806.0,28.0,2.0,4.0,1853.0,nan,nan,nan,nan,nan,nan,nan,nan,nan,nan,nan,nan,nan,nan,nan,nan,nan,nan,nan,nan,nan,nan,nan,nan,Liga NOS,nan,nan,nan,nan,nan,nan,nan,nan,29/6/2010,Christian,7450671.0,796.0,10/15/1985,24.0,0.0,0.0,0.0,0.0,4225.0,6500.0,6500.0,140.0,130.0,3397719.0,182.0,77.0,D/WB/M L,1.0,2.0,1.0,2.0,1.0,1.0,2.0,4.0,3.0,2.0,2.0,11.0,11.0,10.0,10.0,10.0,11.0,18.0,11.0,18.0,12.0,11.0,12.0,12.0,10.0,14.0,11.0,18.0,7.0,8.0,10.0,8.0,13.0,8.0,8.0,12.0,11.0,13.0,16.0,17.0,15.0,17.0,13.0,20.0,18.0,15.0,7.0,18.0,17.0,12.0,11.0,12.0,12.0,12.0,15.0,12.0,14.0,9.0,9.0,10.0,6.0,15.0,Cristiano,ÃÂÃÂ£1.80m ,Liga NOS
19/6/2011,CarlÃÂ£o,2102133,1651,1/19/1986,25,0,0,0,0,4400,5524,5524,135,121,337676,182,73,D/DM C,3,1,1,2,2,2,3,1,1,3,3,10,12,9,6,11,12,14,11,9,13,10,10,14,11,15,14,16,10,12,9,11,13,11,7,7,11,14,15,14,12,14,11,20,13,12,8,15,14,11,15,13,13,15,7,14,13,15,14,10,10,8,20,14,10,1,1,14,20,D/DM C,111,1,1,1,1,1,1,20,14,1,17,10,1,1,14,1,0.0,0,0,0,0,0,0,0,0,0,0,0,0,0,0,0,0,0,0,0,0,0,0,0,0,0,0,0,0,0,0,0,0,0,0,0,0,0,0,0,0,0,0,0,0,0,0,0,0,CarlÃÂ£o,ÃÂ£1.80m ,34.0,183.0,Defender - Centre-Back,left,Paysandu Sport Club,27.0,1.0,0.0,1945.0,23.0,0.0,0.0,1603.0,17.0,0.0,0.0,1114.0,29.0,1.0,2.0,2420.0,30.0,0.0,0.0,2433.0,36.0,3.0,0.0,2994.0,31.0,0.0,1.0,2636.0,28.0,1.0,1.0,2205.0,30.0,1.0,0.0,2549.0,Ligue 1,1.0,0.0,0.0,90.0,nan,nan,nan,nan,29/6/2010,CarlÃÂ£o,2102133.0,1651.0,1/19/1986,24.0,0.0,0.0,0.0,0.0,1050.0,5500.0,5500.0,140.0,123.0,2513011.0,182.0,73.0,DM C,1.0,2.0,3.0,1.0,1.0,1.0,2.0,4.0,1.0,1.0,3.0,10.0,12.0,9.0,6.0,11.0,12.0,14.0,11.0,9.0,13.0,10.0,10.0,14.0,11.0,15.0,14.0,16.0,12.0,12.0,9.0,12.0,13.0,11.0,7.0,7.0,11.0,14.0,17.0,14.0,12.0,14.0,11.0,20.0,13.0,12.0,8.0,15.0,14.0,13.0,15.0,13.0,11.0,15.0,7.0,14.0,13.0,15.0,14.0,10.0,10.0,8.0,Carlao,ÃÂÃÂ£1.44m ,Liga NOS
19/6/2011,Beg Ferati,69001402,798,1/1/1986,25,0,0,12,1,3750,5500,6000,131,120,419452,188,80,D C,2,1,1,1,2,3,3,4,2,2,3,5,5,8,7,9,7,14,7,10,13,11,8,14,7,13,10,11,11,11,4,13,11,7,7,5,13,11,12,15,9,13,12,8,15,14,20,14,15,12,11,11,5,9,6,12,12,11,10,10,8,13,20,1,1,1,1,1,20,D C,101,1,1,1,1,1,1,20,1,1,8,1,1,1,1,1,0.0,0,0,0,0,0,0,0,0,0,0,0,0,0,0,0,0,0,0,0,0,0,0,0,0,0,0,0,0,0,0,0,0,0,0,0,0,0,0,0,0,0,0,0,0,0,0,0,0,Beg Ferati,ÃÂ£720Th. ,33.0,188.0,Defender - Centre-Back,right,FC Pratteln,26.0,0.0,1.0,2236.0,7.0,0.0,0.0,383.0,18.0,2.0,0.0,1575.0,34.0,0.0,0.0,3003.0,8.0,0.0,0.0,599.0,15.0,0.0,0.0,1214.0,2.0,0.0,0.0,137.0,1.0,0.0,0.0,90.0,nan,nan,nan,nan,Bundesliga,nan,nan,nan,nan,nan,nan,nan,nan,nan,nan,nan,nan,nan,nan,nan,nan,nan,nan,nan,nan,nan,nan,nan,nan,nan,nan,nan,nan,nan,nan,nan,nan,nan,nan,nan,nan,nan,nan,nan,nan,nan,nan,nan,nan,nan,nan,nan,nan,nan,nan,nan,nan,nan,nan,nan,nan,nan,nan,nan,nan,nan,nan,nan,nan,nan,nan,nan,nan,nan,nan,nan,nan,nan,nan,nan,nan,nan,nan,nan,nan,nan,nan,nan,nan,nan,nan,nan,nan,nan,nan,nan,nan
19/6/2011,AurÃÂ©lien Chedjou,8439083,11,6/20/1985,25,17,0,4,0,5900,7250,6583,150,145,887870,184,86,D/DM C,1,1,3,1,3,2,1,3,2,3,2,10,9,11,6,13,10,15,13,6,15,12,10,14,13,14,17,14,13,14,11,13,15,8,12,8,16,13,15,15,12,17,12,8,14,13,20,15,16,15,14,14,7,14,11,14,13,14,15,14,14,5,20,1,14,12,1,10,20,D/DM C,111,1,1,1,12,10,1,20,1,1,16,14,10,1,1,1,512.0,0,0,0,0,0,0,0,0,0,1,0,0,0,0,0,0,0,0,0,0,0,0,0,0,0,0,0,0,0,0,0,0,0,0,0,0,0,0,0,0,0,0,0,0,0,0,0,0,Aurelien Chedjou,ÃÂ£9.00m ,35.0,184.0,Defender - Centre-Back,right,Adana Demirspor,49.0,4.0,0.0,3862.0,36.0,4.0,1.0,3184.0,46.0,4.0,1.0,4155.0,33.0,4.0,0.0,2828.0,35.0,4.0,2.0,3149.0,31.0,3.0,3.0,2482.0,20.0,1.0,1.0,1707.0,1.0,0.0,0.0,53.0,26.0,1.0,0.0,2324.0,Ligue 1,28.0,0.0,0.0,2354.0,2.0,0.0,0.0,180.0,29/6/2010,AurÃÂ©lien Chedjou,8439083.0,11.0,6/20/1985,25.0,10.0,0.0,4.0,0.0,4970.0,7050.0,6350.0,150.0,141.0,5142818.0,184.0,84.0,D/DM C,2.0,3.0,1.0,3.0,2.0,3.0,3.0,4.0,2.0,1.0,3.0,10.0,9.0,11.0,7.0,13.0,10.0,15.0,13.0,6.0,15.0,13.0,10.0,13.0,13.0,14.0,16.0,14.0,13.0,13.0,12.0,12.0,15.0,8.0,12.0,8.0,15.0,13.0,15.0,15.0,12.0,16.0,12.0,8.0,14.0,13.0,20.0,14.0,16.0,15.0,14.0,14.0,7.0,14.0,11.0,14.0,13.0,14.0,15.0,14.0,14.0,5.0,Aurelien Chedjou,ÃÂÃÂ£7.20m ,Ligue 1
19/6/2011,Andrea Masiello,7984549,776,2/5/1986,25,0,0,0,0,3500,7425,7500,150,135,480317,185,75,D RC,2,2,1,3,2,1,1,6,2,2,2,3,8,7,5,8,5,15,5,3,15,10,4,16,8,13,16,15,14,13,8,14,16,5,16,8,16,14,13,13,13,14,13,5,14,13,20,16,15,14,8,14,7,10,14,16,16,15,16,17,16,3,20,1,1,1,18,9,20,D RC,103,1,13,1,1,1,1,20,9,18,1,1,1,1,1,1,0.0,0,0,0,0,0,0,0,0,0,0,0,0,0,0,0,0,0,0,0,0,0,0,0,0,0,0,0,0,0,0,0,0,0,0,0,0,0,0,0,0,0,0,0,0,0,0,0,0,Andrea Masiello,ÃÂ£1.80m ,34.0,184.0,Defender - Centre-Back,right,Genoa CFC,39.0,2.0,0.0,3355.0,18.0,1.0,1.0,1539.0,nan,nan,nan,nan,nan,nan,nan,nan,14.0,0.0,0.0,1106.0,31.0,0.0,1.0,2578.0,38.0,3.0,0.0,3137.0,41.0,5.0,0.0,3565.0,33.0,1.0,3.0,2593.0,Serie A,27.0,0.0,1.0,2149.0,2.0,0.0,0.0,180.0,29/6/2010,Andrea Masiello,7984549.0,776.0,2/5/1986,24.0,0.0,0.0,0.0,0.0,3500.0,6650.0,6650.0,156.0,141.0,4286859.0,185.0,75.0,D RC,1.0,2.0,2.0,1.0,1.0,1.0,2.0,5.0,3.0,2.0,2.0,3.0,8.0,7.0,5.0,10.0,5.0,15.0,5.0,3.0,16.0,10.0,4.0,16.0,10.0,13.0,16.0,15.0,14.0,13.0,8.0,14.0,14.0,12.0,16.0,8.0,16.0,14.0,13.0,13.0,13.0,14.0,13.0,6.0,14.0,13.0,20.0,16.0,15.0,14.0,8.0,14.0,7.0,10.0,14.0,16.0,16.0,3.0,16.0,14.0,11.0,3.0,Andrea Masiello,ÃÂÃÂ£2.70m ,Serie A,19-06-17,18.3.4.28,Andrea Masiello,7984549,776,05-Feb-86,31,0,0,0,0,4000,6550,6900,138,138,232186002,184,82,D RC,2,1,1,3,3,2,3,4,2,3,3,3,8,7,6,11,4,14,7,7,15,10,4,14,11,13,16,13,14,15,7,14,16,5,12,7,15,14,13,13,14,13,12,10,14,13,20,13,14,14,8,14,7,10,13,15,13,15,15,13,16,7,20,10,1,1,18,1,20,D RC,103,1,13,1,1,1,1,20,1,18,1,1,1,1,1,10,32768.0,0,0,0,0,0,0,0,0,0,0,0,0,0,0,0,1,0,0,0,0,0,0,0,0,0,0,0,0,0,0,0,0,0,0,0,0,0,0,0,0,0,0,0,0,0,0,0,0,Andrea Masiello,ÃÂ£2.70m ,34.0,184.0,Defender - Centre-Back,right,Genoa CFC,38.0,3.0,0.0,3137.0,41.0,5.0,0.0,3565.0,33.0,1.0,3.0,2593.0,27.0,0.0,1.0,2149.0,2.0,0.0,0.0,180.0,Serie A,15-07-16,17.3.2.23,Andrea Masiello,7984549.0,776.0,05-Feb-86,30.0,0.0,0.0,0.0,0.0,3500.0,6500.0,6650.0,135.0,134.0,232186002.0,185.0,79.0,D RC,3.0,1.0,1.0,1.0,1.0,1.0,2.0,1.0,3.0,1.0,2.0,3.0,8.0,7.0,4.0,11.0,4.0,13.0,7.0,7.0,15.0,10.0,4.0,14.0,11.0,13.0,15.0,13.0,14.0,15.0,7.0,13.0,16.0,5.0,12.0,7.0,15.0,13.0,13.0,13.0,14.0,13.0,12.0,9.0,14.0,13.0,20.0,13.0,14.0,14.0,8.0,14.0,7.0,10.0,18.0,15.0,4.0,15.0,15.0,13.0,16.0,7.0,Andrea Masiello,ÃÂ£2.25m ,Serie A
19/6/2011,Andrea Esposito,837132,776,5/17/1986,25,0,0,0,0,2500,6100,6100,135,122,279536,187,78,D C,1,1,1,1,1,1,1,1,1,1,1,7,7,7,7,9,2,15,7,2,11,9,7,13,9,13,13,15,13,14,6,14,13,6,6,10,13,15,16,13,12,10,16,20,17,13,5,16,11,11,10,9,5,7,14,19,16,10,9,12,17,1,20,1,1,1,12,1,20,D C,101,1,1,1,1,1,1,20,1,12,1,1,1,1,1,1,0.0,0,0,0,0,0,0,0,0,0,0,0,0,0,0,0,0,0,0,0,0,0,0,0,0,0,0,0,0,0,0,0,0,0,0,0,0,0,0,0,0,0,0,0,0,0,0,0,0,Andrea Esposito,ÃÂ£810Th. ,34.0,191.0,Defender - Centre-Back,right,Latina Calcio 1932,13.0,0.0,0.0,976.0,27.0,1.0,0.0,1960.0,29.0,1.0,0.0,2203.0,40.0,0.0,1.0,3344.0,7.0,0.0,0.0,570.0,24.0,1.0,0.0,1727.0,36.0,1.0,0.0,3084.0,27.0,0.0,2.0,2001.0,23.0,1.0,0.0,1329.0,Serie A,22.0,1.0,1.0,1569.0,5.0,1.0,0.0,450.0,29/6/2010,Andrea Esposito,837132.0,776.0,5/17/1986,24.0,0.0,0.0,0.0,0.0,2500.0,6000.0,6000.0,151.0,130.0,1943793.0,187.0,78.0,D C,1.0,1.0,1.0,1.0,1.0,1.0,1.0,1.0,1.0,1.0,1.0,8.0,8.0,8.0,8.0,10.0,3.0,16.0,8.0,2.0,15.0,10.0,8.0,14.0,10.0,13.0,13.0,15.0,13.0,14.0,6.0,14.0,13.0,6.0,6.0,10.0,13.0,15.0,16.0,13.0,12.0,10.0,16.0,20.0,17.0,13.0,5.0,16.0,11.0,11.0,10.0,9.0,5.0,8.0,14.0,19.0,16.0,10.0,9.0,12.0,17.0,1.0,Andrea Esposito,ÃÂÃÂ£990Th. ,Serie A
19/6/2011,Alexis,7444671,796,8/4/1985,25,0,0,3,0,5000,6900,6900,154,140,1625884,183,75,D C,1,1,3,2,1,1,3,7,2,2,1,7,8,8,7,13,6,16,8,9,14,13,9,15,13,15,16,15,12,10,11,10,11,7,9,10,14,14,16,14,13,15,13,13,11,13,20,15,13,13,13,14,14,13,8,11,10,9,9,14,8,9,20,3,5,1,12,13,20,D C,101,1,12,1,1,1,1,20,13,12,10,5,1,1,3,2,137439000000.0,0,0,0,0,0,0,0,0,0,0,0,0,0,0,0,0,0,0,0,0,0,0,0,0,0,0,0,0,0,0,0,0,0,0,0,0,0,1,0,0,0,0,0,0,0,0,0,0,Alex,ÃÂ£7.65m ,38.0,188.0,Defender - Centre-Back,right,Retired,20.0,2.0,1.0,1504.0,25.0,2.0,0.0,1932.0,34.0,4.0,1.0,2943.0,42.0,3.0,0.0,3550.0,23.0,1.0,0.0,1578.0,25.0,3.0,1.0,2093.0,nan,nan,nan,nan,nan,nan,nan,nan,nan,nan,nan,nan,Premier League,nan,nan,nan,nan,nan,nan,nan,nan,29/6/2010,Alexis,7444671.0,796.0,8/4/1985,24.0,0.0,0.0,3.0,0.0,5184.0,7150.0,7150.0,154.0,144.0,144492258.0,183.0,75.0,D C,2.0,3.0,3.0,1.0,1.0,2.0,2.0,2.0,3.0,3.0,1.0,7.0,8.0,8.0,6.0,13.0,6.0,16.0,8.0,9.0,14.0,13.0,9.0,16.0,13.0,13.0,17.0,15.0,14.0,13.0,12.0,15.0,14.0,7.0,10.0,9.0,16.0,15.0,16.0,11.0,12.0,15.0,13.0,9.0,11.0,12.0,20.0,15.0,12.0,14.0,13.0,14.0,14.0,12.0,8.0,14.0,14.0,12.0,12.0,15.0,10.0,6.0,Alex,ÃÂÃÂ£14.40m ,Premier League,19-06-17,18.3.4.28,Alexis,7444671,796,04-Aug-85,31,0,0,3,0,5750,6750,6750,140,135,232186002,183,75,D C,1,1,4,3,1,2,2,2,1,2,3,7,7,8,6,12,6,16,8,9,14,11,9,16,12,15,15,15,13,12,10,12,10,7,9,10,14,15,14,13,12,14,14,13,11,13,20,12,12,12,15,14,12,14,8,10,10,9,9,9,7,12,20,3,1,1,12,13,20,D C,101,1,12,1,1,1,1,20,13,12,8,1,1,1,3,2,137439000000.0,0,0,0,0,0,0,0,0,0,0,0,0,0,0,0,0,0,0,0,0,0,0,0,0,0,0,0,0,0,0,0,0,0,0,0,0,0,1,0,0,0,0,0,0,0,0,0,0,nan,nan,nan,nan,nan,nan,nan,nan,nan,nan,nan,nan,nan,nan,nan,nan,nan,nan,nan,nan,nan,nan,nan,nan,nan,nan,nan,nan,15-07-16,17.3.2.23,Alexis,7444671.0,796.0,04-Aug-85,30.0,0.0,0.0,3.0,0.0,5750.0,6750.0,6750.0,140.0,135.0,232186002.0,183.0,75.0,D C,2.0,2.0,3.0,3.0,3.0,3.0,2.0,2.0,2.0,1.0,4.0,7.0,7.0,8.0,6.0,12.0,6.0,16.0,8.0,9.0,14.0,11.0,9.0,16.0,12.0,15.0,15.0,15.0,13.0,12.0,10.0,12.0,10.0,7.0,9.0,10.0,14.0,15.0,14.0,13.0,12.0,14.0,14.0,13.0,11.0,13.0,20.0,12.0,12.0,12.0,15.0,14.0,12.0,14.0,8.0,10.0,10.0,9.0,9.0,9.0,7.0,12.0,Alex,ÃÂ£540Th. ,Liga NOS
19/6/2011,Ahmed Kantari,8430573,34,6/28/1985,25,4,0,6,0,5100,6300,5650,138,126,744769,185,80,D C,2,1,1,2,1,3,2,1,1,1,3,4,7,7,6,9,6,15,9,5,14,8,7,14,9,14,15,16,12,13,8,12,16,6,12,6,14,14,14,12,11,15,13,20,14,11,5,16,15,14,14,15,8,8,9,13,15,14,15,13,13,6,20,1,1,1,1,12,20,D C,101,1,1,5,1,1,1,20,12,1,8,1,1,1,1,1,137439000000.0,0,0,0,0,0,0,0,0,0,0,0,0,0,0,0,1,0,0,0,0,0,0,0,0,0,0,0,0,0,0,0,0,0,0,0,0,0,1,0,0,0,0,0,0,0,0,0,0,Ahmed Kantari,ÃÂ£1.58m ,35.0,185.0,Defender - Centre-Back,left,Retired,34.0,0.0,0.0,3046.0,12.0,0.0,0.0,917.0,30.0,1.0,0.0,2605.0,30.0,1.0,0.0,2675.0,46.0,1.0,0.0,3942.0,nan,nan,nan,nan,27.0,0.0,2.0,2296.0,nan,nan,nan,nan,14.0,0.0,0.0,1192.0,Ligue 1,nan,nan,nan,nan,nan,nan,nan,nan,29/6/2010,Ahmed Kantari,8430573.0,34.0,6/28/1985,25.0,1.0,0.0,0.0,0.0,2700.0,5714.0,4150.0,138.0,127.0,2305797.0,185.0,80.0,D C,1.0,3.0,1.0,3.0,2.0,1.0,1.0,7.0,3.0,2.0,3.0,5.0,7.0,7.0,6.0,9.0,6.0,14.0,10.0,5.0,14.0,9.0,7.0,14.0,9.0,14.0,15.0,16.0,14.0,14.0,8.0,13.0,16.0,6.0,11.0,6.0,14.0,14.0,14.0,12.0,9.0,15.0,13.0,20.0,14.0,11.0,5.0,16.0,15.0,14.0,14.0,15.0,7.0,8.0,7.0,13.0,15.0,14.0,15.0,13.0,13.0,6.0,Ahmed Kantari,ÃÂÃÂ£2.25m ,Ligue 1
19/6/2011,Adil Rami,34004844,769,12/27/1985,25,11,0,0,0,6100,7550,6950,165,151,4868674,190,87,D C,1,2,3,2,1,3,3,5,1,2,1,5,7,9,8,9,11,17,11,8,16,12,6,15,11,16,16,17,12,10,7,13,18,9,14,9,14,15,16,14,13,18,15,8,16,13,20,16,18,16,15,14,8,12,10,16,12,15,12,13,13,10,20,10,10,1,10,1,20,D C,101,5,1,1,1,1,1,20,1,10,12,10,1,1,1,10,8864810000000.0,0,0,0,0,0,1,0,0,1,0,0,0,0,0,0,0,0,0,0,0,0,0,0,0,0,0,0,0,0,0,0,0,0,0,0,0,1,0,0,0,0,0,0,1,0,0,0,0,Adil Rami,ÃÂ£12.60m ,34.0,191.0,Defender - Centre-Back,right,Boavista FC,47.0,0.0,4.0,4183.0,53.0,6.0,2.0,4745.0,36.0,2.0,2.0,3067.0,26.0,3.0,2.0,2124.0,22.0,1.0,1.0,1754.0,46.0,3.0,1.0,4124.0,33.0,0.0,0.0,2845.0,54.0,2.0,2.0,4814.0,21.0,1.0,1.0,1800.0,LaLiga,7.0,0.0,0.0,556.0,3.0,0.0,0.0,186.0,29/6/2010,Adil Rami,34004844.0,769.0,12/27/1985,24.0,0.0,0.0,0.0,0.0,5450.0,6850.0,6850.0,165.0,152.0,5944989.0,190.0,90.0,D C,3.0,2.0,3.0,3.0,3.0,3.0,2.0,5.0,3.0,1.0,1.0,5.0,7.0,7.0,9.0,9.0,11.0,17.0,12.0,8.0,16.0,10.0,6.0,14.0,9.0,15.0,16.0,17.0,12.0,13.0,7.0,13.0,18.0,6.0,12.0,8.0,15.0,15.0,16.0,14.0,12.0,18.0,15.0,8.0,16.0,13.0,20.0,16.0,18.0,15.0,15.0,15.0,8.0,12.0,6.0,15.0,11.0,15.0,14.0,12.0,12.0,7.0,Adil Rami,ÃÂÃÂ£10.80m ,Ligue 1,19-06-17,18.3.4.28,Adil Rami,34004844,769,27-Dec-85,31,33,1,0,0,5750,7150,7150,154,143,232186002,190,88,D C,2,3,2,3,2,3,2,1,3,1,2,5,7,9,8,10,7,16,11,9,15,13,5,16,12,17,15,17,13,13,11,12,16,7,10,10,14,15,16,11,12,16,16,8,15,13,20,15,16,13,15,14,10,12,14,15,12,14,12,13,11,15,20,1,1,1,7,1,20,D C,101,1,1,1,1,1,1,20,1,7,5,1,1,1,1,1,1.15293e+18,0,0,0,0,0,0,0,0,0,0,0,0,0,0,0,0,0,0,0,0,0,0,0,0,0,0,0,0,0,0,0,0,0,0,0,0,0,0,0,0,0,0,0,1,0,0,0,0,Adil Rami,ÃÂ£6.30m ,34.0,191.0,Defender - Centre-Back,right,Boavista FC,33.0,0.0,0.0,2845.0,54.0,2.0,2.0,4814.0,21.0,1.0,1.0,1800.0,7.0,0.0,0.0,556.0,3.0,0.0,0.0,186.0,Ligue 1,15-07-16,17.3.2.23,Adil Rami,34004844.0,769.0,27-Dec-85,30.0,32.0,1.0,0.0,0.0,6750.0,7250.0,7500.0,154.0,153.0,232186002.0,190.0,88.0,D C,1.0,3.0,1.0,2.0,2.0,2.0,3.0,1.0,3.0,3.0,1.0,5.0,7.0,9.0,8.0,10.0,7.0,16.0,11.0,9.0,15.0,13.0,5.0,16.0,12.0,17.0,16.0,17.0,13.0,13.0,11.0,12.0,16.0,7.0,14.0,10.0,14.0,15.0,15.0,14.0,12.0,17.0,16.0,9.0,15.0,14.0,20.0,16.0,18.0,15.0,15.0,14.0,10.0,12.0,14.0,15.0,12.0,14.0,12.0,13.0,11.0,15.0,Adil Rami,ÃÂ£4.50m ,LaLiga
