GameDate_2012,Name_2012,UID_2012,NationID_2012,Born_2012,Age_2012,IntCaps_2012,IntGoals_2012,U21Caps_2012,U21Goals_2012,WorldReputation_2012,HomeReputation_2012,CurrentReputation_2012,PA_2012,CA_2012,Price_2012,Height_2012,Weight_2012,PositionsString_2012,GK.AerialAbility_2012,GK.CommandOfArea_2012,GK.Communication_2012,GK.Eccentricity_2012,GK.Handling_2012,GK.Kicking_2012,GK.OneOnOnes_2012,GK.Reflexes_2012,GK.RushingOut_2012,GK.TendencyToPunch_2012,GK.Throwing_2012,Tech.Corners_2012,Tech.Crossing_2012,Tech.Dribbling_2012,Tech.Finishing_2012,Tech.FirstTouch_2012, Tech.Freekicks_2012,Tech.Heading_2012,Tech.LongShots_2012,Tech.Longthrows_2012,Tech.Marking_2012,Tech.Passing_2012,Tech.PenaltyTaking_2012, Tech.Tackling_2012,Tech.Technique_2012,Mental.Aggression_2012,Mental.Anticipation_2012,Mental.Bravery_2012,Mental.Composure_2012,Mental.Concentration_2012,Mental.Vision_2012,Mental.Decisions_2012,Mental.Determination_2012,Mental.Flair_2012,Mental.Leadership_2012, Mental.OffTheBall_2012,Mental.Positioning_2012,Mental.Teamwork_2012,Mental.Workrate_2012,Phy.Acceleration_2012,Phy.Agility_2012,Phy.Balance_2012,Phy.Jumping_2012,Phy.LeftFoot_2012,Phy.NaturalFitness_2012,Phy.Pace_2012,Phy.RightFoot_2012,Phy.Stamina_2012,Phy.Strength_2012, Hidden.Consistency_2012,Hidden.Dirtiness_2012,Hidden.ImportantMatches_2012,Hidden.InjuryProness_2012,Hidden.Versatility_2012,Personality.Adaptability_2012,Personality.Ambition_2012,Personality.Loyalty_2012,Personality.Pressure_2012,Personality.Professional_2012,Personality.Sportsmanship_2012,Personality.Temperament_2012,Personality.Controversy_2012,Positions.Defender_2012,Positions.WingBack_2012,Positions.Midfielder_2012,Positions.AttackingMidfielder_2012,Positions.Right_2012,Positions.Left_2012,Positions.Centre_2012,Positions.PositionsDesc_2012,Positions.PositionsDescVal_2012,Positions.Goalkeeper_2012,Positions.Sweeper_2012,Positions.Striker_2012,Positions.AttackingMidCentral_2012,Positions.AttackingMidLeft_2012,Positions.AttackingMidRight_2012,Positions.DefenderCentral_2012,Positions.DefenderLeft_2012, Positions.DefenderRight_2012,Positions.DefensiveMidfielder_2012,Positions.MidfielderCentral_2012,Positions.MidfielderLeft_2012,Positions.MidfielderRight_2012,Positions.WingBackLeft_2012,Positions.WingBackRight_2012,PPMVal_2012,PPM0_2012,PPM1_2012,PPM2_2012,PPM3_2012,PPM4_2012,PPM5_2012,PPM6_2012,PPM7_2012,PPM8_2012,PPM9_2012,PPM10_2012,PPM11_2012,PPM12_2012,PPM13_2012,PPM14_2012,PPM15_2012,PPM16_2012,PPM17_2012,PPM18_2012,PPM19_2012,PPM20_2012,PPM21_2012,PPM22_2012,PPM23_2012,PPM24_2012,PPM25_2012,PPM26_2012,PPM27_2012,PPM28_2012,PPM29_2012,PPM30_2012,PPM31_2012,PPM32_2012,PPM33_2012,PPM34_2012,PPM35_2012,PPM36_2012,PPM37_2012,PPM38_2012,PPM39_2012,PPM40_2012,PPM41_2012,PPM42_2012,PPM43_2012,PPM44_2012,PPM45_2012,PPM46_2012,PPM47_2012,name_2012,Market Value_2012,age_2012,height_2012,position_2012,foot_2012,current club_2012,10/11 games_2012,10/11 goals/conceded_2012,10/11 assists/clean_2012,10/11 minutes_2012,11/12 games_2012,11/12 goals/conceded_2012,11/12 assists/clean_2012,11/12 minutes_2012,12/13 games_2012,12/13 goals/conceded_2012,12/13 assists/clean_2012,12/13 minutes_2012,13/14 games_2012,13/14 goals/conceded_2012,13/14 assists/clean_2012,13/14 minutes_2012,14/15 games_2012,14/15 goals/conceded_2012,14/15 assists/clean_2012,14/15 minutes_2012,15/16 games_2012,15/16 goals/conceded_2012,15/16 assists/clean_2012,15/16 minutes_2012,16/17 games_2012,16/17 goals/conceded_2012,16/17 assists/clean_2012,16/17 minutes_2012,17/18 games_2012,17/18 goals/conceded_2012,17/18 assists/clean_2012,17/18 minutes_2012,18/19 games_2012,18/19 goals/conceded_2012,18/19 assists/clean_2012,18/19 minutes_2012,current league_2012,19/20 games_2012,19/20 goals/conceded_2012,19/20 assists/clean_2012,19/20 minutes_2012,20/21 games_2012,20/21 goals/conceded_2012,20/21 assists/clean_2012,20/21 minutes_2012,GameDate_2011,Name_2011,UID_2011,NationID_2011,Born_2011,Age_2011,IntCaps_2011,IntGoals_2011,U21Caps_2011,U21Goals_2011,WorldReputation_2011,HomeReputation_2011,CurrentReputation_2011,PA_2011,CA_2011,Price_2011,Height_2011,Weight_2011,PositionsString_2011,GK.AerialAbility_2011,GK.CommandOfArea_2011,GK.Communication_2011,GK.Eccentricity_2011,GK.Handling_2011,GK.Kicking_2011,GK.OneOnOnes_2011,GK.Reflexes_2011,GK.RushingOut_2011,GK.TendencyToPunch_2011,GK.Throwing_2011,Tech.Corners_2011,Tech.Crossing_2011,Tech.Dribbling_2011,Tech.Finishing_2011,Tech.FirstTouch_2011,Tech.Freekicks_2011,Tech.Heading_2011,Tech.LongShots_2011,Tech.Longthrows_2011,Tech.Marking_2011,Tech.Passing_2011,Tech.PenaltyTaking_2011,Tech.Tackling_2011,Tech.Technique_2011,Mental.Aggression_2011,Mental.Anticipation_2011,Mental.Bravery_2011,Mental.Composure_2011,Mental.Concentration_2011,Mental.Vision_2011,Mental.Decisions_2011,Mental.Determination_2011,Mental.Flair_2011,Mental.Leadership_2011,Mental.OffTheBall_2011,Mental.Positioning_2011,Mental.Teamwork_2011,Mental.Workrate_2011,Phy.Acceleration_2011,Phy.Agility_2011,Phy.Balance_2011,Phy.Jumping_2011,Phy.LeftFoot_2011,Phy.NaturalFitness_2011,Phy.Pace_2011,Phy.RightFoot_2011,Phy.Stamina_2011,Phy.Strength_2011,Hidden.Consistency_2011,Hidden.Dirtiness_2011,Hidden.ImportantMatches_2011,Hidden.InjuryProness_2011,Hidden.Versatility_2011,Personality.Adaptability_2011,Personality.Ambition_2011,Personality.Loyalty_2011,Personality.Pressure_2011,Personality.Professional_2011,Personality.Sportsmanship_2011,Personality.Temperament_2011,Personality.Controversy_2011,name_2011,Market Value_2011,current league_2011,GameDate_2018,FMRTEVersion_2018,Name_2018,UID_2018,NationID_2018,Born_2018,Age_2018,IntCaps_2018,IntGoals_2018,U21Caps_2018,U21Goals_2018,WorldReputation_2018,HomeReputation_2018,CurrentReputation_2018,PA_2018,CA_2018,Price_2018,Height_2018,Weight_2018,PositionsString_2018,GK.AerialAbility_2018,GK.CommandOfArea_2018,GK.Communication_2018,GK.Eccentricity_2018,GK.Handling_2018,GK.Kicking_2018,GK.OneOnOnes_2018,GK.Reflexes_2018,GK.RushingOut_2018,GK.TendencyToPunch_2018,GK.Throwing_2018,Tech.Corners_2018,Tech.Crossing_2018,Tech.Dribbling_2018,Tech.Finishing_2018,Tech.FirstTouch_2018,Tech.Freekicks_2018,Tech.Heading_2018,Tech.LongShots_2018,Tech.Longthrows_2018,Tech.Marking_2018,Tech.Passing_2018,Tech.PenaltyTaking_2018,Tech.Tackling_2018,Tech.Technique_2018,Mental.Aggression_2018,Mental.Anticipation_2018,Mental.Bravery_2018,Mental.Composure_2018,Mental.Concentration_2018,Mental.Vision_2018,Mental.Decisions_2018,Mental.Determination_2018,Mental.Flair_2018,Mental.Leadership_2018,Mental.OffTheBall_2018,Mental.Positioning_2018,Mental.Teamwork_2018,Mental.Workrate_2018,Phy.Acceleration_2018,Phy.Agility_2018,Phy.Balance_2018,Phy.Jumping_2018,Phy.LeftFoot_2018,Phy.NaturalFitness_2018,Phy.Pace_2018,Phy.RightFoot_2018,Phy.Stamina_2018,Phy.Strength_2018,Hidden.Consistency_2018,Hidden.Dirtiness_2018,Hidden.ImportantMatches_2018,Hidden.InjuryProness_2018,Hidden.Versatility_2018,Personality.Adaptability_2018,Personality.Ambition_2018,Personality.Loyalty_2018,Personality.Pressure_2018,Personality.Professional_2018,Personality.Sportsmanship_2018,Personality.Temperament_2018,Personality.Controversy_2018,Positions.Defender_2018,Positions.WingBack_2018,Positions.Midfielder_2018,Positions.AttackingMidfielder_2018,Positions.Right_2018,Positions.Left_2018,Positions.Centre_2018,Positions.PositionsDesc_2018,Positions.PositionsDescVal_2018,Positions.Goalkeeper_2018,Positions.Sweeper_2018,Positions.Striker_2018,Positions.AttackingMidCentral_2018,Positions.AttackingMidLeft_2018,Positions.AttackingMidRight_2018,Positions.DefenderCentral_2018,Positions.DefenderLeft_2018,Positions.DefenderRight_2018,Positions.DefensiveMidfielder_2018,Positions.MidfielderCentral_2018,Positions.MidfielderLeft_2018,Positions.MidfielderRight_2018,Positions.WingBackLeft_2018,Positions.WingBackRight_2018,PPMVal_2018,PPM0_2018,PPM1_2018,PPM2_2018,PPM3_2018,PPM4_2018,PPM5_2018,PPM6_2018,PPM7_2018,PPM8_2018,PPM9_2018,PPM10_2018,PPM11_2018,PPM12_2018,PPM13_2018,PPM14_2018,PPM15_2018,PPM16_2018,PPM17_2018,PPM18_2018,PPM19_2018,PPM20_2018,PPM21_2018,PPM22_2018,PPM23_2018,PPM24_2018,PPM25_2018,PPM26_2018,PPM27_2018,PPM28_2018,PPM29_2018,PPM30_2018,PPM31_2018,PPM32_2018,PPM33_2018,PPM34_2018,PPM35_2018,PPM36_2018,PPM37_2018,PPM38_2018,PPM39_2018,PPM40_2018,PPM41_2018,PPM42_2018,PPM43_2018,PPM44_2018,PPM45_2018,PPM46_2018,PPM47_2018,name_2018,Market Value_2018,age_2018,height_2018,position_2018,foot_2018,current club_2018,16/17 games_2018,16/17 goals/conceded_2018,16/17 assists/clean_2018,16/17 minutes_2018,17/18 games_2018,17/18 goals/conceded_2018,17/18 assists/clean_2018,17/18 minutes_2018,18/19 games_2018,18/19 goals/conceded_2018,18/19 assists/clean_2018,18/19 minutes_2018,19/20 games_2018,19/20 goals/conceded_2018,19/20 assists/clean_2018,19/20 minutes_2018,20/21 games_2018,20/21 goals/conceded_2018,20/21 assists/clean_2018,20/21 minutes_2018,current league_2018,GameDate_2017,FMRTEVersion_2017,Name_2017,UID_2017,NationID_2017,Born_2017,Age_2017,IntCaps_2017,IntGoals_2017,U21Caps_2017,U21Goals_2017,WorldReputation_2017,HomeReputation_2017,CurrentReputation_2017,PA_2017,CA_2017,Price_2017,Height_2017,Weight_2017,PositionsString_2017,GK.AerialAbility_2017,GK.CommandOfArea_2017,GK.Communication_2017,GK.Eccentricity_2017,GK.Handling_2017,GK.Kicking_2017,GK.OneOnOnes_2017,GK.Reflexes_2017,GK.RushingOut_2017,GK.TendencyToPunch_2017,GK.Throwing_2017,Tech.Corners_2017,Tech.Crossing_2017,Tech.Dribbling_2017,Tech.Finishing_2017,Tech.FirstTouch_2017,Tech.Freekicks_2017,Tech.Heading_2017,Tech.LongShots_2017,Tech.Longthrows_2017,Tech.Marking_2017,Tech.Passing_2017,Tech.PenaltyTaking_2017,Tech.Tackling_2017,Tech.Technique_2017,Mental.Aggression_2017,Mental.Anticipation_2017,Mental.Bravery_2017,Mental.Composure_2017,Mental.Concentration_2017,Mental.Vision_2017,Mental.Decisions_2017,Mental.Determination_2017,Mental.Flair_2017,Mental.Leadership_2017,Mental.OffTheBall_2017,Mental.Positioning_2017,Mental.Teamwork_2017,Mental.Workrate_2017,Phy.Acceleration_2017,Phy.Agility_2017,Phy.Balance_2017,Phy.Jumping_2017,Phy.LeftFoot_2017,Phy.NaturalFitness_2017,Phy.Pace_2017,Phy.RightFoot_2017,Phy.Stamina_2017,Phy.Strength_2017,Hidden.Consistency_2017,Hidden.Dirtiness_2017,Hidden.ImportantMatches_2017,Hidden.InjuryProness_2017,Hidden.Versatility_2017,Personality.Adaptability_2017,Personality.Ambition_2017,Personality.Loyalty_2017,Personality.Pressure_2017,Personality.Professional_2017,Personality.Sportsmanship_2017,Personality.Temperament_2017,Personality.Controversy_2017,name_2017,Market Value_2017,current league_2017
19/6/2011,Ross Barkley,28058224,765,12/5/1993,17,0,0,0,0,3000,5750,5750,163,109,3549579,189,77,M C,2,3,1,2,2,2,1,7,3,1,3,4,7,10,8,11,3,11,12,1,10,12,4,10,12,17,9,10,11,9,12,9,14,5,9,11,8,10,13,12,10,10,11,14,13,12,20,15,12,15,3,14,6,8,7,15,15,12,14,11,9,9,1,1,20,13,14,13,20,M C,401,1,1,1,13,10,12,1,1,1,13,20,13,14,1,1,277026000000.0,0,0,0,0,0,0,1,1,0,0,0,0,0,0,0,0,0,0,0,1,0,0,0,0,0,0,0,0,0,0,0,1,0,0,0,0,0,0,1,0,0,0,0,0,0,0,0,0,Ross Barkley,ÃÂ£4.05m ,26.0,185.0,Midfielder - Central Midfield,right,Aston Villa,3.0,1.0,0.0,270.0,23.0,3.0,5.0,1644.0,37.0,7.0,1.0,2658.0,38.0,7.0,3.0,2617.0,36.0,2.0,3.0,2481.0,48.0,12.0,11.0,3914.0,39.0,6.0,9.0,3150.0,5.0,0.0,0.0,271.0,48.0,5.0,6.0,2725.0,Premier League,31.0,5.0,5.0,1700.0,6.0,3.0,0.0,400.0,nan,nan,nan,nan,nan,nan,nan,nan,nan,nan,nan,nan,nan,nan,nan,nan,nan,nan,nan,nan,nan,nan,nan,nan,nan,nan,nan,nan,nan,nan,nan,nan,nan,nan,nan,nan,nan,nan,nan,nan,nan,nan,nan,nan,nan,nan,nan,nan,nan,nan,nan,nan,nan,nan,nan,nan,nan,nan,nan,nan,nan,nan,nan,nan,nan,nan,nan,nan,nan,nan,nan,nan,nan,nan,nan,nan,nan,nan,nan,nan,nan,nan,nan,nan,19-06-17,18.3.4.28,Ross Barkley,28058224,765,05-Dec-93,23,22,2,5,1,5750,7250,7250,159,147,64924983,189,76,M/AM C,3,4,3,3,3,1,3,3,2,3,2,11,12,16,12,16,14,12,15,9,6,15,12,8,16,8,14,11,13,11,14,10,12,14,11,13,10,11,12,15,11,15,11,16,13,14,20,12,18,12,6,10,9,8,5,14,15,13,15,12,13,1,1,1,20,20,13,13,20,M/AM C,411,1,1,1,20,13,13,1,1,1,14,20,1,1,1,1,17596500000000.0,0,0,1,0,0,0,0,0,0,1,0,0,0,0,0,0,0,0,0,0,0,0,0,0,0,0,0,0,0,0,0,0,1,0,0,0,0,0,0,0,0,0,0,0,1,0,0,0,Ross Barkley,ÃÂ£22.50m ,26.0,185.0,Midfielder - Central Midfield,right,Aston Villa,39.0,6.0,9.0,3150.0,5.0,0.0,0.0,271.0,48.0,5.0,6.0,2725.0,31.0,5.0,5.0,1700.0,6.0,3.0,0.0,400.0,Premier League,15-07-16,17.3.2.23,Ross Barkley,28058224.0,765.0,05-Dec-93,22.0,22.0,2.0,5.0,1.0,5746.0,7246.0,7246.0,159.0,145.0,49604086.0,189.0,76.0,M/AM C,3.0,1.0,3.0,1.0,3.0,1.0,1.0,1.0,3.0,2.0,3.0,11.0,12.0,16.0,12.0,16.0,14.0,13.0,14.0,9.0,6.0,15.0,12.0,8.0,15.0,8.0,15.0,11.0,14.0,11.0,14.0,10.0,12.0,14.0,8.0,13.0,8.0,13.0,12.0,15.0,11.0,15.0,11.0,15.0,13.0,14.0,20.0,12.0,18.0,11.0,6.0,10.0,8.0,8.0,5.0,14.0,15.0,13.0,15.0,12.0,13.0,1.0,Ross Barkley,ÃÂ£22.50m ,Premier League
19/6/2011,Pasquale De Vita,43081378,776,3/3/1994,17,0,0,0,0,219,3259,3259,130,69,38313,182,78,DM/M C,2,1,1,1,1,1,3,1,2,1,2,6,8,4,9,13,9,6,9,5,5,13,9,13,13,12,7,2,7,11,10,7,8,4,7,7,10,8,12,13,12,11,7,8,11,12,20,8,4,10,10,10,5,10,7,13,5,13,6,19,6,19,1,1,20,1,1,1,20,DM/M C,311,1,1,1,1,1,1,1,1,1,20,20,1,1,1,1,0.0,0,0,0,0,0,0,0,0,0,0,0,0,0,0,0,0,0,0,0,0,0,0,0,0,0,0,0,0,0,0,0,0,0,0,0,0,0,0,0,0,0,0,0,0,0,0,0,0,nan,nan,nan,nan,nan,nan,nan,nan,nan,nan,nan,nan,nan,nan,nan,nan,nan,nan,nan,nan,nan,nan,nan,nan,nan,nan,nan,nan,nan,nan,nan,nan,nan,nan,nan,nan,nan,nan,nan,nan,nan,nan,nan,nan,nan,nan,nan,nan,nan,nan,nan,nan,nan,nan,nan,nan,nan,nan,nan,nan,nan,nan,nan,nan,nan,nan,nan,nan,nan,nan,nan,nan,nan,nan,nan,nan,nan,nan,nan,nan,nan,nan,nan,nan,nan,nan,nan,nan,nan,nan,nan,nan,nan,nan,nan,nan,nan,nan,nan,nan,nan,nan,nan,nan,nan,nan,nan,nan,nan,nan,nan,nan,nan,nan,nan,nan,nan,nan,nan,nan,nan,nan,nan,nan,nan,nan,nan,nan,nan,nan,nan,nan,nan,nan,nan,nan
19/6/2011,Andrea Barberis,43078258,776,12/11/1993,17,0,0,0,0,50,2600,2600,113,60,22529,184,81,M C,1,1,3,2,2,1,2,1,1,2,3,8,7,2,7,10,8,7,11,1,8,8,3,11,12,14,11,2,9,4,8,11,7,4,1,5,7,10,11,9,12,10,8,8,8,12,20,8,5,10,12,10,5,9,8,10,8,9,7,12,6,10,1,1,20,1,1,1,20,M C,401,1,1,1,1,1,1,1,1,1,15,20,1,1,1,1,0.0,0,0,0,0,0,0,0,0,0,0,0,0,0,0,0,0,0,0,0,0,0,0,0,0,0,0,0,0,0,0,0,0,0,0,0,0,0,0,0,0,0,0,0,0,0,0,0,0,Andrea Barberis,ÃÂ£113Th. ,26.0,177.0,Midfielder - Central Midfield,right,AC Monza,25.0,0.0,0.0,1672.0,25.0,2.0,0.0,2174.0,29.0,3.0,0.0,1430.0,24.0,1.0,2.0,1478.0,27.0,1.0,1.0,1544.0,29.0,1.0,1.0,2456.0,27.0,0.0,3.0,2153.0,39.0,2.0,2.0,3108.0,33.0,2.0,1.0,2813.0,Serie A,39.0,2.0,9.0,3335.0,4.0,0.0,0.0,280.0,nan,nan,nan,nan,nan,nan,nan,nan,nan,nan,nan,nan,nan,nan,nan,nan,nan,nan,nan,nan,nan,nan,nan,nan,nan,nan,nan,nan,nan,nan,nan,nan,nan,nan,nan,nan,nan,nan,nan,nan,nan,nan,nan,nan,nan,nan,nan,nan,nan,nan,nan,nan,nan,nan,nan,nan,nan,nan,nan,nan,nan,nan,nan,nan,nan,nan,nan,nan,nan,nan,nan,nan,nan,nan,nan,nan,nan,nan,nan,nan,nan,nan,nan,nan,19-06-17,18.3.4.28,Andrea Barberis,43078258,776,11-Dec-93,23,0,0,0,0,3000,6000,6000,132,120,5261980,177,72,DM/M C,3,3,1,1,1,1,3,1,3,1,2,6,8,11,7,12,14,8,10,6,11,13,9,12,12,11,13,11,14,13,14,13,18,14,12,10,14,14,12,13,12,13,9,9,16,13,20,14,13,14,8,15,6,10,7,15,15,12,15,15,10,6,1,1,20,1,1,1,20,DM/M C,421,1,1,1,1,1,1,1,1,1,17,20,1,1,1,1,4718720.0,0,0,0,0,0,0,0,1,0,0,0,0,0,0,0,0,0,0,0,1,0,0,1,0,0,0,0,0,0,0,0,0,0,0,0,0,0,0,0,0,0,0,0,0,0,0,0,0,Andrea Barberis,ÃÂ£1.80m ,26.0,177.0,Midfielder - Central Midfield,right,AC Monza,27.0,0.0,3.0,2153.0,39.0,2.0,2.0,3108.0,33.0,2.0,1.0,2813.0,39.0,2.0,9.0,3335.0,5.0,0.0,0.0,357.0,Serie A,15-07-16,17.3.2.23,Andrea Barberis,43078258.0,776.0,11-Dec-93,22.0,0.0,0.0,0.0,0.0,2500.0,5250.0,5650.0,135.0,115.0,1612305.0,177.0,72.0,DM/M C,2.0,3.0,2.0,2.0,3.0,1.0,2.0,3.0,1.0,1.0,1.0,6.0,8.0,12.0,7.0,12.0,14.0,8.0,10.0,6.0,11.0,13.0,9.0,10.0,12.0,7.0,13.0,11.0,14.0,13.0,14.0,13.0,18.0,14.0,12.0,12.0,14.0,14.0,12.0,12.0,12.0,12.0,9.0,7.0,16.0,11.0,20.0,14.0,12.0,14.0,8.0,15.0,6.0,6.0,7.0,15.0,15.0,12.0,15.0,15.0,10.0,6.0,Andrea Barberis,ÃÂ£1.80m ,Serie A
19/6/2011,Richard Boateng,13107264,21,7/10/1992,18,0,0,0,0,2267,4759,4534,130,95,128899,162,62,M C,2,1,3,1,3,3,2,7,3,1,3,10,6,7,9,14,10,4,13,5,14,14,10,11,14,9,9,7,8,8,11,11,10,12,11,12,9,8,12,14,13,14,3,5,14,13,20,11,5,9,17,10,7,10,12,17,12,14,8,12,13,12,1,1,20,1,1,1,20,M C,401,1,1,1,1,1,1,1,1,1,1,20,1,1,1,1,0.0,0,0,0,0,0,0,0,0,0,0,0,0,0,0,0,0,0,0,0,0,0,0,0,0,0,0,0,0,0,0,0,0,0,0,0,0,0,0,0,0,0,0,0,0,0,0,0,0,Richard Boateng,- ,28.0,180.0,Midfielder - Central Midfield,right,AD AlcorcÃÂ³n,nan,nan,nan,nan,0.0,0.0,0.0,0.0,37.0,1.0,1.0,2537.0,32.0,2.0,0.0,2463.0,34.0,5.0,2.0,2507.0,25.0,6.0,0.0,1640.0,10.0,2.0,0.0,830.0,31.0,14.0,0.0,2458.0,26.0,0.0,0.0,1405.0,LaLiga,36.0,5.0,5.0,2764.0,4.0,0.0,0.0,325.0,nan,nan,nan,nan,nan,nan,nan,nan,nan,nan,nan,nan,nan,nan,nan,nan,nan,nan,nan,nan,nan,nan,nan,nan,nan,nan,nan,nan,nan,nan,nan,nan,nan,nan,nan,nan,nan,nan,nan,nan,nan,nan,nan,nan,nan,nan,nan,nan,nan,nan,nan,nan,nan,nan,nan,nan,nan,nan,nan,nan,nan,nan,nan,nan,nan,nan,nan,nan,nan,nan,nan,nan,nan,nan,nan,nan,nan,nan,nan,nan,nan,nan,nan,nan
19/6/2011,Rafael LeÃÂ£o,28065671,1651,4/6/1993,18,0,0,0,0,1251,2750,2750,127,63,37091,176,64,DM C,1,2,1,2,2,3,3,6,1,2,3,8,6,7,10,12,3,8,8,3,10,12,8,12,12,5,8,9,12,5,9,7,6,5,11,4,8,9,9,9,8,8,5,10,12,8,20,6,2,10,3,10,7,8,13,7,8,5,5,10,14,2,1,1,15,1,1,1,15,DM C,301,1,1,8,1,1,1,1,1,1,20,15,1,1,1,1,0.0,0,0,0,0,0,0,0,0,0,0,0,0,0,0,0,0,0,0,0,0,0,0,0,0,0,0,0,0,0,0,0,0,0,0,0,0,0,0,0,0,0,0,0,0,0,0,0,0,nan,nan,nan,nan,nan,nan,nan,nan,nan,nan,nan,nan,nan,nan,nan,nan,nan,nan,nan,nan,nan,nan,nan,nan,nan,nan,nan,nan,nan,nan,nan,nan,nan,nan,nan,nan,nan,nan,nan,nan,nan,nan,nan,nan,nan,nan,nan,nan,nan,nan,nan,nan,nan,nan,nan,nan,nan,nan,nan,nan,nan,nan,nan,nan,nan,nan,nan,nan,nan,nan,nan,nan,nan,nan,nan,nan,nan,nan,nan,nan,nan,nan,nan,nan,nan,nan,nan,nan,nan,nan,nan,nan,nan,nan,nan,nan,nan,nan,nan,nan,nan,nan,nan,nan,nan,nan,nan,nan,nan,nan,nan,nan,nan,nan,nan,nan,nan,nan,nan,nan,nan,nan,nan,nan,nan,nan,nan,nan,nan,nan,nan,nan,nan,nan,nan,nan
19/6/2011,Pablo HervÃÂ­as,67115983,796,3/8/1993,18,0,0,0,0,1750,4150,4150,119,90,235491,167,66,M/AM RC,3,2,3,3,3,1,2,3,3,3,2,12,12,12,9,8,10,7,11,2,1,11,10,4,14,8,9,8,9,10,12,11,12,14,9,12,3,10,4,14,10,9,6,10,12,13,20,11,10,11,6,9,9,13,8,14,6,9,6,11,10,7,1,1,16,20,20,13,18,M/AM RC,523,1,1,4,18,13,20,1,1,1,4,16,13,14,1,1,4.0,0,0,1,0,0,0,0,0,0,0,0,0,0,0,0,0,0,0,0,0,0,0,0,0,0,0,0,0,0,0,0,0,0,0,0,0,0,0,0,0,0,0,0,0,0,0,0,0,nan,nan,nan,nan,nan,nan,nan,nan,nan,nan,nan,nan,nan,nan,nan,nan,nan,nan,nan,nan,nan,nan,nan,nan,nan,nan,nan,nan,nan,nan,nan,nan,nan,nan,nan,nan,nan,nan,nan,nan,nan,nan,nan,nan,nan,nan,nan,nan,nan,nan,nan,nan,nan,nan,nan,nan,nan,nan,nan,nan,nan,nan,nan,nan,nan,nan,nan,nan,nan,nan,nan,nan,nan,nan,nan,nan,nan,nan,nan,nan,nan,nan,nan,nan,nan,nan,nan,nan,nan,nan,nan,nan,nan,nan,nan,nan,nan,nan,nan,nan,nan,nan,nan,nan,nan,nan,nan,nan,nan,nan,nan,nan,nan,nan,nan,nan,nan,nan,nan,nan,nan,nan,nan,nan,nan,nan,nan,nan,nan,nan,nan,nan,nan,nan,nan,nan
19/6/2011,Moritz Leitner,16020473,771,12/8/1992,18,0,0,0,0,3150,6000,6000,139,120,18181818,174,65,M/AM RLC,1,2,2,1,3,1,2,4,3,3,2,9,13,14,7,13,13,5,13,2,5,14,6,5,14,9,10,14,11,11,13,11,12,13,4,13,4,13,14,14,16,8,7,15,12,13,20,10,7,8,3,8,4,17,9,14,11,9,13,12,13,9,1,1,19,20,18,18,20,M/AM RLC,526,1,1,1,20,16,16,1,1,1,12,19,18,18,1,1,268435456.0,0,0,0,0,0,0,0,0,0,0,0,0,0,0,0,0,0,0,0,0,0,0,0,0,0,0,0,0,1,0,0,0,0,0,0,0,0,0,0,0,0,0,0,0,0,0,0,0,Moritz Leitner,ÃÂ£3.60m ,27.0,174.0,Midfielder - Central Midfield,right,Norwich City,27.0,0.0,5.0,1318.0,25.0,0.0,3.0,998.0,31.0,0.0,3.0,1222.0,24.0,1.0,2.0,1751.0,21.0,1.0,2.0,1208.0,21.0,3.0,6.0,1087.0,8.0,0.0,0.0,248.0,12.0,0.0,0.0,863.0,31.0,2.0,2.0,1802.0,Bundesliga,10.0,0.0,0.0,805.0,1.0,0.0,0.0,45.0,nan,nan,nan,nan,nan,nan,nan,nan,nan,nan,nan,nan,nan,nan,nan,nan,nan,nan,nan,nan,nan,nan,nan,nan,nan,nan,nan,nan,nan,nan,nan,nan,nan,nan,nan,nan,nan,nan,nan,nan,nan,nan,nan,nan,nan,nan,nan,nan,nan,nan,nan,nan,nan,nan,nan,nan,nan,nan,nan,nan,nan,nan,nan,nan,nan,nan,nan,nan,nan,nan,nan,nan,nan,nan,nan,nan,nan,nan,nan,nan,nan,nan,nan,nan
19/6/2011,Markus Mendler,91100204,771,1/7/1993,18,0,0,0,0,4527,5935,6036,146,118,2085958,173,67,M/AM RLC,2,1,2,2,1,2,3,2,3,3,1,11,12,13,7,12,6,5,11,5,9,11,10,11,12,16,11,8,9,12,14,6,8,9,12,10,7,14,13,13,12,12,6,20,18,13,12,13,9,10,10,10,10,10,10,8,12,6,12,17,17,12,1,1,18,20,20,18,18,M/AM RLC,526,1,1,1,16,18,20,1,1,1,1,18,14,16,1,1,0.0,0,0,0,0,0,0,0,0,0,0,0,0,0,0,0,0,0,0,0,0,0,0,0,0,0,0,0,0,0,0,0,0,0,0,0,0,0,0,0,0,0,0,0,0,0,0,0,0,Markus Mendler,ÃÂ£720Th. ,27.0,173.0,Forward - Left Winger,left,1.FC SaarbrÃÂ¼cken,25.0,5.0,1.0,1740.0,17.0,2.0,1.0,1002.0,11.0,4.0,0.0,855.0,11.0,0.0,0.0,711.0,20.0,3.0,0.0,876.0,30.0,4.0,1.0,1611.0,23.0,4.0,5.0,1184.0,32.0,12.0,18.0,2233.0,34.0,9.0,11.0,2196.0,Bundesliga,28.0,9.0,5.0,1679.0,4.0,2.0,0.0,114.0,nan,nan,nan,nan,nan,nan,nan,nan,nan,nan,nan,nan,nan,nan,nan,nan,nan,nan,nan,nan,nan,nan,nan,nan,nan,nan,nan,nan,nan,nan,nan,nan,nan,nan,nan,nan,nan,nan,nan,nan,nan,nan,nan,nan,nan,nan,nan,nan,nan,nan,nan,nan,nan,nan,nan,nan,nan,nan,nan,nan,nan,nan,nan,nan,nan,nan,nan,nan,nan,nan,nan,nan,nan,nan,nan,nan,nan,nan,nan,nan,nan,nan,nan,nan
19/6/2011,JosÃÂ© CampaÃÂ±a,67089223,796,5/30/1993,18,0,0,0,0,3000,5300,5300,137,107,812992,179,74,M/AM C,2,1,1,2,2,3,3,5,2,2,1,11,13,11,7,15,14,5,11,9,7,15,10,8,15,9,14,8,14,13,15,14,10,14,2,11,10,13,10,11,10,9,8,20,9,10,8,10,9,13,12,10,5,9,11,15,12,6,7,11,7,5,1,1,20,18,8,12,20,M/AM C,411,1,1,1,18,1,1,1,1,1,13,20,12,8,1,1,128.0,0,0,0,0,0,0,0,1,0,0,0,0,0,0,0,0,0,0,0,0,0,0,0,0,0,0,0,0,0,0,0,0,0,0,0,0,0,0,0,0,0,0,0,0,0,0,0,0,JosÃÂ© CampaÃÂ±a,ÃÂ£1.35m ,27.0,179.0,Midfielder - Central Midfield,right,Levante UD,17.0,1.0,1.0,1302.0,18.0,0.0,3.0,600.0,6.0,0.0,1.0,215.0,16.0,1.0,3.0,899.0,12.0,1.0,2.0,883.0,35.0,3.0,2.0,2971.0,40.0,4.0,5.0,3002.0,38.0,1.0,4.0,3013.0,39.0,4.0,9.0,3390.0,LaLiga,40.0,2.0,7.0,3388.0,5.0,0.0,1.0,450.0,nan,nan,nan,nan,nan,nan,nan,nan,nan,nan,nan,nan,nan,nan,nan,nan,nan,nan,nan,nan,nan,nan,nan,nan,nan,nan,nan,nan,nan,nan,nan,nan,nan,nan,nan,nan,nan,nan,nan,nan,nan,nan,nan,nan,nan,nan,nan,nan,nan,nan,nan,nan,nan,nan,nan,nan,nan,nan,nan,nan,nan,nan,nan,nan,nan,nan,nan,nan,nan,nan,nan,nan,nan,nan,nan,nan,nan,nan,nan,nan,nan,nan,nan,nan,19-06-17,18.3.4.28,JosÃÂÃÂ¼ÃÂ CampaÃÂÃÂ¼ÃÂa,67089223,796,31-May-93,24,0,0,2,0,5100,6550,6550,145,131,7677389,179,72,DM/M/AM C,1,2,3,2,2,3,1,3,3,1,2,12,13,12,10,15,13,9,13,5,8,16,11,10,15,10,12,9,13,13,15,14,14,14,12,12,12,15,12,12,14,12,9,10,13,11,20,13,9,13,6,12,7,10,12,15,12,14,13,13,14,7,1,1,20,16,1,1,20,DM/M/AM C,431,1,1,1,16,1,1,1,1,1,17,20,1,1,1,1,140740000000000.0,0,0,0,0,0,0,0,0,0,0,0,0,0,0,0,0,0,0,0,0,0,0,1,0,0,0,0,0,0,0,0,1,0,0,0,0,0,0,0,0,0,0,0,0,0,0,0,1,nan,nan,nan,nan,nan,nan,nan,nan,nan,nan,nan,nan,nan,nan,nan,nan,nan,nan,nan,nan,nan,nan,nan,nan,nan,nan,nan,nan,nan,nan,nan,nan,nan,nan,nan,nan,nan,nan,nan,nan,nan,nan,nan,nan,nan,nan,nan,nan,nan,nan,nan,nan,nan,nan,nan,nan,nan,nan,nan,nan,nan,nan,nan,nan,nan,nan,nan,nan,nan,nan,nan,nan,nan,nan,nan,nan,nan,nan,nan,nan,nan,nan,nan,nan,nan,nan,nan,nan,nan,nan,nan,nan,nan,nan,nan,nan,nan,nan,nan,nan,nan,nan,nan,nan,nan,nan,nan,nan,nan,nan,nan,nan,nan
19/6/2011,David Alaba,16010162,755,6/24/1992,18,10,0,5,0,5750,6250,6450,170,131,5541489,178,72,M LC,3,1,1,3,1,3,3,1,2,2,2,10,14,12,7,16,13,5,10,9,9,15,11,11,15,7,9,10,13,9,13,12,19,14,11,10,8,12,15,14,16,15,9,20,18,16,9,13,12,10,8,16,6,16,15,17,10,16,16,16,16,6,12,14,20,14,1,18,20,M LC,404,1,1,1,14,14,1,1,12,1,14,20,18,1,14,1,4194304.0,0,0,0,0,0,0,0,0,0,0,0,0,0,0,0,0,0,0,0,0,0,0,1,0,0,0,0,0,0,0,0,0,0,0,0,0,0,0,0,0,0,0,0,0,0,0,0,0,David Alaba,ÃÂ£14.40m ,28.0,180.0,Defender - Centre-Back,left,Bayern Munich,31.0,2.0,3.0,2474.0,47.0,3.0,3.0,2787.0,38.0,5.0,6.0,3195.0,49.0,4.0,9.0,4241.0,29.0,5.0,3.0,2556.0,46.0,2.0,4.0,4022.0,47.0,5.0,7.0,3799.0,36.0,2.0,6.0,2638.0,43.0,3.0,7.0,3631.0,Bundesliga,42.0,2.0,2.0,3693.0,6.0,0.0,1.0,562.0,29/6/2010,David Alaba,16010162.0,755.0,6/24/1992,18.0,1.0,0.0,0.0,0.0,2000.0,6250.0,6500.0,167.0,119.0,41388913.0,178.0,72.0,M LC,1.0,1.0,1.0,3.0,3.0,2.0,1.0,2.0,2.0,1.0,1.0,10.0,10.0,11.0,11.0,13.0,14.0,7.0,11.0,7.0,10.0,14.0,10.0,11.0,12.0,7.0,13.0,8.0,14.0,10.0,13.0,14.0,19.0,14.0,15.0,9.0,9.0,12.0,12.0,13.0,13.0,15.0,9.0,20.0,18.0,13.0,9.0,13.0,10.0,12.0,8.0,16.0,6.0,16.0,15.0,17.0,6.0,16.0,16.0,16.0,16.0,6.0,David Alaba,ÃÂÃÂ£4.50m ,Bundesliga,19-06-17,18.3.4.28,David Alaba,16010162,755,24-Jun-92,24,57,11,5,0,8250,8500,8750,174,170,232186002,178,72,D/WB/M LC,3,1,1,2,4,3,3,3,2,2,3,12,13,12,10,14,15,8,14,13,10,14,15,12,15,17,16,13,15,16,13,15,17,11,12,14,10,18,17,16,14,14,11,20,19,16,9,18,11,18,8,18,6,19,14,17,12,18,15,13,10,10,20,20,17,12,1,20,17,D/WB/M LC,124,1,1,1,12,12,1,16,20,1,14,17,12,1,20,1,135268352.0,0,0,0,0,0,0,0,0,0,0,0,1,0,0,0,0,0,0,0,0,1,0,0,0,0,0,0,1,0,0,0,0,0,0,0,0,0,0,0,0,0,0,0,0,0,0,0,0,David Alaba,ÃÂ£45.00m ,28.0,180.0,Defender - Centre-Back,left,Bayern Munich,47.0,5.0,7.0,3799.0,36.0,2.0,6.0,2638.0,43.0,3.0,7.0,3631.0,42.0,2.0,2.0,3693.0,6.0,0.0,1.0,562.0,Bundesliga,15-07-16,17.3.2.23,David Alaba,16010162.0,755.0,24-Jun-92,24.0,49.0,11.0,5.0,0.0,8700.0,8700.0,8700.0,174.0,174.0,190806690.0,178.0,72.0,D/WB/M LC,1.0,1.0,4.0,3.0,3.0,1.0,1.0,2.0,3.0,3.0,2.0,12.0,13.0,12.0,10.0,15.0,15.0,8.0,14.0,13.0,10.0,14.0,15.0,13.0,15.0,17.0,16.0,13.0,15.0,17.0,13.0,15.0,17.0,11.0,12.0,14.0,10.0,18.0,17.0,16.0,14.0,14.0,11.0,20.0,19.0,16.0,9.0,19.0,11.0,18.0,8.0,18.0,6.0,18.0,14.0,17.0,12.0,18.0,15.0,13.0,10.0,10.0,David Alaba,ÃÂ£34.20m ,Bundesliga
19/6/2011,ZÃÂ© Eduardo,19070329,1651,8/16/1991,19,0,0,7,0,2505,5350,5011,144,105,196378,186,80,DM/M/AM C,1,3,1,1,1,3,2,3,2,2,1,1,9,12,10,10,4,12,9,4,12,11,11,13,12,12,11,15,11,11,9,11,11,5,11,11,11,12,12,14,13,13,13,6,15,14,20,14,13,11,11,11,12,15,3,16,5,9,10,11,7,15,1,1,20,16,11,1,20,DM/M/AM C,431,1,1,1,16,1,7,1,1,1,19,20,1,11,1,1,34.0,0,1,0,0,0,1,0,0,0,0,0,0,0,0,0,0,0,0,0,0,0,0,0,0,0,0,0,0,0,0,0,0,0,0,0,0,0,0,0,0,0,0,0,0,0,0,0,0,ZÃÂ© Eduardo,ÃÂ£450Th. ,29.0,186.0,Midfielder - Defensive Midfield,right,Sandefjord Fotball,14.0,0.0,0.0,1140.0,20.0,0.0,0.0,1328.0,35.0,4.0,3.0,2778.0,41.0,3.0,5.0,3331.0,14.0,1.0,1.0,735.0,16.0,0.0,1.0,1104.0,nan,nan,nan,nan,27.0,4.0,1.0,2019.0,30.0,0.0,1.0,2455.0,Serie A,4.0,1.0,0.0,166.0,nan,nan,nan,nan,29/6/2010,ZÃÂÃÂ© Eduardo,19070329.0,1651.0,8/16/1991,18.0,0.0,0.0,7.0,0.0,2500.0,5350.0,5350.0,155.0,107.0,2186391.0,186.0,80.0,DM/M/AM C,1.0,3.0,3.0,3.0,3.0,2.0,3.0,6.0,2.0,1.0,3.0,1.0,9.0,12.0,10.0,10.0,4.0,12.0,9.0,4.0,12.0,11.0,11.0,13.0,12.0,12.0,11.0,15.0,11.0,12.0,9.0,11.0,11.0,5.0,11.0,11.0,11.0,12.0,12.0,14.0,13.0,13.0,13.0,6.0,15.0,15.0,20.0,14.0,13.0,11.0,11.0,11.0,12.0,15.0,9.0,16.0,5.0,9.0,10.0,11.0,7.0,15.0,ZÃÂÃÂ© Eduardo,ÃÂÃÂ£270Th. ,Serie A
19/6/2011,Yunus Malli,91017783,771,2/24/1992,19,0,0,0,0,2500,5250,5250,146,105,424054,179,70,M/AM RC,3,3,3,3,2,2,1,4,2,1,2,9,10,13,8,13,14,4,12,2,6,12,13,4,15,9,12,6,7,11,14,11,6,13,6,14,4,9,8,14,17,7,3,10,11,15,20,13,4,8,7,7,8,10,13,1,3,14,13,6,6,6,1,1,18,20,16,10,20,M/AM RC,523,1,1,1,20,10,16,1,1,1,10,18,10,15,1,1,0.0,0,0,0,0,0,0,0,0,0,0,0,0,0,0,0,0,0,0,0,0,0,0,0,0,0,0,0,0,0,0,0,0,0,0,0,0,0,0,0,0,0,0,0,0,0,0,0,0,Yunus Malli,ÃÂ£720Th. ,28.0,179.0,Midfielder - Attacking Midfield,right,VfL Wolfsburg,30.0,7.0,9.0,2412.0,22.0,5.0,3.0,1305.0,23.0,3.0,2.0,1390.0,29.0,5.0,5.0,1676.0,34.0,6.0,4.0,2416.0,36.0,11.0,5.0,2946.0,43.0,9.0,9.0,3377.0,37.0,6.0,5.0,2704.0,23.0,1.0,2.0,773.0,Bundesliga,15.0,0.0,1.0,726.0,1.0,0.0,0.0,58.0,nan,nan,nan,nan,nan,nan,nan,nan,nan,nan,nan,nan,nan,nan,nan,nan,nan,nan,nan,nan,nan,nan,nan,nan,nan,nan,nan,nan,nan,nan,nan,nan,nan,nan,nan,nan,nan,nan,nan,nan,nan,nan,nan,nan,nan,nan,nan,nan,nan,nan,nan,nan,nan,nan,nan,nan,nan,nan,nan,nan,nan,nan,nan,nan,nan,nan,nan,nan,nan,nan,nan,nan,nan,nan,nan,nan,nan,nan,nan,nan,nan,nan,nan,nan,19-06-17,18.3.4.28,Yunus Malli,91017783,799,24-Feb-92,25,12,0,0,0,6700,6700,7200,148,144,34497957,179,70,M/AM/S LC,3,3,2,3,1,3,1,2,1,3,1,14,12,15,13,15,12,7,11,4,6,14,12,8,16,16,13,7,12,9,15,12,8,16,5,16,10,13,17,15,17,8,6,12,14,11,20,15,7,13,4,11,8,14,7,10,12,10,14,14,18,9,1,1,16,20,12,16,20,M/AM/S LC,534,1,1,17,20,16,12,1,1,1,8,13,16,12,1,1,549757000000.0,0,0,0,0,0,0,0,0,0,0,1,0,0,0,0,0,0,0,0,0,1,0,0,0,0,0,0,0,0,0,0,0,0,0,0,0,0,0,0,1,0,0,0,0,0,0,0,0,Yunus Malli,ÃÂ£8.10m ,28.0,179.0,Midfielder - Attacking Midfield,right,VfL Wolfsburg,43.0,9.0,9.0,3377.0,37.0,6.0,5.0,2704.0,23.0,1.0,2.0,773.0,15.0,0.0,1.0,726.0,1.0,0.0,0.0,58.0,Bundesliga,15-07-16,17.3.2.23,Yunus Malli,91017783.0,799.0,24-Feb-92,24.0,7.0,0.0,0.0,0.0,6300.0,6800.0,7300.0,152.0,146.0,38910983.0,179.0,70.0,M/AM/S LC,2.0,2.0,2.0,1.0,2.0,3.0,3.0,1.0,2.0,1.0,3.0,14.0,12.0,15.0,13.0,16.0,12.0,7.0,11.0,4.0,6.0,14.0,12.0,8.0,16.0,16.0,13.0,7.0,12.0,9.0,15.0,12.0,8.0,16.0,5.0,16.0,10.0,13.0,17.0,15.0,17.0,8.0,6.0,12.0,14.0,11.0,20.0,15.0,7.0,13.0,4.0,11.0,8.0,14.0,7.0,10.0,12.0,10.0,14.0,14.0,18.0,9.0,Yunus Malli,ÃÂ£9.00m ,Bundesliga
19/6/2011,Tolga Cigerci,91107170,771,3/23/1992,19,0,0,0,0,4250,5850,5850,175,117,2818169,185,75,M/AM C,2,1,1,3,3,3,2,2,3,2,3,11,12,13,12,13,11,11,10,6,12,13,10,12,13,10,12,9,12,11,12,13,11,10,2,11,12,13,12,12,13,10,12,9,13,13,20,12,11,10,10,10,9,10,3,10,10,10,10,11,10,5,1,1,20,17,1,1,20,M/AM C,411,1,1,1,17,1,1,1,1,1,15,20,1,1,1,1,0.0,0,0,0,0,0,0,0,0,0,0,0,0,0,0,0,0,0,0,0,0,0,0,0,0,0,0,0,0,0,0,0,0,0,0,0,0,0,0,0,0,0,0,0,0,0,0,0,0,Tolga Cigerci,ÃÂ£720Th. ,28.0,185.0,Midfielder - Central Midfield,right,Fenerbahce SK,22.0,3.0,3.0,1579.0,17.0,3.0,1.0,1160.0,19.0,1.0,0.0,1274.0,20.0,1.0,3.0,1577.0,2.0,0.0,0.0,76.0,21.0,0.0,2.0,1221.0,25.0,0.0,0.0,1922.0,24.0,6.0,0.0,1605.0,2.0,0.0,0.0,90.0,Bundesliga,33.0,2.0,4.0,2093.0,3.0,0.0,0.0,174.0,nan,nan,nan,nan,nan,nan,nan,nan,nan,nan,nan,nan,nan,nan,nan,nan,nan,nan,nan,nan,nan,nan,nan,nan,nan,nan,nan,nan,nan,nan,nan,nan,nan,nan,nan,nan,nan,nan,nan,nan,nan,nan,nan,nan,nan,nan,nan,nan,nan,nan,nan,nan,nan,nan,nan,nan,nan,nan,nan,nan,nan,nan,nan,nan,nan,nan,nan,nan,nan,nan,nan,nan,nan,nan,nan,nan,nan,nan,nan,nan,nan,nan,nan,nan
19/6/2011,Saphir TaÃÂ¯der,85041832,769,2/29/1992,19,0,0,0,0,3238,4923,4915,147,108,389439,180,73,M RC,1,1,3,2,3,2,2,1,3,2,1,8,8,13,8,13,13,6,12,5,7,12,11,5,15,8,12,11,12,12,13,9,14,12,7,11,9,13,14,14,14,13,9,8,14,11,20,14,11,13,8,14,7,8,12,15,14,13,13,15,15,7,1,1,20,1,15,10,20,M RC,403,1,1,1,1,1,1,1,1,1,14,20,10,15,1,1,1073741824.0,0,0,0,0,0,0,0,0,0,0,0,0,0,0,0,0,0,0,0,0,0,0,0,0,0,0,0,0,0,0,1,0,0,0,0,0,0,0,0,0,0,0,0,0,0,0,0,0,Saphir Taider,ÃÂ£2.70m ,28.0,180.0,Midfielder - Central Midfield,right,Al-Ain,26.0,1.0,0.0,1682.0,19.0,2.0,1.0,1362.0,35.0,5.0,2.0,2967.0,26.0,2.0,2.0,1140.0,28.0,4.0,3.0,1773.0,29.0,0.0,0.0,2111.0,25.0,4.0,0.0,1992.0,45.0,7.0,9.0,3423.0,37.0,10.0,9.0,3033.0,Serie A,14.0,5.0,5.0,1158.0,1.0,1.0,0.0,90.0,nan,nan,nan,nan,nan,nan,nan,nan,nan,nan,nan,nan,nan,nan,nan,nan,nan,nan,nan,nan,nan,nan,nan,nan,nan,nan,nan,nan,nan,nan,nan,nan,nan,nan,nan,nan,nan,nan,nan,nan,nan,nan,nan,nan,nan,nan,nan,nan,nan,nan,nan,nan,nan,nan,nan,nan,nan,nan,nan,nan,nan,nan,nan,nan,nan,nan,nan,nan,nan,nan,nan,nan,nan,nan,nan,nan,nan,nan,nan,nan,nan,nan,nan,nan
19/6/2011,Ruben Pinto,55022438,788,4/24/1992,19,0,0,0,0,1568,4307,4307,150,90,206514,181,69,M/AM RC,3,3,1,3,1,3,2,9,1,1,1,10,11,11,9,11,9,7,9,6,7,11,10,6,11,9,12,10,12,12,12,12,10,12,10,12,9,10,11,11,11,9,9,8,12,11,20,8,8,13,7,11,14,12,9,19,13,14,15,7,12,19,1,1,20,17,17,13,20,M/AM RC,413,1,1,1,17,13,17,1,1,1,8,20,5,10,1,1,0.0,0,0,0,0,0,0,0,0,0,0,0,0,0,0,0,0,0,0,0,0,0,0,0,0,0,0,0,0,0,0,0,0,0,0,0,0,0,0,0,0,0,0,0,0,0,0,0,0,RÃÂºben Pinto,ÃÂ£450Th. ,28.0,183.0,Midfielder - Defensive Midfield,right,MOL FehÃÂ©rvÃÂ¡r FC,nan,nan,nan,nan,0.0,0.0,0.0,0.0,5.0,0.0,0.0,233.0,34.0,4.0,4.0,2814.0,36.0,7.0,2.0,3118.0,46.0,3.0,2.0,3481.0,29.0,2.0,1.0,2301.0,30.0,4.0,1.0,2309.0,43.0,5.0,1.0,3461.0,Liga NOS,15.0,1.0,2.0,1188.0,0.0,0.0,0.0,0.0,29/6/2010,Ruben Pinto,55022438.0,788.0,4/24/1992,18.0,0.0,0.0,0.0,0.0,1250.0,3500.0,3500.0,145.0,75.0,127135.0,181.0,69.0,M/AM RC,1.0,2.0,2.0,2.0,1.0,2.0,2.0,4.0,2.0,1.0,1.0,9.0,10.0,10.0,8.0,10.0,8.0,6.0,8.0,5.0,6.0,10.0,9.0,5.0,10.0,9.0,11.0,9.0,11.0,11.0,11.0,11.0,10.0,12.0,9.0,11.0,8.0,9.0,10.0,10.0,10.0,8.0,8.0,8.0,12.0,10.0,20.0,7.0,7.0,13.0,7.0,11.0,3.0,12.0,17.0,13.0,13.0,14.0,12.0,17.0,8.0,6.0,Nuno Pinto,ÃÂÃÂ£900Th. ,Liga NOS
19/6/2011,Roberto Firmino,19068857,1651,10/2/1991,19,0,0,0,0,4150,6050,6450,168,130,5809513,180,76,M/AM C,3,2,1,3,1,1,2,6,2,1,1,9,12,16,15,17,8,13,10,5,6,14,9,7,17,8,14,9,12,10,15,11,12,17,5,14,6,11,13,13,17,8,9,14,12,13,20,10,6,11,2,7,10,10,7,12,7,10,13,8,11,7,1,1,18,20,1,1,20,M/AM C,521,1,1,1,20,1,1,1,1,1,1,18,1,1,1,1,70403400000000.0,0,0,0,0,0,0,0,0,0,0,1,0,0,0,0,0,0,0,0,0,1,0,0,0,0,0,0,0,1,0,0,0,0,0,0,1,0,0,0,0,0,0,0,0,0,0,1,0,Roberto Firmino,ÃÂ£6.30m ,29.0,181.0,Forward - Centre-Forward,right,Liverpool FC,11.0,3.0,0.0,467.0,33.0,7.0,4.0,2490.0,36.0,7.0,4.0,2710.0,37.0,22.0,16.0,3297.0,36.0,10.0,12.0,3201.0,49.0,11.0,11.0,3326.0,41.0,12.0,11.0,3463.0,54.0,27.0,17.0,4188.0,48.0,16.0,8.0,3406.0,Bundesliga,52.0,12.0,13.0,3921.0,8.0,1.0,2.0,638.0,nan,nan,nan,nan,nan,nan,nan,nan,nan,nan,nan,nan,nan,nan,nan,nan,nan,nan,nan,nan,nan,nan,nan,nan,nan,nan,nan,nan,nan,nan,nan,nan,nan,nan,nan,nan,nan,nan,nan,nan,nan,nan,nan,nan,nan,nan,nan,nan,nan,nan,nan,nan,nan,nan,nan,nan,nan,nan,nan,nan,nan,nan,nan,nan,nan,nan,nan,nan,nan,nan,nan,nan,nan,nan,nan,nan,nan,nan,nan,nan,nan,nan,nan,nan,19-06-17,18.3.4.28,Roberto Firmino,19068857,1651,02-Oct-91,25,15,5,0,0,7000,8000,8000,172,168,96357191,181,76,AM/S RLC,3,1,3,1,3,3,1,1,1,2,3,11,13,16,15,17,9,12,13,4,12,15,12,14,18,12,17,12,16,16,15,15,14,16,5,17,12,17,17,14,15,15,11,10,16,13,20,16,14,15,5,15,8,12,15,15,13,14,14,11,16,8,1,1,1,18,15,17,18,AM/S RLC,626,1,1,20,18,17,15,1,1,1,1,1,1,1,1,1,550024000000.0,0,0,0,0,1,0,0,0,0,0,1,0,0,0,0,0,0,0,0,0,0,0,0,0,0,0,0,0,1,0,0,0,0,0,0,0,0,0,0,1,0,0,0,0,0,0,0,0,Roberto Firmino,ÃÂ£72.00m ,29.0,181.0,Forward - Centre-Forward,right,Liverpool FC,41.0,12.0,11.0,3463.0,54.0,27.0,17.0,4188.0,48.0,16.0,8.0,3406.0,52.0,12.0,13.0,3921.0,8.0,1.0,2.0,638.0,Premier League,15-07-16,17.3.2.23,Roberto Firmino,19068857.0,1651.0,02-Oct-91,24.0,11.0,4.0,0.0,0.0,7000.0,8000.0,8000.0,168.0,159.0,126890572.0,181.0,76.0,AM/S RLC,1.0,1.0,1.0,1.0,3.0,2.0,2.0,3.0,2.0,3.0,1.0,11.0,13.0,16.0,15.0,16.0,11.0,11.0,14.0,4.0,8.0,14.0,11.0,11.0,17.0,12.0,15.0,10.0,15.0,14.0,15.0,13.0,14.0,16.0,7.0,17.0,11.0,16.0,16.0,14.0,15.0,15.0,10.0,11.0,16.0,13.0,20.0,15.0,13.0,13.0,5.0,14.0,8.0,12.0,15.0,15.0,13.0,14.0,14.0,11.0,13.0,12.0,Roberto Firmino,ÃÂ£34.20m ,Premier League
19/6/2011,Phil Jones,28027433,765,2/21/1992,19,0,0,9,0,5500,7400,7400,170,145,14653081,181,71,D/DM C,1,2,1,2,2,3,1,1,2,1,2,2,5,8,5,14,6,13,4,10,15,12,8,16,10,15,15,16,14,13,11,14,18,14,15,9,14,13,13,14,12,11,13,12,18,14,20,15,17,15,10,18,6,14,18,18,8,18,18,14,16,8,20,1,15,1,14,1,20,D/DM C,111,1,1,1,1,1,1,20,1,14,18,15,1,1,1,1,143074000000000.0,0,0,1,0,0,1,0,0,0,0,0,0,0,0,0,0,0,0,0,0,0,0,0,0,0,0,0,0,0,0,0,0,0,0,0,0,0,1,0,0,0,1,0,0,0,0,0,1,Phil Jones,ÃÂ£16.20m ,28.0,185.0,Defender - Centre-Back,right,Manchester United,29.0,0.0,0.0,2339.0,42.0,2.0,4.0,3076.0,24.0,0.0,2.0,1788.0,39.0,3.0,2.0,3099.0,25.0,0.0,2.0,2074.0,18.0,0.0,0.0,1045.0,26.0,0.0,0.0,2222.0,25.0,0.0,0.0,2152.0,24.0,0.0,1.0,1713.0,Premier League,8.0,1.0,0.0,562.0,nan,nan,nan,nan,29/6/2010,Phil Jones,28027433.0,765.0,2/21/1992,18.0,0.0,0.0,1.0,0.0,3100.0,6350.0,6350.0,168.0,116.0,11793468.0,186.0,71.0,D C,3.0,1.0,2.0,2.0,2.0,1.0,2.0,5.0,1.0,2.0,3.0,2.0,5.0,8.0,5.0,11.0,6.0,13.0,2.0,10.0,11.0,9.0,8.0,13.0,9.0,17.0,14.0,17.0,13.0,13.0,7.0,11.0,17.0,4.0,12.0,7.0,13.0,14.0,16.0,14.0,11.0,12.0,13.0,10.0,16.0,14.0,20.0,13.0,14.0,16.0,11.0,18.0,3.0,16.0,5.0,14.0,15.0,17.0,18.0,15.0,16.0,4.0,Phil Jones,ÃÂÃÂ£3.15m ,Premier League
19/6/2011,Pajtim Kasami,28027647,798,6/2/1992,19,0,0,10,1,3500,5500,6250,160,120,1510795,187,70,M/AM RC,1,1,1,1,1,1,1,1,1,1,1,10,14,13,14,12,5,9,13,3,9,13,11,14,8,7,13,14,12,10,11,9,10,17,8,11,9,13,11,15,13,14,12,20,12,14,8,11,13,10,12,10,17,6,14,5,11,6,10,5,11,8,1,1,20,20,17,13,20,M/AM RC,413,1,1,8,20,13,17,1,1,1,14,20,13,17,1,1,0.0,0,0,0,0,0,0,0,0,0,0,0,0,0,0,0,0,0,0,0,0,0,0,0,0,0,0,0,0,0,0,0,0,0,0,0,0,0,0,0,0,0,0,0,0,0,0,0,0,Pajtim Kasami,ÃÂ£2.25m ,28.0,188.0,Midfielder - Right Midfield,left,FC Basel 1893,23.0,0.0,3.0,866.0,24.0,3.0,2.0,1216.0,24.0,2.0,2.0,1665.0,35.0,3.0,1.0,2321.0,36.0,5.0,6.0,2440.0,30.0,4.0,3.0,2213.0,27.0,2.0,2.0,1974.0,26.0,6.0,4.0,2225.0,38.0,11.0,8.0,3068.0,Premier League,39.0,15.0,4.0,3234.0,nan,nan,nan,nan,29/6/2010,Pajtim Kasami,28027647.0,798.0,6/2/1992,18.0,0.0,0.0,1.0,0.0,2250.0,5084.0,4900.0,144.0,113.0,1541290.0,187.0,70.0,M/AM RC,1.0,1.0,1.0,1.0,1.0,1.0,1.0,1.0,1.0,1.0,1.0,10.0,12.0,14.0,12.0,11.0,10.0,9.0,12.0,9.0,8.0,12.0,10.0,13.0,7.0,7.0,14.0,14.0,12.0,14.0,10.0,8.0,10.0,7.0,8.0,11.0,8.0,12.0,10.0,12.0,11.0,13.0,18.0,20.0,12.0,14.0,8.0,10.0,12.0,10.0,13.0,10.0,8.0,6.0,6.0,12.0,10.0,7.0,13.0,13.0,11.0,5.0,Pajtim Kasami,ÃÂÃÂ£1.89m ,Serie A
19/6/2011,Pablo Sarabia,67045428,796,5/11/1992,19,0,0,0,0,4070,6080,6080,164,124,5895804,177,72,M/AM LC,2,2,2,1,2,2,1,7,3,2,1,13,15,16,11,15,12,8,10,5,4,15,12,6,17,10,11,9,12,8,15,11,4,16,8,14,5,11,9,15,16,9,7,20,12,13,8,11,8,10,9,15,10,9,11,14,12,7,9,7,6,5,1,1,16,20,13,20,18,M/AM LC,524,1,1,10,18,20,13,1,1,1,1,15,16,9,1,1,2192.0,0,0,0,0,1,0,0,1,0,0,0,1,0,0,0,0,0,0,0,0,0,0,0,0,0,0,0,0,0,0,0,0,0,0,0,0,0,0,0,0,0,0,0,0,0,0,0,0,Pablo Sarabia,ÃÂ£2.25m ,28.0,174.0,Forward - Right Winger,left,Paris Saint-Germain,34.0,12.0,4.0,2628.0,20.0,0.0,1.0,983.0,16.0,2.0,0.0,629.0,36.0,2.0,6.0,2141.0,41.0,4.0,7.0,2927.0,32.0,7.0,6.0,2553.0,46.0,11.0,12.0,2809.0,53.0,9.0,9.0,3753.0,52.0,23.0,17.0,3729.0,LaLiga,40.0,14.0,8.0,2409.0,9.0,1.0,4.0,464.0,nan,nan,nan,nan,nan,nan,nan,nan,nan,nan,nan,nan,nan,nan,nan,nan,nan,nan,nan,nan,nan,nan,nan,nan,nan,nan,nan,nan,nan,nan,nan,nan,nan,nan,nan,nan,nan,nan,nan,nan,nan,nan,nan,nan,nan,nan,nan,nan,nan,nan,nan,nan,nan,nan,nan,nan,nan,nan,nan,nan,nan,nan,nan,nan,nan,nan,nan,nan,nan,nan,nan,nan,nan,nan,nan,nan,nan,nan,nan,nan,nan,nan,nan,nan,19-06-17,18.3.4.28,Pablo Sarabia,67045428,796,11-May-92,25,0,0,13,2,5000,7300,7300,155,146,24430727,174,70,WB/M/AM RLC,2,3,3,2,2,1,3,2,2,3,2,14,15,16,11,15,16,8,13,5,8,15,12,6,16,10,11,10,12,14,15,12,9,16,8,14,5,12,13,15,16,9,7,20,12,14,9,13,9,12,9,15,10,14,19,12,10,12,13,14,10,10,8,16,18,20,20,19,18,WB/M/AM RLC,536,1,1,10,18,19,20,1,8,1,1,15,18,12,16,1,2192.0,0,0,0,0,1,0,0,1,0,0,0,1,0,0,0,0,0,0,0,0,0,0,0,0,0,0,0,0,0,0,0,0,0,0,0,0,0,0,0,0,0,0,0,0,0,0,0,0,Pablo Sarabia,ÃÂ£18.00m ,28.0,174.0,Forward - Right Winger,left,Paris Saint-Germain,46.0,11.0,12.0,2809.0,53.0,9.0,9.0,3753.0,52.0,23.0,17.0,3729.0,40.0,14.0,8.0,2409.0,9.0,1.0,4.0,464.0,LaLiga,15-07-16,17.3.2.23,Pablo Sarabia,67045428.0,796.0,11-May-92,24.0,0.0,0.0,13.0,2.0,5000.0,7300.0,7300.0,155.0,146.0,24999999.0,174.0,70.0,WB/M/AM RLC,2.0,2.0,1.0,3.0,1.0,1.0,3.0,2.0,2.0,2.0,2.0,14.0,15.0,16.0,11.0,16.0,16.0,8.0,12.0,5.0,8.0,16.0,12.0,6.0,17.0,10.0,11.0,10.0,12.0,11.0,15.0,12.0,9.0,16.0,8.0,14.0,5.0,11.0,10.0,15.0,16.0,9.0,7.0,20.0,12.0,14.0,8.0,13.0,9.0,12.0,9.0,15.0,10.0,14.0,7.0,12.0,10.0,12.0,13.0,14.0,10.0,10.0,Pablo Sarabia,ÃÂ£13.50m ,LaLiga
19/6/2011,Pablo Ceppelini,78034945,1657,9/11/1991,19,0,0,0,0,2296,5077,5042,141,112,732886,176,70,M/AM RC,2,3,2,3,1,2,1,5,2,3,3,15,14,14,12,16,14,4,12,11,7,15,14,6,15,12,13,9,12,8,12,12,10,12,6,15,9,12,12,12,16,7,7,10,17,10,20,13,8,12,8,12,2,13,14,10,15,14,15,14,8,10,1,1,16,20,16,12,20,M/AM RC,523,1,1,8,20,12,16,1,1,1,1,16,8,12,1,1,0.0,0,0,0,0,0,0,0,0,0,0,0,0,0,0,0,0,0,0,0,0,0,0,0,0,0,0,0,0,0,0,0,0,0,0,0,0,0,0,0,0,0,0,0,0,0,0,0,0,Pablo Ceppelini,ÃÂ£1.35m ,29.0,178.0,Midfielder - Attacking Midfield,right,CD Cruz Azul,18.0,1.0,4.0,1217.0,18.0,5.0,0.0,1101.0,18.0,2.0,1.0,1131.0,3.0,0.0,0.0,94.0,29.0,5.0,2.0,1988.0,9.0,0.0,2.0,370.0,55.0,12.0,11.0,4938.0,34.0,6.0,6.0,2348.0,46.0,9.0,9.0,2797.0,Serie A,7.0,1.0,0.0,278.0,0.0,0.0,0.0,0.0,nan,nan,nan,nan,nan,nan,nan,nan,nan,nan,nan,nan,nan,nan,nan,nan,nan,nan,nan,nan,nan,nan,nan,nan,nan,nan,nan,nan,nan,nan,nan,nan,nan,nan,nan,nan,nan,nan,nan,nan,nan,nan,nan,nan,nan,nan,nan,nan,nan,nan,nan,nan,nan,nan,nan,nan,nan,nan,nan,nan,nan,nan,nan,nan,nan,nan,nan,nan,nan,nan,nan,nan,nan,nan,nan,nan,nan,nan,nan,nan,nan,nan,nan,nan
19/6/2011,Nadir Minotti,43058969,776,5/16/1992,19,0,0,0,0,50,4500,4500,160,95,176359,182,75,M/AM C,1,1,2,3,1,1,1,2,2,3,2,10,9,11,13,11,7,11,12,5,6,12,12,11,12,13,11,10,11,9,12,10,14,12,12,8,10,10,11,11,11,10,10,8,12,12,20,11,13,14,10,11,5,13,10,13,14,15,12,14,16,6,1,1,18,20,1,1,20,M/AM C,521,1,1,1,20,1,1,1,1,1,15,18,1,1,1,1,0.0,0,0,0,0,0,0,0,0,0,0,0,0,0,0,0,0,0,0,0,0,0,0,0,0,0,0,0,0,0,0,0,0,0,0,0,0,0,0,0,0,0,0,0,0,0,0,0,0,Nadir Minotti,ÃÂ£675Th. ,28.0,188.0,Midfielder - Defensive Midfield,right,FC Lumezzane,29.0,13.0,0.0,2301.0,12.0,1.0,0.0,852.0,25.0,1.0,0.0,1413.0,25.0,2.0,0.0,1549.0,28.0,1.0,2.0,2013.0,26.0,1.0,0.0,1674.0,32.0,4.0,2.0,2394.0,nan,nan,nan,nan,nan,nan,nan,nan,Serie A,nan,nan,nan,nan,nan,nan,nan,nan,nan,nan,nan,nan,nan,nan,nan,nan,nan,nan,nan,nan,nan,nan,nan,nan,nan,nan,nan,nan,nan,nan,nan,nan,nan,nan,nan,nan,nan,nan,nan,nan,nan,nan,nan,nan,nan,nan,nan,nan,nan,nan,nan,nan,nan,nan,nan,nan,nan,nan,nan,nan,nan,nan,nan,nan,nan,nan,nan,nan,nan,nan,nan,nan,nan,nan,nan,nan,nan,nan,nan,nan,nan,nan,nan,nan,nan,nan,nan,nan,nan,nan,nan,nan
19/6/2011,Matthias Zimmermann,35017462,771,6/16/1992,19,0,0,0,0,2400,5600,5600,158,112,3791743,178,76,D/WB/DM/M RC,3,2,1,1,3,2,3,4,1,1,3,10,12,9,6,11,6,7,6,10,14,12,6,13,11,14,13,14,11,13,11,10,15,8,12,6,11,15,14,14,13,13,8,20,13,14,5,12,8,12,7,9,6,6,4,15,13,14,15,14,13,5,20,16,16,1,20,14,16,D/WB/DM/M RC,133,1,1,1,1,1,1,1,14,20,18,16,1,8,12,16,32800.0,0,0,0,0,0,1,0,0,0,0,0,0,0,0,0,1,0,0,0,0,0,0,0,0,0,0,0,0,0,0,0,0,0,0,0,0,0,0,0,0,0,0,0,0,0,0,0,0,Matthias Zimmermann,ÃÂ£900Th. ,28.0,177.0,Defender - Right-Back,right,Fortuna DÃÂ¼sseldorf,34.0,1.0,1.0,3042.0,14.0,1.0,1.0,1124.0,34.0,2.0,3.0,2775.0,21.0,0.0,1.0,1520.0,34.0,3.0,7.0,2849.0,36.0,1.0,1.0,2941.0,30.0,1.0,0.0,1726.0,7.0,0.0,0.0,427.0,36.0,1.0,3.0,3230.0,Bundesliga,38.0,2.0,4.0,3250.0,5.0,1.0,0.0,288.0,nan,nan,nan,nan,nan,nan,nan,nan,nan,nan,nan,nan,nan,nan,nan,nan,nan,nan,nan,nan,nan,nan,nan,nan,nan,nan,nan,nan,nan,nan,nan,nan,nan,nan,nan,nan,nan,nan,nan,nan,nan,nan,nan,nan,nan,nan,nan,nan,nan,nan,nan,nan,nan,nan,nan,nan,nan,nan,nan,nan,nan,nan,nan,nan,nan,nan,nan,nan,nan,nan,nan,nan,nan,nan,nan,nan,nan,nan,nan,nan,nan,nan,nan,nan,19-06-17,18.3.4.28,Matthias Zimmermann,35017462,771,16-Jun-92,25,0,0,0,0,2800,5800,5800,120,116,1494444,177,77,D/WB/DM/M RC,3,1,2,2,3,1,4,2,1,2,3,8,10,9,7,11,6,8,9,10,11,13,7,13,12,11,14,9,12,13,10,14,10,7,10,8,13,16,12,12,13,9,8,9,14,12,20,14,10,12,7,10,6,17,7,13,12,8,15,15,17,5,20,16,17,10,20,12,17,D/WB/DM/M RC,133,1,1,1,1,1,10,1,12,20,18,17,1,10,10,16,0.0,0,0,0,0,0,0,0,0,0,0,0,0,0,0,0,0,0,0,0,0,0,0,0,0,0,0,0,0,0,0,0,0,0,0,0,0,0,0,0,0,0,0,0,0,0,0,0,0,Matthias Zimmermann,ÃÂ£900Th. ,28.0,177.0,Defender - Right-Back,right,Fortuna DÃÂ¼sseldorf,30.0,1.0,0.0,1726.0,7.0,0.0,0.0,427.0,36.0,1.0,3.0,3230.0,38.0,2.0,4.0,3250.0,5.0,1.0,0.0,288.0,Bundesliga,nan,nan,nan,nan,nan,nan,nan,nan,nan,nan,nan,nan,nan,nan,nan,nan,nan,nan,nan,nan,nan,nan,nan,nan,nan,nan,nan,nan,nan,nan,nan,nan,nan,nan,nan,nan,nan,nan,nan,nan,nan,nan,nan,nan,nan,nan,nan,nan,nan,nan,nan,nan,nan,nan,nan,nan,nan,nan,nan,nan,nan,nan,nan,nan,nan,nan,nan,nan,nan,nan,nan,nan,nan,nan,nan,nan,nan,nan,nan,nan,nan,nan,nan,nan,nan
19/6/2011,Manuel Giandonato,43052125,776,10/10/1991,19,0,0,1,0,2022,5428,5027,142,120,134610,184,82,DM/M C,2,3,1,2,3,2,3,4,3,2,3,10,10,7,11,14,10,10,12,4,14,14,10,14,14,11,13,4,5,11,10,13,7,5,8,8,14,17,12,14,14,14,11,20,11,14,11,9,11,10,5,10,5,10,14,10,9,10,11,7,5,4,1,1,18,1,1,1,18,DM/M C,311,1,1,1,1,1,1,1,1,1,20,18,1,1,1,1,0.0,0,0,0,0,0,0,0,0,0,0,0,0,0,0,0,0,0,0,0,0,0,0,0,0,0,0,0,0,0,0,0,0,0,0,0,0,0,0,0,0,0,0,0,0,0,0,0,0,Manuel Giandonato,ÃÂ£450Th. ,29.0,188.0,Midfielder - Central Midfield,right,Olbia Calcio 1905,17.0,5.0,0.0,1138.0,8.0,0.0,0.0,208.0,25.0,1.0,4.0,1261.0,11.0,0.0,0.0,345.0,27.0,2.0,1.0,1512.0,22.0,0.0,4.0,639.0,17.0,0.0,2.0,1335.0,25.0,0.0,0.0,1389.0,33.0,3.0,1.0,2367.0,Serie A,24.0,0.0,3.0,1650.0,5.0,0.0,0.0,403.0,nan,nan,nan,nan,nan,nan,nan,nan,nan,nan,nan,nan,nan,nan,nan,nan,nan,nan,nan,nan,nan,nan,nan,nan,nan,nan,nan,nan,nan,nan,nan,nan,nan,nan,nan,nan,nan,nan,nan,nan,nan,nan,nan,nan,nan,nan,nan,nan,nan,nan,nan,nan,nan,nan,nan,nan,nan,nan,nan,nan,nan,nan,nan,nan,nan,nan,nan,nan,nan,nan,nan,nan,nan,nan,nan,nan,nan,nan,nan,nan,nan,nan,nan,nan
19/6/2011,Koke,67047092,796,1/8/1992,19,0,0,0,0,4000,6150,6150,137,123,4745066,175,72,M/AM LC,3,2,3,2,3,2,2,9,3,1,3,8,13,12,8,13,12,8,13,6,11,15,10,12,15,7,11,12,14,13,14,15,15,13,12,11,10,13,14,10,12,13,8,20,14,12,10,13,10,13,5,12,5,10,14,14,14,13,15,11,12,6,1,1,20,17,10,15,20,M/AM LC,414,1,1,1,17,8,1,1,1,1,14,20,15,10,1,1,4194304.0,0,0,0,0,0,0,0,0,0,0,0,0,0,0,0,0,0,0,0,0,0,0,1,0,0,0,0,0,0,0,0,0,0,0,0,0,0,0,0,0,0,0,0,0,0,0,0,0,Koke,ÃÂ£3.15m ,28.0,176.0,Midfielder - Central Midfield,right,AtlÃÂ©tico Madrid,32.0,4.0,1.0,2128.0,40.0,2.0,6.0,1907.0,48.0,3.0,13.0,3391.0,58.0,7.0,18.0,4624.0,49.0,4.0,18.0,4195.0,51.0,5.0,17.0,4430.0,54.0,5.0,10.0,4694.0,51.0,6.0,7.0,4093.0,41.0,6.0,7.0,3511.0,LaLiga,42.0,5.0,6.0,3526.0,6.0,0.0,0.0,421.0,nan,nan,nan,nan,nan,nan,nan,nan,nan,nan,nan,nan,nan,nan,nan,nan,nan,nan,nan,nan,nan,nan,nan,nan,nan,nan,nan,nan,nan,nan,nan,nan,nan,nan,nan,nan,nan,nan,nan,nan,nan,nan,nan,nan,nan,nan,nan,nan,nan,nan,nan,nan,nan,nan,nan,nan,nan,nan,nan,nan,nan,nan,nan,nan,nan,nan,nan,nan,nan,nan,nan,nan,nan,nan,nan,nan,nan,nan,nan,nan,nan,nan,nan,nan,19-06-17,18.3.4.28,Koke,67047092,796,08-Jan-92,25,24,0,9,1,7400,8100,8100,169,163,155241911,177,73,M RLC,1,3,2,3,1,2,3,2,1,1,3,16,15,13,13,15,14,9,14,6,13,16,10,14,14,14,15,15,15,17,15,15,16,10,14,15,15,17,16,13,13,15,9,14,14,13,20,15,12,15,10,13,6,18,10,15,17,13,15,11,12,6,1,1,20,14,16,19,20,M RLC,406,1,1,1,14,11,9,1,1,1,12,20,19,16,1,1,4503600000000000.0,0,0,0,0,0,0,1,0,1,0,0,1,0,0,0,0,0,0,0,0,0,0,0,0,0,0,0,0,0,0,0,0,0,0,0,0,0,0,0,0,0,0,0,0,0,0,0,0,Koke,ÃÂ£63.00m ,28.0,176.0,Midfielder - Central Midfield,right,AtlÃÂ©tico Madrid,54.0,5.0,10.0,4694.0,51.0,6.0,7.0,4093.0,41.0,6.0,7.0,3511.0,42.0,5.0,6.0,3526.0,6.0,0.0,0.0,421.0,LaLiga,15-07-16,17.3.2.23,Koke,67047092.0,796.0,08-Jan-92,24.0,24.0,0.0,9.0,1.0,7500.0,8200.0,8200.0,174.0,165.0,59999998.0,178.0,73.0,M RLC,3.0,3.0,3.0,2.0,1.0,2.0,3.0,3.0,1.0,2.0,3.0,16.0,16.0,13.0,13.0,15.0,14.0,9.0,14.0,6.0,13.0,16.0,10.0,14.0,14.0,14.0,15.0,15.0,16.0,17.0,15.0,16.0,15.0,10.0,14.0,15.0,15.0,17.0,16.0,13.0,13.0,15.0,9.0,14.0,14.0,13.0,20.0,15.0,12.0,15.0,10.0,13.0,6.0,18.0,9.0,14.0,16.0,13.0,15.0,11.0,12.0,6.0,Koke,ÃÂ£54.00m ,LaLiga
19/6/2011,Kevin,67059115,796,2/13/1992,19,0,0,0,0,2550,5050,5050,152,101,274841,178,69,M/AM C,2,1,1,1,3,1,1,4,2,3,3,11,10,12,9,13,8,8,11,8,5,14,12,8,14,10,9,11,11,8,13,11,12,13,6,12,7,12,11,13,14,9,7,9,13,13,20,12,6,13,8,10,10,12,11,13,15,12,13,13,13,3,1,1,16,20,13,10,20,M/AM C,521,1,1,1,20,10,13,1,1,1,8,16,9,12,1,1,17592200000000.0,0,0,0,0,1,0,0,1,0,0,0,0,0,0,0,0,0,0,0,0,0,0,0,0,0,0,0,0,0,0,0,0,0,0,0,0,0,0,0,0,0,0,0,0,1,0,0,0,Kelvin,ÃÂ£1.80m ,27.0,175.0,Forward - Right Winger,left,Botafogo de Futebol e Regatas,4.0,1.0,0.0,324.0,27.0,2.0,2.0,1449.0,24.0,5.0,1.0,1382.0,23.0,1.0,2.0,1196.0,24.0,2.0,8.0,1464.0,35.0,2.0,3.0,2415.0,6.0,0.0,1.0,302.0,22.0,1.0,4.0,902.0,10.0,1.0,0.0,401.0,Liga NOS,6.0,0.0,0.0,346.0,nan,nan,nan,nan,29/6/2010,Kevin,67059115.0,796.0,2/13/1992,18.0,0.0,0.0,0.0,0.0,2000.0,4904.0,3500.0,165.0,109.0,2136734.0,178.0,69.0,M/AM RC,1.0,1.0,1.0,2.0,1.0,1.0,1.0,1.0,2.0,2.0,1.0,12.0,11.0,13.0,9.0,15.0,8.0,5.0,10.0,5.0,4.0,16.0,9.0,7.0,16.0,10.0,10.0,11.0,13.0,9.0,15.0,11.0,12.0,16.0,6.0,13.0,7.0,12.0,11.0,13.0,15.0,9.0,7.0,6.0,12.0,13.0,20.0,12.0,6.0,13.0,8.0,10.0,5.0,12.0,11.0,13.0,15.0,12.0,13.0,13.0,13.0,3.0,nan,nan,nan
19/6/2011,Jonjo Shelvey,28011776,765,2/27/1992,19,0,0,0,0,3500,5800,5700,151,120,2640938,183,70,M/AM C,1,3,3,3,2,3,3,4,3,3,2,13,14,9,12,14,13,6,13,6,7,15,12,9,14,9,11,8,15,12,14,13,16,13,9,16,9,12,14,8,9,13,10,11,16,12,20,16,11,12,6,13,7,15,9,17,15,13,13,15,10,10,8,1,20,18,10,10,20,M/AM C,411,1,1,10,18,10,10,1,8,1,10,20,10,10,1,1,4718592.0,0,0,0,0,0,0,0,0,0,0,0,0,0,0,0,0,0,0,0,1,0,0,1,0,0,0,0,0,0,0,0,0,0,0,0,0,0,0,0,0,0,0,0,0,0,0,0,0,Jonjo Shelvey,ÃÂ£2.70m ,28.0,184.0,Midfielder - Central Midfield,right,Newcastle United,26.0,1.0,1.0,1106.0,28.0,11.0,4.0,1849.0,37.0,6.0,4.0,2276.0,42.0,6.0,8.0,3080.0,35.0,3.0,6.0,2770.0,34.0,1.0,7.0,2400.0,47.0,5.0,12.0,3817.0,33.0,2.0,3.0,2518.0,18.0,2.0,1.0,1039.0,Premier League,29.0,6.0,2.0,2254.0,6.0,1.0,0.0,522.0,nan,nan,nan,nan,nan,nan,nan,nan,nan,nan,nan,nan,nan,nan,nan,nan,nan,nan,nan,nan,nan,nan,nan,nan,nan,nan,nan,nan,nan,nan,nan,nan,nan,nan,nan,nan,nan,nan,nan,nan,nan,nan,nan,nan,nan,nan,nan,nan,nan,nan,nan,nan,nan,nan,nan,nan,nan,nan,nan,nan,nan,nan,nan,nan,nan,nan,nan,nan,nan,nan,nan,nan,nan,nan,nan,nan,nan,nan,nan,nan,nan,nan,nan,nan,19-06-17,18.3.4.28,Jonjo Shelvey,28011776,765,27-Feb-92,25,6,0,13,4,6000,6900,6900,145,138,38297950,185,83,M C,3,1,3,1,1,3,1,2,2,1,3,12,14,13,11,13,12,8,15,6,9,17,15,12,15,17,13,15,13,12,18,13,11,13,14,12,10,14,11,11,9,11,11,12,11,11,20,14,14,13,16,13,5,7,11,14,12,12,12,5,5,15,1,1,20,15,10,10,20,M C,401,1,1,10,15,5,5,1,1,1,14,20,10,10,1,1,140875000000000.0,0,0,0,0,0,0,0,0,1,0,0,0,0,0,0,0,0,1,0,0,0,0,1,0,0,0,0,0,0,0,0,0,0,0,0,0,0,1,0,0,0,0,0,0,0,0,0,1,Jonjo Shelvey,ÃÂ£13.50m ,28.0,184.0,Midfielder - Central Midfield,right,Newcastle United,47.0,5.0,12.0,3817.0,33.0,2.0,3.0,2518.0,18.0,2.0,1.0,1039.0,29.0,6.0,2.0,2254.0,6.0,1.0,0.0,522.0,Premier League,nan,nan,nan,nan,nan,nan,nan,nan,nan,nan,nan,nan,nan,nan,nan,nan,nan,nan,nan,nan,nan,nan,nan,nan,nan,nan,nan,nan,nan,nan,nan,nan,nan,nan,nan,nan,nan,nan,nan,nan,nan,nan,nan,nan,nan,nan,nan,nan,nan,nan,nan,nan,nan,nan,nan,nan,nan,nan,nan,nan,nan,nan,nan,nan,nan,nan,nan,nan,nan,nan,nan,nan,nan,nan,nan,nan,nan,nan,nan,nan,nan,nan,nan,nan,nan
19/6/2011,Jason Lowe,28027434,765,9/2/1991,19,0,0,0,0,3100,5750,6000,137,105,740561,176,75,D/M RC,3,1,1,2,3,3,2,1,2,3,2,8,4,8,7,10,10,6,8,2,9,11,5,13,10,10,11,7,14,12,13,10,14,9,8,7,9,13,17,13,11,11,9,7,15,11,20,18,13,10,12,4,6,9,6,14,7,7,13,12,11,6,16,1,20,1,16,1,20,D/M RC,423,1,1,1,1,1,1,1,1,16,12,20,1,10,1,1,67108928.0,0,0,0,0,0,0,1,0,0,0,0,0,0,0,0,0,0,0,0,0,0,0,0,0,0,0,1,0,0,0,0,0,0,0,0,0,0,0,0,0,0,0,0,0,0,0,0,0,Jason Lowe,ÃÂ£1.35m ,29.0,183.0,Midfielder - Defensive Midfield,right,Salford City,18.0,2.0,2.0,1581.0,38.0,0.0,1.0,3117.0,42.0,0.0,3.0,3291.0,42.0,1.0,3.0,3592.0,14.0,0.0,0.0,1071.0,13.0,0.0,1.0,1050.0,49.0,0.0,3.0,4363.0,11.0,0.0,0.0,572.0,37.0,0.0,0.0,3197.0,Premier League,34.0,0.0,1.0,2947.0,10.0,0.0,1.0,900.0,nan,nan,nan,nan,nan,nan,nan,nan,nan,nan,nan,nan,nan,nan,nan,nan,nan,nan,nan,nan,nan,nan,nan,nan,nan,nan,nan,nan,nan,nan,nan,nan,nan,nan,nan,nan,nan,nan,nan,nan,nan,nan,nan,nan,nan,nan,nan,nan,nan,nan,nan,nan,nan,nan,nan,nan,nan,nan,nan,nan,nan,nan,nan,nan,nan,nan,nan,nan,nan,nan,nan,nan,nan,nan,nan,nan,nan,nan,nan,nan,nan,nan,nan,nan
19/6/2011,Florian Trinks,92002691,771,3/11/1992,19,0,0,0,0,3250,5250,5750,143,108,1212135,185,74,M/AM RLC,2,2,1,2,3,2,1,4,2,2,3,13,14,16,10,14,16,6,14,6,4,11,12,5,14,13,10,7,8,7,12,6,5,15,3,14,5,7,11,14,13,7,10,13,12,12,20,10,9,8,14,13,10,13,9,18,8,12,6,3,5,18,1,1,17,20,19,19,20,M/AM RLC,526,1,1,13,20,19,19,1,1,1,5,17,15,15,1,1,0.0,0,0,0,0,0,0,0,0,0,0,0,0,0,0,0,0,0,0,0,0,0,0,0,0,0,0,0,0,0,0,0,0,0,0,0,0,0,0,0,0,0,0,0,0,0,0,0,0,Florian Trinks,ÃÂ£540Th. ,28.0,185.0,Midfielder - Attacking Midfield,right,Without Club,14.0,0.0,2.0,743.0,23.0,1.0,0.0,1593.0,22.0,4.0,9.0,1797.0,32.0,4.0,7.0,1626.0,20.0,1.0,0.0,932.0,17.0,1.0,2.0,773.0,13.0,4.0,2.0,879.0,10.0,1.0,1.0,529.0,24.0,9.0,4.0,1771.0,Bundesliga,nan,nan,nan,nan,nan,nan,nan,nan,nan,nan,nan,nan,nan,nan,nan,nan,nan,nan,nan,nan,nan,nan,nan,nan,nan,nan,nan,nan,nan,nan,nan,nan,nan,nan,nan,nan,nan,nan,nan,nan,nan,nan,nan,nan,nan,nan,nan,nan,nan,nan,nan,nan,nan,nan,nan,nan,nan,nan,nan,nan,nan,nan,nan,nan,nan,nan,nan,nan,nan,nan,nan,nan,nan,nan,nan,nan,nan,nan,nan,nan,nan,nan,nan,nan,nan,nan,nan,nan,nan,nan,nan,nan
19/6/2011,FlÃÂ¡vio Ferreira,55022003,788,10/19/1991,19,0,0,0,0,500,1500,1500,109,90,58202,176,76,DM/M C,2,2,1,2,3,1,3,4,2,3,3,8,8,9,7,10,8,11,8,10,13,9,10,13,10,12,12,12,12,12,10,12,12,7,10,10,12,12,12,10,10,9,11,8,11,10,20,10,10,12,9,8,9,10,12,10,13,10,9,10,10,8,14,1,20,1,1,1,20,DM/M C,421,1,1,1,1,1,1,14,1,1,17,20,1,1,1,1,0.0,0,0,0,0,0,0,0,0,0,0,0,0,0,0,0,0,0,0,0,0,0,0,0,0,0,0,0,0,0,0,0,0,0,0,0,0,0,0,0,0,0,0,0,0,0,0,0,0,FlÃÂ¡vio Ferreira,ÃÂ£360Th. ,29.0,180.0,Defender - Centre-Back,right,Retired,22.0,0.0,0.0,1868.0,22.0,0.0,0.0,1253.0,38.0,1.0,1.0,3450.0,16.0,0.0,0.0,1325.0,0.0,0.0,0.0,0.0,nan,nan,nan,nan,nan,nan,nan,nan,nan,nan,nan,nan,nan,nan,nan,nan,Liga NOS,nan,nan,nan,nan,nan,nan,nan,nan,nan,nan,nan,nan,nan,nan,nan,nan,nan,nan,nan,nan,nan,nan,nan,nan,nan,nan,nan,nan,nan,nan,nan,nan,nan,nan,nan,nan,nan,nan,nan,nan,nan,nan,nan,nan,nan,nan,nan,nan,nan,nan,nan,nan,nan,nan,nan,nan,nan,nan,nan,nan,nan,nan,nan,nan,nan,nan,nan,nan,nan,nan,nan,nan,nan,nan,nan,nan,nan,nan,nan,nan,nan,nan,nan,nan,nan,nan,nan,nan,nan,nan,nan,nan
19/6/2011,Fanol Perdedaj,91018525,771,7/16/1991,19,0,0,0,0,693,5000,5000,130,100,178910,172,66,DM C,3,1,1,2,1,3,1,4,3,3,1,9,7,6,4,10,9,11,8,3,12,10,10,13,10,15,11,17,10,12,10,10,18,3,11,9,11,17,18,10,12,12,6,5,17,12,20,13,15,10,12,10,3,9,12,12,7,14,16,15,14,2,1,1,15,1,1,1,15,DM C,301,1,1,1,1,1,1,1,1,1,20,15,1,1,1,1,137439000000.0,0,0,0,0,0,0,0,0,0,1,0,0,0,0,0,0,0,0,0,0,0,0,0,0,0,0,0,0,0,0,0,0,0,0,0,0,0,1,0,0,0,0,0,0,0,0,0,0,Fanol Perdedaj,ÃÂ£720Th. ,29.0,173.0,Midfielder - Central Midfield,right,1.FC SaarbrÃÂ¼cken,21.0,0.0,1.0,1169.0,27.0,2.0,0.0,2073.0,26.0,1.0,2.0,1917.0,21.0,0.0,2.0,1425.0,38.0,1.0,2.0,3330.0,32.0,3.0,5.0,2862.0,17.0,0.0,0.0,1275.0,14.0,2.0,0.0,875.0,30.0,6.0,5.0,2035.0,Bundesliga,24.0,5.0,8.0,1871.0,1.0,0.0,0.0,23.0,nan,nan,nan,nan,nan,nan,nan,nan,nan,nan,nan,nan,nan,nan,nan,nan,nan,nan,nan,nan,nan,nan,nan,nan,nan,nan,nan,nan,nan,nan,nan,nan,nan,nan,nan,nan,nan,nan,nan,nan,nan,nan,nan,nan,nan,nan,nan,nan,nan,nan,nan,nan,nan,nan,nan,nan,nan,nan,nan,nan,nan,nan,nan,nan,nan,nan,nan,nan,nan,nan,nan,nan,nan,nan,nan,nan,nan,nan,nan,nan,nan,nan,nan,nan
19/6/2011,Danilo Pereira,55013032,788,9/9/1991,19,0,0,0,0,2043,5000,5000,135,100,306312,186,70,DM/M C,1,2,3,3,2,3,3,1,2,1,3,10,11,10,9,11,10,11,10,7,10,10,11,11,11,12,11,11,11,10,10,11,12,11,11,11,10,12,11,11,12,11,14,8,14,12,20,11,11,12,8,12,8,12,12,14,12,10,15,16,16,3,10,1,20,10,10,1,20,DM/M C,421,1,1,1,10,1,1,10,1,1,18,20,1,10,1,1,0.0,0,0,0,0,0,0,0,0,0,0,0,0,0,0,0,0,0,0,0,0,0,0,0,0,0,0,0,0,0,0,0,0,0,0,0,0,0,0,0,0,0,0,0,0,0,0,0,0,Danilo Pereira,ÃÂ£450Th. ,29.0,188.0,Midfielder - Defensive Midfield,right,Paris Saint-Germain,15.0,2.0,0.0,1125.0,10.0,1.0,0.0,486.0,36.0,1.0,1.0,3056.0,32.0,1.0,1.0,2611.0,38.0,3.0,1.0,3390.0,45.0,6.0,2.0,3497.0,41.0,4.0,1.0,3599.0,30.0,4.0,3.0,2435.0,43.0,3.0,1.0,3523.0,Serie A,40.0,2.0,1.0,3149.0,5.0,0.0,0.0,450.0,nan,nan,nan,nan,nan,nan,nan,nan,nan,nan,nan,nan,nan,nan,nan,nan,nan,nan,nan,nan,nan,nan,nan,nan,nan,nan,nan,nan,nan,nan,nan,nan,nan,nan,nan,nan,nan,nan,nan,nan,nan,nan,nan,nan,nan,nan,nan,nan,nan,nan,nan,nan,nan,nan,nan,nan,nan,nan,nan,nan,nan,nan,nan,nan,nan,nan,nan,nan,nan,nan,nan,nan,nan,nan,nan,nan,nan,nan,nan,nan,nan,nan,nan,nan,19-06-17,18.3.4.28,Danilo Pereira,55013032,788,09-Sep-91,25,22,1,3,0,6000,7650,7650,160,153,57713232,188,83,DM C,3,1,3,3,3,2,2,3,2,3,2,8,9,10,9,12,8,11,11,11,16,13,12,16,12,12,15,15,13,17,12,14,14,9,12,14,16,17,15,14,13,15,12,10,18,15,20,16,16,17,9,13,6,11,14,14,8,10,15,16,16,3,12,1,15,1,1,1,15,DM C,301,1,1,1,1,1,1,12,1,1,20,15,1,1,1,1,32832.0,0,0,0,0,0,0,1,0,0,0,0,0,0,0,0,1,0,0,0,0,0,0,0,0,0,0,0,0,0,0,0,0,0,0,0,0,0,0,0,0,0,0,0,0,0,0,0,0,Danilo Pereira,ÃÂ£21.60m ,29.0,188.0,Midfielder - Defensive Midfield,right,Paris Saint-Germain,41.0,4.0,1.0,3599.0,30.0,4.0,3.0,2435.0,43.0,3.0,1.0,3523.0,40.0,2.0,1.0,3149.0,5.0,0.0,0.0,450.0,Liga NOS,15-07-16,17.3.2.23,Danilo Pereira,55013032.0,788.0,09-Sep-91,24.0,17.0,1.0,3.0,0.0,4500.0,7300.0,7700.0,162.0,154.0,69096441.0,188.0,83.0,DM C,1.0,2.0,3.0,3.0,1.0,3.0,3.0,2.0,2.0,3.0,1.0,8.0,9.0,10.0,9.0,12.0,9.0,8.0,11.0,11.0,15.0,13.0,12.0,16.0,12.0,12.0,14.0,15.0,12.0,16.0,13.0,14.0,14.0,9.0,12.0,14.0,16.0,17.0,15.0,14.0,13.0,16.0,12.0,13.0,18.0,15.0,20.0,16.0,15.0,15.0,9.0,11.0,6.0,11.0,13.0,14.0,8.0,10.0,15.0,16.0,16.0,3.0,Danilo Pereira,ÃÂ£18.00m ,Liga NOS
19/6/2011,Daniel Kofi Agyei,43026881,21,1/1/1992,19,0,0,0,0,1000,5500,5000,159,105,208774,181,75,DM C,2,1,1,3,2,2,3,3,3,3,2,7,6,9,7,12,6,9,9,14,14,14,5,13,13,12,15,11,12,12,10,10,18,6,8,12,10,10,12,11,12,12,9,5,15,13,20,13,12,12,8,14,5,8,18,16,17,14,16,18,14,4,1,1,15,1,1,1,15,DM C,301,1,1,1,1,1,1,1,1,1,20,15,1,1,1,1,1077936384.0,0,0,0,0,0,0,0,0,1,0,0,0,0,0,0,0,0,0,0,0,0,0,1,0,0,0,0,0,0,0,1,0,0,0,0,0,0,0,0,0,0,0,0,0,0,0,0,0,Daniel Kofi Agyei,ÃÂ£270Th. ,28.0,178.0,Midfielder - Defensive Midfield,both,Carrarese Calcio 1908,24.0,0.0,0.0,1771.0,33.0,1.0,0.0,3028.0,20.0,0.0,0.0,1143.0,20.0,0.0,0.0,1275.0,33.0,2.0,0.0,2139.0,25.0,2.0,0.0,2024.0,35.0,1.0,2.0,2617.0,30.0,1.0,0.0,2027.0,24.0,1.0,1.0,1841.0,Serie A,15.0,0.0,0.0,346.0,8.0,0.0,0.0,627.0,29/6/2010,Daniel Kofi Agyei,43026881.0,21.0,1/1/1992,18.0,0.0,0.0,0.0,0.0,1000.0,5500.0,4850.0,165.0,115.0,10336499.0,181.0,75.0,DM C,1.0,3.0,3.0,2.0,3.0,2.0,3.0,3.0,3.0,3.0,3.0,7.0,6.0,9.0,7.0,14.0,6.0,9.0,11.0,14.0,14.0,16.0,5.0,13.0,14.0,12.0,15.0,11.0,12.0,12.0,11.0,10.0,18.0,6.0,8.0,12.0,10.0,10.0,14.0,13.0,12.0,12.0,9.0,5.0,15.0,14.0,20.0,13.0,12.0,12.0,8.0,14.0,5.0,8.0,18.0,16.0,17.0,14.0,16.0,18.0,14.0,4.0,Daniel Kofi Agyei,ÃÂÃÂ£225Th. ,Serie A
19/6/2011,Cristian Battocchio,43072700,1649,2/10/1992,19,0,0,0,0,1550,5450,5400,145,108,406871,160,55,M C,2,2,1,2,2,3,3,2,2,1,2,12,8,15,8,14,12,1,13,3,8,16,12,11,14,14,10,8,13,8,15,9,13,15,7,6,7,11,13,14,15,8,1,12,10,12,20,9,5,10,7,12,4,10,16,13,12,12,11,14,16,3,1,1,20,1,1,1,20,M C,401,1,1,1,1,1,1,1,1,1,15,20,1,1,1,1,4194304.0,0,0,0,0,0,0,0,0,0,0,0,0,0,0,0,0,0,0,0,0,0,0,1,0,0,0,0,0,0,0,0,0,0,0,0,0,0,0,0,0,0,0,0,0,0,0,0,0,Cristian Battocchio,ÃÂ£720Th. ,28.0,177.0,Midfielder - Central Midfield,right,Stade Brest 29,23.0,5.0,0.0,1945.0,15.0,1.0,0.0,955.0,26.0,2.0,2.0,1577.0,41.0,5.0,3.0,2557.0,32.0,0.0,3.0,2328.0,33.0,5.0,4.0,2591.0,38.0,8.0,6.0,3316.0,36.0,1.0,2.0,2297.0,14.0,2.0,3.0,648.0,Serie A,27.0,3.0,2.0,1506.0,5.0,0.0,0.0,177.0,nan,nan,nan,nan,nan,nan,nan,nan,nan,nan,nan,nan,nan,nan,nan,nan,nan,nan,nan,nan,nan,nan,nan,nan,nan,nan,nan,nan,nan,nan,nan,nan,nan,nan,nan,nan,nan,nan,nan,nan,nan,nan,nan,nan,nan,nan,nan,nan,nan,nan,nan,nan,nan,nan,nan,nan,nan,nan,nan,nan,nan,nan,nan,nan,nan,nan,nan,nan,nan,nan,nan,nan,nan,nan,nan,nan,nan,nan,nan,nan,nan,nan,nan,nan
19/6/2011,Alexander Merkel,35017440,771,2/22/1992,19,0,0,0,0,1922,5039,5533,142,112,292258,179,70,M/AM RC,2,2,1,1,3,2,1,1,1,3,1,13,14,10,8,12,14,9,12,7,4,13,8,5,14,9,13,11,9,11,14,10,14,9,7,14,7,9,11,13,14,9,9,11,14,15,20,11,8,12,7,7,8,16,17,14,15,11,15,18,16,10,1,1,20,17,16,12,20,M/AM RC,413,1,1,1,17,9,14,1,1,1,1,20,12,16,1,1,16.0,0,0,0,0,1,0,0,0,0,0,0,0,0,0,0,0,0,0,0,0,0,0,0,0,0,0,0,0,0,0,0,0,0,0,0,0,0,0,0,0,0,0,0,0,0,0,0,0,Alexander Merkel,ÃÂ£4.50m ,28.0,179.0,Midfielder - Central Midfield,right,Al-Faisaly Harmah,19.0,1.0,1.0,1132.0,17.0,0.0,3.0,1139.0,12.0,1.0,0.0,462.0,12.0,1.0,2.0,640.0,11.0,0.0,1.0,405.0,2.0,0.0,0.0,109.0,11.0,0.0,1.0,628.0,18.0,1.0,4.0,1247.0,36.0,0.0,2.0,2947.0,Serie A,28.0,2.0,4.0,2341.0,2.0,0.0,0.0,180.0,nan,nan,nan,nan,nan,nan,nan,nan,nan,nan,nan,nan,nan,nan,nan,nan,nan,nan,nan,nan,nan,nan,nan,nan,nan,nan,nan,nan,nan,nan,nan,nan,nan,nan,nan,nan,nan,nan,nan,nan,nan,nan,nan,nan,nan,nan,nan,nan,nan,nan,nan,nan,nan,nan,nan,nan,nan,nan,nan,nan,nan,nan,nan,nan,nan,nan,nan,nan,nan,nan,nan,nan,nan,nan,nan,nan,nan,nan,nan,nan,nan,nan,nan,nan
19/6/2011,Akaki Gogia,92025869,771,1/18/1992,19,0,0,0,0,1599,5900,5900,129,110,646382,177,76,M/AM C,2,1,3,1,2,2,2,1,1,2,1,12,8,12,13,12,14,12,13,1,8,11,10,11,13,11,14,3,7,9,12,12,7,10,2,9,10,11,11,12,11,7,8,14,10,13,20,8,7,10,9,10,7,10,7,14,14,17,12,11,13,13,1,1,18,20,1,1,20,M/AM C,521,1,1,15,20,1,1,1,1,1,1,18,1,1,1,1,0.0,0,0,0,0,0,0,0,0,0,0,0,0,0,0,0,0,0,0,0,0,0,0,0,0,0,0,0,0,0,0,0,0,0,0,0,0,0,0,0,0,0,0,0,0,0,0,0,0,Akaki Gogia,ÃÂ£540Th. ,28.0,178.0,Forward - Right Winger,both,1.FC Union Berlin,36.0,18.0,2.0,2954.0,14.0,0.0,1.0,588.0,25.0,1.0,3.0,1413.0,36.0,8.0,5.0,2962.0,38.0,13.0,10.0,3267.0,14.0,0.0,1.0,503.0,24.0,10.0,2.0,1800.0,22.0,2.0,5.0,1471.0,31.0,6.0,5.0,1505.0,Bundesliga,3.0,0.0,0.0,120.0,0.0,0.0,0.0,0.0,nan,nan,nan,nan,nan,nan,nan,nan,nan,nan,nan,nan,nan,nan,nan,nan,nan,nan,nan,nan,nan,nan,nan,nan,nan,nan,nan,nan,nan,nan,nan,nan,nan,nan,nan,nan,nan,nan,nan,nan,nan,nan,nan,nan,nan,nan,nan,nan,nan,nan,nan,nan,nan,nan,nan,nan,nan,nan,nan,nan,nan,nan,nan,nan,nan,nan,nan,nan,nan,nan,nan,nan,nan,nan,nan,nan,nan,nan,nan,nan,nan,nan,nan,nan
19/6/2011,Tolgay Arslan,91003495,799,8/16/1990,20,0,0,1,0,3650,6000,6000,144,120,1711244,179,76,AM C,2,2,2,2,2,2,2,3,3,1,3,8,10,15,13,13,11,7,12,5,6,13,11,6,14,11,11,13,13,13,13,11,8,8,10,11,4,11,13,12,13,11,8,16,13,12,20,13,9,7,14,10,7,10,9,16,13,7,8,4,7,7,1,1,15,20,10,10,20,AM C,501,1,1,12,20,10,10,1,1,1,1,15,1,1,1,1,0.0,0,0,0,0,0,0,0,0,0,0,0,0,0,0,0,0,0,0,0,0,0,0,0,0,0,0,0,0,0,0,0,0,0,0,0,0,0,0,0,0,0,0,0,0,0,0,0,0,Tolgay Arslan,ÃÂ£1.35m ,30.0,180.0,Midfielder - Central Midfield,both,Udinese Calcio,35.0,6.0,5.0,2427.0,9.0,1.0,0.0,442.0,26.0,0.0,1.0,1664.0,37.0,1.0,3.0,2834.0,37.0,2.0,2.0,2309.0,7.0,0.0,1.0,222.0,44.0,0.0,8.0,2540.0,43.0,0.0,3.0,2590.0,28.0,1.0,0.0,1669.0,Bundesliga,21.0,2.0,1.0,1034.0,4.0,0.0,0.0,247.0,nan,nan,nan,nan,nan,nan,nan,nan,nan,nan,nan,nan,nan,nan,nan,nan,nan,nan,nan,nan,nan,nan,nan,nan,nan,nan,nan,nan,nan,nan,nan,nan,nan,nan,nan,nan,nan,nan,nan,nan,nan,nan,nan,nan,nan,nan,nan,nan,nan,nan,nan,nan,nan,nan,nan,nan,nan,nan,nan,nan,nan,nan,nan,nan,nan,nan,nan,nan,nan,nan,nan,nan,nan,nan,nan,nan,nan,nan,nan,nan,nan,nan,nan,nan
19/6/2011,SÃÂ¶ren Bertram,91018461,771,6/5/1991,20,0,0,0,0,2250,5700,5700,135,114,1316822,183,70,M/AM RC,1,2,1,1,1,2,3,5,1,3,3,11,12,12,9,13,10,7,12,10,9,12,10,8,12,11,12,15,9,10,13,10,10,13,8,14,9,12,14,13,13,10,11,20,8,13,11,9,9,11,7,4,5,10,5,1,7,11,13,14,5,8,1,1,20,20,20,12,17,M/AM RC,413,1,1,1,1,1,20,1,1,1,14,17,12,20,1,1,0.0,0,0,0,0,0,0,0,0,0,0,0,0,0,0,0,0,0,0,0,0,0,0,0,0,0,0,0,0,0,0,0,0,0,0,0,0,0,0,0,0,0,0,0,0,0,0,0,0,SÃÂ¶ren Bertram,ÃÂ£360Th. ,29.0,185.0,Forward - Left Winger,left,1.FC Magdeburg,19.0,2.0,0.0,790.0,25.0,6.0,6.0,2187.0,16.0,3.0,1.0,960.0,37.0,12.0,6.0,2925.0,30.0,3.0,11.0,2175.0,35.0,10.0,8.0,2983.0,8.0,0.0,0.0,217.0,25.0,7.0,1.0,1247.0,21.0,1.0,2.0,924.0,Bundesliga,35.0,10.0,4.0,2790.0,6.0,0.0,0.0,299.0,nan,nan,nan,nan,nan,nan,nan,nan,nan,nan,nan,nan,nan,nan,nan,nan,nan,nan,nan,nan,nan,nan,nan,nan,nan,nan,nan,nan,nan,nan,nan,nan,nan,nan,nan,nan,nan,nan,nan,nan,nan,nan,nan,nan,nan,nan,nan,nan,nan,nan,nan,nan,nan,nan,nan,nan,nan,nan,nan,nan,nan,nan,nan,nan,nan,nan,nan,nan,nan,nan,nan,nan,nan,nan,nan,nan,nan,nan,nan,nan,nan,nan,nan,nan
19/6/2011,Sergio Canales,67053076,796,2/16/1991,20,0,0,0,0,5600,7000,7000,166,142,0,176,70,AM C,1,3,3,3,3,3,3,3,1,1,2,15,14,16,12,18,14,8,13,9,4,17,13,7,18,7,12,8,14,11,19,13,11,18,8,12,6,13,10,14,17,10,8,20,11,12,11,11,7,8,6,15,6,10,12,14,9,12,13,15,13,7,1,1,15,20,10,14,20,AM C,501,1,1,8,20,14,10,1,1,1,1,15,12,9,1,1,17592200000000.0,0,0,0,0,1,0,0,1,0,0,0,0,0,0,0,0,0,0,0,0,0,1,0,0,0,0,0,0,0,0,0,0,0,0,0,0,0,0,0,0,0,0,0,0,1,0,0,0,Sergio Canales,ÃÂ£4.50m ,29.0,180.0,Midfielder - Attacking Midfield,left,Real Betis BalompiÃÂ©,15.0,0.0,1.0,518.0,16.0,1.0,2.0,775.0,15.0,2.0,2.0,636.0,45.0,4.0,4.0,2408.0,43.0,5.0,6.0,2965.0,18.0,1.0,0.0,987.0,37.0,0.0,4.0,1248.0,45.0,5.0,11.0,2659.0,46.0,9.0,3.0,3812.0,LaLiga,37.0,6.0,6.0,3257.0,7.0,1.0,2.0,599.0,29/6/2010,Sergio Canales,67053076.0,796.0,2/16/1991,19.0,0.0,0.0,0.0,0.0,5184.0,7000.0,7000.0,179.0,144.0,28983635.0,176.0,65.0,M/AM C,1.0,2.0,2.0,2.0,3.0,1.0,2.0,4.0,2.0,3.0,1.0,15.0,14.0,16.0,12.0,18.0,14.0,6.0,13.0,7.0,4.0,17.0,13.0,7.0,18.0,7.0,13.0,10.0,17.0,12.0,19.0,13.0,14.0,19.0,9.0,14.0,7.0,13.0,11.0,13.0,16.0,10.0,8.0,20.0,11.0,12.0,11.0,12.0,6.0,10.0,6.0,15.0,6.0,10.0,12.0,16.0,9.0,13.0,13.0,15.0,13.0,7.0,Sergio Canales,ÃÂÃÂ£5.40m ,LaLiga,19-06-17,18.3.4.28,Sergio Canales,67053076,796,16-Feb-91,26,0,0,7,5,5100,6800,6800,152,138,9760773,179,65,M/AM C,1,3,2,1,1,3,1,3,1,1,2,15,13,15,12,17,14,8,13,9,5,17,13,7,17,7,14,8,14,13,15,14,11,17,10,13,10,14,10,13,15,13,8,20,10,12,9,11,10,10,6,13,15,6,15,14,9,12,13,16,14,7,1,1,17,20,14,14,20,M/AM C,521,1,1,8,20,14,14,1,1,1,1,17,1,1,1,1,17592200000000.0,0,0,0,0,0,0,0,1,0,0,0,0,0,0,0,0,0,0,0,0,0,1,0,0,0,0,0,0,0,0,0,0,0,0,0,0,0,0,0,0,0,0,0,0,1,0,0,0,Sergio Canales,ÃÂ£4.50m ,29.0,180.0,Midfielder - Attacking Midfield,left,Real Betis BalompiÃÂ©,37.0,0.0,4.0,1248.0,45.0,5.0,11.0,2659.0,46.0,9.0,3.0,3812.0,37.0,6.0,6.0,3257.0,7.0,1.0,2.0,599.0,LaLiga,15-07-16,17.3.2.23,Sergio Canales,67053076.0,796.0,16-Feb-91,25.0,0.0,0.0,7.0,5.0,5100.0,6900.0,6900.0,152.0,137.0,13553153.0,179.0,65.0,M/AM C,1.0,1.0,2.0,3.0,3.0,1.0,3.0,3.0,3.0,2.0,3.0,15.0,13.0,14.0,12.0,17.0,15.0,8.0,13.0,9.0,5.0,17.0,13.0,7.0,17.0,7.0,14.0,8.0,14.0,12.0,15.0,14.0,11.0,17.0,10.0,13.0,10.0,14.0,10.0,13.0,15.0,13.0,8.0,20.0,10.0,12.0,9.0,11.0,10.0,10.0,6.0,18.0,15.0,6.0,15.0,14.0,9.0,12.0,13.0,16.0,14.0,7.0,Sergio Canales,ÃÂ£2.70m ,LaLiga
19/6/2011,Robert Gucher,28018443,755,2/20/1991,20,0,0,0,0,2047,4746,4545,148,105,187155,183,80,DM/M C,3,3,3,1,1,3,2,1,1,1,1,7,7,10,6,12,10,8,11,1,12,13,9,11,12,11,12,12,10,9,14,9,10,8,8,11,11,14,14,11,13,11,9,5,14,12,20,14,14,9,12,10,10,10,15,4,13,11,9,11,8,12,1,1,20,1,8,1,20,DM/M C,311,1,1,1,1,1,1,1,1,1,20,20,1,8,1,1,0.0,0,0,0,0,0,0,0,0,0,0,0,0,0,0,0,0,0,0,0,0,0,0,0,0,0,0,0,0,0,0,0,0,0,0,0,0,0,0,0,0,0,0,0,0,0,0,0,0,Robert Tesche,ÃÂ£1.13m ,33.0,182.0,Midfielder - Central Midfield,right,VfL Bochum,12.0,0.0,0.0,537.0,26.0,2.0,1.0,1245.0,18.0,0.0,1.0,1112.0,21.0,2.0,1.0,1330.0,37.0,4.0,5.0,2903.0,25.0,1.0,1.0,1615.0,26.0,0.0,0.0,1852.0,19.0,2.0,0.0,1188.0,31.0,3.0,2.0,2440.0,Bundesliga,26.0,1.0,1.0,1891.0,6.0,0.0,0.0,451.0,nan,nan,nan,nan,nan,nan,nan,nan,nan,nan,nan,nan,nan,nan,nan,nan,nan,nan,nan,nan,nan,nan,nan,nan,nan,nan,nan,nan,nan,nan,nan,nan,nan,nan,nan,nan,nan,nan,nan,nan,nan,nan,nan,nan,nan,nan,nan,nan,nan,nan,nan,nan,nan,nan,nan,nan,nan,nan,nan,nan,nan,nan,nan,nan,nan,nan,nan,nan,nan,nan,nan,nan,nan,nan,nan,nan,nan,nan,nan,nan,nan,nan,nan,nan
19/6/2011,Recio,67138565,796,1/11/1991,20,0,0,1,0,3750,5900,5900,142,120,1242458,184,75,DM/M C,3,3,1,2,1,2,2,5,3,2,2,7,10,9,9,12,9,12,9,9,12,14,4,14,12,13,15,13,13,13,13,13,12,7,9,10,13,13,12,12,12,10,9,7,12,13,20,14,12,10,7,12,7,12,12,15,11,12,11,11,13,8,1,1,20,1,1,1,20,DM/M C,421,1,1,1,1,1,1,1,1,1,18,20,1,1,1,1,96.0,0,0,0,0,0,1,1,0,0,0,0,0,0,0,0,0,0,0,0,0,0,0,0,0,0,0,0,0,0,0,0,0,0,0,0,0,0,0,0,0,0,0,0,0,0,0,0,0,Recio,ÃÂ£1.80m ,29.0,183.0,Midfielder - Central Midfield,right,SD Eibar,25.0,2.0,2.0,1778.0,8.0,0.0,0.0,318.0,22.0,2.0,0.0,1616.0,32.0,2.0,0.0,2473.0,36.0,3.0,3.0,1932.0,34.0,0.0,5.0,2840.0,18.0,3.0,2.0,1358.0,23.0,2.0,2.0,1932.0,22.0,0.0,0.0,1647.0,LaLiga,26.0,0.0,0.0,1601.0,4.0,0.0,0.0,175.0,nan,nan,nan,nan,nan,nan,nan,nan,nan,nan,nan,nan,nan,nan,nan,nan,nan,nan,nan,nan,nan,nan,nan,nan,nan,nan,nan,nan,nan,nan,nan,nan,nan,nan,nan,nan,nan,nan,nan,nan,nan,nan,nan,nan,nan,nan,nan,nan,nan,nan,nan,nan,nan,nan,nan,nan,nan,nan,nan,nan,nan,nan,nan,nan,nan,nan,nan,nan,nan,nan,nan,nan,nan,nan,nan,nan,nan,nan,nan,nan,nan,nan,nan,nan,19-06-17,18.3.4.28,Recio,67138565,796,11-Jan-91,26,0,0,1,0,4500,7100,6900,148,138,14482157,182,79,DM/M C,2,1,1,1,2,4,1,1,1,3,3,12,12,14,11,15,13,11,14,9,13,14,11,12,15,17,15,14,13,14,14,14,12,5,9,14,15,18,16,11,13,9,11,8,12,10,20,15,13,12,13,12,7,12,18,15,15,12,14,6,8,13,1,1,20,10,1,8,20,DM/M C,421,1,1,1,10,1,1,1,1,1,17,20,8,1,1,1,137439000000.0,0,0,0,0,0,1,1,0,0,0,0,0,0,0,0,0,0,1,0,0,0,0,0,0,0,0,0,0,0,0,0,0,0,0,0,0,0,1,0,0,0,0,0,0,0,0,0,0,Recio,ÃÂ£1.80m ,29.0,183.0,Midfielder - Central Midfield,right,SD Eibar,18.0,3.0,2.0,1358.0,23.0,2.0,2.0,1932.0,22.0,0.0,0.0,1647.0,26.0,0.0,0.0,1601.0,4.0,0.0,0.0,175.0,LaLiga,15-07-16,17.3.2.23,Recio,67138565.0,796.0,11-Jan-91,25.0,0.0,0.0,1.0,0.0,4500.0,7000.0,7000.0,150.0,140.0,9999999.0,182.0,79.0,DM/M C,2.0,2.0,4.0,2.0,1.0,2.0,1.0,3.0,2.0,1.0,2.0,12.0,11.0,14.0,11.0,15.0,13.0,11.0,14.0,9.0,13.0,15.0,11.0,12.0,15.0,17.0,15.0,14.0,12.0,14.0,15.0,14.0,12.0,7.0,9.0,15.0,15.0,18.0,16.0,11.0,13.0,9.0,11.0,8.0,12.0,10.0,20.0,15.0,13.0,12.0,7.0,12.0,7.0,12.0,10.0,15.0,15.0,12.0,14.0,6.0,8.0,13.0,Recio,ÃÂ£3.15m ,LaLiga
19/6/2011,RafaÃÂ«l Dias,34007437,788,1/29/1991,20,0,0,0,0,2350,4769,4750,145,106,220686,174,69,M/AM C,3,2,3,3,2,3,3,6,1,2,1,14,12,11,7,13,14,7,13,5,3,11,14,6,13,9,12,11,13,13,13,11,13,13,7,9,8,12,12,15,14,12,7,5,14,13,20,15,9,13,9,10,8,10,7,13,14,13,14,15,15,6,1,1,18,20,12,1,20,M/AM C,521,1,1,10,20,1,12,1,1,1,14,18,1,12,1,1,0.0,0,0,0,0,0,0,0,0,0,0,0,0,0,0,0,0,0,0,0,0,0,0,0,0,0,0,0,0,0,0,0,0,0,0,0,0,0,0,0,0,0,0,0,0,0,0,0,0,RafaÃÂ«l Dias,ÃÂ£270Th. ,29.0,180.0,Midfielder - Central Midfield,right,FC BesanÃÂ§on,4.0,0.0,0.0,23.0,4.0,0.0,0.0,51.0,17.0,1.0,3.0,884.0,23.0,2.0,2.0,1378.0,12.0,1.0,0.0,635.0,25.0,3.0,0.0,1738.0,nan,nan,nan,nan,27.0,2.0,2.0,1784.0,nan,nan,nan,nan,Ligue 1,nan,nan,nan,nan,nan,nan,nan,nan,nan,nan,nan,nan,nan,nan,nan,nan,nan,nan,nan,nan,nan,nan,nan,nan,nan,nan,nan,nan,nan,nan,nan,nan,nan,nan,nan,nan,nan,nan,nan,nan,nan,nan,nan,nan,nan,nan,nan,nan,nan,nan,nan,nan,nan,nan,nan,nan,nan,nan,nan,nan,nan,nan,nan,nan,nan,nan,nan,nan,nan,nan,nan,nan,nan,nan,nan,nan,nan,nan,nan,nan,nan,nan,nan,nan,nan,nan,nan,nan,nan,nan,nan,nan
19/6/2011,Prince Segbefia,12012410,50,3/11/1991,20,0,0,0,0,2450,4904,4900,133,109,98884,176,70,DM/M C,3,3,2,3,3,2,3,5,3,1,2,6,10,11,6,12,7,9,12,6,7,10,8,14,11,11,13,15,11,11,13,10,10,11,7,9,11,13,15,15,14,12,8,5,13,13,20,14,11,13,11,10,8,8,12,14,10,8,17,2,16,7,7,7,17,8,7,1,17,DM/M C,311,1,1,1,8,1,1,1,1,7,20,17,1,1,1,7,34359738496.0,0,0,0,0,0,0,0,1,0,0,0,0,0,0,0,0,0,0,0,0,0,0,0,0,0,0,0,0,0,0,0,0,0,0,0,1,0,0,0,0,0,0,0,0,0,0,0,0,Prince Segbefia,ÃÂ£630Th. ,29.0,179.0,Midfielder - Central Midfield,right,Tuzlaspor,4.0,0.0,0.0,307.0,19.0,0.0,0.0,1348.0,23.0,0.0,0.0,1176.0,24.0,3.0,1.0,1777.0,14.0,1.0,0.0,877.0,24.0,5.0,0.0,2136.0,32.0,4.0,0.0,2483.0,14.0,0.0,1.0,790.0,32.0,3.0,1.0,2561.0,Ligue 1,2.0,0.0,0.0,74.0,7.0,0.0,0.0,418.0,nan,nan,nan,nan,nan,nan,nan,nan,nan,nan,nan,nan,nan,nan,nan,nan,nan,nan,nan,nan,nan,nan,nan,nan,nan,nan,nan,nan,nan,nan,nan,nan,nan,nan,nan,nan,nan,nan,nan,nan,nan,nan,nan,nan,nan,nan,nan,nan,nan,nan,nan,nan,nan,nan,nan,nan,nan,nan,nan,nan,nan,nan,nan,nan,nan,nan,nan,nan,nan,nan,nan,nan,nan,nan,nan,nan,nan,nan,nan,nan,nan,nan,nan,nan
19/6/2011,Ness Zamir,42008801,775,10/31/1990,20,0,0,10,1,1600,3960,3600,116,72,15335,178,69,AM LC,1,3,3,2,1,3,3,5,2,3,2,7,9,10,9,9,8,2,7,2,4,11,8,7,13,12,9,2,8,6,10,8,8,17,4,9,2,6,10,12,12,11,9,9,12,12,20,7,2,10,13,10,6,10,11,10,7,13,12,11,14,5,1,1,15,20,13,18,20,AM LC,504,1,1,8,20,18,13,1,1,1,1,15,15,10,1,1,0.0,0,0,0,0,0,0,0,0,0,0,0,0,0,0,0,0,0,0,0,0,0,0,0,0,0,0,0,0,0,0,0,0,0,0,0,0,0,0,0,0,0,0,0,0,0,0,0,0,nan,nan,nan,nan,nan,nan,nan,nan,nan,nan,nan,nan,nan,nan,nan,nan,nan,nan,nan,nan,nan,nan,nan,nan,nan,nan,nan,nan,nan,nan,nan,nan,nan,nan,nan,nan,nan,nan,nan,nan,nan,nan,nan,nan,nan,nan,nan,nan,nan,nan,nan,nan,nan,nan,nan,nan,nan,nan,nan,nan,nan,nan,nan,nan,nan,nan,nan,nan,nan,nan,nan,nan,nan,nan,nan,nan,nan,nan,nan,nan,nan,nan,nan,nan,nan,nan,nan,nan,nan,nan,nan,nan,nan,nan,nan,nan,nan,nan,nan,nan,nan,nan,nan,nan,nan,nan,nan,nan,nan,nan,nan,nan,nan,nan,nan,nan,nan,nan,nan,nan,nan,nan,nan,nan,nan,nan,nan,nan,nan,nan,nan,nan,nan,nan,nan,nan
19/6/2011,Mubarak Wakaso,12006112,21,7/25/1990,20,0,0,0,0,4250,5489,6250,148,122,680661,169,67,DM/M LC,1,1,1,3,3,3,3,3,1,1,1,12,13,12,8,11,11,5,14,8,10,13,9,13,12,18,11,16,7,8,12,9,14,12,6,12,8,13,17,16,16,13,6,20,17,14,7,18,11,12,14,10,5,9,9,11,9,7,8,8,7,14,10,12,20,9,1,15,20,DM/M LC,424,1,1,1,8,9,1,1,10,1,16,20,15,1,12,1,137573000000.0,0,0,0,0,0,0,0,0,0,0,0,0,0,0,0,0,0,1,0,0,0,0,0,0,0,0,0,1,0,0,0,0,0,0,0,0,0,1,0,0,0,0,0,0,0,0,0,0,Mubarak Wakaso,ÃÂ£1.80m ,30.0,171.0,Midfielder - Central Midfield,left,Jiangsu Suning,38.0,3.0,1.0,2011.0,10.0,0.0,0.0,311.0,27.0,3.0,6.0,1917.0,18.0,2.0,2.0,841.0,13.0,1.0,1.0,849.0,24.0,2.0,2.0,1204.0,27.0,2.0,3.0,2158.0,24.0,0.0,2.0,1374.0,29.0,1.0,1.0,1663.0,LaLiga,32.0,0.0,1.0,2466.0,nan,nan,nan,nan,nan,nan,nan,nan,nan,nan,nan,nan,nan,nan,nan,nan,nan,nan,nan,nan,nan,nan,nan,nan,nan,nan,nan,nan,nan,nan,nan,nan,nan,nan,nan,nan,nan,nan,nan,nan,nan,nan,nan,nan,nan,nan,nan,nan,nan,nan,nan,nan,nan,nan,nan,nan,nan,nan,nan,nan,nan,nan,nan,nan,nan,nan,nan,nan,nan,nan,nan,nan,nan,nan,nan,nan,nan,nan,nan,nan,nan,nan,nan,nan,nan,nan,nan,nan,19-06-17,18.3.4.28,Mubarak Wakaso,12006112,21,25-Jul-90,26,41,10,2,0,4500,6500,6350,135,127,4427173,171,78,M/AM RLC,3,3,2,3,1,1,1,4,3,2,2,11,14,12,8,9,11,8,13,14,12,11,9,12,10,17,8,16,7,8,12,8,11,12,4,12,10,9,17,15,14,12,7,20,17,15,10,16,10,11,14,11,8,11,12,12,10,7,7,7,5,15,10,14,20,18,17,20,17,M/AM RLC,416,1,1,1,10,18,17,1,10,1,10,17,20,16,14,1,137573000000.0,0,0,0,0,0,0,0,0,0,0,0,0,0,0,0,0,0,1,0,0,0,0,0,0,0,0,0,1,0,0,0,0,0,0,0,0,0,1,0,0,0,0,0,0,0,0,0,0,Mubarak Wakaso,ÃÂ£1.08m ,30.0,171.0,Midfielder - Central Midfield,left,Jiangsu Suning,27.0,2.0,3.0,2158.0,24.0,0.0,2.0,1374.0,29.0,1.0,1.0,1663.0,32.0,0.0,1.0,2466.0,nan,nan,nan,nan,LaLiga,15-07-16,17.3.2.23,Mubarak Wakaso,12006112.0,21.0,25-Jul-90,25.0,41.0,10.0,2.0,0.0,4500.0,6500.0,6500.0,135.0,130.0,3816415.0,171.0,78.0,M/AM RLC,3.0,2.0,3.0,1.0,1.0,4.0,4.0,2.0,1.0,3.0,4.0,11.0,14.0,12.0,8.0,9.0,11.0,8.0,13.0,14.0,12.0,11.0,9.0,12.0,10.0,17.0,8.0,16.0,7.0,8.0,12.0,8.0,15.0,12.0,4.0,12.0,10.0,9.0,17.0,16.0,15.0,12.0,7.0,20.0,17.0,15.0,10.0,16.0,10.0,11.0,14.0,11.0,8.0,11.0,12.0,14.0,10.0,8.0,8.0,7.0,6.0,14.0,Mubarak Wakaso,ÃÂ£900Th. ,LaLiga
19/6/2011,Marc Hornschuh,35011184,771,3/2/1991,20,0,0,3,0,2800,5250,5250,122,105,225945,188,71,D/DM/M RC,3,1,3,3,1,1,2,2,2,1,3,5,6,6,5,10,5,11,6,12,14,9,8,14,9,12,13,13,11,9,7,11,11,5,7,6,13,14,12,10,12,13,14,10,12,12,20,14,13,12,9,11,8,13,6,14,12,18,12,11,12,5,20,15,16,1,17,5,20,D/DM/M RC,123,1,1,1,1,1,1,20,5,17,19,16,5,5,5,15,0.0,0,0,0,0,0,0,0,0,0,0,0,0,0,0,0,0,0,0,0,0,0,0,0,0,0,0,0,0,0,0,0,0,0,0,0,0,0,0,0,0,0,0,0,0,0,0,0,0,Marc Hornschuh,ÃÂ£225Th. ,29.0,188.0,Defender - Centre-Back,right,Hamburger SV II,25.0,1.0,0.0,2241.0,17.0,1.0,0.0,1440.0,31.0,0.0,3.0,2466.0,36.0,2.0,1.0,3240.0,33.0,1.0,0.0,2832.0,27.0,2.0,2.0,2280.0,22.0,0.0,1.0,1908.0,7.0,0.0,0.0,609.0,4.0,0.0,0.0,341.0,Bundesliga,7.0,0.0,0.0,571.0,9.0,0.0,0.0,781.0,nan,nan,nan,nan,nan,nan,nan,nan,nan,nan,nan,nan,nan,nan,nan,nan,nan,nan,nan,nan,nan,nan,nan,nan,nan,nan,nan,nan,nan,nan,nan,nan,nan,nan,nan,nan,nan,nan,nan,nan,nan,nan,nan,nan,nan,nan,nan,nan,nan,nan,nan,nan,nan,nan,nan,nan,nan,nan,nan,nan,nan,nan,nan,nan,nan,nan,nan,nan,nan,nan,nan,nan,nan,nan,nan,nan,nan,nan,nan,nan,nan,nan,nan,nan
19/6/2011,Manuel Zeitz,91016944,771,8/1/1990,20,0,0,0,0,3000,5250,5250,139,105,419575,180,74,DM/M C,3,3,3,3,1,2,1,1,1,1,3,12,11,11,11,12,10,9,11,5,11,14,12,11,12,14,12,12,12,11,12,13,13,12,10,12,11,14,15,11,12,10,10,7,11,10,20,12,7,11,6,10,5,13,9,15,10,12,11,11,11,7,11,1,18,13,1,1,18,DM/M C,311,1,1,1,13,1,1,11,1,1,20,18,1,1,1,1,0.0,0,0,0,0,0,0,0,0,0,0,0,0,0,0,0,0,0,0,0,0,0,0,0,0,0,0,0,0,0,0,0,0,0,0,0,0,0,0,0,0,0,0,0,0,0,0,0,0,Manuel Zeitz,ÃÂ£360Th. ,30.0,181.0,Midfielder - Defensive Midfield,right,1.FC SaarbrÃÂ¼cken,31.0,6.0,6.0,2621.0,26.0,4.0,1.0,2246.0,25.0,2.0,0.0,1197.0,27.0,0.0,0.0,1596.0,23.0,6.0,0.0,2039.0,33.0,2.0,1.0,2780.0,32.0,3.0,2.0,2770.0,34.0,4.0,3.0,2914.0,34.0,5.0,1.0,3000.0,Bundesliga,29.0,3.0,2.0,2604.0,6.0,0.0,0.0,540.0,nan,nan,nan,nan,nan,nan,nan,nan,nan,nan,nan,nan,nan,nan,nan,nan,nan,nan,nan,nan,nan,nan,nan,nan,nan,nan,nan,nan,nan,nan,nan,nan,nan,nan,nan,nan,nan,nan,nan,nan,nan,nan,nan,nan,nan,nan,nan,nan,nan,nan,nan,nan,nan,nan,nan,nan,nan,nan,nan,nan,nan,nan,nan,nan,nan,nan,nan,nan,nan,nan,nan,nan,nan,nan,nan,nan,nan,nan,nan,nan,nan,nan,nan,nan
19/6/2011,Lukas Rupp,91012163,771,1/8/1991,20,0,0,0,0,1500,5400,5400,132,108,243145,179,67,M/AM RC,3,3,3,1,3,2,1,5,1,2,2,9,9,13,10,14,10,6,12,3,4,15,12,4,14,8,12,11,13,11,15,9,13,12,9,14,7,13,9,13,14,9,10,6,12,12,20,14,7,11,6,9,6,8,9,12,9,10,14,14,12,7,1,1,16,20,18,14,20,M/AM RC,523,1,1,10,20,14,18,1,1,1,6,15,12,16,1,1,8813280000000.0,0,0,0,0,0,0,0,1,0,0,0,0,0,0,0,0,0,0,0,0,0,0,1,0,0,0,0,0,0,0,0,0,0,0,1,0,0,0,0,0,0,0,0,1,0,0,0,0,Lukas Rupp,ÃÂ£900Th. ,29.0,178.0,Midfielder - Central Midfield,right,Norwich City,27.0,4.0,0.0,1561.0,26.0,4.0,6.0,1605.0,28.0,0.0,4.0,1652.0,15.0,1.0,0.0,394.0,32.0,4.0,2.0,2050.0,32.0,6.0,6.0,2324.0,17.0,3.0,0.0,955.0,25.0,3.0,3.0,1466.0,4.0,0.0,3.0,238.0,Bundesliga,24.0,0.0,0.0,1319.0,7.0,0.0,0.0,527.0,nan,nan,nan,nan,nan,nan,nan,nan,nan,nan,nan,nan,nan,nan,nan,nan,nan,nan,nan,nan,nan,nan,nan,nan,nan,nan,nan,nan,nan,nan,nan,nan,nan,nan,nan,nan,nan,nan,nan,nan,nan,nan,nan,nan,nan,nan,nan,nan,nan,nan,nan,nan,nan,nan,nan,nan,nan,nan,nan,nan,nan,nan,nan,nan,nan,nan,nan,nan,nan,nan,nan,nan,nan,nan,nan,nan,nan,nan,nan,nan,nan,nan,nan,nan,19-06-17,18.3.4.28,Lukas Rupp,91012163,771,08-Jan-91,26,0,0,0,0,4800,6800,6800,139,136,14997053,180,67,M/AM RC,1,4,3,1,1,1,1,3,2,2,3,10,14,12,12,14,9,6,13,6,8,13,9,12,15,17,15,10,10,12,12,12,12,10,7,14,11,16,18,12,15,10,9,12,14,12,20,17,7,14,5,12,6,17,8,16,10,10,14,14,12,7,1,1,20,18,18,13,20,M/AM RC,413,1,1,8,16,13,18,1,1,1,14,20,13,18,1,1,17179869184.0,0,0,0,0,0,0,0,0,0,0,0,0,0,0,0,0,0,0,0,0,0,0,0,0,0,0,0,0,0,0,0,0,0,0,1,0,0,0,0,0,0,0,0,0,0,0,0,0,Lukas Rupp,ÃÂ£4.05m ,29.0,178.0,Midfielder - Central Midfield,right,Norwich City,17.0,3.0,0.0,955.0,25.0,3.0,3.0,1466.0,4.0,0.0,3.0,238.0,24.0,0.0,0.0,1319.0,7.0,0.0,0.0,527.0,Bundesliga,15-07-16,17.3.2.23,Lukas Rupp,91012163.0,771.0,08-Jan-91,25.0,0.0,0.0,0.0,0.0,6450.0,6950.0,6950.0,142.0,139.0,20258577.0,180.0,67.0,M/AM RC,3.0,1.0,2.0,3.0,3.0,2.0,2.0,1.0,1.0,2.0,2.0,10.0,14.0,12.0,12.0,15.0,9.0,6.0,13.0,6.0,8.0,13.0,9.0,12.0,15.0,17.0,15.0,10.0,11.0,12.0,12.0,12.0,12.0,10.0,7.0,14.0,11.0,16.0,18.0,12.0,15.0,10.0,9.0,12.0,14.0,12.0,20.0,17.0,8.0,14.0,5.0,12.0,6.0,17.0,8.0,15.0,10.0,10.0,14.0,14.0,12.0,7.0,Lukas Rupp,ÃÂ£4.05m ,Bundesliga
19/6/2011,Lewis Holtby,91000734,771,9/18/1990,20,2,0,10,5,5750,7050,7050,161,140,8547927,174,66,AM LC,2,1,3,2,3,2,2,6,1,3,3,13,12,14,11,17,11,7,12,5,6,17,10,7,16,9,14,8,10,7,17,11,13,15,10,13,6,8,14,14,16,12,6,20,11,13,15,14,8,9,5,11,4,9,12,15,11,11,15,12,14,6,1,1,15,20,14,18,20,AM LC,504,1,1,10,20,18,14,1,1,1,8,15,14,10,1,1,549774000000.0,0,0,1,0,0,0,0,1,0,0,0,0,0,0,0,0,0,0,0,0,1,0,0,0,1,0,0,0,0,0,0,0,0,0,0,0,0,0,0,1,0,0,0,0,0,0,0,0,Lewis Holtby,ÃÂ£7.20m ,30.0,176.0,Midfielder - Attacking Midfield,left,Blackburn Rovers,32.0,6.0,10.0,2157.0,41.0,9.0,5.0,2981.0,44.0,4.0,13.0,2934.0,37.0,6.0,9.0,2148.0,28.0,0.0,2.0,1918.0,35.0,3.0,4.0,2977.0,30.0,1.0,6.0,2511.0,17.0,6.0,0.0,1240.0,31.0,5.0,6.0,2300.0,Bundesliga,27.0,3.0,4.0,1301.0,8.0,1.0,0.0,630.0,29/6/2010,Lewis Holtby,91000734.0,771.0,9/18/1990,19.0,0.0,0.0,2.0,0.0,3000.0,6600.0,6600.0,169.0,132.0,12137148.0,174.0,66.0,M/AM RLC,3.0,2.0,2.0,1.0,3.0,1.0,1.0,4.0,1.0,3.0,2.0,12.0,15.0,14.0,10.0,16.0,11.0,5.0,12.0,6.0,7.0,16.0,10.0,5.0,15.0,12.0,11.0,8.0,9.0,8.0,17.0,12.0,13.0,15.0,6.0,14.0,5.0,8.0,13.0,14.0,17.0,9.0,6.0,20.0,11.0,13.0,15.0,12.0,6.0,9.0,7.0,11.0,4.0,9.0,14.0,15.0,11.0,7.0,15.0,12.0,14.0,6.0,Lewis Holtby,ÃÂÃÂ£5.40m ,Bundesliga,19-06-17,18.3.4.28,Lewis Holtby,91000734,771,18-Sep-90,26,3,0,24,14,6300,6800,6800,144,136,14750546,174,66,M/AM C,3,3,3,2,3,1,2,1,1,2,2,11,12,13,11,15,11,9,12,5,10,16,10,13,15,17,11,10,12,10,15,12,15,13,10,14,11,15,17,13,15,10,6,20,16,11,12,16,8,12,6,11,3,14,10,17,8,12,14,16,8,14,1,1,18,20,12,12,20,M/AM C,521,1,1,10,20,12,12,1,1,1,14,18,12,12,1,1,2748800000000.0,0,0,0,0,0,0,0,0,0,0,0,0,0,0,0,0,0,0,0,0,1,0,0,0,1,0,0,0,0,0,0,0,0,0,0,0,0,0,0,1,0,1,0,0,0,0,0,0,Lewis Holtby,ÃÂ£2.25m ,30.0,176.0,Midfielder - Attacking Midfield,left,Blackburn Rovers,30.0,1.0,6.0,2511.0,17.0,6.0,0.0,1240.0,31.0,5.0,6.0,2300.0,27.0,3.0,4.0,1301.0,8.0,1.0,0.0,630.0,Bundesliga,15-07-16,17.3.2.23,Lewis Holtby,91000734.0,771.0,18-Sep-90,25.0,3.0,0.0,24.0,14.0,6350.0,6850.0,6850.0,144.0,137.0,17540892.0,174.0,66.0,M/AM C,3.0,3.0,1.0,1.0,1.0,1.0,1.0,1.0,2.0,3.0,3.0,11.0,12.0,13.0,11.0,15.0,11.0,9.0,12.0,5.0,8.0,16.0,10.0,12.0,15.0,17.0,11.0,10.0,12.0,10.0,16.0,12.0,15.0,13.0,11.0,14.0,10.0,15.0,17.0,13.0,15.0,10.0,6.0,20.0,16.0,11.0,12.0,16.0,8.0,12.0,6.0,11.0,3.0,14.0,10.0,17.0,8.0,12.0,14.0,16.0,8.0,14.0,Lewis Holtby,ÃÂ£4.50m ,Bundesliga
19/6/2011,Korey Smith,28013681,765,1/31/1991,20,0,0,0,0,2400,5250,5250,135,108,449632,183,78,M C,3,2,3,2,2,1,3,4,1,2,1,6,9,11,10,10,4,9,12,2,12,12,7,13,12,13,12,13,12,12,12,12,14,11,6,12,11,12,14,12,12,13,9,8,13,13,20,13,13,13,5,10,3,13,9,13,12,9,13,12,16,1,13,12,20,14,14,1,20,M C,401,1,1,1,8,1,14,1,1,13,1,20,1,13,1,12,32.0,0,0,0,0,0,1,0,0,0,0,0,0,0,0,0,0,0,0,0,0,0,0,0,0,0,0,0,0,0,0,0,0,0,0,0,0,0,0,0,0,0,0,0,0,0,0,0,0,Korey Smith,ÃÂ£900Th. ,29.0,183.0,Midfielder - Defensive Midfield,right,Swansea City,30.0,0.0,3.0,1978.0,17.0,0.0,3.0,1282.0,35.0,1.0,4.0,2911.0,52.0,2.0,2.0,4702.0,54.0,2.0,3.0,4727.0,38.0,0.0,3.0,3416.0,24.0,0.0,1.0,1901.0,52.0,3.0,1.0,4313.0,6.0,0.0,0.0,326.0,Premier League,22.0,0.0,0.0,1686.0,8.0,0.0,1.0,702.0,nan,nan,nan,nan,nan,nan,nan,nan,nan,nan,nan,nan,nan,nan,nan,nan,nan,nan,nan,nan,nan,nan,nan,nan,nan,nan,nan,nan,nan,nan,nan,nan,nan,nan,nan,nan,nan,nan,nan,nan,nan,nan,nan,nan,nan,nan,nan,nan,nan,nan,nan,nan,nan,nan,nan,nan,nan,nan,nan,nan,nan,nan,nan,nan,nan,nan,nan,nan,nan,nan,nan,nan,nan,nan,nan,nan,nan,nan,nan,nan,nan,nan,nan,nan
19/6/2011,JosuÃÂ©,55013011,788,9/17/1990,20,0,0,0,0,2250,3750,4850,148,107,585661,175,67,M C,1,2,2,3,3,2,2,1,3,3,1,14,14,12,11,15,15,7,8,10,10,15,15,10,14,11,14,10,7,11,14,12,14,12,11,14,12,12,13,12,12,8,8,8,12,11,20,11,7,11,7,13,7,10,10,13,14,13,14,14,14,6,1,1,20,10,1,1,20,M C,401,1,1,1,10,1,1,1,1,1,1,20,1,1,1,1,0.0,0,0,0,0,0,0,0,0,0,0,0,0,0,0,0,0,0,0,0,0,0,0,0,0,0,0,0,0,0,0,0,0,0,0,0,0,0,0,0,0,0,0,0,0,0,0,0,0,JosuÃÂ©,ÃÂ£900Th. ,30.0,174.0,Midfielder - Attacking Midfield,left,Hapoel Beer Sheva,13.0,0.0,0.0,946.0,23.0,1.0,0.0,1160.0,32.0,4.0,3.0,2309.0,35.0,5.0,10.0,2209.0,39.0,9.0,7.0,3121.0,39.0,5.0,6.0,2745.0,33.0,4.0,6.0,1787.0,10.0,0.0,3.0,743.0,29.0,4.0,4.0,2331.0,Liga NOS,32.0,6.0,6.0,2538.0,7.0,5.0,2.0,629.0,nan,nan,nan,nan,nan,nan,nan,nan,nan,nan,nan,nan,nan,nan,nan,nan,nan,nan,nan,nan,nan,nan,nan,nan,nan,nan,nan,nan,nan,nan,nan,nan,nan,nan,nan,nan,nan,nan,nan,nan,nan,nan,nan,nan,nan,nan,nan,nan,nan,nan,nan,nan,nan,nan,nan,nan,nan,nan,nan,nan,nan,nan,nan,nan,nan,nan,nan,nan,nan,nan,nan,nan,nan,nan,nan,nan,nan,nan,nan,nan,nan,nan,nan,nan
19/6/2011,Joel Chukwuma Obi,43008775,38,5/22/1991,20,5,0,0,0,3850,5714,6250,157,127,488387,177,70,M C,1,1,1,1,1,1,1,1,1,1,1,12,12,14,9,11,7,7,10,7,10,12,8,13,13,17,13,14,11,10,12,11,13,14,8,13,10,12,13,16,17,13,7,20,13,14,9,15,11,13,12,13,13,16,15,12,13,13,6,7,12,9,1,1,20,14,10,14,20,M C,401,1,1,1,14,14,10,1,1,1,8,20,14,10,1,1,34493956100.0,0,0,1,0,0,0,0,0,0,0,0,0,0,0,0,0,0,0,0,0,0,0,0,0,0,0,0,1,0,0,0,0,0,0,0,1,0,0,0,0,0,0,0,0,0,0,0,0,nan,nan,nan,nan,nan,nan,nan,nan,nan,nan,nan,nan,nan,nan,nan,nan,nan,nan,nan,nan,nan,nan,nan,nan,nan,nan,nan,nan,nan,nan,nan,nan,nan,nan,nan,nan,nan,nan,nan,nan,nan,nan,nan,nan,nan,nan,nan,nan,nan,nan,nan,nan,29/6/2010,Joel Chukwuma Obi,43008775.0,38.0,5/22/1991,19.0,0.0,0.0,0.0,0.0,1500.0,3000.0,5000.0,131.0,100.0,1473707.0,177.0,70.0,M/AM C,1.0,1.0,1.0,1.0,1.0,1.0,1.0,1.0,1.0,1.0,1.0,11.0,11.0,13.0,8.0,10.0,7.0,5.0,9.0,4.0,7.0,11.0,10.0,7.0,13.0,15.0,11.0,9.0,10.0,7.0,10.0,9.0,13.0,14.0,8.0,11.0,9.0,9.0,9.0,15.0,16.0,11.0,7.0,20.0,15.0,14.0,10.0,13.0,8.0,13.0,11.0,13.0,8.0,16.0,15.0,12.0,13.0,13.0,6.0,7.0,12.0,9.0,nan,nan,nan,19-06-17,18.3.4.28,Joel Obi,43008775,38,22-May-91,26,12,0,0,0,4000,6250,6500,138,130,9750849,177,72,WB/M RLC,1,1,1,1,1,1,1,1,1,1,1,12,13,12,9,12,7,9,10,7,12,12,8,14,13,14,13,14,11,11,12,11,13,14,8,13,13,14,14,15,16,13,9,20,11,14,9,14,12,13,13,14,13,18,15,13,13,10,12,12,11,9,9,16,20,8,15,18,20,WB/M RLC,426,1,1,1,7,8,8,1,9,7,1,20,18,15,16,12,134217732.0,0,0,1,0,0,0,0,0,0,0,0,0,0,0,0,0,0,0,0,0,0,0,0,0,0,0,0,1,0,0,0,0,0,0,0,0,0,0,0,0,0,0,0,0,0,0,0,0,Joel Obi,ÃÂ£4.50m ,29.0,178.0,Midfielder - Central Midfield,left,Chievo Verona,23.0,0.0,1.0,854.0,25.0,6.0,1.0,1397.0,13.0,1.0,0.0,694.0,29.0,1.0,2.0,2044.0,4.0,0.0,1.0,322.0,Serie A,15-07-16,17.3.2.23,Joel Obi,43008775.0,38.0,22-May-91,25.0,12.0,0.0,0.0,0.0,4000.0,6500.0,6450.0,138.0,130.0,7417931.0,177.0,72.0,M RLC,1.0,1.0,1.0,1.0,1.0,1.0,1.0,1.0,1.0,1.0,1.0,12.0,13.0,12.0,9.0,12.0,7.0,7.0,10.0,7.0,10.0,12.0,8.0,13.0,13.0,14.0,13.0,14.0,11.0,11.0,12.0,11.0,13.0,14.0,8.0,13.0,12.0,14.0,14.0,15.0,16.0,13.0,9.0,20.0,11.0,14.0,9.0,14.0,11.0,13.0,13.0,14.0,13.0,18.0,15.0,13.0,13.0,10.0,12.0,12.0,11.0,9.0,Joel Obi,ÃÂ£1.35m ,Serie A
19/6/2011,Jazz Richards,28028902,801,4/12/1991,20,0,0,10,0,2400,5350,4450,135,98,231110,186,83,M C,2,1,2,2,2,3,3,1,2,3,3,5,5,4,6,10,4,9,5,7,5,12,7,10,10,14,10,12,10,11,12,10,14,8,11,11,10,10,15,14,12,11,12,11,15,12,20,15,14,9,8,10,16,12,12,14,10,11,12,10,13,8,13,1,20,15,13,1,20,M C,401,1,1,1,15,1,1,1,1,13,1,20,1,1,1,1,0.0,0,0,0,0,0,0,0,0,0,0,0,0,0,0,0,0,0,0,0,0,0,0,0,0,0,0,0,0,0,0,0,0,0,0,0,0,0,0,0,0,0,0,0,0,0,0,0,0,Jazz Richards,ÃÂ£900Th. ,29.0,174.0,Defender - Right-Back,right,Without Club,8.0,0.0,0.0,703.0,26.0,0.0,0.0,2146.0,15.0,0.0,3.0,1152.0,11.0,0.0,0.0,782.0,27.0,0.0,2.0,2164.0,26.0,0.0,1.0,2078.0,28.0,0.0,1.0,2442.0,11.0,0.0,0.0,957.0,5.0,0.0,0.0,187.0,Premier League,13.0,0.0,0.0,1156.0,nan,nan,nan,nan,nan,nan,nan,nan,nan,nan,nan,nan,nan,nan,nan,nan,nan,nan,nan,nan,nan,nan,nan,nan,nan,nan,nan,nan,nan,nan,nan,nan,nan,nan,nan,nan,nan,nan,nan,nan,nan,nan,nan,nan,nan,nan,nan,nan,nan,nan,nan,nan,nan,nan,nan,nan,nan,nan,nan,nan,nan,nan,nan,nan,nan,nan,nan,nan,nan,nan,nan,nan,nan,nan,nan,nan,nan,nan,nan,nan,nan,nan,nan,nan,nan,nan,nan,nan
19/6/2011,James McCarthy,61002273,789,11/12/1990,20,3,0,6,1,4250,6000,6350,156,132,2942728,181,63,DM/M RC,1,2,3,3,2,3,1,2,1,3,2,12,12,14,14,14,5,11,13,4,7,16,8,11,17,12,14,13,14,7,12,13,10,12,5,15,11,13,14,14,12,10,8,10,14,13,20,16,5,11,8,14,5,10,12,5,18,14,15,1,10,17,1,1,20,13,15,1,20,DM/M RC,423,1,1,1,13,1,1,1,1,1,17,20,1,15,1,1,51539609760.0,0,0,0,0,0,1,0,1,0,0,0,1,0,0,0,0,0,0,0,0,0,0,0,0,0,0,0,0,0,0,0,0,0,0,1,1,0,0,0,0,0,0,0,0,0,0,0,0,James McCarthy,ÃÂ£4.95m ,29.0,180.0,Midfielder - Central Midfield,right,Crystal Palace,27.0,3.0,2.0,2044.0,34.0,0.0,3.0,2973.0,42.0,3.0,2.0,3645.0,45.0,1.0,3.0,3841.0,37.0,2.0,3.0,2936.0,37.0,2.0,2.0,3045.0,13.0,1.0,2.0,678.0,6.0,0.0,0.0,356.0,2.0,0.0,0.0,104.0,Premier League,35.0,0.0,0.0,1847.0,4.0,0.0,0.0,319.0,29/6/2010,James McCarthy,61002273.0,789.0,11/12/1990,19.0,1.0,0.0,5.0,0.0,3906.0,6000.0,6350.0,156.0,125.0,13534989.0,181.0,63.0,DM/M/AM RC,1.0,3.0,2.0,1.0,3.0,1.0,1.0,3.0,3.0,1.0,2.0,10.0,11.0,13.0,14.0,12.0,5.0,10.0,13.0,4.0,7.0,15.0,8.0,11.0,17.0,10.0,11.0,11.0,11.0,7.0,12.0,11.0,10.0,12.0,5.0,15.0,11.0,13.0,14.0,14.0,12.0,10.0,8.0,10.0,14.0,13.0,20.0,15.0,5.0,11.0,8.0,14.0,5.0,10.0,12.0,5.0,18.0,14.0,15.0,10.0,10.0,17.0,James McCarthy,ÃÂÃÂ£2.70m ,Premier League,19-06-17,18.3.4.28,James McCarthy,61002273,789,12-Nov-90,26,41,0,7,1,6250,7400,7200,146,142,53380660,180,72,DM/M C,1,1,3,3,2,1,1,1,3,4,2,8,9,9,9,11,5,13,9,4,16,13,8,18,10,14,14,16,12,13,10,15,14,6,10,8,15,16,17,12,12,14,10,10,14,13,20,17,14,14,11,13,14,14,12,5,16,14,15,10,10,17,7,7,20,1,7,1,20,DM/M C,311,1,1,1,1,1,1,1,1,7,20,20,1,7,1,7,137439000000.0,0,0,0,0,0,0,1,0,0,0,0,0,0,0,0,0,0,0,0,0,0,0,0,0,0,0,0,0,0,0,0,0,0,0,0,0,0,1,0,0,0,0,0,0,0,0,0,0,James McCarthy,ÃÂ£7.20m ,29.0,180.0,Midfielder - Central Midfield,right,Crystal Palace,13.0,1.0,2.0,678.0,6.0,0.0,0.0,356.0,2.0,0.0,0.0,104.0,35.0,0.0,0.0,1847.0,4.0,0.0,0.0,319.0,Premier League,15-07-16,17.3.2.23,James McCarthy,61002273.0,789.0,12-Nov-90,25.0,39.0,0.0,7.0,1.0,6250.0,7400.0,7200.0,160.0,142.0,43189690.0,180.0,72.0,DM/M C,3.0,4.0,1.0,4.0,3.0,2.0,2.0,1.0,3.0,3.0,1.0,8.0,9.0,9.0,9.0,11.0,5.0,13.0,9.0,4.0,16.0,13.0,8.0,18.0,10.0,14.0,14.0,16.0,12.0,13.0,10.0,15.0,14.0,6.0,10.0,8.0,15.0,16.0,17.0,12.0,12.0,14.0,10.0,10.0,14.0,13.0,20.0,17.0,14.0,14.0,11.0,13.0,8.0,14.0,12.0,5.0,16.0,14.0,15.0,10.0,10.0,17.0,James McCarthy,ÃÂ£13.50m ,Premier League
19/6/2011,Jack Rodwell,28010312,765,3/11/1991,20,0,0,17,2,4750,6750,6750,165,135,3939874,188,80,DM/M C,2,1,1,2,1,1,1,6,3,3,3,4,9,12,12,14,4,14,12,3,13,14,10,13,14,12,12,12,14,11,11,13,12,5,14,8,13,14,14,14,12,14,14,14,15,14,20,15,13,9,7,12,5,10,6,15,13,14,13,11,15,5,1,1,20,13,7,7,20,DM/M C,421,1,1,1,13,1,1,1,1,1,18,20,7,7,1,1,33088.0,0,0,0,0,0,0,1,0,1,0,0,0,0,0,0,1,0,0,0,0,0,0,0,0,0,0,0,0,0,0,0,0,0,0,0,0,0,0,0,0,0,0,0,0,0,0,0,0,Jack Rodwell,ÃÂ£13.50m ,29.0,188.0,Midfielder - Defensive Midfield,right,Sheffield United,29.0,1.0,2.0,1754.0,19.0,2.0,2.0,1343.0,16.0,2.0,1.0,670.0,10.0,0.0,0.0,336.0,26.0,3.0,0.0,1663.0,24.0,3.0,2.0,1292.0,23.0,0.0,1.0,1763.0,9.0,1.0,0.0,669.0,23.0,1.0,0.0,1589.0,Premier League,2.0,0.0,0.0,73.0,nan,nan,nan,nan,29/6/2010,Jack Rodwell,28010312.0,765.0,3/11/1991,19.0,0.0,0.0,11.0,2.0,4556.0,7100.0,7100.0,172.0,135.0,15908261.0,188.0,80.0,D/DM/M C,3.0,1.0,2.0,2.0,3.0,2.0,1.0,1.0,1.0,2.0,1.0,4.0,9.0,10.0,9.0,14.0,4.0,14.0,11.0,3.0,13.0,14.0,10.0,14.0,14.0,13.0,12.0,13.0,14.0,11.0,12.0,13.0,12.0,5.0,14.0,8.0,14.0,14.0,14.0,14.0,12.0,14.0,14.0,10.0,15.0,14.0,20.0,16.0,13.0,9.0,7.0,12.0,5.0,10.0,7.0,15.0,13.0,14.0,13.0,11.0,15.0,5.0,Jack Rodwell,ÃÂÃÂ£12.60m ,Premier League
19/6/2011,Ilkay GÃÂ¼ndogan,91003875,771,10/24/1990,20,0,0,3,0,5000,7050,7050,162,138,18181818,180,78,M/AM C,3,3,3,1,3,1,2,2,2,3,3,12,11,14,12,17,12,9,13,6,8,16,12,11,17,11,13,12,10,10,15,14,14,13,11,14,9,12,13,12,16,14,9,12,13,12,20,13,11,9,8,11,11,14,9,15,13,13,14,14,13,5,1,1,20,19,11,11,20,M/AM C,411,1,1,1,19,11,11,1,1,1,13,20,11,11,1,1,5243044.0,0,0,1,0,0,1,0,1,0,0,0,0,0,0,0,0,0,0,0,0,1,0,1,0,0,0,0,0,0,0,0,0,0,0,0,0,0,0,0,0,0,0,0,0,0,0,0,0,Ilkay GÃÂ¼ndogan,ÃÂ£8.10m ,30.0,180.0,Midfielder - Central Midfield,right,Manchester City,26.0,5.0,3.0,1917.0,37.0,4.0,4.0,2565.0,45.0,4.0,4.0,3541.0,3.0,1.0,0.0,227.0,33.0,3.0,5.0,2715.0,40.0,3.0,7.0,3008.0,16.0,5.0,2.0,1230.0,49.0,6.0,7.0,2816.0,50.0,6.0,8.0,3387.0,Bundesliga,50.0,5.0,5.0,3551.0,3.0,1.0,0.0,183.0,29/6/2010,Ilkay GÃÂÃÂ¼ndogan,91003875.0,771.0,10/24/1990,19.0,0.0,0.0,0.0,0.0,2750.0,6400.0,6400.0,160.0,123.0,10214960.0,180.0,75.0,M/AM C,1.0,1.0,3.0,2.0,2.0,1.0,2.0,8.0,1.0,1.0,2.0,12.0,12.0,15.0,11.0,16.0,13.0,8.0,14.0,11.0,9.0,16.0,12.0,9.0,16.0,10.0,14.0,8.0,11.0,12.0,15.0,12.0,10.0,14.0,10.0,12.0,12.0,11.0,10.0,12.0,15.0,9.0,9.0,7.0,12.0,12.0,20.0,12.0,9.0,9.0,8.0,11.0,10.0,14.0,9.0,11.0,11.0,14.0,14.0,13.0,6.0,6.0,Ilkay GÃÂÃÂ¼ndogan,ÃÂÃÂ£5.85m ,Bundesliga,19-06-17,18.3.4.28,Ilkay GÃÂÃÂ¼ÃÂndogan,91003875,771,24-Oct-90,26,20,4,8,1,7500,7900,8000,167,163,183318929,180,80,DM/M C,1,3,1,4,3,1,2,3,1,2,4,10,12,14,11,17,10,7,11,6,10,16,12,13,17,15,13,12,17,14,17,16,12,13,10,13,11,16,14,12,16,13,9,14,13,13,20,15,12,16,8,16,14,14,10,17,7,14,16,16,14,6,1,1,20,15,11,11,20,DM/M C,311,1,1,1,15,11,11,1,1,1,20,20,11,11,1,1,5242880.0,0,0,0,0,0,0,0,0,0,0,0,0,0,0,0,0,0,0,0,0,1,0,1,0,0,0,0,0,0,0,0,0,0,0,0,0,0,0,0,0,0,0,0,0,0,0,0,0,Ilkay GÃÂ¼ndogan,ÃÂ£36.00m ,30.0,180.0,Midfielder - Central Midfield,right,Manchester City,16.0,5.0,2.0,1230.0,49.0,6.0,7.0,2816.0,50.0,6.0,8.0,3387.0,50.0,5.0,5.0,3551.0,3.0,1.0,0.0,183.0,Premier League,nan,nan,nan,nan,nan,nan,nan,nan,nan,nan,nan,nan,nan,nan,nan,nan,nan,nan,nan,nan,nan,nan,nan,nan,nan,nan,nan,nan,nan,nan,nan,nan,nan,nan,nan,nan,nan,nan,nan,nan,nan,nan,nan,nan,nan,nan,nan,nan,nan,nan,nan,nan,nan,nan,nan,nan,nan,nan,nan,nan,nan,nan,nan,nan,nan,nan,nan,nan,nan,nan,nan,nan,nan,nan,nan,nan,nan,nan,nan,nan,nan,nan,nan,nan,nan
19/6/2011,HÃÂ¥vard Nordtveit,53000623,786,6/21/1990,20,1,0,15,1,4850,5849,6450,142,130,5376676,188,72,D/DM/M C,3,2,1,3,1,2,2,1,2,3,1,5,11,9,6,14,7,12,7,19,12,15,5,14,13,11,15,12,14,9,13,15,14,7,13,7,12,17,12,12,9,10,14,12,13,17,20,13,12,11,8,14,9,10,14,14,16,16,15,12,16,7,18,10,17,1,12,1,18,D/DM/M C,331,1,12,1,1,1,1,18,1,12,20,17,1,1,1,10,8796180000000.0,0,0,0,0,0,0,0,0,0,0,0,0,0,0,0,0,0,0,0,1,0,0,1,0,1,0,1,0,0,0,0,0,0,0,0,0,0,0,0,0,0,0,0,1,0,0,0,0,Havard Nordtveit,ÃÂ£4.95m ,30.0,188.0,Defender - Centre-Back,right,TSG 1899 Hoffenheim,25.0,2.0,1.0,2196.0,36.0,1.0,0.0,2872.0,42.0,2.0,6.0,3563.0,22.0,1.0,2.0,1285.0,30.0,3.0,1.0,1550.0,39.0,4.0,1.0,2996.0,22.0,0.0,1.0,1420.0,23.0,0.0,1.0,1502.0,16.0,1.0,1.0,1011.0,Bundesliga,12.0,0.0,1.0,818.0,nan,nan,nan,nan,nan,nan,nan,nan,nan,nan,nan,nan,nan,nan,nan,nan,nan,nan,nan,nan,nan,nan,nan,nan,nan,nan,nan,nan,nan,nan,nan,nan,nan,nan,nan,nan,nan,nan,nan,nan,nan,nan,nan,nan,nan,nan,nan,nan,nan,nan,nan,nan,nan,nan,nan,nan,nan,nan,nan,nan,nan,nan,nan,nan,nan,nan,nan,nan,nan,nan,nan,nan,nan,nan,nan,nan,nan,nan,nan,nan,nan,nan,nan,nan,nan,nan,nan,nan,19-06-17,18.3.4.28,HÃÂºvard Nordtveit,53000623,786,21-Jun-90,26,32,2,24,1,5650,6650,6650,137,133,10770670,188,85,D/DM/M C,3,1,2,2,3,3,1,3,2,2,1,11,11,9,8,10,12,10,13,18,13,13,8,14,10,15,14,16,10,16,10,12,15,7,13,11,12,18,15,11,9,12,14,12,17,14,20,17,14,15,10,15,9,15,17,14,13,13,17,14,16,6,20,8,18,1,12,1,20,D/DM/M C,121,1,12,1,1,1,1,20,1,12,18,18,1,1,1,8,0.0,0,0,0,0,0,0,0,0,0,0,0,0,0,0,0,0,0,0,0,0,0,0,0,0,0,0,0,0,0,0,0,0,0,0,0,0,0,0,0,0,0,0,0,0,0,0,0,0,Havard Nordtveit,ÃÂ£3.60m ,30.0,188.0,Defender - Centre-Back,right,TSG 1899 Hoffenheim,22.0,0.0,1.0,1420.0,23.0,0.0,1.0,1502.0,16.0,1.0,1.0,1011.0,12.0,0.0,1.0,818.0,nan,nan,nan,nan,Bundesliga,15-07-16,17.3.2.23,HÃÂºvard Nordtveit,53000623.0,786.0,21-Jun-90,26.0,28.0,2.0,24.0,1.0,5845.0,6345.0,6845.0,140.0,132.0,23096766.0,188.0,85.0,D/DM/M C,2.0,2.0,1.0,2.0,1.0,1.0,2.0,2.0,2.0,1.0,3.0,10.0,11.0,9.0,8.0,11.0,12.0,11.0,12.0,18.0,14.0,11.0,8.0,14.0,10.0,17.0,14.0,16.0,10.0,14.0,10.0,12.0,15.0,7.0,13.0,11.0,12.0,18.0,17.0,11.0,10.0,12.0,14.0,12.0,17.0,12.0,20.0,17.0,14.0,14.0,10.0,14.0,9.0,15.0,17.0,14.0,13.0,13.0,17.0,14.0,16.0,8.0,Havard Nordtveit,ÃÂ£4.50m ,Premier League
19/6/2011,Guilherme,55024926,1651,5/21/1991,20,0,0,0,0,2000,2500,4650,150,93,109321,174,70,AM LC,3,2,2,1,3,3,1,5,2,2,1,11,12,12,10,14,13,5,12,7,6,12,12,8,13,12,12,11,7,9,11,11,12,15,12,13,7,8,11,12,12,8,7,20,12,12,6,9,7,12,9,12,9,10,14,15,10,12,11,10,10,18,1,1,15,20,7,15,20,AM LC,504,1,1,1,20,15,7,1,1,1,1,15,8,7,1,1,0.0,0,0,0,0,0,0,0,0,0,0,0,0,0,0,0,0,0,0,0,0,0,0,0,0,0,0,0,0,0,0,0,0,0,0,0,0,0,0,0,0,0,0,0,0,0,0,0,0,Guilherme,ÃÂ£450Th. ,29.0,174.0,Forward - Right Winger,left,GÃÂ¶ztepe,8.0,2.0,0.0,383.0,27.0,1.0,1.0,1067.0,32.0,3.0,7.0,2522.0,2.0,0.0,0.0,164.0,30.0,1.0,2.0,2157.0,55.0,8.0,11.0,3830.0,41.0,7.0,8.0,2955.0,34.0,7.0,4.0,2469.0,35.0,5.0,7.0,2577.0,Liga NOS,44.0,9.0,8.0,2649.0,5.0,2.0,0.0,312.0,nan,nan,nan,nan,nan,nan,nan,nan,nan,nan,nan,nan,nan,nan,nan,nan,nan,nan,nan,nan,nan,nan,nan,nan,nan,nan,nan,nan,nan,nan,nan,nan,nan,nan,nan,nan,nan,nan,nan,nan,nan,nan,nan,nan,nan,nan,nan,nan,nan,nan,nan,nan,nan,nan,nan,nan,nan,nan,nan,nan,nan,nan,nan,nan,nan,nan,nan,nan,nan,nan,nan,nan,nan,nan,nan,nan,nan,nan,nan,nan,nan,nan,nan,nan,19-06-17,18.3.4.28,Guilherme,55024926,1651,21-May-91,26,0,0,0,0,4500,5500,5750,122,116,867957,174,70,M/AM RLC,1,1,1,2,2,3,3,3,3,2,1,12,13,14,8,14,14,6,10,8,7,16,13,10,14,12,13,15,7,10,13,9,15,17,11,14,8,12,13,14,14,10,6,20,10,11,8,13,8,11,14,12,12,13,14,15,8,12,10,8,10,14,12,10,17,20,20,15,19,M/AM RLC,526,1,1,1,19,15,20,1,12,1,10,17,15,10,10,1,34359869440.0,0,0,0,0,0,0,0,0,0,0,0,0,0,0,0,0,0,1,0,0,0,0,0,0,0,0,0,0,0,0,0,0,0,0,0,1,0,0,0,0,0,0,0,0,0,0,0,0,Guilherme,ÃÂ£3.60m ,29.0,174.0,Forward - Right Winger,left,GÃÂ¶ztepe,41.0,7.0,8.0,2955.0,34.0,7.0,4.0,2469.0,35.0,5.0,7.0,2577.0,44.0,9.0,8.0,2649.0,5.0,2.0,0.0,312.0,Serie A,15-07-16,17.3.2.23,Guilherme,19105719.0,1651.0,05-Apr-91,25.0,0.0,0.0,0.0,0.0,4000.0,6250.0,6400.0,137.0,131.0,6927383.0,179.0,77.0,DM C,3.0,2.0,4.0,3.0,1.0,2.0,3.0,3.0,3.0,2.0,1.0,5.0,12.0,12.0,10.0,12.0,11.0,12.0,14.0,10.0,13.0,13.0,10.0,14.0,14.0,12.0,13.0,12.0,12.0,12.0,13.0,12.0,13.0,9.0,9.0,12.0,14.0,15.0,13.0,14.0,14.0,14.0,10.0,9.0,14.0,13.0,20.0,14.0,12.0,10.0,10.0,11.0,5.0,14.0,10.0,13.0,14.0,14.0,14.0,10.0,14.0,8.0,Guilherme,ÃÂ£3.60m ,LaLiga
19/6/2011,GueÃÂ¯da Fofana,34011543,769,5/16/1991,20,0,0,0,0,2623,5399,4121,160,120,654545,182,74,DM/M C,3,2,3,3,2,3,1,5,3,1,1,8,9,11,7,11,13,9,13,5,8,13,10,9,14,13,14,13,12,10,12,10,14,11,13,9,11,14,14,16,13,14,11,8,15,13,20,15,14,12,13,15,6,8,7,15,12,14,13,15,15,7,1,1,20,1,12,1,20,DM/M C,421,1,1,1,1,1,1,1,1,1,16,20,1,12,1,1,274878000000.0,0,0,1,0,0,1,0,0,0,0,0,0,0,0,0,0,0,0,0,0,0,0,0,0,0,0,0,0,0,0,0,0,0,0,0,0,0,0,1,0,0,0,0,0,0,0,0,0,GueÃÂ¯da Fofana,ÃÂ£3.15m ,29.0,182.0,Midfielder - Defensive Midfield,right,Retired,36.0,3.0,3.0,2593.0,25.0,0.0,0.0,1502.0,38.0,5.0,6.0,2658.0,39.0,4.0,1.0,3145.0,2.0,0.0,0.0,41.0,0.0,0.0,0.0,0.0,nan,nan,nan,nan,nan,nan,nan,nan,nan,nan,nan,nan,Ligue 1,nan,nan,nan,nan,nan,nan,nan,nan,nan,nan,nan,nan,nan,nan,nan,nan,nan,nan,nan,nan,nan,nan,nan,nan,nan,nan,nan,nan,nan,nan,nan,nan,nan,nan,nan,nan,nan,nan,nan,nan,nan,nan,nan,nan,nan,nan,nan,nan,nan,nan,nan,nan,nan,nan,nan,nan,nan,nan,nan,nan,nan,nan,nan,nan,nan,nan,nan,nan,nan,nan,nan,nan,nan,nan,nan,nan,nan,nan,nan,nan,nan,nan,nan,nan,nan,nan,nan,nan,nan,nan,nan,nan
19/6/2011,Franco Zuculini,14006042,1649,9/5/1990,20,1,0,9,0,3900,6750,6250,144,123,476360,176,70,DM/M RC,2,2,2,3,1,3,2,6,1,3,2,6,10,12,6,15,6,8,7,12,18,14,8,12,14,18,7,19,7,9,10,8,18,9,11,10,7,15,19,17,15,14,7,8,12,13,20,18,12,9,14,12,6,12,2,9,12,10,7,9,7,14,1,1,20,1,15,14,20,DM/M RC,423,1,1,1,1,1,1,1,1,1,18,20,14,15,1,1,137439000000.0,0,0,0,0,0,0,0,0,0,0,0,0,0,0,0,1,0,0,0,0,0,0,0,0,0,0,0,0,0,0,0,0,0,0,0,0,0,1,0,0,0,0,0,0,0,0,0,0,Franco Zuculini,ÃÂ£2.70m ,30.0,176.0,Midfielder - Central Midfield,right,Defensor Sporting Club,23.0,0.0,1.0,1145.0,23.0,0.0,3.0,1161.0,20.0,2.0,1.0,1190.0,19.0,0.0,1.0,857.0,28.0,3.0,6.0,1805.0,3.0,1.0,0.0,174.0,16.0,1.0,1.0,565.0,14.0,0.0,0.0,592.0,20.0,0.0,0.0,1117.0,LaLiga,21.0,1.0,2.0,1239.0,nan,nan,nan,nan,29/6/2010,Franco Zuculini,14006042.0,1649.0,9/5/1990,19.0,1.0,0.0,9.0,0.0,3600.0,6750.0,6250.0,164.0,125.0,9200000.0,176.0,70.0,DM/M RC,2.0,3.0,1.0,3.0,1.0,3.0,1.0,1.0,2.0,1.0,1.0,6.0,10.0,12.0,6.0,15.0,6.0,8.0,7.0,12.0,18.0,14.0,8.0,11.0,14.0,19.0,7.0,19.0,8.0,9.0,10.0,8.0,18.0,9.0,11.0,13.0,7.0,15.0,19.0,17.0,15.0,16.0,7.0,8.0,12.0,13.0,20.0,18.0,12.0,9.0,14.0,12.0,6.0,10.0,2.0,9.0,12.0,13.0,8.0,9.0,7.0,14.0,Franco Zuculini,ÃÂÃÂ£2.70m ,Serie A
19/6/2011,Francis Coquelin,34012022,769,5/13/1991,20,0,0,0,0,4400,5576,5576,164,123,2842045,178,73,DM/M C,1,3,1,1,1,1,3,4,3,1,1,5,8,11,5,13,6,9,7,5,8,14,8,12,13,12,13,15,12,12,12,13,16,8,11,9,12,14,16,15,13,12,8,12,14,12,20,15,11,13,12,15,11,15,13,16,14,13,13,15,15,5,12,12,16,12,12,1,16,DM/M C,311,1,1,1,10,1,12,1,1,12,20,16,1,12,1,12,0.0,0,0,0,0,0,0,0,0,0,0,0,0,0,0,0,0,0,0,0,0,0,0,0,0,0,0,0,0,0,0,0,0,0,0,0,0,0,0,0,0,0,0,0,0,0,0,0,0,Francis Coquelin,ÃÂ£2.70m ,29.0,177.0,Midfielder - Defensive Midfield,right,Villarreal CF,25.0,1.0,1.0,1296.0,18.0,0.0,1.0,1191.0,26.0,0.0,1.0,1293.0,24.0,1.0,0.0,1241.0,37.0,0.0,0.0,2770.0,36.0,0.0,0.0,2380.0,39.0,0.0,0.0,2338.0,26.0,1.0,1.0,1675.0,42.0,0.0,1.0,2810.0,Premier League,36.0,0.0,2.0,2579.0,6.0,0.0,0.0,371.0,29/6/2010,Francis Coquelin,34012022.0,769.0,5/13/1991,19.0,0.0,0.0,0.0,0.0,2025.0,3150.0,4250.0,149.0,90.0,-1.0,178.0,73.0,D/DM/M RC,1.0,2.0,2.0,2.0,2.0,1.0,3.0,1.0,1.0,2.0,1.0,5.0,5.0,8.0,5.0,10.0,4.0,9.0,5.0,5.0,10.0,11.0,3.0,13.0,12.0,12.0,11.0,15.0,9.0,10.0,8.0,9.0,16.0,8.0,13.0,10.0,10.0,14.0,15.0,12.0,10.0,12.0,8.0,12.0,14.0,10.0,20.0,15.0,12.0,14.0,5.0,10.0,10.0,15.0,13.0,16.0,14.0,10.0,13.0,15.0,14.0,5.0,Francis Coquelin,ÃÂÃÂ£1.17m ,Ligue 1,19-06-17,18.3.4.28,Francis Coquelin,34012022,769,13-May-91,26,0,0,7,0,6250,6750,7200,155,144,35295941,179,74,DM/M C,3,1,3,3,2,3,4,3,3,1,1,4,8,10,7,14,4,13,7,8,15,12,8,16,14,15,15,18,14,14,11,15,17,8,10,11,14,18,17,14,12,15,12,10,16,13,20,17,15,16,12,15,8,15,15,14,14,14,16,12,13,5,8,8,20,1,8,8,20,DM/M C,421,1,1,1,1,1,1,1,8,8,17,20,8,8,8,8,16777216.0,0,0,0,0,0,0,0,0,0,0,0,0,0,0,0,0,0,0,0,0,0,0,0,0,1,0,0,0,0,0,0,0,0,0,0,0,0,0,0,0,0,0,0,0,0,0,0,0,Francis Coquelin,ÃÂ£10.80m ,29.0,177.0,Midfielder - Defensive Midfield,right,Villarreal CF,39.0,0.0,0.0,2338.0,26.0,1.0,1.0,1675.0,42.0,0.0,1.0,2810.0,36.0,0.0,2.0,2579.0,6.0,0.0,0.0,371.0,Premier League,15-07-16,17.3.2.23,Francis Coquelin,34012022.0,769.0,13-May-91,25.0,0.0,0.0,7.0,0.0,6249.0,6749.0,7249.0,158.0,149.0,40523544.0,179.0,74.0,DM/M C,1.0,2.0,2.0,3.0,1.0,3.0,2.0,2.0,2.0,2.0,3.0,4.0,10.0,10.0,7.0,15.0,4.0,13.0,7.0,8.0,15.0,14.0,8.0,16.0,14.0,15.0,15.0,18.0,14.0,14.0,12.0,15.0,17.0,8.0,10.0,11.0,15.0,18.0,17.0,14.0,12.0,15.0,12.0,12.0,16.0,13.0,20.0,17.0,15.0,17.0,12.0,15.0,8.0,17.0,15.0,14.0,14.0,15.0,16.0,12.0,15.0,5.0,Francis Coquelin,ÃÂ£13.50m ,Premier League
19/6/2011,Eric TiÃÂ©-Bi,34011692,24,7/20/1990,20,0,0,0,0,1250,2500,2500,135,100,60188,189,76,DM C,2,3,3,1,3,2,3,4,2,2,3,5,5,8,5,11,7,13,9,5,10,11,11,8,11,14,13,13,11,11,9,8,14,11,9,7,11,14,16,15,11,14,14,5,16,12,20,18,14,14,14,14,5,6,5,13,13,14,15,14,14,5,1,1,15,1,1,1,15,DM C,301,1,1,1,1,1,1,1,1,1,20,15,1,1,1,1,1073741824.0,0,0,0,0,0,0,0,0,0,0,0,0,0,0,0,0,0,0,0,0,0,0,0,0,0,0,0,0,0,0,1,0,0,0,0,0,0,0,0,0,0,0,0,0,0,0,0,0,Eric TiÃÂ© Bi,ÃÂ£900Th. ,30.0,181.0,Midfielder - Defensive Midfield,right,Unknown,25.0,0.0,0.0,1675.0,26.0,0.0,3.0,1398.0,24.0,0.0,2.0,1332.0,22.0,0.0,1.0,1732.0,19.0,0.0,0.0,1039.0,29.0,0.0,1.0,2096.0,14.0,0.0,0.0,1155.0,26.0,0.0,0.0,1358.0,nan,nan,nan,nan,Ligue 1,nan,nan,nan,nan,nan,nan,nan,nan,nan,nan,nan,nan,nan,nan,nan,nan,nan,nan,nan,nan,nan,nan,nan,nan,nan,nan,nan,nan,nan,nan,nan,nan,nan,nan,nan,nan,nan,nan,nan,nan,nan,nan,nan,nan,nan,nan,nan,nan,nan,nan,nan,nan,nan,nan,nan,nan,nan,nan,nan,nan,nan,nan,nan,nan,nan,nan,nan,nan,nan,nan,nan,nan,nan,nan,nan,nan,nan,nan,nan,nan,nan,nan,nan,nan,nan,nan,nan,nan,nan,nan,nan,nan
19/6/2011,Emmanuel Badu,12035987,21,12/2/1990,20,22,1,0,0,3500,6300,6050,149,129,789860,173,70,DM/M C,2,2,3,2,1,2,2,2,3,2,3,11,11,8,6,10,14,11,14,11,15,12,9,14,11,15,13,15,12,12,11,11,11,9,13,12,12,15,15,14,14,15,8,8,15,13,20,14,14,12,13,14,6,8,10,12,11,11,12,11,12,7,1,1,18,1,1,1,18,DM/M C,311,1,1,1,1,1,1,1,1,1,20,18,1,1,1,1,35184400000000.0,0,0,0,0,0,0,0,0,1,1,0,0,0,0,0,0,0,0,0,0,0,0,0,0,0,0,0,0,0,0,0,0,0,0,0,0,0,0,0,0,0,0,0,0,0,1,0,0,Emmanuel Badu,ÃÂ£1.62m ,29.0,173.0,Midfielder - Central Midfield,right,Hellas Verona,11.0,0.0,0.0,432.0,18.0,0.0,1.0,1265.0,32.0,0.0,2.0,1990.0,32.0,5.0,1.0,2054.0,27.0,1.0,1.0,1869.0,34.0,4.0,3.0,2745.0,30.0,0.0,3.0,2118.0,19.0,1.0,1.0,1512.0,4.0,0.0,0.0,161.0,Serie A,10.0,0.0,0.0,224.0,nan,nan,nan,nan,29/6/2010,Emmanuel Badu,12035987.0,21.0,12/2/1990,19.0,3.0,0.0,0.0,0.0,2800.0,5800.0,5300.0,143.0,115.0,4386257.0,173.0,70.0,DM/M C,2.0,2.0,3.0,3.0,2.0,1.0,2.0,2.0,3.0,2.0,1.0,11.0,11.0,8.0,6.0,9.0,14.0,11.0,14.0,11.0,14.0,12.0,9.0,12.0,11.0,15.0,13.0,14.0,12.0,11.0,11.0,10.0,11.0,9.0,13.0,13.0,11.0,14.0,14.0,14.0,13.0,15.0,8.0,5.0,15.0,13.0,20.0,14.0,14.0,12.0,13.0,14.0,6.0,8.0,10.0,10.0,11.0,9.0,12.0,11.0,12.0,7.0,Emmanuel Badu,ÃÂÃÂ£1.35m ,Serie A
19/6/2011,Elvis,19062098,1651,9/9/1990,20,0,0,0,0,1802,5550,5550,131,111,128725,170,70,M/AM C,1,2,2,3,3,2,2,2,2,1,1,12,12,13,11,13,10,10,11,5,6,13,10,6,14,11,11,9,11,12,13,12,10,13,12,12,6,12,13,13,14,6,5,10,12,14,20,13,6,12,7,7,8,13,6,9,10,9,6,8,11,11,1,1,16,20,1,1,20,M/AM C,521,1,1,1,20,1,1,1,1,1,1,16,1,1,1,1,0.0,0,0,0,0,0,0,0,0,0,0,0,0,0,0,0,0,0,0,0,0,0,0,0,0,0,0,0,0,0,0,0,0,0,0,0,0,0,0,0,0,0,0,0,0,0,0,0,0,Elias,ÃÂ£7.20m ,35.0,173.0,Midfielder - Central Midfield,right,Esporte Clube Bahia,16.0,2.0,0.0,736.0,35.0,5.0,4.0,2858.0,46.0,5.0,3.0,3910.0,24.0,3.0,2.0,2098.0,34.0,9.0,9.0,2847.0,15.0,3.0,0.0,1056.0,55.0,8.0,4.0,3974.0,35.0,5.0,4.0,2493.0,41.0,3.0,3.0,3354.0,LaLiga,6.0,0.0,0.0,518.0,nan,nan,nan,nan,nan,nan,nan,nan,nan,nan,nan,nan,nan,nan,nan,nan,nan,nan,nan,nan,nan,nan,nan,nan,nan,nan,nan,nan,nan,nan,nan,nan,nan,nan,nan,nan,nan,nan,nan,nan,nan,nan,nan,nan,nan,nan,nan,nan,nan,nan,nan,nan,nan,nan,nan,nan,nan,nan,nan,nan,nan,nan,nan,nan,nan,nan,nan,nan,nan,nan,nan,nan,nan,nan,nan,nan,nan,nan,nan,nan,nan,nan,nan,nan,nan,nan,nan,nan
19/6/2011,Eliaquim Mangala,18031822,769,2/13/1991,20,0,0,9,0,4000,6000,6000,132,123,2213439,187,84,D/DM/M C,3,1,3,2,2,2,1,5,3,2,2,7,7,9,10,10,8,15,8,12,15,7,10,13,10,14,14,15,8,14,8,7,14,10,7,8,10,15,17,14,14,18,17,8,15,14,20,10,17,11,12,7,12,10,13,14,14,11,9,10,8,5,20,14,18,1,14,14,20,D/DM/M C,121,1,1,1,1,1,1,20,14,14,19,18,12,14,14,14,0.0,0,0,0,0,0,0,0,0,0,0,0,0,0,0,0,0,0,0,0,0,0,0,0,0,0,0,0,0,0,0,0,0,0,0,0,0,0,0,0,0,0,0,0,0,0,0,0,0,Eliaquim Mangala,ÃÂ£4.50m ,29.0,187.0,Defender - Centre-Back,left,Valencia CF,41.0,2.0,2.0,3356.0,14.0,1.0,0.0,1160.0,40.0,7.0,2.0,3363.0,42.0,5.0,2.0,3725.0,31.0,0.0,2.0,2728.0,33.0,0.0,1.0,2848.0,33.0,2.0,0.0,2886.0,17.0,0.0,0.0,1178.0,5.0,0.0,0.0,251.0,Liga NOS,11.0,0.0,0.0,884.0,1.0,0.0,0.0,17.0,nan,nan,nan,nan,nan,nan,nan,nan,nan,nan,nan,nan,nan,nan,nan,nan,nan,nan,nan,nan,nan,nan,nan,nan,nan,nan,nan,nan,nan,nan,nan,nan,nan,nan,nan,nan,nan,nan,nan,nan,nan,nan,nan,nan,nan,nan,nan,nan,nan,nan,nan,nan,nan,nan,nan,nan,nan,nan,nan,nan,nan,nan,nan,nan,nan,nan,nan,nan,nan,nan,nan,nan,nan,nan,nan,nan,nan,nan,nan,nan,nan,nan,nan,nan
19/6/2011,Eden Hazard,18004418,757,1/7/1991,20,20,0,0,0,6648,8058,7252,180,161,8577286,172,72,M/AM LC,1,1,3,3,1,3,1,6,3,2,1,14,13,18,10,18,13,7,13,5,3,16,13,3,18,8,12,9,13,13,15,13,10,15,6,14,7,11,12,18,16,13,6,14,16,15,20,14,12,14,8,15,7,8,15,17,15,13,12,14,14,9,1,1,16,20,14,19,20,M/AM LC,524,1,1,10,20,19,14,1,1,1,1,16,12,12,1,1,2322200000000000.0,0,0,0,0,0,0,0,1,0,0,0,0,0,0,0,0,0,0,0,0,1,0,0,0,0,0,0,0,0,0,0,0,0,0,0,1,0,0,0,0,0,0,0,0,0,0,1,0,Eden Hazard,ÃÂ£29.70m ,29.0,175.0,Forward - Left Winger,both,Real Madrid,54.0,12.0,14.0,4110.0,49.0,22.0,22.0,4193.0,62.0,13.0,24.0,4523.0,49.0,17.0,10.0,3943.0,52.0,19.0,13.0,4441.0,43.0,6.0,8.0,3079.0,43.0,17.0,7.0,3373.0,52.0,17.0,13.0,3804.0,52.0,21.0,17.0,3878.0,Ligue 1,22.0,1.0,7.0,1545.0,nan,nan,nan,nan,29/6/2010,Eden Hazard,18004418.0,757.0,1/7/1991,19.0,12.0,0.0,0.0,0.0,6006.0,7000.0,7000.0,180.0,155.0,19306756.0,170.0,69.0,M/AM LC,1.0,3.0,3.0,1.0,1.0,3.0,1.0,3.0,1.0,3.0,2.0,14.0,12.0,18.0,8.0,17.0,13.0,7.0,13.0,5.0,2.0,15.0,13.0,3.0,17.0,8.0,12.0,9.0,13.0,14.0,15.0,12.0,14.0,16.0,6.0,13.0,7.0,11.0,12.0,18.0,16.0,13.0,5.0,14.0,14.0,15.0,20.0,14.0,12.0,14.0,8.0,15.0,7.0,8.0,15.0,16.0,16.0,14.0,15.0,14.0,14.0,5.0,Eden Hazard,ÃÂÃÂ£20.25m ,Ligue 1,19-06-17,18.3.4.28,Eden Hazard,18004418,757,07-Jan-91,26,77,17,0,0,8750,9000,8750,185,179,186143682,173,76,AM RLC,1,3,3,3,2,2,3,3,3,2,3,12,12,20,13,17,13,7,13,5,3,15,19,4,18,8,12,17,15,13,16,16,16,18,6,14,7,11,13,17,20,16,8,16,16,16,20,17,11,15,8,15,3,10,15,18,14,15,14,17,14,9,1,1,11,20,16,20,19,AM RLC,506,1,1,10,19,20,16,1,1,1,1,10,11,11,1,1,2462940000000000.0,0,0,0,0,0,0,0,0,0,0,0,0,0,0,0,0,0,0,0,1,1,0,0,0,1,0,1,0,0,0,0,0,0,0,0,1,0,0,0,0,0,0,0,0,0,0,1,1,Eden Hazard,ÃÂ£99.00m ,29.0,175.0,Forward - Left Winger,both,Real Madrid,43.0,17.0,7.0,3373.0,52.0,17.0,13.0,3804.0,52.0,21.0,17.0,3878.0,22.0,1.0,7.0,1545.0,nan,nan,nan,nan,Premier League,15-07-16,17.3.2.23,Eden Hazard,18004418.0,757.0,07-Jan-91,25.0,70.0,14.0,0.0,0.0,8750.0,9000.0,8750.0,185.0,175.0,212977903.0,173.0,76.0,M/AM RLC,3.0,2.0,4.0,4.0,3.0,1.0,2.0,3.0,3.0,1.0,2.0,13.0,12.0,20.0,13.0,17.0,13.0,7.0,13.0,5.0,3.0,15.0,19.0,4.0,18.0,8.0,12.0,17.0,15.0,13.0,16.0,13.0,16.0,18.0,6.0,14.0,7.0,11.0,13.0,17.0,20.0,16.0,8.0,16.0,16.0,16.0,20.0,17.0,9.0,15.0,8.0,15.0,3.0,8.0,15.0,18.0,14.0,15.0,14.0,17.0,14.0,9.0,Eden Hazard,ÃÂ£67.50m ,Premier League
19/6/2011,Dias,55013002,788,2/25/1991,20,0,0,0,0,1250,4500,4500,110,90,182386,189,79,M C,2,2,2,3,3,3,2,4,2,2,1,10,11,11,9,11,10,14,12,10,11,10,10,10,11,12,12,12,10,10,10,9,13,8,15,10,13,13,11,10,11,14,15,10,12,11,20,11,13,12,12,10,9,11,9,15,13,15,13,11,10,8,5,1,20,8,1,1,20,M C,401,1,1,1,8,1,1,5,1,1,15,20,1,1,1,1,0.0,0,0,0,0,0,0,0,0,0,0,0,0,0,0,0,0,0,0,0,0,0,0,0,0,0,0,0,0,0,0,0,0,0,0,0,0,0,0,0,0,0,0,0,0,0,0,0,0,nan,nan,nan,nan,nan,nan,nan,nan,nan,nan,nan,nan,nan,nan,nan,nan,nan,nan,nan,nan,nan,nan,nan,nan,nan,nan,nan,nan,nan,nan,nan,nan,nan,nan,nan,nan,nan,nan,nan,nan,nan,nan,nan,nan,nan,nan,nan,nan,nan,nan,nan,nan,nan,nan,nan,nan,nan,nan,nan,nan,nan,nan,nan,nan,nan,nan,nan,nan,nan,nan,nan,nan,nan,nan,nan,nan,nan,nan,nan,nan,nan,nan,nan,nan,nan,nan,nan,nan,nan,nan,nan,nan,nan,nan,nan,nan,nan,nan,nan,nan,nan,nan,nan,nan,nan,nan,nan,nan,nan,nan,nan,nan,nan,nan,nan,nan,nan,nan,nan,nan,nan,nan,nan,nan,nan,nan,nan,nan,nan,nan,nan,nan,nan,nan,nan,nan
19/6/2011,Benjamin AndrÃÂ©,85028361,769,8/3/1990,20,0,0,6,0,2400,3650,3650,145,112,710681,177,68,M C,1,3,2,1,1,3,2,3,2,3,2,7,11,11,6,12,9,9,13,6,7,12,8,10,13,10,12,13,13,13,13,12,15,9,6,8,12,15,16,15,13,12,8,5,14,13,20,15,9,14,10,8,7,16,5,18,13,14,6,12,8,6,10,10,20,14,12,1,20,M C,401,1,1,1,14,1,1,10,1,10,12,20,1,12,1,10,0.0,0,0,0,0,0,0,0,0,0,0,0,0,0,0,0,0,0,0,0,0,0,0,0,0,0,0,0,0,0,0,0,0,0,0,0,0,0,0,0,0,0,0,0,0,0,0,0,0,Benjamin AndrÃÂ©,ÃÂ£2.03m ,30.0,180.0,Midfielder - Central Midfield,right,LOSC Lille,35.0,1.0,1.0,2524.0,34.0,4.0,4.0,2743.0,29.0,0.0,2.0,1844.0,38.0,4.0,5.0,3229.0,27.0,1.0,0.0,1763.0,34.0,1.0,3.0,2837.0,38.0,0.0,3.0,3326.0,39.0,4.0,2.0,3466.0,46.0,4.0,4.0,3956.0,Ligue 1,36.0,2.0,3.0,2819.0,8.0,0.0,0.0,673.0,nan,nan,nan,nan,nan,nan,nan,nan,nan,nan,nan,nan,nan,nan,nan,nan,nan,nan,nan,nan,nan,nan,nan,nan,nan,nan,nan,nan,nan,nan,nan,nan,nan,nan,nan,nan,nan,nan,nan,nan,nan,nan,nan,nan,nan,nan,nan,nan,nan,nan,nan,nan,nan,nan,nan,nan,nan,nan,nan,nan,nan,nan,nan,nan,nan,nan,nan,nan,nan,nan,nan,nan,nan,nan,nan,nan,nan,nan,nan,nan,nan,nan,nan,nan,19-06-17,18.3.4.28,Benjamin AndrÃÂ©,85028361,769,03-Aug-90,26,0,0,7,0,4500,6450,6700,134,134,14888691,180,76,DM/M C,1,3,1,3,2,3,1,3,3,2,3,10,12,11,8,14,9,13,13,8,10,13,8,14,14,13,13,15,13,14,13,13,15,10,13,11,12,15,14,14,15,14,11,8,14,13,20,15,13,14,13,14,5,16,19,14,16,13,14,12,13,8,13,13,20,12,13,10,20,DM/M C,421,1,1,1,12,10,12,1,1,13,18,20,10,12,1,13,137439000000.0,0,0,0,0,0,0,0,0,0,0,0,0,0,0,0,0,0,0,0,0,0,0,0,0,0,0,0,0,0,0,0,0,0,0,0,0,0,1,0,0,0,0,0,0,0,0,0,0,Benjamin AndrÃÂ©,ÃÂ£9.00m ,30.0,180.0,Midfielder - Central Midfield,right,LOSC Lille,38.0,0.0,3.0,3326.0,39.0,4.0,2.0,3466.0,46.0,4.0,4.0,3956.0,36.0,2.0,3.0,2819.0,8.0,0.0,0.0,673.0,Ligue 1,15-07-16,17.3.2.23,Benjamin AndrÃÂ©,85028361.0,769.0,03-Aug-90,25.0,0.0,0.0,7.0,0.0,4592.0,6542.0,6642.0,136.0,133.0,11908799.0,180.0,76.0,DM/M C,3.0,2.0,3.0,1.0,1.0,2.0,1.0,1.0,2.0,1.0,1.0,10.0,12.0,11.0,8.0,14.0,9.0,12.0,13.0,8.0,10.0,14.0,8.0,12.0,14.0,13.0,13.0,15.0,13.0,14.0,13.0,13.0,15.0,10.0,7.0,11.0,12.0,15.0,16.0,14.0,15.0,14.0,10.0,8.0,14.0,13.0,20.0,15.0,13.0,14.0,13.0,14.0,9.0,16.0,13.0,13.0,15.0,13.0,14.0,12.0,11.0,8.0,Benjamin AndrÃÂ©,ÃÂ£3.60m ,Ligue 1
19/6/2011,Andrea Bertolacci,43028376,776,1/11/1991,20,0,0,0,0,2500,5750,5750,166,125,247952,179,75,M C,3,2,2,3,2,2,3,1,1,1,2,9,11,13,12,12,9,8,12,9,12,15,8,13,13,12,13,13,13,12,14,11,15,12,13,15,12,14,15,13,13,10,9,20,13,13,5,14,11,13,11,12,8,13,11,14,14,13,14,13,14,5,1,1,20,15,1,1,20,M C,401,1,1,7,15,1,1,1,1,1,15,20,1,1,1,1,0.0,0,0,0,0,0,0,0,0,0,0,0,0,0,0,0,0,0,0,0,0,0,0,0,0,0,0,0,0,0,0,0,0,0,0,0,0,0,0,0,0,0,0,0,0,0,0,0,0,Andrea Bertolacci,ÃÂ£2.25m ,29.0,179.0,Midfielder - Central Midfield,left,Without Club,10.0,4.0,0.0,734.0,28.0,3.0,3.0,1273.0,29.0,4.0,5.0,2027.0,26.0,2.0,1.0,1996.0,35.0,6.0,8.0,2726.0,30.0,1.0,1.0,2025.0,18.0,1.0,1.0,1048.0,34.0,1.0,1.0,3018.0,4.0,0.0,0.0,139.0,Serie A,12.0,0.0,0.0,536.0,nan,nan,nan,nan,29/6/2010,Andrea Bertolacci,43028376.0,776.0,1/11/1991,19.0,0.0,0.0,0.0,0.0,350.0,5084.0,4650.0,142.0,113.0,426105.0,179.0,75.0,M C,1.0,2.0,1.0,3.0,3.0,3.0,1.0,4.0,1.0,1.0,1.0,9.0,11.0,13.0,10.0,12.0,9.0,8.0,12.0,9.0,10.0,13.0,8.0,13.0,13.0,12.0,11.0,13.0,13.0,12.0,14.0,11.0,14.0,12.0,13.0,14.0,11.0,14.0,13.0,13.0,11.0,10.0,9.0,20.0,13.0,12.0,5.0,12.0,13.0,12.0,11.0,12.0,8.0,13.0,11.0,13.0,12.0,13.0,14.0,13.0,14.0,5.0,Andrea Bertolacci,ÃÂÃÂ£1.35m ,Serie A,19-06-17,18.3.4.28,Andrea Bertolacci,43028376,776,11-Jan-91,26,5,0,7,1,5250,6500,6800,144,136,19224059,179,75,M C,1,1,2,2,3,3,3,2,1,3,3,13,13,14,9,14,13,8,14,7,9,15,13,11,14,12,13,11,11,12,14,12,12,14,11,15,12,14,13,14,13,13,10,20,11,13,12,14,12,13,12,11,17,13,8,14,14,9,12,13,12,5,1,1,20,15,8,8,20,M C,401,1,1,5,15,1,1,1,1,1,10,20,8,8,1,1,256.0,0,0,0,0,0,0,0,0,1,0,0,0,0,0,0,0,0,0,0,0,0,0,0,0,0,0,0,0,0,0,0,0,0,0,0,0,0,0,0,0,0,0,0,0,0,0,0,0,Andrea Bertolacci,ÃÂ£6.75m ,29.0,179.0,Midfielder - Central Midfield,left,Without Club,18.0,1.0,1.0,1048.0,34.0,1.0,1.0,3018.0,4.0,0.0,0.0,139.0,12.0,0.0,0.0,536.0,nan,nan,nan,nan,Serie A,15-07-16,17.3.2.23,Andrea Bertolacci,43028376.0,776.0,11-Jan-91,25.0,5.0,0.0,7.0,1.0,5000.0,6800.0,6950.0,149.0,138.0,16359422.0,179.0,75.0,M C,1.0,2.0,3.0,3.0,1.0,2.0,3.0,3.0,2.0,1.0,2.0,13.0,12.0,14.0,10.0,14.0,13.0,8.0,14.0,7.0,9.0,15.0,12.0,11.0,14.0,12.0,14.0,12.0,13.0,12.0,15.0,13.0,14.0,14.0,11.0,15.0,13.0,14.0,14.0,14.0,13.0,12.0,10.0,20.0,14.0,13.0,12.0,14.0,12.0,13.0,12.0,11.0,12.0,13.0,10.0,14.0,14.0,11.0,13.0,13.0,12.0,5.0,Andrea Bertolacci,ÃÂ£9.00m ,Serie A
19/6/2011,AndrÃÂ© Almeida,55011100,788,9/10/1990,20,0,0,0,0,1799,5300,5300,139,106,62373,186,75,D/M RC,1,3,2,1,1,2,3,1,2,3,1,12,12,12,9,13,12,8,12,8,10,13,13,9,14,10,14,10,12,12,12,13,12,11,12,12,13,13,11,12,12,10,11,6,13,12,20,11,11,9,6,10,8,12,11,15,14,12,14,14,14,5,20,7,20,13,20,10,20,D/M RC,113,1,1,1,13,10,10,5,1,20,10,20,10,10,1,7,0.0,0,0,0,0,0,0,0,0,0,0,0,0,0,0,0,0,0,0,0,0,0,0,0,0,0,0,0,0,0,0,0,0,0,0,0,0,0,0,0,0,0,0,0,0,0,0,0,0,AndrÃÂ© Almeida,ÃÂ£900Th. ,30.0,186.0,Defender - Right-Back,right,SL Benfica,22.0,2.0,0.0,1699.0,16.0,1.0,0.0,1188.0,40.0,1.0,1.0,2953.0,27.0,0.0,1.0,2035.0,31.0,0.0,3.0,2112.0,37.0,0.0,6.0,3090.0,25.0,2.0,3.0,1851.0,40.0,2.0,8.0,3354.0,53.0,2.0,12.0,4727.0,Liga NOS,27.0,4.0,5.0,2366.0,5.0,0.0,2.0,374.0,nan,nan,nan,nan,nan,nan,nan,nan,nan,nan,nan,nan,nan,nan,nan,nan,nan,nan,nan,nan,nan,nan,nan,nan,nan,nan,nan,nan,nan,nan,nan,nan,nan,nan,nan,nan,nan,nan,nan,nan,nan,nan,nan,nan,nan,nan,nan,nan,nan,nan,nan,nan,nan,nan,nan,nan,nan,nan,nan,nan,nan,nan,nan,nan,nan,nan,nan,nan,nan,nan,nan,nan,nan,nan,nan,nan,nan,nan,nan,nan,nan,nan,nan,nan,19-06-17,18.3.4.28,AndrÃÂ© Almeida,55011100,788,10-Sep-90,26,8,0,17,0,4500,6800,6800,137,135,7318787,186,80,D/DM/M RLC,3,2,4,2,2,4,3,1,1,3,2,8,11,11,8,11,8,10,11,12,13,12,7,15,11,15,14,15,12,15,11,12,14,6,12,12,14,15,15,13,12,13,13,8,15,13,20,16,12,15,12,13,8,17,12,14,14,12,16,14,16,6,20,12,16,5,20,17,16,D/DM/M RLC,126,1,1,1,5,1,1,1,17,20,18,16,1,10,1,12,0.0,0,0,0,0,0,0,0,0,0,0,0,0,0,0,0,0,0,0,0,0,0,0,0,0,0,0,0,0,0,0,0,0,0,0,0,0,0,0,0,0,0,0,0,0,0,0,0,0,AndrÃÂ© Almeida,ÃÂ£6.75m ,30.0,186.0,Defender - Right-Back,right,SL Benfica,25.0,2.0,3.0,1851.0,40.0,2.0,8.0,3354.0,53.0,2.0,12.0,4727.0,27.0,4.0,5.0,2366.0,5.0,0.0,2.0,374.0,Liga NOS,15-07-16,17.3.2.23,AndrÃÂ© Almeida,55011100.0,788.0,10-Sep-90,25.0,8.0,0.0,17.0,0.0,4500.0,6850.0,6850.0,140.0,137.0,7074175.0,186.0,80.0,D/DM/M RLC,2.0,2.0,3.0,2.0,1.0,1.0,1.0,1.0,1.0,1.0,1.0,8.0,12.0,11.0,8.0,11.0,8.0,10.0,11.0,12.0,13.0,12.0,7.0,14.0,11.0,15.0,14.0,15.0,12.0,15.0,11.0,12.0,14.0,6.0,12.0,12.0,15.0,15.0,15.0,13.0,12.0,14.0,14.0,8.0,15.0,13.0,20.0,16.0,13.0,15.0,12.0,13.0,8.0,17.0,12.0,15.0,14.0,12.0,16.0,14.0,14.0,5.0,AndrÃÂ© Almeida,ÃÂ£4.50m ,Liga NOS
19/6/2011,Aleksandar Ignjovski,62013411,802,1/27/1991,20,0,0,1,0,3500,5939,6550,154,132,678486,175,68,DM/M C,3,1,1,3,1,3,2,3,3,1,3,8,10,11,7,13,6,8,7,8,17,13,10,17,12,18,12,17,8,8,11,13,18,6,10,10,9,15,19,15,17,11,8,15,14,12,20,16,8,11,12,11,4,19,14,15,13,14,17,14,13,5,14,14,19,12,14,14,19,DM/M C,311,1,1,1,12,1,1,1,14,14,20,19,13,13,14,14,137439000000.0,0,0,0,0,0,0,0,0,0,0,0,0,0,0,0,1,0,0,0,0,0,0,0,0,0,0,0,0,0,0,0,0,0,0,0,0,0,1,0,0,0,0,0,0,0,0,0,0,Aleksandar Ignjovski,ÃÂ£3.60m ,29.0,175.0,Midfielder - Defensive Midfield,right,Holstein Kiel,25.0,0.0,2.0,1953.0,26.0,0.0,1.0,1994.0,21.0,1.0,2.0,1667.0,14.0,0.0,0.0,811.0,22.0,0.0,1.0,1366.0,19.0,0.0,2.0,1239.0,21.0,0.0,0.0,1243.0,1.0,0.0,0.0,55.0,17.0,0.0,0.0,1059.0,Bundesliga,22.0,0.0,0.0,1261.0,5.0,0.0,0.0,224.0,nan,nan,nan,nan,nan,nan,nan,nan,nan,nan,nan,nan,nan,nan,nan,nan,nan,nan,nan,nan,nan,nan,nan,nan,nan,nan,nan,nan,nan,nan,nan,nan,nan,nan,nan,nan,nan,nan,nan,nan,nan,nan,nan,nan,nan,nan,nan,nan,nan,nan,nan,nan,nan,nan,nan,nan,nan,nan,nan,nan,nan,nan,nan,nan,nan,nan,nan,nan,nan,nan,nan,nan,nan,nan,nan,nan,nan,nan,nan,nan,nan,nan,nan,nan,19-06-17,18.3.4.28,Aleksandar Ignjovski,62013411,802,27-Jan-91,26,12,0,10,1,4200,6200,6200,128,124,4762059,175,71,D/WB/DM/M RC,1,3,1,1,2,4,1,4,3,2,2,8,10,12,6,9,6,8,7,12,14,11,10,15,10,18,10,16,8,12,9,8,18,6,11,10,12,13,17,14,15,12,8,14,16,13,20,16,8,13,14,11,4,19,14,16,12,14,17,12,10,5,20,16,18,12,20,14,18,D/WB/DM/M RC,133,1,1,1,10,12,12,1,14,20,18,18,12,12,10,16,0.0,0,0,0,0,0,0,0,0,0,0,0,0,0,0,0,0,0,0,0,0,0,0,0,0,0,0,0,0,0,0,0,0,0,0,0,0,0,0,0,0,0,0,0,0,0,0,0,0,Aleksandar Ignjovski,ÃÂ£450Th. ,29.0,175.0,Midfielder - Defensive Midfield,right,Holstein Kiel,21.0,0.0,0.0,1243.0,1.0,0.0,0.0,55.0,17.0,0.0,0.0,1059.0,22.0,0.0,0.0,1261.0,5.0,0.0,0.0,224.0,Bundesliga,15-07-16,17.3.2.23,Aleksandar Ignjovski,62013411.0,802.0,27-Jan-91,25.0,11.0,0.0,10.0,1.0,3446.0,6196.0,5946.0,128.0,124.0,2648542.0,175.0,68.0,D/WB/DM/M RC,2.0,3.0,1.0,3.0,3.0,2.0,4.0,2.0,2.0,3.0,2.0,8.0,11.0,12.0,6.0,10.0,6.0,8.0,7.0,12.0,14.0,11.0,10.0,15.0,10.0,18.0,10.0,16.0,8.0,12.0,9.0,8.0,18.0,6.0,11.0,10.0,11.0,14.0,18.0,14.0,15.0,12.0,8.0,14.0,16.0,13.0,20.0,16.0,7.0,13.0,14.0,11.0,4.0,19.0,14.0,16.0,12.0,14.0,17.0,12.0,10.0,5.0,Aleksandar Ignjovski,ÃÂ£1.35m ,Bundesliga
19/6/2011,Abdoulaye Coulibaly,85074660,31,4/6/1991,20,0,0,0,0,1308,4850,2617,125,97,45289,186,73,DM/M C,3,2,2,2,3,1,1,2,3,1,2,5,6,8,7,11,6,12,9,6,9,11,6,11,11,12,13,13,12,12,9,13,15,5,6,9,9,14,14,12,12,14,13,20,14,10,8,13,13,12,12,13,8,8,8,13,13,11,14,14,14,6,1,1,16,1,1,12,16,DM/M C,311,1,1,1,1,1,1,1,1,1,20,16,12,1,1,1,64.0,0,0,0,0,0,0,1,0,0,0,0,0,0,0,0,0,0,0,0,0,0,0,0,0,0,0,0,0,0,0,0,0,0,0,0,0,0,0,0,0,0,0,0,0,0,0,0,0,Adama Coulibaly,ÃÂ£2.70m ,40.0,186.0,Defender - Centre-Back,right,Retired,50.0,1.0,1.0,4474.0,9.0,0.0,0.0,747.0,26.0,1.0,0.0,2257.0,43.0,3.0,1.0,3930.0,28.0,2.0,0.0,2403.0,nan,nan,nan,nan,nan,nan,nan,nan,nan,nan,nan,nan,nan,nan,nan,nan,Ligue 1,nan,nan,nan,nan,nan,nan,nan,nan,nan,nan,nan,nan,nan,nan,nan,nan,nan,nan,nan,nan,nan,nan,nan,nan,nan,nan,nan,nan,nan,nan,nan,nan,nan,nan,nan,nan,nan,nan,nan,nan,nan,nan,nan,nan,nan,nan,nan,nan,nan,nan,nan,nan,nan,nan,nan,nan,nan,nan,nan,nan,nan,nan,nan,nan,nan,nan,nan,nan,nan,nan,nan,nan,nan,nan,nan,nan,nan,nan,nan,nan,nan,nan,nan,nan,nan,nan,nan,nan,nan,nan,nan,nan
19/6/2011,Aaron Ramsey,29000737,801,12/26/1990,20,14,3,12,2,5500,7250,7250,185,138,20426510,178,67,M C,1,1,3,1,2,3,3,3,2,2,3,7,11,12,11,15,6,4,12,3,7,16,5,11,17,8,11,10,14,12,15,12,17,15,7,15,9,12,15,12,17,13,8,16,16,11,20,14,10,14,3,13,5,15,14,14,17,13,17,16,10,3,10,1,20,13,12,1,20,M C,401,1,1,10,13,1,12,1,1,10,1,20,1,12,1,1,4294967424.0,0,0,0,0,0,0,0,1,0,0,0,0,0,0,0,0,0,0,0,0,0,0,0,0,0,0,0,0,0,0,0,0,1,0,0,0,0,0,0,0,0,0,0,0,0,0,0,0,Aaron Ramsey,ÃÂ£10.35m ,29.0,182.0,Midfielder - Central Midfield,both,Juventus FC,20.0,2.0,0.0,1189.0,44.0,3.0,6.0,3160.0,47.0,2.0,4.0,2692.0,34.0,16.0,10.0,2724.0,41.0,10.0,8.0,2918.0,40.0,6.0,5.0,3134.0,32.0,4.0,5.0,2016.0,32.0,11.0,12.0,2466.0,40.0,6.0,8.0,2171.0,Premier League,35.0,4.0,1.0,1384.0,4.0,0.0,1.0,327.0,nan,nan,nan,nan,nan,nan,nan,nan,nan,nan,nan,nan,nan,nan,nan,nan,nan,nan,nan,nan,nan,nan,nan,nan,nan,nan,nan,nan,nan,nan,nan,nan,nan,nan,nan,nan,nan,nan,nan,nan,nan,nan,nan,nan,nan,nan,nan,nan,nan,nan,nan,nan,nan,nan,nan,nan,nan,nan,nan,nan,nan,nan,nan,nan,nan,nan,nan,nan,nan,nan,nan,nan,nan,nan,nan,nan,nan,nan,nan,nan,nan,nan,nan,nan,19-06-17,18.3.4.28,Aaron Ramsey,29000737,801,26-Dec-90,26,47,12,12,2,6650,8000,7500,161,149,61032860,178,67,M/AM RC,3,2,2,3,3,1,1,3,3,1,2,9,13,15,11,15,8,5,12,3,8,15,12,12,17,10,14,13,14,14,17,14,15,14,12,17,11,16,16,13,16,13,8,10,16,12,20,15,12,12,6,15,14,16,16,14,16,14,17,16,14,6,8,8,20,16,16,12,20,M/AM RC,413,1,1,1,15,12,16,1,1,8,12,20,10,12,1,8,6442451072.0,0,0,0,0,0,0,0,1,0,0,0,0,0,0,0,0,0,0,0,0,0,0,0,0,0,0,0,0,0,0,0,1,1,0,0,0,0,0,0,0,0,0,0,0,0,0,0,0,Aaron Ramsey,ÃÂ£40.50m ,29.0,182.0,Midfielder - Central Midfield,both,Juventus FC,32.0,4.0,5.0,2016.0,32.0,11.0,12.0,2466.0,40.0,6.0,8.0,2171.0,35.0,4.0,1.0,1384.0,4.0,0.0,1.0,327.0,Premier League,15-07-16,17.3.2.23,Aaron Ramsey,29000737.0,801.0,26-Dec-90,25.0,44.0,11.0,12.0,2.0,6750.0,8000.0,7750.0,164.0,155.0,71432176.0,178.0,67.0,M/AM RC,1.0,3.0,2.0,3.0,2.0,1.0,3.0,2.0,1.0,1.0,3.0,9.0,13.0,15.0,12.0,15.0,8.0,5.0,12.0,3.0,9.0,15.0,12.0,12.0,17.0,10.0,14.0,13.0,16.0,14.0,17.0,14.0,15.0,14.0,12.0,17.0,11.0,16.0,16.0,13.0,16.0,14.0,8.0,12.0,16.0,12.0,20.0,16.0,12.0,14.0,6.0,15.0,12.0,16.0,19.0,14.0,16.0,14.0,17.0,16.0,14.0,6.0,Aaron Ramsey,ÃÂ£31.50m ,Premier League
19/6/2011,Yuki Ohtsu,45015203,116,3/24/1990,21,0,0,1,0,2000,5150,5000,113,101,126482,180,73,M/AM C,1,2,1,2,3,1,3,2,1,3,2,10,8,14,14,13,9,8,10,8,14,13,10,9,11,13,14,8,14,8,12,7,10,13,8,14,8,10,11,12,10,7,9,11,16,12,20,7,7,10,7,7,9,10,7,13,17,7,12,8,10,13,1,1,20,17,1,1,20,M/AM C,411,1,1,12,17,1,1,1,1,1,1,20,1,1,1,1,0.0,0,0,0,0,0,0,0,0,0,0,0,0,0,0,0,0,0,0,0,0,0,0,0,0,0,0,0,0,0,0,0,0,0,0,0,0,0,0,0,0,0,0,0,0,0,0,0,0,Yuki Otsu,ÃÂ£360Th. ,30.0,180.0,Midfielder - Attacking Midfield,right,Yokohama F. Marinos,11.0,0.0,2.0,797.0,13.0,0.0,5.0,697.0,27.0,7.0,3.0,1309.0,22.0,4.0,3.0,1631.0,37.0,3.0,4.0,1562.0,26.0,3.0,4.0,916.0,23.0,1.0,0.0,880.0,36.0,3.0,4.0,2269.0,32.0,3.0,1.0,1265.0,Bundesliga,12.0,0.0,0.0,336.0,nan,nan,nan,nan,nan,nan,nan,nan,nan,nan,nan,nan,nan,nan,nan,nan,nan,nan,nan,nan,nan,nan,nan,nan,nan,nan,nan,nan,nan,nan,nan,nan,nan,nan,nan,nan,nan,nan,nan,nan,nan,nan,nan,nan,nan,nan,nan,nan,nan,nan,nan,nan,nan,nan,nan,nan,nan,nan,nan,nan,nan,nan,nan,nan,nan,nan,nan,nan,nan,nan,nan,nan,nan,nan,nan,nan,nan,nan,nan,nan,nan,nan,nan,nan,nan,nan,nan,nan
19/6/2011,Younousse SankharÃÂ©,34011678,769,9/10/1989,21,0,0,16,2,4250,5354,5350,150,119,1548788,184,76,DM/M C,1,2,2,1,2,1,2,6,1,3,3,10,10,13,7,13,12,13,10,6,8,14,9,9,15,12,13,12,11,11,13,11,12,13,10,11,10,11,12,15,13,15,13,20,15,13,5,16,15,13,12,14,5,12,13,15,15,7,11,11,13,11,8,8,20,14,1,12,20,DM/M C,421,1,1,1,14,12,1,5,8,1,17,20,12,1,8,1,34359739040.0,0,0,0,0,0,1,0,1,0,1,0,0,0,0,0,0,0,0,0,0,0,0,0,0,0,0,0,0,0,0,0,0,0,0,0,1,0,0,0,0,0,0,0,0,0,0,0,0,Younousse SankharÃÂ©,ÃÂ£1.80m ,31.0,184.0,Midfielder - Central Midfield,left,CSKA Sofia,27.0,6.0,0.0,2305.0,38.0,5.0,0.0,3140.0,20.0,0.0,2.0,1552.0,40.0,3.0,4.0,3372.0,41.0,0.0,5.0,3325.0,36.0,6.0,2.0,3251.0,41.0,7.0,4.0,3259.0,33.0,10.0,1.0,2234.0,33.0,4.0,5.0,2353.0,Ligue 1,nan,nan,nan,nan,12.0,2.0,2.0,780.0,nan,nan,nan,nan,nan,nan,nan,nan,nan,nan,nan,nan,nan,nan,nan,nan,nan,nan,nan,nan,nan,nan,nan,nan,nan,nan,nan,nan,nan,nan,nan,nan,nan,nan,nan,nan,nan,nan,nan,nan,nan,nan,nan,nan,nan,nan,nan,nan,nan,nan,nan,nan,nan,nan,nan,nan,nan,nan,nan,nan,nan,nan,nan,nan,nan,nan,nan,nan,nan,nan,nan,nan,nan,nan,nan,nan,nan,nan,nan,nan,nan,nan,nan,nan,19-06-17,18.3.4.28,Younousse SankharÃÂ©,34011678,41,10-Sep-89,27,6,1,0,0,4250,6450,6450,134,129,9188583,184,76,M C,2,3,3,2,1,3,2,1,1,3,2,10,11,12,10,13,12,13,10,6,10,13,9,13,12,14,13,15,12,12,12,12,15,12,12,14,12,13,15,15,13,15,13,20,15,14,7,16,15,11,12,14,5,12,13,15,10,12,12,11,10,10,7,7,20,10,1,10,20,M C,401,1,1,1,10,10,1,5,7,1,15,20,10,1,7,1,680.0,0,0,0,1,0,1,0,1,0,1,0,0,0,0,0,0,0,0,0,0,0,0,0,0,0,0,0,0,0,0,0,0,0,0,0,0,0,0,0,0,0,0,0,0,0,0,0,0,Younousse SankharÃÂ©,ÃÂ£4.50m ,31.0,184.0,Midfielder - Central Midfield,left,CSKA Sofia,41.0,7.0,4.0,3259.0,33.0,10.0,1.0,2234.0,33.0,4.0,5.0,2353.0,nan,nan,nan,nan,12.0,2.0,2.0,780.0,Ligue 1,15-07-16,17.3.2.23,Younousse SankharÃÂ©,34011678.0,41.0,10-Sep-89,26.0,0.0,0.0,0.0,0.0,4500.0,6300.0,6450.0,130.0,128.0,8826973.0,184.0,76.0,DM/M C,3.0,3.0,2.0,3.0,2.0,3.0,2.0,1.0,3.0,1.0,3.0,10.0,11.0,13.0,9.0,13.0,12.0,13.0,10.0,6.0,11.0,13.0,9.0,14.0,12.0,12.0,13.0,12.0,12.0,11.0,13.0,12.0,13.0,13.0,10.0,12.0,13.0,12.0,16.0,15.0,13.0,15.0,13.0,20.0,15.0,14.0,5.0,16.0,15.0,13.0,12.0,14.0,5.0,12.0,12.0,14.0,10.0,7.0,11.0,11.0,13.0,10.0,Younousse SankharÃÂ©,ÃÂ£3.15m ,Ligue 1
19/6/2011,Yacine Brahimi,34002647,769,2/8/1990,21,0,0,5,1,4350,5450,5450,160,121,276095,175,65,AM RLC,2,1,1,1,3,2,1,5,2,1,1,12,12,15,7,16,13,5,10,5,1,13,12,2,16,6,10,7,13,11,14,10,13,16,7,13,5,7,10,16,15,12,7,10,15,13,20,14,7,13,6,14,6,8,8,16,14,11,12,14,14,8,1,1,15,20,18,18,20,AM RLC,506,1,1,1,20,18,18,1,1,1,1,15,12,12,1,1,2251830000000000.0,0,0,0,0,0,0,0,0,0,0,0,0,0,0,0,0,0,0,0,0,1,0,0,0,0,0,0,0,0,0,0,0,0,0,0,1,0,0,0,0,0,0,0,0,0,0,0,0,Yacine Brahimi,ÃÂ£2.70m ,30.0,175.0,Forward - Left Winger,right,Al-Rayyan SC,26.0,6.0,3.0,1509.0,28.0,3.0,2.0,1130.0,28.0,0.0,2.0,1916.0,36.0,3.0,3.0,2858.0,42.0,13.0,10.0,2835.0,44.0,9.0,10.0,3245.0,31.0,7.0,4.0,1927.0,49.0,12.0,10.0,3914.0,49.0,13.0,9.0,3429.0,Ligue 1,23.0,15.0,5.0,2040.0,3.0,1.0,1.0,270.0,29/6/2010,Yacine Brahimi,34002647.0,769.0,2/8/1990,20.0,0.0,0.0,0.0,0.0,150.0,3750.0,3750.0,168.0,114.0,926830.0,175.0,65.0,M/AM C,1.0,2.0,1.0,3.0,1.0,1.0,2.0,3.0,2.0,2.0,1.0,12.0,12.0,14.0,6.0,14.0,13.0,5.0,9.0,6.0,2.0,11.0,12.0,2.0,16.0,6.0,8.0,6.0,12.0,12.0,15.0,13.0,8.0,13.0,8.0,12.0,6.0,11.0,11.0,16.0,14.0,11.0,7.0,20.0,15.0,13.0,10.0,14.0,7.0,14.0,6.0,10.0,6.0,10.0,12.0,14.0,8.0,2.0,13.0,10.0,12.0,3.0,Yacine Brahimi,ÃÂÃÂ£2.88m ,Ligue 1,19-06-17,18.3.4.28,Yacine Brahimi,34002647,5,08-Feb-90,27,38,8,0,0,6250,7500,7650,156,154,61104149,175,69,AM RLC,3,1,3,1,1,2,1,2,2,4,3,13,13,18,13,16,14,5,12,5,5,16,11,5,18,10,12,10,14,13,16,15,9,19,5,14,6,11,10,16,16,14,7,13,12,15,20,13,9,11,6,15,7,13,14,16,8,9,10,11,14,8,1,1,12,20,16,20,18,AM RLC,506,1,1,1,18,20,16,1,1,1,1,1,12,12,1,1,2252380000000000.0,0,0,0,0,0,0,0,0,0,0,0,0,0,0,0,0,0,0,0,0,1,0,0,0,0,0,0,0,0,0,0,0,0,0,0,1,0,0,0,1,0,0,0,0,0,0,0,0,Yacine Brahimi,ÃÂ£23.40m ,30.0,175.0,Forward - Left Winger,right,Al-Rayyan SC,31.0,7.0,4.0,1927.0,49.0,12.0,10.0,3914.0,49.0,13.0,9.0,3429.0,23.0,15.0,5.0,2040.0,4.0,1.0,1.0,360.0,Liga NOS,15-07-16,17.3.2.23,Yacine Brahimi,34002647.0,5.0,08-Feb-90,26.0,28.0,7.0,0.0,0.0,6000.0,7500.0,7550.0,162.0,151.0,49082187.0,175.0,69.0,AM RLC,1.0,3.0,2.0,2.0,1.0,1.0,3.0,1.0,3.0,1.0,2.0,13.0,13.0,18.0,13.0,16.0,14.0,5.0,12.0,5.0,5.0,14.0,11.0,5.0,18.0,6.0,12.0,8.0,14.0,12.0,14.0,11.0,9.0,19.0,5.0,13.0,6.0,9.0,9.0,16.0,16.0,14.0,7.0,13.0,12.0,16.0,20.0,13.0,10.0,8.0,6.0,15.0,7.0,13.0,7.0,16.0,8.0,9.0,10.0,11.0,14.0,8.0,Yacine Brahimi,ÃÂ£16.20m ,Liga NOS
19/6/2011,Vladimir Weiss,4001874,794,11/30/1989,21,18,1,7,0,5300,6800,6800,169,131,1475550,176,69,M/AM RLC,1,3,2,3,2,3,1,2,2,2,1,13,14,15,12,15,13,3,12,3,3,13,9,5,15,9,15,10,11,11,15,10,15,15,7,15,5,11,11,16,15,16,6,4,13,15,20,14,9,12,8,13,7,13,15,14,9,14,14,9,15,7,1,1,17,20,20,17,15,M/AM RLC,526,1,1,7,15,14,20,1,1,1,1,15,17,15,1,1,70420600000000.0,0,1,0,0,0,0,0,0,0,0,0,0,0,0,0,0,0,0,0,0,0,0,0,0,0,0,0,0,1,0,0,0,0,0,1,1,0,0,0,0,0,0,0,0,0,0,1,0,Vladimir Weiss,ÃÂ£3.15m ,30.0,173.0,Forward - Left Winger,right,Slovan Bratislava,35.0,5.0,15.0,1858.0,33.0,4.0,5.0,2146.0,23.0,5.0,5.0,1492.0,39.0,11.0,10.0,2585.0,31.0,10.0,7.0,2060.0,24.0,10.0,5.0,1882.0,21.0,10.0,4.0,1821.0,7.0,5.0,1.0,500.0,20.0,8.0,2.0,1431.0,LaLiga,8.0,1.0,0.0,292.0,6.0,0.0,2.0,188.0,nan,nan,nan,nan,nan,nan,nan,nan,nan,nan,nan,nan,nan,nan,nan,nan,nan,nan,nan,nan,nan,nan,nan,nan,nan,nan,nan,nan,nan,nan,nan,nan,nan,nan,nan,nan,nan,nan,nan,nan,nan,nan,nan,nan,nan,nan,nan,nan,nan,nan,nan,nan,nan,nan,nan,nan,nan,nan,nan,nan,nan,nan,nan,nan,nan,nan,nan,nan,nan,nan,nan,nan,nan,nan,nan,nan,nan,nan,nan,nan,nan,nan,nan,nan
19/6/2011,Toni Kroos,156772,771,1/4/1990,21,18,0,10,2,6600,7950,7950,175,149,7855047,182,74,M/AM LC,1,1,3,1,1,2,3,6,2,1,2,16,18,13,14,19,15,6,17,6,6,18,14,10,17,7,13,8,15,9,17,16,8,11,9,8,11,15,8,11,13,8,9,17,12,13,20,12,10,10,3,14,6,15,16,12,16,9,13,15,18,4,1,1,20,19,14,16,20,M/AM LC,414,1,1,1,19,16,14,1,1,1,10,20,14,13,1,1,4512400000000000.0,0,0,0,0,0,0,0,0,0,0,0,1,0,0,0,0,0,0,0,0,0,0,1,0,0,0,0,0,0,0,0,0,0,0,0,0,0,0,0,0,0,0,0,1,0,0,0,0,Toni Kroos,ÃÂ£20.70m ,30.0,183.0,Midfielder - Central Midfield,right,Real Madrid,37.0,2.0,8.0,2409.0,51.0,7.0,19.0,4095.0,37.0,9.0,8.0,2857.0,51.0,4.0,9.0,3931.0,55.0,2.0,14.0,4600.0,44.0,1.0,13.0,3741.0,48.0,4.0,16.0,4170.0,43.0,5.0,10.0,3570.0,43.0,1.0,6.0,3431.0,Bundesliga,45.0,6.0,9.0,3569.0,5.0,0.0,0.0,323.0,29/6/2010,Toni Kroos,156772.0,771.0,1/4/1990,20.0,8.0,0.0,10.0,2.0,5250.0,7400.0,7400.0,178.0,148.0,37390172.0,182.0,74.0,M/AM LC,3.0,1.0,3.0,2.0,2.0,1.0,2.0,5.0,3.0,3.0,2.0,17.0,17.0,13.0,16.0,18.0,15.0,6.0,18.0,6.0,5.0,17.0,14.0,8.0,16.0,7.0,14.0,8.0,15.0,10.0,18.0,17.0,12.0,12.0,11.0,8.0,10.0,15.0,8.0,10.0,12.0,9.0,9.0,16.0,14.0,14.0,20.0,12.0,11.0,11.0,3.0,14.0,3.0,15.0,14.0,15.0,16.0,14.0,13.0,15.0,18.0,4.0,Toni Kroos,ÃÂÃÂ£10.80m ,Bundesliga,19-06-17,18.3.4.28,Toni Kroos,156772,771,04-Jan-90,27,76,12,10,2,8400,8700,8500,176,170,232186002,183,76,DM/M C,2,2,3,3,3,1,2,3,1,3,1,18,18,14,13,18,14,7,17,8,8,20,13,9,16,9,17,9,18,14,18,19,9,11,12,14,12,18,12,11,9,12,10,15,12,12,20,15,14,13,10,14,7,13,8,14,8,14,17,18,17,7,1,1,20,11,1,10,20,DM/M C,421,1,1,1,11,1,1,1,1,1,17,20,10,1,1,1,140737000000000.0,0,0,0,0,0,0,0,0,0,0,1,1,0,0,0,0,0,0,0,0,0,0,1,0,0,0,0,0,0,0,0,0,0,0,0,0,0,0,0,0,0,0,0,0,0,0,0,1,Toni Kroos,ÃÂ£72.00m ,30.0,183.0,Midfielder - Central Midfield,right,Real Madrid,48.0,4.0,16.0,4170.0,43.0,5.0,10.0,3570.0,43.0,1.0,6.0,3431.0,45.0,6.0,9.0,3569.0,5.0,0.0,0.0,323.0,LaLiga,15-07-16,17.3.2.23,Toni Kroos,156772.0,771.0,04-Jan-90,26.0,71.0,11.0,10.0,2.0,8400.0,8600.0,8650.0,176.0,172.0,112935272.0,182.0,78.0,DM/M C,4.0,3.0,3.0,2.0,2.0,2.0,1.0,3.0,3.0,1.0,2.0,18.0,18.0,14.0,13.0,18.0,14.0,7.0,17.0,8.0,8.0,20.0,13.0,9.0,16.0,10.0,17.0,10.0,18.0,14.0,18.0,19.0,9.0,11.0,12.0,14.0,12.0,18.0,13.0,12.0,9.0,12.0,10.0,15.0,12.0,13.0,20.0,16.0,14.0,13.0,10.0,14.0,7.0,13.0,8.0,14.0,8.0,14.0,17.0,18.0,17.0,7.0,Toni Kroos,ÃÂ£63.00m ,LaLiga
19/6/2011,Tongo Doumbia,85040297,769,8/6/1989,21,0,0,0,0,4400,5597,5571,150,124,452696,192,80,DM/M C,1,3,1,3,3,2,2,9,1,2,3,5,8,10,6,12,7,13,12,6,11,13,7,9,12,14,13,14,10,13,12,11,15,8,7,9,12,15,18,14,13,17,16,8,15,13,20,15,17,12,14,13,7,14,15,14,12,12,10,14,14,7,10,1,20,12,1,1,20,DM/M C,421,1,10,1,12,1,1,10,1,1,16,20,1,1,1,1,0.0,0,0,0,0,0,0,0,0,0,0,0,0,0,0,0,0,0,0,0,0,0,0,0,0,0,0,0,0,0,0,0,0,0,0,0,0,0,0,0,0,0,0,0,0,0,0,0,0,Tongo Doumbia,ÃÂ£1.80m ,31.0,191.0,Midfielder - Defensive Midfield,right,Ajman Club,20.0,0.0,0.0,1007.0,34.0,2.0,1.0,2376.0,35.0,2.0,3.0,2533.0,36.0,4.0,2.0,3004.0,26.0,3.0,2.0,2179.0,28.0,1.0,2.0,2170.0,12.0,0.0,0.0,668.0,32.0,1.0,1.0,2578.0,14.0,1.0,1.0,1042.0,Ligue 1,4.0,0.0,0.0,301.0,nan,nan,nan,nan,nan,nan,nan,nan,nan,nan,nan,nan,nan,nan,nan,nan,nan,nan,nan,nan,nan,nan,nan,nan,nan,nan,nan,nan,nan,nan,nan,nan,nan,nan,nan,nan,nan,nan,nan,nan,nan,nan,nan,nan,nan,nan,nan,nan,nan,nan,nan,nan,nan,nan,nan,nan,nan,nan,nan,nan,nan,nan,nan,nan,nan,nan,nan,nan,nan,nan,nan,nan,nan,nan,nan,nan,nan,nan,nan,nan,nan,nan,nan,nan,nan,nan,nan,nan
19/6/2011,Tom Cleverley,28000906,765,8/12/1989,21,0,0,16,0,4850,7100,7100,160,136,3081614,175,67,M/AM RLC,2,2,2,2,2,2,2,2,2,2,2,11,15,13,13,14,6,9,14,9,9,14,4,10,14,13,13,13,14,10,10,10,18,12,9,14,9,15,15,14,11,12,8,13,15,14,20,14,11,14,10,10,9,16,7,11,14,16,16,12,12,2,1,1,19,20,18,18,20,M/AM RLC,526,1,1,1,20,18,17,1,1,1,1,19,18,18,1,1,2251800000000000.0,0,0,0,1,0,1,0,0,0,0,0,0,0,0,0,0,0,0,0,0,0,0,0,0,0,0,0,0,1,0,0,0,0,0,0,0,0,0,0,0,0,0,0,0,0,0,0,0,Tom Cleverley,ÃÂ£7.65m ,31.0,175.0,Midfielder - Central Midfield,right,Watford FC,25.0,4.0,2.0,1632.0,17.0,0.0,4.0,944.0,33.0,4.0,4.0,2353.0,31.0,1.0,1.0,2227.0,38.0,3.0,0.0,3098.0,30.0,2.0,6.0,2319.0,29.0,0.0,3.0,1958.0,25.0,1.0,3.0,2008.0,17.0,1.0,1.0,662.0,Premier League,19.0,1.0,0.0,1000.0,7.0,1.0,0.0,506.0,29/6/2010,Tom Cleverley,28000906.0,765.0,8/12/1989,20.0,0.0,0.0,6.0,0.0,4000.0,6250.0,6250.0,142.0,129.0,4130116.0,175.0,67.0,M/AM RLC,2.0,2.0,2.0,2.0,2.0,2.0,2.0,2.0,2.0,2.0,2.0,7.0,14.0,12.0,13.0,14.0,6.0,9.0,14.0,9.0,9.0,14.0,4.0,10.0,12.0,13.0,12.0,13.0,14.0,10.0,9.0,10.0,18.0,12.0,9.0,12.0,9.0,15.0,15.0,13.0,11.0,10.0,8.0,15.0,15.0,14.0,20.0,14.0,11.0,14.0,10.0,10.0,9.0,16.0,8.0,11.0,14.0,16.0,16.0,12.0,12.0,2.0,Tom Cleverley,ÃÂÃÂ£2.25m ,Premier League,19-06-17,18.3.4.28,Tom Cleverley,28000906,765,12-Aug-89,27,13,0,16,0,5550,7000,7000,145,143,42711500,175,67,M/AM C,2,2,2,2,2,2,2,2,2,2,2,13,13,10,10,14,13,6,12,9,9,13,8,10,14,14,12,13,13,15,14,14,18,8,12,14,10,17,17,14,15,10,7,14,17,12,20,18,8,13,10,10,13,16,11,13,14,10,16,15,14,2,6,1,20,18,10,14,20,M/AM C,411,1,1,1,18,14,10,1,6,6,10,20,14,10,1,1,269485120.0,0,0,0,0,0,0,1,0,0,0,1,0,0,0,0,0,0,0,0,0,1,0,0,0,0,0,0,0,1,0,0,0,0,0,0,0,0,0,0,0,0,0,0,0,0,0,0,0,nan,nan,nan,nan,nan,nan,nan,nan,nan,nan,nan,nan,nan,nan,nan,nan,nan,nan,nan,nan,nan,nan,nan,nan,nan,nan,nan,nan,15-07-16,17.3.2.23,Tom Cleverley,28000906.0,765.0,12-Aug-89,26.0,13.0,0.0,16.0,0.0,5397.0,6497.0,6497.0,145.0,133.0,21019791.0,175.0,67.0,M C,2.0,2.0,2.0,2.0,2.0,2.0,2.0,2.0,2.0,2.0,2.0,12.0,13.0,10.0,10.0,14.0,7.0,6.0,10.0,9.0,7.0,13.0,8.0,9.0,14.0,14.0,12.0,13.0,13.0,14.0,14.0,14.0,18.0,8.0,9.0,14.0,10.0,17.0,15.0,14.0,17.0,10.0,7.0,14.0,15.0,12.0,20.0,15.0,8.0,13.0,10.0,10.0,13.0,16.0,20.0,13.0,14.0,13.0,16.0,15.0,14.0,2.0,Tom Cleverley,ÃÂ£7.20m ,Premier League
19/6/2011,Sergio Tejera,29000484,796,5/28/1990,21,0,0,0,0,4000,6150,6150,151,127,658924,183,76,M/AM C,3,2,3,1,2,1,1,1,1,1,2,16,15,12,10,16,15,7,13,6,5,16,11,9,16,10,12,10,14,10,17,13,12,16,8,13,10,13,12,12,13,11,11,20,9,11,7,14,11,10,13,9,15,10,12,17,10,13,15,14,18,5,1,1,20,16,5,12,20,M/AM C,411,1,1,1,16,8,1,1,1,1,6,20,12,5,1,1,128.0,0,0,0,0,0,0,0,1,0,0,0,0,0,0,0,0,0,0,0,0,0,0,0,0,0,0,0,0,0,0,0,0,0,0,0,0,0,0,0,0,0,0,0,0,0,0,0,0,Sergio Tejera,ÃÂ£900Th. ,30.0,180.0,Midfielder - Central Midfield,left,Real Oviedo,28.0,1.0,3.0,1683.0,18.0,0.0,1.0,848.0,13.0,1.0,0.0,419.0,13.0,0.0,3.0,520.0,12.0,1.0,0.0,687.0,37.0,0.0,3.0,2835.0,38.0,6.0,5.0,3293.0,26.0,0.0,2.0,1992.0,35.0,4.0,3.0,2865.0,LaLiga,35.0,2.0,2.0,2977.0,8.0,1.0,0.0,654.0,29/6/2010,Sergio Tejera,29000484.0,796.0,5/28/1990,20.0,0.0,0.0,0.0,0.0,3000.0,4500.0,4500.0,134.0,114.0,2103146.0,183.0,76.0,M/AM C,3.0,2.0,1.0,1.0,1.0,1.0,1.0,1.0,3.0,3.0,1.0,16.0,15.0,12.0,10.0,16.0,15.0,7.0,13.0,6.0,5.0,17.0,11.0,9.0,16.0,10.0,11.0,10.0,14.0,9.0,17.0,12.0,12.0,16.0,8.0,13.0,7.0,13.0,9.0,11.0,12.0,10.0,11.0,20.0,9.0,10.0,6.0,12.0,10.0,10.0,13.0,9.0,15.0,10.0,12.0,17.0,11.0,13.0,15.0,14.0,18.0,5.0,Sergio Tejera,ÃÂÃÂ£720Th. ,LaLiga
19/6/2011,Sebastian Rudy,29022542,771,2/28/1990,21,0,0,12,2,6000,6750,6750,144,130,1247466,179,73,DM/M C,3,1,2,1,2,2,3,5,2,1,1,13,14,12,10,16,10,7,11,6,9,16,11,13,15,6,14,6,11,9,15,15,9,12,5,10,10,18,13,12,15,7,7,12,8,14,20,11,6,10,4,8,9,14,14,12,14,8,4,17,19,5,1,1,20,15,13,14,20,DM/M C,421,1,1,1,15,1,1,1,1,1,17,20,14,13,1,1,8813290000000.0,0,0,0,0,0,0,0,1,0,0,0,0,0,0,0,0,0,0,0,0,0,0,1,0,1,0,0,0,0,0,0,0,0,0,1,0,0,0,0,0,0,0,0,1,0,0,0,0,Sebastian Rudy,ÃÂ£4.95m ,30.0,180.0,Midfielder - Defensive Midfield,right,TSG 1899 Hoffenheim,38.0,2.0,7.0,2870.0,29.0,0.0,2.0,2457.0,26.0,0.0,2.0,1932.0,30.0,2.0,6.0,2511.0,33.0,4.0,7.0,2596.0,25.0,2.0,1.0,1874.0,34.0,3.0,10.0,2998.0,35.0,1.0,5.0,2133.0,28.0,0.0,0.0,1853.0,Bundesliga,35.0,1.0,4.0,2993.0,5.0,0.0,2.0,450.0,29/6/2010,Sebastian Rudy,29022542.0,771.0,2/28/1990,20.0,0.0,0.0,0.0,0.0,3250.0,6300.0,6300.0,146.0,122.0,8000000.0,179.0,73.0,DM/M C,2.0,3.0,2.0,1.0,2.0,3.0,3.0,3.0,3.0,2.0,2.0,13.0,14.0,12.0,10.0,16.0,10.0,7.0,12.0,6.0,7.0,16.0,11.0,9.0,15.0,6.0,12.0,6.0,14.0,9.0,17.0,10.0,10.0,12.0,5.0,10.0,9.0,18.0,12.0,12.0,15.0,6.0,7.0,12.0,8.0,14.0,20.0,9.0,6.0,10.0,4.0,10.0,9.0,14.0,14.0,13.0,10.0,12.0,20.0,14.0,14.0,5.0,Sebastian Rudy,ÃÂÃÂ£5.85m ,Bundesliga,19-06-17,18.3.4.28,Sebastian Rudy,29022542,771,28-Feb-90,27,20,0,23,5,6500,7500,7500,150,150,49787611,180,74,D/WB/DM/M RC,2,3,3,1,3,3,2,3,3,3,2,12,12,10,9,15,10,7,13,8,11,16,11,13,15,11,16,10,17,13,14,16,9,8,10,9,15,18,12,12,14,10,9,12,13,12,20,16,9,13,4,10,7,14,7,13,13,11,15,17,19,3,16,16,20,12,16,10,20,D/WB/DM/M RC,343,1,1,1,12,10,11,1,1,16,20,20,10,11,1,16,17200840704.0,0,0,0,0,0,0,0,0,0,0,0,0,0,0,0,0,0,0,0,0,0,0,1,0,1,0,0,0,0,0,0,0,0,0,1,0,0,0,0,0,0,0,0,0,0,0,0,0,Sebastian Rudy,ÃÂ£13.50m ,30.0,180.0,Midfielder - Defensive Midfield,right,TSG 1899 Hoffenheim,34.0,3.0,10.0,2998.0,35.0,1.0,5.0,2133.0,28.0,0.0,0.0,1853.0,35.0,1.0,4.0,2993.0,5.0,0.0,2.0,450.0,Bundesliga,15-07-16,17.3.2.23,Sebastian Rudy,29022542.0,771.0,28-Feb-90,26.0,11.0,0.0,23.0,5.0,6246.0,7246.0,7246.0,146.0,145.0,26479174.0,180.0,74.0,D/WB/DM/M RC,1.0,3.0,2.0,3.0,3.0,2.0,3.0,2.0,2.0,1.0,2.0,12.0,12.0,10.0,9.0,15.0,10.0,7.0,11.0,8.0,11.0,16.0,11.0,13.0,15.0,11.0,15.0,10.0,16.0,13.0,14.0,16.0,8.0,8.0,9.0,9.0,14.0,18.0,12.0,12.0,14.0,10.0,7.0,12.0,13.0,12.0,20.0,15.0,9.0,13.0,4.0,10.0,7.0,14.0,7.0,13.0,13.0,11.0,15.0,17.0,19.0,3.0,Sebastian Rudy,ÃÂ£7.20m ,Bundesliga
19/6/2011,Rodney Strasser,43037061,43,3/30/1990,21,3,0,0,0,1500,5264,5400,141,117,96929,178,80,DM/M RC,2,3,2,3,1,2,2,3,2,3,1,4,6,7,8,9,5,12,9,15,14,11,8,14,11,17,12,14,13,12,12,12,16,4,6,9,15,14,14,13,13,15,10,7,15,14,20,13,15,13,16,7,8,12,17,14,15,12,14,15,16,4,1,1,20,1,15,12,20,DM/M RC,423,1,1,1,1,1,1,1,1,1,17,20,12,15,1,1,0.0,0,0,0,0,0,0,0,0,0,0,0,0,0,0,0,0,0,0,0,0,0,0,0,0,0,0,0,0,0,0,0,0,0,0,0,0,0,0,0,0,0,0,0,0,0,0,0,0,Rodney Strasser,ÃÂ£1.80m ,30.0,181.0,Midfielder - Defensive Midfield,right,Turun Palloseura,8.0,1.0,0.0,463.0,15.0,1.0,0.0,970.0,4.0,0.0,0.0,166.0,22.0,0.0,0.0,1684.0,2.0,0.0,0.0,61.0,28.0,1.0,1.0,2259.0,13.0,0.0,0.0,911.0,nan,nan,nan,nan,14.0,0.0,1.0,1106.0,Serie A,9.0,0.0,0.0,515.0,nan,nan,nan,nan,nan,nan,nan,nan,nan,nan,nan,nan,nan,nan,nan,nan,nan,nan,nan,nan,nan,nan,nan,nan,nan,nan,nan,nan,nan,nan,nan,nan,nan,nan,nan,nan,nan,nan,nan,nan,nan,nan,nan,nan,nan,nan,nan,nan,nan,nan,nan,nan,nan,nan,nan,nan,nan,nan,nan,nan,nan,nan,nan,nan,nan,nan,nan,nan,nan,nan,nan,nan,nan,nan,nan,nan,nan,nan,nan,nan,nan,nan,nan,nan,nan,nan,nan,nan
19/6/2011,Rene Krhin,64001295,795,5/21/1990,21,4,0,3,0,4000,5800,5650,149,120,265673,189,78,DM/M C,1,1,1,1,1,1,1,1,1,1,1,8,8,10,6,13,8,12,11,5,11,14,11,13,13,13,11,12,11,13,12,11,15,10,10,10,13,14,14,11,11,12,13,10,14,11,20,14,13,12,13,11,14,12,15,12,15,13,17,16,14,5,8,1,18,5,8,1,18,DM/M C,311,1,1,1,5,1,1,1,1,8,20,18,1,1,1,1,4294967488.0,0,0,0,0,0,0,1,1,0,0,0,0,0,0,0,0,0,0,0,0,0,0,0,0,0,0,0,0,0,0,0,0,1,0,0,0,0,0,0,0,0,0,0,0,0,0,0,0,Rene Krhin,ÃÂ£1.08m ,30.0,189.0,Midfielder - Central Midfield,right,Without Club,9.0,0.0,0.0,587.0,9.0,1.0,0.0,513.0,23.0,0.0,0.0,1476.0,28.0,0.0,0.0,2146.0,19.0,0.0,0.0,1328.0,25.0,0.0,0.0,1520.0,12.0,0.0,0.0,937.0,19.0,1.0,0.0,1328.0,21.0,1.0,0.0,1272.0,Serie A,10.0,0.0,0.0,341.0,nan,nan,nan,nan,29/6/2010,Rene Krhin,64001295.0,795.0,5/21/1990,20.0,4.0,0.0,0.0,0.0,3481.0,6100.0,6100.0,148.0,118.0,1948752.0,189.0,78.0,DM/M C,1.0,1.0,1.0,1.0,1.0,1.0,1.0,1.0,1.0,1.0,1.0,8.0,8.0,10.0,6.0,13.0,8.0,13.0,11.0,5.0,11.0,14.0,11.0,14.0,13.0,14.0,11.0,12.0,11.0,13.0,12.0,11.0,15.0,10.0,10.0,10.0,15.0,14.0,14.0,11.0,11.0,13.0,13.0,10.0,14.0,11.0,20.0,14.0,13.0,12.0,13.0,11.0,14.0,12.0,15.0,12.0,15.0,13.0,17.0,16.0,14.0,5.0,Rene Krhin,ÃÂÃÂ£1.80m ,Serie A,19-06-17,18.3.4.28,Rene Krhin,64001295,795,21-May-90,27,32,2,7,0,4000,6850,6250,136,126,3883129,189,78,DM/M C,1,1,1,1,1,1,1,1,1,1,1,8,9,10,6,12,8,13,14,7,11,14,11,13,13,13,13,16,13,13,12,13,14,10,10,12,13,15,15,12,11,9,15,10,14,13,20,14,14,12,13,11,14,12,14,11,14,12,16,15,13,5,13,1,20,5,8,1,20,DM/M C,421,1,1,1,5,1,1,13,1,8,19,20,1,1,1,1,0.0,0,0,0,0,0,0,0,0,0,0,0,0,0,0,0,0,0,0,0,0,0,0,0,0,0,0,0,0,0,0,0,0,0,0,0,0,0,0,0,0,0,0,0,0,0,0,0,0,Rene Krhin,ÃÂ£1.35m ,30.0,189.0,Midfielder - Central Midfield,right,Without Club,12.0,0.0,0.0,937.0,19.0,1.0,0.0,1328.0,21.0,1.0,0.0,1272.0,10.0,0.0,0.0,341.0,nan,nan,nan,nan,Ligue 1,15-07-16,17.3.2.23,Rene Krhin,64001295.0,795.0,21-May-90,26.0,25.0,1.0,7.0,0.0,4000.0,6750.0,6250.0,136.0,126.0,3883129.0,189.0,78.0,DM/M C,1.0,1.0,1.0,1.0,1.0,1.0,1.0,1.0,1.0,1.0,1.0,8.0,9.0,10.0,6.0,12.0,8.0,13.0,14.0,7.0,11.0,14.0,11.0,13.0,13.0,13.0,13.0,16.0,13.0,13.0,12.0,13.0,14.0,10.0,10.0,12.0,13.0,15.0,15.0,12.0,11.0,9.0,15.0,10.0,14.0,13.0,20.0,14.0,14.0,12.0,13.0,11.0,14.0,12.0,14.0,11.0,14.0,12.0,16.0,15.0,13.0,5.0,Rene Krhin,ÃÂ£1.35m ,LaLiga
19/6/2011,RÃÂ©my Cabella,34008670,769,3/8/1990,21,0,0,5,1,1350,2750,2750,154,110,38337,171,62,M/AM LC,1,1,3,3,3,1,3,8,1,3,3,10,10,14,8,14,10,6,11,7,1,11,8,2,16,5,10,7,14,14,13,13,14,13,6,13,5,9,12,16,15,8,5,20,8,15,5,12,5,14,5,16,13,8,12,14,14,13,12,15,15,5,1,1,18,20,10,16,20,M/AM LC,524,1,1,10,20,16,10,1,1,1,1,18,16,10,1,1,2251800000000000.0,0,0,0,0,0,0,0,0,0,0,0,0,0,0,0,0,0,0,0,0,0,0,0,0,0,0,0,0,0,0,0,0,0,0,0,0,0,0,0,0,0,0,0,0,0,0,0,0,RÃÂ©my Cabella,ÃÂ£2.70m ,30.0,171.0,Midfielder - Attacking Midfield,right,FK Krasnodar,18.0,3.0,0.0,790.0,34.0,6.0,2.0,1758.0,41.0,8.0,8.0,3133.0,41.0,14.0,8.0,3535.0,34.0,1.0,2.0,2173.0,45.0,6.0,3.0,3194.0,32.0,6.0,5.0,1853.0,31.0,8.0,7.0,2415.0,37.0,10.0,5.0,3239.0,Ligue 1,12.0,2.0,1.0,556.0,10.0,6.0,2.0,714.0,29/6/2010,RÃÂÃÂ©my Cabella,34008670.0,769.0,3/8/1990,20.0,0.0,0.0,0.0,0.0,1350.0,2750.0,2750.0,150.0,110.0,3278556.0,171.0,62.0,M/AM LC,1.0,1.0,2.0,3.0,3.0,3.0,3.0,4.0,2.0,1.0,1.0,10.0,10.0,14.0,8.0,14.0,10.0,6.0,11.0,7.0,1.0,11.0,8.0,2.0,16.0,5.0,10.0,7.0,14.0,14.0,13.0,13.0,14.0,13.0,6.0,13.0,5.0,9.0,12.0,16.0,15.0,8.0,5.0,20.0,8.0,15.0,5.0,12.0,5.0,14.0,5.0,16.0,12.0,8.0,10.0,14.0,14.0,13.0,12.0,15.0,15.0,5.0,RÃÂÃÂ©my Cabella,ÃÂÃÂ£360Th. ,Ligue 1,19-06-17,18.3.4.28,RÃÂÃÂ¼ÃÂmy Cabella,34008670,769,08-Mar-90,27,4,0,17,4,4250,6450,6550,145,131,11318889,171,62,M/AM LC,2,2,3,3,3,2,1,3,1,3,2,12,14,14,10,15,12,6,12,5,3,15,14,4,15,10,13,11,14,12,14,13,14,15,7,14,7,15,12,14,15,10,6,10,14,14,20,13,8,12,10,13,6,12,9,15,15,12,14,12,15,5,1,1,16,20,14,18,20,M/AM LC,524,1,1,12,20,18,14,1,1,1,1,14,16,10,1,1,2251830000000000.0,0,0,0,0,0,0,0,0,0,0,0,0,0,0,0,0,0,0,0,0,1,0,0,0,0,0,0,0,0,0,0,0,0,0,0,1,0,0,0,0,0,0,0,0,0,0,0,0,RÃÂ©my Cabella,ÃÂ£8.10m ,30.0,171.0,Midfielder - Attacking Midfield,right,FK Krasnodar,32.0,6.0,5.0,1853.0,31.0,8.0,7.0,2415.0,37.0,10.0,5.0,3239.0,12.0,2.0,1.0,556.0,10.0,6.0,2.0,714.0,Ligue 1,nan,nan,nan,nan,nan,nan,nan,nan,nan,nan,nan,nan,nan,nan,nan,nan,nan,nan,nan,nan,nan,nan,nan,nan,nan,nan,nan,nan,nan,nan,nan,nan,nan,nan,nan,nan,nan,nan,nan,nan,nan,nan,nan,nan,nan,nan,nan,nan,nan,nan,nan,nan,nan,nan,nan,nan,nan,nan,nan,nan,nan,nan,nan,nan,nan,nan,nan,nan,nan,nan,nan,nan,nan,nan,nan,nan,nan,nan,nan,nan,nan,nan,nan,nan,nan
19/6/2011,Moussa Sissoko,8448722,769,8/16/1989,21,2,0,11,2,6600,6569,6550,165,146,5191698,187,83,DM/M C,3,3,1,3,1,1,1,4,2,2,1,6,9,13,11,14,11,13,15,5,12,14,8,11,14,11,15,14,14,14,14,12,17,11,10,12,12,12,16,16,13,16,14,8,15,13,20,17,16,13,11,15,7,8,11,15,14,11,13,14,14,6,1,1,20,14,14,12,20,DM/M C,421,1,1,5,10,12,14,1,1,1,16,20,12,14,1,1,292.0,0,0,1,0,0,1,0,0,1,0,0,0,0,0,0,0,0,0,0,0,0,0,0,0,0,0,0,0,0,0,0,0,0,0,0,0,0,0,0,0,0,0,0,0,0,0,0,0,Moussa Sissoko,ÃÂ£8.55m ,31.0,187.0,Midfielder - Central Midfield,right,Tottenham Hotspur,38.0,6.0,2.0,3167.0,37.0,2.0,3.0,3066.0,40.0,4.0,4.0,3461.0,38.0,3.0,6.0,3242.0,38.0,5.0,2.0,3275.0,39.0,1.0,8.0,3402.0,34.0,0.0,4.0,1307.0,47.0,2.0,5.0,2431.0,44.0,0.0,4.0,3403.0,Ligue 1,35.0,2.0,2.0,2873.0,7.0,0.0,0.0,430.0,29/6/2010,Moussa Sissoko,8448722.0,769.0,8/16/1989,20.0,2.0,0.0,11.0,2.0,5329.0,6569.0,6550.0,180.0,146.0,16779908.0,187.0,83.0,DM/M C,1.0,1.0,3.0,1.0,2.0,3.0,1.0,5.0,3.0,1.0,3.0,6.0,9.0,13.0,11.0,14.0,11.0,13.0,15.0,5.0,12.0,14.0,8.0,11.0,14.0,11.0,15.0,14.0,14.0,14.0,14.0,12.0,17.0,11.0,10.0,12.0,12.0,12.0,16.0,16.0,13.0,16.0,14.0,8.0,15.0,13.0,20.0,17.0,16.0,13.0,11.0,15.0,7.0,8.0,12.0,15.0,14.0,11.0,13.0,14.0,14.0,6.0,Moussa Sissoko,ÃÂÃÂ£9.90m ,Ligue 1,19-06-17,18.3.4.28,Moussa Sissoko,8448722,769,16-Aug-89,27,52,2,18,1,6250,7200,6800,150,136,19064495,187,91,M/AM RC,1,2,1,1,3,1,2,2,3,3,3,9,12,13,11,13,10,12,11,5,11,12,13,11,12,11,15,13,13,9,13,13,11,12,12,16,10,14,13,14,13,15,13,8,17,14,20,17,16,10,6,13,5,15,14,15,10,13,13,14,14,12,8,13,20,16,20,12,18,M/AM RC,413,1,1,1,14,12,16,1,1,8,1,18,1,20,1,13,2251800000000000.0,0,0,1,1,0,0,0,0,0,0,0,0,0,0,0,0,0,0,0,0,0,0,0,0,0,0,0,0,0,0,0,0,0,0,0,0,0,0,0,0,0,0,0,0,0,0,0,0,Moussa Sissoko,ÃÂ£16.20m ,31.0,187.0,Midfielder - Central Midfield,right,Tottenham Hotspur,34.0,0.0,4.0,1307.0,47.0,2.0,5.0,2431.0,44.0,0.0,4.0,3403.0,35.0,2.0,2.0,2873.0,7.0,0.0,0.0,430.0,Premier League,15-07-16,17.3.2.23,Moussa Sissoko,8448722.0,769.0,16-Aug-89,26.0,44.0,1.0,18.0,1.0,6400.0,7400.0,6900.0,150.0,138.0,24251656.0,188.0,83.0,M/AM RC,2.0,3.0,1.0,2.0,2.0,1.0,1.0,2.0,2.0,1.0,1.0,7.0,12.0,15.0,11.0,13.0,10.0,12.0,11.0,5.0,9.0,13.0,13.0,11.0,12.0,11.0,13.0,13.0,13.0,13.0,13.0,12.0,12.0,12.0,12.0,15.0,9.0,13.0,13.0,14.0,13.0,14.0,13.0,8.0,16.0,15.0,20.0,15.0,15.0,10.0,6.0,13.0,5.0,10.0,14.0,15.0,10.0,14.0,13.0,14.0,14.0,10.0,Moussa Sissoko,ÃÂ£18.00m ,Premier League
19/6/2011,Miralem Pjanic,8438112,759,4/2/1990,21,24,3,0,0,5700,7755,6350,160,141,7509499,180,68,M/AM C,1,2,1,3,3,3,3,2,1,1,1,14,14,14,8,16,14,10,14,7,5,15,12,5,16,7,12,10,14,12,16,13,15,13,8,13,8,14,11,15,14,13,10,12,13,13,20,14,11,13,7,16,8,10,13,16,13,12,15,14,14,7,1,1,18,20,14,12,20,M/AM C,521,1,1,1,20,12,14,1,1,1,10,18,12,14,1,1,5243008.0,0,0,0,0,0,0,0,1,0,0,0,0,0,0,0,0,0,0,0,0,1,0,1,0,0,0,0,0,0,0,0,0,0,0,0,0,0,0,0,0,0,0,0,0,0,0,0,0,Miralem Pjanic,ÃÂ£11.25m ,30.0,180.0,Midfielder - Defensive Midfield,right,FC Barcelona,39.0,4.0,3.0,1956.0,36.0,4.0,12.0,2724.0,29.0,4.0,8.0,1899.0,38.0,6.0,6.0,2809.0,46.0,5.0,10.0,3347.0,41.0,12.0,11.0,3343.0,47.0,8.0,14.0,3428.0,44.0,7.0,11.0,3569.0,44.0,4.0,8.0,3275.0,Serie A,43.0,3.0,8.0,3350.0,3.0,0.0,0.0,103.0,29/6/2010,Miralem Pjanic,8438112.0,759.0,4/2/1990,20.0,16.0,1.0,0.0,0.0,4450.0,7000.0,6300.0,185.0,140.0,32185533.0,180.0,68.0,M/AM C,3.0,1.0,3.0,1.0,1.0,2.0,2.0,3.0,3.0,2.0,1.0,14.0,14.0,14.0,8.0,16.0,15.0,10.0,14.0,5.0,5.0,15.0,14.0,5.0,16.0,7.0,12.0,10.0,12.0,12.0,17.0,12.0,16.0,15.0,8.0,13.0,7.0,12.0,12.0,16.0,13.0,13.0,10.0,12.0,13.0,13.0,20.0,14.0,11.0,14.0,7.0,16.0,6.0,10.0,13.0,17.0,12.0,15.0,15.0,14.0,14.0,7.0,Miralem Pjanic,ÃÂÃÂ£8.10m ,Ligue 1,19-06-17,18.3.4.28,Miralem Pjanic,8438112,759,02-Apr-90,27,75,11,0,0,6900,8500,8450,171,169,232186002,178,72,DM/M/AM C,2,1,3,2,1,3,3,1,2,2,3,15,16,14,13,18,19,8,16,5,10,19,14,12,17,10,18,12,13,12,18,16,13,16,7,14,14,16,13,14,15,13,7,12,14,12,20,13,10,12,10,11,13,10,16,17,11,9,16,14,15,6,1,1,20,17,9,9,20,DM/M/AM C,431,1,1,1,17,9,9,1,1,1,17,20,7,7,1,1,18350208.0,0,0,0,0,0,0,0,1,0,0,0,0,0,0,0,0,0,0,0,1,1,0,0,0,1,0,0,0,0,0,0,0,0,0,0,0,0,0,0,0,0,0,0,0,0,0,0,0,Miralem Pjanic,ÃÂ£58.50m ,30.0,180.0,Midfielder - Defensive Midfield,right,FC Barcelona,47.0,8.0,14.0,3428.0,44.0,7.0,11.0,3569.0,44.0,4.0,8.0,3275.0,43.0,3.0,8.0,3350.0,3.0,0.0,0.0,103.0,Serie A,15-07-16,17.3.2.23,Miralem Pjanic,8438112.0,759.0,02-Apr-90,26.0,69.0,11.0,0.0,0.0,6900.0,8500.0,8250.0,171.0,166.0,113791406.0,180.0,74.0,DM/M/AM C,1.0,1.0,3.0,3.0,4.0,3.0,1.0,3.0,2.0,1.0,4.0,15.0,15.0,15.0,13.0,18.0,19.0,8.0,16.0,5.0,6.0,19.0,14.0,12.0,18.0,10.0,18.0,12.0,13.0,12.0,18.0,15.0,13.0,16.0,8.0,14.0,10.0,16.0,13.0,15.0,15.0,12.0,7.0,12.0,12.0,12.0,20.0,13.0,8.0,9.0,10.0,11.0,13.0,10.0,16.0,17.0,11.0,10.0,16.0,14.0,14.0,9.0,Miralem Pjanic,ÃÂ£36.00m ,Serie A
19/6/2011,Mehmet Ekici,29022517,799,3/25/1990,21,4,0,0,0,5000,6750,6750,155,135,3935936,180,70,M/AM C,1,3,3,3,1,1,1,9,2,1,3,18,17,12,14,18,14,6,13,6,9,16,15,8,18,11,12,10,16,12,13,9,16,12,9,8,11,10,14,12,16,17,9,10,11,12,20,13,10,8,7,11,10,15,5,14,5,17,17,14,13,6,1,1,20,17,13,11,20,M/AM C,411,1,1,8,17,10,12,1,1,1,14,20,11,13,1,1,4503600000000000.0,0,0,0,0,0,0,0,0,0,0,0,0,0,0,0,0,0,0,0,1,0,0,1,0,0,1,0,0,0,0,1,0,0,0,0,0,0,0,0,0,0,0,0,0,0,0,0,0,Mehmet Ekici,ÃÂ£4.50m ,30.0,180.0,Midfielder - Attacking Midfield,both,Without Club,36.0,4.0,11.0,2824.0,22.0,1.0,4.0,972.0,9.0,2.0,0.0,463.0,12.0,1.0,0.0,658.0,42.0,10.0,14.0,3261.0,22.0,5.0,3.0,1679.0,19.0,3.0,1.0,1551.0,11.0,0.0,1.0,426.0,25.0,5.0,2.0,1288.0,Bundesliga,13.0,0.0,2.0,716.0,nan,nan,nan,nan,29/6/2010,Mehmet Ekici,29022517.0,771.0,3/25/1990,20.0,0.0,0.0,0.0,0.0,750.0,5750.0,5750.0,155.0,115.0,776406.0,180.0,74.0,DM/M/AM C,3.0,2.0,2.0,2.0,1.0,1.0,3.0,3.0,1.0,1.0,3.0,13.0,13.0,14.0,13.0,14.0,14.0,8.0,13.0,4.0,8.0,14.0,16.0,8.0,14.0,11.0,12.0,11.0,14.0,13.0,14.0,13.0,16.0,15.0,7.0,13.0,10.0,13.0,11.0,13.0,13.0,8.0,9.0,20.0,11.0,11.0,8.0,9.0,8.0,6.0,10.0,14.0,13.0,13.0,8.0,13.0,8.0,17.0,17.0,6.0,7.0,6.0,Mehmet Ekici,ÃÂÃÂ£5.85m ,Bundesliga
19/6/2011,Maxi SepÃÂºlveda,14000700,1649,3/29/1990,21,0,0,0,0,1750,3599,2595,127,80,1698,172,66,M C,3,3,2,3,2,2,3,1,1,1,3,5,5,7,7,11,9,9,9,1,12,11,9,12,13,8,10,8,5,9,11,11,9,9,3,7,8,11,13,13,9,10,7,20,16,12,10,10,7,10,7,10,13,10,13,10,6,13,14,6,9,2,1,1,20,1,1,1,20,M C,401,1,1,1,1,1,1,1,1,1,14,20,1,1,1,1,0.0,0,0,0,0,0,0,0,0,0,0,0,0,0,0,0,0,0,0,0,0,0,0,0,0,0,0,0,0,0,0,0,0,0,0,0,0,0,0,0,0,0,0,0,0,0,0,0,0,nan,nan,nan,nan,nan,nan,nan,nan,nan,nan,nan,nan,nan,nan,nan,nan,nan,nan,nan,nan,nan,nan,nan,nan,nan,nan,nan,nan,nan,nan,nan,nan,nan,nan,nan,nan,nan,nan,nan,nan,nan,nan,nan,nan,nan,nan,nan,nan,nan,nan,nan,nan,nan,nan,nan,nan,nan,nan,nan,nan,nan,nan,nan,nan,nan,nan,nan,nan,nan,nan,nan,nan,nan,nan,nan,nan,nan,nan,nan,nan,nan,nan,nan,nan,nan,nan,nan,nan,nan,nan,nan,nan,nan,nan,nan,nan,nan,nan,nan,nan,nan,nan,nan,nan,nan,nan,nan,nan,nan,nan,nan,nan,nan,nan,nan,nan,nan,nan,nan,nan,nan,nan,nan,nan,nan,nan,nan,nan,nan,nan,nan,nan,nan,nan,nan,nan
19/6/2011,Mateusz Klich,54005896,787,6/13/1990,21,1,0,1,0,3250,5500,5500,125,115,1531292,183,68,M/AM C,1,1,1,1,1,1,1,6,3,3,3,11,10,12,10,14,12,9,11,3,9,13,10,9,13,9,8,10,13,12,13,12,10,14,10,11,9,13,12,12,11,12,13,13,13,13,20,10,11,14,7,11,12,10,15,14,15,14,15,14,7,2,1,1,20,20,1,1,20,M/AM C,411,1,1,1,20,1,1,1,1,1,1,20,1,1,1,1,4294967300.0,0,0,1,0,0,0,0,0,0,0,0,0,0,0,0,0,0,0,0,0,0,0,0,0,0,0,0,0,0,0,0,0,1,0,0,0,0,0,0,0,0,0,0,0,0,0,0,0,Mateusz Klich,ÃÂ£540Th. ,30.0,183.0,Midfielder - Central Midfield,right,Leeds United,29.0,4.0,8.0,2264.0,9.0,1.0,2.0,608.0,17.0,2.0,2.0,1342.0,34.0,4.0,10.0,2826.0,13.0,4.0,4.0,902.0,20.0,3.0,1.0,1309.0,30.0,6.0,4.0,2693.0,26.0,1.0,3.0,1728.0,50.0,10.0,9.0,4065.0,Bundesliga,47.0,7.0,5.0,3998.0,6.0,2.0,2.0,518.0,nan,nan,nan,nan,nan,nan,nan,nan,nan,nan,nan,nan,nan,nan,nan,nan,nan,nan,nan,nan,nan,nan,nan,nan,nan,nan,nan,nan,nan,nan,nan,nan,nan,nan,nan,nan,nan,nan,nan,nan,nan,nan,nan,nan,nan,nan,nan,nan,nan,nan,nan,nan,nan,nan,nan,nan,nan,nan,nan,nan,nan,nan,nan,nan,nan,nan,nan,nan,nan,nan,nan,nan,nan,nan,nan,nan,nan,nan,nan,nan,nan,nan,nan,nan
19/6/2011,Marco HÃÂ¶ger,92014217,771,9/16/1989,21,0,0,0,0,4500,6550,6550,146,131,535365,186,78,D/DM/M RC,3,3,3,2,3,1,1,1,2,2,1,9,16,8,9,14,11,12,15,5,9,14,16,10,14,11,13,12,15,11,13,15,16,9,12,10,10,15,12,10,11,12,13,17,9,11,20,13,12,12,8,11,12,12,5,15,12,12,15,9,14,8,18,14,20,12,18,1,20,D/DM/M RC,433,1,1,1,1,1,12,1,1,18,17,20,1,15,1,14,0.0,0,0,0,0,0,0,0,0,0,0,0,0,0,0,0,0,0,0,0,0,0,0,0,0,0,0,0,0,0,0,0,0,0,0,0,0,0,0,0,0,0,0,0,0,0,0,0,0,Marco HÃÂÃÂ¶ger,ÃÂ£3.60m ,31.0,182.0,Midfielder - Defensive Midfield,right,1. FC KÃÂÃÂ¶ln,37.0,10.0,9.0,3235.0,43.0,1.0,5.0,2983.0,30.0,3.0,2.0,1858.0,14.0,2.0,1.0,1039.0,34.0,1.0,3.0,2756.0,6.0,0.0,0.0,219.0,32.0,0.0,1.0,2124.0,26.0,0.0,0.0,1876.0,28.0,1.0,3.0,2155.0,Bundesliga,16.0,0.0,0.0,727.0,3.0,0.0,0.0,109.0,nan,nan,nan,nan,nan,nan,nan,nan,nan,nan,nan,nan,nan,nan,nan,nan,nan,nan,nan,nan,nan,nan,nan,nan,nan,nan,nan,nan,nan,nan,nan,nan,nan,nan,nan,nan,nan,nan,nan,nan,nan,nan,nan,nan,nan,nan,nan,nan,nan,nan,nan,nan,nan,nan,nan,nan,nan,nan,nan,nan,nan,nan,nan,nan,nan,nan,nan,nan,nan,nan,nan,nan,nan,nan,nan,nan,nan,nan,nan,nan,nan,nan,nan,nan,19-06-17,18.3.4.28,Marco HÃÂ¶ger,92014217,771,16-Sep-89,27,0,0,0,0,4100,6600,6600,133,132,10186680,186,78,DM/M C,3,3,1,1,2,1,1,3,3,1,1,9,12,9,10,11,11,10,14,10,12,13,15,13,12,16,14,17,15,12,10,14,11,9,12,9,11,17,16,10,12,15,11,15,13,11,20,15,13,14,12,14,12,17,7,14,12,14,13,14,16,6,14,14,20,12,14,7,20,DM/M C,311,1,1,1,8,1,12,8,1,14,20,20,7,12,7,14,0.0,0,0,0,0,0,0,0,0,0,0,0,0,0,0,0,0,0,0,0,0,0,0,0,0,0,0,0,0,0,0,0,0,0,0,0,0,0,0,0,0,0,0,0,0,0,0,0,0,Marco HÃÂÃÂ¶ger,ÃÂ£1.80m ,31.0,182.0,Midfielder - Defensive Midfield,right,1. FC KÃÂÃÂ¶ln,32.0,0.0,1.0,2124.0,26.0,0.0,0.0,1876.0,28.0,1.0,3.0,2155.0,16.0,0.0,0.0,727.0,3.0,0.0,0.0,109.0,Bundesliga,15-07-16,17.3.2.23,Marco HÃÂ¶ger,92014217.0,771.0,16-Sep-89,26.0,0.0,0.0,0.0,0.0,4650.0,6650.0,6650.0,134.0,133.0,12284473.0,186.0,78.0,DM/M C,2.0,2.0,2.0,3.0,3.0,2.0,2.0,3.0,2.0,2.0,3.0,9.0,11.0,9.0,10.0,12.0,11.0,10.0,14.0,10.0,12.0,13.0,15.0,12.0,13.0,16.0,14.0,17.0,15.0,12.0,10.0,14.0,11.0,9.0,10.0,9.0,11.0,17.0,16.0,11.0,12.0,15.0,11.0,15.0,14.0,11.0,20.0,15.0,13.0,14.0,12.0,14.0,11.0,17.0,7.0,14.0,12.0,14.0,13.0,14.0,16.0,6.0,Marco HÃÂÃÂ¶ger,ÃÂ£3.60m ,Bundesliga
19/6/2011,Luca Marrone,43025940,776,3/28/1990,21,0,0,16,1,2000,5500,5500,154,119,224003,186,75,DM/M C,1,1,1,1,1,2,3,3,2,1,1,6,6,9,6,11,7,11,11,10,13,14,6,14,12,13,14,14,14,12,11,15,15,7,12,8,12,14,14,12,12,13,12,6,15,12,20,13,13,13,10,9,6,10,8,14,13,5,12,14,11,13,1,1,18,1,1,1,18,DM/M C,311,1,1,1,1,1,1,1,1,1,20,18,1,1,1,1,0.0,0,0,0,0,0,0,0,0,0,0,0,0,0,0,0,0,0,0,0,0,0,0,0,0,0,0,0,0,0,0,0,0,0,0,0,0,0,0,0,0,0,0,0,0,0,0,0,0,Luca Marrone,ÃÂ£2.25m ,30.0,186.0,Defender - Centre-Back,right,FC Crotone,19.0,1.0,3.0,1237.0,6.0,1.0,1.0,304.0,15.0,0.0,0.0,1172.0,15.0,0.0,3.0,1140.0,0.0,0.0,0.0,0.0,25.0,1.0,5.0,1992.0,28.0,1.0,0.0,1779.0,34.0,1.0,1.0,2930.0,25.0,0.0,0.0,2058.0,Serie A,31.0,3.0,0.0,2576.0,4.0,0.0,0.0,360.0,nan,nan,nan,nan,nan,nan,nan,nan,nan,nan,nan,nan,nan,nan,nan,nan,nan,nan,nan,nan,nan,nan,nan,nan,nan,nan,nan,nan,nan,nan,nan,nan,nan,nan,nan,nan,nan,nan,nan,nan,nan,nan,nan,nan,nan,nan,nan,nan,nan,nan,nan,nan,nan,nan,nan,nan,nan,nan,nan,nan,nan,nan,nan,nan,nan,nan,nan,nan,nan,nan,nan,nan,nan,nan,nan,nan,nan,nan,nan,nan,nan,nan,nan,nan
19/6/2011,Jordan Henderson,28005568,765,6/17/1990,21,1,0,10,1,5500,7150,7000,155,133,8863636,183,67,M/AM RC,1,1,3,3,3,3,2,7,3,2,1,13,17,14,11,13,13,6,13,4,7,15,4,8,13,6,13,8,14,10,13,10,10,15,10,14,8,11,14,13,13,12,9,10,16,15,20,16,8,10,7,8,4,14,8,12,15,10,15,9,9,6,1,1,20,19,19,10,20,M/AM RC,413,1,1,5,10,10,19,1,1,1,3,20,10,18,1,1,4400330000000.0,0,0,0,0,0,1,0,0,0,0,0,0,0,0,0,0,0,0,0,0,0,0,0,0,0,0,0,1,0,0,0,1,0,0,0,0,0,0,0,0,0,0,1,0,0,0,0,0,Jordan Henderson,ÃÂ£13.50m ,30.0,187.0,Midfielder - Central Midfield,right,Liverpool FC,39.0,3.0,5.0,3319.0,48.0,2.0,4.0,3499.0,44.0,6.0,5.0,2642.0,40.0,5.0,7.0,3483.0,54.0,7.0,15.0,4739.0,26.0,2.0,3.0,1950.0,27.0,1.0,4.0,2355.0,41.0,1.0,2.0,3308.0,44.0,1.0,5.0,2811.0,Premier League,40.0,4.0,5.0,3167.0,5.0,0.0,0.0,335.0,29/6/2010,Jordan Henderson,28005568.0,765.0,6/17/1990,20.0,0.0,0.0,0.0,0.0,3500.0,6600.0,6600.0,151.0,126.0,11566864.0,182.0,67.0,M/AM RC,1.0,3.0,2.0,3.0,3.0,1.0,2.0,2.0,3.0,1.0,2.0,11.0,15.0,14.0,10.0,13.0,13.0,8.0,13.0,4.0,6.0,13.0,10.0,8.0,13.0,6.0,11.0,8.0,13.0,8.0,13.0,8.0,10.0,16.0,8.0,14.0,8.0,9.0,10.0,15.0,13.0,12.0,10.0,10.0,14.0,15.0,20.0,16.0,8.0,7.0,13.0,10.0,8.0,14.0,14.0,12.0,11.0,10.0,14.0,8.0,8.0,10.0,Jordan Henderson,ÃÂÃÂ£7.65m ,Premier League,19-06-17,18.3.4.28,Jordan Henderson,28005568,765,17-Jun-90,27,32,0,27,4,6500,7750,7600,158,154,69910700,183,67,DM/M C,2,3,2,3,1,1,3,3,3,1,3,12,13,12,11,15,11,11,12,4,13,16,10,14,14,14,14,14,15,14,14,15,18,13,16,14,14,17,18,13,13,13,12,8,18,14,20,18,14,14,8,15,11,13,15,17,17,17,18,13,18,6,8,12,20,10,14,10,20,DM/M C,311,1,1,1,8,4,10,1,1,8,20,20,10,14,1,12,140737000000000.0,0,0,0,0,0,0,0,0,0,0,1,0,0,0,0,0,0,0,0,1,0,0,1,0,0,0,0,0,0,0,0,0,0,0,0,0,0,0,0,0,0,0,0,0,0,0,0,1,Jordan Henderson,ÃÂ£22.50m ,30.0,187.0,Midfielder - Central Midfield,right,Liverpool FC,27.0,1.0,4.0,2355.0,41.0,1.0,2.0,3308.0,44.0,1.0,5.0,2811.0,40.0,4.0,5.0,3167.0,5.0,0.0,0.0,335.0,Premier League,15-07-16,17.3.2.23,Jordan Henderson,28005568.0,765.0,17-Jun-90,26.0,27.0,0.0,27.0,4.0,6500.0,7600.0,7600.0,165.0,155.0,104245468.0,183.0,67.0,DM/M C,1.0,2.0,2.0,1.0,3.0,1.0,3.0,3.0,2.0,1.0,3.0,12.0,13.0,12.0,11.0,15.0,11.0,11.0,12.0,4.0,13.0,16.0,10.0,14.0,14.0,14.0,14.0,14.0,15.0,15.0,14.0,15.0,17.0,13.0,16.0,14.0,15.0,17.0,18.0,13.0,13.0,13.0,12.0,8.0,18.0,14.0,20.0,18.0,14.0,15.0,8.0,15.0,9.0,13.0,15.0,17.0,17.0,17.0,18.0,13.0,15.0,6.0,Jordan Henderson,ÃÂ£25.20m ,Premier League
19/6/2011,Joe Allen,29007955,801,3/14/1990,21,2,0,13,1,4122,6234,5932,145,115,660965,168,81,DM/M C,3,3,1,2,2,3,2,1,2,2,3,2,9,12,10,13,2,4,11,4,6,14,6,11,12,9,10,13,10,12,12,10,15,11,2,11,12,13,10,14,14,13,5,15,11,13,20,6,10,13,6,15,7,11,6,9,14,16,14,14,15,2,1,1,20,14,10,1,20,DM/M C,311,1,1,1,14,1,10,1,1,1,20,20,1,10,1,1,17592200000000.0,0,0,0,0,0,0,1,0,0,1,0,0,0,0,0,0,0,0,0,0,0,0,0,0,0,0,0,0,0,0,0,0,0,0,0,0,0,0,0,0,0,0,0,0,1,0,0,0,Joe Allen,ÃÂ£3.60m ,30.0,168.0,Midfielder - Central Midfield,right,Stoke City,48.0,2.0,6.0,3500.0,39.0,4.0,4.0,3018.0,37.0,2.0,0.0,2640.0,26.0,1.0,1.0,1593.0,32.0,1.0,1.0,2409.0,37.0,3.0,3.0,1778.0,39.0,6.0,4.0,3155.0,38.0,4.0,7.0,3277.0,46.0,6.0,3.0,4132.0,Premier League,35.0,4.0,2.0,2940.0,nan,nan,nan,nan,nan,nan,nan,nan,nan,nan,nan,nan,nan,nan,nan,nan,nan,nan,nan,nan,nan,nan,nan,nan,nan,nan,nan,nan,nan,nan,nan,nan,nan,nan,nan,nan,nan,nan,nan,nan,nan,nan,nan,nan,nan,nan,nan,nan,nan,nan,nan,nan,nan,nan,nan,nan,nan,nan,nan,nan,nan,nan,nan,nan,nan,nan,nan,nan,nan,nan,nan,nan,nan,nan,nan,nan,nan,nan,nan,nan,nan,nan,nan,nan,nan,nan,nan,nan,19-06-17,18.3.4.28,Joe Allen,29007955,801,14-Mar-90,27,36,2,14,2,5700,7200,7200,152,142,53380660,168,62,DM/M/AM C,2,3,2,2,3,1,3,2,1,2,2,8,9,13,9,15,7,7,8,3,14,15,6,13,14,13,15,14,15,15,13,14,13,12,8,14,13,17,18,13,15,14,6,11,15,12,20,16,10,14,6,15,8,11,10,14,14,13,15,15,12,2,1,1,20,16,1,1,20,DM/M/AM C,431,1,1,1,16,1,1,1,1,1,18,20,1,1,1,1,17592200000000.0,0,0,0,0,0,0,1,0,0,0,0,0,0,0,0,0,0,0,0,0,0,0,0,0,1,0,0,0,0,0,0,0,0,0,0,0,0,0,0,0,0,0,0,0,1,0,0,0,Joe Allen,ÃÂ£16.20m ,30.0,168.0,Midfielder - Central Midfield,right,Stoke City,39.0,6.0,4.0,3155.0,38.0,4.0,7.0,3277.0,46.0,6.0,3.0,4132.0,35.0,4.0,2.0,2940.0,nan,nan,nan,nan,Premier League,15-07-16,17.3.2.23,Joe Allen,29007955.0,801.0,14-Mar-90,26.0,31.0,0.0,7.0,2.0,5600.0,7200.0,7200.0,152.0,142.0,43189690.0,168.0,62.0,DM/M/AM C,2.0,3.0,2.0,2.0,1.0,3.0,1.0,2.0,1.0,3.0,1.0,8.0,9.0,13.0,9.0,15.0,7.0,7.0,8.0,3.0,14.0,15.0,6.0,13.0,15.0,13.0,15.0,15.0,15.0,15.0,13.0,14.0,13.0,12.0,8.0,14.0,13.0,17.0,18.0,13.0,15.0,14.0,6.0,11.0,15.0,12.0,20.0,15.0,10.0,14.0,6.0,15.0,8.0,11.0,10.0,14.0,14.0,13.0,15.0,15.0,12.0,2.0,Joe Allen,ÃÂ£13.50m ,Premier League
19/6/2011,Jan Moravek,25007942,763,11/1/1989,21,3,0,9,0,5150,6000,6500,149,127,1147650,180,75,M/AM C,3,3,3,1,2,1,1,5,3,1,3,11,12,13,15,16,10,13,14,6,7,14,12,10,16,5,14,6,13,8,15,15,6,13,5,16,10,14,13,10,12,7,8,10,14,13,20,12,9,9,5,12,6,11,12,10,14,9,13,12,19,2,1,1,18,20,13,14,20,M/AM C,521,1,1,1,20,14,13,1,1,1,10,18,10,12,1,1,1184.0,0,0,0,0,0,1,0,1,0,0,1,0,0,0,0,0,0,0,0,0,0,0,0,0,0,0,0,0,0,0,0,0,0,0,0,0,0,0,0,0,0,0,0,0,0,0,0,0,Jan MorÃÂ¡vek,ÃÂ£1.58m ,30.0,180.0,Midfielder - Central Midfield,right,FC Augsburg,33.0,5.0,2.0,2255.0,17.0,0.0,1.0,562.0,23.0,1.0,3.0,1359.0,17.0,0.0,1.0,1064.0,0.0,0.0,0.0,0.0,15.0,3.0,1.0,575.0,13.0,0.0,0.0,697.0,16.0,0.0,0.0,699.0,14.0,0.0,2.0,834.0,Bundesliga,11.0,0.0,1.0,467.0,nan,nan,nan,nan,29/6/2010,Jan Moravek,25007942.0,763.0,11/1/1989,20.0,2.0,0.0,2.0,0.0,1900.0,6000.0,5500.0,149.0,110.0,5000000.0,180.0,75.0,M/AM C,2.0,1.0,2.0,1.0,2.0,2.0,3.0,4.0,2.0,1.0,2.0,10.0,7.0,12.0,12.0,14.0,10.0,6.0,13.0,4.0,10.0,14.0,8.0,11.0,14.0,9.0,13.0,10.0,10.0,11.0,14.0,10.0,11.0,10.0,11.0,11.0,9.0,13.0,15.0,14.0,14.0,14.0,15.0,8.0,11.0,14.0,20.0,12.0,5.0,10.0,14.0,10.0,9.0,10.0,14.0,19.0,13.0,4.0,9.0,1.0,12.0,7.0,Jan MorÃÂÃÂ¡vek,ÃÂÃÂ£3.15m ,Bundesliga,19-06-17,18.3.4.28,Jan Moravek,25007942,763,01-Nov-89,27,3,0,9,0,4300,6050,6300,128,126,6154702,180,75,DM/M/AM C,2,3,1,2,2,4,1,2,1,1,2,13,12,13,10,15,10,9,12,7,8,14,10,10,15,11,13,11,15,12,15,13,8,15,7,12,10,14,12,10,13,10,9,10,11,11,20,13,11,10,5,12,18,13,13,15,13,10,17,12,18,2,1,1,20,18,12,12,20,DM/M/AM C,431,1,1,1,18,12,12,1,1,1,16,20,12,12,1,1,1024.0,0,0,0,0,0,0,0,0,0,0,1,0,0,0,0,0,0,0,0,0,0,0,0,0,0,0,0,0,0,0,0,0,0,0,0,0,0,0,0,0,0,0,0,0,0,0,0,0,Jan MorÃÂ¡vek,ÃÂ£675Th. ,30.0,180.0,Midfielder - Central Midfield,right,FC Augsburg,13.0,0.0,0.0,697.0,16.0,0.0,0.0,699.0,14.0,0.0,2.0,834.0,11.0,0.0,1.0,467.0,nan,nan,nan,nan,Bundesliga,15-07-16,17.3.2.23,Jan Moravek,25007942.0,763.0,01-Nov-89,26.0,3.0,0.0,9.0,0.0,3249.0,5999.0,6249.0,128.0,125.0,3749581.0,180.0,75.0,DM/M/AM C,2.0,1.0,1.0,3.0,2.0,2.0,1.0,2.0,4.0,2.0,1.0,13.0,12.0,13.0,10.0,15.0,10.0,9.0,12.0,7.0,8.0,14.0,10.0,10.0,15.0,11.0,13.0,10.0,15.0,12.0,15.0,13.0,8.0,15.0,7.0,12.0,10.0,14.0,12.0,10.0,13.0,9.0,9.0,10.0,11.0,11.0,20.0,13.0,10.0,10.0,5.0,12.0,18.0,13.0,13.0,15.0,12.0,10.0,17.0,12.0,18.0,2.0,Jan MorÃÂ¡vek,ÃÂ£675Th. ,Bundesliga
19/6/2011,Jack Colback,28005566,765,10/24/1989,21,0,0,0,0,3250,6250,6500,140,116,1202539,176,73,M LC,1,1,1,1,2,2,1,7,1,2,2,10,7,11,13,13,8,9,9,5,12,13,11,14,12,17,14,16,13,10,12,12,13,11,10,12,13,15,15,12,10,11,7,20,12,12,10,12,11,14,10,10,10,13,8,14,12,10,11,8,6,8,10,1,20,1,1,15,20,M LC,404,1,1,1,1,1,1,1,10,1,12,20,15,1,1,1,137439000000.0,0,0,0,0,0,0,0,0,0,0,0,0,0,0,0,0,0,0,0,0,0,0,0,0,0,0,0,0,0,0,0,0,0,0,0,0,0,1,0,0,0,0,0,0,0,0,0,0,Jack Colback,ÃÂ£4.05m ,31.0,177.0,Midfielder - Defensive Midfield,left,Nottingham Forest,33.0,1.0,3.0,2449.0,39.0,2.0,2.0,3071.0,40.0,0.0,2.0,3230.0,42.0,3.0,3.0,3110.0,38.0,4.0,7.0,3429.0,30.0,1.0,1.0,2414.0,34.0,0.0,2.0,2288.0,19.0,1.0,0.0,1696.0,39.0,3.0,2.0,3477.0,Premier League,nan,nan,nan,nan,6.0,0.0,0.0,484.0,29/6/2010,Jack Colback,28005566.0,765.0,10/24/1989,20.0,0.0,0.0,0.0,0.0,2750.0,5850.0,5850.0,120.0,114.0,12361965.0,176.0,75.0,M C,3.0,2.0,2.0,1.0,1.0,1.0,2.0,7.0,1.0,1.0,3.0,10.0,7.0,11.0,13.0,12.0,8.0,9.0,9.0,5.0,12.0,13.0,11.0,14.0,12.0,17.0,14.0,16.0,13.0,10.0,12.0,12.0,14.0,11.0,10.0,12.0,13.0,15.0,15.0,11.0,8.0,10.0,7.0,20.0,11.0,11.0,10.0,12.0,11.0,14.0,10.0,10.0,10.0,12.0,13.0,14.0,12.0,10.0,11.0,8.0,5.0,8.0,Jack Colback,ÃÂÃÂ£1.13m ,Premier League
19/6/2011,Ignacio Camacho,67015002,796,5/4/1990,21,0,0,3,0,4250,6500,6500,155,130,1585653,177,72,DM/M C,3,1,1,2,3,2,3,2,2,3,2,6,11,10,10,13,9,14,8,5,14,13,6,15,12,14,14,15,11,12,13,14,10,13,14,8,13,16,17,10,11,13,9,10,15,13,20,14,14,13,15,14,8,12,12,17,13,16,16,19,15,7,10,1,16,1,1,1,16,DM/M C,311,1,1,1,1,1,1,10,1,1,20,16,1,1,1,1,32832.0,0,0,0,0,0,0,1,0,0,0,0,0,0,0,0,1,0,0,0,0,0,0,0,0,0,0,0,0,0,0,0,0,0,0,0,0,0,0,0,0,0,0,0,0,0,0,0,0,Ignacio Camacho,ÃÂ£900Th. ,30.0,182.0,Midfielder - Defensive Midfield,right,Retired,21.0,0.0,1.0,1402.0,14.0,1.0,0.0,863.0,48.0,3.0,1.0,3726.0,34.0,5.0,2.0,2461.0,28.0,4.0,2.0,2479.0,24.0,2.0,1.0,2065.0,35.0,4.0,2.0,3146.0,15.0,1.0,0.0,1082.0,6.0,0.0,0.0,540.0,LaLiga,nan,nan,nan,nan,nan,nan,nan,nan,nan,nan,nan,nan,nan,nan,nan,nan,nan,nan,nan,nan,nan,nan,nan,nan,nan,nan,nan,nan,nan,nan,nan,nan,nan,nan,nan,nan,nan,nan,nan,nan,nan,nan,nan,nan,nan,nan,nan,nan,nan,nan,nan,nan,nan,nan,nan,nan,nan,nan,nan,nan,nan,nan,nan,nan,nan,nan,nan,nan,nan,nan,nan,nan,nan,nan,nan,nan,nan,nan,nan,nan,nan,nan,nan,nan,nan,nan,nan,nan,nan,nan,nan,nan,19-06-17,18.3.4.28,Ignacio Camacho,67015002,796,04-May-90,27,1,0,9,0,6850,7350,7350,150,147,47801003,183,77,DM/M C,3,2,2,1,4,1,2,3,3,2,3,7,10,9,9,12,7,16,11,10,16,13,9,18,12,17,16,18,14,17,11,13,12,7,16,12,15,18,15,11,12,15,13,10,13,11,20,16,14,15,10,15,12,8,10,12,14,17,16,16,13,7,12,1,20,1,1,1,20,DM/M C,311,1,1,1,1,1,1,12,1,1,20,20,1,1,1,1,32768.0,0,0,0,0,0,0,0,0,0,0,0,0,0,0,0,1,0,0,0,0,0,0,0,0,0,0,0,0,0,0,0,0,0,0,0,0,0,0,0,0,0,0,0,0,0,0,0,0,Ignacio Camacho,ÃÂ£9.00m ,30.0,182.0,Midfielder - Defensive Midfield,right,Retired,35.0,4.0,2.0,3146.0,15.0,1.0,0.0,1082.0,6.0,0.0,0.0,540.0,nan,nan,nan,nan,nan,nan,nan,nan,Bundesliga,15-07-16,17.3.2.23,Ignacio Camacho,67015002.0,796.0,04-May-90,26.0,1.0,0.0,9.0,0.0,6250.0,7750.0,7750.0,156.0,155.0,17999999.0,183.0,77.0,DM/M C,3.0,3.0,2.0,2.0,2.0,2.0,3.0,3.0,3.0,2.0,3.0,10.0,10.0,12.0,9.0,15.0,10.0,16.0,10.0,8.0,15.0,14.0,9.0,14.0,12.0,17.0,16.0,18.0,14.0,16.0,14.0,14.0,12.0,8.0,15.0,13.0,17.0,19.0,18.0,12.0,14.0,9.0,13.0,10.0,13.0,11.0,20.0,16.0,15.0,15.0,13.0,15.0,14.0,12.0,8.0,17.0,14.0,17.0,16.0,19.0,13.0,7.0,Ignacio Camacho,ÃÂ£9.00m ,LaLiga
19/6/2011,GrÃÂ©gory Sertic,8443655,769,8/5/1989,21,0,0,5,0,4350,5500,5500,145,122,486113,181,69,M/AM LC,3,1,2,1,2,3,2,1,1,1,2,13,12,13,7,14,14,10,13,5,5,13,12,7,14,7,11,12,13,12,14,11,15,11,8,11,8,12,13,14,14,14,10,12,14,11,20,13,11,12,7,14,6,15,19,14,13,11,14,13,13,6,8,1,20,18,12,16,20,M/AM LC,414,1,1,1,18,14,12,8,1,1,10,20,16,12,1,1,4194336.0,0,0,0,0,0,1,0,0,0,0,0,0,0,0,0,0,0,0,0,0,0,0,1,0,0,0,0,0,0,0,0,0,0,0,0,0,0,0,0,0,0,0,0,0,0,0,0,0,GrÃÂ©gory Sertic,ÃÂ£1.13m ,31.0,183.0,Midfielder - Defensive Midfield,right,Without Club,24.0,0.0,2.0,1099.0,22.0,0.0,1.0,1008.0,44.0,1.0,5.0,3112.0,37.0,3.0,11.0,3061.0,30.0,1.0,1.0,2341.0,3.0,0.0,0.0,141.0,28.0,1.0,1.0,2319.0,13.0,0.0,0.0,716.0,17.0,0.0,0.0,1103.0,Ligue 1,nan,nan,nan,nan,nan,nan,nan,nan,29/6/2010,GrÃÂÃÂ©gory Sertic,8443655.0,769.0,8/5/1989,20.0,0.0,0.0,5.0,0.0,3969.0,5669.0,5650.0,160.0,126.0,5345207.0,181.0,69.0,M/AM LC,1.0,1.0,1.0,1.0,1.0,2.0,3.0,8.0,3.0,1.0,2.0,13.0,12.0,13.0,7.0,14.0,15.0,10.0,13.0,5.0,5.0,13.0,12.0,7.0,14.0,7.0,11.0,12.0,13.0,13.0,15.0,11.0,14.0,13.0,9.0,11.0,8.0,12.0,13.0,15.0,14.0,14.0,10.0,12.0,14.0,11.0,20.0,14.0,11.0,14.0,7.0,14.0,6.0,15.0,5.0,15.0,12.0,13.0,14.0,13.0,13.0,8.0,GrÃÂÃÂ©gory Sertic,ÃÂÃÂ£1.08m ,Ligue 1,19-06-17,18.3.4.28,GrÃÂ©gory Sertic,8443655,761,05-Aug-89,27,0,0,0,0,4000,6250,6000,134,125,2051036,183,76,D/DM C,1,2,4,3,3,3,4,2,1,2,2,13,12,12,7,14,14,12,13,5,12,14,12,10,14,6,13,14,13,14,14,13,15,10,12,10,12,13,14,10,12,14,9,10,11,10,20,14,14,12,7,13,8,15,13,14,12,11,14,13,13,6,18,1,15,7,7,7,18,D/DM C,321,1,1,1,7,1,1,18,1,1,20,15,7,7,1,1,4194304.0,0,0,0,0,0,0,0,0,0,0,0,0,0,0,0,0,0,0,0,0,0,0,1,0,0,0,0,0,0,0,0,0,0,0,0,0,0,0,0,0,0,0,0,0,0,0,0,0,GrÃÂ©gory Sertic,ÃÂ£3.60m ,31.0,183.0,Midfielder - Defensive Midfield,right,Without Club,28.0,1.0,1.0,2319.0,13.0,0.0,0.0,716.0,17.0,0.0,0.0,1103.0,nan,nan,nan,nan,nan,nan,nan,nan,Ligue 1,15-07-16,17.3.2.23,GrÃÂ©gory Sertic,8443655.0,761.0,05-Aug-89,26.0,0.0,0.0,0.0,0.0,4500.0,6200.0,6400.0,134.0,128.0,8179415.0,183.0,76.0,DM/M C,3.0,3.0,1.0,2.0,2.0,1.0,3.0,3.0,1.0,3.0,1.0,13.0,12.0,12.0,7.0,14.0,14.0,12.0,14.0,5.0,10.0,14.0,12.0,10.0,14.0,6.0,13.0,14.0,13.0,13.0,13.0,12.0,15.0,10.0,13.0,12.0,12.0,13.0,14.0,11.0,13.0,14.0,9.0,12.0,11.0,12.0,20.0,14.0,13.0,13.0,7.0,13.0,8.0,15.0,12.0,14.0,12.0,11.0,14.0,13.0,13.0,6.0,GrÃÂ©gory Sertic,ÃÂ£3.60m ,Ligue 1
19/6/2011,Fran MÃÂ©rida,29005328,796,3/4/1990,21,0,0,4,0,4750,6250,6250,145,127,675961,173,69,M/AM C,1,3,1,1,1,2,2,2,2,1,1,9,14,14,10,15,12,4,13,3,6,15,9,6,16,8,12,9,14,13,15,14,12,15,5,13,8,13,11,12,15,14,7,20,13,11,13,12,9,14,4,10,4,12,13,16,10,11,12,12,9,8,1,1,20,19,10,14,20,M/AM C,411,1,1,1,19,12,8,1,1,1,1,20,14,10,1,1,4210688.0,0,0,0,0,0,0,0,0,0,0,0,0,0,0,1,0,0,0,0,0,0,0,1,0,0,0,0,0,0,0,0,0,0,0,0,0,0,0,0,0,0,0,0,0,0,0,0,0,Fran MÃÂ©rida,ÃÂ£2.25m ,30.0,174.0,Midfielder - Central Midfield,left,RCD Espanyol Barcelona,27.0,3.0,4.0,1071.0,11.0,1.0,0.0,261.0,25.0,2.0,1.0,1591.0,6.0,0.0,1.0,208.0,21.0,1.0,0.0,1131.0,39.0,9.0,4.0,3047.0,17.0,1.0,0.0,922.0,37.0,8.0,5.0,3045.0,31.0,1.0,1.0,2418.0,LaLiga,25.0,1.0,1.0,1338.0,8.0,1.0,0.0,585.0,29/6/2010,Fran MÃÂÃÂ©rida,29005328.0,796.0,3/4/1990,20.0,0.0,0.0,4.0,0.0,2750.0,5399.0,5000.0,131.0,120.0,7308829.0,173.0,69.0,M/AM LC,1.0,2.0,3.0,3.0,1.0,1.0,2.0,4.0,3.0,3.0,1.0,9.0,13.0,13.0,10.0,15.0,12.0,4.0,13.0,3.0,6.0,14.0,9.0,5.0,16.0,6.0,12.0,9.0,14.0,12.0,14.0,12.0,12.0,15.0,5.0,13.0,8.0,12.0,10.0,12.0,15.0,14.0,8.0,20.0,13.0,11.0,13.0,10.0,9.0,14.0,4.0,10.0,4.0,12.0,13.0,16.0,10.0,11.0,12.0,12.0,9.0,8.0,Fran MÃÂÃÂ©rida,ÃÂÃÂ£2.70m ,LaLiga
19/6/2011,FÃÂ©lix Van Hulst,85054535,769,4/30/1990,21,0,0,0,0,1251,4184,2502,125,93,11501,178,71,DM C,3,2,2,3,2,2,2,4,2,3,1,8,10,9,7,12,13,7,13,6,6,11,7,8,12,10,11,11,13,13,13,12,13,11,7,7,8,12,12,12,12,12,9,5,15,11,20,15,11,14,10,10,5,8,7,13,13,13,13,15,15,6,1,1,15,1,1,1,15,DM C,301,1,1,1,1,1,1,1,1,1,20,15,1,1,1,1,4194304.0,0,0,0,0,0,0,0,0,0,0,0,0,0,0,0,0,0,0,0,0,0,0,1,0,0,0,0,0,0,0,0,0,0,0,0,0,0,0,0,0,0,0,0,0,0,0,0,0,nan,nan,nan,nan,nan,nan,nan,nan,nan,nan,nan,nan,nan,nan,nan,nan,nan,nan,nan,nan,nan,nan,nan,nan,nan,nan,nan,nan,nan,nan,nan,nan,nan,nan,nan,nan,nan,nan,nan,nan,nan,nan,nan,nan,nan,nan,nan,nan,nan,nan,nan,nan,nan,nan,nan,nan,nan,nan,nan,nan,nan,nan,nan,nan,nan,nan,nan,nan,nan,nan,nan,nan,nan,nan,nan,nan,nan,nan,nan,nan,nan,nan,nan,nan,nan,nan,nan,nan,nan,nan,nan,nan,nan,nan,nan,nan,nan,nan,nan,nan,nan,nan,nan,nan,nan,nan,nan,nan,nan,nan,nan,nan,nan,nan,nan,nan,nan,nan,nan,nan,nan,nan,nan,nan,nan,nan,nan,nan,nan,nan,nan,nan,nan,nan,nan,nan
19/6/2011,Federico Casarini,43006683,776,8/7/1989,21,0,0,0,0,3050,6500,6500,164,129,699889,181,72,M C,1,2,1,2,1,2,3,4,3,3,2,10,12,13,9,10,10,11,12,8,11,15,4,13,16,12,11,14,8,12,13,11,14,14,6,11,11,15,15,14,13,10,12,12,13,14,20,15,12,14,8,13,3,6,10,7,12,11,9,9,11,9,1,1,20,14,1,1,20,M C,401,1,1,1,14,1,1,1,1,1,1,20,1,1,1,1,0.0,0,0,0,0,0,0,0,0,0,0,0,0,0,0,0,0,0,0,0,0,0,0,0,0,0,0,0,0,0,0,0,0,0,0,0,0,0,0,0,0,0,0,0,0,0,0,0,0,Federico Casarini,ÃÂ£1.08m ,31.0,181.0,Midfielder - Central Midfield,right,US Alessandria Calcio 1912,35.0,0.0,2.0,2118.0,13.0,0.0,0.0,820.0,11.0,1.0,0.0,363.0,35.0,2.0,3.0,2901.0,35.0,1.0,3.0,2723.0,35.0,0.0,5.0,3052.0,41.0,3.0,2.0,3594.0,30.0,1.0,0.0,2324.0,19.0,0.0,2.0,976.0,Serie A,21.0,3.0,1.0,1220.0,8.0,0.0,0.0,640.0,29/6/2010,Federico Casarini,43006683.0,776.0,8/7/1989,20.0,0.0,0.0,0.0,0.0,950.0,5354.0,5100.0,145.0,119.0,1842299.0,181.0,72.0,M C,3.0,3.0,1.0,3.0,2.0,2.0,1.0,5.0,3.0,3.0,1.0,9.0,11.0,12.0,8.0,9.0,9.0,10.0,11.0,6.0,10.0,14.0,7.0,12.0,15.0,11.0,10.0,13.0,7.0,11.0,12.0,10.0,14.0,13.0,5.0,10.0,10.0,14.0,14.0,14.0,13.0,10.0,12.0,11.0,13.0,14.0,20.0,15.0,12.0,13.0,8.0,12.0,7.0,5.0,10.0,7.0,12.0,11.0,9.0,9.0,11.0,9.0,Federico Casarini,ÃÂÃÂ£1.35m ,Serie A
19/6/2011,Fabian Delph,29001228,765,11/21/1989,21,0,0,4,0,5000,6500,7000,162,128,1260936,174,60,M C,3,1,3,2,2,1,2,2,3,3,2,10,12,14,11,14,10,3,14,1,5,13,8,10,13,17,10,15,14,10,12,9,16,14,10,12,10,11,12,17,18,16,8,20,15,15,7,15,8,12,3,10,9,12,8,16,15,12,14,7,3,4,1,1,20,13,14,14,20,M C,401,1,1,1,13,1,1,1,1,1,10,20,14,14,1,1,140892000000000.0,0,0,1,0,0,0,0,1,0,0,0,0,0,0,0,0,0,0,0,0,0,0,0,0,0,0,0,0,0,0,0,0,0,0,1,0,0,1,0,0,0,0,0,0,0,0,0,1,Fabian Delph,ÃÂ£3.15m ,30.0,174.0,Midfielder - Central Midfield,left,Everton FC,8.0,0.0,0.0,503.0,16.0,0.0,0.0,1274.0,32.0,1.0,0.0,2320.0,36.0,4.0,3.0,3153.0,32.0,2.0,5.0,2793.0,27.0,2.0,0.0,1235.0,13.0,2.0,0.0,515.0,29.0,1.0,2.0,2324.0,20.0,0.0,1.0,1219.0,Premier League,20.0,0.0,0.0,1471.0,4.0,0.0,0.0,216.0,nan,nan,nan,nan,nan,nan,nan,nan,nan,nan,nan,nan,nan,nan,nan,nan,nan,nan,nan,nan,nan,nan,nan,nan,nan,nan,nan,nan,nan,nan,nan,nan,nan,nan,nan,nan,nan,nan,nan,nan,nan,nan,nan,nan,nan,nan,nan,nan,nan,nan,nan,nan,nan,nan,nan,nan,nan,nan,nan,nan,nan,nan,nan,nan,nan,nan,nan,nan,nan,nan,nan,nan,nan,nan,nan,nan,nan,nan,nan,nan,nan,nan,nan,nan,19-06-17,18.3.4.28,Fabian Delph,29001228,765,21-Nov-89,27,9,0,4,0,6000,7000,6900,146,146,33559286,174,65,D/M LC,1,3,2,2,2,1,2,2,2,3,3,10,11,12,11,12,10,3,11,4,8,14,8,14,12,15,13,15,12,16,13,14,12,14,16,14,13,17,18,17,18,14,8,20,12,14,7,16,12,12,16,10,16,16,12,16,15,11,16,9,5,4,16,14,20,13,14,16,20,D/M LC,424,1,1,1,13,1,1,1,16,1,10,20,12,14,14,1,159988000000.0,0,0,0,0,0,0,0,0,0,0,0,0,0,0,0,0,0,0,0,0,0,0,0,0,0,0,0,0,0,0,1,0,1,0,1,0,0,1,0,0,0,0,0,0,0,0,0,0,Fabian Delph,ÃÂ£13.50m ,30.0,174.0,Midfielder - Central Midfield,left,Everton FC,13.0,2.0,0.0,515.0,29.0,1.0,2.0,2324.0,20.0,0.0,1.0,1219.0,20.0,0.0,0.0,1471.0,4.0,0.0,0.0,216.0,Premier League,15-07-16,17.3.2.23,Fabian Delph,29001228.0,765.0,21-Nov-89,26.0,9.0,0.0,4.0,0.0,6000.0,6900.0,6900.0,145.0,138.0,23039073.0,174.0,60.0,M C,1.0,2.0,2.0,1.0,1.0,4.0,1.0,3.0,1.0,3.0,2.0,10.0,11.0,12.0,11.0,12.0,10.0,3.0,9.0,4.0,7.0,12.0,8.0,14.0,12.0,15.0,13.0,15.0,12.0,14.0,13.0,14.0,12.0,14.0,16.0,14.0,13.0,17.0,17.0,17.0,18.0,14.0,8.0,20.0,13.0,14.0,7.0,16.0,12.0,12.0,16.0,10.0,15.0,12.0,12.0,16.0,15.0,11.0,14.0,7.0,3.0,4.0,Fabian Delph,ÃÂ£7.20m ,Premier League
19/6/2011,David Timor,67067064,796,10/17/1989,21,0,0,0,0,2526,4776,4776,125,95,170140,185,77,DM/M C,1,3,3,3,3,1,1,1,3,2,2,7,5,6,5,11,8,13,6,5,13,13,8,13,9,13,11,9,11,13,9,11,10,6,8,8,13,13,14,11,10,11,14,5,12,10,20,13,14,12,9,12,6,7,7,10,12,6,9,14,9,7,1,1,18,1,1,1,18,DM/M C,311,1,1,1,1,1,1,1,1,1,20,18,1,1,1,1,0.0,0,0,0,0,0,0,0,0,0,0,0,0,0,0,0,0,0,0,0,0,0,0,0,0,0,0,0,0,0,0,0,0,0,0,0,0,0,0,0,0,0,0,0,0,0,0,0,0,David Timor,ÃÂ£720Th. ,31.0,185.0,Midfielder - Defensive Midfield,left,Getafe CF,31.0,7.0,0.0,2526.0,27.0,0.0,2.0,1053.0,19.0,1.0,3.0,1203.0,39.0,8.0,3.0,3410.0,38.0,6.0,2.0,2919.0,35.0,2.0,2.0,2754.0,25.0,2.0,1.0,1965.0,19.0,2.0,0.0,1101.0,37.0,1.0,4.0,3166.0,LaLiga,33.0,3.0,1.0,1590.0,6.0,0.0,0.0,85.0,nan,nan,nan,nan,nan,nan,nan,nan,nan,nan,nan,nan,nan,nan,nan,nan,nan,nan,nan,nan,nan,nan,nan,nan,nan,nan,nan,nan,nan,nan,nan,nan,nan,nan,nan,nan,nan,nan,nan,nan,nan,nan,nan,nan,nan,nan,nan,nan,nan,nan,nan,nan,nan,nan,nan,nan,nan,nan,nan,nan,nan,nan,nan,nan,nan,nan,nan,nan,nan,nan,nan,nan,nan,nan,nan,nan,nan,nan,nan,nan,nan,nan,nan,nan,19-06-17,18.3.4.28,David Timor,67067064,796,17-Oct-89,27,0,0,0,0,3950,6250,6250,131,125,3113445,185,77,M/AM C,2,3,1,1,1,3,1,2,1,2,3,11,12,13,12,15,12,14,14,5,12,15,9,12,15,10,11,9,11,11,15,12,11,14,7,14,10,12,11,11,10,8,14,20,12,13,10,13,13,12,14,13,6,7,12,14,7,7,13,8,7,14,1,1,20,17,1,10,20,M/AM C,411,1,1,1,17,1,1,1,1,1,9,20,10,1,1,1,131072.0,0,0,0,0,0,0,0,0,0,0,0,0,0,0,0,0,0,1,0,0,0,0,0,0,0,0,0,0,0,0,0,0,0,0,0,0,0,0,0,0,0,0,0,0,0,0,0,0,David Timor,ÃÂ£1.80m ,31.0,185.0,Midfielder - Defensive Midfield,left,Getafe CF,25.0,2.0,1.0,1965.0,19.0,2.0,0.0,1101.0,37.0,1.0,4.0,3166.0,33.0,3.0,1.0,1590.0,6.0,0.0,0.0,85.0,LaLiga,15-07-16,17.3.2.23,David Timor,67067064.0,796.0,17-Oct-89,26.0,0.0,0.0,0.0,0.0,4100.0,6550.0,6550.0,136.0,131.0,2670396.0,185.0,77.0,M/AM C,3.0,3.0,1.0,3.0,2.0,1.0,2.0,3.0,2.0,2.0,2.0,11.0,12.0,13.0,12.0,15.0,12.0,14.0,14.0,5.0,12.0,15.0,9.0,12.0,15.0,10.0,11.0,9.0,11.0,11.0,15.0,12.0,11.0,14.0,7.0,14.0,10.0,12.0,11.0,11.0,11.0,10.0,14.0,20.0,12.0,13.0,12.0,14.0,14.0,12.0,14.0,13.0,6.0,7.0,12.0,14.0,7.0,7.0,13.0,8.0,7.0,14.0,David Timor,ÃÂ£1.80m ,LaLiga
19/6/2011,Daniel Royer,16018632,755,5/22/1990,21,2,0,5,0,1405,5459,4385,140,121,316205,177,72,M/AM RLC,1,1,1,3,2,3,3,3,1,1,3,9,13,13,10,13,10,10,11,5,11,11,7,11,14,8,9,13,9,8,11,11,10,15,8,11,12,11,11,13,14,10,11,17,14,13,20,14,12,8,6,4,9,11,7,2,9,11,7,10,9,9,1,11,20,20,20,20,20,M/AM RLC,416,1,1,1,1,20,17,1,1,1,1,20,20,20,11,11,2748780000000.0,0,0,0,0,0,0,0,0,0,0,0,0,0,0,0,0,0,0,0,0,1,0,0,0,0,0,0,0,0,0,0,0,0,0,0,0,0,0,0,1,0,1,0,0,0,0,0,0,Daniel Royer,ÃÂ£720Th. ,30.0,177.0,Forward - Left Winger,both,New York Red Bulls,41.0,5.0,7.0,3019.0,24.0,2.0,3.0,1899.0,29.0,3.0,2.0,1354.0,41.0,7.0,9.0,2656.0,36.0,7.0,5.0,2259.0,43.0,3.0,5.0,2622.0,34.0,15.0,3.0,2442.0,41.0,16.0,4.0,2899.0,37.0,14.0,8.0,2808.0,Bundesliga,18.0,4.0,2.0,1297.0,nan,nan,nan,nan,nan,nan,nan,nan,nan,nan,nan,nan,nan,nan,nan,nan,nan,nan,nan,nan,nan,nan,nan,nan,nan,nan,nan,nan,nan,nan,nan,nan,nan,nan,nan,nan,nan,nan,nan,nan,nan,nan,nan,nan,nan,nan,nan,nan,nan,nan,nan,nan,nan,nan,nan,nan,nan,nan,nan,nan,nan,nan,nan,nan,nan,nan,nan,nan,nan,nan,nan,nan,nan,nan,nan,nan,nan,nan,nan,nan,nan,nan,nan,nan,nan,nan,nan,nan
19/6/2011,Daniel Didavi,92012101,771,2/21/1990,21,0,0,4,0,3250,5600,5900,139,112,269183,180,77,M LC,1,1,2,3,1,3,3,3,2,2,3,13,14,12,8,13,15,7,12,4,3,14,13,7,14,7,12,7,11,11,16,11,10,14,4,12,8,13,14,12,12,13,11,20,11,11,8,12,10,10,4,10,10,8,4,12,11,7,2,14,10,18,1,1,20,15,1,20,17,M LC,404,1,1,1,1,15,1,1,1,1,1,17,20,1,1,1,256.0,0,0,0,0,0,0,0,0,1,0,0,0,0,0,0,0,0,0,0,0,0,0,0,0,0,0,0,0,0,0,0,0,0,0,0,0,0,0,0,0,0,0,0,0,0,0,0,0,Daniel Didavi,ÃÂ£2.25m ,30.0,180.0,Midfielder - Attacking Midfield,left,VfB Stuttgart,15.0,0.0,2.0,672.0,27.0,9.0,3.0,1809.0,5.0,0.0,0.0,145.0,9.0,1.0,2.0,582.0,14.0,5.0,0.0,986.0,34.0,14.0,5.0,2694.0,22.0,4.0,5.0,1235.0,33.0,10.0,7.0,2411.0,23.0,2.0,2.0,1111.0,Bundesliga,21.0,6.0,4.0,1609.0,6.0,1.0,2.0,468.0,29/6/2010,Daniel Didavi,92012101.0,771.0,2/21/1990,20.0,0.0,0.0,0.0,0.0,3000.0,5600.0,5600.0,140.0,112.0,8536546.0,180.0,77.0,M LC,1.0,3.0,3.0,2.0,1.0,1.0,2.0,4.0,1.0,3.0,2.0,13.0,14.0,12.0,8.0,13.0,15.0,7.0,12.0,4.0,3.0,14.0,13.0,7.0,14.0,7.0,12.0,7.0,11.0,11.0,16.0,11.0,9.0,14.0,4.0,12.0,8.0,13.0,14.0,12.0,12.0,13.0,11.0,20.0,11.0,11.0,8.0,12.0,10.0,10.0,4.0,8.0,10.0,8.0,5.0,5.0,18.0,6.0,11.0,12.0,8.0,13.0,Daniel Didavi,ÃÂÃÂ£900Th. ,Bundesliga,19-06-17,18.3.4.28,Daniel Didavi,92012101,771,21-Feb-90,27,0,0,5,1,6550,6800,7050,145,141,24349786,180,77,AM LC,3,2,4,1,3,1,1,2,1,2,1,15,14,12,15,16,15,10,17,6,7,14,13,9,15,15,14,8,13,10,16,12,9,15,7,13,10,12,15,14,15,11,9,20,12,12,10,14,11,14,7,13,16,10,8,12,14,12,13,11,11,7,1,1,15,20,14,15,20,AM LC,504,1,1,1,20,15,14,1,1,1,10,12,15,14,1,1,549756000000.0,0,0,0,0,0,0,0,0,0,0,0,1,0,0,0,0,0,0,0,0,0,0,0,0,0,0,0,0,0,0,0,0,0,0,0,0,0,0,0,1,0,0,0,0,0,0,0,0,Daniel Didavi,ÃÂ£6.30m ,30.0,180.0,Midfielder - Attacking Midfield,left,VfB Stuttgart,22.0,4.0,5.0,1235.0,33.0,10.0,7.0,2411.0,23.0,2.0,2.0,1111.0,21.0,6.0,4.0,1609.0,6.0,1.0,2.0,468.0,Bundesliga,15-07-16,17.3.2.23,Daniel Didavi,92012101.0,771.0,21-Feb-90,26.0,0.0,0.0,5.0,1.0,4650.0,7150.0,7150.0,145.0,143.0,22137839.0,180.0,77.0,AM LC,1.0,1.0,2.0,2.0,1.0,1.0,2.0,2.0,2.0,1.0,3.0,15.0,14.0,12.0,15.0,16.0,15.0,10.0,17.0,6.0,7.0,14.0,13.0,9.0,16.0,15.0,14.0,8.0,13.0,10.0,16.0,13.0,9.0,15.0,7.0,13.0,10.0,12.0,15.0,14.0,15.0,11.0,9.0,20.0,12.0,12.0,10.0,14.0,11.0,14.0,7.0,13.0,16.0,10.0,8.0,12.0,14.0,12.0,13.0,11.0,11.0,7.0,Daniel Didavi,ÃÂ£3.60m ,Bundesliga
19/6/2011,Dan Gosling,29007273,765,2/1/1990,21,0,0,2,0,3500,6250,6250,150,122,2565562,178,70,D/DM/M RC,1,3,1,2,2,3,1,5,1,3,3,7,9,13,11,12,8,10,8,8,10,13,9,10,12,9,11,12,14,14,13,12,14,7,14,14,13,13,14,12,12,10,9,12,15,11,20,14,12,15,4,14,11,14,12,12,8,15,15,13,14,2,16,10,20,13,18,1,20,D/DM/M RC,333,1,1,1,10,1,13,1,1,16,20,20,1,18,1,10,17592200000000.0,0,1,0,0,0,0,1,0,0,0,0,0,0,0,0,0,0,0,0,0,0,0,0,0,0,0,0,0,0,0,0,0,0,0,0,0,0,0,0,0,0,0,0,0,1,0,0,0,Dan Gosling,ÃÂ£1.35m ,30.0,180.0,Midfielder - Central Midfield,right,AFC Bournemouth,2.0,0.0,1.0,90.0,22.0,5.0,5.0,941.0,14.0,2.0,1.0,831.0,26.0,3.0,1.0,1799.0,24.0,5.0,2.0,814.0,37.0,4.0,2.0,2595.0,30.0,3.0,1.0,1600.0,32.0,3.0,1.0,2331.0,26.0,2.0,1.0,1827.0,Premier League,25.0,3.0,1.0,1350.0,8.0,2.0,0.0,509.0,29/6/2010,Dan Gosling,29007273.0,765.0,2/1/1990,20.0,0.0,0.0,2.0,0.0,3500.0,5750.0,5750.0,150.0,122.0,5648247.0,178.0,70.0,D/DM/M RC,2.0,1.0,1.0,3.0,1.0,2.0,3.0,3.0,1.0,2.0,1.0,7.0,9.0,13.0,11.0,12.0,8.0,10.0,8.0,2.0,10.0,13.0,9.0,10.0,12.0,9.0,11.0,12.0,14.0,14.0,13.0,12.0,14.0,7.0,14.0,14.0,13.0,13.0,14.0,12.0,12.0,10.0,9.0,12.0,15.0,11.0,20.0,14.0,10.0,15.0,4.0,14.0,7.0,14.0,12.0,12.0,8.0,15.0,15.0,13.0,14.0,2.0,Dan Gosling,ÃÂÃÂ£2.25m ,Premier League,19-06-17,18.3.4.28,Dan Gosling,29007273,765,01-Feb-90,27,0,0,3,0,4750,6500,6500,130,130,24753445,181,78,M C,4,1,2,2,1,2,2,3,1,2,2,7,8,14,14,13,8,12,12,4,10,14,10,13,13,9,13,12,14,13,13,12,13,7,12,13,13,14,17,13,12,10,11,7,14,13,20,17,14,14,8,13,13,16,12,13,7,15,14,14,14,6,1,1,20,13,1,1,20,M C,401,1,1,1,13,1,1,1,1,1,1,20,1,1,1,1,17595400000000.0,0,0,0,0,0,0,1,0,0,0,0,0,0,0,0,0,0,0,0,0,0,0,0,0,0,0,0,0,0,0,1,1,0,0,0,0,0,0,0,0,0,0,0,0,1,0,0,0,Dan Gosling,ÃÂ£3.15m ,30.0,180.0,Midfielder - Central Midfield,right,AFC Bournemouth,30.0,3.0,1.0,1600.0,32.0,3.0,1.0,2331.0,26.0,2.0,1.0,1827.0,25.0,3.0,1.0,1350.0,8.0,2.0,0.0,509.0,Premier League,15-07-16,17.3.2.23,Dan Gosling,29007273.0,765.0,01-Feb-90,26.0,0.0,0.0,3.0,0.0,4497.0,6297.0,6397.0,130.0,128.0,17681843.0,181.0,78.0,M C,1.0,3.0,1.0,3.0,3.0,2.0,1.0,2.0,2.0,1.0,1.0,7.0,8.0,14.0,14.0,13.0,8.0,11.0,10.0,4.0,10.0,14.0,10.0,13.0,13.0,9.0,12.0,12.0,14.0,13.0,13.0,12.0,13.0,7.0,12.0,13.0,13.0,14.0,17.0,13.0,12.0,10.0,11.0,7.0,14.0,13.0,20.0,17.0,14.0,14.0,8.0,13.0,13.0,16.0,12.0,13.0,2.0,15.0,13.0,14.0,14.0,6.0,Dan Gosling,ÃÂ£2.70m ,Premier League
19/6/2011,Christoph Moritz,91018390,771,1/27/1990,21,0,0,4,0,4650,6350,6350,142,127,478893,186,73,DM/M C,3,2,3,2,1,3,2,1,3,2,1,8,12,9,6,13,6,8,9,11,9,13,8,10,14,9,16,10,15,17,11,15,12,5,12,8,13,19,17,12,13,9,13,10,11,12,20,18,10,17,6,10,14,16,6,11,10,10,13,9,14,13,10,8,18,12,10,1,18,DM/M C,311,1,1,1,12,1,1,1,1,10,20,18,1,10,1,8,0.0,0,0,0,0,0,0,0,0,0,0,0,0,0,0,0,0,0,0,0,0,0,0,0,0,0,0,0,0,0,0,0,0,0,0,0,0,0,0,0,0,0,0,0,0,0,0,0,0,Christoph Moritz,ÃÂ£2.25m ,30.0,186.0,Midfielder - Central Midfield,right,SSV Jahn Regensburg,18.0,0.0,2.0,1046.0,17.0,0.0,0.0,947.0,11.0,0.0,0.0,606.0,27.0,2.0,2.0,1840.0,13.0,1.0,0.0,840.0,10.0,0.0,0.0,389.0,29.0,1.0,2.0,2439.0,32.0,5.0,1.0,2445.0,24.0,1.0,0.0,931.0,Bundesliga,10.0,0.0,2.0,458.0,5.0,0.0,0.0,279.0,29/6/2010,Christoph Moritz,91018390.0,771.0,1/27/1990,20.0,0.0,0.0,0.0,0.0,2250.0,6750.0,6750.0,142.0,129.0,16844798.0,186.0,73.0,DM/M C,1.0,2.0,2.0,3.0,3.0,3.0,1.0,1.0,1.0,2.0,3.0,8.0,12.0,9.0,7.0,13.0,6.0,8.0,9.0,11.0,9.0,13.0,8.0,10.0,14.0,9.0,16.0,10.0,15.0,17.0,12.0,15.0,12.0,5.0,12.0,8.0,13.0,19.0,17.0,12.0,13.0,9.0,13.0,10.0,18.0,12.0,20.0,18.0,10.0,17.0,6.0,8.0,5.0,16.0,4.0,13.0,16.0,5.0,14.0,14.0,9.0,9.0,Christoph Moritz,ÃÂÃÂ£2.70m ,Bundesliga
19/6/2011,Barry Bannan,29010507,793,12/1/1989,21,5,0,10,1,4000,6250,6750,150,119,1023631,170,60,M LC,2,2,1,3,1,3,2,4,1,1,1,11,14,13,10,14,11,6,11,3,4,15,15,8,14,11,11,11,14,10,15,12,13,14,4,13,9,12,12,16,13,14,6,20,14,12,7,12,5,14,5,10,3,15,10,14,12,16,10,10,12,4,1,1,20,14,13,16,20,M LC,404,1,1,1,10,14,11,1,1,1,1,20,16,13,1,1,10995100000000.0,0,0,0,0,0,0,0,0,0,0,0,0,0,0,0,0,0,0,0,0,0,0,1,0,0,0,0,0,0,0,0,0,0,0,0,0,0,0,0,0,0,1,0,1,0,0,0,0,Barry Bannan,ÃÂ£4.50m ,30.0,169.0,Midfielder - Central Midfield,left,Sheffield Wednesday,30.0,4.0,5.0,1804.0,38.0,4.0,6.0,2070.0,30.0,0.0,2.0,2122.0,17.0,1.0,2.0,1174.0,26.0,0.0,5.0,1808.0,41.0,3.0,2.0,3566.0,46.0,1.0,8.0,3942.0,31.0,1.0,3.0,2636.0,45.0,4.0,12.0,3952.0,Premier League,46.0,2.0,8.0,3963.0,8.0,1.0,0.0,720.0,29/6/2010,Barry Bannan,29010507.0,793.0,12/1/1989,20.0,0.0,0.0,5.0,0.0,2500.0,5400.0,5000.0,123.0,104.0,3103756.0,170.0,60.0,M RLC,2.0,2.0,1.0,3.0,2.0,2.0,2.0,1.0,2.0,3.0,3.0,10.0,12.0,12.0,9.0,12.0,10.0,5.0,10.0,2.0,3.0,12.0,14.0,7.0,12.0,11.0,9.0,11.0,10.0,9.0,12.0,7.0,13.0,14.0,4.0,12.0,8.0,11.0,11.0,15.0,9.0,10.0,5.0,20.0,14.0,12.0,7.0,11.0,6.0,14.0,5.0,10.0,3.0,15.0,10.0,14.0,12.0,16.0,10.0,10.0,12.0,4.0,Barry Bannan,ÃÂÃÂ£2.70m ,Premier League
19/6/2011,Asier Illarramendi,67039257,796,3/8/1990,21,0,0,0,0,3668,6029,6029,149,126,324913,177,74,M C,2,1,3,2,1,1,3,1,1,1,1,13,10,11,10,13,14,7,10,3,11,14,7,11,13,7,11,12,13,13,13,13,12,12,13,12,13,18,15,12,12,12,9,12,11,13,20,14,10,12,7,10,5,10,11,13,15,12,15,14,13,18,1,1,20,14,1,1,20,M C,401,1,1,1,14,1,1,1,1,1,15,20,1,1,1,1,0.0,0,0,0,0,0,0,0,0,0,0,0,0,0,0,0,0,0,0,0,0,0,0,0,0,0,0,0,0,0,0,0,0,0,0,0,0,0,0,0,0,0,0,0,0,0,0,0,0,Asier Illarramendi,ÃÂ£1.08m ,30.0,179.0,Midfielder - Defensive Midfield,right,Real Sociedad,31.0,3.0,0.0,2348.0,18.0,0.0,1.0,1405.0,34.0,0.0,1.0,2836.0,49.0,3.0,1.0,2506.0,41.0,0.0,0.0,1721.0,35.0,1.0,2.0,2990.0,39.0,1.0,4.0,3454.0,44.0,7.0,6.0,3738.0,26.0,1.0,1.0,2017.0,LaLiga,3.0,0.0,0.0,217.0,nan,nan,nan,nan,nan,nan,nan,nan,nan,nan,nan,nan,nan,nan,nan,nan,nan,nan,nan,nan,nan,nan,nan,nan,nan,nan,nan,nan,nan,nan,nan,nan,nan,nan,nan,nan,nan,nan,nan,nan,nan,nan,nan,nan,nan,nan,nan,nan,nan,nan,nan,nan,nan,nan,nan,nan,nan,nan,nan,nan,nan,nan,nan,nan,nan,nan,nan,nan,nan,nan,nan,nan,nan,nan,nan,nan,nan,nan,nan,nan,nan,nan,nan,nan,nan,nan,nan,nan,19-06-17,18.3.4.28,Asier Illarramendi,67039257,796,08-Mar-90,27,1,0,16,0,6250,7400,7400,155,150,31949394,179,76,DM/M C,2,2,3,3,2,1,2,2,1,1,1,11,10,11,8,15,11,8,13,6,14,17,9,14,15,15,15,14,12,16,15,14,9,7,12,9,17,19,17,11,12,13,10,8,14,12,20,18,14,14,13,14,7,9,13,12,14,9,17,15,15,4,1,1,20,1,1,1,20,DM/M C,311,1,1,1,1,1,1,1,1,1,20,20,1,1,1,1,149534000000000.0,0,0,0,0,0,0,0,0,0,0,0,0,0,0,0,0,0,0,0,1,0,0,0,0,0,0,1,0,0,0,0,0,0,0,0,0,0,0,0,0,0,0,0,1,0,0,0,1,Asier Illarramendi,ÃÂ£18.00m ,30.0,179.0,Midfielder - Defensive Midfield,right,Real Sociedad,39.0,1.0,4.0,3454.0,44.0,7.0,6.0,3738.0,26.0,1.0,1.0,2017.0,3.0,0.0,0.0,217.0,nan,nan,nan,nan,LaLiga,15-07-16,17.3.2.23,Asier Illarramendi,67039257.0,796.0,08-Mar-90,26.0,0.0,0.0,16.0,0.0,6250.0,7400.0,7400.0,155.0,148.0,31580923.0,179.0,76.0,DM/M C,1.0,2.0,2.0,2.0,2.0,2.0,2.0,2.0,3.0,3.0,2.0,11.0,10.0,10.0,7.0,15.0,11.0,8.0,11.0,6.0,14.0,17.0,9.0,14.0,14.0,15.0,15.0,14.0,12.0,16.0,15.0,14.0,9.0,7.0,12.0,9.0,17.0,19.0,17.0,11.0,12.0,13.0,10.0,8.0,14.0,12.0,20.0,18.0,14.0,14.0,13.0,12.0,7.0,9.0,13.0,12.0,14.0,9.0,17.0,15.0,15.0,4.0,Asier Illarramendi,ÃÂ£13.50m ,LaLiga
19/6/2011,Armin Bacinovic,64001279,795,10/24/1989,21,6,0,11,4,4500,6261,6900,165,138,6491726,183,75,DM/M C,3,1,1,2,3,2,2,2,2,2,2,9,10,11,10,11,9,14,16,7,13,14,8,13,12,10,13,12,14,12,16,14,15,12,10,13,14,14,12,12,11,14,12,10,13,11,20,14,14,12,13,13,11,12,14,12,12,15,10,10,11,13,12,1,20,1,12,1,20,DM/M C,421,1,13,1,1,1,1,11,1,12,18,20,1,1,1,1,512.0,0,0,0,0,0,0,0,0,0,1,0,0,0,0,0,0,0,0,0,0,0,0,0,0,0,0,0,0,0,0,0,0,0,0,0,0,0,0,0,0,0,0,0,0,0,0,0,0,Armin Bacinovic,ÃÂ£3.15m ,31.0,183.0,Midfielder - Defensive Midfield,right,Without Club,44.0,2.0,2.0,3346.0,14.0,0.0,0.0,681.0,20.0,1.0,2.0,1519.0,9.0,0.0,0.0,640.0,30.0,1.0,1.0,2068.0,31.0,1.0,1.0,2351.0,28.0,2.0,1.0,1963.0,27.0,0.0,2.0,1471.0,nan,nan,nan,nan,Serie A,nan,nan,nan,nan,nan,nan,nan,nan,29/6/2010,Armin Bacinovic,64001279.0,795.0,10/24/1989,20.0,1.0,0.0,11.0,4.0,3250.0,6000.0,5500.0,148.0,117.0,5135258.0,183.0,75.0,DM/M C,3.0,2.0,3.0,3.0,1.0,1.0,2.0,1.0,1.0,3.0,1.0,10.0,11.0,12.0,11.0,11.0,8.0,15.0,13.0,8.0,14.0,13.0,9.0,12.0,13.0,10.0,14.0,12.0,15.0,13.0,11.0,11.0,15.0,12.0,9.0,14.0,10.0,13.0,13.0,13.0,12.0,13.0,12.0,20.0,13.0,12.0,7.0,13.0,12.0,12.0,13.0,13.0,11.0,12.0,14.0,12.0,12.0,15.0,10.0,10.0,11.0,13.0,Armin Bacinovic,ÃÂÃÂ£4.50m ,Serie A
19/6/2011,Andrea Poli,43006570,776,9/28/1989,21,0,0,13,1,4522,6516,6666,172,134,873547,181,70,M C,3,1,2,3,2,2,3,5,1,1,2,15,10,12,10,16,12,10,12,8,10,17,10,12,15,12,12,12,14,15,15,15,12,16,10,17,12,12,12,13,12,12,10,10,15,10,20,16,12,16,10,16,8,12,15,16,12,10,10,10,10,13,1,1,20,1,1,1,20,M C,401,1,1,1,1,1,1,1,1,1,10,20,1,1,1,1,549756000000.0,0,0,0,0,0,0,0,0,0,0,0,0,0,0,0,0,0,0,0,0,0,0,0,0,0,0,0,0,0,0,0,0,0,0,0,0,0,0,0,1,0,0,0,0,0,0,0,0,Andrea Poli,ÃÂ£6.75m ,31.0,182.0,Midfielder - Central Midfield,right,Bologna FC 1909,28.0,0.0,2.0,1754.0,21.0,1.0,1.0,1136.0,32.0,3.0,0.0,2630.0,37.0,2.0,4.0,2161.0,35.0,1.0,3.0,2244.0,24.0,0.0,3.0,981.0,13.0,0.0,0.0,380.0,33.0,2.0,0.0,2658.0,32.0,4.0,1.0,2124.0,Serie A,30.0,3.0,1.0,2047.0,1.0,0.0,0.0,64.0,29/6/2010,Andrea Poli,43006570.0,776.0,9/28/1989,20.0,0.0,0.0,10.0,1.0,4500.0,6500.0,6500.0,176.0,140.0,14899501.0,181.0,70.0,DM/M C,2.0,3.0,2.0,2.0,2.0,3.0,3.0,2.0,3.0,2.0,1.0,15.0,10.0,16.0,14.0,16.0,12.0,10.0,12.0,8.0,10.0,17.0,10.0,12.0,15.0,12.0,12.0,12.0,14.0,15.0,15.0,15.0,12.0,16.0,10.0,17.0,12.0,12.0,12.0,13.0,12.0,12.0,10.0,10.0,15.0,10.0,20.0,16.0,12.0,16.0,10.0,16.0,8.0,12.0,15.0,16.0,12.0,10.0,10.0,10.0,10.0,12.0,Andrea Poli,ÃÂÃÂ£4.95m ,Serie A,19-06-17,18.3.4.28,Andrea Poli,43006570,776,29-Sep-89,27,5,1,13,1,5100,6250,6700,140,134,16370723,182,77,M C,3,2,3,4,3,3,1,2,3,1,2,6,11,13,7,13,6,10,11,10,13,13,8,14,13,15,12,15,13,14,12,12,14,8,12,13,14,15,16,14,13,14,10,12,14,15,20,14,12,15,13,11,11,12,9,13,14,13,16,15,11,6,1,1,20,5,1,1,20,M C,401,1,1,1,5,1,1,1,1,1,12,20,1,1,1,1,0.0,0,0,0,0,0,0,0,0,0,0,0,0,0,0,0,0,0,0,0,0,0,0,0,0,0,0,0,0,0,0,0,0,0,0,0,0,0,0,0,0,0,0,0,0,0,0,0,0,Andrea Poli,ÃÂ£3.60m ,31.0,182.0,Midfielder - Central Midfield,right,Bologna FC 1909,13.0,0.0,0.0,380.0,33.0,2.0,0.0,2658.0,32.0,4.0,1.0,2124.0,30.0,3.0,1.0,2047.0,1.0,0.0,0.0,64.0,Serie A,15-07-16,17.3.2.23,Andrea Poli,43006570.0,776.0,29-Sep-89,26.0,5.0,1.0,13.0,1.0,5250.0,6750.0,6800.0,148.0,135.0,8692057.0,182.0,77.0,M C,1.0,4.0,2.0,3.0,2.0,1.0,3.0,4.0,2.0,1.0,2.0,6.0,11.0,13.0,8.0,13.0,6.0,10.0,11.0,10.0,13.0,14.0,8.0,14.0,13.0,15.0,14.0,15.0,13.0,14.0,12.0,13.0,14.0,8.0,11.0,13.0,14.0,15.0,16.0,14.0,14.0,14.0,10.0,12.0,14.0,15.0,20.0,14.0,12.0,15.0,13.0,11.0,11.0,12.0,8.0,14.0,14.0,13.0,16.0,15.0,10.0,6.0,Andrea Poli,ÃÂ£3.60m ,Serie A
19/6/2011,AndrÃÂ© Martins,55009957,788,1/21/1990,21,0,0,4,1,1250,5250,5250,125,110,449645,166,56,M C,2,3,3,1,2,2,2,1,2,3,2,12,12,12,10,14,11,6,11,7,9,13,11,10,14,12,13,11,11,11,12,12,14,11,9,11,10,14,14,13,11,6,6,8,10,12,20,10,8,12,9,9,7,11,10,11,14,12,15,15,15,5,1,1,20,10,1,1,20,M C,401,1,1,1,10,1,1,1,1,1,10,20,1,1,1,1,0.0,0,0,0,0,0,0,0,0,0,0,0,0,0,0,0,0,0,0,0,0,0,0,0,0,0,0,0,0,0,0,0,0,0,0,0,0,0,0,0,0,0,0,0,0,0,0,0,0,AndrÃÂ© Martins,ÃÂ£2.25m ,30.0,169.0,Midfielder - Central Midfield,right,Legia Warszawa,4.0,0.0,0.0,118.0,21.0,0.0,2.0,929.0,22.0,0.0,2.0,1108.0,29.0,3.0,5.0,2089.0,27.0,1.0,1.0,1357.0,8.0,0.0,0.0,349.0,39.0,1.0,3.0,2529.0,14.0,1.0,1.0,697.0,28.0,2.0,3.0,2124.0,Liga NOS,44.0,0.0,1.0,3339.0,6.0,0.0,0.0,214.0,nan,nan,nan,nan,nan,nan,nan,nan,nan,nan,nan,nan,nan,nan,nan,nan,nan,nan,nan,nan,nan,nan,nan,nan,nan,nan,nan,nan,nan,nan,nan,nan,nan,nan,nan,nan,nan,nan,nan,nan,nan,nan,nan,nan,nan,nan,nan,nan,nan,nan,nan,nan,nan,nan,nan,nan,nan,nan,nan,nan,nan,nan,nan,nan,nan,nan,nan,nan,nan,nan,nan,nan,nan,nan,nan,nan,nan,nan,nan,nan,nan,nan,nan,nan
19/6/2011,AndrÃÂ© Ayew,8442448,21,12/17/1989,21,32,2,12,4,6050,7500,6750,165,150,2055336,176,72,M/AM LC,2,1,3,2,1,1,2,2,1,3,2,11,13,15,11,14,8,14,12,5,6,13,15,13,15,14,13,15,13,13,13,14,16,13,13,13,12,16,18,16,15,15,9,20,15,16,5,17,13,15,14,16,7,12,11,17,13,12,12,13,14,12,8,8,20,17,10,17,20,M/AM LC,414,1,1,12,12,17,10,1,8,1,1,20,17,10,8,1,2251950000000000.0,0,0,0,1,0,1,0,0,0,0,0,0,0,0,0,0,0,0,0,0,0,0,0,0,0,0,0,0,0,0,0,0,0,0,1,0,0,1,0,0,0,0,0,0,0,0,0,0,AndrÃÂ© Ayew,ÃÂ£13.50m ,30.0,176.0,Forward - Left Winger,left,Swansea City,51.0,13.0,6.0,3850.0,39.0,16.0,4.0,3153.0,45.0,12.0,5.0,3846.0,29.0,8.0,4.0,2482.0,30.0,11.0,6.0,2519.0,35.0,12.0,5.0,2943.0,26.0,6.0,3.0,1453.0,36.0,6.0,5.0,2361.0,38.0,5.0,2.0,2620.0,Ligue 1,47.0,18.0,7.0,4116.0,8.0,3.0,1.0,720.0,29/6/2010,AndrÃÂ© Ayew,8442448.0,21.0,12/17/1989,20.0,25.0,1.0,12.0,4.0,4422.0,6650.0,6000.0,160.0,133.0,18589951.0,176.0,72.0,M/AM LC,2.0,3.0,1.0,2.0,3.0,1.0,3.0,6.0,3.0,3.0,1.0,11.0,11.0,14.0,9.0,14.0,8.0,12.0,12.0,5.0,5.0,14.0,12.0,6.0,14.0,11.0,12.0,14.0,12.0,12.0,14.0,12.0,15.0,13.0,13.0,11.0,10.0,13.0,16.0,16.0,13.0,13.0,9.0,20.0,14.0,14.0,8.0,15.0,13.0,13.0,11.0,15.0,7.0,12.0,13.0,17.0,14.0,12.0,11.0,13.0,14.0,10.0,AndrÃÂÃÂ© Ayew,ÃÂÃÂ£9.00m ,Ligue 1,19-06-17,18.3.4.28,AndrÃÂÃÂ¼ÃÂ Ayew,8442448,21,17-Dec-89,27,75,14,12,4,6250,6900,6650,143,133,31216778,176,72,M/AM RLC,2,1,2,3,3,1,1,2,2,2,2,9,11,14,15,13,10,15,10,5,8,11,13,11,15,14,14,15,12,11,11,12,14,14,14,14,11,14,14,13,14,15,11,20,15,12,5,15,13,12,13,13,7,15,17,16,11,14,15,12,13,12,1,8,18,20,17,20,16,M/AM RLC,526,1,1,15,16,20,17,1,1,1,11,14,18,17,8,1,17179869192.0,0,0,0,1,0,0,0,0,0,0,0,0,0,0,0,0,0,0,0,0,0,0,0,0,0,0,0,0,0,0,0,0,0,0,1,0,0,0,0,0,0,0,0,0,0,0,0,0,AndrÃÂ© Ayew,ÃÂ£13.50m ,30.0,176.0,Forward - Left Winger,left,Swansea City,26.0,6.0,3.0,1453.0,36.0,6.0,5.0,2361.0,38.0,5.0,2.0,2620.0,47.0,18.0,7.0,4116.0,8.0,3.0,1.0,720.0,Premier League,nan,nan,nan,nan,nan,nan,nan,nan,nan,nan,nan,nan,nan,nan,nan,nan,nan,nan,nan,nan,nan,nan,nan,nan,nan,nan,nan,nan,nan,nan,nan,nan,nan,nan,nan,nan,nan,nan,nan,nan,nan,nan,nan,nan,nan,nan,nan,nan,nan,nan,nan,nan,nan,nan,nan,nan,nan,nan,nan,nan,nan,nan,nan,nan,nan,nan,nan,nan,nan,nan,nan,nan,nan,nan,nan,nan,nan,nan,nan,nan,nan,nan,nan,nan,nan
19/6/2011,Ander Herrera,67009261,796,8/14/1989,21,0,0,9,1,4950,7000,7000,161,139,5691700,182,72,M/AM C,2,3,2,1,1,3,3,3,2,3,3,11,10,14,8,18,9,8,10,8,6,16,11,10,17,14,13,12,13,11,18,15,16,16,12,13,8,15,13,14,18,7,10,11,12,12,20,11,8,8,12,16,6,12,8,15,14,13,15,12,13,8,1,1,20,18,10,10,20,M/AM C,411,1,1,1,18,10,10,1,1,1,9,20,10,10,1,1,17592200000000.0,0,0,0,0,1,0,0,1,0,0,0,0,0,0,0,0,0,0,0,0,1,0,0,0,0,0,0,0,0,0,0,0,0,0,0,0,0,0,0,0,0,0,0,0,1,0,0,0,Ander Herrera,ÃÂ£7.20m ,31.0,182.0,Midfielder - Central Midfield,right,Paris Saint-Germain,35.0,2.0,2.0,2663.0,54.0,4.0,11.0,3751.0,35.0,2.0,2.0,2885.0,39.0,5.0,6.0,2934.0,31.0,8.0,5.0,2134.0,41.0,5.0,6.0,2410.0,50.0,2.0,11.0,4020.0,39.0,2.0,2.0,2209.0,28.0,3.0,3.0,1887.0,LaLiga,22.0,1.0,1.0,1282.0,9.0,0.0,0.0,545.0,29/6/2010,Ander,67009261.0,796.0,8/14/1989,20.0,0.0,0.0,4.0,0.0,4624.0,6700.0,6700.0,165.0,136.0,18579153.0,182.0,72.0,M/AM C,3.0,2.0,1.0,3.0,2.0,3.0,1.0,6.0,3.0,3.0,2.0,11.0,12.0,15.0,9.0,18.0,9.0,8.0,10.0,6.0,5.0,16.0,11.0,8.0,17.0,12.0,12.0,11.0,13.0,12.0,19.0,13.0,17.0,18.0,11.0,12.0,9.0,13.0,12.0,15.0,16.0,7.0,10.0,11.0,10.0,12.0,20.0,12.0,7.0,12.0,12.0,15.0,8.0,12.0,12.0,16.0,15.0,16.0,15.0,12.0,13.0,6.0,Anderson,ÃÂÃÂ£18.90m ,Premier League,19-06-17,18.3.4.28,Ander Herrera,67009261,796,14-Aug-89,27,2,0,15,4,6500,7250,7750,156,150,90688054,182,73,DM/M C,3,2,1,1,2,1,2,1,3,1,1,7,15,10,10,15,8,5,9,3,15,15,14,14,15,17,17,14,13,14,14,13,16,14,15,12,14,16,18,14,16,12,7,10,17,13,20,18,11,16,17,17,6,13,16,16,15,13,18,8,12,8,1,1,20,14,10,10,20,DM/M C,421,1,1,1,14,10,10,1,1,1,16,20,9,9,1,1,17592200000000.0,0,0,0,0,0,0,0,0,0,0,0,0,0,0,0,0,1,1,0,0,1,0,0,0,0,0,0,0,0,0,0,0,0,0,0,0,0,0,0,0,0,0,0,0,1,0,0,0,Ander Herrera,ÃÂ£27.00m ,31.0,182.0,Midfielder - Central Midfield,right,Paris Saint-Germain,50.0,2.0,11.0,4020.0,39.0,2.0,2.0,2209.0,28.0,3.0,3.0,1887.0,22.0,1.0,1.0,1282.0,9.0,0.0,0.0,545.0,Premier League,15-07-16,17.3.2.23,Ander Herrera,67009261.0,796.0,14-Aug-89,26.0,0.0,0.0,15.0,4.0,6500.0,7250.0,7500.0,162.0,156.0,57736218.0,182.0,73.0,M/AM C,2.0,3.0,3.0,3.0,2.0,2.0,1.0,3.0,1.0,2.0,3.0,10.0,11.0,12.0,11.0,17.0,11.0,5.0,12.0,3.0,7.0,16.0,14.0,13.0,17.0,14.0,16.0,14.0,14.0,15.0,15.0,14.0,16.0,14.0,15.0,15.0,14.0,16.0,17.0,14.0,16.0,12.0,9.0,11.0,15.0,13.0,20.0,16.0,11.0,15.0,15.0,15.0,6.0,13.0,14.0,16.0,15.0,13.0,18.0,10.0,12.0,8.0,Ander Herrera,ÃÂ£27.00m ,Premier League
19/6/2011,Albin Ekdal,8120012,797,7/28/1989,21,0,0,8,2,3000,6250,6500,167,134,529935,186,75,M C,1,1,1,2,3,2,1,1,1,3,1,11,12,12,9,15,12,12,13,10,11,15,14,12,16,7,14,17,15,14,16,15,14,15,13,15,14,14,14,10,12,11,13,5,15,12,20,13,12,9,5,14,11,13,10,14,12,15,12,12,10,3,1,1,20,15,8,8,20,M C,401,1,1,1,15,8,8,1,1,1,14,20,7,5,1,1,0.0,0,0,0,0,0,0,0,0,0,0,0,0,0,0,0,0,0,0,0,0,0,0,0,0,0,0,0,0,0,0,0,0,0,0,0,0,0,0,0,0,0,0,0,0,0,0,0,0,Albin Ekdal,ÃÂ£2.70m ,31.0,186.0,Midfielder - Defensive Midfield,right,UC Sampdoria,24.0,1.0,1.0,1556.0,31.0,1.0,1.0,2080.0,34.0,1.0,1.0,2547.0,23.0,1.0,0.0,1786.0,34.0,5.0,3.0,2813.0,15.0,0.0,0.0,1194.0,23.0,1.0,1.0,1423.0,19.0,0.0,1.0,1108.0,33.0,0.0,0.0,2771.0,Serie A,33.0,0.0,4.0,2406.0,5.0,0.0,0.0,412.0,29/6/2010,Albin Ekdal,8120012.0,797.0,7/28/1989,20.0,0.0,0.0,8.0,2.0,250.0,6250.0,5850.0,158.0,123.0,3531098.0,186.0,75.0,M C,1.0,3.0,3.0,1.0,3.0,3.0,2.0,1.0,1.0,2.0,1.0,10.0,11.0,12.0,8.0,14.0,9.0,10.0,12.0,8.0,10.0,14.0,13.0,11.0,15.0,6.0,13.0,16.0,14.0,13.0,15.0,14.0,14.0,14.0,12.0,14.0,13.0,13.0,13.0,10.0,12.0,11.0,13.0,5.0,15.0,12.0,20.0,13.0,12.0,8.0,5.0,13.0,11.0,12.0,10.0,14.0,12.0,15.0,12.0,12.0,10.0,3.0,Albin Ekdal,ÃÂÃÂ£2.88m ,Serie A,19-06-17,18.3.4.28,Albin Ekdal,8120012,797,28-Jul-89,27,30,0,12,2,5650,6650,6650,139,133,12713766,186,75,DM/M C,2,3,1,3,1,2,2,1,4,3,1,9,12,12,10,14,9,10,11,8,11,13,10,13,15,12,15,14,16,16,11,13,14,9,12,13,12,18,16,10,11,15,11,12,17,12,20,15,12,16,10,16,9,16,14,16,12,13,15,13,17,3,1,1,20,14,11,10,20,DM/M C,421,1,1,1,14,10,11,1,1,1,18,20,10,11,1,1,4194304.0,0,0,0,0,0,0,0,0,0,0,0,0,0,0,0,0,0,0,0,0,0,0,1,0,0,0,0,0,0,0,0,0,0,0,0,0,0,0,0,0,0,0,0,0,0,0,0,0,Albin Ekdal,ÃÂ£2.25m ,31.0,186.0,Midfielder - Defensive Midfield,right,UC Sampdoria,23.0,1.0,1.0,1423.0,19.0,0.0,1.0,1108.0,33.0,0.0,0.0,2771.0,33.0,0.0,4.0,2406.0,5.0,0.0,0.0,412.0,Bundesliga,15-07-16,17.3.2.23,Albin Ekdal,8120012.0,797.0,28-Jul-89,26.0,25.0,0.0,12.0,2.0,6250.0,6750.0,6750.0,139.0,135.0,14883198.0,186.0,75.0,DM/M C,2.0,3.0,2.0,1.0,1.0,4.0,2.0,1.0,3.0,3.0,3.0,9.0,12.0,12.0,10.0,14.0,9.0,10.0,11.0,8.0,11.0,13.0,10.0,13.0,15.0,12.0,15.0,14.0,16.0,16.0,11.0,13.0,14.0,9.0,12.0,13.0,11.0,18.0,17.0,10.0,11.0,15.0,11.0,12.0,17.0,12.0,20.0,16.0,12.0,16.0,10.0,16.0,9.0,16.0,14.0,16.0,12.0,13.0,15.0,13.0,17.0,3.0,Albin Ekdal,ÃÂ£2.25m ,Bundesliga
19/6/2011,Abdou Sissoko,85022790,769,3/20/1990,21,0,0,3,0,2500,3750,3750,145,114,405426,180,68,DM/M LC,3,3,2,3,2,1,2,4,1,1,1,6,9,11,6,11,8,12,11,7,7,12,7,10,13,12,14,12,12,12,12,12,14,11,9,8,10,13,16,15,13,14,11,8,15,12,20,15,11,13,12,14,7,10,12,16,13,12,8,11,11,13,1,1,20,1,1,16,20,DM/M LC,424,1,1,1,1,1,1,1,1,1,18,20,16,1,1,1,0.0,0,0,0,0,0,0,0,0,0,0,0,0,0,0,0,0,0,0,0,0,0,0,0,0,0,0,0,0,0,0,0,0,0,0,0,0,0,0,0,0,0,0,0,0,0,0,0,0,Abdoul Sissoko,ÃÂ£900Th. ,30.0,183.0,Midfielder - Defensive Midfield,left,Al-Kuwait Sports Club,27.0,0.0,1.0,1899.0,12.0,1.0,0.0,645.0,39.0,0.0,0.0,3252.0,34.0,3.0,2.0,2836.0,13.0,0.0,0.0,856.0,35.0,3.0,6.0,2681.0,24.0,1.0,0.0,1722.0,38.0,2.0,0.0,3127.0,45.0,0.0,0.0,3855.0,Serie A,4.0,0.0,0.0,366.0,nan,nan,nan,nan,nan,nan,nan,nan,nan,nan,nan,nan,nan,nan,nan,nan,nan,nan,nan,nan,nan,nan,nan,nan,nan,nan,nan,nan,nan,nan,nan,nan,nan,nan,nan,nan,nan,nan,nan,nan,nan,nan,nan,nan,nan,nan,nan,nan,nan,nan,nan,nan,nan,nan,nan,nan,nan,nan,nan,nan,nan,nan,nan,nan,nan,nan,nan,nan,nan,nan,nan,nan,nan,nan,nan,nan,nan,nan,nan,nan,nan,nan,nan,nan,nan,nan,nan,nan
19/6/2011,Thierry DoubaÃÂ¯,69003609,24,7/1/1988,22,1,0,0,0,4520,5619,6027,147,124,838222,179,74,DM/M C,2,1,3,2,1,3,1,1,3,3,1,8,9,11,6,13,10,7,9,9,12,16,10,13,13,11,13,12,12,11,10,13,7,12,10,10,13,14,12,14,9,11,10,11,14,14,20,16,14,10,8,10,12,10,9,14,1,15,15,16,12,13,1,1,18,1,1,1,18,DM/M C,311,1,1,1,1,1,1,1,1,1,20,18,1,1,1,1,0.0,0,0,0,0,0,0,0,0,0,0,0,0,0,0,0,0,0,0,0,0,0,0,0,0,0,0,0,0,0,0,0,0,0,0,0,0,0,0,0,0,0,0,0,0,0,0,0,0,Thierry Doubai,ÃÂ£1.35m ,32.0,179.0,Midfielder - Defensive Midfield,right,AFAD DjÃÂ©kanou,50.0,1.0,6.0,4174.0,17.0,1.0,0.0,1051.0,14.0,2.0,1.0,1035.0,17.0,0.0,0.0,775.0,30.0,1.0,0.0,2146.0,21.0,1.0,0.0,1631.0,nan,nan,nan,nan,nan,nan,nan,nan,nan,nan,nan,nan,Serie A,nan,nan,nan,nan,nan,nan,nan,nan,nan,nan,nan,nan,nan,nan,nan,nan,nan,nan,nan,nan,nan,nan,nan,nan,nan,nan,nan,nan,nan,nan,nan,nan,nan,nan,nan,nan,nan,nan,nan,nan,nan,nan,nan,nan,nan,nan,nan,nan,nan,nan,nan,nan,nan,nan,nan,nan,nan,nan,nan,nan,nan,nan,nan,nan,nan,nan,nan,nan,nan,nan,nan,nan,nan,nan,nan,nan,nan,nan,nan,nan,nan,nan,nan,nan,nan,nan,nan,nan,nan,nan,nan,nan
19/6/2011,Sven Bender,35007386,771,4/27/1989,22,1,0,0,0,5778,7418,7400,157,145,3043723,185,72,DM/M C,1,2,3,2,1,3,2,7,3,2,1,8,9,8,6,13,9,13,9,13,18,13,9,18,12,14,18,18,14,17,7,15,15,7,13,8,16,19,16,12,13,15,12,11,11,12,20,18,12,17,8,11,13,8,12,13,15,12,18,13,16,4,1,1,18,1,1,1,18,DM/M C,311,1,1,1,1,1,1,1,1,1,20,18,1,1,1,1,137489000000.0,0,0,0,0,0,0,1,0,0,0,0,0,0,0,0,0,0,0,0,0,0,0,0,0,1,1,0,0,0,0,0,0,0,0,0,0,0,1,0,0,0,0,0,0,0,0,0,0,Sven Bender,ÃÂ£12.60m ,31.0,186.0,Defender - Centre-Back,right,Bayer 04 Leverkusen,39.0,1.0,1.0,2923.0,32.0,1.0,5.0,2105.0,33.0,1.0,0.0,2190.0,27.0,1.0,1.0,1938.0,32.0,0.0,0.0,1900.0,35.0,0.0,2.0,2259.0,8.0,0.0,1.0,404.0,34.0,2.0,0.0,2812.0,32.0,0.0,1.0,2435.0,Bundesliga,47.0,4.0,2.0,3881.0,6.0,0.0,1.0,499.0,29/6/2010,Sven Bender,35007386.0,771.0,4/27/1989,21.0,0.0,0.0,0.0,0.0,3250.0,6600.0,6600.0,158.0,129.0,4398472.0,185.0,72.0,DM/M C,2.0,3.0,1.0,2.0,2.0,1.0,1.0,1.0,3.0,2.0,1.0,8.0,8.0,9.0,7.0,12.0,9.0,12.0,10.0,13.0,15.0,12.0,10.0,16.0,12.0,10.0,17.0,15.0,13.0,15.0,8.0,14.0,14.0,7.0,13.0,9.0,16.0,17.0,13.0,12.0,13.0,13.0,12.0,10.0,11.0,12.0,20.0,15.0,11.0,14.0,8.0,11.0,13.0,10.0,14.0,13.0,14.0,12.0,15.0,13.0,14.0,8.0,Sven Bender,ÃÂÃÂ£8.10m ,Bundesliga,19-06-17,18.3.4.28,Sven Bender,35007386,771,27-Apr-89,28,7,0,0,0,5200,6950,7200,148,144,31048161,186,80,D/DM/M C,1,1,3,1,1,2,2,2,1,3,1,6,9,8,7,11,6,12,8,13,15,12,9,18,11,19,15,18,10,16,9,13,18,7,13,8,14,18,19,12,11,15,12,10,17,12,20,18,13,19,10,15,14,9,9,14,16,17,18,13,16,4,20,1,18,1,1,1,20,D/DM/M C,121,1,1,1,1,1,1,20,1,1,18,18,1,1,1,1,274895000000.0,0,0,0,0,0,0,0,0,0,0,0,0,0,0,0,0,0,0,0,0,0,0,0,0,1,0,0,0,0,0,0,0,0,0,0,0,0,0,1,0,0,0,0,0,0,0,0,0,Sven Bender,ÃÂ£13.50m ,31.0,186.0,Defender - Centre-Back,right,Bayer 04 Leverkusen,8.0,0.0,1.0,404.0,34.0,2.0,0.0,2812.0,32.0,0.0,1.0,2435.0,47.0,4.0,2.0,3881.0,7.0,0.0,1.0,589.0,Bundesliga,15-07-16,17.3.2.23,Sven Bender,35007386.0,771.0,27-Apr-89,27.0,7.0,0.0,0.0,0.0,5300.0,7050.0,7300.0,148.0,146.0,48657441.0,186.0,80.0,D/DM/M C,2.0,4.0,2.0,1.0,1.0,1.0,2.0,1.0,3.0,1.0,4.0,6.0,9.0,8.0,7.0,11.0,6.0,12.0,8.0,13.0,16.0,12.0,9.0,18.0,11.0,19.0,15.0,18.0,10.0,16.0,9.0,13.0,18.0,7.0,13.0,8.0,14.0,18.0,19.0,12.0,11.0,15.0,12.0,10.0,17.0,12.0,20.0,18.0,13.0,19.0,10.0,15.0,13.0,9.0,9.0,14.0,16.0,17.0,18.0,13.0,16.0,4.0,Sven Bender,ÃÂ£6.30m ,Bundesliga
19/6/2011,Steven N'Zonzi,34011354,769,12/15/1988,22,0,0,6,0,5500,5950,6750,155,132,1449678,190,75,DM/M C,1,2,1,3,1,2,1,3,1,1,2,4,7,8,6,15,10,10,8,6,14,14,8,12,15,14,15,15,18,12,13,11,12,14,11,10,16,10,10,15,10,14,17,10,18,13,20,16,16,13,10,15,4,10,16,16,8,18,8,12,8,12,1,1,17,8,1,1,17,DM/M C,311,1,1,1,8,1,1,1,1,1,20,17,1,1,1,1,274878000000.0,0,0,0,0,0,0,1,0,0,0,0,0,0,0,0,0,0,0,0,1,0,0,0,0,0,0,0,0,0,0,0,0,0,0,0,0,0,0,1,0,0,0,0,0,0,0,0,0,Steven Nzonzi,ÃÂ£4.05m ,31.0,196.0,Midfielder - Defensive Midfield,right,Stade Rennais FC,26.0,1.0,0.0,1658.0,34.0,2.0,5.0,2972.0,38.0,1.0,1.0,3409.0,40.0,2.0,2.0,3356.0,42.0,4.0,1.0,3690.0,46.0,4.0,2.0,3228.0,46.0,3.0,3.0,4086.0,44.0,1.0,2.0,3693.0,39.0,1.0,2.0,3275.0,Premier League,22.0,0.0,1.0,1849.0,8.0,1.0,0.0,720.0,29/6/2010,Steven N'Zonzi,34011354.0,769.0,12/15/1988,21.0,0.0,0.0,6.0,0.0,4250.0,6074.0,6550.0,160.0,135.0,999999.0,194.0,75.0,DM/M C,1.0,1.0,3.0,2.0,1.0,2.0,3.0,7.0,1.0,1.0,1.0,5.0,7.0,10.0,8.0,13.0,11.0,16.0,12.0,6.0,13.0,12.0,8.0,13.0,13.0,16.0,14.0,15.0,12.0,11.0,11.0,9.0,15.0,11.0,11.0,10.0,15.0,17.0,16.0,14.0,10.0,17.0,18.0,10.0,18.0,14.0,20.0,16.0,17.0,18.0,15.0,15.0,4.0,10.0,20.0,14.0,12.0,18.0,15.0,13.0,18.0,6.0,Steven Nzonzi,ÃÂÃÂ£3.60m ,Premier League,19-06-17,18.3.4.28,Steven N'Zonzi,34011354,769,15-Dec-88,28,0,0,6,0,6750,7300,7500,155,153,34928206,190,75,DM/M C,3,4,1,2,3,3,3,2,3,1,2,4,7,9,7,15,10,15,11,9,13,16,8,13,15,14,15,15,17,14,15,15,13,15,11,12,16,13,13,14,11,15,17,12,18,13,20,16,16,17,10,15,4,13,16,16,10,18,12,12,6,16,1,1,19,1,1,1,19,DM/M C,311,1,1,1,1,1,1,1,1,1,20,19,1,1,1,1,275952000000.0,0,0,0,0,0,0,1,0,0,0,0,0,0,0,0,0,0,0,0,1,0,0,0,0,0,0,0,0,0,0,1,0,0,0,0,0,0,0,1,0,0,0,0,0,0,0,0,0,Steven Nzonzi,ÃÂ£27.00m ,31.0,196.0,Midfielder - Defensive Midfield,right,Stade Rennais FC,46.0,3.0,3.0,4086.0,44.0,1.0,2.0,3693.0,39.0,1.0,2.0,3275.0,22.0,0.0,1.0,1849.0,8.0,1.0,0.0,720.0,LaLiga,15-07-16,17.3.2.23,Steven N'Zonzi,34011354.0,769.0,15-Dec-88,27.0,0.0,0.0,6.0,0.0,6750.0,7300.0,7500.0,155.0,153.0,34810851.0,190.0,75.0,DM/M C,3.0,3.0,1.0,4.0,3.0,3.0,2.0,3.0,2.0,1.0,2.0,4.0,7.0,9.0,7.0,15.0,10.0,15.0,11.0,9.0,14.0,16.0,8.0,13.0,15.0,14.0,15.0,15.0,17.0,14.0,15.0,15.0,13.0,15.0,11.0,12.0,16.0,13.0,13.0,15.0,11.0,15.0,17.0,12.0,18.0,13.0,20.0,16.0,17.0,17.0,10.0,15.0,4.0,13.0,16.0,16.0,10.0,18.0,12.0,12.0,6.0,16.0,Steven Nzonzi,ÃÂ£27.00m ,LaLiga
19/6/2011,Souza,19060675,1651,2/11/1989,22,0,0,5,0,3250,6400,6650,150,133,1169499,186,77,M C,3,2,1,2,3,2,2,3,2,2,1,12,12,14,11,14,10,8,13,6,11,13,12,11,14,11,13,11,13,13,11,13,13,14,11,13,12,10,12,11,13,14,13,13,13,11,20,13,13,12,8,12,7,12,12,13,10,12,12,5,12,11,1,1,20,10,1,1,20,M C,401,1,1,1,10,1,1,1,1,1,15,20,1,1,1,1,0.0,0,0,0,0,0,0,0,0,0,0,0,0,0,0,0,0,0,0,0,0,0,0,0,0,0,0,0,0,0,0,0,0,0,0,0,0,0,0,0,0,0,0,0,0,0,0,0,0,nan,nan,nan,nan,nan,nan,nan,nan,nan,nan,nan,nan,nan,nan,nan,nan,nan,nan,nan,nan,nan,nan,nan,nan,nan,nan,nan,nan,nan,nan,nan,nan,nan,nan,nan,nan,nan,nan,nan,nan,nan,nan,nan,nan,nan,nan,nan,nan,nan,nan,nan,nan,29/6/2010,Souza,19060675.0,1651.0,2/11/1989,21.0,0.0,0.0,5.0,0.0,3250.0,6400.0,6400.0,156.0,129.0,20413701.0,186.0,77.0,M C,2.0,1.0,2.0,3.0,3.0,3.0,2.0,3.0,1.0,2.0,1.0,12.0,12.0,14.0,11.0,14.0,10.0,8.0,13.0,6.0,11.0,13.0,12.0,11.0,14.0,11.0,13.0,11.0,13.0,13.0,11.0,13.0,13.0,14.0,11.0,13.0,12.0,10.0,12.0,11.0,13.0,14.0,13.0,13.0,13.0,11.0,20.0,13.0,13.0,12.0,8.0,12.0,7.0,12.0,12.0,13.0,10.0,12.0,12.0,5.0,12.0,11.0,nan,nan,nan
19/6/2011,Sergio Busquets,1510566,796,7/16/1988,22,30,0,3,1,7500,8500,8500,172,167,7375960,189,73,DM/M C,2,3,2,2,2,2,1,4,1,3,3,9,12,13,9,17,9,13,11,8,16,15,10,14,13,14,18,13,18,14,14,17,12,8,9,12,19,18,17,13,13,15,14,10,14,14,20,17,13,13,16,15,8,13,11,13,13,14,13,6,7,8,13,1,18,10,1,1,18,DM/M C,311,1,1,1,10,1,1,13,1,1,20,18,1,1,1,1,196672.0,0,0,0,0,0,0,1,0,0,0,0,0,0,0,0,0,1,1,0,0,0,0,0,0,0,0,0,0,0,0,0,0,0,0,0,0,0,0,0,0,0,0,0,0,0,0,0,0,Sergio Busquets,ÃÂ£31.50m ,32.0,189.0,Midfielder - Defensive Midfield,right,FC Barcelona,46.0,1.0,6.0,3814.0,52.0,2.0,3.0,4067.0,45.0,1.0,2.0,3453.0,48.0,3.0,2.0,4074.0,47.0,1.0,3.0,3592.0,53.0,0.0,6.0,4422.0,48.0,0.0,3.0,3928.0,50.0,1.0,4.0,4164.0,54.0,0.0,2.0,4333.0,LaLiga,43.0,2.0,2.0,3265.0,6.0,0.0,0.0,444.0,29/6/2010,Sergio Busquets,1510566.0,796.0,7/16/1988,21.0,20.0,0.0,3.0,1.0,6806.0,8500.0,8500.0,169.0,165.0,42473514.0,189.0,73.0,DM/M C,1.0,3.0,2.0,3.0,3.0,1.0,1.0,1.0,1.0,3.0,1.0,9.0,12.0,13.0,9.0,17.0,9.0,13.0,13.0,8.0,14.0,17.0,10.0,14.0,13.0,14.0,17.0,16.0,15.0,14.0,16.0,16.0,11.0,8.0,9.0,12.0,19.0,17.0,16.0,13.0,13.0,15.0,14.0,9.0,13.0,14.0,20.0,16.0,12.0,15.0,7.0,13.0,8.0,14.0,9.0,6.0,12.0,7.0,9.0,6.0,12.0,9.0,Sergio Busquets,ÃÂÃÂ£27.00m ,LaLiga,19-06-17,18.3.4.28,Sergio Busquets,1510566,796,16-Jul-88,28,87,2,3,1,8250,8450,8450,171,167,229627891,189,76,DM/M C,4,1,3,3,2,2,2,2,1,1,2,8,11,12,9,16,8,13,10,8,15,17,11,15,15,12,19,13,18,18,16,18,16,9,10,11,17,19,16,10,12,9,14,12,13,12,20,16,13,18,13,16,7,13,8,14,14,14,14,6,8,7,10,1,17,1,1,1,17,DM/M C,311,1,10,1,1,1,1,10,1,1,20,17,1,1,1,1,4503610000000000.0,0,0,0,0,0,0,1,0,0,0,0,0,0,0,0,0,1,0,0,0,0,0,0,0,0,0,0,0,0,0,0,0,0,1,0,0,0,0,0,0,0,0,0,0,0,0,0,0,Sergio Busquets,ÃÂ£72.00m ,32.0,189.0,Midfielder - Defensive Midfield,right,FC Barcelona,48.0,0.0,3.0,3928.0,50.0,1.0,4.0,4164.0,54.0,0.0,2.0,4333.0,43.0,2.0,2.0,3265.0,6.0,0.0,0.0,444.0,LaLiga,15-07-16,17.3.2.23,Sergio Busquets,1510566.0,796.0,16-Jul-88,27.0,87.0,2.0,3.0,1.0,8250.0,8500.0,8500.0,171.0,170.0,128582931.0,189.0,76.0,DM/M C,1.0,2.0,1.0,2.0,1.0,1.0,1.0,1.0,2.0,4.0,1.0,8.0,11.0,13.0,9.0,16.0,8.0,13.0,10.0,8.0,16.0,17.0,11.0,15.0,15.0,12.0,19.0,13.0,17.0,17.0,16.0,18.0,16.0,9.0,10.0,11.0,19.0,19.0,15.0,10.0,13.0,9.0,14.0,12.0,13.0,12.0,20.0,16.0,13.0,18.0,13.0,16.0,7.0,13.0,12.0,14.0,14.0,14.0,14.0,6.0,8.0,7.0,Sergio Busquets,ÃÂ£54.00m ,LaLiga
19/6/2011,Sebastian Eriksson,8109541,797,1/31/1989,22,5,0,16,0,2280,5500,5500,137,110,72802,185,74,M C,2,2,2,2,2,3,2,1,3,3,2,11,9,9,9,10,8,10,8,5,12,11,5,15,11,16,10,16,11,11,12,11,13,8,14,9,15,15,16,14,11,11,11,20,10,12,7,15,15,12,9,13,7,12,12,11,17,11,16,12,16,3,7,5,20,15,1,14,20,M C,401,1,1,1,15,1,1,1,7,1,14,20,14,1,5,1,131200.0,0,0,0,0,0,0,0,1,0,0,0,0,0,0,0,0,0,1,0,0,0,0,0,0,0,0,0,0,0,0,0,0,0,0,0,0,0,0,0,0,0,0,0,0,0,0,0,0,Sebastian Eriksson,ÃÂ£1.08m ,31.0,184.0,Midfielder - Defensive Midfield,left,IFK GÃÂ¶teborg,16.0,3.0,1.0,1108.0,1.0,0.0,0.0,1.0,15.0,1.0,0.0,773.0,25.0,1.0,0.0,1509.0,27.0,2.0,2.0,1801.0,35.0,0.0,4.0,2887.0,39.0,3.0,3.0,3177.0,15.0,0.0,0.0,1331.0,22.0,3.0,0.0,1858.0,Serie A,1.0,0.0,0.0,10.0,nan,nan,nan,nan,nan,nan,nan,nan,nan,nan,nan,nan,nan,nan,nan,nan,nan,nan,nan,nan,nan,nan,nan,nan,nan,nan,nan,nan,nan,nan,nan,nan,nan,nan,nan,nan,nan,nan,nan,nan,nan,nan,nan,nan,nan,nan,nan,nan,nan,nan,nan,nan,nan,nan,nan,nan,nan,nan,nan,nan,nan,nan,nan,nan,nan,nan,nan,nan,nan,nan,nan,nan,nan,nan,nan,nan,nan,nan,nan,nan,nan,nan,nan,nan,nan,nan,nan,nan
19/6/2011,Sandro,19042321,1651,3/15/1989,22,7,0,13,2,6000,7800,7400,173,146,2755070,187,82,DM/M C,2,2,2,2,3,2,2,7,1,3,3,9,10,11,10,12,8,14,8,7,15,12,6,15,13,14,16,17,14,14,11,15,15,12,13,12,16,17,17,14,16,16,14,8,15,14,20,15,15,15,11,13,3,12,14,13,13,15,11,10,13,6,1,1,20,1,14,1,20,DM/M C,311,1,1,1,1,1,1,1,1,1,20,20,1,14,1,1,0.0,0,0,0,0,0,0,0,0,0,0,0,0,0,0,0,0,0,0,0,0,0,0,0,0,0,0,0,0,0,0,0,0,0,0,0,0,0,0,0,0,0,0,0,0,0,0,0,0,Sandro,ÃÂ£10.35m ,31.0,187.0,Midfielder - Defensive Midfield,right,GoiÃÂ¡s Esporte Clube,26.0,1.0,1.0,1566.0,27.0,0.0,1.0,1649.0,27.0,1.0,2.0,2141.0,27.0,1.0,0.0,1629.0,18.0,1.0,0.0,1298.0,24.0,0.0,0.0,1190.0,20.0,3.0,0.0,1227.0,18.0,1.0,0.0,1328.0,26.0,0.0,1.0,1316.0,Premier League,8.0,0.0,0.0,590.0,nan,nan,nan,nan,nan,nan,nan,nan,nan,nan,nan,nan,nan,nan,nan,nan,nan,nan,nan,nan,nan,nan,nan,nan,nan,nan,nan,nan,nan,nan,nan,nan,nan,nan,nan,nan,nan,nan,nan,nan,nan,nan,nan,nan,nan,nan,nan,nan,nan,nan,nan,nan,nan,nan,nan,nan,nan,nan,nan,nan,nan,nan,nan,nan,nan,nan,nan,nan,nan,nan,nan,nan,nan,nan,nan,nan,nan,nan,nan,nan,nan,nan,nan,nan,nan,nan,nan,nan,19-06-17,18.3.4.28,Sandro,19042321,1651,15-Mar-89,28,17,1,13,2,4500,6100,6200,145,120,1789332,187,83,DM/M C,2,2,4,3,2,3,4,1,3,1,3,9,10,10,9,13,8,14,10,7,14,12,6,15,12,16,15,18,13,15,9,14,14,10,14,10,12,13,12,8,12,15,12,8,5,9,20,11,17,12,16,12,19,12,15,13,13,13,12,10,13,6,8,1,20,1,1,1,20,DM/M C,311,1,1,1,1,1,1,8,1,1,20,20,1,1,1,1,137439000000.0,0,0,0,0,0,0,1,0,0,0,0,0,0,0,0,0,0,0,0,0,0,0,0,0,0,0,0,0,0,0,0,0,0,0,0,0,0,1,0,0,0,0,0,0,0,0,0,0,Sandro,ÃÂ£2.25m ,31.0,187.0,Midfielder - Defensive Midfield,right,GoiÃÂ¡s Esporte Clube,20.0,3.0,0.0,1227.0,18.0,1.0,0.0,1328.0,26.0,0.0,1.0,1316.0,8.0,0.0,0.0,590.0,nan,nan,nan,nan,Serie A,15-07-16,17.3.2.23,Sandro,67149094.0,796.0,09-Jul-95,21.0,0.0,0.0,3.0,0.0,4700.0,7200.0,7200.0,158.0,144.0,25254750.0,175.0,72.0,AM/S RL,3.0,1.0,2.0,3.0,1.0,3.0,1.0,2.0,2.0,1.0,3.0,14.0,13.0,15.0,16.0,16.0,16.0,13.0,15.0,5.0,4.0,10.0,14.0,6.0,16.0,12.0,15.0,15.0,9.0,12.0,11.0,11.0,15.0,12.0,10.0,15.0,7.0,12.0,13.0,15.0,17.0,13.0,9.0,10.0,14.0,15.0,20.0,13.0,13.0,16.0,7.0,12.0,9.0,9.0,14.0,11.0,8.0,11.0,12.0,8.0,15.0,11.0,Evandro,ÃÂ£1.80m ,Premier League
19/6/2011,RubÃÂ©n PÃÂ©rez,67037324,796,4/26/1989,22,0,0,0,0,4550,6550,6550,164,132,238098,178,72,DM/M C,2,3,2,3,1,2,3,5,2,2,2,11,12,13,11,14,13,7,12,11,12,14,11,12,14,14,11,14,14,14,13,14,15,13,13,15,12,15,14,13,11,11,8,10,12,13,20,14,12,15,12,8,7,13,13,14,13,14,15,11,13,7,1,1,20,13,1,1,20,DM/M C,421,1,1,1,13,1,1,1,1,1,16,20,1,1,1,1,256.0,0,0,0,0,0,0,0,0,1,0,0,0,0,0,0,0,0,0,0,0,0,0,0,0,0,0,0,0,0,0,0,0,0,0,0,0,0,0,0,0,0,0,0,0,0,0,0,0,RubÃÂ©n PÃÂ©rez,ÃÂ£2.52m ,31.0,178.0,Midfielder - Defensive Midfield,right,CD LeganÃÂ©s,37.0,0.0,2.0,3168.0,10.0,0.0,0.0,722.0,30.0,1.0,0.0,2058.0,32.0,0.0,0.0,2721.0,22.0,0.0,0.0,1300.0,32.0,0.0,2.0,2509.0,32.0,0.0,1.0,2495.0,36.0,0.0,0.0,2895.0,32.0,0.0,0.0,2561.0,LaLiga,28.0,1.0,1.0,2376.0,8.0,0.0,0.0,720.0,29/6/2010,RubÃÂ©n PÃÂ©rez,67037324.0,796.0,4/26/1989,21.0,0.0,0.0,0.0,0.0,1980.0,4200.0,4200.0,144.0,89.0,1378297.0,178.0,72.0,DM/M C,1.0,2.0,1.0,2.0,1.0,2.0,2.0,3.0,1.0,1.0,3.0,9.0,7.0,9.0,6.0,9.0,4.0,9.0,11.0,5.0,8.0,11.0,9.0,11.0,13.0,15.0,13.0,14.0,11.0,10.0,9.0,10.0,10.0,7.0,4.0,6.0,13.0,13.0,12.0,13.0,10.0,10.0,11.0,5.0,12.0,13.0,20.0,7.0,13.0,15.0,10.0,6.0,8.0,13.0,12.0,16.0,12.0,5.0,13.0,5.0,8.0,12.0,RubÃÂÃÂ©n PÃÂÃÂ©rez,ÃÂÃÂ£2.25m ,LaLiga,19-06-17,18.3.4.28,RubÃÂ©n PÃÂ©rez,67037324,796,26-Apr-89,28,0,0,5,0,4500,6500,6650,141,134,9089223,178,76,DM/M C,3,1,3,2,3,3,3,1,3,1,1,9,12,12,8,15,8,8,11,6,11,14,10,12,13,14,14,13,14,17,12,14,15,13,13,11,14,14,13,13,13,13,11,9,12,12,20,16,14,16,12,13,7,13,13,14,13,14,15,11,13,7,1,1,20,9,1,1,20,DM/M C,421,1,1,1,9,1,1,1,1,1,17,20,1,1,1,1,8796100000000.0,0,0,0,0,0,0,0,0,1,0,0,0,0,0,0,0,0,0,0,0,0,0,1,0,0,0,0,0,0,0,0,0,0,0,0,0,0,0,0,0,0,0,0,1,0,0,0,0,RubÃÂ©n PÃÂ©rez,ÃÂ£6.75m ,31.0,178.0,Midfielder - Defensive Midfield,right,CD LeganÃÂ©s,32.0,0.0,1.0,2495.0,36.0,0.0,0.0,2895.0,32.0,0.0,0.0,2561.0,28.0,1.0,1.0,2376.0,8.0,0.0,0.0,720.0,LaLiga,15-07-16,17.3.2.23,RubÃÂ©n PÃÂ©rez,67037324.0,796.0,26-Apr-89,27.0,0.0,0.0,5.0,0.0,4500.0,6500.0,6650.0,141.0,134.0,3495855.0,178.0,76.0,DM/M C,4.0,3.0,3.0,3.0,1.0,2.0,2.0,1.0,2.0,3.0,2.0,9.0,12.0,12.0,8.0,15.0,8.0,8.0,11.0,6.0,11.0,14.0,10.0,12.0,13.0,14.0,14.0,13.0,14.0,17.0,12.0,14.0,15.0,13.0,13.0,11.0,14.0,14.0,13.0,13.0,13.0,13.0,11.0,9.0,12.0,12.0,20.0,16.0,14.0,16.0,12.0,13.0,7.0,13.0,13.0,14.0,13.0,14.0,15.0,11.0,13.0,7.0,RubÃÂ©n PÃÂ©rez,ÃÂ£2.25m ,LaLiga
19/6/2011,Richard,19074791,1651,3/20/1989,22,0,0,0,0,896,4769,4476,118,106,7361,177,68,AM C,1,1,2,3,1,2,2,1,2,2,1,12,13,12,13,13,11,7,14,6,8,11,12,11,12,12,13,14,12,11,11,11,13,13,10,14,10,10,13,12,13,11,10,20,12,13,5,11,12,11,8,12,10,12,13,14,12,13,13,11,11,8,10,12,15,20,1,14,20,AM C,501,1,1,5,20,10,1,1,10,1,10,15,14,1,12,1,2251800000000000.0,0,0,0,0,0,0,0,0,0,0,0,0,0,0,0,0,0,0,0,0,0,0,0,0,0,0,0,0,0,0,0,0,0,0,0,0,0,0,0,0,0,0,0,0,0,0,0,0,Richard,ÃÂ£900Th. ,31.0,177.0,Midfielder - Central Midfield,left,Without Club,37.0,6.0,0.0,2392.0,37.0,0.0,2.0,2842.0,30.0,13.0,0.0,2558.0,35.0,8.0,2.0,2941.0,44.0,3.0,1.0,3438.0,43.0,13.0,0.0,3325.0,31.0,7.0,1.0,2692.0,41.0,7.0,5.0,3054.0,27.0,5.0,2.0,1950.0,Liga NOS,36.0,3.0,0.0,2907.0,nan,nan,nan,nan,nan,nan,nan,nan,nan,nan,nan,nan,nan,nan,nan,nan,nan,nan,nan,nan,nan,nan,nan,nan,nan,nan,nan,nan,nan,nan,nan,nan,nan,nan,nan,nan,nan,nan,nan,nan,nan,nan,nan,nan,nan,nan,nan,nan,nan,nan,nan,nan,nan,nan,nan,nan,nan,nan,nan,nan,nan,nan,nan,nan,nan,nan,nan,nan,nan,nan,nan,nan,nan,nan,nan,nan,nan,nan,nan,nan,nan,nan,nan,nan,nan,nan,nan,nan
19/6/2011,Rene Mihelic,64000038,795,7/5/1988,22,3,0,23,8,3900,6000,6000,138,115,466135,177,70,M/AM LC,3,1,2,3,1,1,2,1,2,2,3,13,13,11,10,12,14,10,12,8,12,15,13,6,14,17,12,11,12,13,11,12,16,12,13,12,2,14,16,15,12,13,11,20,12,14,5,12,11,12,8,16,9,13,14,14,18,13,16,15,15,9,1,1,20,20,1,20,20,M/AM LC,414,1,1,7,20,20,1,1,1,1,1,20,17,1,1,1,0.0,0,0,0,0,0,0,0,0,0,0,0,0,0,0,0,0,0,0,0,0,0,0,0,0,0,0,0,0,0,0,0,0,0,0,0,0,0,0,0,0,0,0,0,0,0,0,0,0,Rene Mihelic,ÃÂ£720Th. ,32.0,177.0,Midfielder - Attacking Midfield,right,NK Maribor,18.0,1.0,3.0,995.0,25.0,0.0,5.0,1605.0,19.0,1.0,0.0,1052.0,22.0,4.0,5.0,1447.0,19.0,2.0,5.0,1040.0,36.0,4.0,5.0,2571.0,28.0,5.0,2.0,1990.0,14.0,2.0,4.0,673.0,27.0,1.0,3.0,2019.0,Liga NOS,3.0,0.0,1.0,73.0,0.0,0.0,0.0,0.0,29/6/2010,Rene Mihelic,64000038.0,795.0,7/5/1988,21.0,3.0,0.0,21.0,7.0,3364.0,5800.0,5800.0,140.0,116.0,800000.0,177.0,70.0,M/AM LC,1.0,1.0,3.0,3.0,2.0,2.0,1.0,1.0,3.0,1.0,1.0,13.0,13.0,11.0,10.0,12.0,14.0,10.0,12.0,8.0,12.0,15.0,13.0,6.0,14.0,17.0,12.0,11.0,12.0,13.0,11.0,12.0,16.0,12.0,13.0,12.0,2.0,14.0,16.0,15.0,12.0,13.0,11.0,20.0,12.0,14.0,5.0,12.0,11.0,12.0,8.0,16.0,9.0,13.0,14.0,14.0,18.0,13.0,16.0,15.0,15.0,9.0,Rene Mihelic,ÃÂÃÂ£720Th. ,Liga NOS
19/6/2011,RaÃÂºl Baena,1510564,796,3/2/1989,22,0,0,0,0,4400,6900,6900,145,140,822582,180,73,DM/M/AM C,3,1,2,3,2,3,1,7,1,1,3,9,9,11,8,14,10,10,12,6,12,14,11,13,13,9,13,14,14,15,12,14,11,10,11,12,14,15,16,14,13,12,10,12,11,13,20,14,12,13,7,10,12,12,12,7,5,12,9,5,8,18,1,1,19,16,1,1,19,DM/M/AM C,321,1,1,1,16,1,1,1,1,1,20,19,1,1,1,1,0.0,0,0,0,0,0,0,0,0,0,0,0,0,0,0,0,0,0,0,0,0,0,0,0,0,0,0,0,0,0,0,0,0,0,0,0,0,0,0,0,0,0,0,0,0,0,0,0,0,RaÃÂºl Baena,ÃÂ£2.16m ,31.0,181.0,Midfielder - Defensive Midfield,right,Without Club,18.0,0.0,0.0,1373.0,35.0,1.0,2.0,2325.0,20.0,1.0,1.0,1090.0,23.0,0.0,0.0,1475.0,30.0,2.0,0.0,2525.0,26.0,1.0,1.0,2023.0,19.0,1.0,0.0,1139.0,23.0,0.0,1.0,1284.0,24.0,1.0,1.0,1627.0,LaLiga,19.0,0.0,0.0,1100.0,nan,nan,nan,nan,29/6/2010,JosÃÂÃÂ© RaÃÂÃÂºl Baena,1510564.0,796.0,3/2/1989,21.0,0.0,0.0,0.0,0.0,3000.0,5759.0,5750.0,145.0,128.0,5944491.0,180.0,73.0,DM/M/AM C,2.0,3.0,1.0,1.0,2.0,3.0,2.0,6.0,1.0,3.0,1.0,8.0,9.0,9.0,7.0,14.0,10.0,9.0,11.0,6.0,8.0,14.0,11.0,8.0,14.0,9.0,13.0,11.0,12.0,14.0,13.0,13.0,10.0,11.0,9.0,12.0,14.0,15.0,14.0,14.0,13.0,12.0,10.0,11.0,12.0,13.0,20.0,14.0,11.0,14.0,7.0,7.0,7.0,12.0,10.0,2.0,6.0,6.0,8.0,12.0,10.0,8.0,RaÃÂÃÂºl Baena,ÃÂÃÂ£1.80m ,LaLiga
19/6/2011,Radosav Petrovic,5765125,802,3/8/1989,22,18,1,3,0,4900,7000,6250,154,132,886215,193,83,DM/M C,3,2,2,2,3,1,1,5,3,3,2,10,10,12,12,12,12,13,16,10,12,16,17,15,12,12,10,14,12,14,14,10,14,10,15,10,13,12,15,10,13,11,16,10,14,11,20,13,13,12,9,11,7,9,11,13,18,11,10,13,12,7,1,1,16,1,1,1,16,DM/M C,311,1,1,1,1,1,1,1,1,1,20,16,1,1,1,1,17867100000000.0,0,0,0,0,0,0,0,0,1,1,0,0,0,0,0,0,0,0,0,0,0,0,0,0,0,0,0,0,0,0,0,0,0,0,0,0,0,0,1,0,0,0,0,0,1,0,0,0,Radosav Petrovic,ÃÂ£1.80m ,31.0,193.0,Midfielder - Defensive Midfield,right,UD AlmerÃÂ­a,41.0,9.0,7.0,2787.0,24.0,0.0,0.0,1439.0,29.0,3.0,3.0,2146.0,22.0,2.0,3.0,1478.0,33.0,5.0,0.0,2451.0,12.0,1.0,0.0,1013.0,16.0,0.0,0.0,1308.0,13.0,0.0,0.0,728.0,23.0,0.0,0.0,998.0,Premier League,28.0,1.0,0.0,1820.0,4.0,0.0,0.0,133.0,nan,nan,nan,nan,nan,nan,nan,nan,nan,nan,nan,nan,nan,nan,nan,nan,nan,nan,nan,nan,nan,nan,nan,nan,nan,nan,nan,nan,nan,nan,nan,nan,nan,nan,nan,nan,nan,nan,nan,nan,nan,nan,nan,nan,nan,nan,nan,nan,nan,nan,nan,nan,nan,nan,nan,nan,nan,nan,nan,nan,nan,nan,nan,nan,nan,nan,nan,nan,nan,nan,nan,nan,nan,nan,nan,nan,nan,nan,nan,nan,nan,nan,nan,nan,19-06-17,18.3.4.28,Radosav Petrovic,5765125,802,08-Mar-89,28,43,2,3,0,5000,6400,6650,134,133,3379825,193,86,DM/M C,2,3,1,1,2,3,1,1,3,3,1,10,8,10,10,13,13,14,13,10,12,14,12,14,12,13,11,12,13,14,12,13,14,10,11,10,14,14,13,11,13,13,16,12,14,11,20,14,15,12,15,11,7,9,12,13,18,10,10,13,12,7,1,1,16,1,1,1,16,DM/M C,311,1,1,1,1,1,1,1,1,1,20,16,1,1,1,1,17867100000000.0,0,0,0,0,0,0,1,0,1,1,0,0,0,0,0,0,0,0,0,0,0,0,0,0,0,0,0,0,0,0,0,0,0,0,0,0,0,0,1,0,0,0,0,0,1,0,0,0,Radosav Petrovic,ÃÂ£900Th. ,31.0,193.0,Midfielder - Defensive Midfield,right,UD AlmerÃÂ­a,16.0,0.0,0.0,1308.0,13.0,0.0,0.0,728.0,23.0,0.0,0.0,998.0,28.0,1.0,0.0,1820.0,4.0,0.0,0.0,133.0,Liga NOS,15-07-16,17.3.2.23,Radosav Petrovic,5765125.0,802.0,08-Mar-89,27.0,43.0,2.0,3.0,0.0,5000.0,6600.0,6600.0,134.0,132.0,1847566.0,193.0,86.0,DM/M C,3.0,2.0,2.0,4.0,1.0,3.0,3.0,3.0,2.0,4.0,3.0,10.0,8.0,10.0,10.0,13.0,13.0,14.0,13.0,10.0,12.0,14.0,12.0,14.0,12.0,13.0,11.0,12.0,13.0,14.0,12.0,13.0,14.0,10.0,11.0,10.0,14.0,14.0,12.0,11.0,13.0,13.0,16.0,12.0,14.0,11.0,20.0,14.0,15.0,12.0,15.0,11.0,7.0,9.0,4.0,13.0,18.0,10.0,10.0,13.0,12.0,7.0,Radosav Petrovic,ÃÂ£1.35m ,Liga NOS
19/6/2011,Philipp Bargfrede,92012217,771,3/3/1989,22,0,0,4,1,4500,6600,6600,155,129,805283,174,71,DM/M RC,2,3,3,2,2,3,1,5,1,1,2,11,13,12,7,11,8,10,9,11,14,9,11,14,13,14,17,14,12,15,8,8,13,7,11,8,16,18,17,15,15,14,8,12,12,12,20,16,10,13,7,9,11,15,8,10,12,8,14,12,13,7,1,1,20,10,15,8,20,DM/M RC,423,1,1,1,10,5,5,1,1,1,18,20,8,15,1,1,0.0,0,0,0,0,0,0,0,0,0,0,0,0,0,0,0,0,0,0,0,0,0,0,0,0,0,0,0,0,0,0,0,0,0,0,0,0,0,0,0,0,0,0,0,0,0,0,0,0,Philipp Bargfrede,ÃÂ£3.15m ,31.0,174.0,Midfielder - Defensive Midfield,right,SV Werder Bremen II,38.0,0.0,2.0,2676.0,24.0,0.0,1.0,1944.0,14.0,0.0,1.0,644.0,20.0,3.0,0.0,1579.0,16.0,1.0,0.0,1253.0,17.0,0.0,1.0,1455.0,11.0,1.0,1.0,449.0,30.0,2.0,1.0,2048.0,17.0,1.0,0.0,1238.0,Bundesliga,17.0,0.0,1.0,716.0,nan,nan,nan,nan,29/6/2010,Philipp Bargfrede,92012217.0,771.0,3/3/1989,21.0,0.0,0.0,0.0,0.0,1750.0,6950.0,6950.0,155.0,129.0,5826824.0,174.0,71.0,DM/M RC,1.0,2.0,3.0,2.0,1.0,1.0,3.0,1.0,3.0,2.0,3.0,11.0,13.0,12.0,7.0,11.0,8.0,10.0,9.0,11.0,14.0,9.0,11.0,14.0,13.0,14.0,17.0,14.0,12.0,15.0,8.0,8.0,13.0,7.0,11.0,8.0,16.0,18.0,17.0,15.0,15.0,14.0,8.0,12.0,12.0,12.0,20.0,16.0,10.0,13.0,7.0,9.0,11.0,15.0,8.0,10.0,12.0,8.0,14.0,12.0,13.0,7.0,Philipp Bargfrede,ÃÂÃÂ£3.60m ,Bundesliga,19-06-17,18.3.4.28,Philipp Bargfrede,92012217,771,03-Mar-89,28,0,0,4,1,4000,6500,6500,131,130,6605803,174,71,DM/M C,1,1,1,3,3,2,2,3,1,1,4,9,11,10,7,12,8,10,10,10,14,13,9,15,12,17,13,16,12,14,9,12,15,7,11,8,14,16,17,14,13,14,9,12,12,12,20,15,10,17,10,15,19,13,6,10,17,12,17,14,14,5,1,1,20,12,12,8,20,DM/M C,311,1,1,1,10,8,12,1,1,1,20,20,8,12,1,1,16777216.0,0,0,0,0,0,0,0,0,0,0,0,0,0,0,0,0,0,0,0,0,0,0,0,0,1,0,0,0,0,0,0,0,0,0,0,0,0,0,0,0,0,0,0,0,0,0,0,0,Philipp Bargfrede,ÃÂ£1.80m ,31.0,174.0,Midfielder - Defensive Midfield,right,SV Werder Bremen II,11.0,1.0,1.0,449.0,30.0,2.0,1.0,2048.0,17.0,1.0,0.0,1238.0,17.0,0.0,1.0,716.0,nan,nan,nan,nan,Bundesliga,15-07-16,17.3.2.23,Philipp Bargfrede,92012217.0,771.0,03-Mar-89,27.0,0.0,0.0,4.0,1.0,4500.0,6500.0,6500.0,131.0,130.0,6160426.0,174.0,71.0,DM/M C,1.0,1.0,1.0,2.0,1.0,2.0,1.0,2.0,3.0,1.0,3.0,9.0,11.0,10.0,7.0,12.0,8.0,10.0,10.0,10.0,14.0,13.0,9.0,15.0,12.0,17.0,13.0,16.0,12.0,14.0,9.0,12.0,14.0,7.0,11.0,8.0,14.0,16.0,17.0,14.0,13.0,14.0,9.0,12.0,12.0,12.0,20.0,15.0,10.0,17.0,10.0,15.0,19.0,13.0,6.0,10.0,16.0,10.0,17.0,14.0,12.0,5.0,Philipp Bargfrede,ÃÂ£1.35m ,Bundesliga
19/6/2011,Paul Lasne,8440938,769,1/16/1989,22,0,0,0,0,2400,3650,3650,130,110,309911,186,79,DM/M C,3,2,3,1,1,3,2,4,2,2,1,7,10,9,6,12,11,12,11,8,9,13,6,12,12,13,12,13,12,12,12,12,14,7,10,9,10,14,16,12,13,14,13,20,14,11,5,16,13,13,13,13,5,12,8,13,14,13,15,15,15,5,10,10,20,12,1,12,20,DM/M C,421,1,1,1,12,1,1,8,10,1,16,20,12,1,10,1,0.0,0,0,0,0,0,0,0,0,0,0,0,0,0,0,0,0,0,0,0,0,0,0,0,0,0,0,0,0,0,0,0,0,0,0,0,0,0,0,0,0,0,0,0,0,0,0,0,0,Paul Lasne,ÃÂ£630Th. ,31.0,186.0,Midfielder - Defensive Midfield,left,Stade Brest 29,34.0,1.0,0.0,2033.0,30.0,0.0,1.0,1542.0,29.0,1.0,1.0,1709.0,37.0,3.0,4.0,3039.0,33.0,2.0,1.0,1913.0,9.0,0.0,0.0,516.0,27.0,3.0,3.0,1741.0,42.0,1.0,2.0,3463.0,37.0,2.0,0.0,1942.0,Ligue 1,20.0,2.0,1.0,1319.0,3.0,0.0,0.0,112.0,nan,nan,nan,nan,nan,nan,nan,nan,nan,nan,nan,nan,nan,nan,nan,nan,nan,nan,nan,nan,nan,nan,nan,nan,nan,nan,nan,nan,nan,nan,nan,nan,nan,nan,nan,nan,nan,nan,nan,nan,nan,nan,nan,nan,nan,nan,nan,nan,nan,nan,nan,nan,nan,nan,nan,nan,nan,nan,nan,nan,nan,nan,nan,nan,nan,nan,nan,nan,nan,nan,nan,nan,nan,nan,nan,nan,nan,nan,nan,nan,nan,nan,nan,nan,19-06-17,18.3.4.28,Paul Lasne,8440938,769,16-Jan-89,28,0,0,0,0,3900,6350,6350,129,127,6475543,186,77,DM/M RC,3,3,2,1,3,3,3,2,3,3,1,10,11,12,11,13,11,12,15,8,10,14,6,12,13,13,12,13,12,12,12,12,14,9,10,12,12,14,15,12,13,14,12,20,12,11,9,16,13,14,13,13,15,12,7,13,14,13,15,15,15,5,1,1,20,13,17,12,20,DM/M RC,423,1,1,1,12,1,13,1,1,1,19,20,12,17,1,1,256.0,0,0,0,0,0,0,0,0,1,0,0,0,0,0,0,0,0,0,0,0,0,0,0,0,0,0,0,0,0,0,0,0,0,0,0,0,0,0,0,0,0,0,0,0,0,0,0,0,Paul Lasne,ÃÂ£2.25m ,31.0,186.0,Midfielder - Defensive Midfield,left,Stade Brest 29,27.0,3.0,3.0,1741.0,42.0,1.0,2.0,3463.0,37.0,2.0,0.0,1942.0,20.0,2.0,1.0,1319.0,3.0,0.0,0.0,112.0,Ligue 1,15-07-16,17.3.2.23,Paul Lasne,8440938.0,769.0,16-Jan-89,27.0,0.0,0.0,0.0,0.0,4000.0,6100.0,6250.0,130.0,125.0,6129157.0,186.0,77.0,DM/M RC,4.0,1.0,3.0,3.0,2.0,3.0,3.0,3.0,1.0,1.0,2.0,10.0,11.0,12.0,10.0,13.0,11.0,12.0,14.0,8.0,10.0,14.0,6.0,12.0,13.0,13.0,12.0,13.0,12.0,12.0,12.0,12.0,14.0,9.0,10.0,12.0,11.0,14.0,15.0,12.0,13.0,14.0,12.0,20.0,12.0,11.0,9.0,16.0,13.0,13.0,13.0,13.0,15.0,12.0,8.0,13.0,14.0,13.0,15.0,15.0,15.0,5.0,Paul Lasne,ÃÂ£2.25m ,Ligue 1
19/6/2011,Nuri Sahin,8728250,799,9/5/1988,22,26,1,16,5,6500,7000,7600,169,152,0,180,72,DM/M C,3,2,1,3,2,2,1,6,1,2,3,16,17,12,8,18,15,7,13,10,10,18,12,12,17,12,16,10,15,16,19,19,14,13,14,10,13,15,12,10,13,12,10,20,14,12,10,14,11,16,8,12,8,9,12,18,14,13,17,10,10,8,1,1,20,14,10,12,20,DM/M C,421,1,1,1,14,9,9,1,1,1,18,20,12,10,1,1,140738000000000.0,0,0,0,0,0,0,0,1,0,0,0,0,0,0,0,0,0,0,0,1,0,0,1,0,1,0,0,0,0,0,0,0,0,0,0,0,0,0,0,0,0,0,0,0,0,0,0,1,Nuri Sahin,ÃÂ£16.20m ,32.0,180.0,Midfielder - Defensive Midfield,left,Antalyaspor,40.0,8.0,13.0,3500.0,10.0,1.0,1.0,641.0,30.0,6.0,6.0,1743.0,48.0,2.0,3.0,4091.0,9.0,1.0,1.0,724.0,12.0,0.0,2.0,650.0,9.0,1.0,1.0,459.0,25.0,2.0,3.0,1809.0,23.0,1.0,1.0,1742.0,LaLiga,17.0,0.0,4.0,1351.0,6.0,0.0,0.0,383.0,29/6/2010,Nuri Sahin,8728250.0,799.0,9/5/1988,21.0,22.0,1.0,16.0,5.0,5184.0,7200.0,7200.0,169.0,144.0,23610166.0,179.0,65.0,DM/M C,1.0,2.0,1.0,2.0,2.0,2.0,2.0,6.0,2.0,1.0,3.0,14.0,13.0,14.0,7.0,18.0,14.0,7.0,11.0,10.0,11.0,18.0,15.0,11.0,17.0,10.0,15.0,11.0,14.0,14.0,18.0,16.0,12.0,13.0,13.0,14.0,13.0,15.0,12.0,10.0,14.0,12.0,10.0,20.0,14.0,12.0,10.0,13.0,10.0,14.0,7.0,12.0,8.0,15.0,12.0,15.0,17.0,9.0,16.0,14.0,12.0,4.0,Nuri Sahin,ÃÂÃÂ£18.00m ,Bundesliga,19-06-17,18.3.4.28,Nuri Sahin,8728250,799,05-Sep-88,28,50,2,11,4,6000,6750,7000,152,140,18813675,180,73,DM/M C,3,2,2,3,1,2,2,4,2,3,1,14,14,10,10,15,12,7,13,8,11,18,11,12,15,11,16,10,17,16,15,17,13,11,13,8,14,17,11,9,13,11,9,20,12,11,10,13,10,13,8,12,10,9,7,13,15,12,17,10,9,8,1,1,20,14,10,10,20,DM/M C,311,1,1,1,14,10,10,1,1,1,20,20,10,10,1,1,140737000000000.0,0,0,0,0,0,0,0,0,0,0,0,0,0,0,0,0,0,0,0,0,0,0,1,0,0,0,0,0,0,0,0,0,0,0,0,0,0,0,0,0,0,0,0,0,0,0,0,1,Nuri Sahin,ÃÂ£4.05m ,32.0,180.0,Midfielder - Defensive Midfield,left,Antalyaspor,9.0,1.0,1.0,459.0,25.0,2.0,3.0,1809.0,23.0,1.0,1.0,1742.0,17.0,0.0,4.0,1351.0,6.0,0.0,0.0,383.0,Bundesliga,15-07-16,17.3.2.23,Nuri Sahin,8728250.0,799.0,05-Sep-88,27.0,50.0,2.0,11.0,5.0,4300.0,7300.0,6800.0,152.0,141.0,13954654.0,180.0,73.0,DM/M C,3.0,3.0,2.0,1.0,2.0,1.0,2.0,2.0,1.0,1.0,1.0,14.0,14.0,10.0,10.0,15.0,13.0,7.0,13.0,8.0,10.0,18.0,12.0,12.0,16.0,11.0,16.0,10.0,17.0,15.0,16.0,17.0,13.0,11.0,13.0,8.0,13.0,15.0,12.0,9.0,13.0,11.0,9.0,20.0,12.0,11.0,10.0,14.0,9.0,13.0,8.0,12.0,10.0,9.0,7.0,13.0,15.0,12.0,17.0,10.0,9.0,8.0,Nuri Sahin,ÃÂ£3.60m ,Bundesliga
19/6/2011,Nikola Gulan,5779088,802,3/23/1989,22,0,0,23,0,2500,5610,4656,125,102,148327,183,73,D/M LC,1,1,2,1,1,2,2,1,2,2,2,8,12,9,8,10,8,10,7,8,11,12,5,12,11,8,11,10,10,12,10,12,9,13,11,12,12,15,9,12,13,14,14,20,12,11,5,14,14,7,11,4,7,9,9,16,11,11,13,14,4,2,18,1,20,9,1,20,16,D/M LC,424,1,1,1,1,9,1,1,18,1,1,16,20,1,1,1,0.0,0,0,0,0,0,0,0,0,0,0,0,0,0,0,0,0,0,0,0,0,0,0,0,0,0,0,0,0,0,0,0,0,0,0,0,0,0,0,0,0,0,0,0,0,0,0,0,0,Nikola Gulan,ÃÂ£270Th. ,31.0,183.0,Defender - Left-Back,left,BK HÃÂ¤cken,9.0,0.0,0.0,533.0,1.0,0.0,0.0,10.0,20.0,0.0,1.0,1638.0,14.0,0.0,0.0,990.0,33.0,0.0,2.0,2565.0,17.0,0.0,1.0,1373.0,25.0,0.0,0.0,1564.0,11.0,0.0,0.0,712.0,26.0,0.0,2.0,2202.0,Serie A,29.0,0.0,1.0,2153.0,nan,nan,nan,nan,nan,nan,nan,nan,nan,nan,nan,nan,nan,nan,nan,nan,nan,nan,nan,nan,nan,nan,nan,nan,nan,nan,nan,nan,nan,nan,nan,nan,nan,nan,nan,nan,nan,nan,nan,nan,nan,nan,nan,nan,nan,nan,nan,nan,nan,nan,nan,nan,nan,nan,nan,nan,nan,nan,nan,nan,nan,nan,nan,nan,nan,nan,nan,nan,nan,nan,nan,nan,nan,nan,nan,nan,nan,nan,nan,nan,nan,nan,nan,nan,nan,nan,nan,nan
19/6/2011,Mesut ÃÂzil,35002219,771,10/15/1988,22,26,4,16,5,8250,8800,8450,182,166,0,183,76,AM LC,2,2,2,2,2,2,1,8,2,1,1,14,15,17,10,18,12,5,11,6,4,19,13,5,18,5,17,7,13,14,18,18,6,17,5,19,6,17,8,18,17,11,9,20,10,16,10,11,9,10,4,12,6,10,8,17,5,13,14,11,18,12,1,1,15,20,11,16,20,AM LC,504,1,1,10,20,16,11,1,1,1,1,15,15,10,1,1,18350224.0,0,0,0,0,1,0,0,1,0,0,0,0,0,0,0,0,0,0,0,1,1,0,0,0,1,0,0,0,0,0,0,0,0,0,0,0,0,0,0,0,0,0,0,0,0,0,0,0,Mesut ÃÂzil,ÃÂ£28.80m ,32.0,180.0,Midfielder - Attacking Midfield,left,Arsenal FC,54.0,10.0,29.0,3907.0,52.0,7.0,28.0,3850.0,52.0,10.0,24.0,3549.0,42.0,7.0,14.0,3367.0,32.0,5.0,9.0,2711.0,45.0,8.0,20.0,3940.0,44.0,12.0,14.0,3746.0,35.0,5.0,14.0,2953.0,35.0,6.0,3.0,2420.0,LaLiga,23.0,1.0,3.0,1812.0,nan,nan,nan,nan,29/6/2010,Mesut ÃÂÃÂzil,35002219.0,771.0,10/15/1988,21.0,17.0,2.0,16.0,5.0,6400.0,8000.0,8000.0,182.0,160.0,167399930.0,182.0,73.0,M/AM LC,1.0,2.0,3.0,2.0,1.0,2.0,2.0,4.0,1.0,3.0,1.0,14.0,15.0,16.0,9.0,18.0,12.0,5.0,11.0,6.0,4.0,18.0,13.0,5.0,18.0,5.0,17.0,7.0,8.0,14.0,18.0,18.0,6.0,17.0,5.0,18.0,6.0,19.0,8.0,18.0,16.0,11.0,7.0,20.0,10.0,16.0,9.0,11.0,8.0,9.0,4.0,12.0,6.0,10.0,8.0,17.0,5.0,13.0,14.0,11.0,18.0,12.0,Mesut ÃÂÃÂzil,ÃÂÃÂ£28.80m ,LaLiga,19-06-17,18.3.4.28,Mesut ÃÂÃÂ¼ÃÂzil,35002219,771,15-Oct-88,28,84,21,16,5,7750,8500,8250,180,162,215628997,183,72,AM RLC,3,3,2,1,4,3,2,3,2,1,4,14,15,17,11,19,12,7,11,1,6,19,11,9,19,6,18,7,18,12,19,16,8,19,6,19,6,16,11,14,16,14,9,20,15,13,8,15,9,11,5,13,6,10,16,13,9,14,15,14,16,12,1,1,12,20,17,16,20,AM RLC,506,1,1,1,20,16,17,1,1,1,1,12,12,10,1,1,18350224.0,0,0,0,0,1,0,0,1,0,0,0,0,0,0,0,0,0,0,0,1,1,0,0,0,1,0,0,0,0,0,0,0,0,0,0,0,0,0,0,0,0,0,0,0,0,0,0,0,Mesut ÃÂzil,ÃÂ£45.00m ,32.0,180.0,Midfielder - Attacking Midfield,left,Arsenal FC,44.0,12.0,14.0,3746.0,35.0,5.0,14.0,2953.0,35.0,6.0,3.0,2420.0,23.0,1.0,3.0,1812.0,nan,nan,nan,nan,Premier League,nan,nan,nan,nan,nan,nan,nan,nan,nan,nan,nan,nan,nan,nan,nan,nan,nan,nan,nan,nan,nan,nan,nan,nan,nan,nan,nan,nan,nan,nan,nan,nan,nan,nan,nan,nan,nan,nan,nan,nan,nan,nan,nan,nan,nan,nan,nan,nan,nan,nan,nan,nan,nan,nan,nan,nan,nan,nan,nan,nan,nan,nan,nan,nan,nan,nan,nan,nan,nan,nan,nan,nan,nan,nan,nan,nan,nan,nan,nan,nan,nan,nan,nan,nan,nan
19/6/2011,Mario Paglialunga,14006616,1649,10/29/1988,22,0,0,0,0,4500,5309,5100,148,118,249493,182,81,DM C,3,3,2,1,1,1,3,6,2,2,1,5,9,12,8,11,7,12,10,6,14,14,9,11,12,9,14,15,7,11,12,12,13,6,13,12,14,14,14,11,12,14,12,20,13,13,8,15,13,8,8,12,5,10,12,12,15,8,12,13,9,9,10,1,15,1,1,1,15,DM C,301,1,1,1,1,1,1,10,1,1,20,15,1,1,1,1,17592200000000.0,0,0,0,0,0,0,1,0,0,0,0,0,0,0,0,0,0,0,0,0,0,0,0,0,0,0,0,0,0,0,0,0,0,0,0,0,0,0,0,0,0,0,0,0,1,0,0,0,Mario Paglialunga,ÃÂ£450Th. ,31.0,182.0,Midfielder - Defensive Midfield,left,Club AtlÃÂ©tico Central CÃÂ³rdoba (Cba),12.0,2.0,1.0,978.0,5.0,1.0,0.0,450.0,26.0,2.0,0.0,1874.0,25.0,0.0,0.0,2056.0,28.0,0.0,1.0,1388.0,6.0,0.0,0.0,246.0,nan,nan,nan,nan,nan,nan,nan,nan,nan,nan,nan,nan,Serie A,nan,nan,nan,nan,nan,nan,nan,nan,nan,nan,nan,nan,nan,nan,nan,nan,nan,nan,nan,nan,nan,nan,nan,nan,nan,nan,nan,nan,nan,nan,nan,nan,nan,nan,nan,nan,nan,nan,nan,nan,nan,nan,nan,nan,nan,nan,nan,nan,nan,nan,nan,nan,nan,nan,nan,nan,nan,nan,nan,nan,nan,nan,nan,nan,nan,nan,nan,nan,nan,nan,nan,nan,nan,nan,nan,nan,nan,nan,nan,nan,nan,nan,nan,nan,nan,nan,nan,nan,nan,nan,nan,nan
19/6/2011,Marcos Paulo,85013938,1651,7/13/1988,22,0,0,0,0,2049,5000,5750,135,115,556927,182,70,M C,2,3,2,2,2,2,2,1,3,3,3,7,7,11,6,13,11,11,14,5,10,13,7,12,13,11,13,14,11,11,11,9,13,8,7,8,8,13,11,13,13,14,11,9,15,12,20,16,11,12,11,13,7,8,9,12,10,11,14,14,14,6,1,1,20,8,5,1,20,M C,401,1,1,1,8,1,1,1,1,1,13,20,1,5,1,1,0.0,0,0,0,0,0,0,0,0,0,0,0,0,0,0,0,0,0,0,0,0,0,0,0,0,0,0,0,0,0,0,0,0,0,0,0,0,0,0,0,0,0,0,0,0,0,0,0,0,Marcos Paulo,ÃÂ£900Th. ,32.0,182.0,Midfielder - Central Midfield,right,FC Vizela,28.0,1.0,0.0,2199.0,29.0,0.0,0.0,2387.0,16.0,0.0,0.0,912.0,15.0,5.0,0.0,1107.0,24.0,2.0,0.0,1669.0,29.0,2.0,1.0,2343.0,31.0,3.0,1.0,2632.0,30.0,3.0,0.0,2318.0,15.0,0.0,2.0,1017.0,Liga NOS,23.0,1.0,3.0,1747.0,8.0,1.0,0.0,624.0,29/6/2010,Marcos Paulo,85013938.0,1651.0,7/13/1988,21.0,0.0,0.0,0.0,0.0,850.0,4904.0,5450.0,125.0,109.0,994273.0,182.0,70.0,DM/M C,3.0,1.0,1.0,1.0,1.0,1.0,3.0,1.0,3.0,2.0,2.0,7.0,7.0,11.0,6.0,13.0,11.0,11.0,14.0,5.0,10.0,13.0,7.0,12.0,13.0,11.0,13.0,14.0,11.0,11.0,11.0,9.0,13.0,8.0,7.0,8.0,8.0,13.0,11.0,13.0,13.0,14.0,11.0,5.0,15.0,12.0,20.0,16.0,11.0,12.0,11.0,13.0,7.0,8.0,9.0,12.0,10.0,11.0,14.0,14.0,14.0,6.0,Marcos Paulo,ÃÂÃÂ£135Th. ,Liga NOS
19/6/2011,Marco Gallozzi,1413286,776,7/27/1988,22,0,0,0,0,1512,4618,4618,124,102,13877,185,66,M/AM RC,1,2,2,1,3,3,1,3,2,2,1,11,14,11,7,13,9,8,10,10,8,14,4,13,14,8,14,5,14,10,11,14,9,17,10,10,9,17,14,13,12,11,13,5,11,13,20,9,4,10,11,10,10,10,13,18,8,13,15,13,12,16,1,1,20,17,20,1,17,M/AM RC,413,1,1,1,1,1,17,1,1,1,1,17,1,20,1,1,0.0,0,0,0,0,0,0,0,0,0,0,0,0,0,0,0,0,0,0,0,0,0,0,0,0,0,0,0,0,0,0,0,0,0,0,0,0,0,0,0,0,0,0,0,0,0,0,0,0,Marco Gallozzi,ÃÂ£270Th. ,32.0,185.0,Midfielder - Right Midfield,right,Tolentino Calcio,28.0,1.0,0.0,1838.0,6.0,0.0,0.0,303.0,6.0,0.0,0.0,332.0,20.0,2.0,0.0,984.0,16.0,1.0,0.0,916.0,3.0,0.0,0.0,177.0,1.0,0.0,0.0,37.0,24.0,0.0,2.0,1542.0,29.0,1.0,3.0,1928.0,Serie A,18.0,1.0,2.0,1146.0,3.0,0.0,0.0,143.0,nan,nan,nan,nan,nan,nan,nan,nan,nan,nan,nan,nan,nan,nan,nan,nan,nan,nan,nan,nan,nan,nan,nan,nan,nan,nan,nan,nan,nan,nan,nan,nan,nan,nan,nan,nan,nan,nan,nan,nan,nan,nan,nan,nan,nan,nan,nan,nan,nan,nan,nan,nan,nan,nan,nan,nan,nan,nan,nan,nan,nan,nan,nan,nan,nan,nan,nan,nan,nan,nan,nan,nan,nan,nan,nan,nan,nan,nan,nan,nan,nan,nan,nan,nan
19/6/2011,Marcelo BenÃÂ­tez,14010074,1649,5/29/1989,22,0,0,11,1,2350,3350,3850,106,77,33099,177,72,DM C,3,3,3,2,2,2,2,1,1,2,3,7,8,6,5,10,6,4,9,5,8,12,7,10,10,14,10,12,7,10,8,10,10,8,9,6,10,13,12,12,8,10,7,8,14,9,20,13,8,14,9,10,7,10,9,15,8,8,12,9,13,9,1,1,15,8,1,1,15,DM C,301,1,1,1,8,1,1,1,1,1,20,15,1,1,1,1,140738000000000.0,0,0,0,0,0,0,0,0,0,0,0,0,0,0,0,0,0,0,0,0,0,0,0,0,0,0,1,0,0,0,0,0,0,0,0,0,0,0,0,0,0,0,0,0,0,0,0,1,nan,nan,nan,nan,nan,nan,nan,nan,nan,nan,nan,nan,nan,nan,nan,nan,nan,nan,nan,nan,nan,nan,nan,nan,nan,nan,nan,nan,nan,nan,nan,nan,nan,nan,nan,nan,nan,nan,nan,nan,nan,nan,nan,nan,nan,nan,nan,nan,nan,nan,nan,nan,nan,nan,nan,nan,nan,nan,nan,nan,nan,nan,nan,nan,nan,nan,nan,nan,nan,nan,nan,nan,nan,nan,nan,nan,nan,nan,nan,nan,nan,nan,nan,nan,nan,nan,nan,nan,nan,nan,nan,nan,nan,nan,nan,nan,nan,nan,nan,nan,nan,nan,nan,nan,nan,nan,nan,nan,nan,nan,nan,nan,nan,nan,nan,nan,nan,nan,nan,nan,nan,nan,nan,nan,nan,nan,nan,nan,nan,nan,nan,nan,nan,nan,nan,nan
19/6/2011,Manuel Schmiedebach,35008171,771,12/5/1988,22,0,0,0,0,4100,6700,6700,151,139,1030925,170,70,D/WB/DM/M RC,3,3,3,3,1,1,3,5,2,3,3,9,13,12,6,13,7,5,6,16,17,14,7,12,14,17,9,16,12,10,12,13,13,13,10,8,9,15,18,16,17,14,6,10,12,12,20,18,8,15,9,12,7,16,12,12,11,10,12,13,14,6,18,18,19,15,18,1,19,D/WB/DM/M RC,343,1,1,1,1,1,15,1,1,18,20,19,1,16,1,18,16809984.0,0,0,0,0,0,0,0,0,0,0,0,0,0,0,0,1,0,0,0,0,0,0,0,0,1,0,0,0,0,0,0,0,0,0,0,0,0,0,0,0,0,0,0,0,0,0,0,0,Manuel Schmiedebach,ÃÂ£4.95m ,31.0,171.0,Midfielder - Defensive Midfield,right,Without Club,33.0,0.0,6.0,2693.0,44.0,0.0,2.0,3344.0,36.0,1.0,1.0,2144.0,28.0,2.0,2.0,1936.0,28.0,0.0,1.0,2343.0,24.0,1.0,1.0,1967.0,28.0,0.0,2.0,2366.0,7.0,0.0,0.0,226.0,36.0,0.0,2.0,3032.0,Bundesliga,6.0,0.0,0.0,255.0,nan,nan,nan,nan,29/6/2010,Manuel Schmiedebach,35008171.0,771.0,12/5/1988,21.0,0.0,0.0,0.0,0.0,1000.0,5250.0,5250.0,122.0,105.0,5750333.0,174.0,68.0,D R,1.0,1.0,1.0,2.0,1.0,2.0,2.0,4.0,2.0,2.0,2.0,6.0,8.0,8.0,10.0,8.0,4.0,11.0,4.0,7.0,11.0,14.0,8.0,14.0,13.0,11.0,13.0,13.0,14.0,13.0,8.0,7.0,9.0,5.0,9.0,7.0,8.0,17.0,12.0,14.0,12.0,10.0,8.0,8.0,16.0,14.0,20.0,10.0,4.0,9.0,3.0,8.0,8.0,10.0,8.0,5.0,14.0,8.0,12.0,5.0,11.0,12.0,Manuel Schmiedebach,ÃÂÃÂ£4.50m ,Bundesliga,19-06-17,18.3.4.28,Manuel Schmiedebach,35008171,771,05-Dec-88,28,0,0,0,0,4400,6400,6400,136,128,7834442,170,70,DM/M C,2,3,3,3,3,3,3,3,3,1,3,9,11,12,6,14,7,5,6,17,13,13,7,12,14,16,14,17,12,11,12,13,17,10,11,10,13,17,16,13,16,15,6,12,14,10,20,14,10,14,14,12,7,17,8,10,17,12,14,10,8,6,14,14,20,12,14,10,20,DM/M C,311,1,1,1,1,10,12,1,1,14,20,20,10,12,1,14,16973824.0,0,0,0,0,0,0,0,0,0,0,0,0,0,0,0,0,1,1,0,0,0,0,0,0,1,0,0,0,0,0,0,0,0,0,0,0,0,0,0,0,0,0,0,0,0,0,0,0,Manuel Schmiedebach,ÃÂ£900Th. ,31.0,171.0,Midfielder - Defensive Midfield,right,Without Club,28.0,0.0,2.0,2366.0,7.0,0.0,0.0,226.0,36.0,0.0,2.0,3032.0,6.0,0.0,0.0,255.0,nan,nan,nan,nan,Bundesliga,nan,nan,nan,nan,nan,nan,nan,nan,nan,nan,nan,nan,nan,nan,nan,nan,nan,nan,nan,nan,nan,nan,nan,nan,nan,nan,nan,nan,nan,nan,nan,nan,nan,nan,nan,nan,nan,nan,nan,nan,nan,nan,nan,nan,nan,nan,nan,nan,nan,nan,nan,nan,nan,nan,nan,nan,nan,nan,nan,nan,nan,nan,nan,nan,nan,nan,nan,nan,nan,nan,nan,nan,nan,nan,nan,nan,nan,nan,nan,nan,nan,nan,nan,nan,nan
19/6/2011,Lukas Schmitz,35021353,771,10/13/1988,22,0,0,0,0,4600,6400,6800,132,127,1386540,184,80,D/M/AM LC,3,2,2,3,1,2,1,1,3,2,2,13,16,9,10,8,12,9,13,15,9,10,11,11,8,14,8,15,9,16,12,10,14,6,11,13,7,18,16,13,10,15,12,8,13,16,20,17,13,15,6,9,4,17,6,13,12,18,15,14,17,5,17,15,20,18,1,20,15,D/M/AM LC,434,1,1,1,1,18,1,1,17,1,1,15,20,1,15,1,1116690000000.0,0,0,0,1,0,0,0,0,0,0,0,0,0,0,0,0,0,0,0,0,0,0,0,0,0,0,0,0,0,0,0,0,0,0,1,0,0,0,0,0,1,0,0,0,0,0,0,0,Lukas Schmitz,ÃÂ£2.25m ,32.0,183.0,Defender - Left-Back,left,VVV-Venlo,37.0,0.0,4.0,2743.0,27.0,0.0,4.0,1994.0,23.0,0.0,1.0,1762.0,6.0,0.0,0.0,364.0,23.0,1.0,3.0,1971.0,28.0,1.0,4.0,2454.0,34.0,0.0,5.0,3001.0,13.0,1.0,3.0,925.0,33.0,2.0,4.0,2955.0,Bundesliga,38.0,1.0,2.0,3232.0,5.0,0.0,0.0,441.0,29/6/2010,Lukas Schmitz,35021353.0,771.0,10/13/1988,21.0,0.0,0.0,0.0,0.0,1250.0,6400.0,6400.0,135.0,128.0,10272279.0,184.0,80.0,D/M/AM L,3.0,3.0,3.0,3.0,3.0,1.0,2.0,2.0,1.0,2.0,2.0,14.0,16.0,7.0,12.0,8.0,13.0,9.0,14.0,15.0,8.0,10.0,11.0,10.0,8.0,14.0,9.0,15.0,14.0,16.0,11.0,11.0,11.0,6.0,9.0,13.0,8.0,17.0,16.0,13.0,10.0,15.0,12.0,9.0,13.0,16.0,20.0,17.0,13.0,15.0,6.0,9.0,4.0,17.0,6.0,9.0,14.0,10.0,15.0,16.0,5.0,2.0,Lukas Schmitz,ÃÂÃÂ£2.25m ,Bundesliga
19/6/2011,Lars Stindl,35011818,771,8/26/1988,22,0,0,1,0,4150,6550,6550,149,131,656115,180,73,M/AM RC,1,2,1,1,1,3,3,3,2,3,2,13,12,12,13,14,13,8,14,4,6,14,15,7,14,7,12,12,13,13,15,13,14,12,10,14,8,16,14,13,11,12,10,8,13,14,20,15,13,11,9,11,5,13,9,14,13,11,15,14,13,9,1,1,20,19,18,14,20,M/AM RC,413,1,1,5,19,14,18,1,1,1,13,20,14,18,1,1,4398050000000.0,0,0,0,0,0,0,0,1,0,0,0,0,0,0,0,0,0,0,0,0,0,0,1,0,0,0,0,0,0,0,0,0,0,0,0,0,0,0,0,0,0,0,1,0,0,0,0,0,Lars Stindl,ÃÂ£5.40m ,32.0,181.0,Forward - Second Striker,right,Borussia MÃÂ¶nchengladbach,34.0,2.0,5.0,2302.0,43.0,6.0,7.0,3766.0,29.0,4.0,9.0,2435.0,33.0,3.0,3.0,2837.0,22.0,11.0,4.0,1884.0,39.0,14.0,15.0,3384.0,44.0,18.0,9.0,3811.0,34.0,6.0,5.0,3001.0,22.0,3.0,3.0,1602.0,Bundesliga,30.0,11.0,3.0,1712.0,7.0,2.0,1.0,438.0,29/6/2010,Lars Stindl,35011818.0,771.0,8/26/1988,21.0,0.0,0.0,1.0,0.0,3550.0,6400.0,6400.0,149.0,128.0,5909511.0,180.0,73.0,M/AM LC,3.0,3.0,3.0,2.0,1.0,2.0,3.0,1.0,3.0,2.0,1.0,14.0,10.0,12.0,13.0,14.0,15.0,8.0,14.0,4.0,6.0,15.0,15.0,7.0,14.0,7.0,12.0,13.0,13.0,13.0,15.0,10.0,14.0,8.0,9.0,14.0,7.0,14.0,13.0,13.0,11.0,12.0,10.0,8.0,13.0,14.0,20.0,14.0,13.0,13.0,9.0,11.0,5.0,13.0,18.0,14.0,13.0,11.0,15.0,14.0,13.0,9.0,Lars Stindl,ÃÂÃÂ£2.70m ,Bundesliga,19-06-17,18.3.4.28,Lars Stindl,35011818,771,26-Aug-88,28,6,3,1,0,6800,7300,7300,146,146,46360061,180,73,AM/S C,1,3,3,2,2,3,2,2,2,1,3,13,15,12,13,15,11,10,14,10,8,14,13,11,15,17,15,13,11,14,14,12,14,10,12,16,11,18,17,12,14,11,10,10,17,12,20,16,10,15,7,14,5,17,9,12,14,12,17,15,13,7,1,1,15,19,14,12,19,AM/S C,621,1,1,20,19,12,14,1,1,1,11,15,12,14,1,1,2.88e+17,0,0,0,0,0,0,0,0,0,0,0,0,0,0,0,0,0,0,0,0,0,0,1,0,0,0,0,0,0,0,0,0,0,0,0,0,0,0,0,0,0,0,0,0,0,0,0,0,Lars Stindl,ÃÂ£16.20m ,32.0,181.0,Forward - Second Striker,right,Borussia MÃÂ¶nchengladbach,44.0,18.0,9.0,3811.0,34.0,6.0,5.0,3001.0,22.0,3.0,3.0,1602.0,30.0,11.0,3.0,1712.0,7.0,2.0,1.0,438.0,Bundesliga,15-07-16,17.3.2.23,Lars Stindl,35011818.0,771.0,26-Aug-88,27.0,0.0,0.0,1.0,0.0,6700.0,6700.0,7200.0,145.0,144.0,29871767.0,180.0,73.0,AM/S RC,3.0,1.0,2.0,2.0,2.0,2.0,3.0,3.0,2.0,4.0,1.0,13.0,15.0,12.0,13.0,15.0,11.0,10.0,14.0,10.0,8.0,14.0,13.0,11.0,15.0,17.0,15.0,13.0,11.0,14.0,14.0,12.0,14.0,10.0,12.0,16.0,11.0,18.0,17.0,11.0,14.0,11.0,10.0,10.0,17.0,12.0,20.0,16.0,10.0,15.0,7.0,14.0,5.0,17.0,9.0,12.0,14.0,12.0,17.0,15.0,13.0,7.0,Lars Stindl,ÃÂ£13.50m ,Bundesliga
19/6/2011,Lars Bender,35007385,771,4/27/1989,22,0,0,1,0,5400,6850,6850,160,137,871708,184,77,DM/M C,1,1,2,3,2,2,2,6,3,1,1,8,11,13,10,14,11,12,11,8,13,14,10,15,14,12,14,15,14,13,14,12,17,10,11,11,15,15,15,13,12,11,12,10,14,13,20,13,11,13,6,13,9,14,5,13,16,15,17,15,15,4,5,1,20,14,10,6,20,DM/M C,421,1,1,1,14,1,1,5,1,1,19,20,6,10,1,1,0.0,0,0,0,0,0,0,0,0,0,0,0,0,0,0,0,0,0,0,0,0,0,0,0,0,0,0,0,0,0,0,0,0,0,0,0,0,0,0,0,0,0,0,0,0,0,0,0,0,Lars Bender,ÃÂ£13.50m ,31.0,185.0,Defender - Right-Back,right,Bayer 04 Leverkusen,42.0,3.0,2.0,2202.0,37.0,5.0,5.0,3168.0,41.0,3.0,8.0,3469.0,39.0,4.0,2.0,3151.0,35.0,1.0,3.0,2806.0,17.0,2.0,0.0,1315.0,12.0,0.0,1.0,823.0,24.0,3.0,7.0,1792.0,27.0,1.0,5.0,1814.0,Bundesliga,28.0,2.0,1.0,2043.0,5.0,1.0,1.0,425.0,29/6/2010,Lars Bender,35007385.0,771.0,4/27/1989,21.0,0.0,0.0,0.0,0.0,3000.0,6550.0,6550.0,160.0,131.0,12586681.0,183.0,75.0,DM/M C,2.0,2.0,1.0,1.0,3.0,2.0,1.0,1.0,3.0,3.0,1.0,8.0,11.0,13.0,10.0,14.0,11.0,12.0,11.0,8.0,13.0,14.0,10.0,14.0,14.0,12.0,13.0,15.0,14.0,13.0,14.0,12.0,17.0,10.0,11.0,11.0,15.0,15.0,14.0,13.0,12.0,11.0,12.0,10.0,14.0,12.0,20.0,13.0,9.0,16.0,6.0,13.0,9.0,14.0,2.0,13.0,15.0,15.0,17.0,15.0,15.0,4.0,Lars Bender,ÃÂÃÂ£4.95m ,Bundesliga,19-06-17,18.3.4.28,Lars Bender,35007385,771,27-Apr-89,28,19,4,1,0,6800,7050,7300,154,146,44042058,185,81,D/DM/M RC,3,1,3,3,1,1,4,1,2,2,2,7,10,8,9,12,7,12,11,13,15,13,8,17,11,15,16,18,12,17,10,14,17,5,14,12,14,19,17,11,11,14,12,10,18,12,20,17,13,18,6,18,13,15,9,14,14,16,19,15,18,2,16,12,20,10,16,1,20,D/DM/M RC,333,1,1,1,8,1,10,10,1,16,20,20,1,10,1,12,274928000000.0,0,0,0,0,0,0,0,0,0,0,0,0,0,0,0,0,0,0,0,0,0,0,0,0,1,1,0,0,0,0,0,0,0,0,0,0,0,0,1,0,0,0,0,0,0,0,0,0,Lars Bender,ÃÂ£11.70m ,31.0,185.0,Defender - Right-Back,right,Bayer 04 Leverkusen,12.0,0.0,1.0,823.0,24.0,3.0,7.0,1792.0,27.0,1.0,5.0,1814.0,28.0,2.0,1.0,2043.0,6.0,1.0,1.0,461.0,Bundesliga,15-07-16,17.3.2.23,Lars Bender,35007385.0,771.0,27-Apr-89,27.0,19.0,4.0,1.0,0.0,6247.0,6997.0,7247.0,154.0,145.0,30574219.0,184.0,77.0,DM/M C,1.0,1.0,2.0,2.0,2.0,2.0,3.0,2.0,1.0,1.0,1.0,7.0,10.0,8.0,9.0,12.0,7.0,12.0,11.0,13.0,15.0,13.0,8.0,17.0,11.0,15.0,16.0,18.0,12.0,17.0,10.0,14.0,17.0,5.0,13.0,13.0,14.0,19.0,18.0,11.0,11.0,14.0,12.0,10.0,20.0,13.0,20.0,17.0,13.0,18.0,6.0,18.0,10.0,15.0,9.0,14.0,14.0,16.0,19.0,15.0,18.0,2.0,Lars Bender,ÃÂ£9.00m ,Bundesliga
19/6/2011,Kwadwo Asamoah,12012662,21,12/9/1988,22,29,1,0,0,5750,7450,7450,172,150,2431051,178,78,M C,3,1,2,1,2,1,1,9,2,1,2,6,11,15,12,14,8,8,14,3,14,13,12,15,14,14,13,16,15,13,12,13,13,11,8,14,14,12,14,16,15,17,9,20,17,15,8,16,16,14,13,14,6,14,14,15,12,15,12,14,16,4,1,1,20,15,1,12,20,M C,401,1,1,1,15,1,1,1,1,1,15,20,12,1,1,1,4.0,0,0,1,0,0,0,0,0,0,0,0,0,0,0,0,0,0,0,0,0,0,0,0,0,0,0,0,0,0,0,0,0,0,0,0,0,0,0,0,0,0,0,0,0,0,0,0,0,Kwadwo Asamoah,ÃÂ£13.50m ,31.0,173.0,Midfielder - Left Midfield,left,Without Club,39.0,2.0,3.0,3336.0,40.0,3.0,3.0,3385.0,36.0,3.0,9.0,2738.0,47.0,2.0,6.0,3847.0,10.0,0.0,1.0,884.0,13.0,0.0,2.0,770.0,24.0,0.0,2.0,1883.0,26.0,0.0,0.0,2029.0,42.0,0.0,2.0,3578.0,Serie A,11.0,0.0,1.0,899.0,nan,nan,nan,nan,29/6/2010,Kwadwo Asamoah,12012662.0,21.0,12/9/1988,21.0,19.0,1.0,0.0,0.0,4750.0,7100.0,7000.0,169.0,140.0,44424282.0,178.0,78.0,DM/M LC,2.0,2.0,2.0,2.0,2.0,1.0,3.0,5.0,2.0,2.0,2.0,4.0,10.0,15.0,13.0,13.0,8.0,9.0,14.0,3.0,14.0,13.0,12.0,15.0,14.0,14.0,12.0,17.0,14.0,13.0,11.0,11.0,14.0,11.0,8.0,14.0,14.0,12.0,14.0,15.0,14.0,17.0,9.0,20.0,17.0,15.0,7.0,15.0,16.0,15.0,14.0,14.0,6.0,14.0,14.0,15.0,10.0,15.0,12.0,15.0,15.0,4.0,Kwadwo Asamoah,ÃÂÃÂ£8.55m ,Serie A,19-06-17,18.3.4.28,Kwadwo Asamoah,12012662,21,09-Dec-88,28,69,4,0,0,6000,7400,7400,158,146,33940029,173,75,D/WB/M LC,3,3,3,2,2,2,3,2,1,1,1,9,11,13,10,13,10,9,13,14,13,14,12,14,13,14,12,13,14,14,10,11,13,12,7,13,16,15,17,14,13,16,9,20,4,14,9,15,15,16,7,14,20,16,14,13,13,15,14,14,16,4,17,19,20,8,1,19,20,D/WB/M LC,434,1,1,1,1,8,1,1,17,1,12,20,19,1,19,1,4.0,0,0,1,0,0,0,0,0,0,0,0,0,0,0,0,0,0,0,0,0,0,0,0,0,0,0,0,0,0,0,0,0,0,0,0,0,0,0,0,0,0,0,0,0,0,0,0,0,Kwadwo Asamoah,ÃÂ£12.60m ,31.0,173.0,Midfielder - Left Midfield,left,Without Club,24.0,0.0,2.0,1883.0,26.0,0.0,0.0,2029.0,42.0,0.0,2.0,3578.0,11.0,0.0,1.0,899.0,nan,nan,nan,nan,Serie A,15-07-16,17.3.2.23,Kwadwo Asamoah,12012662.0,21.0,09-Dec-88,27.0,69.0,4.0,0.0,0.0,5900.0,7500.0,7600.0,163.0,151.0,37525793.0,173.0,76.0,WB/M LC,2.0,3.0,3.0,3.0,2.0,1.0,3.0,4.0,1.0,3.0,1.0,9.0,11.0,14.0,10.0,13.0,10.0,9.0,13.0,10.0,14.0,14.0,12.0,14.0,13.0,14.0,13.0,13.0,14.0,15.0,12.0,12.0,13.0,12.0,7.0,13.0,16.0,15.0,17.0,14.0,14.0,16.0,11.0,20.0,4.0,14.0,10.0,17.0,15.0,16.0,7.0,14.0,20.0,16.0,14.0,15.0,13.0,15.0,12.0,14.0,16.0,4.0,Kwadwo Asamoah,ÃÂ£9.90m ,Serie A
19/6/2011,Joshua,67010757,796,1/28/1989,22,0,0,0,0,2050,4050,4050,108,81,82843,180,75,DM/M C,1,2,3,2,3,1,2,2,1,1,3,13,12,11,9,9,12,7,10,2,10,13,4,10,10,7,7,18,9,6,13,15,12,14,6,13,12,6,12,8,9,9,10,5,14,12,20,7,10,13,5,10,6,11,14,17,12,20,14,14,9,14,1,1,20,1,1,1,20,DM/M C,421,1,1,1,1,1,1,1,1,1,18,20,1,1,1,1,17592200000000.0,0,0,0,0,0,0,0,0,0,0,0,0,0,0,0,0,0,0,0,0,0,0,1,0,0,0,0,0,0,0,0,0,0,0,0,0,0,0,0,0,0,0,0,0,1,0,0,0,nan,nan,nan,nan,nan,nan,nan,nan,nan,nan,nan,nan,nan,nan,nan,nan,nan,nan,nan,nan,nan,nan,nan,nan,nan,nan,nan,nan,nan,nan,nan,nan,nan,nan,nan,nan,nan,nan,nan,nan,nan,nan,nan,nan,nan,nan,nan,nan,nan,nan,nan,nan,nan,nan,nan,nan,nan,nan,nan,nan,nan,nan,nan,nan,nan,nan,nan,nan,nan,nan,nan,nan,nan,nan,nan,nan,nan,nan,nan,nan,nan,nan,nan,nan,nan,nan,nan,nan,nan,nan,nan,nan,nan,nan,nan,nan,nan,nan,nan,nan,nan,nan,nan,nan,nan,nan,nan,nan,nan,nan,nan,nan,nan,nan,nan,nan,nan,nan,nan,nan,nan,nan,nan,nan,nan,nan,nan,nan,nan,nan,nan,nan,nan,nan,nan,nan
19/6/2011,JoÃÂ£o Victor,2114918,1651,11/7/1988,22,0,0,0,0,4750,5967,6400,142,132,531315,181,78,DM/M C,3,1,1,1,1,3,2,3,3,1,3,10,12,12,12,14,9,7,12,4,13,14,12,11,13,9,11,11,14,13,11,12,10,12,13,13,13,13,14,13,14,13,12,12,14,13,20,14,14,14,11,12,9,11,11,10,6,7,14,9,5,14,1,1,18,14,1,1,18,DM/M C,311,1,1,1,14,1,1,1,1,1,20,18,1,1,1,1,0.0,0,0,0,0,0,0,0,0,0,0,0,0,0,0,0,0,0,0,0,0,0,0,0,0,0,0,0,0,0,0,0,0,0,0,0,0,0,0,0,0,0,0,0,0,0,0,0,0,JoÃÂ£o Victor,ÃÂ£2.25m ,31.0,181.0,Midfielder - Defensive Midfield,right,Hyderabad FC,36.0,0.0,1.0,2462.0,17.0,0.0,1.0,1093.0,7.0,0.0,0.0,275.0,nan,nan,nan,nan,37.0,1.0,1.0,3144.0,25.0,3.0,0.0,2231.0,33.0,4.0,0.0,2919.0,35.0,7.0,2.0,3143.0,30.0,4.0,0.0,2700.0,LaLiga,22.0,0.0,0.0,1715.0,nan,nan,nan,nan,29/6/2010,JoÃÂÃÂ£o Victor,2114918.0,1651.0,11/7/1988,21.0,0.0,0.0,0.0,0.0,1750.0,4700.0,4700.0,134.0,94.0,2635050.0,181.0,78.0,M/AM C,3.0,2.0,1.0,2.0,3.0,2.0,2.0,5.0,1.0,1.0,3.0,10.0,9.0,12.0,12.0,11.0,10.0,7.0,14.0,3.0,7.0,12.0,10.0,7.0,12.0,7.0,7.0,5.0,11.0,11.0,11.0,8.0,10.0,8.0,8.0,14.0,10.0,9.0,13.0,14.0,13.0,14.0,13.0,1.0,5.0,13.0,20.0,9.0,12.0,10.0,11.0,10.0,13.0,10.0,7.0,14.0,9.0,10.0,11.0,6.0,1.0,7.0,JoÃÂÃÂ£o Victor,ÃÂÃÂ£1.80m ,LaLiga
19/6/2011,Jeffrey Sarpong,856984,784,8/3/1988,22,0,0,0,0,4250,5708,5708,147,125,422810,176,65,AM RLC,1,1,3,3,3,1,1,5,3,3,3,13,13,14,12,15,14,9,14,3,5,13,10,5,14,11,11,10,9,8,12,10,10,12,7,13,4,9,10,14,15,7,7,14,11,14,20,13,13,8,8,8,9,13,13,10,11,11,16,12,5,7,1,1,15,20,16,18,20,AM RLC,506,1,1,8,20,18,16,1,1,1,1,15,15,12,1,1,2251800000000000.0,0,0,0,0,0,0,0,0,0,1,0,0,0,0,0,0,0,0,0,0,0,0,0,0,0,0,0,0,0,0,0,0,0,0,0,0,0,0,0,0,0,0,0,0,0,0,0,0,Jeffrey Sarpong,ÃÂ£900Th. ,32.0,176.0,Forward - Left Winger,right,Without Club,19.0,2.0,1.0,483.0,14.0,1.0,1.0,566.0,14.0,1.0,0.0,612.0,32.0,2.0,4.0,2454.0,36.0,3.0,6.0,2349.0,13.0,0.0,1.0,676.0,25.0,5.0,5.0,2031.0,20.0,1.0,5.0,1275.0,22.0,0.0,1.0,1111.0,LaLiga,nan,nan,nan,nan,nan,nan,nan,nan,29/6/2010,Jeffrey Sarpong,856984.0,784.0,8/3/1988,21.0,0.0,0.0,0.0,0.0,3844.0,5700.0,5700.0,147.0,124.0,2647723.0,176.0,65.0,M/AM LC,1.0,3.0,1.0,1.0,1.0,2.0,3.0,1.0,3.0,1.0,2.0,10.0,12.0,14.0,12.0,15.0,6.0,9.0,13.0,4.0,5.0,13.0,9.0,5.0,16.0,15.0,11.0,9.0,9.0,9.0,11.0,10.0,8.0,10.0,7.0,13.0,5.0,8.0,10.0,14.0,16.0,7.0,7.0,15.0,13.0,14.0,20.0,13.0,10.0,11.0,15.0,9.0,5.0,10.0,5.0,9.0,11.0,6.0,10.0,10.0,9.0,10.0,Jeffrey Sarpong,ÃÂÃÂ£900Th. ,LaLiga
19/6/2011,Javier Matilla,67067070,796,8/16/1988,22,0,0,1,0,4600,6600,6600,154,132,482738,176,72,M C,3,2,2,2,2,2,1,5,1,3,3,11,12,12,9,16,10,7,10,5,10,16,12,10,16,10,12,9,12,12,16,14,13,13,9,11,12,15,12,13,14,10,8,13,12,11,20,13,11,13,8,12,8,8,11,15,13,12,15,14,13,6,1,1,20,8,1,1,20,M C,401,1,1,1,8,1,1,1,1,1,13,20,1,1,1,1,4194304.0,0,0,0,0,0,0,0,0,0,0,0,0,0,0,0,0,0,0,0,0,0,0,1,0,0,0,0,0,0,0,0,0,0,0,0,0,0,0,0,0,0,0,0,0,0,0,0,0,Javier Matilla,ÃÂ£1.35m ,32.0,178.0,Midfielder - Central Midfield,right,Aris Thessaloniki,18.0,0.0,0.0,832.0,15.0,0.0,0.0,453.0,35.0,12.0,4.0,3026.0,26.0,1.0,1.0,1562.0,18.0,2.0,2.0,1445.0,nan,nan,nan,nan,15.0,2.0,1.0,1155.0,10.0,0.0,0.0,559.0,31.0,3.0,5.0,2115.0,LaLiga,43.0,2.0,5.0,3887.0,6.0,1.0,0.0,418.0,29/6/2010,Javier Matilla,67067070.0,796.0,8/16/1988,21.0,0.0,0.0,0.0,0.0,4290.0,6550.0,6550.0,158.0,131.0,15124879.0,176.0,72.0,M C,1.0,2.0,2.0,3.0,1.0,3.0,2.0,7.0,2.0,1.0,3.0,10.0,8.0,14.0,7.0,14.0,10.0,10.0,12.0,4.0,14.0,13.0,10.0,13.0,14.0,15.0,14.0,9.0,12.0,9.0,14.0,12.0,10.0,7.0,12.0,10.0,11.0,16.0,15.0,14.0,14.0,14.0,6.0,12.0,14.0,14.0,20.0,10.0,5.0,10.0,4.0,10.0,12.0,10.0,14.0,8.0,8.0,14.0,12.0,5.0,14.0,10.0,Javier Matilla,ÃÂÃÂ£1.35m ,LaLiga
19/6/2011,Javi MartÃÂ­nez,1512305,796,9/2/1988,22,3,0,14,0,5500,7750,7750,166,157,5343423,190,87,M C,1,2,3,1,1,2,1,5,1,2,2,6,9,11,12,12,9,15,13,8,14,14,13,14,14,14,15,15,15,16,13,15,14,13,14,14,15,16,16,13,13,14,16,13,15,14,20,17,16,17,9,14,7,13,15,16,14,13,15,14,12,4,1,1,20,14,12,1,20,M C,401,1,1,1,14,1,1,1,1,1,13,20,1,12,1,1,0.0,0,0,0,0,0,0,0,0,0,0,0,0,0,0,0,0,0,0,0,0,0,0,0,0,0,0,0,0,0,0,0,0,0,0,0,0,0,0,0,0,0,0,0,0,0,0,0,0,Javi MartÃÂ­nez,ÃÂ£19.80m ,32.0,192.0,Midfielder - Defensive Midfield,right,Bayern Munich,38.0,4.0,1.0,3242.0,54.0,4.0,1.0,4615.0,43.0,3.0,4.0,3071.0,34.0,1.0,0.0,2217.0,3.0,0.0,0.0,96.0,27.0,1.0,2.0,1915.0,37.0,2.0,1.0,2975.0,37.0,2.0,2.0,2738.0,33.0,4.0,0.0,2257.0,LaLiga,24.0,0.0,0.0,1015.0,7.0,1.0,0.0,248.0,29/6/2010,Javi MartÃÂ­nez,1512305.0,796.0,9/2/1988,21.0,3.0,0.0,9.0,0.0,5329.0,6650.0,6650.0,164.0,146.0,17687432.0,190.0,87.0,M C,3.0,1.0,2.0,1.0,3.0,3.0,1.0,1.0,3.0,1.0,1.0,6.0,9.0,12.0,12.0,12.0,9.0,15.0,12.0,8.0,11.0,13.0,13.0,13.0,13.0,14.0,13.0,15.0,14.0,14.0,12.0,13.0,14.0,14.0,14.0,12.0,14.0,15.0,15.0,13.0,12.0,14.0,16.0,13.0,15.0,14.0,20.0,17.0,17.0,14.0,7.0,13.0,7.0,13.0,15.0,16.0,14.0,13.0,15.0,14.0,11.0,4.0,Javi MartÃÂÃÂ­nez,ÃÂÃÂ£18.00m ,LaLiga,19-06-17,18.3.4.28,Javi MartÃÂ­nez,1512305,796,02-Sep-88,28,18,0,24,1,7650,7650,8150,165,163,186515761,190,86,D/DM/M C,2,1,3,1,2,1,3,3,3,3,2,7,10,9,12,14,7,13,10,8,15,13,11,16,14,12,18,14,16,17,12,15,15,9,14,12,17,18,14,9,11,17,16,14,14,12,20,14,16,18,10,18,12,15,14,17,12,16,17,13,13,4,20,1,16,10,8,1,20,D/DM/M C,121,1,1,5,10,1,8,20,1,1,19,16,1,8,1,1,4294967296.0,0,0,0,0,0,0,0,0,0,0,0,0,0,0,0,0,0,0,0,0,0,0,0,0,0,0,0,0,0,0,0,0,1,0,0,0,0,0,0,0,0,0,0,0,0,0,0,0,Javi MartÃÂ­nez,ÃÂ£36.00m ,32.0,192.0,Midfielder - Defensive Midfield,right,Bayern Munich,37.0,2.0,1.0,2975.0,37.0,2.0,2.0,2738.0,33.0,4.0,0.0,2257.0,24.0,0.0,0.0,1015.0,7.0,1.0,0.0,248.0,Bundesliga,15-07-16,17.3.2.23,Javi MartÃÂ­nez,1512305.0,796.0,02-Sep-88,27.0,18.0,0.0,24.0,1.0,7600.0,7600.0,8100.0,165.0,162.0,91440038.0,190.0,86.0,D/DM/M C,3.0,2.0,3.0,3.0,2.0,1.0,1.0,1.0,1.0,3.0,2.0,7.0,10.0,9.0,12.0,14.0,7.0,13.0,10.0,8.0,15.0,13.0,11.0,16.0,14.0,12.0,18.0,14.0,16.0,17.0,12.0,15.0,15.0,9.0,14.0,12.0,17.0,18.0,14.0,9.0,11.0,17.0,16.0,14.0,14.0,12.0,20.0,14.0,16.0,18.0,10.0,18.0,12.0,15.0,14.0,17.0,12.0,16.0,17.0,13.0,13.0,4.0,Javi MartÃÂ­nez,ÃÂ£27.00m ,Bundesliga
19/6/2011,Ja-Cheol Ku,66001373,135,2/27/1989,22,19,8,16,5,4400,6500,6400,155,128,316205,182,72,M/AM C,2,3,3,2,2,3,1,6,3,1,3,14,16,9,13,15,12,8,15,4,9,15,12,8,14,14,13,11,12,11,14,11,15,11,12,15,9,12,16,10,11,12,9,17,11,10,20,13,10,7,12,15,10,16,15,11,14,11,12,10,9,13,1,1,20,18,12,1,20,M/AM C,411,1,1,10,18,1,1,1,1,1,14,20,1,12,1,1,8796090000000.0,0,0,0,0,0,1,0,1,1,0,0,0,0,0,0,0,0,0,0,1,0,0,0,0,0,0,0,0,0,0,0,0,0,0,0,0,0,0,0,0,0,0,0,1,0,0,0,0,Ja-cheol Koo,ÃÂ£3.15m ,31.0,182.0,Midfielder - Central Midfield,right,Al-Gharafa SC,10.0,0.0,1.0,281.0,27.0,5.0,3.0,1811.0,22.0,3.0,2.0,1687.0,26.0,1.0,2.0,1446.0,26.0,7.0,2.0,1751.0,38.0,8.0,4.0,2590.0,25.0,3.0,4.0,1981.0,29.0,2.0,0.0,2066.0,28.0,2.0,1.0,1827.0,Bundesliga,18.0,1.0,0.0,1617.0,4.0,1.0,0.0,335.0,nan,nan,nan,nan,nan,nan,nan,nan,nan,nan,nan,nan,nan,nan,nan,nan,nan,nan,nan,nan,nan,nan,nan,nan,nan,nan,nan,nan,nan,nan,nan,nan,nan,nan,nan,nan,nan,nan,nan,nan,nan,nan,nan,nan,nan,nan,nan,nan,nan,nan,nan,nan,nan,nan,nan,nan,nan,nan,nan,nan,nan,nan,nan,nan,nan,nan,nan,nan,nan,nan,nan,nan,nan,nan,nan,nan,nan,nan,nan,nan,nan,nan,nan,nan,19-06-17,18.3.4.28,Ja-Cheol Koo,66001373,135,27-Feb-89,28,61,19,16,5,6100,7350,7100,143,142,30969985,183,78,M/AM C,2,3,2,2,2,3,3,3,2,2,3,13,14,14,13,17,12,9,15,6,7,14,12,8,18,14,12,8,17,10,14,12,8,15,10,11,9,16,14,10,16,12,9,17,16,10,20,14,10,9,5,11,5,15,8,18,10,9,17,14,16,10,1,1,18,20,14,14,20,M/AM C,521,1,1,10,20,14,14,1,1,1,12,18,14,14,1,1,0.0,0,0,0,0,0,0,0,0,0,0,0,0,0,0,0,0,0,0,0,0,0,0,0,0,0,0,0,0,0,0,0,0,0,0,0,0,0,0,0,0,0,0,0,0,0,0,0,0,Ja-cheol Koo,ÃÂ£3.15m ,31.0,182.0,Midfielder - Central Midfield,right,Al-Gharafa SC,25.0,3.0,4.0,1981.0,29.0,2.0,0.0,2066.0,28.0,2.0,1.0,1827.0,18.0,1.0,0.0,1617.0,5.0,2.0,0.0,424.0,Bundesliga,15-07-16,17.3.2.23,Ja-Cheol Koo,66001373.0,135.0,27-Feb-89,27.0,53.0,17.0,16.0,5.0,6100.0,7100.0,7100.0,143.0,142.0,21731702.0,183.0,75.0,M/AM C,2.0,2.0,2.0,2.0,1.0,3.0,2.0,3.0,2.0,1.0,4.0,13.0,14.0,14.0,13.0,17.0,12.0,9.0,15.0,6.0,7.0,14.0,12.0,8.0,18.0,14.0,12.0,8.0,17.0,10.0,14.0,12.0,8.0,15.0,10.0,11.0,9.0,16.0,14.0,10.0,16.0,12.0,9.0,17.0,16.0,10.0,20.0,14.0,10.0,9.0,5.0,11.0,5.0,15.0,8.0,18.0,10.0,9.0,17.0,14.0,16.0,10.0,Ja-cheol Koo,ÃÂ£4.05m ,Bundesliga
19/6/2011,Ivan Radovanovic,62013021,802,8/29/1988,22,1,0,11,0,3600,6000,5550,138,114,108399,186,76,DM C,1,1,3,1,1,1,2,2,3,1,3,11,12,11,9,12,11,12,11,8,12,14,10,13,13,13,9,11,7,8,14,11,15,10,11,10,11,12,12,12,11,12,12,10,11,12,20,15,11,12,14,9,9,8,14,9,16,8,16,18,12,2,10,8,15,10,7,10,15,DM C,301,1,1,1,10,1,1,6,10,1,20,15,1,7,8,1,0.0,0,0,0,0,0,0,0,0,0,0,0,0,0,0,0,0,0,0,0,0,0,0,0,0,0,0,0,0,0,0,0,0,0,0,0,0,0,0,0,0,0,0,0,0,0,0,0,0,Ivan Radovanovic,ÃÂ£810Th. ,32.0,187.0,Midfielder - Defensive Midfield,right,Genoa CFC,16.0,1.0,0.0,635.0,30.0,2.0,0.0,1696.0,17.0,0.0,0.0,718.0,35.0,1.0,1.0,2519.0,31.0,1.0,0.0,2476.0,27.0,0.0,0.0,2148.0,37.0,0.0,0.0,3025.0,36.0,1.0,1.0,3261.0,36.0,0.0,0.0,3080.0,Serie A,22.0,0.0,1.0,1522.0,4.0,0.0,0.0,161.0,29/6/2010,Ivan Radovanovic,62013021.0,802.0,8/29/1988,21.0,0.0,0.0,10.0,0.0,3025.0,5500.0,5500.0,138.0,110.0,317367.0,186.0,76.0,DM/M C,1.0,2.0,3.0,3.0,2.0,3.0,2.0,4.0,2.0,2.0,1.0,11.0,12.0,11.0,9.0,12.0,11.0,12.0,11.0,8.0,12.0,14.0,10.0,12.0,13.0,13.0,9.0,11.0,7.0,8.0,14.0,11.0,15.0,10.0,11.0,9.0,11.0,12.0,12.0,12.0,11.0,12.0,12.0,10.0,11.0,12.0,20.0,15.0,11.0,12.0,14.0,9.0,9.0,7.0,14.0,9.0,16.0,8.0,16.0,18.0,12.0,2.0,Ivan Radovanovic,ÃÂÃÂ£720Th. ,Serie A,19-06-17,18.3.4.28,Ivan Radovanovic,62013021,802,29-Aug-88,28,10,0,12,0,4500,6700,6700,139,134,16370723,187,80,DM/M C,3,2,3,1,2,1,1,2,3,1,1,11,10,10,9,13,13,12,14,13,12,14,10,14,13,15,13,15,10,14,12,13,15,12,11,12,13,14,16,10,10,14,13,15,12,10,20,16,14,13,14,11,12,8,14,9,16,8,16,18,12,2,1,1,20,1,1,1,20,DM/M C,421,1,1,1,1,1,1,1,1,1,19,20,1,1,1,1,8796090000000.0,0,0,0,0,0,0,0,0,0,0,0,0,0,0,0,0,0,0,0,0,0,0,0,0,0,0,0,0,0,0,0,0,0,0,0,0,0,0,0,0,0,0,0,1,0,0,0,0,Ivan Radovanovic,ÃÂ£3.15m ,32.0,187.0,Midfielder - Defensive Midfield,right,Genoa CFC,37.0,0.0,0.0,3025.0,36.0,1.0,1.0,3261.0,36.0,0.0,0.0,3080.0,22.0,0.0,1.0,1522.0,4.0,0.0,0.0,161.0,Serie A,15-07-16,17.3.2.23,Ivan Radovanovic,62013021.0,802.0,29-Aug-88,27.0,10.0,0.0,12.0,0.0,3900.0,6000.0,6550.0,135.0,131.0,10024624.0,187.0,80.0,DM/M C,4.0,3.0,4.0,3.0,3.0,3.0,2.0,1.0,2.0,3.0,2.0,11.0,10.0,10.0,9.0,13.0,12.0,12.0,14.0,13.0,12.0,14.0,10.0,14.0,13.0,15.0,13.0,15.0,10.0,14.0,12.0,13.0,15.0,12.0,11.0,12.0,14.0,14.0,14.0,10.0,10.0,14.0,13.0,13.0,11.0,10.0,20.0,16.0,14.0,13.0,14.0,11.0,12.0,8.0,14.0,9.0,16.0,8.0,16.0,18.0,12.0,2.0,Ivan Radovanovic,ÃÂ£2.25m ,Serie A
19/6/2011,Ivan Perisic,34012563,761,2/2/1989,22,3,0,8,3,5250,6800,6800,157,139,2149203,187,79,AM LC,2,3,2,3,2,3,3,2,2,1,1,11,13,12,17,15,14,17,12,5,5,13,14,6,14,7,16,14,15,12,12,14,14,13,6,17,8,7,9,14,10,11,16,16,15,14,20,11,11,11,7,15,6,17,9,14,10,14,7,14,8,6,1,1,15,20,14,19,20,AM LC,504,1,1,14,20,19,14,1,1,1,12,15,15,14,1,1,1056.0,0,0,0,0,0,1,0,0,0,0,1,0,0,0,0,0,0,0,0,0,0,0,0,0,0,0,0,0,0,0,0,0,0,0,0,0,0,0,0,0,0,0,0,0,0,0,0,0,Ivan Perisic,ÃÂ£6.30m ,31.0,187.0,Forward - Left Winger,both,Inter Milan,46.0,22.0,10.0,3787.0,41.0,9.0,6.0,1525.0,34.0,5.0,2.0,1400.0,38.0,11.0,7.0,2586.0,35.0,7.0,9.0,2380.0,41.0,10.0,6.0,2915.0,42.0,11.0,10.0,3042.0,39.0,11.0,11.0,3489.0,45.0,9.0,8.0,3631.0,Bundesliga,35.0,8.0,10.0,1756.0,6.0,0.0,2.0,397.0,nan,nan,nan,nan,nan,nan,nan,nan,nan,nan,nan,nan,nan,nan,nan,nan,nan,nan,nan,nan,nan,nan,nan,nan,nan,nan,nan,nan,nan,nan,nan,nan,nan,nan,nan,nan,nan,nan,nan,nan,nan,nan,nan,nan,nan,nan,nan,nan,nan,nan,nan,nan,nan,nan,nan,nan,nan,nan,nan,nan,nan,nan,nan,nan,nan,nan,nan,nan,nan,nan,nan,nan,nan,nan,nan,nan,nan,nan,nan,nan,nan,nan,nan,nan,19-06-17,18.3.4.28,Ivan Perisic,34012563,761,02-Feb-89,28,57,15,8,3,6750,8050,7800,160,156,146540793,186,80,M/AM RLC,2,2,2,1,1,2,1,3,2,1,2,12,14,15,14,14,13,13,12,5,7,14,13,7,14,8,16,12,13,11,12,13,13,13,6,17,8,10,12,16,13,13,13,15,13,16,20,14,12,11,7,15,6,17,12,15,10,15,14,12,10,16,7,7,18,20,16,20,15,M/AM RLC,526,1,1,14,15,20,16,1,7,4,11,7,18,13,7,6,4947800000000.0,0,0,0,1,0,1,0,0,0,0,0,0,0,0,0,0,0,0,0,0,0,0,0,0,0,0,0,0,0,0,0,0,0,0,0,0,0,0,0,1,0,0,1,0,0,0,0,0,Ivan Perisic,ÃÂ£36.00m ,31.0,187.0,Forward - Left Winger,both,Inter Milan,42.0,11.0,10.0,3042.0,39.0,11.0,11.0,3489.0,45.0,9.0,8.0,3631.0,35.0,8.0,10.0,1756.0,6.0,0.0,2.0,397.0,Serie A,15-07-16,17.3.2.23,Ivan Perisic,34012563.0,761.0,02-Feb-89,27.0,51.0,15.0,8.0,3.0,6250.0,7650.0,7650.0,154.0,153.0,73952544.0,186.0,79.0,M/AM RLC,3.0,1.0,1.0,4.0,3.0,1.0,3.0,2.0,1.0,2.0,2.0,12.0,13.0,15.0,14.0,15.0,14.0,13.0,12.0,5.0,7.0,13.0,12.0,7.0,14.0,8.0,14.0,11.0,14.0,11.0,11.0,13.0,13.0,13.0,6.0,16.0,8.0,12.0,12.0,16.0,13.0,13.0,13.0,15.0,13.0,15.0,20.0,14.0,12.0,14.0,7.0,15.0,6.0,17.0,13.0,16.0,9.0,15.0,10.0,12.0,10.0,16.0,Ivan Perisic,ÃÂ£27.00m ,Serie A
19/6/2011,Giacomo Bonaventura,43006720,776,5/13/1989,22,0,0,0,0,3766,6414,6400,157,129,506351,181,75,M/AM RLC,3,1,2,2,2,3,2,3,1,3,3,11,13,14,11,14,11,9,12,7,7,14,11,10,15,9,9,12,12,12,13,12,17,14,11,13,11,12,11,15,14,8,9,10,13,14,20,13,9,15,7,15,4,15,12,16,12,12,14,12,9,12,1,1,20,19,19,19,20,M/AM RLC,416,1,1,1,19,17,16,1,1,1,12,20,19,19,1,1,144.0,0,0,0,0,1,0,0,1,0,0,0,0,0,0,0,0,0,0,0,0,0,0,0,0,0,0,0,0,0,0,0,0,0,0,0,0,0,0,0,0,0,0,0,0,0,0,0,0,Giacomo Bonaventura,ÃÂ£2.70m ,31.0,180.0,Midfielder - Central Midfield,right,ACF Fiorentina,33.0,9.0,5.0,1952.0,30.0,2.0,1.0,1835.0,36.0,8.0,4.0,2702.0,31.0,5.0,4.0,2520.0,36.0,7.0,5.0,2843.0,39.0,7.0,11.0,3310.0,22.0,5.0,5.0,1874.0,47.0,9.0,4.0,3557.0,10.0,3.0,0.0,797.0,Serie A,32.0,4.0,6.0,1530.0,5.0,0.0,1.0,388.0,nan,nan,nan,nan,nan,nan,nan,nan,nan,nan,nan,nan,nan,nan,nan,nan,nan,nan,nan,nan,nan,nan,nan,nan,nan,nan,nan,nan,nan,nan,nan,nan,nan,nan,nan,nan,nan,nan,nan,nan,nan,nan,nan,nan,nan,nan,nan,nan,nan,nan,nan,nan,nan,nan,nan,nan,nan,nan,nan,nan,nan,nan,nan,nan,nan,nan,nan,nan,nan,nan,nan,nan,nan,nan,nan,nan,nan,nan,nan,nan,nan,nan,nan,nan,19-06-17,18.3.4.28,Giacomo Bonaventura,43006720,776,22-Aug-89,27,8,0,12,3,6000,7400,7650,155,153,109879505,180,75,M/AM LC,1,2,1,3,3,3,2,4,2,1,2,14,14,15,11,14,15,13,15,6,10,14,12,11,15,12,14,13,14,14,13,14,15,14,14,15,12,15,14,15,14,11,11,12,14,14,20,13,12,15,8,15,9,17,13,15,15,16,15,13,14,5,1,1,20,19,13,19,20,M/AM LC,414,1,1,1,18,19,12,1,1,1,1,20,19,13,1,1,1.44e+17,0,0,0,0,1,0,0,1,0,0,0,0,0,0,0,0,0,0,0,0,0,0,0,0,0,0,0,0,0,0,0,0,0,0,0,0,0,0,0,0,0,1,0,0,0,0,0,0,Giacomo Bonaventura,ÃÂ£20.70m ,31.0,180.0,Midfielder - Central Midfield,right,ACF Fiorentina,22.0,5.0,5.0,1874.0,47.0,9.0,4.0,3557.0,10.0,3.0,0.0,797.0,32.0,4.0,6.0,1530.0,5.0,0.0,1.0,388.0,Serie A,15-07-16,17.3.2.23,Giacomo Bonaventura,43006720.0,776.0,22-Aug-89,26.0,8.0,0.0,12.0,3.0,5200.0,7400.0,7600.0,155.0,153.0,70277494.0,180.0,75.0,M/AM LC,3.0,3.0,3.0,1.0,1.0,1.0,3.0,3.0,2.0,3.0,2.0,14.0,14.0,15.0,11.0,15.0,15.0,13.0,15.0,6.0,10.0,14.0,11.0,11.0,14.0,12.0,14.0,13.0,14.0,13.0,14.0,14.0,14.0,14.0,12.0,15.0,12.0,15.0,14.0,15.0,14.0,12.0,11.0,12.0,15.0,14.0,20.0,13.0,11.0,14.0,8.0,15.0,4.0,17.0,16.0,15.0,15.0,13.0,15.0,13.0,14.0,5.0,Giacomo Bonaventura,ÃÂ£21.60m ,Serie A
19/6/2011,Georges Mandjeck,35015134,11,12/9/1988,22,7,0,2,1,3250,6750,6350,140,127,577965,183,72,DM C,1,3,2,1,3,3,3,3,2,3,1,5,7,12,9,13,11,15,11,5,15,14,10,15,14,12,13,13,12,11,11,12,13,12,11,8,13,12,13,12,13,12,13,8,13,14,20,13,13,13,10,11,5,11,13,12,10,12,13,11,9,5,14,12,15,1,12,1,15,DM C,301,1,1,1,1,1,1,14,1,12,20,15,1,1,1,12,0.0,0,0,0,0,0,0,0,0,0,0,0,0,0,0,0,0,0,0,0,0,0,0,0,0,0,0,0,0,0,0,0,0,0,0,0,0,0,0,0,0,0,0,0,0,0,0,0,0,Georges Mandjeck,ÃÂ£1.58m ,31.0,185.0,Midfielder - Defensive Midfield,right,Waasland-Beveren,24.0,0.0,0.0,940.0,32.0,1.0,0.0,2629.0,31.0,1.0,0.0,2419.0,25.0,1.0,2.0,1771.0,12.0,0.0,0.0,633.0,27.0,0.0,1.0,2049.0,30.0,3.0,0.0,2459.0,27.0,0.0,0.0,1878.0,32.0,5.0,1.0,2545.0,Ligue 1,18.0,0.0,0.0,1049.0,1.0,0.0,0.0,73.0,29/6/2010,Georges Mandjeck,35015134.0,11.0,12/9/1988,21.0,7.0,0.0,2.0,1.0,3250.0,6750.0,6350.0,147.0,127.0,2638726.0,183.0,72.0,DM C,1.0,2.0,1.0,2.0,2.0,1.0,3.0,5.0,1.0,1.0,2.0,5.0,7.0,12.0,9.0,13.0,11.0,15.0,11.0,5.0,15.0,14.0,10.0,15.0,14.0,12.0,13.0,13.0,12.0,11.0,11.0,12.0,13.0,12.0,11.0,8.0,13.0,12.0,13.0,12.0,13.0,12.0,13.0,8.0,13.0,14.0,20.0,13.0,13.0,13.0,10.0,11.0,5.0,11.0,13.0,12.0,10.0,12.0,13.0,11.0,9.0,5.0,Georges Mandjeck,ÃÂÃÂ£1.44m ,Ligue 1,19-06-17,18.3.4.28,Georges Mandjeck,35015134,11,09-Dec-88,28,41,0,2,1,5000,6450,6250,127,123,2542059,183,72,DM ,1,2,2,3,1,1,3,1,2,1,2,5,8,10,6,11,10,14,11,5,14,12,10,15,11,14,13,16,12,11,9,11,12,8,12,8,13,14,14,14,13,16,11,8,12,13,20,15,15,10,10,11,7,11,13,13,9,9,11,10,10,8,13,10,10,1,12,1,13,DM ,300,1,1,1,1,1,1,13,1,12,20,10,1,10,1,10,64.0,0,0,0,0,0,0,1,0,0,0,0,0,0,0,0,0,0,0,0,0,0,0,0,0,0,0,0,0,0,0,0,0,0,0,0,0,0,0,0,0,0,0,0,0,0,0,0,0,Georges Mandjeck,ÃÂ£900Th. ,31.0,185.0,Midfielder - Defensive Midfield,right,Waasland-Beveren,30.0,3.0,0.0,2459.0,27.0,0.0,0.0,1878.0,32.0,5.0,1.0,2545.0,18.0,0.0,0.0,1049.0,1.0,0.0,0.0,73.0,Ligue 1,15-07-16,17.3.2.23,Georges Mandjeck,35015134.0,11.0,09-Dec-88,27.0,27.0,1.0,2.0,1.0,4247.0,5847.0,6197.0,127.0,120.0,5925400.0,183.0,72.0,DM ,1.0,1.0,3.0,2.0,1.0,2.0,3.0,1.0,1.0,4.0,3.0,5.0,8.0,10.0,6.0,11.0,10.0,14.0,11.0,5.0,14.0,12.0,10.0,15.0,11.0,14.0,13.0,16.0,11.0,11.0,9.0,10.0,12.0,8.0,12.0,8.0,13.0,14.0,14.0,14.0,12.0,16.0,11.0,8.0,12.0,13.0,20.0,15.0,15.0,10.0,14.0,11.0,7.0,11.0,13.0,13.0,9.0,9.0,11.0,10.0,10.0,8.0,Georges Mandjeck,ÃÂ£1.13m ,Ligue 1
19/6/2011,Francesco Bolzoni,43002298,776,5/7/1989,22,0,0,14,0,1155,5500,5500,137,110,259201,180,78,M C,1,1,1,1,1,1,1,1,1,1,1,4,9,10,4,12,5,10,10,6,10,13,13,14,12,15,12,14,12,11,10,12,15,8,9,10,13,12,14,12,13,14,12,8,12,12,20,15,13,10,14,13,9,6,10,12,16,12,17,17,17,7,1,1,20,1,1,1,20,M C,401,1,1,1,1,1,1,1,1,1,10,20,1,1,1,1,32832.0,0,0,0,0,0,0,1,0,0,0,0,0,0,0,0,1,0,0,0,0,0,0,0,0,0,0,0,0,0,0,0,0,0,0,0,0,0,0,0,0,0,0,0,0,0,0,0,0,Francesco Bolzoni,ÃÂ£1.08m ,31.0,183.0,Midfielder - Central Midfield,right,Calcio Lecco 1912,28.0,3.0,2.0,2254.0,20.0,1.0,0.0,1119.0,27.0,0.0,0.0,1684.0,39.0,4.0,1.0,3351.0,24.0,0.0,0.0,1092.0,2.0,0.0,0.0,51.0,14.0,0.0,0.0,722.0,30.0,0.0,0.0,2364.0,33.0,1.0,0.0,2665.0,Serie A,15.0,0.0,0.0,1001.0,4.0,0.0,0.0,283.0,nan,nan,nan,nan,nan,nan,nan,nan,nan,nan,nan,nan,nan,nan,nan,nan,nan,nan,nan,nan,nan,nan,nan,nan,nan,nan,nan,nan,nan,nan,nan,nan,nan,nan,nan,nan,nan,nan,nan,nan,nan,nan,nan,nan,nan,nan,nan,nan,nan,nan,nan,nan,nan,nan,nan,nan,nan,nan,nan,nan,nan,nan,nan,nan,nan,nan,nan,nan,nan,nan,nan,nan,nan,nan,nan,nan,nan,nan,nan,nan,nan,nan,nan,nan
19/6/2011,FayÃÂ§al Fajr,85084000,34,8/1/1988,22,0,0,0,0,1300,4769,2650,125,106,31620,178,72,M/AM C,3,2,1,3,3,3,2,5,2,3,3,12,13,13,8,13,14,6,11,5,2,13,12,2,14,5,10,8,11,10,13,10,17,15,6,11,5,11,10,14,13,12,9,12,13,11,20,11,11,13,13,14,6,8,10,15,13,12,14,11,11,5,1,1,16,20,14,12,20,M/AM C,521,1,1,1,20,12,14,1,1,1,1,16,12,14,1,1,34359738496.0,0,0,0,0,0,0,0,1,0,0,0,0,0,0,0,0,0,0,0,0,0,0,0,0,0,0,0,0,0,0,0,0,0,0,0,1,0,0,0,0,0,0,0,0,0,0,0,0,FayÃÂ§al Fajr,ÃÂ£630Th. ,32.0,179.0,Midfielder - Central Midfield,right,Sivasspor,2.0,1.0,0.0,66.0,17.0,2.0,1.0,1079.0,34.0,5.0,7.0,2843.0,38.0,10.0,15.0,2950.0,38.0,1.0,5.0,2769.0,41.0,5.0,5.0,2962.0,26.0,0.0,3.0,1293.0,33.0,1.0,4.0,2564.0,40.0,5.0,9.0,3578.0,Ligue 1,16.0,0.0,1.0,930.0,4.0,1.0,0.0,340.0,nan,nan,nan,nan,nan,nan,nan,nan,nan,nan,nan,nan,nan,nan,nan,nan,nan,nan,nan,nan,nan,nan,nan,nan,nan,nan,nan,nan,nan,nan,nan,nan,nan,nan,nan,nan,nan,nan,nan,nan,nan,nan,nan,nan,nan,nan,nan,nan,nan,nan,nan,nan,nan,nan,nan,nan,nan,nan,nan,nan,nan,nan,nan,nan,nan,nan,nan,nan,nan,nan,nan,nan,nan,nan,nan,nan,nan,nan,nan,nan,nan,nan,nan,nan,19-06-17,18.3.4.28,FayÃÂÃÂ¼ÃÂal Fajr,85084000,34,01-Aug-88,28,1,0,0,0,5500,6800,6800,143,136,12912832,179,70,M/AM RLC,3,3,2,1,3,1,1,4,3,2,4,14,13,15,11,14,13,8,12,5,7,13,12,8,18,11,11,11,9,10,14,10,17,15,8,12,8,12,11,14,13,12,10,12,13,14,20,15,12,10,9,10,7,8,17,15,13,10,11,12,10,8,1,1,18,20,17,17,20,M/AM RLC,526,1,1,1,20,17,17,1,1,1,10,18,15,15,1,1,2233400000000.0,0,0,0,0,0,0,0,1,0,0,0,1,0,0,0,0,0,0,0,0,0,0,0,0,1,0,0,0,0,0,0,0,0,0,0,1,0,0,0,0,0,1,0,0,0,0,0,0,FayÃÂ§al Fajr,ÃÂ£2.25m ,32.0,179.0,Midfielder - Central Midfield,right,Sivasspor,26.0,0.0,3.0,1293.0,33.0,1.0,4.0,2564.0,40.0,5.0,9.0,3578.0,16.0,0.0,1.0,930.0,5.0,1.0,0.0,430.0,LaLiga,nan,nan,nan,nan,nan,nan,nan,nan,nan,nan,nan,nan,nan,nan,nan,nan,nan,nan,nan,nan,nan,nan,nan,nan,nan,nan,nan,nan,nan,nan,nan,nan,nan,nan,nan,nan,nan,nan,nan,nan,nan,nan,nan,nan,nan,nan,nan,nan,nan,nan,nan,nan,nan,nan,nan,nan,nan,nan,nan,nan,nan,nan,nan,nan,nan,nan,nan,nan,nan,nan,nan,nan,nan,nan,nan,nan,nan,nan,nan,nan,nan,nan,nan,nan,nan
19/6/2011,Fabio Sciacca,43002359,776,5/16/1989,22,0,0,0,0,3000,5650,5650,140,113,211707,182,76,DM/M C,1,1,1,1,1,1,1,1,1,1,1,8,10,9,10,12,12,15,15,4,7,14,9,11,13,12,10,14,11,8,14,8,14,11,13,14,9,12,12,12,11,13,10,11,10,13,20,12,14,13,13,10,15,14,14,16,16,13,16,12,12,5,1,1,20,10,14,12,20,DM/M C,421,1,1,1,10,1,1,1,1,1,17,20,12,14,1,1,272.0,0,0,0,0,1,0,0,0,1,0,0,0,0,0,0,0,0,0,0,0,0,0,0,0,0,0,0,0,0,0,0,0,0,0,0,0,0,0,0,0,0,0,0,0,0,0,0,0,Fabio Sciacca,ÃÂ£540Th. ,31.0,184.0,Midfielder - Central Midfield,right,Calcio Biancavilla 1990,9.0,0.0,0.0,674.0,25.0,1.0,0.0,1466.0,4.0,0.0,0.0,129.0,5.0,0.0,0.0,309.0,16.0,0.0,2.0,864.0,nan,nan,nan,nan,3.0,0.0,0.0,111.0,21.0,0.0,0.0,884.0,nan,nan,nan,nan,Serie A,2.0,0.0,0.0,107.0,3.0,0.0,0.0,187.0,29/6/2010,Fabio Sciacca,43002359.0,776.0,5/16/1989,21.0,0.0,0.0,0.0,0.0,3000.0,5250.0,5250.0,149.0,113.0,1461963.0,182.0,76.0,M C,1.0,1.0,1.0,1.0,1.0,1.0,1.0,1.0,1.0,1.0,1.0,8.0,10.0,9.0,10.0,12.0,12.0,15.0,15.0,4.0,7.0,14.0,9.0,11.0,13.0,12.0,10.0,14.0,11.0,8.0,14.0,8.0,14.0,11.0,13.0,14.0,9.0,12.0,12.0,13.0,11.0,13.0,10.0,11.0,16.0,13.0,20.0,12.0,14.0,13.0,13.0,10.0,9.0,14.0,9.0,16.0,16.0,13.0,16.0,12.0,12.0,5.0,Fabio Sciacca,ÃÂÃÂ£540Th. ,Serie A
19/6/2011,Ever Banega,14001284,1649,6/29/1988,22,2,0,14,0,6500,7650,7500,168,154,5142705,174,71,M C,2,3,3,1,1,2,2,7,3,2,1,13,13,15,10,18,10,6,13,7,8,18,12,11,18,14,14,9,18,11,18,16,14,15,8,13,9,15,11,13,14,13,7,14,12,12,20,13,11,9,14,13,11,10,8,13,12,11,6,11,8,15,1,1,20,12,7,7,20,M C,401,1,1,1,12,1,1,1,1,1,13,20,7,7,1,1,17593300000000.0,0,0,0,0,0,0,0,0,1,0,0,0,0,0,0,0,0,0,0,0,0,0,1,0,0,0,0,0,0,0,1,0,0,0,0,0,0,0,0,0,0,0,0,0,1,0,0,0,ÃÂver Banega,ÃÂ£11.70m ,32.0,174.0,Midfielder - Central Midfield,right,Al-Shabab Riyadh,34.0,3.0,3.0,2181.0,25.0,1.0,2.0,1805.0,40.0,4.0,8.0,2557.0,42.0,2.0,5.0,2993.0,49.0,3.0,4.0,3306.0,45.0,9.0,5.0,3377.0,33.0,6.0,7.0,1899.0,50.0,5.0,6.0,3981.0,51.0,8.0,11.0,4075.0,LaLiga,43.0,3.0,11.0,3056.0,1.0,0.0,0.0,87.0,29/6/2010,Ever Banega,14001284.0,1649.0,6/29/1988,22.0,2.0,0.0,14.0,0.0,5929.0,7500.0,7500.0,166.0,154.0,86992260.0,174.0,71.0,M C,1.0,1.0,2.0,3.0,1.0,1.0,2.0,2.0,1.0,1.0,3.0,12.0,11.0,15.0,9.0,17.0,10.0,8.0,11.0,7.0,8.0,18.0,12.0,11.0,18.0,12.0,14.0,11.0,18.0,13.0,18.0,16.0,15.0,14.0,9.0,13.0,10.0,16.0,13.0,13.0,12.0,13.0,8.0,14.0,12.0,12.0,20.0,15.0,10.0,12.0,15.0,16.0,11.0,10.0,6.0,16.0,14.0,14.0,13.0,11.0,8.0,13.0,ÃÂÃÂver Banega,ÃÂÃÂ£10.80m ,LaLiga,19-06-17,18.3.4.28,ÃÂÃÂ¼ÃÂver Banega,14001284,1649,29-Jun-88,28,55,4,6,0,6250,7750,7600,161,152,67124973,174,71,M/AM C,1,3,2,1,2,3,1,4,1,2,2,14,16,15,12,17,14,6,13,4,10,17,12,13,17,14,14,11,16,11,17,13,13,17,11,14,11,16,13,12,13,15,7,12,12,12,20,14,10,15,10,13,12,10,8,13,10,14,9,13,10,13,1,1,19,20,1,1,20,M/AM C,521,1,1,1,20,1,1,1,1,1,13,19,1,1,1,1,17593300000000.0,0,0,0,0,0,0,0,1,1,0,0,0,0,0,0,0,0,0,0,0,0,0,1,0,0,0,0,0,0,0,1,0,0,0,0,0,0,0,0,0,0,0,0,0,1,0,0,0,ÃÂver Banega,ÃÂ£10.80m ,32.0,174.0,Midfielder - Central Midfield,right,Al-Shabab Riyadh,33.0,6.0,7.0,1899.0,50.0,5.0,6.0,3981.0,51.0,8.0,11.0,4075.0,43.0,3.0,11.0,3056.0,2.0,1.0,0.0,177.0,LaLiga,nan,nan,nan,nan,nan,nan,nan,nan,nan,nan,nan,nan,nan,nan,nan,nan,nan,nan,nan,nan,nan,nan,nan,nan,nan,nan,nan,nan,nan,nan,nan,nan,nan,nan,nan,nan,nan,nan,nan,nan,nan,nan,nan,nan,nan,nan,nan,nan,nan,nan,nan,nan,nan,nan,nan,nan,nan,nan,nan,nan,nan,nan,nan,nan,nan,nan,nan,nan,nan,nan,nan,nan,nan,nan,nan,nan,nan,nan,nan,nan,nan,nan,nan,nan,nan
19/6/2011,Etienne Capoue,8448716,769,7/11/1988,22,0,0,13,0,5150,6450,6450,165,143,1712166,189,80,DM C,3,3,2,2,2,2,2,3,1,1,3,5,11,12,6,13,8,16,8,7,13,15,8,13,13,13,17,15,14,14,13,14,13,11,8,10,14,15,16,12,13,16,14,8,16,13,20,17,16,15,13,15,5,10,5,15,15,15,13,14,14,7,14,12,15,10,12,1,15,DM C,301,1,1,1,10,1,1,14,1,12,20,15,1,1,1,12,8796090000000.0,0,0,0,0,0,1,0,0,0,0,0,0,0,0,0,0,0,0,0,0,0,0,0,0,0,0,0,0,0,0,0,0,0,0,0,0,0,0,0,0,0,0,0,1,0,0,0,0,ÃÂtienne Capoue,ÃÂ£10.80m ,32.0,189.0,Midfielder - Defensive Midfield,right,Watford FC,39.0,2.0,0.0,3540.0,34.0,3.0,5.0,2909.0,38.0,7.0,1.0,3406.0,19.0,1.0,1.0,1284.0,19.0,1.0,2.0,1284.0,36.0,0.0,1.0,3017.0,39.0,7.0,1.0,3357.0,26.0,3.0,0.0,1755.0,39.0,4.0,3.0,3352.0,Ligue 1,30.0,0.0,3.0,2632.0,2.0,0.0,0.0,73.0,29/6/2010,Etienne Capoue,8448716.0,769.0,7/11/1988,21.0,0.0,0.0,12.0,0.0,1400.0,6074.0,6050.0,165.0,135.0,8421558.0,189.0,80.0,DM C,3.0,3.0,1.0,1.0,1.0,1.0,2.0,4.0,1.0,1.0,2.0,6.0,10.0,12.0,6.0,12.0,8.0,16.0,10.0,8.0,14.0,14.0,8.0,12.0,14.0,14.0,15.0,14.0,13.0,13.0,13.0,13.0,13.0,8.0,10.0,10.0,12.0,14.0,16.0,12.0,12.0,16.0,14.0,8.0,16.0,13.0,20.0,17.0,16.0,14.0,11.0,15.0,6.0,10.0,5.0,15.0,15.0,15.0,13.0,14.0,14.0,7.0,ÃÂÃÂtienne Capoue,ÃÂÃÂ£7.20m ,Ligue 1,19-06-17,18.3.4.28,Etienne Capoue,8448716,769,11-Jul-88,28,7,1,13,0,5600,7050,7000,148,140,41974748,189,80,DM/M C,1,3,3,1,3,2,2,2,3,1,2,5,11,12,8,15,8,14,7,7,11,15,10,14,16,13,17,14,15,14,14,13,11,12,8,12,14,14,13,12,13,16,13,8,16,13,20,17,15,8,10,15,8,10,8,15,15,15,12,14,11,14,12,12,20,4,12,7,20,DM/M C,311,1,1,1,4,1,1,7,1,12,20,20,7,7,1,12,34359738408.0,0,0,0,1,0,1,0,0,0,0,0,0,0,0,0,0,0,0,0,0,0,0,0,0,0,0,0,0,0,0,0,0,0,0,0,1,0,0,0,0,0,0,0,0,0,0,0,0,ÃÂtienne Capoue,ÃÂ£7.20m ,32.0,189.0,Midfielder - Defensive Midfield,right,Watford FC,39.0,7.0,1.0,3357.0,26.0,3.0,0.0,1755.0,39.0,4.0,3.0,3352.0,30.0,0.0,3.0,2632.0,2.0,0.0,0.0,73.0,Premier League,15-07-16,17.3.2.23,Etienne Capoue,8448716.0,769.0,11-Jul-88,28.0,7.0,1.0,13.0,0.0,5597.0,7047.0,7197.0,148.0,143.0,43236170.0,189.0,80.0,DM/M C,3.0,1.0,4.0,1.0,1.0,3.0,2.0,1.0,1.0,1.0,1.0,5.0,11.0,12.0,8.0,14.0,8.0,14.0,7.0,7.0,11.0,15.0,10.0,14.0,15.0,13.0,17.0,15.0,15.0,14.0,13.0,13.0,11.0,11.0,8.0,11.0,14.0,15.0,16.0,12.0,13.0,16.0,13.0,8.0,16.0,13.0,20.0,17.0,15.0,10.0,13.0,15.0,14.0,10.0,8.0,15.0,15.0,15.0,12.0,14.0,11.0,14.0,ÃÂtienne Capoue,ÃÂ£8.10m ,Premier League
19/6/2011,Elliott Bennett,28006433,765,12/18/1988,22,0,0,0,0,3350,5550,5900,136,111,580394,178,73,M/AM RLC,1,2,2,1,1,1,2,2,1,1,1,14,14,11,7,12,13,5,13,3,8,12,9,8,11,7,9,7,10,11,13,10,14,9,5,13,11,13,12,15,9,8,9,10,14,14,20,14,8,15,5,12,2,16,10,12,13,11,14,13,16,1,9,9,19,20,20,19,19,M/AM RLC,526,1,1,1,19,19,20,1,1,9,1,19,15,19,1,9,0.0,0,0,0,0,0,0,0,0,0,0,0,0,0,0,0,0,0,0,0,0,0,0,0,0,0,0,0,0,0,0,0,0,0,0,0,0,0,0,0,0,0,0,0,0,0,0,0,0,Elliott Bennett,ÃÂ£2.70m ,31.0,179.0,Defender - Right-Back,right,Blackburn Rovers,53.0,8.0,20.0,4571.0,37.0,1.0,7.0,2295.0,29.0,2.0,3.0,1284.0,6.0,1.0,3.0,442.0,21.0,0.0,1.0,1315.0,42.0,2.0,5.0,3091.0,31.0,4.0,2.0,2153.0,47.0,2.0,7.0,3962.0,42.0,1.0,5.0,3611.0,Premier League,42.0,0.0,4.0,2829.0,1.0,0.0,0.0,11.0,nan,nan,nan,nan,nan,nan,nan,nan,nan,nan,nan,nan,nan,nan,nan,nan,nan,nan,nan,nan,nan,nan,nan,nan,nan,nan,nan,nan,nan,nan,nan,nan,nan,nan,nan,nan,nan,nan,nan,nan,nan,nan,nan,nan,nan,nan,nan,nan,nan,nan,nan,nan,nan,nan,nan,nan,nan,nan,nan,nan,nan,nan,nan,nan,nan,nan,nan,nan,nan,nan,nan,nan,nan,nan,nan,nan,nan,nan,nan,nan,nan,nan,nan,nan
19/6/2011,Elizeu,19097681,1651,5/28/1989,22,0,0,0,0,1772,5436,5400,126,109,95103,183,78,DM/M C,2,3,1,3,2,3,1,4,1,1,1,9,10,11,9,11,7,11,11,7,13,12,11,12,12,10,12,10,12,12,10,12,15,5,7,8,13,15,14,12,12,15,12,8,14,12,20,14,16,12,11,11,6,10,11,15,5,11,10,13,13,15,1,1,18,1,1,1,18,DM/M C,311,1,1,1,1,1,1,1,1,1,20,18,1,1,1,1,0.0,0,0,0,0,0,0,0,0,0,0,0,0,0,0,0,0,0,0,0,0,0,0,0,0,0,0,0,0,0,0,0,0,0,0,0,0,0,0,0,0,0,0,0,0,0,0,0,0,Elizeu,ÃÂ£720Th. ,31.0,184.0,Defender - Centre-Back,right,Petaling Jaya City FC,nan,nan,nan,nan,21.0,1.0,0.0,1352.0,13.0,0.0,0.0,657.0,nan,nan,nan,nan,nan,nan,nan,nan,nan,nan,nan,nan,19.0,3.0,1.0,1770.0,nan,nan,nan,nan,21.0,1.0,0.0,1855.0,Liga NOS,6.0,1.0,0.0,540.0,nan,nan,nan,nan,nan,nan,nan,nan,nan,nan,nan,nan,nan,nan,nan,nan,nan,nan,nan,nan,nan,nan,nan,nan,nan,nan,nan,nan,nan,nan,nan,nan,nan,nan,nan,nan,nan,nan,nan,nan,nan,nan,nan,nan,nan,nan,nan,nan,nan,nan,nan,nan,nan,nan,nan,nan,nan,nan,nan,nan,nan,nan,nan,nan,nan,nan,nan,nan,nan,nan,nan,nan,nan,nan,nan,nan,nan,nan,nan,nan,nan,nan,nan,nan,nan,nan,nan,nan
19/6/2011,Edu Bedia,67053077,796,3/23/1989,22,0,0,1,0,4000,5750,5750,135,112,165357,184,74,M C,2,1,3,3,1,1,3,1,3,2,2,14,13,12,13,13,14,8,11,8,8,14,13,8,15,7,12,7,13,12,15,13,9,15,8,12,8,10,10,11,13,7,11,20,11,11,12,11,6,12,7,12,8,7,10,14,11,8,15,15,10,8,1,1,20,15,1,1,20,M C,401,1,1,1,15,1,1,1,1,1,6,20,1,1,1,1,8796160000000.0,0,0,0,0,0,0,0,0,0,0,0,0,0,0,0,0,0,0,0,0,0,0,0,0,0,0,1,0,0,0,0,0,0,0,0,0,0,0,0,0,0,0,0,1,0,0,0,0,Edu Bedia,ÃÂ£450Th. ,31.0,183.0,Midfielder - Central Midfield,left,FC Goa,27.0,3.0,0.0,1290.0,14.0,0.0,1.0,965.0,34.0,5.0,8.0,2625.0,39.0,7.0,2.0,3021.0,10.0,0.0,0.0,806.0,26.0,0.0,2.0,1111.0,22.0,1.0,1.0,1259.0,21.0,1.0,2.0,1753.0,23.0,8.0,5.0,1791.0,LaLiga,13.0,1.0,2.0,529.0,nan,nan,nan,nan,nan,nan,nan,nan,nan,nan,nan,nan,nan,nan,nan,nan,nan,nan,nan,nan,nan,nan,nan,nan,nan,nan,nan,nan,nan,nan,nan,nan,nan,nan,nan,nan,nan,nan,nan,nan,nan,nan,nan,nan,nan,nan,nan,nan,nan,nan,nan,nan,nan,nan,nan,nan,nan,nan,nan,nan,nan,nan,nan,nan,nan,nan,nan,nan,nan,nan,nan,nan,nan,nan,nan,nan,nan,nan,nan,nan,nan,nan,nan,nan,nan,nan,nan,nan
19/6/2011,Distel Zola,8432569,53,2/5/1989,22,0,0,0,0,2500,5084,3750,140,113,133196,182,76,DM/M C,2,3,2,2,1,3,1,3,1,2,2,6,8,11,6,11,7,13,9,6,8,12,9,11,13,12,14,14,12,12,14,12,15,9,11,7,13,14,16,11,13,13,11,6,13,12,20,15,15,14,10,14,10,8,11,14,16,14,14,14,14,6,1,1,16,12,1,1,16,DM/M C,311,1,1,1,12,1,1,1,1,1,20,16,1,1,1,1,0.0,0,0,0,0,0,0,0,0,0,0,0,0,0,0,0,0,0,0,0,0,0,0,0,0,0,0,0,0,0,0,0,0,0,0,0,0,0,0,0,0,0,0,0,0,0,0,0,0,Distel Zola,ÃÂ£360Th. ,31.0,189.0,Midfielder - Defensive Midfield,right,El Paso Locomotive FC,28.0,1.0,1.0,2170.0,17.0,1.0,1.0,1235.0,36.0,1.0,0.0,2520.0,33.0,0.0,0.0,2188.0,22.0,0.0,0.0,1491.0,3.0,0.0,0.0,138.0,16.0,0.0,1.0,939.0,nan,nan,nan,nan,27.0,0.0,0.0,2178.0,Ligue 1,11.0,0.0,0.0,460.0,nan,nan,nan,nan,nan,nan,nan,nan,nan,nan,nan,nan,nan,nan,nan,nan,nan,nan,nan,nan,nan,nan,nan,nan,nan,nan,nan,nan,nan,nan,nan,nan,nan,nan,nan,nan,nan,nan,nan,nan,nan,nan,nan,nan,nan,nan,nan,nan,nan,nan,nan,nan,nan,nan,nan,nan,nan,nan,nan,nan,nan,nan,nan,nan,nan,nan,nan,nan,nan,nan,nan,nan,nan,nan,nan,nan,nan,nan,nan,nan,nan,nan,nan,nan,nan,nan,nan,nan
19/6/2011,Diego Estrada,80001537,366,5/25/1989,22,3,0,12,2,2035,5000,4071,119,102,37071,169,65,AM C,3,1,1,3,1,1,1,1,2,1,2,13,12,14,7,15,11,6,8,5,5,15,13,6,16,7,11,6,13,10,16,12,10,16,8,10,7,13,9,13,15,9,4,20,10,10,8,8,6,8,4,8,6,10,10,6,7,14,11,12,5,5,1,1,15,20,1,1,20,AM C,501,1,1,1,20,1,1,1,1,1,1,15,1,1,1,1,524416.0,0,0,0,0,0,0,0,1,0,0,0,0,0,0,0,0,0,0,0,1,0,0,0,0,0,0,0,0,0,0,0,0,0,0,0,0,0,0,0,0,0,0,0,0,0,0,0,0,Dani Estrada,ÃÂ£2.25m ,33.0,179.0,Defender - Right-Back,right,Barakaldo CF,21.0,1.0,1.0,1806.0,32.0,2.0,1.0,2531.0,20.0,0.0,1.0,1060.0,5.0,0.0,0.0,405.0,1.0,0.0,0.0,0.0,21.0,1.0,0.0,1133.0,19.0,2.0,2.0,1670.0,35.0,1.0,0.0,2974.0,39.0,2.0,0.0,3510.0,LaLiga,26.0,3.0,0.0,2283.0,1.0,0.0,0.0,90.0,nan,nan,nan,nan,nan,nan,nan,nan,nan,nan,nan,nan,nan,nan,nan,nan,nan,nan,nan,nan,nan,nan,nan,nan,nan,nan,nan,nan,nan,nan,nan,nan,nan,nan,nan,nan,nan,nan,nan,nan,nan,nan,nan,nan,nan,nan,nan,nan,nan,nan,nan,nan,nan,nan,nan,nan,nan,nan,nan,nan,nan,nan,nan,nan,nan,nan,nan,nan,nan,nan,nan,nan,nan,nan,nan,nan,nan,nan,nan,nan,nan,nan,nan,nan
19/6/2011,Dani Parejo,67030707,796,4/16/1989,22,0,0,3,1,5000,6900,6900,160,141,3607321,180,75,M/AM C,1,1,1,1,1,1,1,1,1,2,2,17,16,16,11,17,17,4,15,4,5,16,12,7,16,13,13,14,16,13,17,14,12,15,6,13,10,14,14,10,14,11,10,14,12,10,20,13,11,13,15,12,8,8,9,15,14,13,12,11,11,8,1,1,20,18,10,10,20,M/AM C,411,1,1,3,18,10,10,1,1,1,13,20,8,8,1,1,67111040.0,0,0,0,0,0,0,0,1,0,0,0,1,0,0,0,0,0,0,0,0,0,0,0,0,0,0,1,0,0,0,0,0,0,0,0,0,0,0,0,0,0,0,0,0,0,0,0,0,Dani Parejo,ÃÂ£5.40m ,31.0,182.0,Midfielder - Central Midfield,right,Villarreal CF,44.0,4.0,6.0,3056.0,30.0,0.0,1.0,1643.0,36.0,2.0,7.0,2679.0,46.0,5.0,7.0,3678.0,37.0,11.0,8.0,3095.0,50.0,11.0,6.0,4096.0,39.0,6.0,9.0,3419.0,42.0,8.0,10.0,3618.0,56.0,10.0,9.0,4695.0,LaLiga,47.0,10.0,6.0,4140.0,6.0,1.0,0.0,540.0,29/6/2010,Daniel Parejo,67030707.0,796.0,4/16/1989,21.0,0.0,0.0,3.0,1.0,4556.0,6300.0,6300.0,155.0,135.0,7333442.0,180.0,75.0,M/AM C,3.0,2.0,2.0,3.0,3.0,2.0,1.0,7.0,1.0,3.0,2.0,17.0,15.0,14.0,14.0,17.0,17.0,4.0,14.0,4.0,5.0,16.0,12.0,7.0,16.0,14.0,11.0,14.0,16.0,12.0,17.0,12.0,12.0,15.0,6.0,13.0,9.0,12.0,14.0,10.0,13.0,11.0,10.0,13.0,12.0,10.0,20.0,13.0,11.0,10.0,15.0,12.0,9.0,8.0,9.0,15.0,14.0,13.0,12.0,11.0,11.0,8.0,Dani Parejo,ÃÂÃÂ£7.20m ,LaLiga,19-06-17,18.3.4.28,Dani Parejo,67030707,796,16-Apr-89,28,0,0,19,5,6000,7500,7500,159,155,54063671,182,74,DM/M/AM C,2,1,1,3,4,1,2,3,3,1,1,15,14,12,14,16,18,8,16,8,9,18,17,14,15,11,16,11,16,11,17,13,10,13,8,13,14,15,16,10,11,12,9,14,12,12,20,15,13,12,12,13,10,10,9,13,8,11,11,13,14,13,1,1,20,16,8,10,20,DM/M/AM C,431,1,1,1,16,1,1,1,1,1,18,20,10,8,1,1,3225946112.0,0,0,0,0,0,0,0,0,0,0,0,1,0,0,0,0,0,0,0,1,0,0,1,0,0,0,0,0,0,0,1,1,0,0,0,0,0,0,0,0,0,0,0,0,0,0,0,0,Dani Parejo,ÃÂ£18.00m ,31.0,182.0,Midfielder - Central Midfield,right,Villarreal CF,39.0,6.0,9.0,3419.0,42.0,8.0,10.0,3618.0,56.0,10.0,9.0,4695.0,47.0,10.0,6.0,4140.0,6.0,1.0,0.0,540.0,LaLiga,15-07-16,17.3.2.23,Dani Parejo,67030707.0,796.0,16-Apr-89,27.0,0.0,0.0,19.0,5.0,6000.0,7150.0,7150.0,158.0,149.0,19182916.0,180.0,75.0,DM/M/AM C,1.0,1.0,1.0,3.0,2.0,3.0,2.0,2.0,4.0,2.0,2.0,15.0,14.0,12.0,14.0,16.0,18.0,8.0,15.0,8.0,9.0,18.0,17.0,13.0,15.0,11.0,15.0,12.0,16.0,11.0,16.0,11.0,10.0,13.0,8.0,15.0,13.0,15.0,14.0,9.0,12.0,11.0,9.0,14.0,12.0,12.0,20.0,13.0,13.0,11.0,12.0,13.0,10.0,10.0,9.0,13.0,8.0,9.0,9.0,13.0,12.0,13.0,Dani Parejo,ÃÂ£13.50m ,LaLiga
19/6/2011,CauÃÂª,19029503,1651,5/24/1989,22,0,0,0,0,500,5400,5450,125,111,189597,186,81,DM/M C,3,1,1,3,1,1,1,1,2,2,1,9,9,8,8,10,8,13,10,11,11,10,8,13,11,13,12,12,13,12,9,11,12,7,10,11,12,16,14,12,11,16,15,7,14,11,20,14,16,12,10,10,7,10,10,7,8,10,11,12,13,15,1,1,18,1,1,1,18,DM/M C,311,1,1,1,1,1,1,1,1,1,20,18,1,1,1,1,0.0,0,0,0,0,0,0,0,0,0,0,0,0,0,0,0,0,0,0,0,0,0,0,0,0,0,0,0,0,0,0,0,0,0,0,0,0,0,0,0,0,0,0,0,0,0,0,0,0,CauÃÂª,ÃÂ£1.44m ,31.0,186.0,Midfielder - Defensive Midfield,right,Belenenses SAD,34.0,1.0,0.0,3064.0,35.0,5.0,0.0,3017.0,34.0,1.0,1.0,2379.0,19.0,2.0,0.0,1666.0,31.0,1.0,2.0,2397.0,26.0,0.0,1.0,1654.0,52.0,5.0,1.0,4341.0,15.0,3.0,1.0,1301.0,35.0,3.0,3.0,2780.0,Liga NOS,nan,nan,nan,nan,4.0,0.0,0.0,210.0,nan,nan,nan,nan,nan,nan,nan,nan,nan,nan,nan,nan,nan,nan,nan,nan,nan,nan,nan,nan,nan,nan,nan,nan,nan,nan,nan,nan,nan,nan,nan,nan,nan,nan,nan,nan,nan,nan,nan,nan,nan,nan,nan,nan,nan,nan,nan,nan,nan,nan,nan,nan,nan,nan,nan,nan,nan,nan,nan,nan,nan,nan,nan,nan,nan,nan,nan,nan,nan,nan,nan,nan,nan,nan,nan,nan,nan,nan,nan,nan,nan,nan,nan,nan
19/6/2011,Axel Witsel,8169215,757,1/12/1989,22,19,5,12,0,6500,7000,7100,165,142,6324111,183,73,M C,2,1,1,1,3,2,3,2,3,3,3,10,12,14,12,15,11,13,12,8,8,14,18,5,15,11,14,11,14,16,14,15,13,15,9,16,15,16,15,13,11,14,10,10,15,15,20,12,10,15,14,15,9,17,14,15,12,10,14,9,11,6,9,1,20,13,13,12,20,M C,401,1,1,10,12,11,13,9,1,1,14,20,12,13,1,1,549756000000.0,0,0,0,0,0,0,0,0,0,0,0,0,0,0,0,0,0,0,0,0,0,0,0,0,0,0,0,0,0,0,0,0,0,0,0,0,0,0,0,1,0,0,0,0,0,0,0,0,Axel Witsel,ÃÂ£12.60m ,31.0,188.0,Midfielder - Defensive Midfield,right,Borussia Dortmund,43.0,12.0,6.0,3816.0,49.0,5.0,6.0,3911.0,34.0,5.0,1.0,2845.0,43.0,4.0,4.0,3624.0,42.0,6.0,1.0,3495.0,41.0,6.0,5.0,3600.0,52.0,5.0,6.0,4467.0,18.0,2.0,1.0,1645.0,43.0,6.0,1.0,3703.0,Liga NOS,39.0,4.0,5.0,3216.0,7.0,0.0,0.0,552.0,nan,nan,nan,nan,nan,nan,nan,nan,nan,nan,nan,nan,nan,nan,nan,nan,nan,nan,nan,nan,nan,nan,nan,nan,nan,nan,nan,nan,nan,nan,nan,nan,nan,nan,nan,nan,nan,nan,nan,nan,nan,nan,nan,nan,nan,nan,nan,nan,nan,nan,nan,nan,nan,nan,nan,nan,nan,nan,nan,nan,nan,nan,nan,nan,nan,nan,nan,nan,nan,nan,nan,nan,nan,nan,nan,nan,nan,nan,nan,nan,nan,nan,nan,nan
19/6/2011,Ander Iturraspe,67037562,796,3/8/1989,22,0,0,0,0,4350,6250,6250,144,128,236277,187,75,M C,3,1,2,1,1,1,2,2,3,3,1,4,10,12,10,13,6,12,13,7,9,13,8,11,14,10,11,12,11,12,14,13,13,11,11,10,11,15,13,13,11,12,14,14,11,13,20,13,13,12,7,12,7,11,13,12,14,13,10,10,6,5,1,1,20,14,14,1,20,M C,401,1,1,1,14,1,1,1,1,1,10,20,1,14,1,1,0.0,0,0,0,0,0,0,0,0,0,0,0,0,0,0,0,0,0,0,0,0,0,0,0,0,0,0,0,0,0,0,0,0,0,0,0,0,0,0,0,0,0,0,0,0,0,0,0,0,Ander Iturraspe,ÃÂ£3.15m ,31.0,187.0,Midfielder - Defensive Midfield,right,Without Club,18.0,0.0,0.0,624.0,58.0,1.0,0.0,4524.0,41.0,0.0,1.0,3098.0,38.0,0.0,3.0,3145.0,38.0,2.0,0.0,2759.0,28.0,0.0,2.0,1423.0,32.0,0.0,1.0,1589.0,38.0,0.0,0.0,2445.0,5.0,0.0,0.0,260.0,LaLiga,18.0,0.0,0.0,975.0,nan,nan,nan,nan,29/6/2010,Ander Iturraspe,67037562.0,796.0,3/8/1989,21.0,0.0,0.0,0.0,0.0,3906.0,5750.0,5750.0,142.0,125.0,2125509.0,187.0,75.0,M C,3.0,1.0,2.0,2.0,3.0,2.0,3.0,3.0,1.0,1.0,1.0,10.0,10.0,12.0,10.0,13.0,9.0,12.0,13.0,7.0,9.0,13.0,10.0,11.0,13.0,10.0,11.0,12.0,11.0,11.0,14.0,12.0,13.0,11.0,11.0,9.0,9.0,15.0,13.0,13.0,11.0,12.0,14.0,14.0,11.0,13.0,20.0,12.0,12.0,11.0,7.0,12.0,7.0,11.0,11.0,13.0,9.0,13.0,10.0,10.0,9.0,5.0,Ander Iturraspe,ÃÂÃÂ£1.80m ,LaLiga,19-06-17,18.3.4.28,Ander Iturraspe,67037562,796,08-Mar-89,28,1,0,0,0,5250,7150,7150,149,143,32581673,187,75,DM/M C,2,1,1,2,2,1,1,3,2,2,2,4,11,12,7,14,6,10,12,7,15,15,11,14,13,14,16,14,15,14,13,14,14,8,13,12,17,13,16,11,11,8,14,12,10,13,20,15,14,14,7,12,14,7,12,12,14,13,11,13,10,5,1,1,19,1,1,1,19,DM/M C,311,1,1,1,1,1,1,1,1,1,20,19,1,1,1,1,524352.0,0,0,0,0,0,0,1,0,0,0,0,0,0,0,0,0,0,0,0,1,0,0,0,0,0,0,0,0,0,0,0,0,0,0,0,0,0,0,0,0,0,0,0,0,0,0,0,0,Ander Iturraspe,ÃÂ£4.50m ,31.0,187.0,Midfielder - Defensive Midfield,right,Without Club,32.0,0.0,1.0,1589.0,38.0,0.0,0.0,2445.0,5.0,0.0,0.0,260.0,18.0,0.0,0.0,975.0,nan,nan,nan,nan,LaLiga,15-07-16,17.3.2.23,Ander Iturraspe,67037562.0,796.0,08-Mar-89,27.0,1.0,0.0,0.0,0.0,5250.0,7150.0,7150.0,149.0,143.0,32581673.0,187.0,75.0,DM/M C,3.0,3.0,1.0,1.0,2.0,1.0,1.0,1.0,2.0,2.0,1.0,4.0,11.0,12.0,7.0,14.0,6.0,10.0,12.0,7.0,15.0,15.0,11.0,14.0,13.0,14.0,16.0,14.0,15.0,14.0,13.0,15.0,14.0,8.0,13.0,12.0,17.0,13.0,16.0,11.0,11.0,8.0,14.0,12.0,10.0,13.0,20.0,15.0,14.0,14.0,7.0,12.0,14.0,7.0,9.0,12.0,14.0,13.0,11.0,13.0,10.0,5.0,Ander Iturraspe,ÃÂ£4.50m ,LaLiga
19/6/2011,Almog Cohen,42004287,775,9/1/1988,22,7,0,14,0,5200,6600,6400,144,128,568194,169,65,DM/M C,2,2,3,2,3,2,2,1,1,1,1,9,8,11,9,13,10,5,14,8,14,13,7,14,15,14,13,15,11,12,10,13,16,8,11,11,13,14,17,14,12,9,6,9,12,13,20,15,10,15,5,11,12,8,17,14,13,14,17,15,16,4,1,1,18,12,1,1,18,DM/M C,311,1,1,1,12,1,1,1,1,1,20,18,1,1,1,1,65536.0,0,0,0,0,0,0,0,0,0,0,0,0,0,0,0,0,1,0,0,0,0,0,0,0,0,0,0,0,0,0,0,0,0,0,0,0,0,0,0,0,0,0,0,0,0,0,0,0,Almog Cohen,ÃÂ£1.80m ,32.0,170.0,Midfielder - Central Midfield,right,Maccabi Netanya,27.0,2.0,0.0,1703.0,26.0,0.0,0.0,1236.0,22.0,1.0,1.0,1527.0,25.0,1.0,2.0,1983.0,5.0,0.0,0.0,141.0,20.0,0.0,2.0,825.0,33.0,7.0,2.0,2638.0,30.0,3.0,1.0,2359.0,22.0,1.0,0.0,1712.0,Bundesliga,25.0,0.0,1.0,1977.0,1.0,0.0,0.0,90.0,29/6/2010,Almog Cohen,42004287.0,775.0,9/1/1988,21.0,0.0,0.0,17.0,0.0,2500.0,6545.0,5950.0,130.0,119.0,923119.0,170.0,65.0,DM C,2.0,3.0,1.0,1.0,2.0,1.0,1.0,2.0,3.0,2.0,2.0,11.0,11.0,12.0,10.0,12.0,11.0,10.0,13.0,10.0,14.0,15.0,7.0,13.0,15.0,11.0,12.0,11.0,9.0,10.0,13.0,13.0,9.0,8.0,12.0,12.0,13.0,12.0,11.0,12.0,9.0,8.0,11.0,9.0,10.0,13.0,20.0,12.0,10.0,15.0,6.0,11.0,4.0,8.0,8.0,19.0,10.0,5.0,14.0,8.0,12.0,2.0,Almog Cohen,ÃÂÃÂ£2.70m ,Bundesliga
19/6/2011,Adrien,55001975,788,3/15/1989,22,0,0,14,1,3250,5750,6000,135,113,113253,175,75,DM/M C,3,2,2,2,2,3,3,4,1,2,1,13,13,12,12,14,11,9,12,8,8,14,11,11,13,12,14,12,15,15,16,14,14,11,10,13,15,14,13,10,12,11,8,8,14,10,20,12,9,16,8,13,7,13,14,14,16,13,15,16,17,5,1,1,20,10,5,5,20,DM/M C,421,1,1,1,10,1,1,1,1,1,17,20,5,5,1,1,16777280.0,0,0,0,0,0,0,1,0,0,0,0,0,0,0,0,0,0,0,0,0,0,0,0,0,1,0,0,0,0,0,0,0,0,0,0,0,0,0,0,0,0,0,0,0,0,0,0,0,AdriÃÂ¡n, ,33.0,190.0,Goalkeeper,right,Liverpool FC,9.0,6.0,4.0,810.0,11.0,12.0,5.0,990.0,32.0,46.0,11.0,2869.0,26.0,42.0,7.0,2340.0,42.0,54.0,10.0,3781.0,36.0,44.0,10.0,3300.0,19.0,36.0,6.0,1710.0,22.0,31.0,8.0,1980.0,5.0,8.0,2.0,450.0,LaLiga,18.0,24.0,3.0,1563.0,5.0,11.0,2.0,450.0,nan,nan,nan,nan,nan,nan,nan,nan,nan,nan,nan,nan,nan,nan,nan,nan,nan,nan,nan,nan,nan,nan,nan,nan,nan,nan,nan,nan,nan,nan,nan,nan,nan,nan,nan,nan,nan,nan,nan,nan,nan,nan,nan,nan,nan,nan,nan,nan,nan,nan,nan,nan,nan,nan,nan,nan,nan,nan,nan,nan,nan,nan,nan,nan,nan,nan,nan,nan,nan,nan,nan,nan,nan,nan,nan,nan,nan,nan,nan,nan,nan,nan,nan,nan,19-06-17,18.3.4.28,Adrien Silva,55001975,788,15-Mar-89,28,20,1,13,1,6500,7900,7900,159,158,112056939,175,73,M C,4,3,3,2,1,3,1,1,4,3,1,15,12,12,12,15,12,9,15,8,15,15,18,16,14,17,15,16,15,17,14,15,18,11,17,13,16,18,18,11,12,14,10,11,15,11,20,17,12,18,13,14,7,14,12,12,19,15,18,13,11,5,1,1,20,12,1,1,20,M C,401,1,1,1,12,1,1,1,1,1,12,20,1,1,1,1,64.0,0,0,0,0,0,0,1,0,0,0,0,0,0,0,0,0,0,0,0,0,0,0,0,0,0,0,0,0,0,0,0,0,0,0,0,0,0,0,0,0,0,0,0,0,0,0,0,0,Adrien Silva,ÃÂ£18.00m ,31.0,175.0,Midfielder - Central Midfield,right,UC Sampdoria,36.0,6.0,4.0,2857.0,22.0,1.0,2.0,1436.0,20.0,0.0,1.0,1506.0,25.0,0.0,2.0,1404.0,1.0,0.0,0.0,32.0,Premier League,15-07-16,17.3.2.23,Adrien Silva,55001975.0,788.0,15-Mar-89,27.0,14.0,0.0,13.0,1.0,6500.0,7850.0,7850.0,159.0,157.0,70269579.0,175.0,73.0,M C,3.0,2.0,2.0,1.0,1.0,2.0,2.0,3.0,2.0,1.0,1.0,15.0,12.0,12.0,12.0,15.0,12.0,9.0,15.0,8.0,15.0,15.0,18.0,16.0,14.0,17.0,15.0,16.0,15.0,17.0,14.0,15.0,18.0,11.0,17.0,13.0,16.0,18.0,18.0,11.0,12.0,14.0,10.0,11.0,15.0,11.0,20.0,17.0,12.0,18.0,13.0,14.0,7.0,14.0,12.0,12.0,19.0,15.0,18.0,13.0,11.0,5.0,Adrien Silva,ÃÂ£22.50m ,Liga NOS
19/6/2011,Adam Matuszczyk,35014358,787,2/14/1989,22,10,1,4,0,3900,6500,6200,145,124,307212,183,73,DM C,1,1,1,3,3,2,2,5,1,1,2,10,9,11,10,10,13,10,15,10,12,12,11,11,13,11,13,12,14,13,12,12,13,9,13,9,13,14,13,12,12,13,11,15,14,11,20,12,11,13,13,12,6,12,12,13,15,13,14,11,12,8,8,7,15,7,10,7,15,DM C,301,1,1,1,7,1,3,8,5,5,20,15,5,10,7,7,0.0,0,0,0,0,0,0,0,0,0,0,0,0,0,0,0,0,0,0,0,0,0,0,0,0,0,0,0,0,0,0,0,0,0,0,0,0,0,0,0,0,0,0,0,0,0,0,0,0,Adam Matuschyk,ÃÂ£1.80m ,31.0,183.0,Midfielder - Defensive Midfield,both,1.FC DÃÂ¼ren,27.0,2.0,1.0,1766.0,20.0,1.0,0.0,629.0,30.0,1.0,1.0,2183.0,25.0,1.0,0.0,1462.0,13.0,0.0,0.0,615.0,32.0,1.0,3.0,2507.0,2.0,0.0,0.0,92.0,34.0,0.0,1.0,2678.0,27.0,0.0,1.0,2165.0,Bundesliga,25.0,1.0,0.0,1914.0,1.0,0.0,0.0,37.0,29/6/2010,Adam Matuszczyk,35014358.0,787.0,2/14/1989,21.0,3.0,0.0,1.0,0.0,3250.0,5500.0,5850.0,145.0,118.0,1503055.0,183.0,73.0,DM C,2.0,1.0,3.0,3.0,1.0,3.0,1.0,1.0,3.0,2.0,2.0,10.0,9.0,11.0,9.0,10.0,11.0,10.0,12.0,5.0,12.0,12.0,11.0,11.0,13.0,11.0,13.0,12.0,13.0,13.0,11.0,12.0,10.0,9.0,13.0,9.0,13.0,14.0,13.0,12.0,12.0,12.0,11.0,15.0,14.0,10.0,20.0,12.0,11.0,13.0,13.0,12.0,10.0,12.0,12.0,12.0,15.0,5.0,5.0,9.0,6.0,15.0,Adam Matuschyk,ÃÂÃÂ£2.70m ,Bundesliga
19/6/2011,Zdravko Kuzmanovic,5727648,802,9/22/1987,23,38,4,0,0,6500,7150,7050,159,141,3481159,186,72,DM/M C,3,1,2,2,3,1,2,4,3,2,1,9,14,8,13,14,13,12,15,10,9,16,15,11,14,9,14,12,17,17,14,16,9,8,13,10,12,18,12,8,8,17,14,13,16,13,20,15,14,14,12,11,3,12,16,15,8,15,12,5,14,9,1,1,20,8,12,10,20,DM/M C,421,1,1,1,8,1,1,1,1,1,18,20,10,12,1,1,35184400000000.0,0,0,0,0,0,0,0,0,0,0,0,0,0,0,0,0,0,0,0,0,0,0,1,0,0,0,0,0,0,0,0,0,0,0,0,0,0,0,0,0,0,0,0,0,0,1,0,0,Zdravko Kuzmanovic,ÃÂ£8.10m ,33.0,186.0,Midfielder - Central Midfield,right,Retired,47.0,11.0,6.0,3689.0,29.0,6.0,3.0,2001.0,31.0,0.0,4.0,2023.0,16.0,0.0,0.0,924.0,25.0,1.0,5.0,1482.0,34.0,0.0,0.0,2286.0,4.0,0.0,0.0,216.0,8.0,0.0,1.0,482.0,17.0,2.0,1.0,841.0,Bundesliga,5.0,0.0,1.0,158.0,nan,nan,nan,nan,29/6/2010,Zdravko Kuzmanovic,5727648.0,802.0,9/22/1987,22.0,31.0,4.0,0.0,0.0,4600.0,7100.0,7150.0,161.0,143.0,12497048.0,186.0,72.0,DM/M RC,3.0,3.0,2.0,1.0,2.0,1.0,1.0,6.0,1.0,3.0,1.0,9.0,13.0,8.0,12.0,14.0,11.0,12.0,13.0,8.0,11.0,16.0,12.0,12.0,14.0,13.0,15.0,16.0,14.0,14.0,14.0,16.0,11.0,8.0,12.0,11.0,13.0,18.0,16.0,9.0,8.0,17.0,13.0,13.0,16.0,12.0,20.0,17.0,14.0,14.0,12.0,11.0,3.0,12.0,16.0,15.0,11.0,15.0,12.0,12.0,10.0,12.0,Zdravko Kuzmanovic,ÃÂÃÂ£7.65m ,Bundesliga,19-06-17,18.3.4.28,Zdravko Kuzmanovic,5727648,802,22-Sep-87,29,50,6,4,0,5750,6750,6750,136,135,10621421,185,81,DM/M C,3,2,4,2,2,3,1,2,4,3,2,10,12,13,11,14,13,13,15,10,12,16,12,14,14,13,14,11,13,13,15,13,10,10,11,12,15,15,12,10,10,8,13,13,10,10,20,12,15,10,8,11,10,12,13,14,10,9,12,12,12,13,1,1,20,8,10,10,20,DM/M C,421,1,1,1,8,1,1,1,1,1,17,20,10,10,1,1,8796100000000.0,0,0,0,0,0,0,0,0,0,0,0,0,0,0,0,0,0,0,0,0,0,0,1,0,0,0,0,0,0,0,0,0,0,0,0,0,0,0,0,0,0,0,0,1,0,0,0,0,Zdravko Kuzmanovic,ÃÂ£540Th. ,33.0,186.0,Midfielder - Central Midfield,right,Retired,4.0,0.0,0.0,216.0,8.0,0.0,1.0,482.0,17.0,2.0,1.0,841.0,5.0,0.0,1.0,158.0,nan,nan,nan,nan,LaLiga,15-07-16,17.3.2.23,Zdravko Kuzmanovic,5727648.0,802.0,22-Sep-87,28.0,50.0,6.0,4.0,0.0,5500.0,6750.0,6750.0,136.0,135.0,9168206.0,185.0,81.0,DM/M C,3.0,1.0,3.0,3.0,4.0,2.0,4.0,3.0,1.0,4.0,1.0,10.0,12.0,13.0,11.0,14.0,13.0,13.0,15.0,10.0,12.0,16.0,12.0,14.0,14.0,13.0,14.0,11.0,13.0,13.0,15.0,13.0,11.0,8.0,11.0,12.0,15.0,15.0,12.0,10.0,10.0,8.0,13.0,13.0,10.0,10.0,20.0,12.0,15.0,12.0,8.0,11.0,10.0,12.0,13.0,14.0,10.0,9.0,12.0,12.0,12.0,13.0,Zdravko Kuzmanovic,ÃÂ£900Th. ,LaLiga
19/6/2011,Wesley,19040469,1651,6/24/1987,23,2,0,0,0,5600,7000,7050,156,140,3503470,179,63,DM/M RC,3,1,2,3,1,3,3,3,1,1,1,12,14,13,9,15,7,8,10,10,13,15,11,12,15,17,10,15,8,10,10,8,15,14,10,13,9,14,18,17,16,8,9,14,14,15,20,17,7,12,7,11,12,17,14,13,13,12,11,8,12,5,14,12,20,15,15,1,20,DM/M RC,423,1,1,10,15,1,10,1,1,14,18,20,1,15,1,12,1074790484.0,0,0,1,0,1,0,1,0,0,0,0,0,0,0,0,0,0,0,0,0,1,0,0,0,0,0,0,0,0,0,1,0,0,0,0,0,0,0,0,0,0,0,0,0,0,0,0,0,Wesley,ÃÂ£4.05m ,33.0,179.0,Midfielder - Central Midfield,right,AvaÃÂ­ Futebol Clube (SC),25.0,1.0,3.0,1945.0,10.0,1.0,1.0,461.0,34.0,7.0,9.0,2823.0,26.0,2.0,2.0,2089.0,27.0,1.0,2.0,1530.0,30.0,1.0,1.0,1915.0,12.0,0.0,0.0,714.0,17.0,0.0,1.0,919.0,33.0,0.0,1.0,2859.0,Bundesliga,1.0,0.0,0.0,13.0,nan,nan,nan,nan,29/6/2010,Wesley,19040469.0,1651.0,6/24/1987,23.0,0.0,0.0,0.0,0.0,4000.0,7500.0,7050.0,160.0,141.0,17473182.0,179.0,63.0,DM/M C,1.0,1.0,2.0,3.0,1.0,3.0,2.0,2.0,1.0,2.0,2.0,12.0,14.0,13.0,9.0,16.0,7.0,8.0,11.0,10.0,13.0,16.0,11.0,9.0,15.0,17.0,15.0,16.0,8.0,9.0,14.0,9.0,15.0,14.0,10.0,13.0,11.0,12.0,18.0,17.0,15.0,8.0,9.0,14.0,14.0,15.0,20.0,12.0,9.0,12.0,7.0,11.0,12.0,17.0,14.0,13.0,13.0,12.0,11.0,8.0,12.0,5.0,Wesley,ÃÂÃÂ£7.20m ,Bundesliga
19/6/2011,VÃÂ­tor Gomes,55003648,788,12/25/1987,23,0,0,1,0,2500,5750,5750,130,115,646344,184,80,M C,1,1,2,1,3,1,2,8,3,2,3,12,13,12,10,14,12,11,13,10,10,12,13,10,13,13,13,13,12,13,13,13,14,13,13,12,13,13,14,11,11,14,14,8,14,11,20,13,14,14,9,12,7,14,12,13,15,12,13,11,11,8,1,1,20,10,1,1,20,M C,401,1,1,1,10,1,1,1,1,1,10,20,1,1,1,1,0.0,0,0,0,0,0,0,0,0,0,0,0,0,0,0,0,0,0,0,0,0,0,0,0,0,0,0,0,0,0,0,0,0,0,0,0,0,0,0,0,0,0,0,0,0,0,0,0,0,VÃÂ­tor Gomes,ÃÂ£1.35m ,32.0,182.0,Midfielder - Central Midfield,right,Omonia Nicosia,18.0,0.0,0.0,1073.0,28.0,2.0,1.0,2163.0,28.0,0.0,1.0,1800.0,27.0,1.0,1.0,2159.0,33.0,3.0,1.0,2520.0,33.0,3.0,4.0,2764.0,31.0,0.0,3.0,2440.0,33.0,5.0,3.0,2533.0,38.0,4.0,4.0,2974.0,Liga NOS,19.0,1.0,1.0,1583.0,11.0,0.0,1.0,835.0,29/6/2010,VÃÂÃÂ­tor Gomes,55003648.0,788.0,12/25/1987,22.0,0.0,0.0,1.0,0.0,2500.0,5750.0,5750.0,130.0,115.0,1967131.0,184.0,80.0,M/AM C,2.0,2.0,2.0,1.0,1.0,2.0,2.0,5.0,1.0,3.0,2.0,12.0,13.0,12.0,10.0,14.0,12.0,11.0,13.0,10.0,10.0,12.0,13.0,10.0,13.0,13.0,13.0,13.0,12.0,13.0,13.0,13.0,14.0,13.0,13.0,12.0,13.0,13.0,14.0,11.0,11.0,14.0,14.0,8.0,14.0,11.0,20.0,13.0,14.0,14.0,9.0,12.0,7.0,14.0,19.0,13.0,15.0,12.0,13.0,11.0,11.0,8.0,VÃÂÃÂ­tor Gomes,ÃÂÃÂ£1.08m ,Liga NOS,19-06-17,18.3.4.28,VÃÂ­tor Gomes,55003648,788,25-Dec-87,29,0,0,1,0,4100,6200,6200,126,124,588174,182,75,M C,3,2,3,2,3,3,1,4,2,2,3,12,12,10,8,13,12,10,12,10,10,13,13,12,13,13,13,15,12,14,12,13,16,13,14,14,13,15,15,11,11,14,12,10,14,11,20,14,12,14,9,12,7,14,13,13,15,12,15,11,11,7,1,1,20,13,1,1,20,M C,401,1,1,1,13,1,1,1,1,1,9,20,1,1,1,1,4194304.0,0,0,0,0,0,0,0,0,0,0,0,0,0,0,0,0,0,0,0,0,0,0,1,0,0,0,0,0,0,0,0,0,0,0,0,0,0,0,0,0,0,0,0,0,0,0,0,0,VÃÂ­tor Gomes,ÃÂ£720Th. ,32.0,182.0,Midfielder - Central Midfield,right,Omonia Nicosia,31.0,0.0,3.0,2440.0,33.0,5.0,3.0,2533.0,38.0,4.0,4.0,2974.0,19.0,1.0,1.0,1583.0,11.0,0.0,1.0,835.0,Liga NOS,15-07-16,17.3.2.23,VÃÂ­tor Gomes,55003648.0,788.0,25-Dec-87,28.0,0.0,0.0,1.0,0.0,4100.0,6200.0,6200.0,126.0,124.0,511481.0,182.0,75.0,M C,1.0,1.0,3.0,1.0,2.0,2.0,2.0,2.0,1.0,2.0,1.0,12.0,12.0,10.0,8.0,13.0,12.0,10.0,12.0,10.0,10.0,13.0,13.0,12.0,13.0,13.0,13.0,15.0,12.0,14.0,12.0,13.0,16.0,13.0,14.0,14.0,13.0,15.0,15.0,11.0,11.0,14.0,12.0,10.0,14.0,11.0,20.0,14.0,12.0,14.0,9.0,12.0,7.0,14.0,17.0,13.0,15.0,12.0,15.0,11.0,11.0,8.0,VÃÂ­tor Gomes,ÃÂ£720Th. ,Liga NOS
19/6/2011,Vincent Nogueira,8440962,769,1/16/1988,23,0,0,1,0,4700,5877,5877,149,130,456119,170,60,DM/M/AM RC,3,2,2,1,3,2,3,1,2,2,1,11,12,13,8,14,11,6,14,8,8,13,7,7,14,7,13,12,13,13,13,13,13,12,8,12,12,14,15,15,14,11,5,10,8,13,20,15,6,13,7,15,15,15,8,13,15,15,15,15,15,5,8,8,20,16,16,10,20,DM/M/AM RC,433,1,1,1,1,10,16,1,1,8,18,20,10,16,1,8,0.0,0,0,0,0,0,0,0,0,0,0,0,0,0,0,0,0,0,0,0,0,0,0,0,0,0,0,0,0,0,0,0,0,0,0,0,0,0,0,0,0,0,0,0,0,0,0,0,0,Vincent Nogueira,ÃÂ£1.80m ,32.0,170.0,Midfielder - Central Midfield,right,Retired,26.0,1.0,1.0,758.0,31.0,2.0,1.0,2315.0,32.0,2.0,3.0,2511.0,50.0,3.0,5.0,4056.0,31.0,5.0,2.0,2444.0,9.0,2.0,0.0,757.0,27.0,1.0,4.0,1854.0,7.0,0.0,0.0,400.0,2.0,0.0,0.0,47.0,Ligue 1,5.0,0.0,0.0,431.0,nan,nan,nan,nan,29/6/2010,Vincent Nogueira,8440962.0,769.0,1/16/1988,22.0,0.0,0.0,1.0,0.0,3782.0,5500.0,5500.0,145.0,123.0,3103978.0,170.0,60.0,DM/M/AM RC,1.0,2.0,3.0,1.0,3.0,1.0,1.0,1.0,3.0,3.0,3.0,8.0,12.0,13.0,6.0,14.0,7.0,5.0,10.0,8.0,5.0,13.0,7.0,7.0,14.0,7.0,13.0,12.0,13.0,13.0,13.0,12.0,13.0,12.0,8.0,11.0,10.0,14.0,15.0,15.0,14.0,11.0,5.0,10.0,8.0,13.0,20.0,15.0,6.0,13.0,7.0,15.0,15.0,15.0,15.0,13.0,15.0,15.0,15.0,15.0,15.0,5.0,Vincent Nogueira,ÃÂÃÂ£1.08m ,Ligue 1,19-06-17,18.3.4.28,Vincent Nogueira,8440962,769,16-Jan-88,29,0,0,1,0,3250,6050,6050,130,115,2924314,170,60,DM/M/AM RC,1,1,1,1,1,5,1,1,1,1,1,11,12,12,8,14,11,5,13,6,8,13,10,7,14,7,13,12,13,12,13,13,13,12,8,12,12,14,14,12,14,11,5,10,8,13,20,14,6,13,7,14,12,15,11,13,15,15,15,15,15,5,8,8,20,16,16,10,20,DM/M/AM RC,433,1,1,1,10,10,16,1,1,8,18,20,10,16,1,8,0.0,0,0,0,0,0,0,0,0,0,0,0,0,0,0,0,0,0,0,0,0,0,0,0,0,0,0,0,0,0,0,0,0,0,0,0,0,0,0,0,0,0,0,0,0,0,0,0,0,Vincent Nogueira,ÃÂ£1.35m ,32.0,170.0,Midfielder - Central Midfield,right,Retired,27.0,1.0,4.0,1854.0,7.0,0.0,0.0,400.0,2.0,0.0,0.0,47.0,5.0,0.0,0.0,431.0,nan,nan,nan,nan,Ligue 1,nan,nan,nan,nan,nan,nan,nan,nan,nan,nan,nan,nan,nan,nan,nan,nan,nan,nan,nan,nan,nan,nan,nan,nan,nan,nan,nan,nan,nan,nan,nan,nan,nan,nan,nan,nan,nan,nan,nan,nan,nan,nan,nan,nan,nan,nan,nan,nan,nan,nan,nan,nan,nan,nan,nan,nan,nan,nan,nan,nan,nan,nan,nan,nan,nan,nan,nan,nan,nan,nan,nan,nan,nan,nan,nan,nan,nan,nan,nan,nan,nan,nan,nan,nan,nan
19/6/2011,Vicente Iborra,67010183,796,1/16/1988,23,0,0,0,0,4100,6500,6250,145,127,592119,190,76,DM/M C,2,2,2,3,1,3,1,4,3,3,3,9,10,11,8,13,8,14,9,6,8,14,12,12,14,13,13,14,13,14,14,13,12,14,10,11,14,15,14,12,10,15,14,9,14,13,20,15,14,14,12,14,8,9,14,15,14,10,14,15,10,6,1,1,20,14,1,1,20,DM/M C,421,1,1,8,14,1,1,1,1,1,18,20,1,1,1,1,524320.0,0,0,0,0,0,1,0,0,0,0,0,0,0,0,0,0,0,0,0,1,0,0,0,0,0,0,0,0,0,0,0,0,0,0,0,0,0,0,0,0,0,0,0,0,0,0,0,0,Vicente Iborra,ÃÂ£2.25m ,32.0,190.0,Midfielder - Central Midfield,right,Villarreal CF,16.0,0.0,0.0,1261.0,38.0,1.0,1.0,2752.0,49.0,7.0,2.0,4275.0,40.0,4.0,4.0,2994.0,41.0,9.0,2.0,3001.0,47.0,9.0,3.0,2840.0,44.0,8.0,4.0,2373.0,27.0,4.0,2.0,2154.0,36.0,5.0,2.0,2420.0,LaLiga,37.0,1.0,3.0,2808.0,8.0,0.0,0.0,493.0,29/6/2010,Vicente Iborra,67010183.0,796.0,1/16/1988,22.0,0.0,0.0,0.0,0.0,3900.0,5750.0,5750.0,145.0,128.0,2613001.0,190.0,76.0,DM/M C,2.0,1.0,1.0,1.0,2.0,3.0,3.0,1.0,1.0,3.0,2.0,9.0,10.0,12.0,10.0,14.0,8.0,14.0,12.0,6.0,8.0,15.0,12.0,12.0,15.0,13.0,13.0,15.0,12.0,13.0,14.0,12.0,12.0,14.0,10.0,12.0,14.0,15.0,14.0,12.0,11.0,15.0,14.0,8.0,13.0,13.0,20.0,15.0,14.0,14.0,12.0,14.0,8.0,9.0,14.0,15.0,14.0,10.0,14.0,15.0,10.0,6.0,Vicente Iborra,ÃÂÃÂ£1.80m ,LaLiga,19-06-17,18.3.4.28,Vicente Iborra,67010183,796,16-Jan-88,29,0,0,0,0,6000,7250,7450,150,149,69946659,190,77,DM/M C,2,3,1,3,3,4,3,2,1,3,3,6,8,7,11,13,8,16,12,6,15,13,11,15,13,13,15,15,15,17,14,14,16,12,14,10,17,18,18,10,10,14,16,12,15,11,20,16,17,19,12,14,8,15,14,15,15,12,16,14,8,6,10,1,19,12,1,1,19,DM/M C,311,1,1,12,12,1,1,10,1,1,20,19,1,1,1,1,2148007936.0,0,0,0,0,0,0,0,0,0,0,0,0,0,0,0,0,0,0,0,1,0,0,0,0,0,0,0,0,0,0,0,1,0,0,0,0,0,0,0,0,0,0,0,0,0,0,0,0,Vicente Iborra,ÃÂ£9.00m ,32.0,190.0,Midfielder - Central Midfield,right,Villarreal CF,44.0,8.0,4.0,2373.0,27.0,4.0,2.0,2154.0,36.0,5.0,2.0,2420.0,37.0,1.0,3.0,2808.0,8.0,0.0,0.0,493.0,Premier League,15-07-16,17.3.2.23,Vicente Iborra,67010183.0,796.0,16-Jan-88,28.0,0.0,0.0,0.0,0.0,5150.0,7250.0,7250.0,150.0,145.0,19467879.0,190.0,77.0,DM/M C,2.0,1.0,1.0,1.0,2.0,3.0,1.0,3.0,1.0,1.0,1.0,6.0,8.0,7.0,11.0,11.0,8.0,16.0,12.0,6.0,15.0,12.0,11.0,15.0,13.0,13.0,15.0,15.0,16.0,18.0,13.0,14.0,16.0,12.0,14.0,11.0,17.0,18.0,18.0,10.0,10.0,14.0,16.0,12.0,15.0,11.0,20.0,16.0,17.0,19.0,12.0,14.0,8.0,15.0,14.0,15.0,15.0,12.0,16.0,14.0,8.0,6.0,Vicente Iborra,ÃÂ£8.10m ,LaLiga
19/6/2011,TomÃÂ¡s RincÃÂ³n,86000589,1658,1/13/1988,23,38,0,6,0,5500,6600,6400,135,124,741109,175,71,DM/M C,1,1,2,2,1,3,1,5,2,1,1,5,9,10,5,12,5,9,8,15,19,11,7,17,12,19,8,18,9,14,7,7,18,5,11,8,9,17,19,14,15,16,11,10,13,13,20,17,13,10,10,8,11,14,12,10,14,15,17,10,8,6,14,10,18,1,14,1,18,DM/M C,311,1,1,1,1,1,1,1,1,14,20,18,1,10,1,10,138513000000.0,0,0,0,0,0,0,1,0,0,0,0,0,0,0,0,1,0,0,0,0,0,0,0,0,0,0,0,0,0,0,1,0,0,0,0,0,0,1,0,0,0,0,0,0,0,0,0,0,TomÃÂ¡s RincÃÂ³n,ÃÂ£3.60m ,32.0,177.0,Midfielder - Defensive Midfield,right,Torino FC,21.0,0.0,0.0,1268.0,29.0,0.0,1.0,2202.0,20.0,0.0,0.0,933.0,26.0,0.0,0.0,1775.0,31.0,0.0,2.0,2521.0,34.0,3.0,4.0,3050.0,36.0,0.0,4.0,2093.0,38.0,1.0,0.0,3110.0,37.0,4.0,0.0,2994.0,Bundesliga,39.0,1.0,4.0,3107.0,4.0,0.0,1.0,349.0,29/6/2010,TomÃÂ¡s RincÃÂ³n,86000589.0,1658.0,1/13/1988,22.0,19.0,0.0,8.0,1.0,2600.0,4949.0,4250.0,135.0,110.0,2048679.0,175.0,71.0,DM C,1.0,2.0,2.0,1.0,1.0,2.0,1.0,5.0,1.0,1.0,1.0,9.0,9.0,13.0,11.0,13.0,9.0,9.0,13.0,7.0,13.0,13.0,9.0,13.0,13.0,7.0,13.0,10.0,12.0,9.0,12.0,13.0,10.0,5.0,14.0,9.0,13.0,10.0,13.0,8.0,13.0,13.0,3.0,10.0,8.0,13.0,20.0,10.0,7.0,10.0,5.0,4.0,5.0,10.0,11.0,5.0,13.0,11.0,2.0,8.0,4.0,6.0,TomÃÂÃÂ¡s RincÃÂÃÂ³n,ÃÂÃÂ£1.80m ,Bundesliga,19-06-17,18.3.4.28,TomÃÂ¡s RincÃÂ³n,86000589,1658,13-Jan-88,29,83,0,6,0,5250,7000,7000,143,140,10906722,177,76,DM/M C,4,3,2,1,1,3,2,2,2,2,1,5,9,14,5,13,5,11,7,5,17,13,7,16,13,19,13,18,10,15,10,11,18,5,12,9,14,15,19,13,15,17,11,10,16,12,20,18,15,16,16,15,6,14,18,13,15,12,15,10,15,6,8,9,20,6,12,1,20,DM/M C,421,1,1,1,1,1,6,1,1,8,19,20,1,12,1,9,137440000000.0,0,0,0,0,0,0,0,0,0,0,0,0,0,0,0,1,0,0,0,1,0,0,0,0,0,0,0,0,0,0,0,0,0,0,0,0,0,1,0,0,0,0,0,0,0,0,0,0,TomÃÂ¡s RincÃÂ³n,ÃÂ£7.20m ,32.0,177.0,Midfielder - Defensive Midfield,right,Torino FC,36.0,0.0,4.0,2093.0,38.0,1.0,0.0,3110.0,37.0,4.0,0.0,2994.0,39.0,1.0,4.0,3107.0,4.0,0.0,1.0,349.0,Serie A,15-07-16,17.3.2.23,TomÃÂ¡s RincÃÂ³n,86000589.0,1658.0,13-Jan-88,28.0,80.0,0.0,6.0,0.0,5500.0,7100.0,7050.0,142.0,141.0,11214417.0,175.0,75.0,DM/M C,4.0,3.0,4.0,2.0,1.0,1.0,4.0,2.0,3.0,2.0,3.0,5.0,9.0,14.0,5.0,13.0,5.0,11.0,7.0,5.0,19.0,14.0,7.0,18.0,13.0,19.0,13.0,18.0,10.0,15.0,8.0,11.0,18.0,5.0,12.0,9.0,11.0,15.0,19.0,12.0,15.0,17.0,11.0,10.0,16.0,12.0,20.0,18.0,15.0,16.0,16.0,15.0,6.0,14.0,18.0,13.0,15.0,12.0,15.0,10.0,15.0,6.0,TomÃÂ¡s RincÃÂ³n,ÃÂ£7.20m ,Serie A
19/6/2011,Tiago Terroso,55008432,788,1/13/1988,23,0,0,0,0,1250,4500,4500,121,106,107428,178,78,M/AM LC,2,2,2,2,2,2,2,2,2,3,3,13,13,13,10,13,12,9,11,8,10,13,13,11,13,10,13,10,12,11,13,12,12,11,9,12,13,13,13,12,12,12,10,20,12,13,5,11,10,12,7,10,7,12,16,12,15,11,13,14,14,6,1,1,17,20,1,17,20,M/AM LC,524,1,1,1,20,5,1,1,1,1,1,16,17,1,1,1,0.0,0,0,0,0,0,0,0,0,0,0,0,0,0,0,0,0,0,0,0,0,0,0,0,0,0,0,0,0,0,0,0,0,0,0,0,0,0,0,0,0,0,0,0,0,0,0,0,0,Tiago Terroso,ÃÂ£900Th. ,32.0,178.0,Midfielder - Defensive Midfield,left,AD Esposende,36.0,4.0,0.0,2988.0,18.0,0.0,0.0,1101.0,18.0,0.0,0.0,1267.0,19.0,1.0,1.0,996.0,1.0,0.0,0.0,22.0,nan,nan,nan,nan,nan,nan,nan,nan,nan,nan,nan,nan,nan,nan,nan,nan,Liga NOS,nan,nan,nan,nan,nan,nan,nan,nan,nan,nan,nan,nan,nan,nan,nan,nan,nan,nan,nan,nan,nan,nan,nan,nan,nan,nan,nan,nan,nan,nan,nan,nan,nan,nan,nan,nan,nan,nan,nan,nan,nan,nan,nan,nan,nan,nan,nan,nan,nan,nan,nan,nan,nan,nan,nan,nan,nan,nan,nan,nan,nan,nan,nan,nan,nan,nan,nan,nan,nan,nan,nan,nan,nan,nan,nan,nan,nan,nan,nan,nan,nan,nan,nan,nan,nan,nan,nan,nan,nan,nan,nan,nan
19/6/2011,Steven Defour,8163457,757,4/15/1988,23,29,1,0,0,6400,6750,6750,155,135,4263203,174,69,DM/M C,3,2,3,2,3,2,3,2,2,3,1,15,13,11,8,14,12,6,11,5,6,16,15,8,14,18,13,16,13,17,17,15,18,14,19,10,14,19,19,12,12,9,7,10,18,13,20,18,10,17,7,14,14,10,12,18,13,12,15,8,12,15,1,1,19,14,11,10,19,DM/M C,311,1,1,10,14,10,11,1,1,1,20,19,10,11,1,1,17956928.0,0,0,0,0,0,0,1,0,0,0,0,0,0,0,0,0,0,1,0,0,1,0,0,0,1,0,0,0,0,0,0,0,0,0,0,0,0,0,0,0,0,0,0,0,0,0,0,0,Steven Defour,ÃÂ£9.90m ,32.0,175.0,Midfielder - Central Midfield,right,KV Mechelen,32.0,3.0,10.0,2623.0,38.0,2.0,2.0,1789.0,40.0,4.0,2.0,2179.0,36.0,1.0,4.0,2508.0,39.0,7.0,9.0,3003.0,42.0,3.0,10.0,3616.0,28.0,3.0,5.0,1632.0,25.0,1.0,1.0,2009.0,9.0,0.0,0.0,681.0,Liga NOS,12.0,0.0,1.0,736.0,0.0,0.0,0.0,0.0,nan,nan,nan,nan,nan,nan,nan,nan,nan,nan,nan,nan,nan,nan,nan,nan,nan,nan,nan,nan,nan,nan,nan,nan,nan,nan,nan,nan,nan,nan,nan,nan,nan,nan,nan,nan,nan,nan,nan,nan,nan,nan,nan,nan,nan,nan,nan,nan,nan,nan,nan,nan,nan,nan,nan,nan,nan,nan,nan,nan,nan,nan,nan,nan,nan,nan,nan,nan,nan,nan,nan,nan,nan,nan,nan,nan,nan,nan,nan,nan,nan,nan,nan,nan,19-06-17,18.3.4.28,Steven Defour,8163457,757,15-Apr-88,29,50,2,0,0,6100,6750,7200,145,144,54003482,174,69,DM/M C,3,1,3,1,1,3,1,1,1,3,1,13,14,11,8,15,13,9,13,8,9,15,14,14,15,16,17,16,17,15,15,15,15,14,16,10,16,14,14,11,12,11,9,10,12,11,20,13,12,16,14,14,12,13,18,16,12,15,6,10,12,10,1,1,19,14,6,7,19,DM/M C,311,1,1,1,14,5,5,1,1,1,20,19,7,6,1,1,18481216.0,0,0,0,0,0,0,1,0,0,0,0,0,0,0,0,0,0,1,0,1,1,0,0,0,1,0,0,0,0,0,0,0,0,0,0,0,0,0,0,0,0,0,0,0,0,0,0,0,Steven Defour,ÃÂ£6.30m ,32.0,175.0,Midfielder - Central Midfield,right,KV Mechelen,28.0,3.0,5.0,1632.0,25.0,1.0,1.0,2009.0,9.0,0.0,0.0,681.0,12.0,0.0,1.0,736.0,0.0,0.0,0.0,0.0,Premier League,15-07-16,17.3.2.23,Steven Defour,8163457.0,757.0,15-Apr-88,28.0,47.0,2.0,0.0,0.0,6000.0,6550.0,6900.0,145.0,138.0,24786863.0,174.0,69.0,DM/M C,3.0,1.0,3.0,1.0,3.0,2.0,1.0,1.0,1.0,1.0,4.0,14.0,14.0,11.0,8.0,15.0,13.0,9.0,13.0,8.0,9.0,15.0,14.0,14.0,15.0,16.0,14.0,16.0,16.0,15.0,15.0,14.0,15.0,14.0,16.0,10.0,14.0,15.0,14.0,12.0,12.0,8.0,8.0,10.0,11.0,13.0,20.0,11.0,12.0,14.0,14.0,14.0,15.0,13.0,18.0,16.0,12.0,15.0,6.0,10.0,12.0,10.0,Steven Defour,ÃÂ£5.40m ,Premier League
19/6/2011,StÃÂ©nio,55038353,12,5/6/1988,23,0,0,0,0,1020,4500,3500,104,93,33212,182,85,DM/M C,2,2,3,2,1,2,2,6,1,3,2,9,6,11,8,13,9,9,12,2,11,12,9,11,13,13,12,4,11,9,10,12,8,4,3,12,13,12,13,13,10,11,11,8,4,10,20,8,4,10,11,10,10,10,5,18,8,13,15,18,5,9,1,1,20,7,7,1,20,DM/M C,421,1,1,1,7,1,1,1,1,1,18,20,1,7,1,1,0.0,0,0,0,0,0,0,0,0,0,0,0,0,0,0,0,0,0,0,0,0,0,0,0,0,0,0,0,0,0,0,0,0,0,0,0,0,0,0,0,0,0,0,0,0,0,0,0,0,Stenio,ÃÂ£720Th. ,32.0,179.0,Midfielder - Central Midfield,right,UD SantarÃÂ©m,4.0,0.0,0.0,227.0,25.0,0.0,0.0,1620.0,33.0,3.0,1.0,2657.0,33.0,2.0,0.0,2206.0,34.0,6.0,1.0,2911.0,32.0,2.0,0.0,2384.0,30.0,1.0,0.0,2323.0,11.0,2.0,1.0,754.0,nan,nan,nan,nan,Liga NOS,nan,nan,nan,nan,nan,nan,nan,nan,nan,nan,nan,nan,nan,nan,nan,nan,nan,nan,nan,nan,nan,nan,nan,nan,nan,nan,nan,nan,nan,nan,nan,nan,nan,nan,nan,nan,nan,nan,nan,nan,nan,nan,nan,nan,nan,nan,nan,nan,nan,nan,nan,nan,nan,nan,nan,nan,nan,nan,nan,nan,nan,nan,nan,nan,nan,nan,nan,nan,nan,nan,nan,nan,nan,nan,nan,nan,nan,nan,nan,nan,nan,nan,nan,nan,nan,nan,nan,nan,nan,nan,nan,nan
19/6/2011,Samir Nasri,8428584,769,6/26/1987,23,22,2,6,0,7500,8000,8450,175,164,18254545,177,75,M/AM RLC,3,3,2,1,2,3,1,7,2,1,2,12,12,17,15,17,15,5,13,2,6,15,12,9,17,12,14,12,15,12,15,15,16,17,10,16,8,13,13,15,18,18,8,15,15,14,20,15,9,13,6,14,12,14,14,16,14,14,13,14,11,10,1,1,17,20,18,18,20,M/AM RLC,526,1,1,1,20,18,18,1,1,1,10,17,16,16,1,1,554051000000.0,0,0,0,0,0,0,0,0,0,0,1,0,0,0,0,0,0,0,0,1,0,0,0,0,0,0,0,0,0,0,0,0,1,0,0,0,0,0,0,1,0,0,0,0,0,0,0,0,Samir Nasri,ÃÂ£22.50m ,33.0,177.0,Midfielder - Attacking Midfield,right,Without Club,46.0,15.0,5.0,3416.0,46.0,6.0,9.0,3280.0,38.0,5.0,9.0,2472.0,46.0,11.0,12.0,3277.0,33.0,3.0,7.0,2100.0,13.0,2.0,3.0,619.0,31.0,3.0,3.0,2415.0,8.0,2.0,1.0,720.0,6.0,0.0,2.0,303.0,Premier League,9.0,2.0,0.0,594.0,nan,nan,nan,nan,29/6/2010,Samir Nasri,8428584.0,769.0,6/26/1987,23.0,15.0,2.0,6.0,0.0,6320.0,7154.0,8050.0,175.0,159.0,-1.0,177.0,75.0,M/AM RLC,3.0,1.0,3.0,3.0,1.0,2.0,2.0,4.0,1.0,1.0,3.0,12.0,12.0,16.0,14.0,17.0,15.0,5.0,13.0,2.0,6.0,15.0,12.0,10.0,16.0,12.0,14.0,12.0,15.0,12.0,15.0,13.0,16.0,14.0,10.0,16.0,8.0,13.0,13.0,15.0,16.0,16.0,8.0,15.0,15.0,14.0,20.0,15.0,9.0,13.0,6.0,14.0,12.0,14.0,14.0,16.0,14.0,14.0,14.0,14.0,11.0,8.0,Samir Nasri,ÃÂÃÂ£22.50m ,Premier League
19/6/2011,Roman NeustÃÂ¤dter,91002404,771,2/18/1988,23,0,0,2,1,3750,6300,6300,137,116,264449,190,83,D/DM/M C,1,3,3,3,2,3,3,4,2,3,3,5,8,11,6,7,5,13,6,14,16,8,5,17,9,15,13,17,7,10,10,7,13,5,12,8,15,16,18,8,13,14,17,10,11,14,20,18,15,11,5,11,5,14,13,1,11,9,11,11,10,8,16,1,18,1,1,1,18,D/DM/M C,331,1,1,1,1,1,1,16,1,1,20,18,1,1,1,1,0.0,0,0,0,0,0,0,0,0,0,0,0,0,0,0,0,0,0,0,0,0,0,0,0,0,0,0,0,0,0,0,0,0,0,0,0,0,0,0,0,0,0,0,0,0,0,0,0,0,Roman NeustÃÂ¤dter,ÃÂ£3.15m ,32.0,188.0,Midfielder - Defensive Midfield,right,Dynamo Moscow,28.0,1.0,1.0,2058.0,38.0,0.0,2.0,3429.0,41.0,4.0,2.0,3503.0,44.0,2.0,5.0,3553.0,38.0,2.0,0.0,3192.0,38.0,0.0,1.0,3034.0,33.0,0.0,1.0,2019.0,44.0,5.0,0.0,3884.0,31.0,2.0,0.0,2685.0,Bundesliga,21.0,0.0,1.0,1742.0,2.0,0.0,0.0,102.0,29/6/2010,Roman NeustÃÂ¤dter,91002404.0,771.0,2/18/1988,22.0,0.0,0.0,2.0,1.0,1650.0,5500.0,5500.0,135.0,107.0,2028538.0,190.0,83.0,D/DM C,3.0,1.0,3.0,3.0,2.0,2.0,3.0,3.0,1.0,2.0,3.0,5.0,4.0,6.0,11.0,6.0,4.0,15.0,7.0,12.0,13.0,11.0,5.0,13.0,12.0,8.0,11.0,12.0,10.0,12.0,5.0,13.0,10.0,4.0,14.0,5.0,13.0,10.0,9.0,12.0,12.0,14.0,17.0,5.0,11.0,11.0,20.0,13.0,14.0,11.0,5.0,11.0,5.0,7.0,9.0,17.0,18.0,6.0,12.0,17.0,13.0,8.0,Roman NeustÃÂÃÂ¤dter,ÃÂÃÂ£1.13m ,Bundesliga
19/6/2011,Ricardo Alvarez,14009787,1649,4/12/1988,23,0,0,0,0,4100,5850,6400,160,128,4054265,188,73,M/AM LC,1,2,2,3,1,2,1,4,3,2,3,11,12,16,12,12,12,10,16,5,6,14,11,8,16,9,9,10,10,10,13,13,12,17,7,13,10,11,11,14,15,12,12,20,13,13,11,13,11,12,11,12,15,14,10,15,12,13,15,11,8,10,1,1,17,20,14,20,17,M/AM LC,524,1,1,7,15,20,14,1,1,1,1,17,10,9,1,1,562984000000000.0,0,0,0,0,0,0,0,0,1,0,0,0,0,0,0,0,0,0,0,0,0,0,0,0,0,0,0,0,0,0,0,0,0,0,0,1,0,0,0,0,0,0,0,0,0,0,0,0,Ricardo ÃÂlvarez,ÃÂ£10.35m ,32.0,188.0,Midfielder - Attacking Midfield,left,Club AtlÃÂ©tico VÃÂ©lez Sarsfield,38.0,5.0,7.0,1855.0,29.0,3.0,6.0,1532.0,30.0,7.0,3.0,1556.0,31.0,4.0,8.0,2230.0,17.0,1.0,0.0,725.0,13.0,1.0,1.0,809.0,23.0,3.0,1.0,1097.0,15.0,1.0,1.0,419.0,14.0,0.0,2.0,606.0,Serie A,7.0,2.0,1.0,309.0,nan,nan,nan,nan,nan,nan,nan,nan,nan,nan,nan,nan,nan,nan,nan,nan,nan,nan,nan,nan,nan,nan,nan,nan,nan,nan,nan,nan,nan,nan,nan,nan,nan,nan,nan,nan,nan,nan,nan,nan,nan,nan,nan,nan,nan,nan,nan,nan,nan,nan,nan,nan,nan,nan,nan,nan,nan,nan,nan,nan,nan,nan,nan,nan,nan,nan,nan,nan,nan,nan,nan,nan,nan,nan,nan,nan,nan,nan,nan,nan,nan,nan,nan,nan,nan,nan,nan,nan,19-06-17,18.3.4.28,Ricky ÃÂÃÂ¼ÃÂlvarez,14009787,1649,12-Apr-88,29,9,1,0,0,5400,6450,6400,149,128,9006517,188,84,AM C,3,2,3,1,2,4,1,2,1,4,1,14,13,16,12,15,12,10,12,5,7,15,13,12,16,9,12,13,14,10,14,13,11,17,8,16,10,13,12,12,12,14,13,20,10,12,8,12,12,11,11,12,12,15,12,13,13,12,15,8,12,10,1,1,15,20,14,13,20,AM C,501,1,1,8,20,13,14,1,1,1,1,15,11,11,1,1,18176300000000.0,0,0,0,0,0,0,0,0,1,0,0,0,0,0,0,0,0,0,0,0,0,0,0,0,0,0,0,0,0,0,0,0,0,0,0,1,0,0,0,1,0,0,0,0,1,0,0,0,nan,nan,nan,nan,nan,nan,nan,nan,nan,nan,nan,nan,nan,nan,nan,nan,nan,nan,nan,nan,nan,nan,nan,nan,nan,nan,nan,nan,nan,nan,nan,nan,nan,nan,nan,nan,nan,nan,nan,nan,nan,nan,nan,nan,nan,nan,nan,nan,nan,nan,nan,nan,nan,nan,nan,nan,nan,nan,nan,nan,nan,nan,nan,nan,nan,nan,nan,nan,nan,nan,nan,nan,nan,nan,nan,nan,nan,nan,nan,nan,nan,nan,nan,nan,nan,nan,nan,nan,nan,nan,nan,nan,nan,nan,nan,nan,nan,nan,nan,nan,nan,nan,nan,nan,nan,nan,nan,nan,nan,nan,nan,nan,nan
19/6/2011,Radja Nainggolan,8169332,757,5/4/1988,23,1,0,10,1,5000,6461,7250,166,143,2516699,175,65,DM/M/AM C,2,2,3,2,2,2,3,2,1,2,3,8,10,12,12,12,11,9,14,10,13,14,10,16,14,18,15,18,13,15,11,14,20,11,14,13,13,16,15,13,14,15,7,9,15,13,20,17,16,16,15,15,9,20,16,14,16,16,17,15,12,14,1,1,20,18,14,14,20,DM/M/AM C,431,1,1,1,18,13,13,1,1,1,16,20,14,14,1,1,279173000000.0,0,0,0,0,0,0,0,0,0,0,0,0,0,0,0,1,0,0,0,0,0,0,0,0,0,0,0,0,0,0,0,0,1,0,0,0,0,0,1,0,0,0,0,0,0,0,0,0,Radja Nainggolan,ÃÂ£11.70m ,32.0,176.0,Midfielder - Attacking Midfield,right,Inter Milan,38.0,2.0,2.0,2981.0,39.0,1.0,2.0,3364.0,35.0,2.0,2.0,3064.0,38.0,4.0,3.0,3282.0,46.0,5.0,6.0,3714.0,42.0,6.0,2.0,3525.0,53.0,14.0,6.0,4229.0,42.0,6.0,11.0,3580.0,36.0,7.0,3.0,2443.0,Serie A,29.0,6.0,7.0,2279.0,2.0,0.0,0.0,26.0,29/6/2010,Radja Nainggolan,8169332.0,757.0,5/4/1988,22.0,1.0,0.0,8.0,1.0,3250.0,5579.0,5600.0,141.0,124.0,371958.0,175.0,65.0,M/AM RLC,3.0,3.0,2.0,3.0,3.0,3.0,1.0,7.0,1.0,1.0,2.0,4.0,11.0,13.0,10.0,12.0,12.0,8.0,12.0,8.0,11.0,14.0,11.0,14.0,14.0,15.0,13.0,13.0,11.0,12.0,10.0,13.0,9.0,12.0,10.0,11.0,10.0,12.0,14.0,14.0,14.0,14.0,7.0,5.0,15.0,13.0,20.0,15.0,14.0,15.0,15.0,11.0,11.0,20.0,7.0,14.0,7.0,10.0,11.0,11.0,10.0,13.0,Radja Nainggolan,ÃÂÃÂ£4.50m ,Serie A,19-06-17,18.3.4.28,Radja Nainggolan,8169332,757,04-May-88,29,28,6,13,1,7500,8000,8500,170,170,232186002,176,77,M/AM C,3,1,1,1,3,3,1,2,1,1,2,7,10,13,14,15,8,11,16,5,15,14,10,19,14,19,15,19,15,16,13,14,18,13,14,16,13,14,18,16,15,18,9,12,18,14,20,17,16,16,15,15,4,15,16,14,14,16,8,11,12,18,1,1,20,18,1,1,20,M/AM C,411,1,1,1,18,1,1,1,1,1,15,20,1,1,1,1,137439000000.0,0,0,0,0,1,0,0,0,1,1,0,0,0,0,0,1,0,0,0,0,0,0,0,0,0,0,0,0,0,0,0,0,0,0,0,0,0,1,0,0,0,0,0,0,0,0,0,0,Radja Nainggolan,ÃÂ£40.50m ,32.0,176.0,Midfielder - Attacking Midfield,right,Inter Milan,53.0,14.0,6.0,4229.0,42.0,6.0,11.0,3580.0,36.0,7.0,3.0,2443.0,29.0,6.0,7.0,2279.0,2.0,0.0,0.0,26.0,Serie A,15-07-16,17.3.2.23,Radja Nainggolan,8169332.0,757.0,04-May-88,28.0,24.0,6.0,13.0,1.0,6750.0,8250.0,8200.0,170.0,165.0,106905102.0,176.0,65.0,M/AM C,2.0,2.0,2.0,3.0,3.0,4.0,2.0,2.0,1.0,2.0,1.0,7.0,10.0,13.0,14.0,15.0,8.0,8.0,15.0,8.0,14.0,14.0,10.0,19.0,15.0,19.0,13.0,20.0,13.0,13.0,13.0,14.0,18.0,13.0,14.0,16.0,12.0,15.0,20.0,16.0,15.0,17.0,8.0,11.0,16.0,13.0,20.0,17.0,15.0,15.0,17.0,14.0,6.0,16.0,16.0,14.0,16.0,16.0,10.0,11.0,10.0,17.0,Radja Nainggolan,ÃÂ£36.00m ,Serie A
19/6/2011,Pierre de Wit,8728369,771,9/26/1987,23,0,0,0,0,2360,6150,6150,137,123,508237,172,72,DM/M/AM C,1,1,3,2,1,3,1,2,3,1,2,13,14,12,11,14,12,6,12,4,4,15,12,7,15,11,14,13,9,12,13,12,14,13,9,12,4,12,12,13,13,8,7,16,12,13,20,12,9,12,6,11,15,14,11,15,12,12,15,13,11,8,1,1,20,17,13,13,20,DM/M/AM C,431,1,1,1,17,13,13,1,1,1,18,20,13,13,1,1,3072.0,0,0,0,0,0,0,0,0,0,0,1,1,0,0,0,0,0,0,0,0,0,0,0,0,0,0,0,0,0,0,0,0,0,0,0,0,0,0,0,0,0,0,0,0,0,0,0,0,Pierre De Wit,ÃÂ£1.35m ,33.0,171.0,Midfielder - Central Midfield,both,Retired,17.0,0.0,2.0,952.0,28.0,3.0,1.0,1981.0,8.0,0.0,0.0,587.0,39.0,4.0,11.0,3364.0,14.0,0.0,0.0,714.0,2.0,0.0,0.0,92.0,nan,nan,nan,nan,nan,nan,nan,nan,nan,nan,nan,nan,Bundesliga,nan,nan,nan,nan,nan,nan,nan,nan,29/6/2010,Pierre de Wit,8728369.0,771.0,9/26/1987,22.0,0.0,0.0,0.0,0.0,2300.0,6000.0,6000.0,137.0,120.0,1955347.0,172.0,70.0,DM/M C,1.0,2.0,2.0,3.0,2.0,3.0,2.0,3.0,3.0,1.0,3.0,13.0,14.0,12.0,11.0,15.0,12.0,6.0,13.0,4.0,4.0,15.0,12.0,7.0,15.0,11.0,14.0,14.0,9.0,12.0,13.0,10.0,14.0,13.0,9.0,12.0,4.0,12.0,12.0,14.0,13.0,8.0,8.0,16.0,12.0,13.0,20.0,12.0,9.0,13.0,6.0,11.0,17.0,15.0,11.0,15.0,12.0,12.0,15.0,13.0,11.0,8.0,Pierre De Wit,ÃÂÃÂ£675Th. ,Bundesliga
19/6/2011,Nacho Cases,67018616,796,12/22/1987,23,0,0,0,0,4150,6150,6150,143,128,428653,172,65,M C,1,2,3,1,3,1,3,3,1,2,3,13,11,13,8,13,13,7,12,9,10,15,10,13,14,7,14,13,13,13,15,15,10,14,9,13,9,11,13,13,13,15,8,20,11,12,7,13,12,14,7,12,9,10,9,14,5,7,14,9,7,13,1,1,20,10,5,5,20,M C,401,1,1,1,10,2,2,1,1,1,10,20,5,5,1,1,0.0,0,0,0,0,0,0,0,0,0,0,0,0,0,0,0,0,0,0,0,0,0,0,0,0,0,0,0,0,0,0,0,0,0,0,0,0,0,0,0,0,0,0,0,0,0,0,0,0,Nacho Cases,ÃÂ£1.62m ,32.0,175.0,Midfielder - Central Midfield,left,AEK Larnaca,36.0,4.0,2.0,2978.0,22.0,0.0,5.0,1422.0,34.0,3.0,1.0,2546.0,28.0,2.0,5.0,2136.0,33.0,2.0,3.0,2774.0,25.0,1.0,0.0,2012.0,23.0,2.0,1.0,1642.0,25.0,0.0,1.0,1289.0,25.0,1.0,0.0,1595.0,LaLiga,26.0,2.0,2.0,1654.0,nan,nan,nan,nan,nan,nan,nan,nan,nan,nan,nan,nan,nan,nan,nan,nan,nan,nan,nan,nan,nan,nan,nan,nan,nan,nan,nan,nan,nan,nan,nan,nan,nan,nan,nan,nan,nan,nan,nan,nan,nan,nan,nan,nan,nan,nan,nan,nan,nan,nan,nan,nan,nan,nan,nan,nan,nan,nan,nan,nan,nan,nan,nan,nan,nan,nan,nan,nan,nan,nan,nan,nan,nan,nan,nan,nan,nan,nan,nan,nan,nan,nan,nan,nan,nan,nan,nan,nan
19/6/2011,Michael Bradley,980486,390,7/31/1987,23,59,9,25,5,6500,6550,6500,145,130,379447,185,82,DM/M C,1,1,1,1,1,1,1,1,1,1,1,6,9,7,15,11,10,12,13,9,17,11,13,14,10,17,17,18,9,9,10,8,17,6,13,16,11,18,19,8,10,14,14,12,16,16,20,19,13,10,14,17,12,13,15,18,8,12,19,9,7,4,1,1,20,14,8,8,20,DM/M C,421,1,1,1,14,1,1,1,1,1,17,20,8,8,1,1,139586000000.0,0,0,0,0,0,1,1,0,0,0,0,0,0,0,0,1,0,0,0,0,0,0,0,0,0,0,0,0,0,0,0,1,0,0,0,0,0,1,0,0,0,0,0,0,0,0,0,0,Michael Bradley,ÃÂ£3.15m ,33.0,189.0,Midfielder - Central Midfield,right,Toronto FC,27.0,4.0,3.0,2030.0,36.0,1.0,1.0,3043.0,35.0,1.0,2.0,2682.0,38.0,4.0,1.0,2963.0,28.0,5.0,3.0,2504.0,30.0,2.0,4.0,2760.0,38.0,0.0,3.0,3420.0,43.0,0.0,4.0,3847.0,35.0,3.0,1.0,3152.0,Serie A,10.0,0.0,0.0,880.0,nan,nan,nan,nan,29/6/2010,Michael Bradley,980486.0,390.0,7/31/1987,22.0,48.0,8.0,25.0,5.0,4422.0,6100.0,6650.0,154.0,133.0,6625405.0,186.0,84.0,DM/M C,1.0,1.0,1.0,1.0,1.0,1.0,1.0,1.0,1.0,1.0,1.0,6.0,8.0,7.0,15.0,10.0,11.0,12.0,14.0,8.0,17.0,11.0,12.0,14.0,10.0,17.0,17.0,18.0,9.0,9.0,12.0,8.0,17.0,6.0,12.0,16.0,13.0,18.0,19.0,8.0,10.0,14.0,14.0,12.0,16.0,16.0,20.0,19.0,13.0,10.0,14.0,14.0,12.0,13.0,15.0,17.0,9.0,12.0,18.0,10.0,7.0,4.0,Michael Bradley,ÃÂÃÂ£4.50m ,Premier League
19/6/2011,Mauricio Isla,75000523,1652,6/12/1988,23,24,1,1,0,4700,7450,7450,164,150,2330937,175,72,D/WB/DM/M RC,2,3,1,2,2,3,2,3,2,1,3,7,10,14,8,14,6,6,7,7,11,13,10,15,12,18,16,16,12,15,14,12,15,10,13,17,12,17,18,15,14,14,6,9,15,15,20,18,11,14,12,13,3,19,17,15,13,13,12,12,9,6,16,20,17,1,20,7,17,D/WB/DM/M RC,243,1,1,1,1,1,1,1,1,16,17,17,1,14,7,20,1048608.0,0,0,0,0,0,1,0,0,0,0,0,0,0,0,0,0,0,0,0,0,1,0,0,0,0,0,0,0,0,0,0,0,0,0,0,0,0,0,0,0,0,0,0,0,0,0,0,0,Mauricio Isla,ÃÂ£12.60m ,32.0,176.0,Defender - Right-Back,right,Clube de Regatas do Flamengo,35.0,3.0,7.0,2938.0,28.0,3.0,2.0,2239.0,21.0,0.0,3.0,1302.0,27.0,0.0,2.0,1582.0,27.0,0.0,2.0,2161.0,39.0,2.0,2.0,3125.0,35.0,1.0,8.0,2958.0,29.0,0.0,3.0,1942.0,37.0,0.0,7.0,3001.0,Serie A,37.0,0.0,7.0,2900.0,nan,nan,nan,nan,29/6/2010,Mauricio Isla,75000523.0,1652.0,6/12/1988,22.0,16.0,0.0,1.0,0.0,4500.0,6950.0,6950.0,167.0,139.0,36277081.0,175.0,72.0,D/WB/DM/M RC,3.0,2.0,3.0,1.0,3.0,3.0,3.0,8.0,2.0,3.0,3.0,7.0,8.0,14.0,8.0,12.0,6.0,6.0,7.0,7.0,10.0,11.0,10.0,14.0,13.0,18.0,16.0,15.0,9.0,14.0,13.0,12.0,15.0,10.0,14.0,15.0,11.0,16.0,18.0,15.0,14.0,14.0,6.0,9.0,15.0,15.0,20.0,18.0,9.0,14.0,12.0,13.0,3.0,20.0,17.0,15.0,11.0,12.0,12.0,12.0,9.0,6.0,Mauricio Isla,ÃÂÃÂ£9.00m ,Serie A
19/6/2011,Mato Jajalo,24004081,761,5/25/1988,23,0,0,28,5,4000,5759,6400,145,128,710790,182,77,M RC,1,2,2,1,2,3,3,1,3,1,2,11,11,13,10,13,10,12,15,11,10,13,10,12,14,12,12,13,10,13,15,11,12,12,10,12,10,14,14,12,14,14,12,8,16,13,20,14,14,14,4,14,3,12,13,12,12,12,13,14,12,6,5,9,20,10,15,12,20,M RC,403,1,1,3,10,6,6,5,3,3,15,20,12,15,7,9,0.0,0,0,0,0,0,0,0,0,0,0,0,0,0,0,0,0,0,0,0,0,0,0,0,0,0,0,0,0,0,0,0,0,0,0,0,0,0,0,0,0,0,0,0,0,0,0,0,0,Mato Jajalo,ÃÂ£2.03m ,32.0,182.0,Midfielder - Defensive Midfield,right,Udinese Calcio,33.0,2.0,4.0,2423.0,33.0,5.0,2.0,2420.0,26.0,0.0,3.0,1364.0,21.0,1.0,5.0,1523.0,48.0,3.0,9.0,3507.0,29.0,0.0,1.0,2124.0,26.0,1.0,1.0,1861.0,41.0,1.0,5.0,3368.0,35.0,3.0,3.0,3103.0,Bundesliga,28.0,0.0,0.0,1831.0,nan,nan,nan,nan,29/6/2010,Mato Jajalo,24004081.0,761.0,5/25/1988,22.0,0.0,0.0,25.0,3.0,3750.0,5579.0,6150.0,136.0,124.0,3199999.0,182.0,77.0,M C,2.0,1.0,1.0,1.0,3.0,3.0,3.0,2.0,1.0,2.0,2.0,11.0,11.0,14.0,9.0,12.0,8.0,12.0,13.0,7.0,8.0,13.0,10.0,11.0,13.0,12.0,12.0,13.0,10.0,13.0,14.0,12.0,9.0,11.0,10.0,12.0,10.0,14.0,14.0,12.0,14.0,14.0,12.0,8.0,16.0,13.0,20.0,14.0,14.0,14.0,4.0,14.0,3.0,10.0,11.0,13.0,10.0,8.0,3.0,7.0,14.0,14.0,Mato Jajalo,ÃÂÃÂ£2.25m ,Bundesliga
19/6/2011,Marvin Martin,8440961,769,1/10/1988,23,2,2,10,1,6500,7350,6600,165,147,3363656,171,63,M/AM C,2,1,2,3,2,3,1,4,3,2,3,15,14,14,7,16,14,7,13,6,4,16,12,7,16,9,13,12,14,14,17,15,15,14,10,13,10,15,16,14,15,12,6,12,16,13,20,17,7,15,9,15,7,10,8,15,15,16,14,17,17,8,1,1,20,18,10,13,20,M/AM C,411,1,1,1,18,13,10,1,1,1,12,20,13,10,1,1,17592200000000.0,0,0,0,0,0,0,0,1,0,0,0,0,0,0,0,0,0,0,0,0,0,0,1,0,1,0,0,0,0,0,0,0,0,0,0,0,0,0,0,0,0,0,0,0,1,0,0,0,Marvin Martin,ÃÂ£8.55m ,32.0,171.0,Midfielder - Attacking Midfield,right,FC Chambly,41.0,4.0,18.0,3659.0,36.0,2.0,9.0,3069.0,45.0,0.0,8.0,3306.0,22.0,0.0,3.0,1412.0,8.0,0.0,0.0,377.0,15.0,0.0,1.0,702.0,13.0,0.0,1.0,516.0,16.0,1.0,2.0,572.0,13.0,0.0,1.0,626.0,Ligue 1,6.0,0.0,0.0,148.0,2.0,0.0,0.0,110.0,29/6/2010,Marvin Martin,8440961.0,769.0,1/10/1988,22.0,0.0,0.0,8.0,0.0,1400.0,6000.0,6000.0,160.0,134.0,4918554.0,171.0,63.0,M/AM C,3.0,2.0,1.0,2.0,3.0,2.0,2.0,3.0,3.0,2.0,2.0,16.0,12.0,14.0,7.0,14.0,14.0,8.0,11.0,7.0,5.0,14.0,12.0,7.0,14.0,10.0,13.0,13.0,14.0,14.0,15.0,14.0,14.0,12.0,12.0,12.0,11.0,14.0,16.0,11.0,15.0,12.0,5.0,12.0,14.0,14.0,20.0,16.0,8.0,15.0,10.0,15.0,7.0,10.0,9.0,14.0,14.0,15.0,15.0,15.0,15.0,5.0,Marvin Martin,ÃÂÃÂ£6.75m ,Ligue 1
19/6/2011,Martinho,19032956,1651,4/15/1988,23,0,0,0,0,2072,5550,5750,133,115,164682,181,73,M/AM LC,2,1,3,3,3,3,1,1,1,2,1,11,11,15,10,13,10,8,10,11,8,14,10,7,13,8,11,8,8,10,12,8,14,11,8,11,13,9,11,15,14,11,13,20,10,14,8,14,11,12,6,10,13,12,13,15,13,9,11,7,8,4,10,13,20,18,1,20,16,M/AM LC,414,1,1,1,14,18,1,1,10,1,1,16,20,1,13,1,0.0,0,0,0,0,0,0,0,0,0,0,0,0,0,0,0,0,0,0,0,0,0,0,0,0,0,0,0,0,0,0,0,0,0,0,0,0,0,0,0,0,0,0,0,0,0,0,0,0,Marinho,ÃÂ£1.17m ,37.0,166.0,Forward - Right Winger,left,Retired,30.0,2.0,1.0,1883.0,34.0,7.0,2.0,2162.0,41.0,4.0,5.0,2818.0,32.0,1.0,2.0,1461.0,17.0,4.0,1.0,990.0,21.0,3.0,0.0,899.0,44.0,4.0,5.0,3411.0,33.0,6.0,3.0,2079.0,23.0,1.0,2.0,629.0,Liga NOS,nan,nan,nan,nan,nan,nan,nan,nan,29/6/2010,Raphael Martinho,19032956.0,1651.0,1/22/1988,22.0,0.0,0.0,0.0,0.0,1000.0,5550.0,5550.0,134.0,111.0,644106.0,181.0,73.0,M/AM/S C,2.0,2.0,3.0,1.0,2.0,1.0,2.0,6.0,3.0,1.0,1.0,11.0,11.0,12.0,12.0,13.0,10.0,10.0,10.0,11.0,8.0,14.0,10.0,7.0,13.0,8.0,11.0,8.0,8.0,10.0,12.0,8.0,14.0,11.0,8.0,10.0,13.0,9.0,14.0,14.0,14.0,11.0,13.0,20.0,10.0,14.0,8.0,14.0,11.0,11.0,6.0,10.0,9.0,12.0,9.0,15.0,1.0,6.0,8.0,6.0,1.0,16.0,Raphael Martinho,ÃÂÃÂ£450Th. ,Serie A
19/6/2011,Marouane Fellaini,8170873,757,11/22/1987,23,27,4,8,0,7000,7500,7500,172,160,3894595,194,85,DM/M C,1,1,3,3,3,2,2,1,1,1,3,9,9,13,13,15,8,19,10,12,12,15,12,13,15,16,16,18,16,16,12,13,17,10,5,14,16,18,18,9,13,18,17,14,16,12,20,17,19,17,15,14,5,12,12,15,9,13,14,6,5,9,1,1,18,10,1,1,18,DM/M C,311,1,1,1,10,1,1,1,1,1,20,18,1,1,1,1,274878000000.0,0,0,0,0,0,0,0,0,0,0,0,0,0,0,0,0,0,1,0,0,0,0,0,0,0,0,0,0,0,0,0,0,0,0,0,0,0,0,1,0,0,0,0,0,0,0,0,0,Marouane Fellaini,ÃÂ£18.00m ,32.0,194.0,Midfielder - Central Midfield,right,Shandong Luneng Taishan,25.0,3.0,3.0,2147.0,43.0,5.0,7.0,3726.0,36.0,12.0,8.0,3213.0,25.0,1.0,4.0,1725.0,31.0,7.0,1.0,2165.0,35.0,5.0,4.0,2301.0,47.0,4.0,2.0,2651.0,23.0,5.0,1.0,878.0,55.0,14.0,7.0,4108.0,Premier League,14.0,4.0,0.0,1034.0,nan,nan,nan,nan,29/6/2010,Marouane Fellaini,8170873.0,757.0,11/22/1987,22.0,21.0,3.0,8.0,0.0,5700.0,7100.0,7100.0,166.0,151.0,12414558.0,194.0,85.0,DM/M C,2.0,3.0,2.0,2.0,2.0,1.0,1.0,3.0,1.0,3.0,3.0,9.0,9.0,12.0,13.0,14.0,8.0,19.0,10.0,12.0,12.0,15.0,12.0,13.0,15.0,16.0,16.0,18.0,15.0,16.0,12.0,12.0,17.0,10.0,5.0,16.0,15.0,18.0,17.0,9.0,13.0,18.0,17.0,10.0,15.0,12.0,20.0,17.0,19.0,16.0,15.0,14.0,5.0,12.0,12.0,14.0,7.0,10.0,14.0,6.0,5.0,13.0,Marouane Fellaini,ÃÂÃÂ£17.10m ,Premier League,19-06-17,18.3.4.28,Marouane Fellaini,8170873,757,22-Nov-87,29,76,15,7,0,6750,7750,7250,150,142,39238510,194,85,M/AM C,3,1,2,2,3,1,3,2,1,2,3,9,9,7,13,13,8,17,10,13,14,13,12,15,13,17,14,17,13,14,8,14,15,12,7,15,14,18,16,9,12,19,17,12,16,13,20,18,18,15,19,12,5,12,14,16,11,12,14,5,8,9,1,1,20,18,1,1,20,M/AM C,411,1,1,12,18,1,1,1,1,1,14,20,1,1,1,1,274878000000.0,0,0,0,1,0,0,0,0,0,0,0,0,0,0,0,0,1,0,0,0,0,0,0,0,0,0,0,0,0,0,0,0,0,0,0,0,0,0,1,0,0,0,0,0,0,0,0,0,Marouane Fellaini,ÃÂ£10.80m ,32.0,194.0,Midfielder - Central Midfield,right,Shandong Luneng Taishan,47.0,4.0,2.0,2651.0,23.0,5.0,1.0,878.0,55.0,14.0,7.0,4108.0,15.0,4.0,0.0,1124.0,nan,nan,nan,nan,Premier League,15-07-16,17.3.2.23,Marouane Fellaini,8170873.0,757.0,22-Nov-87,28.0,72.0,15.0,7.0,0.0,6744.0,7744.0,7144.0,155.0,143.0,29238274.0,194.0,85.0,M/AM C,1.0,2.0,2.0,2.0,4.0,1.0,1.0,1.0,2.0,2.0,3.0,9.0,9.0,9.0,13.0,14.0,8.0,17.0,10.0,13.0,12.0,13.0,12.0,15.0,15.0,17.0,14.0,16.0,11.0,13.0,10.0,14.0,15.0,12.0,7.0,15.0,13.0,18.0,16.0,9.0,12.0,19.0,17.0,12.0,16.0,13.0,20.0,17.0,17.0,14.0,19.0,12.0,5.0,12.0,14.0,16.0,11.0,12.0,14.0,5.0,8.0,9.0,Marouane Fellaini,ÃÂ£10.80m ,Premier League
19/6/2011,Marek Hamsik,7564092,794,7/27/1987,23,46,8,0,0,7250,8000,8000,178,162,4938291,183,73,M/AM LC,1,3,2,2,1,2,3,6,3,1,1,13,13,14,16,13,12,15,13,9,8,16,16,8,17,11,14,12,18,13,17,16,13,15,16,18,13,15,10,15,15,13,12,11,15,14,20,15,12,10,6,16,5,14,17,16,18,10,13,8,8,8,1,1,20,18,10,17,20,M/AM LC,414,1,1,1,18,17,10,1,1,1,14,20,11,10,1,1,549890000000.0,0,0,0,0,1,1,0,0,0,0,0,0,0,0,0,0,0,0,0,0,0,0,0,0,0,0,0,1,0,0,0,0,0,0,0,0,0,0,0,1,0,0,0,0,0,0,0,0,Marek Hamsik,ÃÂ£22.50m ,33.0,183.0,Midfielder - Central Midfield,both,Dalian Professional,49.0,13.0,9.0,3868.0,50.0,12.0,9.0,3826.0,44.0,11.0,20.0,3501.0,41.0,7.0,9.0,2792.0,54.0,13.0,16.0,3517.0,46.0,8.0,7.0,3707.0,49.0,15.0,9.0,3914.0,49.0,7.0,3.0,3162.0,50.0,4.0,4.0,4047.0,Serie A,14.0,2.0,1.0,1253.0,nan,nan,nan,nan,29/6/2010,Marek Hamsik,7564092.0,794.0,7/27/1987,22.0,36.0,8.0,0.0,0.0,6241.0,8000.0,7750.0,182.0,158.0,36235698.0,183.0,73.0,M/AM C,3.0,3.0,1.0,1.0,2.0,3.0,1.0,5.0,1.0,2.0,3.0,13.0,13.0,14.0,16.0,13.0,12.0,14.0,14.0,9.0,8.0,16.0,16.0,8.0,17.0,11.0,14.0,12.0,18.0,13.0,17.0,15.0,13.0,15.0,16.0,18.0,13.0,15.0,10.0,15.0,15.0,13.0,12.0,11.0,15.0,14.0,20.0,15.0,12.0,10.0,6.0,16.0,5.0,14.0,17.0,16.0,18.0,10.0,13.0,8.0,8.0,8.0,Marek Hamsik,ÃÂÃÂ£21.60m ,Serie A,19-06-17,18.3.4.28,Marek Hamsik,7564092,794,27-Jul-87,29,97,21,2,0,6750,8450,8350,170,167,232186002,183,79,M/AM C,1,3,2,1,3,3,3,2,3,2,2,14,13,13,14,16,12,15,14,8,9,16,14,12,17,11,14,14,15,10,17,13,15,15,17,18,14,15,10,15,15,13,11,15,16,14,20,14,13,16,6,12,5,14,17,15,20,14,18,17,15,5,1,1,20,19,5,13,20,M/AM C,411,1,1,1,19,11,3,1,1,1,1,20,13,5,1,1,134217776.0,0,0,0,0,1,1,0,0,0,0,0,0,0,0,0,0,0,0,0,0,0,0,0,0,0,0,0,1,0,0,0,0,0,0,0,0,0,0,0,0,0,0,0,0,0,0,0,0,Marek Hamsik,ÃÂ£31.50m ,33.0,183.0,Midfielder - Central Midfield,both,Dalian Professional,49.0,15.0,9.0,3914.0,49.0,7.0,3.0,3162.0,50.0,4.0,4.0,4047.0,14.0,2.0,1.0,1253.0,nan,nan,nan,nan,Serie A,15-07-16,17.3.2.23,Marek Hamsik,7564092.0,794.0,27-Jul-87,28.0,91.0,19.0,2.0,0.0,6750.0,8200.0,8200.0,169.0,164.0,101629403.0,183.0,79.0,M/AM C,2.0,1.0,3.0,2.0,1.0,2.0,1.0,1.0,1.0,1.0,3.0,14.0,13.0,13.0,14.0,15.0,12.0,15.0,14.0,8.0,8.0,16.0,14.0,9.0,17.0,11.0,14.0,12.0,15.0,10.0,16.0,14.0,15.0,15.0,17.0,18.0,14.0,15.0,10.0,15.0,15.0,13.0,11.0,15.0,15.0,14.0,20.0,14.0,13.0,13.0,6.0,12.0,5.0,14.0,17.0,16.0,19.0,13.0,18.0,14.0,12.0,8.0,Marek Hamsik,ÃÂ£36.00m ,Serie A
19/6/2011,Marcel Gecov,5653961,763,1/1/1988,23,0,0,13,1,2083,6000,6000,140,120,409091,180,70,DM C,2,3,3,1,3,1,3,3,2,1,3,8,8,14,10,13,10,9,8,5,10,15,12,8,14,7,10,9,9,12,15,11,8,13,16,13,11,8,14,15,11,9,9,11,6,15,20,16,11,12,10,12,12,10,14,8,10,6,10,10,10,2,1,1,15,10,1,1,15,DM C,301,1,1,1,10,1,1,1,1,1,20,15,1,1,1,1,4194304.0,0,0,0,0,0,0,0,0,0,0,0,0,0,0,0,0,0,0,0,0,0,0,1,0,0,0,0,0,0,0,0,0,0,0,0,0,0,0,0,0,0,0,0,0,0,0,0,0,Marcel Gecov,ÃÂ£450Th. ,32.0,183.0,Midfielder - Central Midfield,right,Retired,25.0,1.0,1.0,2089.0,12.0,0.0,0.0,845.0,21.0,2.0,1.0,1372.0,30.0,1.0,0.0,2435.0,25.0,3.0,1.0,1966.0,28.0,1.0,0.0,1928.0,nan,nan,nan,nan,nan,nan,nan,nan,nan,nan,nan,nan,Premier League,nan,nan,nan,nan,nan,nan,nan,nan,nan,nan,nan,nan,nan,nan,nan,nan,nan,nan,nan,nan,nan,nan,nan,nan,nan,nan,nan,nan,nan,nan,nan,nan,nan,nan,nan,nan,nan,nan,nan,nan,nan,nan,nan,nan,nan,nan,nan,nan,nan,nan,nan,nan,nan,nan,nan,nan,nan,nan,nan,nan,nan,nan,nan,nan,nan,nan,nan,nan,nan,nan,nan,nan,nan,nan,nan,nan,nan,nan,nan,nan,nan,nan,nan,nan,nan,nan,nan,nan,nan,nan,nan,nan
19/6/2011,Marc Wilson,5114764,789,8/17/1987,23,1,0,0,0,4417,6275,6650,146,130,1636364,188,80,DM/M RC,2,1,1,2,3,3,1,2,1,1,1,12,15,11,8,13,14,12,8,6,8,14,16,12,12,14,12,12,15,12,14,13,16,10,13,10,12,10,14,11,10,14,14,17,14,12,20,14,13,14,8,11,7,12,14,12,15,10,12,9,9,14,15,8,18,1,15,12,18,DM/M RC,313,1,1,1,1,1,1,15,12,15,20,18,8,8,8,8,149538000000000.0,0,0,0,0,0,0,0,0,0,0,0,0,0,0,0,0,0,0,0,0,0,0,1,0,0,0,0,0,0,0,0,0,1,0,0,0,0,0,0,0,0,0,0,1,0,0,0,1,Marc Wilson,ÃÂ£4.50m ,33.0,188.0,Defender - Centre-Back,both,Retired,41.0,1.0,2.0,2942.0,45.0,0.0,1.0,3801.0,20.0,0.0,0.0,1611.0,38.0,0.0,0.0,3121.0,30.0,0.0,1.0,2394.0,11.0,1.0,0.0,929.0,8.0,1.0,0.0,526.0,22.0,0.0,0.0,1779.0,17.0,0.0,0.0,1267.0,Premier League,nan,nan,nan,nan,nan,nan,nan,nan,29/6/2010,Marc Wilson,5114764.0,789.0,8/17/1987,22.0,0.0,0.0,0.0,0.0,3844.0,6000.0,6350.0,146.0,124.0,10350000.0,188.0,80.0,DM/M C,2.0,3.0,3.0,2.0,1.0,3.0,1.0,1.0,2.0,2.0,3.0,12.0,15.0,11.0,8.0,13.0,14.0,12.0,8.0,6.0,8.0,15.0,16.0,10.0,11.0,14.0,12.0,12.0,15.0,12.0,13.0,13.0,16.0,10.0,13.0,10.0,12.0,9.0,14.0,11.0,10.0,14.0,14.0,17.0,14.0,12.0,20.0,14.0,13.0,12.0,8.0,11.0,7.0,12.0,14.0,12.0,15.0,10.0,12.0,9.0,9.0,14.0,Marc Wilson,ÃÂÃÂ£2.70m ,Premier League
19/6/2011,Mamadou Bah,85000951,22,4/25/1988,23,18,3,0,0,3500,5850,5278,138,117,412196,183,75,DM/M C,2,2,2,1,1,2,3,1,2,1,2,5,7,10,8,12,8,13,12,7,12,13,7,10,12,12,15,13,11,11,12,10,14,11,8,11,11,12,15,14,12,15,11,8,13,12,20,14,15,12,12,14,7,10,9,15,12,12,9,12,12,7,12,1,18,12,1,10,18,DM/M C,311,1,1,1,12,10,1,12,1,1,20,18,10,1,1,1,260.0,0,0,1,0,0,0,0,0,1,0,0,0,0,0,0,0,0,0,0,0,0,0,0,0,0,0,0,0,0,0,0,0,0,0,0,0,0,0,0,0,0,0,0,0,0,0,0,0,Mamadou Bah,ÃÂ£450Th. ,32.0,181.0,Midfielder - Defensive Midfield,left,US Raon-l'ÃÂtape,9.0,0.0,0.0,706.0,3.0,0.0,0.0,11.0,1.0,0.0,0.0,21.0,17.0,1.0,0.0,1423.0,1.0,0.0,0.0,21.0,nan,nan,nan,nan,nan,nan,nan,nan,nan,nan,nan,nan,1.0,0.0,0.0,54.0,Bundesliga,1.0,0.0,0.0,90.0,nan,nan,nan,nan,nan,nan,nan,nan,nan,nan,nan,nan,nan,nan,nan,nan,nan,nan,nan,nan,nan,nan,nan,nan,nan,nan,nan,nan,nan,nan,nan,nan,nan,nan,nan,nan,nan,nan,nan,nan,nan,nan,nan,nan,nan,nan,nan,nan,nan,nan,nan,nan,nan,nan,nan,nan,nan,nan,nan,nan,nan,nan,nan,nan,nan,nan,nan,nan,nan,nan,nan,nan,nan,nan,nan,nan,nan,nan,nan,nan,nan,nan,nan,nan,nan,nan,nan,nan
19/6/2011,Luiz Gustavo,19016523,1651,7/23/1987,23,0,0,0,0,6500,7000,7750,162,148,36363636,187,80,DM/M C,2,2,3,1,3,1,3,6,1,1,3,8,11,9,5,12,5,8,10,12,18,13,6,18,13,16,17,18,8,10,9,12,16,8,10,8,13,17,18,14,13,16,12,20,14,17,12,17,13,11,15,12,7,18,12,14,8,5,13,6,7,10,14,14,18,1,1,14,18,DM/M C,311,1,1,1,1,1,1,12,14,1,20,18,1,1,14,1,33718592.0,0,0,0,0,0,0,1,0,1,0,0,0,0,0,0,1,0,1,0,0,0,0,0,0,0,1,0,0,0,0,0,0,0,0,0,0,0,0,0,0,0,0,0,0,0,0,0,0,Luiz Gustavo,ÃÂ£13.50m ,33.0,187.0,Midfielder - Defensive Midfield,left,Fenerbahce SK,38.0,3.0,5.0,3174.0,46.0,1.0,2.0,3112.0,36.0,4.0,1.0,2039.0,33.0,4.0,3.0,2903.0,47.0,7.0,1.0,4058.0,30.0,1.0,3.0,2529.0,32.0,0.0,0.0,2794.0,57.0,6.0,2.0,4961.0,38.0,4.0,0.0,3117.0,Bundesliga,35.0,3.0,1.0,3023.0,6.0,0.0,0.0,527.0,29/6/2010,Luiz Gustavo,19016523.0,1651.0,7/23/1987,22.0,0.0,0.0,0.0,0.0,3500.0,6389.0,7050.0,160.0,142.0,6018978.0,187.0,80.0,DM/M C,2.0,3.0,3.0,1.0,2.0,1.0,1.0,1.0,1.0,3.0,2.0,6.0,9.0,10.0,4.0,13.0,6.0,10.0,7.0,11.0,16.0,15.0,8.0,12.0,14.0,19.0,17.0,18.0,9.0,8.0,14.0,14.0,16.0,8.0,11.0,10.0,12.0,15.0,18.0,13.0,16.0,12.0,13.0,20.0,14.0,17.0,12.0,17.0,10.0,12.0,17.0,12.0,7.0,15.0,12.0,14.0,8.0,12.0,13.0,6.0,3.0,10.0,Luiz Gustavo,ÃÂÃÂ£13.50m ,Bundesliga,19-06-17,18.3.4.28,Luiz Gustavo,19016523,1651,23-Jul-87,29,41,2,0,0,6500,7500,7500,155,150,59516224,187,80,DM/M C,3,1,1,1,3,1,1,3,1,2,3,6,10,11,7,12,6,10,13,9,15,14,8,18,12,16,13,17,12,14,10,12,17,7,13,9,14,17,18,14,13,16,14,20,18,13,12,18,14,16,16,15,6,15,14,13,10,14,12,7,9,9,14,12,20,1,1,12,20,DM/M C,311,1,1,1,1,1,1,14,12,1,20,20,1,1,12,1,0.0,0,0,0,0,0,0,0,0,0,0,0,0,0,0,0,0,0,0,0,0,0,0,0,0,0,0,0,0,0,0,0,0,0,0,0,0,0,0,0,0,0,0,0,0,0,0,0,0,Luiz Gustavo,ÃÂ£13.50m ,33.0,187.0,Midfielder - Defensive Midfield,left,Fenerbahce SK,32.0,0.0,0.0,2794.0,57.0,6.0,2.0,4961.0,38.0,4.0,0.0,3117.0,35.0,3.0,1.0,3023.0,6.0,0.0,0.0,527.0,Ligue 1,15-07-16,17.3.2.23,Luiz Gustavo,19016523.0,1651.0,23-Jul-87,28.0,41.0,2.0,0.0,0.0,7500.0,7750.0,7500.0,155.0,150.0,39030515.0,187.0,80.0,DM/M C,1.0,2.0,2.0,1.0,3.0,3.0,3.0,2.0,4.0,1.0,3.0,7.0,10.0,11.0,7.0,12.0,7.0,10.0,12.0,13.0,15.0,13.0,8.0,18.0,12.0,18.0,13.0,17.0,12.0,14.0,10.0,12.0,17.0,7.0,13.0,9.0,14.0,17.0,18.0,14.0,13.0,16.0,14.0,20.0,18.0,13.0,12.0,18.0,14.0,15.0,16.0,15.0,6.0,15.0,14.0,13.0,10.0,14.0,12.0,8.0,7.0,8.0,Luiz Gustavo,ÃÂ£10.80m ,Bundesliga
19/6/2011,Lee Cattermole,5123105,765,3/21/1988,23,0,0,16,3,4650,6800,6800,145,136,4052344,178,77,M C,2,1,1,1,2,3,1,10,3,2,1,7,10,12,8,14,12,13,10,10,15,14,6,13,13,20,15,20,13,10,14,12,16,6,17,10,12,18,17,12,10,13,9,12,10,11,20,15,14,11,20,9,15,5,5,14,12,9,9,9,4,15,1,1,20,1,5,1,20,M C,401,1,1,1,1,1,1,1,1,1,15,20,1,5,1,1,2336460000000.0,0,0,0,0,0,0,0,0,0,0,0,0,0,0,0,0,1,0,0,0,0,0,0,0,0,0,0,0,0,0,0,0,0,0,0,0,0,1,0,0,0,1,0,0,0,0,0,0,Lee Cattermole,ÃÂ£5.40m ,32.0,178.0,Midfielder - Defensive Midfield,right,Retired,24.0,0.0,0.0,2012.0,28.0,0.0,0.0,2292.0,14.0,0.0,0.0,878.0,33.0,1.0,1.0,2514.0,28.0,1.0,0.0,2358.0,34.0,0.0,0.0,2407.0,9.0,0.0,0.0,661.0,35.0,1.0,6.0,3032.0,36.0,7.0,1.0,3065.0,Premier League,13.0,0.0,0.0,898.0,nan,nan,nan,nan,29/6/2010,Lee Cattermole,5123105.0,765.0,3/21/1988,22.0,0.0,0.0,16.0,3.0,4650.0,7050.0,7050.0,160.0,140.0,21905811.0,178.0,77.0,M C,3.0,1.0,2.0,2.0,1.0,3.0,3.0,4.0,3.0,2.0,3.0,10.0,10.0,12.0,12.0,13.0,13.0,13.0,12.0,10.0,15.0,13.0,6.0,15.0,13.0,20.0,14.0,20.0,13.0,12.0,13.0,11.0,18.0,10.0,16.0,10.0,13.0,18.0,18.0,12.0,10.0,13.0,9.0,12.0,18.0,11.0,20.0,16.0,14.0,10.0,20.0,12.0,14.0,13.0,6.0,14.0,12.0,11.0,9.0,9.0,4.0,15.0,Lee Cattermole,ÃÂÃÂ£5.40m ,Premier League
19/6/2011,Karim El-Hany,85087983,769,1/12/1988,23,0,0,0,0,2263,4688,3582,125,104,62642,170,60,M/AM LC,2,1,1,1,2,2,1,4,2,2,3,8,9,13,8,13,8,7,11,6,3,11,8,3,13,8,10,11,12,9,12,10,17,14,6,12,7,11,13,16,14,10,5,20,13,15,5,11,6,12,8,13,8,8,6,13,12,13,14,14,14,6,1,1,18,20,1,20,16,M/AM LC,524,1,1,1,16,20,1,1,1,1,1,16,18,1,1,1,2251800000000000.0,0,0,0,0,0,0,0,0,0,0,0,0,0,0,0,0,0,0,0,0,0,0,0,0,0,0,0,0,0,0,0,0,0,0,0,0,0,0,0,0,0,0,0,0,0,0,0,0,Karim El Hany,ÃÂ£180Th. ,32.0,170.0,Midfielder - Defensive Midfield,right,Mouloudia d'Oujda,27.0,0.0,0.0,1249.0,3.0,1.0,0.0,76.0,6.0,0.0,0.0,445.0,11.0,1.0,0.0,554.0,10.0,1.0,0.0,448.0,23.0,0.0,1.0,1691.0,nan,nan,nan,nan,23.0,0.0,4.0,1854.0,29.0,0.0,7.0,2569.0,Ligue 1,28.0,1.0,3.0,2314.0,nan,nan,nan,nan,nan,nan,nan,nan,nan,nan,nan,nan,nan,nan,nan,nan,nan,nan,nan,nan,nan,nan,nan,nan,nan,nan,nan,nan,nan,nan,nan,nan,nan,nan,nan,nan,nan,nan,nan,nan,nan,nan,nan,nan,nan,nan,nan,nan,nan,nan,nan,nan,nan,nan,nan,nan,nan,nan,nan,nan,nan,nan,nan,nan,nan,nan,nan,nan,nan,nan,nan,nan,nan,nan,nan,nan,nan,nan,nan,nan,nan,nan,nan,nan,nan,nan,nan,nan
19/6/2011,Julian Baumgartlinger,5607656,755,1/2/1988,23,13,0,17,1,3900,6000,6000,147,128,343053,183,80,DM/M C,3,1,3,2,2,1,1,2,3,3,2,5,6,10,6,12,8,14,9,8,14,11,5,16,11,12,10,16,11,10,9,9,16,9,17,16,13,17,18,13,13,13,12,16,14,13,20,14,14,14,8,10,13,13,13,15,6,10,15,16,11,4,1,1,20,1,1,1,20,DM/M C,311,1,1,1,1,1,1,1,1,1,20,20,1,1,1,1,1073741888.0,0,0,0,0,0,0,1,0,0,0,0,0,0,0,0,0,0,0,0,0,0,0,0,0,0,0,0,0,0,0,1,0,0,0,0,0,0,0,0,0,0,0,0,0,0,0,0,0,Julian Baumgartlinger,ÃÂ£2.25m ,32.0,184.0,Midfielder - Defensive Midfield,right,Bayer 04 Leverkusen,40.0,3.0,8.0,3219.0,30.0,0.0,5.0,1790.0,36.0,1.0,2.0,3167.0,12.0,1.0,1.0,760.0,28.0,0.0,0.0,2459.0,33.0,2.0,1.0,2897.0,30.0,0.0,2.0,2036.0,24.0,1.0,0.0,1577.0,27.0,0.0,1.0,1955.0,Bundesliga,40.0,2.0,2.0,2404.0,5.0,0.0,1.0,167.0,nan,nan,nan,nan,nan,nan,nan,nan,nan,nan,nan,nan,nan,nan,nan,nan,nan,nan,nan,nan,nan,nan,nan,nan,nan,nan,nan,nan,nan,nan,nan,nan,nan,nan,nan,nan,nan,nan,nan,nan,nan,nan,nan,nan,nan,nan,nan,nan,nan,nan,nan,nan,nan,nan,nan,nan,nan,nan,nan,nan,nan,nan,nan,nan,nan,nan,nan,nan,nan,nan,nan,nan,nan,nan,nan,nan,nan,nan,nan,nan,nan,nan,nan,nan,19-06-17,18.3.4.28,Julian Baumgartlinger,5607656,755,02-Jan-88,29,54,1,17,1,4900,7150,6900,140,138,17484340,183,82,DM/M C,3,3,2,4,3,1,1,1,3,3,1,6,8,9,7,11,6,12,8,10,13,12,6,16,11,18,12,17,10,17,9,12,17,6,15,13,13,16,19,12,10,16,11,14,19,16,20,19,14,18,10,17,6,8,12,16,14,13,18,15,10,4,1,1,20,1,1,1,20,DM/M C,311,1,1,1,1,1,1,1,1,1,20,20,1,1,1,1,0.0,0,0,0,0,0,0,0,0,0,0,0,0,0,0,0,0,0,0,0,0,0,0,0,0,0,0,0,0,0,0,0,0,0,0,0,0,0,0,0,0,0,0,0,0,0,0,0,0,Julian Baumgartlinger,ÃÂ£3.60m ,32.0,184.0,Midfielder - Defensive Midfield,right,Bayer 04 Leverkusen,30.0,0.0,2.0,2036.0,24.0,1.0,0.0,1577.0,27.0,0.0,1.0,1955.0,40.0,2.0,2.0,2404.0,6.0,0.0,1.0,257.0,Bundesliga,15-07-16,17.3.2.23,Julian Baumgartlinger,5607656.0,755.0,02-Jan-88,28.0,48.0,1.0,17.0,1.0,5400.0,7150.0,7400.0,143.0,143.0,33081131.0,183.0,80.0,DM/M C,1.0,3.0,3.0,2.0,1.0,3.0,1.0,1.0,1.0,3.0,3.0,6.0,8.0,9.0,7.0,11.0,6.0,12.0,8.0,10.0,13.0,12.0,6.0,16.0,11.0,18.0,12.0,17.0,10.0,17.0,9.0,12.0,17.0,6.0,15.0,13.0,13.0,18.0,19.0,13.0,11.0,16.0,11.0,14.0,19.0,18.0,20.0,19.0,14.0,18.0,10.0,17.0,6.0,8.0,12.0,16.0,14.0,13.0,18.0,15.0,10.0,4.0,Julian Baumgartlinger,ÃÂ£4.50m ,Bundesliga
19/6/2011,Josip Ilicic,29041284,795,1/29/1988,23,10,0,5,0,4500,6550,6850,160,141,831981,190,79,M/AM LC,2,3,2,1,1,1,2,2,3,2,1,12,13,12,14,12,12,9,17,5,6,15,12,6,16,15,14,11,14,15,14,14,15,15,12,15,12,12,15,13,14,13,15,20,12,13,11,13,13,15,7,13,7,11,14,15,14,14,16,15,15,7,1,1,18,20,10,16,20,M/AM LC,524,1,1,10,20,16,10,1,1,1,1,18,15,5,1,1,0.0,0,0,0,0,0,0,0,0,0,0,0,0,0,0,0,0,0,0,0,0,0,0,0,0,0,0,0,0,0,0,0,0,0,0,0,0,0,0,0,0,0,0,0,0,0,0,0,0,Josip Ilicic,ÃÂ£7.20m ,32.0,190.0,Forward - Second Striker,left,Atalanta BC,50.0,12.0,13.0,3761.0,36.0,6.0,6.0,2455.0,32.0,11.0,2.0,2498.0,31.0,6.0,4.0,1760.0,34.0,10.0,4.0,1966.0,37.0,15.0,5.0,2276.0,36.0,6.0,5.0,2099.0,41.0,15.0,10.0,2561.0,36.0,13.0,9.0,2532.0,Serie A,34.0,21.0,9.0,2233.0,3.0,0.0,1.0,175.0,nan,nan,nan,nan,nan,nan,nan,nan,nan,nan,nan,nan,nan,nan,nan,nan,nan,nan,nan,nan,nan,nan,nan,nan,nan,nan,nan,nan,nan,nan,nan,nan,nan,nan,nan,nan,nan,nan,nan,nan,nan,nan,nan,nan,nan,nan,nan,nan,nan,nan,nan,nan,nan,nan,nan,nan,nan,nan,nan,nan,nan,nan,nan,nan,nan,nan,nan,nan,nan,nan,nan,nan,nan,nan,nan,nan,nan,nan,nan,nan,nan,nan,nan,nan,19-06-17,18.3.4.28,Josip Ilicic,29041284,795,29-Jan-88,29,46,3,5,0,5750,7000,7200,151,144,38780854,190,79,AM RC,2,4,1,2,2,2,4,1,1,1,2,15,14,14,14,15,16,9,16,5,6,15,15,9,16,13,15,7,14,9,14,15,14,16,11,16,10,11,11,12,13,13,14,20,12,13,12,14,13,11,10,13,7,15,14,14,14,13,16,15,12,7,1,1,13,20,16,12,20,AM RC,503,1,1,14,20,12,16,1,1,1,1,13,5,5,1,1,264.0,0,0,0,1,0,0,0,0,1,0,0,0,0,0,0,0,0,0,0,0,0,0,0,0,0,0,0,0,0,0,0,0,0,0,0,0,0,0,0,0,0,0,0,0,0,0,0,0,Josip Ilicic,ÃÂ£11.70m ,32.0,190.0,Forward - Second Striker,left,Atalanta BC,36.0,6.0,5.0,2099.0,41.0,15.0,10.0,2561.0,36.0,13.0,9.0,2532.0,34.0,21.0,9.0,2233.0,3.0,0.0,1.0,175.0,Serie A,15-07-16,17.3.2.23,Josip Ilicic,29041284.0,795.0,29-Jan-88,28.0,43.0,2.0,5.0,0.0,5650.0,6900.0,7250.0,151.0,145.0,42052987.0,190.0,79.0,AM RC,3.0,3.0,3.0,1.0,3.0,3.0,2.0,4.0,3.0,3.0,2.0,15.0,13.0,14.0,14.0,15.0,15.0,9.0,16.0,5.0,6.0,15.0,16.0,9.0,16.0,13.0,15.0,7.0,14.0,11.0,14.0,15.0,14.0,15.0,11.0,16.0,11.0,11.0,11.0,12.0,13.0,13.0,14.0,20.0,12.0,13.0,12.0,14.0,13.0,12.0,10.0,14.0,7.0,15.0,14.0,14.0,14.0,13.0,16.0,15.0,12.0,7.0,Josip Ilicic,ÃÂ£9.00m ,Serie A
19/6/2011,Jonathan de Guzman,860972,784,9/13/1987,23,0,0,4,3,6511,6863,7012,158,146,632467,173,65,M/AM RC,1,2,2,3,1,2,2,8,3,1,2,14,12,15,11,16,12,12,13,8,11,15,13,8,15,15,14,13,12,13,15,14,9,17,9,15,14,15,14,14,14,13,9,12,13,13,20,13,11,15,14,13,18,10,12,16,13,12,14,13,12,12,8,8,20,19,16,12,20,M/AM RC,413,1,1,12,19,12,16,1,8,8,12,20,12,16,8,8,35184400000000.0,0,0,0,0,0,1,0,0,0,0,1,0,0,0,0,0,0,0,0,0,1,0,1,0,0,0,0,0,0,0,0,0,0,0,0,0,0,0,0,0,0,0,0,0,0,1,0,0,Jonathan de GuzmÃÂ¡n,ÃÂ£5.40m ,33.0,173.0,Midfielder - Central Midfield,right,OFI Crete,36.0,6.0,4.0,3072.0,27.0,1.0,2.0,1584.0,45.0,8.0,8.0,3511.0,48.0,7.0,5.0,3310.0,36.0,7.0,3.0,2021.0,5.0,1.0,0.0,111.0,29.0,2.0,2.0,1533.0,19.0,0.0,5.0,1346.0,39.0,3.0,9.0,2083.0,LaLiga,10.0,1.0,1.0,193.0,nan,nan,nan,nan,29/6/2010,Jonathan de Guzman,860972.0,784.0,9/13/1987,22.0,0.0,0.0,4.0,3.0,4489.0,6750.0,6750.0,158.0,134.0,3957083.0,173.0,65.0,M/AM RC,3.0,3.0,2.0,1.0,2.0,1.0,3.0,7.0,1.0,3.0,2.0,14.0,11.0,15.0,11.0,16.0,12.0,11.0,12.0,8.0,8.0,15.0,13.0,6.0,15.0,13.0,14.0,13.0,12.0,13.0,15.0,10.0,10.0,17.0,5.0,14.0,8.0,14.0,12.0,14.0,14.0,13.0,9.0,12.0,13.0,13.0,20.0,11.0,10.0,15.0,12.0,13.0,18.0,10.0,19.0,7.0,12.0,5.0,11.0,16.0,8.0,13.0,Jonathan de GuzmÃÂÃÂ¡n,ÃÂÃÂ£4.50m ,LaLiga,19-06-17,18.3.4.28,Jonathan de GuzmÃÂÃÂ¼ÃÂn,860972,784,13-Sep-87,29,14,0,15,6,5650,6650,6650,147,133,11369040,173,70,M/AM C,1,1,1,2,1,3,2,3,3,3,3,16,14,12,10,15,16,10,14,6,9,15,13,10,14,11,13,10,13,14,14,14,12,15,9,12,12,16,14,12,14,10,9,12,14,12,20,13,8,11,8,12,9,16,18,16,10,10,16,13,17,3,1,1,20,18,12,13,20,M/AM C,411,1,1,8,18,13,12,1,1,1,14,20,13,12,1,1,140737000000000.0,0,0,0,0,0,0,0,0,0,0,0,1,0,0,0,0,0,0,0,0,1,0,1,0,0,0,0,0,0,0,0,0,0,0,0,0,0,0,0,0,0,0,0,0,0,0,0,1,Jonathan de GuzmÃÂ¡n,ÃÂ£2.25m ,33.0,173.0,Midfielder - Central Midfield,right,OFI Crete,29.0,2.0,2.0,1533.0,19.0,0.0,5.0,1346.0,39.0,3.0,9.0,2083.0,10.0,1.0,1.0,193.0,0.0,0.0,0.0,0.0,Bundesliga,nan,nan,nan,nan,nan,nan,nan,nan,nan,nan,nan,nan,nan,nan,nan,nan,nan,nan,nan,nan,nan,nan,nan,nan,nan,nan,nan,nan,nan,nan,nan,nan,nan,nan,nan,nan,nan,nan,nan,nan,nan,nan,nan,nan,nan,nan,nan,nan,nan,nan,nan,nan,nan,nan,nan,nan,nan,nan,nan,nan,nan,nan,nan,nan,nan,nan,nan,nan,nan,nan,nan,nan,nan,nan,nan,nan,nan,nan,nan,nan,nan,nan,nan,nan,nan
19/6/2011,Johannes Flum,35007722,771,12/14/1987,23,0,0,0,0,3900,6250,6250,150,128,541185,190,78,DM/M C,1,3,2,3,1,1,1,5,2,1,2,8,7,10,11,11,12,13,12,9,13,13,9,14,12,10,13,12,12,13,12,11,12,7,8,10,13,14,14,12,10,14,13,14,15,13,20,15,13,8,5,13,9,11,11,11,13,9,12,13,10,9,9,1,20,14,1,1,20,DM/M C,421,1,1,1,14,1,1,9,1,1,17,20,1,1,1,1,524352.0,0,0,0,0,0,0,1,0,0,0,0,0,0,0,0,0,0,0,0,1,0,0,0,0,0,0,0,0,0,0,0,0,0,0,0,0,0,0,0,0,0,0,0,0,0,0,0,0,Johannes Flum,ÃÂ£3.60m ,32.0,190.0,Midfielder - Central Midfield,right,SC Freiburg II,14.0,3.0,0.0,1024.0,30.0,3.0,5.0,2488.0,30.0,2.0,0.0,1341.0,40.0,3.0,2.0,3087.0,8.0,0.0,0.0,157.0,6.0,0.0,2.0,167.0,11.0,0.0,0.0,640.0,30.0,4.0,2.0,1869.0,22.0,1.0,1.0,1630.0,Bundesliga,18.0,0.0,0.0,821.0,9.0,2.0,1.0,702.0,29/6/2010,Johannes Flum,35007722.0,771.0,12/14/1987,22.0,0.0,0.0,0.0,0.0,3850.0,6250.0,6250.0,150.0,129.0,3530450.0,188.0,78.0,DM/M C,1.0,2.0,2.0,2.0,2.0,3.0,3.0,3.0,3.0,1.0,1.0,8.0,7.0,10.0,11.0,11.0,12.0,13.0,12.0,9.0,13.0,14.0,9.0,14.0,12.0,10.0,13.0,12.0,12.0,13.0,12.0,11.0,12.0,7.0,8.0,10.0,13.0,14.0,14.0,12.0,10.0,14.0,13.0,14.0,15.0,13.0,20.0,15.0,13.0,8.0,5.0,13.0,9.0,11.0,11.0,11.0,13.0,9.0,12.0,13.0,10.0,9.0,Johannes Flum,ÃÂÃÂ£1.80m ,Bundesliga
19/6/2011,Jens Hegeler,92001113,771,1/21/1988,23,0,0,4,0,4700,6450,6200,146,129,332726,193,85,DM/M/AM RLC,2,1,3,3,3,1,2,4,1,3,3,4,12,12,9,11,7,14,9,6,13,12,8,14,11,12,13,12,11,14,11,14,14,8,9,11,14,14,15,13,10,14,16,9,13,13,20,15,14,16,4,13,4,15,10,12,13,12,14,15,18,2,1,1,20,18,19,15,20,DM/M/AM RLC,436,1,1,1,14,14,18,1,1,1,18,20,15,19,1,1,0.0,0,0,0,0,0,0,0,0,0,0,0,0,0,0,0,0,0,0,0,0,0,0,0,0,0,0,0,0,0,0,0,0,0,0,0,0,0,0,0,0,0,0,0,0,0,0,0,0,Jens Hegeler,ÃÂ£1.80m ,32.0,193.0,Midfielder - Central Midfield,right,Career break,38.0,3.0,5.0,2745.0,35.0,1.0,2.0,2033.0,37.0,5.0,0.0,1534.0,26.0,1.0,3.0,878.0,27.0,1.0,1.0,1572.0,21.0,0.0,0.0,749.0,21.0,0.0,0.0,1162.0,7.0,1.0,0.0,478.0,0.0,0.0,0.0,0.0,Bundesliga,nan,nan,nan,nan,nan,nan,nan,nan,29/6/2010,Jens Hegeler,92001113.0,771.0,1/21/1988,22.0,0.0,0.0,0.0,0.0,2100.0,5900.0,5900.0,150.0,118.0,1231891.0,193.0,85.0,D/DM/M C,1.0,2.0,1.0,3.0,3.0,1.0,3.0,1.0,2.0,1.0,3.0,4.0,6.0,10.0,8.0,10.0,7.0,13.0,11.0,6.0,12.0,12.0,8.0,14.0,11.0,12.0,13.0,12.0,9.0,14.0,11.0,13.0,12.0,8.0,9.0,10.0,14.0,14.0,13.0,12.0,10.0,14.0,15.0,9.0,13.0,13.0,20.0,14.0,13.0,12.0,4.0,10.0,4.0,14.0,8.0,10.0,13.0,10.0,12.0,15.0,18.0,2.0,Jens Hegeler,ÃÂÃÂ£2.25m ,Bundesliga
19/6/2011,James McArthur,5217388,793,10/7/1987,23,4,1,2,0,4000,6600,6300,155,124,806660,168,64,M C,1,1,1,1,1,1,1,1,1,1,1,8,12,15,8,14,8,7,6,7,10,17,7,13,14,11,14,13,15,14,15,13,13,5,14,12,15,17,17,11,12,14,9,5,14,10,20,15,8,16,12,18,6,7,5,13,16,10,17,13,14,2,1,1,20,1,10,1,20,M C,401,1,1,1,1,1,1,1,1,1,10,20,1,10,1,1,4718656.0,0,0,0,0,0,0,1,0,0,0,0,0,0,0,0,0,0,0,0,1,0,0,1,0,0,0,0,0,0,0,0,0,0,0,0,0,0,0,0,0,0,0,0,0,0,0,0,0,James McArthur,ÃÂ£2.25m ,33.0,178.0,Midfielder - Central Midfield,both,Crystal Palace,29.0,1.0,0.0,1412.0,35.0,3.0,2.0,2116.0,40.0,4.0,5.0,2730.0,54.0,4.0,4.0,4378.0,38.0,3.0,3.0,3147.0,31.0,2.0,2.0,2402.0,31.0,5.0,3.0,2095.0,35.0,7.0,1.0,2614.0,40.0,3.0,6.0,3166.0,Premier League,38.0,0.0,4.0,3155.0,5.0,0.0,0.0,430.0,29/6/2010,James McArthur,5217388.0,793.0,10/7/1987,22.0,0.0,0.0,2.0,0.0,3721.0,6000.0,6000.0,155.0,122.0,1380000.0,168.0,64.0,M C,1.0,1.0,1.0,1.0,1.0,1.0,1.0,1.0,1.0,1.0,1.0,8.0,11.0,14.0,7.0,14.0,8.0,7.0,6.0,7.0,9.0,16.0,7.0,13.0,14.0,10.0,14.0,11.0,15.0,14.0,15.0,13.0,13.0,5.0,14.0,10.0,15.0,17.0,17.0,10.0,12.0,12.0,9.0,5.0,14.0,10.0,20.0,15.0,8.0,16.0,9.0,18.0,3.0,7.0,5.0,13.0,16.0,10.0,17.0,13.0,14.0,2.0,James McArthur,ÃÂÃÂ£1.80m ,Premier League,19-06-17,18.3.4.28,James McArthur,5217388,793,07-Oct-87,29,28,3,2,0,5600,6700,6650,139,133,24779185,178,64,DM/M C,3,1,3,2,3,2,3,1,2,3,2,11,14,11,13,12,11,11,10,5,13,12,8,14,12,10,14,14,14,13,13,12,10,2,12,11,17,13,16,12,14,12,7,10,17,11,20,15,12,12,11,11,12,8,5,13,17,11,17,13,14,2,1,1,20,1,1,1,20,DM/M C,311,1,1,1,1,1,1,1,1,1,20,20,1,1,1,1,4718656.0,0,0,0,0,0,0,1,0,0,0,0,0,0,0,0,0,0,0,0,1,0,0,1,0,0,0,0,0,0,0,0,0,0,0,0,0,0,0,0,0,0,0,0,0,0,0,0,0,James McArthur,ÃÂ£5.40m ,33.0,178.0,Midfielder - Central Midfield,both,Crystal Palace,31.0,5.0,3.0,2095.0,35.0,7.0,1.0,2614.0,40.0,3.0,6.0,3166.0,38.0,0.0,4.0,3155.0,5.0,0.0,0.0,430.0,Premier League,15-07-16,17.3.2.23,James McArthur,5217388.0,793.0,07-Oct-87,28.0,24.0,2.0,2.0,0.0,5600.0,6700.0,6850.0,139.0,134.0,22453770.0,178.0,64.0,DM/M C,1.0,1.0,1.0,1.0,1.0,3.0,1.0,1.0,2.0,1.0,3.0,11.0,16.0,11.0,13.0,12.0,11.0,11.0,10.0,5.0,13.0,12.0,8.0,14.0,12.0,10.0,14.0,14.0,14.0,13.0,13.0,12.0,10.0,2.0,12.0,11.0,17.0,13.0,16.0,12.0,14.0,12.0,7.0,10.0,17.0,11.0,20.0,15.0,12.0,12.0,11.0,11.0,12.0,8.0,5.0,13.0,17.0,11.0,17.0,13.0,14.0,2.0,James McArthur,ÃÂ£6.30m ,Premier League
19/6/2011,Ivan Rakitic,5727652,761,3/10/1988,23,27,8,3,2,6500,7650,7250,171,151,6324111,184,77,M/AM C,3,3,1,1,3,1,2,7,1,1,2,18,16,10,13,17,15,10,17,6,8,15,14,10,17,8,14,9,14,11,14,12,7,11,9,13,11,16,14,9,12,11,12,17,14,16,20,15,11,9,6,11,6,12,10,14,9,11,10,14,18,12,1,1,20,18,14,14,20,M/AM C,411,1,1,8,18,14,14,1,1,1,12,20,12,12,1,1,1108347136.0,0,0,0,0,0,0,0,0,1,0,0,1,0,0,0,0,0,0,0,0,1,0,0,0,0,1,0,0,0,0,1,0,0,0,0,0,0,0,0,0,0,0,0,0,0,0,0,0,Ivan Rakitic,ÃÂ£8.10m ,32.0,184.0,Midfielder - Central Midfield,right,Sevilla FC,42.0,7.0,8.0,3361.0,39.0,1.0,6.0,2078.0,42.0,11.0,14.0,3519.0,52.0,15.0,18.0,4168.0,51.0,8.0,10.0,3344.0,57.0,9.0,5.0,4065.0,51.0,8.0,7.0,3524.0,55.0,4.0,5.0,4266.0,54.0,5.0,10.0,4237.0,LaLiga,42.0,1.0,5.0,2111.0,7.0,1.0,1.0,535.0,29/6/2010,Ivan Rakitic,5727652.0,761.0,3/10/1988,22.0,27.0,8.0,3.0,2.0,5402.0,7650.0,7400.0,172.0,147.0,18631786.0,184.0,77.0,M/AM C,1.0,1.0,1.0,3.0,1.0,1.0,2.0,1.0,1.0,2.0,3.0,18.0,16.0,12.0,14.0,17.0,15.0,10.0,17.0,7.0,8.0,15.0,15.0,11.0,17.0,9.0,14.0,9.0,13.0,11.0,13.0,10.0,8.0,12.0,9.0,10.0,11.0,16.0,14.0,8.0,12.0,10.0,12.0,17.0,14.0,16.0,20.0,16.0,11.0,8.0,6.0,11.0,6.0,12.0,10.0,16.0,9.0,14.0,12.0,11.0,18.0,13.0,Ivan Rakitic,ÃÂÃÂ£9.00m ,LaLiga,19-06-17,18.3.4.28,Ivan Rakitic,5727652,761,10-Mar-88,29,83,16,4,2,8100,8300,8250,168,165,103494607,184,78,M/AM C,2,3,2,2,2,3,3,2,1,3,3,18,15,14,13,16,16,8,18,10,9,17,16,11,16,11,14,12,14,14,16,15,12,12,14,15,12,15,14,12,11,11,12,14,12,14,20,15,14,14,12,13,6,12,14,14,13,11,13,14,18,12,1,1,20,18,12,14,20,M/AM C,411,1,1,1,18,14,12,1,1,1,15,20,12,12,1,1,1051008.0,0,0,0,0,0,0,0,1,1,0,0,1,0,0,0,0,0,0,0,0,1,0,0,0,0,0,0,0,0,0,0,0,0,0,0,0,0,0,0,0,0,0,0,0,0,0,0,0,Ivan Rakitic,ÃÂ£45.00m ,32.0,184.0,Midfielder - Central Midfield,right,Sevilla FC,51.0,8.0,7.0,3524.0,55.0,4.0,5.0,4266.0,54.0,5.0,10.0,4237.0,42.0,1.0,5.0,2111.0,7.0,1.0,1.0,535.0,LaLiga,15-07-16,17.3.2.23,Ivan Rakitic,5727652.0,761.0,10-Mar-88,28.0,80.0,12.0,4.0,2.0,8250.0,9050.0,8500.0,168.0,167.0,96612596.0,184.0,78.0,M/AM C,1.0,2.0,2.0,2.0,1.0,3.0,4.0,2.0,2.0,2.0,2.0,18.0,15.0,14.0,13.0,17.0,16.0,8.0,18.0,10.0,9.0,18.0,16.0,10.0,17.0,11.0,14.0,11.0,14.0,14.0,17.0,15.0,12.0,12.0,14.0,14.0,12.0,14.0,13.0,12.0,11.0,11.0,12.0,14.0,12.0,14.0,20.0,15.0,14.0,14.0,12.0,13.0,6.0,12.0,14.0,14.0,13.0,11.0,13.0,14.0,18.0,12.0,Ivan Rakitic,ÃÂ£40.50m ,LaLiga
19/6/2011,Gonzalo Castellani,964854,1649,8/10/1987,23,0,0,0,0,2000,5250,5000,145,118,105237,183,75,M C,1,3,2,1,3,2,2,5,3,1,1,14,10,13,11,14,13,9,12,4,8,14,15,8,13,12,8,11,12,11,14,14,13,13,13,11,8,12,10,11,10,12,11,12,16,11,20,10,12,13,8,12,4,9,11,12,15,14,15,15,16,11,1,1,20,15,1,1,20,M C,401,1,1,1,15,1,1,1,1,1,1,20,1,1,1,1,0.0,0,0,0,0,0,0,0,0,0,0,0,0,0,0,0,0,0,0,0,0,0,0,0,0,0,0,0,0,0,0,0,0,0,0,0,0,0,0,0,0,0,0,0,0,0,0,0,0,Gonzalo Castellani,ÃÂ£720Th. ,33.0,183.0,Midfielder - Attacking Midfield,right,UniÃÂ³n La Calera,18.0,0.0,0.0,927.0,22.0,0.0,1.0,1139.0,29.0,2.0,0.0,2064.0,39.0,4.0,3.0,3029.0,23.0,0.0,4.0,1248.0,7.0,0.0,0.0,315.0,27.0,1.0,3.0,1385.0,50.0,4.0,5.0,3596.0,17.0,0.0,0.0,981.0,LaLiga,26.0,1.0,2.0,1655.0,nan,nan,nan,nan,29/6/2010,Gonzalo Castellani,964854.0,1649.0,8/10/1987,22.0,0.0,0.0,0.0,0.0,1250.0,5250.0,4250.0,145.0,115.0,649998.0,183.0,75.0,M C,2.0,1.0,1.0,2.0,1.0,3.0,2.0,7.0,1.0,3.0,2.0,14.0,10.0,13.0,11.0,14.0,13.0,9.0,12.0,4.0,8.0,14.0,15.0,8.0,13.0,12.0,8.0,11.0,12.0,11.0,14.0,14.0,13.0,13.0,13.0,11.0,8.0,12.0,10.0,11.0,10.0,12.0,11.0,12.0,16.0,11.0,20.0,10.0,12.0,13.0,8.0,12.0,4.0,9.0,11.0,12.0,15.0,14.0,15.0,15.0,16.0,11.0,Gonzalo Castellani,ÃÂÃÂ£270Th. ,LaLiga
19/6/2011,Gary Medel,75000560,1652,8/3/1987,23,31,3,0,0,5800,7250,7000,160,144,1441490,172,71,D/WB/DM/M RC,2,3,1,2,2,2,3,5,3,1,1,8,10,9,13,10,6,15,13,13,16,12,4,17,11,17,16,19,6,14,11,12,14,12,13,10,15,14,19,13,14,14,8,9,17,13,20,18,11,14,12,16,4,18,13,15,16,12,12,9,7,14,17,16,17,1,17,1,17,D/WB/DM/M RC,343,1,1,1,1,1,1,17,1,16,20,16,1,17,1,16,33088.0,0,0,0,0,0,0,1,0,1,0,0,0,0,0,0,1,0,0,0,0,0,0,0,0,0,0,0,0,0,0,0,0,0,0,0,0,0,0,0,0,0,0,0,0,0,0,0,0,Gary Medel,ÃÂ£5.40m ,33.0,171.0,Midfielder - Defensive Midfield,right,Bologna FC 1909,35.0,0.0,0.0,2866.0,37.0,2.0,0.0,3071.0,39.0,7.0,3.0,3226.0,35.0,0.0,1.0,2918.0,44.0,0.0,3.0,3739.0,34.0,1.0,3.0,2790.0,31.0,0.0,0.0,2576.0,40.0,1.0,2.0,3043.0,35.0,0.0,0.0,2826.0,LaLiga,26.0,0.0,0.0,2015.0,2.0,0.0,1.0,45.0,nan,nan,nan,nan,nan,nan,nan,nan,nan,nan,nan,nan,nan,nan,nan,nan,nan,nan,nan,nan,nan,nan,nan,nan,nan,nan,nan,nan,nan,nan,nan,nan,nan,nan,nan,nan,nan,nan,nan,nan,nan,nan,nan,nan,nan,nan,nan,nan,nan,nan,nan,nan,nan,nan,nan,nan,nan,nan,nan,nan,nan,nan,nan,nan,nan,nan,nan,nan,nan,nan,nan,nan,nan,nan,nan,nan,nan,nan,nan,nan,nan,nan,nan,nan
19/6/2011,Francesco Della Rocca,7983853,776,9/14/1987,23,0,0,0,0,3965,6613,6613,153,132,598744,182,77,M/AM RC,1,2,2,1,1,3,1,3,3,1,2,12,12,12,11,13,10,12,11,11,12,12,13,13,13,14,13,11,13,13,11,13,12,14,10,12,13,15,13,13,13,13,13,10,15,13,20,18,13,15,8,13,7,13,11,9,11,13,14,13,7,8,1,1,20,16,16,1,20,M/AM RC,413,1,1,1,16,1,1,1,1,1,10,20,1,16,1,1,0.0,0,0,0,0,0,0,0,0,0,0,0,0,0,0,0,0,0,0,0,0,0,0,0,0,0,0,0,0,0,0,0,0,0,0,0,0,0,0,0,0,0,0,0,0,0,0,0,0,Francesco Della Rocca,ÃÂ£2.70m ,33.0,182.0,Midfielder - Central Midfield,left,Without Club,27.0,0.0,2.0,2012.0,23.0,1.0,2.0,1223.0,19.0,1.0,0.0,1514.0,11.0,0.0,0.0,721.0,7.0,0.0,0.0,313.0,37.0,0.0,1.0,2611.0,30.0,2.0,0.0,2161.0,7.0,0.0,0.0,512.0,5.0,0.0,0.0,258.0,Serie A,nan,nan,nan,nan,nan,nan,nan,nan,nan,nan,nan,nan,nan,nan,nan,nan,nan,nan,nan,nan,nan,nan,nan,nan,nan,nan,nan,nan,nan,nan,nan,nan,nan,nan,nan,nan,nan,nan,nan,nan,nan,nan,nan,nan,nan,nan,nan,nan,nan,nan,nan,nan,nan,nan,nan,nan,nan,nan,nan,nan,nan,nan,nan,nan,nan,nan,nan,nan,nan,nan,nan,nan,nan,nan,nan,nan,nan,nan,nan,nan,nan,nan,nan,nan,nan,nan,nan,nan,nan,nan,nan,nan
19/6/2011,Fran Rico,1511811,796,8/3/1987,23,0,0,0,0,3500,5500,5500,129,117,311866,178,71,M C,3,3,1,3,1,1,3,4,3,2,1,12,10,12,6,16,10,6,10,4,5,15,10,8,16,12,14,9,14,13,16,15,10,12,16,12,8,14,12,12,12,10,8,9,12,12,20,13,8,15,13,15,15,10,15,6,8,11,6,17,8,6,1,1,20,9,1,1,20,M C,401,1,1,1,9,1,1,1,1,1,15,20,1,1,1,1,4194304.0,0,0,0,0,0,0,0,0,0,0,0,0,0,0,0,0,0,0,0,0,0,0,1,0,0,0,0,0,0,0,0,0,0,0,0,0,0,0,0,0,0,0,0,0,0,0,0,0,Fran Rico,ÃÂ£900Th. ,33.0,178.0,Midfielder - Central Midfield,right,Retired,31.0,6.0,1.0,2641.0,20.0,2.0,1.0,1290.0,nan,nan,nan,nan,33.0,2.0,6.0,2561.0,32.0,3.0,1.0,2639.0,31.0,4.0,0.0,1638.0,22.0,2.0,1.0,1447.0,nan,nan,nan,nan,1.0,0.0,0.0,56.0,LaLiga,nan,nan,nan,nan,nan,nan,nan,nan,nan,nan,nan,nan,nan,nan,nan,nan,nan,nan,nan,nan,nan,nan,nan,nan,nan,nan,nan,nan,nan,nan,nan,nan,nan,nan,nan,nan,nan,nan,nan,nan,nan,nan,nan,nan,nan,nan,nan,nan,nan,nan,nan,nan,nan,nan,nan,nan,nan,nan,nan,nan,nan,nan,nan,nan,nan,nan,nan,nan,nan,nan,nan,nan,nan,nan,nan,nan,nan,nan,nan,nan,nan,nan,nan,nan,nan,nan,nan,nan,nan,nan,nan,nan,19-06-17,18.3.4.28,Fran Rico,1511811,796,03-Aug-87,29,0,0,0,0,4650,6750,6750,141,135,11178195,178,71,DM/M C,3,1,2,2,1,4,1,2,4,3,3,11,10,10,11,16,10,9,12,4,9,15,10,9,15,12,15,9,15,14,16,16,15,12,16,12,13,16,14,11,12,13,8,10,8,11,20,13,10,14,13,15,15,12,12,14,15,15,16,16,16,15,1,1,20,9,1,1,20,DM/M C,421,1,1,1,9,1,1,1,1,1,17,20,1,1,1,1,8796100000000.0,0,0,0,0,0,0,0,0,0,0,0,0,0,0,0,0,0,0,0,0,0,0,1,0,0,0,0,0,0,0,0,0,0,0,0,0,0,0,0,0,0,0,0,1,0,0,0,0,Fran Rico,ÃÂ£720Th. ,33.0,178.0,Midfielder - Central Midfield,right,Retired,22.0,2.0,1.0,1447.0,nan,nan,nan,nan,1.0,0.0,0.0,56.0,nan,nan,nan,nan,nan,nan,nan,nan,LaLiga,15-07-16,17.3.2.23,Fran Rico,1511811.0,796.0,03-Aug-87,28.0,0.0,0.0,0.0,0.0,4650.0,6800.0,6800.0,141.0,136.0,10075902.0,178.0,71.0,DM/M C,1.0,2.0,3.0,1.0,3.0,2.0,1.0,1.0,1.0,3.0,3.0,11.0,10.0,10.0,11.0,16.0,10.0,10.0,12.0,4.0,10.0,15.0,10.0,11.0,15.0,12.0,15.0,10.0,15.0,14.0,16.0,16.0,15.0,12.0,16.0,13.0,13.0,16.0,15.0,11.0,12.0,13.0,8.0,10.0,8.0,11.0,20.0,13.0,10.0,14.0,13.0,15.0,15.0,12.0,12.0,14.0,15.0,15.0,16.0,16.0,16.0,15.0,Fran Rico,ÃÂ£2.25m ,LaLiga
19/6/2011,Felipe Seymour,75003077,1652,7/23/1987,23,1,0,0,0,4000,6500,6500,140,130,546023,174,67,DM/M C,1,3,2,1,2,2,2,3,3,2,1,9,10,11,10,11,7,12,14,8,14,11,6,14,11,12,14,12,14,15,12,12,11,8,10,9,13,15,16,13,13,11,12,8,16,13,20,17,15,13,7,15,4,11,13,15,14,14,13,8,6,17,1,1,20,10,14,12,20,DM/M C,421,1,1,1,10,6,8,1,1,1,19,20,12,14,1,1,4294967296.0,0,0,0,0,0,0,0,0,0,0,0,0,0,0,0,0,0,0,0,0,0,0,0,0,0,0,0,0,0,0,0,0,1,0,0,0,0,0,0,0,0,0,0,0,0,0,0,0,Felipe Seymour,ÃÂ£1.17m ,33.0,174.0,Midfielder - Defensive Midfield,right,UniÃÂ³n La Calera,20.0,0.0,0.0,1673.0,28.0,1.0,0.0,1338.0,23.0,0.0,1.0,1244.0,33.0,1.0,2.0,2374.0,2.0,0.0,0.0,49.0,nan,nan,nan,nan,27.0,1.0,0.0,1845.0,21.0,1.0,0.0,1460.0,18.0,0.0,0.0,1319.0,Serie A,5.0,0.0,0.0,379.0,nan,nan,nan,nan,nan,nan,nan,nan,nan,nan,nan,nan,nan,nan,nan,nan,nan,nan,nan,nan,nan,nan,nan,nan,nan,nan,nan,nan,nan,nan,nan,nan,nan,nan,nan,nan,nan,nan,nan,nan,nan,nan,nan,nan,nan,nan,nan,nan,nan,nan,nan,nan,nan,nan,nan,nan,nan,nan,nan,nan,nan,nan,nan,nan,nan,nan,nan,nan,nan,nan,nan,nan,nan,nan,nan,nan,nan,nan,nan,nan,nan,nan,nan,nan,nan,nan,nan,nan
19/6/2011,Fabrice Muamba,5111919,765,4/6/1988,23,0,0,33,0,4750,6500,6600,140,130,834025,188,78,DM/M C,3,3,2,1,3,1,1,2,2,1,3,9,9,9,6,11,7,9,7,7,14,11,7,14,9,16,15,17,10,12,9,13,16,9,9,11,15,16,17,15,13,13,13,12,17,14,20,17,16,13,9,11,2,10,10,9,16,12,14,13,12,7,1,1,20,1,1,1,20,DM/M C,311,1,1,1,1,1,1,1,1,1,20,20,1,1,1,1,159049000000.0,0,0,0,0,0,0,0,0,0,0,0,0,0,0,0,0,0,0,0,1,0,0,0,0,0,0,0,1,0,0,0,0,1,0,1,0,0,1,0,0,0,0,0,0,0,0,0,0,Fabrice Muamba,ÃÂ£4.50m ,32.0,188.0,Midfielder - Central Midfield,right,Retired,41.0,1.0,2.0,2981.0,24.0,2.0,1.0,1605.0,nan,nan,nan,nan,nan,nan,nan,nan,nan,nan,nan,nan,nan,nan,nan,nan,nan,nan,nan,nan,nan,nan,nan,nan,nan,nan,nan,nan,Premier League,nan,nan,nan,nan,nan,nan,nan,nan,29/6/2010,Fabrice Muamba,5111919.0,765.0,4/6/1988,22.0,0.0,0.0,25.0,0.0,4096.0,6600.0,6600.0,140.0,128.0,4714915.0,188.0,75.0,DM/M C,1.0,3.0,3.0,2.0,2.0,1.0,3.0,1.0,1.0,3.0,2.0,9.0,9.0,9.0,6.0,10.0,7.0,9.0,7.0,7.0,14.0,11.0,7.0,14.0,9.0,16.0,15.0,17.0,9.0,12.0,9.0,12.0,16.0,9.0,9.0,11.0,15.0,16.0,17.0,15.0,13.0,13.0,13.0,12.0,17.0,14.0,20.0,17.0,16.0,13.0,9.0,11.0,2.0,10.0,10.0,9.0,16.0,12.0,14.0,13.0,12.0,7.0,Fabrice Muamba,ÃÂÃÂ£6.30m ,Premier League
19/6/2011,Fabian Lustenberger,69003477,798,5/2/1988,23,0,0,25,2,4250,6250,6250,147,126,519231,180,70,DM/M C,2,2,1,1,1,1,2,2,3,1,1,6,9,10,6,14,8,13,8,7,10,15,6,12,14,14,16,14,13,10,13,15,16,6,6,10,12,17,16,14,15,10,9,8,2,14,20,14,6,11,7,10,17,16,12,15,11,13,16,16,11,4,1,1,18,13,14,1,18,DM/M C,311,1,1,1,12,1,13,1,1,1,20,18,1,14,1,1,20971520.0,0,0,0,0,0,0,0,0,0,0,0,0,0,0,0,0,0,0,0,0,0,0,1,0,1,0,0,0,0,0,0,0,0,0,0,0,0,0,0,0,0,0,0,0,0,0,0,0,Fabian Lustenberger,ÃÂ£1.80m ,32.0,180.0,Defender - Centre-Back,right,BSC Young Boys,22.0,1.0,2.0,1633.0,19.0,1.0,1.0,1017.0,34.0,0.0,2.0,3021.0,21.0,0.0,0.0,1920.0,30.0,1.0,0.0,2489.0,34.0,1.0,0.0,2927.0,22.0,0.0,1.0,1717.0,29.0,0.0,0.0,2076.0,30.0,0.0,1.0,2185.0,Bundesliga,41.0,1.0,0.0,3293.0,9.0,0.0,0.0,810.0,nan,nan,nan,nan,nan,nan,nan,nan,nan,nan,nan,nan,nan,nan,nan,nan,nan,nan,nan,nan,nan,nan,nan,nan,nan,nan,nan,nan,nan,nan,nan,nan,nan,nan,nan,nan,nan,nan,nan,nan,nan,nan,nan,nan,nan,nan,nan,nan,nan,nan,nan,nan,nan,nan,nan,nan,nan,nan,nan,nan,nan,nan,nan,nan,nan,nan,nan,nan,nan,nan,nan,nan,nan,nan,nan,nan,nan,nan,nan,nan,nan,nan,nan,nan,19-06-17,18.3.4.28,Fabian Lustenberger,69003477,798,02-May-88,29,3,0,25,2,4557,5570,6500,130,130,7905881,180,70,D/DM/M C,1,1,2,3,2,4,2,3,1,2,1,6,9,10,6,11,6,11,8,8,12,13,8,14,12,12,17,10,14,14,10,16,13,6,12,8,15,18,13,12,13,10,9,9,12,12,20,14,9,13,7,15,11,16,12,12,16,13,17,16,14,4,18,1,20,1,1,1,20,D/DM/M C,331,1,1,1,1,1,1,18,1,1,20,20,1,1,1,1,20971520.0,0,0,0,0,0,0,0,0,0,0,0,0,0,0,0,0,0,0,0,0,0,0,1,0,1,0,0,0,0,0,0,0,0,0,0,0,0,0,0,0,0,0,0,0,0,0,0,0,Fabian Lustenberger,ÃÂ£2.25m ,32.0,180.0,Defender - Centre-Back,right,BSC Young Boys,22.0,0.0,1.0,1717.0,29.0,0.0,0.0,2076.0,30.0,0.0,1.0,2185.0,41.0,1.0,0.0,3293.0,9.0,0.0,0.0,810.0,Bundesliga,15-07-16,17.3.2.23,Fabian Lustenberger,69003477.0,798.0,02-May-88,28.0,3.0,0.0,25.0,2.0,4574.0,5623.0,6497.0,130.0,130.0,6828419.0,180.0,70.0,D/DM/M C,3.0,1.0,1.0,2.0,1.0,3.0,2.0,3.0,1.0,2.0,3.0,6.0,9.0,10.0,6.0,11.0,6.0,11.0,8.0,8.0,12.0,13.0,8.0,14.0,12.0,12.0,17.0,10.0,14.0,14.0,10.0,16.0,13.0,6.0,12.0,8.0,15.0,18.0,13.0,12.0,13.0,10.0,9.0,9.0,12.0,12.0,20.0,14.0,9.0,13.0,7.0,15.0,11.0,16.0,12.0,12.0,16.0,13.0,17.0,16.0,14.0,4.0,Fabian Lustenberger,ÃÂ£2.70m ,Bundesliga
19/6/2011,Esteban Granero,7458313,796,7/2/1987,23,0,0,8,2,5750,7350,7350,159,147,0,180,75,M/AM RLC,1,3,3,3,1,2,3,1,2,1,2,16,15,15,12,17,13,10,14,7,6,16,13,8,16,10,12,13,15,11,17,13,15,16,10,13,10,12,13,13,15,10,9,13,12,13,20,13,10,12,12,13,7,13,13,14,14,16,13,16,15,7,1,1,18,20,15,16,20,M/AM RLC,526,1,1,1,20,16,15,1,1,1,8,18,13,12,1,1,17592200000000.0,0,0,1,0,1,0,0,1,0,0,0,0,0,0,0,0,0,0,0,0,0,0,0,0,0,0,0,0,0,0,0,0,0,0,0,0,0,0,0,0,0,0,0,0,1,0,0,0,Esteban Granero,ÃÂ£6.30m ,33.0,180.0,Midfielder - Central Midfield,right,Marbella FC,32.0,2.0,4.0,1271.0,28.0,0.0,2.0,1000.0,27.0,1.0,1.0,1886.0,8.0,0.0,1.0,367.0,39.0,1.0,2.0,2791.0,15.0,0.0,0.0,872.0,22.0,0.0,1.0,736.0,31.0,2.0,3.0,1752.0,30.0,3.0,1.0,2137.0,LaLiga,27.0,1.0,3.0,1651.0,2.0,0.0,0.0,178.0,29/6/2010,Esteban Granero,7458313.0,796.0,7/2/1987,22.0,0.0,0.0,8.0,2.0,5402.0,7250.0,7250.0,159.0,147.0,14967881.0,179.0,76.0,M/AM RLC,2.0,3.0,2.0,1.0,2.0,1.0,2.0,5.0,1.0,3.0,3.0,16.0,15.0,15.0,12.0,17.0,13.0,10.0,14.0,7.0,6.0,16.0,13.0,8.0,16.0,10.0,12.0,13.0,15.0,11.0,17.0,13.0,15.0,16.0,10.0,13.0,10.0,12.0,13.0,13.0,15.0,10.0,9.0,13.0,12.0,13.0,20.0,13.0,10.0,12.0,12.0,13.0,7.0,13.0,13.0,14.0,14.0,16.0,13.0,16.0,15.0,7.0,Esteban Granero,ÃÂÃÂ£6.30m ,LaLiga,19-06-17,18.3.4.28,Esteban Granero,7458313,796,02-Jul-87,29,0,0,10,2,4900,6400,6400,142,128,3362261,180,75,M/AM C,2,2,2,3,2,1,1,3,3,3,1,14,13,13,11,13,13,9,12,6,5,13,12,10,13,13,12,13,14,12,14,12,13,14,14,14,11,14,12,12,13,12,10,13,11,13,20,13,10,12,10,13,11,7,13,14,14,13,13,16,15,7,1,1,20,20,9,10,20,M/AM C,411,1,1,1,20,1,1,1,1,1,13,20,10,9,1,1,17592200000000.0,0,0,1,0,1,0,0,1,0,0,0,0,0,0,0,0,0,0,0,0,0,0,0,0,0,0,0,0,0,0,0,0,0,0,0,0,0,0,0,0,0,0,0,0,1,0,0,0,Esteban Granero,ÃÂ£1.35m ,33.0,180.0,Midfielder - Central Midfield,right,Marbella FC,22.0,0.0,1.0,736.0,31.0,2.0,3.0,1752.0,30.0,3.0,1.0,2137.0,27.0,1.0,3.0,1651.0,2.0,0.0,0.0,178.0,LaLiga,15-07-16,17.3.2.23,Esteban Granero,7458313.0,796.0,02-Jul-87,29.0,0.0,0.0,10.0,2.0,5500.0,6350.0,6350.0,142.0,126.0,3724358.0,180.0,75.0,M/AM C,1.0,3.0,3.0,1.0,3.0,1.0,4.0,2.0,2.0,1.0,3.0,14.0,13.0,13.0,11.0,13.0,13.0,9.0,12.0,6.0,5.0,13.0,12.0,10.0,13.0,13.0,12.0,13.0,14.0,12.0,14.0,12.0,13.0,14.0,14.0,14.0,11.0,14.0,12.0,12.0,12.0,12.0,10.0,13.0,11.0,12.0,20.0,13.0,10.0,12.0,10.0,13.0,11.0,7.0,13.0,14.0,14.0,13.0,13.0,16.0,15.0,7.0,Esteban Granero,ÃÂ£1.80m ,LaLiga
19/6/2011,EfraÃÂ­n JuÃÂ¡rez,51000041,379,2/22/1988,23,35,1,4,1,4500,7150,6500,145,130,880925,178,68,WB/DM/M RC,1,2,3,1,2,3,3,1,3,2,2,5,9,10,6,11,5,6,9,5,13,12,11,13,14,13,12,12,13,12,11,13,14,13,13,12,8,14,13,17,13,13,9,10,14,15,20,15,12,15,11,16,4,18,14,16,12,15,10,12,12,6,15,19,16,1,19,1,16,WB/DM/M RC,333,1,1,1,1,1,1,1,1,15,20,16,1,14,1,19,32.0,0,0,0,0,0,1,0,0,0,0,0,0,0,0,0,0,0,0,0,0,0,0,0,0,0,0,0,0,0,0,0,0,0,0,0,0,0,0,0,0,0,0,0,0,0,0,0,0,EfraÃÂ­n JuÃÂ¡rez,ÃÂ£1.35m ,32.0,178.0,Defender - Right-Back,right,Retired,20.0,2.0,1.0,1144.0,16.0,1.0,1.0,1394.0,16.0,0.0,0.0,974.0,26.0,1.0,0.0,2138.0,30.0,0.0,1.0,2495.0,33.0,2.0,2.0,2820.0,28.0,1.0,0.0,1475.0,34.0,1.0,1.0,2406.0,21.0,0.0,4.0,1661.0,LaLiga,nan,nan,nan,nan,nan,nan,nan,nan,nan,nan,nan,nan,nan,nan,nan,nan,nan,nan,nan,nan,nan,nan,nan,nan,nan,nan,nan,nan,nan,nan,nan,nan,nan,nan,nan,nan,nan,nan,nan,nan,nan,nan,nan,nan,nan,nan,nan,nan,nan,nan,nan,nan,nan,nan,nan,nan,nan,nan,nan,nan,nan,nan,nan,nan,nan,nan,nan,nan,nan,nan,nan,nan,nan,nan,nan,nan,nan,nan,nan,nan,nan,nan,nan,nan,nan,nan,nan,nan,nan,nan,nan,nan
19/6/2011,ClÃÂ©ment ChantÃÂ´me,8444109,769,9/11/1987,23,0,0,7,0,5050,6327,6327,150,140,3850075,180,71,M C,3,3,1,3,2,2,2,8,3,3,3,13,12,13,6,15,14,9,13,9,8,14,14,12,15,14,12,16,12,13,14,14,16,12,9,13,12,17,17,14,13,14,10,10,13,12,20,17,12,15,14,16,7,10,9,15,16,14,12,10,12,8,1,1,20,15,14,10,20,M C,401,1,1,1,15,10,12,1,1,1,12,20,10,14,1,1,4195360.0,0,0,0,0,0,1,0,0,0,0,1,0,0,0,0,0,0,0,0,0,0,0,1,0,0,0,0,0,0,0,0,0,0,0,0,0,0,0,0,0,0,0,0,0,0,0,0,0,ClÃÂ©ment ChantÃÂ´me,ÃÂ£5.40m ,33.0,180.0,Midfielder - Defensive Midfield,right,AS Poissy,44.0,3.0,2.0,3652.0,21.0,0.0,3.0,1280.0,38.0,1.0,4.0,2227.0,28.0,2.0,5.0,2243.0,25.0,1.0,3.0,1509.0,35.0,2.0,2.0,2859.0,8.0,0.0,0.0,411.0,23.0,1.0,1.0,1818.0,17.0,0.0,0.0,1233.0,Ligue 1,nan,nan,nan,nan,4.0,0.0,0.0,281.0,29/6/2010,ClÃÂÃÂ©ment ChantÃÂÃÂ´me,8444109.0,769.0,9/11/1987,22.0,0.0,0.0,7.0,0.0,3906.0,5600.0,5600.0,150.0,125.0,3937961.0,180.0,71.0,M C,2.0,1.0,2.0,2.0,3.0,1.0,2.0,1.0,1.0,1.0,3.0,13.0,11.0,13.0,6.0,14.0,14.0,9.0,13.0,9.0,7.0,13.0,14.0,12.0,15.0,9.0,9.0,12.0,13.0,11.0,14.0,11.0,12.0,12.0,9.0,13.0,10.0,14.0,15.0,14.0,13.0,14.0,10.0,10.0,13.0,11.0,20.0,14.0,12.0,12.0,11.0,14.0,7.0,10.0,9.0,15.0,13.0,14.0,12.0,12.0,12.0,8.0,ClÃÂÃÂ©ment ChantÃÂÃÂ´me,ÃÂÃÂ£5.85m ,Ligue 1
19/6/2011,Christian TrÃÂ¤sch,35003512,771,8/1/1987,23,7,0,0,0,6300,7450,7450,151,148,9172104,180,74,D/WB/DM/M RLC,1,3,1,1,2,2,3,1,2,2,3,9,14,11,6,7,9,6,15,15,18,9,9,17,7,16,15,17,9,17,7,12,13,5,14,7,13,19,18,15,10,10,11,16,17,13,20,19,11,18,4,15,6,18,9,7,12,5,15,11,13,9,18,17,19,1,18,16,19,D/WB/DM/M RLC,346,1,1,1,1,1,1,10,16,18,20,19,12,14,15,17,154619000000.0,0,0,0,0,0,0,1,0,0,1,0,0,0,0,0,1,0,0,0,0,0,0,0,0,0,0,0,0,0,0,0,0,0,0,1,0,0,1,0,0,0,0,0,0,0,0,0,0,Christian TrÃÂ¤sch,ÃÂ£6.30m ,33.0,180.0,Midfielder - Defensive Midfield,right,Retired,45.0,1.0,3.0,4005.0,34.0,0.0,5.0,2716.0,21.0,1.0,0.0,1079.0,26.0,0.0,2.0,2184.0,22.0,1.0,2.0,1376.0,38.0,0.0,3.0,2720.0,14.0,0.0,1.0,891.0,26.0,1.0,0.0,2166.0,11.0,0.0,0.0,758.0,Bundesliga,1.0,0.0,0.0,75.0,nan,nan,nan,nan,29/6/2010,Christian TrÃÂ¤sch,35003512.0,771.0,8/1/1987,22.0,1.0,0.0,0.0,0.0,2750.0,6850.0,6850.0,151.0,148.0,19298213.0,180.0,74.0,D/WB/DM/M RLC,3.0,2.0,2.0,3.0,1.0,3.0,3.0,1.0,3.0,1.0,2.0,9.0,12.0,8.0,6.0,7.0,9.0,6.0,15.0,15.0,17.0,10.0,9.0,17.0,7.0,16.0,15.0,17.0,9.0,17.0,8.0,12.0,13.0,5.0,12.0,9.0,13.0,19.0,18.0,15.0,10.0,10.0,11.0,16.0,17.0,13.0,20.0,18.0,11.0,18.0,4.0,15.0,6.0,18.0,10.0,17.0,10.0,10.0,12.0,14.0,2.0,2.0,Christian TrÃÂÃÂ¤sch,ÃÂÃÂ£9.00m ,Bundesliga
19/6/2011,Charles KaborÃÂ©,34013978,9,2/9/1988,23,26,2,0,0,5550,6900,6200,160,138,704117,181,75,DM/M RC,3,1,2,3,2,1,2,5,3,3,2,7,8,12,6,12,6,13,13,10,11,12,10,13,13,15,16,15,13,12,10,13,16,8,13,9,14,14,17,14,13,14,10,8,17,14,20,17,15,13,14,14,5,11,15,15,15,16,13,14,16,7,15,15,20,1,15,1,20,DM/M RC,423,1,1,1,1,1,1,8,1,15,17,20,1,10,1,15,320.0,0,0,0,0,0,0,1,0,1,0,0,0,0,0,0,0,0,0,0,0,0,0,0,0,0,0,0,0,0,0,0,0,0,0,0,0,0,0,0,0,0,0,0,0,0,0,0,0,Charles KaborÃÂ©,ÃÂ£4.50m ,32.0,183.0,Midfielder - Defensive Midfield,right,Dynamo Moscow,44.0,0.0,3.0,2857.0,38.0,0.0,1.0,2061.0,39.0,0.0,5.0,3178.0,35.0,1.0,7.0,2999.0,31.0,0.0,4.0,2649.0,32.0,0.0,1.0,2770.0,33.0,1.0,2.0,2765.0,22.0,0.0,0.0,1657.0,37.0,1.0,2.0,3073.0,Ligue 1,21.0,0.0,0.0,1368.0,11.0,0.0,0.0,732.0,29/6/2010,Charles KaborÃÂ©,34013978.0,9.0,2/9/1988,22.0,20.0,1.0,0.0,0.0,4830.0,6950.0,6250.0,165.0,139.0,12766689.0,181.0,75.0,DM/M RC,2.0,3.0,2.0,2.0,1.0,1.0,3.0,1.0,1.0,1.0,3.0,8.0,10.0,12.0,6.0,13.0,6.0,13.0,13.0,8.0,12.0,12.0,11.0,14.0,12.0,16.0,15.0,15.0,13.0,13.0,11.0,13.0,16.0,8.0,14.0,9.0,13.0,14.0,17.0,14.0,12.0,14.0,10.0,8.0,17.0,14.0,20.0,17.0,15.0,13.0,12.0,15.0,5.0,11.0,15.0,15.0,14.0,16.0,13.0,14.0,16.0,7.0,Charles KaborÃÂÃÂ©,ÃÂÃÂ£5.85m ,Ligue 1
19/6/2011,Bruno Gallo,19045496,1651,5/7/1988,23,0,0,0,0,1587,5350,5350,125,107,104678,182,75,D/WB/M LC,2,1,2,3,1,1,1,4,1,2,3,11,12,12,10,12,11,9,11,10,10,11,12,12,12,11,12,11,12,11,12,13,13,11,10,12,11,11,12,12,12,12,11,20,13,12,6,12,12,10,8,7,8,12,12,13,10,13,14,14,14,6,17,17,20,7,1,20,15,D/WB/M LC,434,1,1,1,1,7,1,1,17,1,1,15,20,1,17,1,0.0,0,0,0,0,0,0,0,0,0,0,0,0,0,0,0,0,0,0,0,0,0,0,0,0,0,0,0,0,0,0,0,0,0,0,0,0,0,0,0,0,0,0,0,0,0,0,0,0,Bruno Gallo,ÃÂ£720Th. ,32.0,182.0,Midfielder - Central Midfield,left,Without Club,13.0,0.0,2.0,844.0,20.0,0.0,1.0,1373.0,19.0,0.0,0.0,715.0,nan,nan,nan,nan,47.0,8.0,2.0,3524.0,6.0,0.0,0.0,272.0,1.0,0.0,0.0,19.0,20.0,4.0,0.0,1799.0,46.0,4.0,2.0,3763.0,Liga NOS,nan,nan,nan,nan,nan,nan,nan,nan,29/6/2010,Bruno Gallo,19045496.0,1651.0,5/7/1988,22.0,0.0,0.0,0.0,0.0,1500.0,5350.0,5350.0,132.0,107.0,408678.0,182.0,75.0,D/WB/M LC,2.0,3.0,3.0,3.0,1.0,2.0,2.0,2.0,1.0,2.0,2.0,11.0,12.0,12.0,10.0,12.0,11.0,9.0,11.0,10.0,10.0,11.0,12.0,12.0,12.0,11.0,12.0,11.0,12.0,11.0,12.0,13.0,13.0,11.0,10.0,12.0,11.0,11.0,12.0,12.0,12.0,12.0,11.0,20.0,13.0,12.0,6.0,12.0,12.0,10.0,8.0,10.0,8.0,12.0,12.0,13.0,4.0,13.0,14.0,14.0,14.0,6.0,Bruno Gallo,ÃÂÃÂ£270Th. ,Liga NOS
19/6/2011,Boy Deul,37000104,380,8/30/1987,23,0,0,0,0,2750,4900,4900,122,102,99862,178,66,M/AM RC,3,2,2,2,3,1,1,2,2,1,2,8,12,13,12,12,8,5,7,3,5,12,10,5,12,9,12,13,12,12,13,12,10,9,8,14,11,14,14,10,13,13,8,10,18,11,20,12,11,10,14,10,11,10,12,6,12,5,10,10,7,20,1,1,18,20,16,14,20,M/AM RC,523,1,1,1,20,14,16,1,1,1,1,18,10,10,1,1,0.0,0,0,0,0,0,0,0,0,0,0,0,0,0,0,0,0,0,0,0,0,0,0,0,0,0,0,0,0,0,0,0,0,0,0,0,0,0,0,0,0,0,0,0,0,0,0,0,0,nan,nan,nan,nan,nan,nan,nan,nan,nan,nan,nan,nan,nan,nan,nan,nan,nan,nan,nan,nan,nan,nan,nan,nan,nan,nan,nan,nan,nan,nan,nan,nan,nan,nan,nan,nan,nan,nan,nan,nan,nan,nan,nan,nan,nan,nan,nan,nan,nan,nan,nan,nan,nan,nan,nan,nan,nan,nan,nan,nan,nan,nan,nan,nan,nan,nan,nan,nan,nan,nan,nan,nan,nan,nan,nan,nan,nan,nan,nan,nan,nan,nan,nan,nan,nan,nan,nan,nan,nan,nan,nan,nan,nan,nan,nan,nan,nan,nan,nan,nan,nan,nan,nan,nan,nan,nan,nan,nan,nan,nan,nan,nan,nan,nan,nan,nan,nan,nan,nan,nan,nan,nan,nan,nan,nan,nan,nan,nan,nan,nan,nan,nan,nan,nan,nan,nan
19/6/2011,AndrÃÂ© Castro,55004179,788,4/2/1988,23,0,0,10,0,4750,5849,6250,147,130,212516,179,75,M/AM C,2,3,2,1,2,3,1,1,1,1,1,12,13,10,12,14,9,10,15,10,12,13,12,12,13,13,11,13,14,13,10,13,16,9,11,12,14,15,16,14,14,12,11,8,13,13,20,12,12,13,9,11,7,14,10,13,18,12,16,13,13,5,1,1,20,17,10,1,20,M/AM C,411,1,1,1,17,1,1,1,1,1,10,20,1,10,1,1,0.0,0,0,0,0,0,0,0,0,0,0,0,0,0,0,0,0,0,0,0,0,0,0,0,0,0,0,0,0,0,0,0,0,0,0,0,0,0,0,0,0,0,0,0,0,0,0,0,0,AndrÃÂ© Castro,ÃÂ£2.25m ,32.0,181.0,Midfielder - Central Midfield,right,SC Braga,21.0,2.0,1.0,1011.0,29.0,2.0,1.0,2164.0,24.0,1.0,2.0,630.0,34.0,3.0,4.0,2951.0,32.0,5.0,1.0,2735.0,33.0,4.0,4.0,2805.0,39.0,7.0,5.0,3315.0,33.0,4.0,9.0,2951.0,34.0,1.0,10.0,2863.0,LaLiga,34.0,4.0,2.0,2254.0,6.0,1.0,0.0,420.0,29/6/2010,Castro,55004179.0,788.0,4/2/1988,22.0,0.0,0.0,10.0,0.0,2250.0,5400.0,5400.0,159.0,118.0,1300776.0,179.0,75.0,M C,2.0,2.0,1.0,2.0,3.0,3.0,1.0,2.0,3.0,1.0,1.0,12.0,12.0,10.0,12.0,12.0,9.0,10.0,13.0,10.0,12.0,12.0,12.0,12.0,12.0,13.0,11.0,13.0,14.0,12.0,10.0,11.0,16.0,9.0,11.0,11.0,13.0,15.0,15.0,12.0,12.0,12.0,11.0,8.0,13.0,11.0,20.0,12.0,12.0,11.0,9.0,11.0,7.0,12.0,10.0,13.0,18.0,12.0,16.0,13.0,13.0,5.0,ZÃÂÃÂ© Castro,ÃÂÃÂ£1.80m ,LaLiga
19/6/2011,Anderson,320552,1651,4/13/1988,23,8,0,0,0,6514,7266,7516,168,151,2882597,176,69,M C,1,1,2,2,1,3,1,9,1,2,3,12,13,13,5,15,14,7,3,7,8,15,15,12,15,14,13,14,13,12,14,11,13,12,7,13,10,16,17,18,16,17,8,20,16,16,13,12,17,12,10,16,5,9,14,16,13,18,12,11,15,8,1,1,20,15,10,12,20,M C,401,1,1,1,15,11,10,1,1,1,12,20,12,8,1,1,17179869316.0,0,0,1,0,0,0,0,1,0,0,0,0,0,0,0,0,0,0,0,0,0,0,0,0,0,0,0,0,0,0,0,0,0,0,1,0,0,0,0,0,0,0,0,0,0,0,0,0,Anderson,ÃÂ£10.80m ,32.0,175.0,Midfielder - Central Midfield,left,Retired,32.0,6.0,3.0,1995.0,16.0,2.0,1.0,1078.0,27.0,2.0,5.0,1566.0,17.0,0.0,0.0,602.0,36.0,0.0,5.0,2272.0,20.0,1.0,1.0,948.0,12.0,0.0,0.0,536.0,nan,nan,nan,nan,14.0,0.0,0.0,769.0,Premier League,1.0,0.0,0.0,45.0,nan,nan,nan,nan,29/6/2010,Anderson,320552.0,1651.0,4/13/1988,22.0,8.0,0.0,0.0,0.0,5625.0,7500.0,7500.0,168.0,150.0,19948265.0,176.0,69.0,M C,3.0,1.0,1.0,1.0,2.0,1.0,1.0,5.0,3.0,3.0,2.0,12.0,13.0,13.0,5.0,15.0,13.0,7.0,3.0,7.0,8.0,15.0,15.0,12.0,15.0,14.0,13.0,14.0,13.0,12.0,14.0,10.0,13.0,12.0,7.0,13.0,9.0,15.0,17.0,18.0,16.0,17.0,8.0,20.0,16.0,16.0,12.0,17.0,16.0,10.0,10.0,16.0,5.0,9.0,14.0,16.0,13.0,18.0,10.0,11.0,15.0,8.0,Anderson,ÃÂÃÂ£18.90m ,Premier League
19/6/2011,Alex Song,8428095,11,9/9/1987,23,24,0,0,0,6264,7867,7717,167,157,20148243,185,74,D/DM/M C,1,1,1,1,1,2,3,4,1,1,2,5,9,12,9,13,5,15,7,10,14,13,10,16,13,14,16,16,17,16,12,14,17,9,9,13,15,16,18,12,14,16,13,13,16,11,20,18,17,16,11,13,5,15,14,14,15,12,15,13,16,8,17,1,18,1,1,1,18,D/DM/M C,331,1,1,1,1,1,1,17,1,1,20,18,1,1,1,1,4.0,0,0,1,0,0,0,0,0,0,0,0,0,0,0,0,0,0,0,0,0,0,0,0,0,0,0,0,0,0,0,0,0,0,0,0,0,0,0,0,0,0,0,0,0,0,0,0,0,Alex Song,ÃÂ£25.65m ,33.0,185.0,Midfielder - Defensive Midfield,right,Without Club,42.0,5.0,4.0,3390.0,46.0,1.0,14.0,4079.0,34.0,1.0,1.0,2394.0,31.0,0.0,1.0,1720.0,31.0,0.0,3.0,2434.0,16.0,0.0,1.0,938.0,16.0,0.0,2.0,1075.0,7.0,1.0,0.0,319.0,16.0,0.0,0.0,1064.0,Premier League,12.0,1.0,0.0,584.0,nan,nan,nan,nan,29/6/2010,Alex Song,8428095.0,11.0,9/9/1987,22.0,24.0,0.0,0.0,0.0,6162.0,7850.0,7750.0,167.0,157.0,-1.0,185.0,74.0,D/DM/M C,1.0,3.0,2.0,3.0,1.0,3.0,1.0,6.0,2.0,3.0,3.0,5.0,9.0,12.0,6.0,13.0,5.0,14.0,8.0,10.0,14.0,13.0,10.0,16.0,13.0,12.0,16.0,15.0,17.0,16.0,12.0,14.0,17.0,9.0,9.0,13.0,15.0,16.0,17.0,12.0,14.0,16.0,13.0,13.0,16.0,11.0,20.0,18.0,17.0,16.0,11.0,13.0,7.0,15.0,14.0,14.0,15.0,12.0,15.0,13.0,16.0,8.0,Alex Song,ÃÂÃÂ£15.30m ,Premier League
19/6/2011,Alain TraorÃÂ©,34001338,9,1/1/1988,23,15,7,0,0,5350,6650,5980,150,133,586439,176,66,M/AM C,2,2,1,1,1,1,1,4,3,2,3,11,13,14,10,14,14,6,15,6,4,13,12,5,16,7,13,11,13,11,15,13,14,14,7,13,10,14,14,15,14,12,8,20,14,13,11,15,7,12,7,14,10,8,11,14,14,12,11,16,16,7,1,1,18,20,1,14,20,M/AM C,521,1,1,1,20,14,1,1,1,1,12,18,14,1,1,1,640.0,0,0,0,0,0,0,0,1,0,1,0,0,0,0,0,0,0,0,0,0,0,0,0,0,0,0,0,0,0,0,0,0,0,0,0,0,0,0,0,0,0,0,0,0,0,0,0,0,Alain TraorÃÂ©,ÃÂ£4.50m ,31.0,176.0,Midfielder - Attacking Midfield,left,Renaissance de Berkane,25.0,5.0,0.0,1863.0,27.0,9.0,8.0,2143.0,14.0,6.0,4.0,1111.0,22.0,2.0,1.0,1400.0,8.0,0.0,0.0,286.0,7.0,0.0,0.0,210.0,19.0,1.0,2.0,684.0,16.0,4.0,1.0,1039.0,22.0,3.0,2.0,1306.0,Ligue 1,25.0,6.0,7.0,1299.0,nan,nan,nan,nan,29/6/2010,Alain TraorÃÂÃÂ©,34001338.0,9.0,1/1/1988,22.0,9.0,2.0,0.0,0.0,3025.0,5500.0,5000.0,130.0,110.0,1085657.0,176.0,66.0,M/AM LC,3.0,2.0,1.0,1.0,1.0,2.0,2.0,3.0,3.0,3.0,3.0,10.0,11.0,13.0,8.0,13.0,12.0,6.0,13.0,6.0,4.0,10.0,11.0,4.0,15.0,6.0,11.0,8.0,12.0,12.0,13.0,10.0,11.0,12.0,7.0,13.0,6.0,11.0,10.0,15.0,14.0,12.0,8.0,20.0,13.0,13.0,8.0,14.0,7.0,12.0,6.0,14.0,10.0,8.0,11.0,14.0,14.0,9.0,12.0,15.0,15.0,7.0,Alain TraorÃÂÃÂ©,ÃÂÃÂ£1.08m ,Ligue 1
19/6/2011,AdriÃÂ¡n,67011224,796,5/25/1988,23,0,0,0,0,4016,5923,5923,131,124,510871,184,75,M LC,3,3,1,2,3,2,3,7,1,3,2,13,13,13,11,14,12,9,13,10,7,13,11,7,13,7,11,12,13,11,13,11,10,13,11,11,9,10,10,14,14,9,11,20,14,14,11,14,9,11,6,11,11,11,12,13,10,11,14,12,7,11,1,1,20,15,1,17,20,M LC,404,1,1,1,12,15,1,1,1,1,7,20,17,1,1,1,141837000000000.0,0,0,0,0,0,1,0,0,0,0,0,0,0,0,0,0,0,0,0,0,0,0,0,0,0,0,0,0,0,0,0,0,0,0,0,0,0,0,0,0,1,0,0,0,0,0,0,1,AdriÃÂ¡n, ,33.0,190.0,Goalkeeper,right,Liverpool FC,9.0,6.0,4.0,810.0,11.0,12.0,5.0,990.0,32.0,46.0,11.0,2869.0,26.0,42.0,7.0,2340.0,42.0,54.0,10.0,3781.0,36.0,44.0,10.0,3300.0,19.0,36.0,6.0,1710.0,22.0,31.0,8.0,1980.0,5.0,8.0,2.0,450.0,LaLiga,18.0,24.0,3.0,1563.0,5.0,11.0,2.0,450.0,29/6/2010,AdriÃÂÃÂ¡n,67011224.0,796.0,5/25/1988,22.0,0.0,0.0,0.0,0.0,3782.0,5750.0,5750.0,139.0,123.0,3880332.0,184.0,75.0,M LC,1.0,1.0,1.0,1.0,2.0,2.0,3.0,7.0,2.0,1.0,2.0,12.0,14.0,14.0,10.0,13.0,11.0,10.0,15.0,9.0,6.0,15.0,9.0,6.0,14.0,12.0,11.0,14.0,12.0,11.0,14.0,9.0,11.0,13.0,10.0,13.0,10.0,11.0,12.0,15.0,14.0,9.0,11.0,20.0,13.0,14.0,8.0,12.0,9.0,14.0,10.0,10.0,11.0,10.0,12.0,18.0,10.0,13.0,14.0,12.0,5.0,11.0,nan,nan,nan,19-06-17,18.3.4.28,AdriÃÂÃÂ¼ÃÂn GonzÃÂÃÂ¼ÃÂlez,67011224,796,25-May-88,29,0,0,1,0,4250,7000,7000,144,140,16801636,183,77,M C,1,1,3,3,2,1,3,2,2,1,2,14,14,13,13,14,12,11,13,10,13,14,12,13,13,14,14,11,13,14,15,14,12,11,11,14,14,12,10,12,13,10,12,20,13,12,12,15,10,12,6,12,11,13,12,13,10,11,14,12,7,12,1,1,20,15,1,12,20,M C,401,1,1,1,15,12,1,1,1,1,15,20,12,1,1,1,141837000000000.0,0,0,0,0,0,1,0,0,1,0,0,0,0,0,0,0,0,0,0,0,0,0,0,0,0,0,0,0,0,0,0,0,0,0,0,0,0,0,0,0,1,0,0,0,0,0,0,1,AdriÃÂ¡n GonzÃÂ¡lez,ÃÂ£2.70m ,32.0,184.0,Midfielder - Central Midfield,left,Real Zaragoza,32.0,9.0,1.0,1789.0,31.0,4.0,0.0,2492.0,40.0,10.0,3.0,3346.0,32.0,6.0,2.0,2587.0,4.0,1.0,0.0,91.0,LaLiga,nan,nan,nan,nan,nan,nan,nan,nan,nan,nan,nan,nan,nan,nan,nan,nan,nan,nan,nan,nan,nan,nan,nan,nan,nan,nan,nan,nan,nan,nan,nan,nan,nan,nan,nan,nan,nan,nan,nan,nan,nan,nan,nan,nan,nan,nan,nan,nan,nan,nan,nan,nan,nan,nan,nan,nan,nan,nan,nan,nan,nan,nan,nan,nan,nan,nan,nan,nan,nan,nan,nan,nan,nan,nan,nan,nan,nan,nan,nan,nan,nan,nan,nan,nan,nan
19/6/2011,ÃÂdÃÂ¡m PintÃÂ©r,38001863,773,6/12/1988,23,5,0,7,0,3717,5726,5726,129,115,374240,190,76,D/DM C,2,1,2,3,1,2,1,7,1,2,2,7,10,9,8,11,12,16,8,10,14,11,8,13,10,12,11,14,9,13,8,10,10,6,10,7,12,16,14,8,10,14,16,13,12,12,20,13,13,14,10,11,10,11,8,12,9,13,6,15,7,8,20,1,15,1,1,1,20,D/DM C,111,1,9,1,1,1,1,20,1,1,19,15,1,1,1,1,0.0,0,0,0,0,0,0,0,0,0,0,0,0,0,0,0,0,0,0,0,0,0,0,0,0,0,0,0,0,0,0,0,0,0,0,0,0,0,0,0,0,0,0,0,0,0,0,0,0,ÃÂdÃÂ¡m PintÃÂ©r,ÃÂ£900Th. ,32.0,190.0,Defender - Centre-Back,right,MTK Budapest,15.0,1.0,0.0,847.0,17.0,0.0,0.0,1259.0,20.0,0.0,0.0,1466.0,13.0,0.0,0.0,548.0,17.0,0.0,0.0,1151.0,26.0,3.0,0.0,1698.0,29.0,0.0,0.0,1982.0,10.0,0.0,0.0,518.0,25.0,0.0,0.0,2059.0,LaLiga,24.0,0.0,1.0,2108.0,nan,nan,nan,nan,29/6/2010,ÃÂdÃÂ¡m PintÃÂ©r,38001863.0,773.0,6/12/1988,22.0,0.0,0.0,6.0,0.0,1000.0,5000.0,5000.0,133.0,110.0,933155.0,190.0,76.0,D/DM C,3.0,1.0,1.0,2.0,3.0,2.0,2.0,1.0,2.0,2.0,2.0,6.0,7.0,7.0,8.0,12.0,11.0,16.0,7.0,9.0,13.0,9.0,9.0,14.0,8.0,12.0,11.0,14.0,11.0,11.0,8.0,9.0,10.0,9.0,10.0,8.0,10.0,13.0,14.0,9.0,14.0,9.0,13.0,11.0,12.0,8.0,20.0,13.0,15.0,14.0,10.0,11.0,10.0,11.0,15.0,5.0,16.0,8.0,15.0,9.0,10.0,19.0,nan,nan,nan
19/6/2011,Abdou TraorÃÂ©,34010357,31,1/17/1988,23,12,2,1,1,5110,6274,5692,145,125,427227,180,74,M/AM RC,3,2,2,2,3,2,2,7,2,3,3,9,12,13,6,14,7,9,10,7,4,13,8,4,14,8,11,13,12,12,13,10,14,13,6,11,8,12,14,15,13,13,10,10,14,14,20,17,12,12,8,15,11,10,13,15,14,11,14,14,14,6,1,1,18,20,20,12,17,M/AM RC,523,1,1,1,17,12,20,1,1,1,1,17,12,18,1,1,549756000000.0,0,0,0,0,0,0,0,0,0,0,0,0,0,0,0,0,0,0,0,0,0,0,0,0,0,0,0,0,0,0,0,0,0,0,0,0,0,0,0,1,0,0,0,0,0,0,0,0,Abdou TraorÃÂ©,ÃÂ£900Th. ,32.0,180.0,Midfielder - Central Midfield,right,Al-Nahda,28.0,1.0,1.0,1733.0,10.0,1.0,0.0,285.0,11.0,0.0,1.0,699.0,23.0,1.0,0.0,1650.0,20.0,1.0,0.0,873.0,20.0,0.0,0.0,1081.0,10.0,0.0,0.0,130.0,nan,nan,nan,nan,nan,nan,nan,nan,Ligue 1,nan,nan,nan,nan,nan,nan,nan,nan,29/6/2010,Abdou TraorÃÂÃÂ©,34010357.0,31.0,1/17/1988,22.0,3.0,0.0,1.0,1.0,3660.0,6050.0,5400.0,148.0,121.0,1446164.0,180.0,74.0,M/AM RC,1.0,1.0,3.0,2.0,1.0,1.0,1.0,1.0,1.0,1.0,2.0,9.0,12.0,12.0,7.0,14.0,7.0,9.0,10.0,7.0,4.0,13.0,8.0,4.0,14.0,8.0,11.0,13.0,12.0,12.0,13.0,10.0,14.0,11.0,6.0,11.0,8.0,11.0,14.0,15.0,13.0,13.0,10.0,8.0,15.0,14.0,20.0,17.0,12.0,13.0,8.0,15.0,8.0,10.0,13.0,15.0,14.0,10.0,14.0,14.0,14.0,6.0,Abdou TraorÃÂÃÂ©,ÃÂÃÂ£1.08m ,Ligue 1
19/6/2011,Youssuf Mulumbu,8440126,53,1/25/1987,24,12,0,0,0,5900,7500,7400,157,144,2742073,177,69,DM/M C,3,3,1,1,2,3,2,5,2,3,1,3,7,12,9,14,5,10,9,7,12,14,4,14,14,13,16,16,13,12,13,13,17,9,14,13,16,16,18,13,13,13,9,12,17,12,20,18,15,17,8,14,6,13,15,14,15,14,13,13,11,7,8,8,20,1,8,1,20,DM/M C,311,1,1,1,1,1,1,3,1,8,20,20,1,5,1,8,557120.0,0,0,0,0,0,0,1,0,0,0,0,0,0,0,0,1,0,0,0,1,0,0,0,0,0,0,0,0,0,0,0,0,0,0,0,0,0,0,0,0,0,0,0,0,0,0,0,0,Youssouf Mulumbu,ÃÂ£3.15m ,33.0,177.0,Midfielder - Defensive Midfield,right,Kilmarnock FC,34.0,6.0,1.0,2862.0,36.0,1.0,4.0,2900.0,30.0,2.0,2.0,2620.0,38.0,2.0,2.0,3169.0,22.0,0.0,0.0,1191.0,10.0,0.0,0.0,600.0,16.0,0.0,1.0,846.0,20.0,1.0,4.0,1602.0,15.0,1.0,2.0,1120.0,Premier League,nan,nan,nan,nan,3.0,0.0,0.0,19.0,29/6/2010,Youssuf Mulumbu,8440126.0,53.0,1/25/1987,23.0,8.0,0.0,0.0,0.0,4250.0,6750.0,6600.0,146.0,133.0,5877712.0,177.0,69.0,DM/M C,3.0,1.0,1.0,2.0,2.0,1.0,2.0,8.0,1.0,2.0,3.0,5.0,7.0,12.0,7.0,12.0,6.0,11.0,11.0,7.0,10.0,13.0,5.0,15.0,13.0,15.0,15.0,17.0,12.0,13.0,12.0,13.0,17.0,9.0,10.0,11.0,16.0,16.0,17.0,12.0,13.0,14.0,9.0,13.0,16.0,12.0,20.0,18.0,15.0,15.0,13.0,13.0,6.0,10.0,15.0,14.0,15.0,14.0,13.0,13.0,11.0,7.0,Youssouf Mulumbu,ÃÂÃÂ£3.15m ,Premier League
19/6/2011,Yoann Gourcuff,919541,769,7/11/1986,24,28,4,19,4,6150,6850,6850,165,152,3950941,185,79,M/AM C,2,2,1,2,3,2,3,6,3,3,3,14,14,14,9,17,14,13,14,5,7,16,14,7,17,12,12,11,13,12,15,12,15,13,8,11,12,15,15,13,14,14,12,14,13,14,20,17,14,10,12,17,10,10,12,16,14,7,17,13,13,5,1,1,18,20,12,12,20,M/AM C,521,1,1,1,20,12,12,1,1,1,12,18,12,12,1,1,140737000000000.0,0,0,0,0,0,0,0,0,1,0,0,0,0,0,1,0,0,0,0,0,1,0,1,0,0,0,0,0,0,0,0,0,0,0,0,0,0,0,0,0,0,0,0,0,0,0,0,1,Yoann Gourcuff,ÃÂ£9.90m ,34.0,185.0,Midfielder - Attacking Midfield,right,Career break,36.0,4.0,6.0,2494.0,23.0,2.0,2.0,1412.0,23.0,4.0,8.0,1605.0,30.0,6.0,9.0,1917.0,19.0,3.0,5.0,807.0,12.0,2.0,0.0,619.0,28.0,4.0,3.0,2365.0,13.0,1.0,1.0,638.0,8.0,0.0,0.0,126.0,Ligue 1,nan,nan,nan,nan,nan,nan,nan,nan,29/6/2010,Yoann Gourcuff,919541.0,769.0,7/11/1986,23.0,22.0,1.0,19.0,4.0,6650.0,7424.0,7400.0,175.0,165.0,57625327.0,185.0,79.0,M/AM RC,2.0,2.0,3.0,1.0,1.0,3.0,3.0,3.0,1.0,1.0,2.0,15.0,15.0,16.0,11.0,18.0,14.0,13.0,14.0,6.0,7.0,17.0,14.0,7.0,18.0,12.0,13.0,10.0,14.0,14.0,16.0,14.0,15.0,13.0,11.0,12.0,12.0,15.0,17.0,13.0,15.0,14.0,12.0,14.0,14.0,14.0,20.0,16.0,14.0,11.0,12.0,17.0,9.0,10.0,12.0,16.0,14.0,10.0,14.0,13.0,13.0,6.0,Yoann Gourcuff,ÃÂÃÂ£18.00m ,Ligue 1,19-06-17,18.3.4.28,Yoann Gourcuff,919541,769,11-Jul-86,30,31,4,19,4,5100,6200,6800,169,134,232186002,185,82,M/AM C,1,3,2,2,1,1,2,3,2,3,1,13,13,13,9,15,14,12,14,5,5,16,14,6,16,9,14,9,14,12,15,13,14,12,11,12,8,15,11,11,13,14,12,12,12,12,20,14,13,13,12,15,15,10,12,14,14,7,16,14,15,5,1,1,19,20,12,13,20,M/AM C,521,1,1,12,20,13,12,1,1,1,10,19,12,12,1,1,140737000000000.0,0,0,0,0,0,0,0,0,1,0,0,0,0,0,1,0,0,0,0,0,1,0,1,0,0,0,0,0,0,0,0,0,0,0,0,0,0,0,0,0,0,0,0,0,0,0,0,1,Yoann Gourcuff,ÃÂ£1.80m ,34.0,185.0,Midfielder - Attacking Midfield,right,Career break,28.0,4.0,3.0,2365.0,13.0,1.0,1.0,638.0,8.0,0.0,0.0,126.0,nan,nan,nan,nan,nan,nan,nan,nan,Ligue 1,15-07-16,17.3.2.23,Yoann Gourcuff,919541.0,769.0,11-Jul-86,30.0,31.0,4.0,19.0,4.0,5209.0,6226.0,6950.0,169.0,139.0,232186002.0,185.0,82.0,M/AM C,3.0,3.0,1.0,1.0,3.0,1.0,3.0,3.0,1.0,2.0,3.0,13.0,13.0,13.0,9.0,16.0,14.0,12.0,14.0,5.0,6.0,16.0,14.0,6.0,16.0,10.0,14.0,10.0,14.0,12.0,15.0,13.0,14.0,12.0,11.0,13.0,8.0,15.0,12.0,12.0,13.0,14.0,12.0,12.0,12.0,12.0,20.0,14.0,14.0,14.0,12.0,15.0,15.0,10.0,12.0,16.0,14.0,8.0,17.0,14.0,15.0,5.0,Yoann Gourcuff,ÃÂ£2.25m ,Ligue 1
19/6/2011,Xavi Torres,1508014,796,11/21/1986,24,0,0,0,0,4000,6500,6500,142,130,261167,182,78,DM/M C,1,3,2,2,3,1,2,6,1,2,1,10,8,8,8,13,12,13,12,8,14,14,10,14,12,13,13,14,12,13,12,13,13,6,12,9,14,15,16,13,11,13,12,8,15,13,20,15,12,14,10,10,5,10,15,13,15,14,15,16,13,7,14,1,17,1,1,5,17,DM/M C,311,1,1,1,1,1,1,14,5,1,20,17,1,1,1,1,4294967296.0,0,0,0,0,0,0,0,0,0,0,0,0,0,0,0,0,0,0,0,0,0,0,0,0,0,0,0,0,0,0,0,0,1,0,0,0,0,0,0,0,0,0,0,0,0,0,0,0,Xavi Torres,ÃÂ£2.70m ,33.0,182.0,Midfielder - Central Midfield,right,CD Lugo,38.0,0.0,3.0,3262.0,37.0,5.0,1.0,2848.0,37.0,0.0,2.0,2925.0,17.0,1.0,0.0,1187.0,28.0,2.0,2.0,2200.0,14.0,0.0,0.0,814.0,19.0,0.0,0.0,1038.0,24.0,4.0,0.0,1888.0,29.0,6.0,1.0,1711.0,LaLiga,nan,nan,nan,nan,5.0,1.0,0.0,363.0,29/6/2010,Xavi Torres,1508014.0,796.0,11/21/1986,23.0,0.0,0.0,0.0,0.0,3844.0,5750.0,5750.0,140.0,124.0,1720377.0,182.0,79.0,D/DM C,2.0,2.0,1.0,1.0,2.0,1.0,1.0,7.0,2.0,1.0,3.0,5.0,5.0,8.0,6.0,14.0,6.0,14.0,11.0,9.0,15.0,14.0,7.0,14.0,10.0,14.0,13.0,12.0,14.0,13.0,9.0,13.0,10.0,7.0,13.0,10.0,16.0,16.0,14.0,12.0,11.0,14.0,13.0,7.0,14.0,12.0,20.0,15.0,13.0,11.0,10.0,11.0,5.0,10.0,14.0,16.0,14.0,17.0,6.0,13.0,5.0,19.0,Xavi Torres,ÃÂÃÂ£1.80m ,LaLiga
19/6/2011,Vadim Demidov,53010227,786,10/10/1986,24,1,0,13,2,4700,6500,6500,148,136,645204,185,73,D/DM/M C,2,3,1,2,2,3,2,5,1,1,1,4,8,10,8,14,5,14,10,5,14,11,8,16,13,14,16,17,13,13,11,13,15,5,16,10,15,14,13,13,11,12,14,10,15,13,20,13,14,14,12,18,8,16,15,17,12,15,15,12,8,18,20,1,17,1,1,1,20,D/DM/M C,121,1,1,1,1,1,1,20,1,1,18,17,1,1,1,1,137439000000.0,0,0,1,0,0,0,0,0,0,0,0,0,0,0,0,0,0,0,0,0,0,0,0,0,0,0,0,0,0,0,0,0,0,0,0,0,0,1,0,0,0,0,0,0,0,0,0,0,Vadim Demidov,ÃÂ£3.15m ,34.0,186.0,Defender - Centre-Back,right,Retired,25.0,1.0,1.0,2173.0,27.0,0.0,1.0,2194.0,19.0,0.0,0.0,1504.0,8.0,0.0,0.0,641.0,26.0,1.0,0.0,2070.0,26.0,1.0,1.0,2291.0,3.0,0.0,0.0,270.0,28.0,1.0,0.0,2397.0,15.0,0.0,2.0,1303.0,LaLiga,nan,nan,nan,nan,nan,nan,nan,nan,nan,nan,nan,nan,nan,nan,nan,nan,nan,nan,nan,nan,nan,nan,nan,nan,nan,nan,nan,nan,nan,nan,nan,nan,nan,nan,nan,nan,nan,nan,nan,nan,nan,nan,nan,nan,nan,nan,nan,nan,nan,nan,nan,nan,nan,nan,nan,nan,nan,nan,nan,nan,nan,nan,nan,nan,nan,nan,nan,nan,nan,nan,nan,nan,nan,nan,nan,nan,nan,nan,nan,nan,nan,nan,nan,nan,nan,nan,nan,nan,nan,nan,nan,nan
19/6/2011,Tom Huddlestone,5113183,765,12/28/1986,24,3,0,33,3,5500,7017,7400,165,148,2638047,192,98,DM/M C,3,1,1,2,1,1,1,4,3,3,2,13,11,12,9,16,13,12,13,5,11,18,12,13,17,14,12,14,15,14,16,15,12,8,13,14,15,16,16,9,8,12,15,14,16,9,20,15,18,14,14,9,5,15,6,16,16,17,11,11,10,8,14,4,20,1,8,8,20,DM/M C,311,1,10,1,1,1,1,14,8,8,20,20,8,8,4,4,9070970000000.0,0,0,0,0,0,0,0,1,1,1,0,0,0,0,0,0,0,0,0,1,0,0,0,0,0,0,0,0,0,0,0,0,0,0,0,0,0,0,1,0,0,0,0,1,0,0,0,0,Tom Huddlestone,ÃÂ£5.40m ,33.0,188.0,Midfielder - Defensive Midfield,right,Without Club,21.0,2.0,2.0,1729.0,4.0,0.0,1.0,181.0,30.0,0.0,6.0,1783.0,40.0,3.0,7.0,3535.0,35.0,0.0,2.0,2830.0,47.0,2.0,5.0,3068.0,39.0,2.0,1.0,2559.0,47.0,2.0,0.0,4196.0,31.0,0.0,1.0,2330.0,Premier League,12.0,1.0,0.0,1020.0,nan,nan,nan,nan,29/6/2010,Tom Huddlestone,5113183.0,765.0,12/28/1986,23.0,3.0,0.0,33.0,3.0,5329.0,7400.0,7400.0,165.0,146.0,16236174.0,192.0,98.0,DM/M C,3.0,1.0,3.0,2.0,2.0,1.0,1.0,3.0,2.0,3.0,1.0,13.0,11.0,12.0,9.0,16.0,13.0,12.0,13.0,3.0,11.0,16.0,12.0,13.0,17.0,14.0,12.0,14.0,15.0,14.0,16.0,15.0,12.0,8.0,12.0,12.0,13.0,16.0,16.0,9.0,8.0,12.0,15.0,14.0,16.0,9.0,20.0,15.0,18.0,14.0,14.0,9.0,5.0,15.0,6.0,16.0,16.0,17.0,11.0,11.0,10.0,8.0,Tom Huddlestone,ÃÂÃÂ£10.80m ,Premier League
19/6/2011,TchÃÂ´,2107518,1651,4/21/1987,24,0,0,8,3,2500,6150,6150,140,123,364393,174,70,M/AM RC,1,1,2,2,2,1,3,1,3,3,2,10,12,16,10,12,10,7,10,7,5,12,8,6,12,12,12,12,11,11,12,11,12,14,9,13,5,11,12,14,13,8,13,16,11,14,20,11,8,12,12,11,13,10,13,11,12,13,14,12,14,10,1,1,16,20,15,1,20,M/AM RC,523,1,1,11,20,1,15,1,1,1,1,16,1,12,1,1,160.0,0,0,0,0,0,1,0,1,0,0,0,0,0,0,0,0,0,0,0,0,0,0,0,0,0,0,0,0,0,0,0,0,0,0,0,0,0,0,0,0,0,0,0,0,0,0,0,0,TchÃÂ´,- ,33.0,175.0,Midfielder - Attacking Midfield,right,Ipatinga Futebol Clube,27.0,7.0,1.0,1482.0,9.0,1.0,0.0,252.0,20.0,4.0,5.0,1072.0,20.0,3.0,1.0,1114.0,2.0,0.0,0.0,26.0,nan,nan,nan,nan,nan,nan,nan,nan,nan,nan,nan,nan,nan,nan,nan,nan,Liga NOS,nan,nan,nan,nan,nan,nan,nan,nan,29/6/2010,TchÃÂÃÂ´,2107518.0,1651.0,4/21/1987,23.0,0.0,0.0,8.0,3.0,2500.0,6150.0,6150.0,140.0,123.0,2249218.0,174.0,70.0,M/AM RC,3.0,2.0,1.0,3.0,2.0,1.0,1.0,6.0,1.0,2.0,1.0,10.0,12.0,16.0,10.0,12.0,10.0,7.0,10.0,7.0,5.0,12.0,8.0,6.0,12.0,12.0,12.0,12.0,11.0,11.0,12.0,11.0,12.0,14.0,9.0,13.0,5.0,11.0,12.0,14.0,13.0,8.0,11.0,19.0,7.0,14.0,20.0,11.0,8.0,12.0,12.0,11.0,13.0,10.0,13.0,11.0,12.0,13.0,14.0,12.0,14.0,10.0,TchÃÂÃÂ´,ÃÂÃÂ£540Th. ,Liga NOS
19/6/2011,Stephen Ireland,5127709,789,8/22/1986,24,6,4,1,0,4800,6000,5500,155,140,2866881,173,65,M/AM C,1,1,2,2,2,3,1,1,3,3,1,10,11,12,14,15,10,5,12,6,8,14,10,13,14,10,16,8,16,14,16,15,5,12,7,17,5,9,17,14,13,16,6,11,12,12,20,17,9,15,11,12,11,14,16,4,10,6,8,14,16,15,1,1,18,20,14,10,20,M/AM C,521,1,1,1,20,10,14,1,1,1,1,18,1,10,1,1,1048712.0,0,0,0,1,0,0,0,1,0,0,0,0,0,0,0,0,0,0,0,0,1,0,0,0,0,0,0,0,0,0,0,0,0,0,0,0,0,0,0,0,0,0,0,0,0,0,0,0,Stephen Ireland,ÃÂ£4.95m ,34.0,173.0,Midfielder - Attacking Midfield,right,Retired,15.0,0.0,0.0,720.0,28.0,1.0,3.0,1950.0,17.0,0.0,4.0,1063.0,29.0,3.0,3.0,1677.0,20.0,3.0,4.0,1097.0,18.0,0.0,2.0,697.0,nan,nan,nan,nan,6.0,0.0,1.0,245.0,nan,nan,nan,nan,Premier League,nan,nan,nan,nan,nan,nan,nan,nan,29/6/2010,Stephen Ireland,5127709.0,789.0,8/22/1986,23.0,6.0,4.0,1.0,0.0,5550.0,7450.0,7450.0,165.0,149.0,50925621.0,173.0,65.0,M/AM C,1.0,2.0,3.0,1.0,3.0,2.0,3.0,6.0,1.0,2.0,3.0,10.0,11.0,12.0,14.0,15.0,10.0,5.0,12.0,6.0,8.0,14.0,10.0,13.0,14.0,10.0,16.0,12.0,16.0,14.0,16.0,15.0,16.0,12.0,7.0,17.0,5.0,14.0,17.0,14.0,13.0,16.0,6.0,11.0,17.0,12.0,20.0,17.0,12.0,15.0,11.0,12.0,8.0,14.0,16.0,12.0,15.0,13.0,14.0,14.0,16.0,14.0,Stephen Ireland,ÃÂÃÂ£8.10m ,Premier League,19-06-17,18.3.4.28,Stephen Ireland,5127709,789,22-Aug-86,30,6,4,1,0,4800,6750,6250,155,132,11318062,173,65,M/AM C,1,1,1,3,1,3,2,2,3,1,2,12,10,12,12,14,10,5,12,6,8,16,10,9,14,6,16,6,14,7,15,13,6,12,7,17,5,10,11,14,14,16,6,11,12,12,20,17,9,11,11,12,11,14,16,4,10,6,8,14,16,15,1,1,18,20,14,10,20,M/AM C,521,1,1,1,20,10,14,1,1,1,1,18,1,10,1,1,1074790528.0,0,0,0,0,0,0,0,1,0,0,0,0,0,0,0,0,0,0,0,0,1,0,0,0,0,0,0,0,0,0,1,0,0,0,0,0,0,0,0,0,0,0,0,0,0,0,0,0,Stephen Ireland,ÃÂ£900Th. ,34.0,173.0,Midfielder - Attacking Midfield,right,Retired,nan,nan,nan,nan,6.0,0.0,1.0,245.0,nan,nan,nan,nan,nan,nan,nan,nan,nan,nan,nan,nan,Premier League,15-07-16,17.3.2.23,Stephen Ireland,5127709.0,789.0,22-Aug-86,29.0,6.0,4.0,1.0,0.0,4800.0,6750.0,6250.0,155.0,132.0,6447282.0,173.0,65.0,M/AM C,4.0,2.0,4.0,1.0,2.0,2.0,3.0,2.0,2.0,1.0,1.0,12.0,10.0,12.0,12.0,14.0,10.0,5.0,12.0,6.0,8.0,16.0,10.0,9.0,14.0,6.0,16.0,6.0,14.0,7.0,15.0,13.0,6.0,12.0,7.0,17.0,5.0,10.0,11.0,14.0,14.0,16.0,6.0,11.0,12.0,12.0,20.0,17.0,9.0,11.0,11.0,12.0,11.0,14.0,16.0,4.0,10.0,6.0,8.0,14.0,16.0,15.0,Stephen Ireland,ÃÂ£900Th. ,Premier League
19/6/2011,Sami Khedira,8723858,771,4/4/1987,24,20,1,14,5,7000,8200,7700,162,154,0,189,85,DM/M C,3,1,2,2,1,3,2,6,3,2,3,6,10,9,14,12,8,15,11,12,15,12,9,14,11,13,17,16,18,18,13,17,17,6,14,16,17,20,19,9,8,14,16,12,18,15,20,19,16,12,10,15,14,16,14,18,9,15,18,16,18,3,1,1,20,14,10,10,20,DM/M C,421,1,1,1,14,8,8,1,1,1,19,20,10,10,1,1,2147484256.0,0,0,0,0,0,1,1,0,0,1,0,0,0,0,0,0,0,0,0,0,0,0,0,0,0,0,0,0,0,0,0,1,0,0,0,0,0,0,0,0,0,0,0,0,0,0,0,0,Sami Khedira,ÃÂ£18.00m ,33.0,189.0,Midfielder - Central Midfield,right,Juventus FC,40.0,0.0,3.0,3076.0,42.0,4.0,3.0,2974.0,44.0,4.0,6.0,3249.0,18.0,1.0,1.0,1376.0,17.0,0.0,0.0,621.0,25.0,5.0,3.0,1952.0,46.0,5.0,3.0,3836.0,39.0,9.0,6.0,2877.0,17.0,2.0,0.0,977.0,LaLiga,18.0,0.0,1.0,978.0,nan,nan,nan,nan,29/6/2010,Sami Khedira,8723858.0,771.0,4/4/1987,23.0,12.0,1.0,14.0,5.0,5476.0,7400.0,7400.0,169.0,148.0,41999998.0,189.0,81.0,DM/M C,2.0,1.0,2.0,2.0,2.0,1.0,3.0,8.0,1.0,1.0,3.0,6.0,10.0,9.0,14.0,11.0,8.0,15.0,12.0,12.0,14.0,10.0,9.0,14.0,11.0,13.0,17.0,16.0,15.0,17.0,13.0,17.0,17.0,6.0,14.0,16.0,15.0,19.0,19.0,9.0,8.0,10.0,16.0,12.0,18.0,15.0,20.0,19.0,16.0,12.0,6.0,15.0,14.0,16.0,14.0,18.0,9.0,15.0,18.0,16.0,18.0,3.0,Sami Khedira,ÃÂÃÂ£18.00m ,LaLiga,19-06-17,18.3.4.28,Sami Khedira,8723858,771,04-Apr-87,30,70,7,15,5,7250,8000,8250,167,165,232186002,189,90,DM/M C,3,3,3,3,1,2,3,2,3,1,3,4,10,11,13,14,8,16,12,8,15,14,10,13,14,14,15,16,16,18,13,18,18,10,12,17,20,20,17,10,11,15,13,11,13,14,20,15,17,18,8,15,19,14,15,16,9,15,18,16,17,4,1,1,20,5,1,1,20,DM/M C,421,1,1,1,5,1,1,1,1,1,19,20,1,1,1,1,4503600000000000.0,0,0,0,1,0,0,1,0,0,1,0,0,0,0,0,0,0,0,0,0,0,0,0,0,0,0,0,0,0,0,0,0,0,0,0,0,0,0,0,0,0,0,0,0,0,0,0,0,Sami Khedira,ÃÂ£23.40m ,33.0,189.0,Midfielder - Central Midfield,right,Juventus FC,46.0,5.0,3.0,3836.0,39.0,9.0,6.0,2877.0,17.0,2.0,0.0,977.0,18.0,0.0,1.0,978.0,nan,nan,nan,nan,Serie A,15-07-16,17.3.2.23,Sami Khedira,8723858.0,771.0,04-Apr-87,29.0,65.0,5.0,15.0,5.0,7250.0,7750.0,8100.0,164.0,162.0,78791808.0,189.0,90.0,DM/M C,3.0,4.0,1.0,1.0,3.0,4.0,3.0,1.0,1.0,3.0,2.0,6.0,10.0,11.0,13.0,14.0,8.0,16.0,12.0,11.0,15.0,14.0,10.0,13.0,14.0,15.0,15.0,16.0,15.0,18.0,13.0,17.0,18.0,10.0,12.0,16.0,17.0,20.0,19.0,10.0,11.0,15.0,14.0,11.0,10.0,14.0,20.0,17.0,16.0,16.0,12.0,15.0,19.0,14.0,15.0,16.0,9.0,15.0,18.0,16.0,17.0,4.0,Sami Khedira,ÃÂ£25.20m ,Serie A
19/6/2011,Rui Sampaio,743487,788,5/29/1987,24,0,0,0,0,3000,5500,5500,127,110,189723,186,75,M/AM C,3,1,1,1,1,2,2,5,1,2,1,12,12,12,12,12,11,13,11,10,10,11,10,11,12,13,12,12,14,12,12,12,14,9,11,12,12,15,12,11,12,13,12,8,12,11,20,11,13,14,8,10,6,14,13,12,13,13,13,13,14,6,1,1,20,20,1,13,20,M/AM C,411,1,1,10,20,13,1,1,1,1,4,20,7,1,1,1,0.0,0,0,0,0,0,0,0,0,0,0,0,0,0,0,0,0,0,0,0,0,0,0,0,0,0,0,0,0,0,0,0,0,0,0,0,0,0,0,0,0,0,0,0,0,0,0,0,0,Rui Sampaio,ÃÂ£540Th. ,33.0,186.0,Midfielder - Central Midfield,right,SC Beira-Mar,35.0,1.0,0.0,2885.0,9.0,1.0,0.0,339.0,15.0,1.0,0.0,1178.0,12.0,1.0,0.0,965.0,33.0,2.0,0.0,2461.0,8.0,0.0,0.0,524.0,17.0,1.0,0.0,1400.0,14.0,0.0,0.0,547.0,1.0,0.0,0.0,90.0,Serie A,2.0,0.0,0.0,210.0,nan,nan,nan,nan,29/6/2010,Rui Sampaio,743487.0,788.0,5/29/1987,23.0,0.0,0.0,0.0,0.0,2000.0,5250.0,5250.0,127.0,109.0,556260.0,186.0,75.0,M C,3.0,2.0,3.0,2.0,1.0,2.0,1.0,5.0,1.0,3.0,1.0,12.0,12.0,12.0,12.0,12.0,11.0,13.0,11.0,10.0,10.0,11.0,10.0,11.0,12.0,13.0,12.0,12.0,14.0,12.0,12.0,11.0,14.0,9.0,11.0,12.0,12.0,15.0,12.0,11.0,12.0,13.0,12.0,8.0,12.0,11.0,20.0,11.0,13.0,13.0,8.0,10.0,8.0,14.0,10.0,12.0,13.0,13.0,13.0,13.0,14.0,6.0,Rui Sampaio,ÃÂÃÂ£630Th. ,Liga NOS
19/6/2011,Ruben Micael,744496,788,8/19/1986,24,2,2,0,0,3500,6650,6650,143,133,1559332,175,73,AM C,1,1,3,3,1,3,1,1,3,3,2,13,13,12,11,14,13,8,13,7,9,14,13,9,14,12,13,13,14,13,15,14,14,14,12,15,9,13,13,12,13,8,6,12,14,11,20,10,7,14,7,13,9,12,12,13,15,15,16,16,16,5,1,1,15,20,10,10,20,AM C,501,1,1,1,20,10,10,1,1,1,5,15,5,5,1,1,0.0,0,0,0,0,0,0,0,0,0,0,0,0,0,0,0,0,0,0,0,0,0,0,0,0,0,0,0,0,0,0,0,0,0,0,0,0,0,0,0,0,0,0,0,0,0,0,0,0,RÃÂºben Micael,ÃÂ£4.50m ,34.0,176.0,Midfielder - Defensive Midfield,right,CD Nacional,36.0,4.0,7.0,1872.0,34.0,0.0,1.0,2215.0,30.0,7.0,4.0,1698.0,27.0,1.0,3.0,2051.0,41.0,8.0,5.0,2846.0,28.0,3.0,4.0,2266.0,19.0,1.0,2.0,1290.0,13.0,1.0,1.0,969.0,30.0,0.0,4.0,1953.0,LaLiga,24.0,0.0,1.0,1941.0,5.0,0.0,0.0,412.0,29/6/2010,Ruben Micael,744496.0,788.0,8/19/1986,23.0,0.0,0.0,0.0,0.0,3500.0,6750.0,6750.0,152.0,140.0,40071818.0,175.0,73.0,M/AM C,2.0,2.0,2.0,2.0,3.0,1.0,1.0,3.0,3.0,1.0,1.0,14.0,14.0,14.0,12.0,16.0,14.0,9.0,14.0,8.0,10.0,16.0,14.0,10.0,16.0,12.0,14.0,13.0,15.0,14.0,16.0,16.0,14.0,16.0,12.0,16.0,10.0,14.0,14.0,13.0,14.0,9.0,7.0,12.0,14.0,12.0,20.0,11.0,8.0,14.0,7.0,13.0,9.0,12.0,12.0,13.0,15.0,15.0,16.0,16.0,16.0,5.0,RÃÂÃÂºben Micael,ÃÂÃÂ£4.41m ,Liga NOS,19-06-17,18.3.4.28,RÃÂÃÂ¼ÃÂben Micael,744496,788,19-Aug-86,30,16,2,0,0,3750,6300,6000,136,120,232186002,176,70,AM C,3,3,2,2,3,2,2,1,3,3,1,14,12,13,9,14,12,8,10,8,6,15,14,8,15,11,12,13,8,10,16,14,16,14,10,14,8,14,11,12,14,8,8,11,12,12,20,12,8,13,12,10,9,12,12,13,15,15,16,16,6,14,1,1,15,20,10,10,20,AM C,501,1,1,1,20,10,10,1,1,1,1,15,8,8,1,1,2199020000000.0,0,0,0,0,0,0,0,0,0,0,0,0,0,0,0,0,0,0,0,0,0,0,0,0,0,0,0,0,0,0,0,0,0,0,0,0,0,0,0,0,0,1,0,0,0,0,0,0,RÃÂºben Micael,ÃÂ£450Th. ,34.0,176.0,Midfielder - Defensive Midfield,right,CD Nacional,19.0,1.0,2.0,1290.0,13.0,1.0,1.0,969.0,30.0,0.0,4.0,1953.0,24.0,0.0,1.0,1941.0,5.0,0.0,0.0,412.0,Liga NOS,nan,nan,nan,nan,nan,nan,nan,nan,nan,nan,nan,nan,nan,nan,nan,nan,nan,nan,nan,nan,nan,nan,nan,nan,nan,nan,nan,nan,nan,nan,nan,nan,nan,nan,nan,nan,nan,nan,nan,nan,nan,nan,nan,nan,nan,nan,nan,nan,nan,nan,nan,nan,nan,nan,nan,nan,nan,nan,nan,nan,nan,nan,nan,nan,nan,nan,nan,nan,nan,nan,nan,nan,nan,nan,nan,nan,nan,nan,nan,nan,nan,nan,nan,nan,nan
19/6/2011,Robert Tesche,35006190,771,5/27/1987,24,0,0,0,0,4500,5750,6250,140,115,105191,180,73,DM/M RC,2,3,2,2,1,1,3,5,1,2,1,10,11,13,10,14,10,10,13,7,11,12,10,14,14,13,14,5,14,13,11,14,10,4,12,14,14,15,15,14,14,14,9,5,17,14,20,12,4,10,8,10,5,10,14,9,5,7,12,9,14,12,1,11,20,11,16,1,20,DM/M RC,423,1,1,1,10,1,11,1,1,1,18,20,1,16,1,11,0.0,0,0,0,0,0,0,0,0,0,0,0,0,0,0,0,0,0,0,0,0,0,0,0,0,0,0,0,0,0,0,0,0,0,0,0,0,0,0,0,0,0,0,0,0,0,0,0,0,Robert Tesche,ÃÂ£1.13m ,33.0,182.0,Midfielder - Central Midfield,right,VfL Bochum,12.0,0.0,0.0,537.0,26.0,2.0,1.0,1245.0,18.0,0.0,1.0,1112.0,21.0,2.0,1.0,1330.0,37.0,4.0,5.0,2903.0,25.0,1.0,1.0,1615.0,26.0,0.0,0.0,1852.0,19.0,2.0,0.0,1188.0,31.0,3.0,2.0,2440.0,Bundesliga,26.0,1.0,1.0,1891.0,6.0,0.0,0.0,451.0,29/6/2010,Robert Tesche,35006190.0,771.0,5/27/1987,23.0,0.0,0.0,0.0,0.0,1500.0,5750.0,5750.0,140.0,115.0,1693695.0,180.0,73.0,DM/M RC,2.0,2.0,1.0,2.0,1.0,2.0,3.0,1.0,2.0,1.0,1.0,11.0,13.0,14.0,12.0,14.0,10.0,10.0,14.0,6.0,10.0,14.0,10.0,14.0,14.0,8.0,14.0,10.0,14.0,12.0,12.0,13.0,10.0,5.0,15.0,8.0,11.0,17.0,14.0,14.0,14.0,14.0,17.0,5.0,14.0,14.0,20.0,9.0,8.0,10.0,8.0,10.0,4.0,10.0,7.0,13.0,20.0,8.0,9.0,11.0,11.0,20.0,Robert Tesche,ÃÂÃÂ£1.58m ,Bundesliga
19/6/2011,RaÃÂºl GarcÃÂ­a,1502117,796,7/11/1986,24,0,0,1,0,4750,6750,6750,149,137,572181,183,81,M C,2,3,2,1,1,2,1,3,2,1,3,15,12,11,12,15,13,13,15,10,12,13,13,12,13,14,13,15,13,13,12,14,14,13,12,11,13,14,14,11,12,14,12,12,16,13,20,14,14,13,14,12,11,13,15,16,15,10,14,15,13,9,1,1,20,15,1,1,20,M C,401,1,1,4,15,1,1,1,1,1,15,20,1,1,1,1,2147484160.0,0,0,0,0,0,0,0,0,0,1,0,0,0,0,0,0,0,0,0,0,0,0,0,0,0,0,0,0,0,0,0,1,0,0,0,0,0,0,0,0,0,0,0,0,0,0,0,0,RaÃÂºl GarcÃÂ­a,ÃÂ£4.50m ,34.0,184.0,Forward - Centre-Forward,right,Athletic Bilbao,41.0,1.0,6.0,2214.0,37.0,11.0,7.0,2643.0,47.0,9.0,4.0,2360.0,53.0,17.0,6.0,3111.0,47.0,10.0,3.0,2763.0,42.0,11.0,9.0,3211.0,46.0,14.0,9.0,3738.0,48.0,14.0,8.0,3564.0,34.0,9.0,4.0,2466.0,LaLiga,42.0,15.0,2.0,3494.0,6.0,0.0,0.0,523.0,29/6/2010,RaÃÂÃÂºl GarcÃÂÃÂ­a,1502117.0,796.0,7/11/1986,23.0,0.0,0.0,1.0,0.0,4830.0,6400.0,6400.0,145.0,139.0,7979960.0,183.0,81.0,DM/M/AM C,3.0,3.0,3.0,2.0,3.0,2.0,1.0,8.0,1.0,1.0,3.0,15.0,12.0,12.0,12.0,15.0,13.0,13.0,15.0,10.0,11.0,14.0,13.0,12.0,14.0,14.0,13.0,15.0,13.0,13.0,11.0,15.0,14.0,15.0,12.0,11.0,13.0,14.0,14.0,11.0,12.0,13.0,11.0,13.0,16.0,13.0,20.0,14.0,14.0,13.0,14.0,12.0,11.0,13.0,15.0,16.0,15.0,10.0,14.0,15.0,13.0,9.0,RaÃÂÃÂºl GarcÃÂÃÂ­a,ÃÂÃÂ£5.40m ,LaLiga,19-06-17,18.3.4.28,RaÃÂÃÂ¼ÃÂl GarcÃÂÃÂ¼ÃÂa,1502117,796,11-Jul-86,30,2,0,20,1,5700,7550,7550,153,152,232186002,183,81,M/AM RC,2,3,2,3,3,3,1,2,3,3,2,14,12,11,14,15,13,16,16,10,11,14,13,12,13,15,14,15,14,15,13,15,14,13,13,15,16,16,16,11,12,12,12,14,16,13,20,15,14,13,15,12,11,13,15,14,15,9,15,8,8,9,1,1,17,20,17,10,20,M/AM RC,523,1,1,15,20,1,9,1,1,1,1,15,10,17,1,1,2147484160.0,0,0,0,0,0,0,0,0,0,1,0,0,0,0,0,0,0,0,0,0,0,0,0,0,0,0,0,0,0,0,0,1,0,0,0,0,0,0,0,0,0,0,0,0,0,0,0,0,nan,nan,nan,nan,nan,nan,nan,nan,nan,nan,nan,nan,nan,nan,nan,nan,nan,nan,nan,nan,nan,nan,nan,nan,nan,nan,nan,nan,nan,nan,nan,nan,nan,nan,nan,nan,nan,nan,nan,nan,nan,nan,nan,nan,nan,nan,nan,nan,nan,nan,nan,nan,nan,nan,nan,nan,nan,nan,nan,nan,nan,nan,nan,nan,nan,nan,nan,nan,nan,nan,nan,nan,nan,nan,nan,nan,nan,nan,nan,nan,nan,nan,nan,nan,nan,nan,nan,nan,nan,nan,nan,nan,nan,nan,nan,nan,nan,nan,nan,nan,nan,nan,nan,nan,nan,nan,nan,nan,nan,nan,nan,nan,nan
19/6/2011,Ramires,2114490,1651,3/24/1987,24,25,2,0,0,6500,8150,7850,168,156,36363636,178,67,M RC,2,3,3,1,3,3,1,1,1,1,2,10,11,13,11,13,7,12,13,10,13,14,12,14,13,13,13,15,14,15,13,14,16,12,13,16,14,16,18,17,15,10,10,9,16,16,20,18,11,18,10,13,9,16,13,14,16,15,18,15,16,8,11,11,20,12,17,5,20,M RC,403,1,1,1,12,1,1,1,1,11,14,20,5,17,1,11,2147524720.0,0,0,0,0,1,1,1,0,0,0,0,0,0,1,0,1,0,0,0,0,0,0,0,0,0,0,0,0,0,0,0,1,0,0,0,0,0,0,0,0,0,0,0,0,0,0,0,0,Ramires,ÃÂ£27.00m ,33.0,179.0,Midfielder - Central Midfield,right,Sociedade Esportiva Palmeiras,41.0,2.0,0.0,2968.0,47.0,12.0,7.0,3861.0,62.0,9.0,8.0,4739.0,46.0,4.0,5.0,3746.0,34.0,4.0,4.0,1757.0,59.0,8.0,8.0,4246.0,34.0,12.0,4.0,3033.0,1.0,0.0,2.0,84.0,6.0,0.0,0.0,159.0,Premier League,30.0,1.0,0.0,1277.0,nan,nan,nan,nan,29/6/2010,Ramires,2114490.0,1651.0,3/24/1987,23.0,15.0,2.0,0.0,0.0,5000.0,7900.0,7500.0,168.0,148.0,30000001.0,180.0,67.0,M RC,3.0,3.0,2.0,2.0,2.0,3.0,1.0,1.0,2.0,2.0,2.0,10.0,11.0,13.0,11.0,13.0,7.0,12.0,13.0,10.0,13.0,14.0,12.0,14.0,13.0,13.0,13.0,15.0,14.0,15.0,13.0,14.0,16.0,12.0,13.0,16.0,14.0,16.0,17.0,17.0,15.0,10.0,10.0,9.0,16.0,16.0,20.0,16.0,10.0,18.0,10.0,13.0,9.0,16.0,13.0,14.0,16.0,15.0,18.0,15.0,16.0,8.0,Ramires,ÃÂÃÂ£12.60m ,Premier League
19/6/2011,Piermario Morosini,7990133,776,7/5/1986,24,0,0,22,0,2281,5250,5250,115,105,185441,182,75,DM/M C,1,1,1,1,1,1,1,1,1,1,1,6,7,11,7,8,3,8,9,4,11,14,5,10,12,11,12,10,10,12,12,13,14,8,9,11,13,16,16,11,10,12,10,8,12,13,20,14,12,10,7,11,7,11,9,13,13,13,20,10,14,12,1,8,20,1,14,1,20,DM/M C,421,1,1,1,1,1,1,1,1,1,18,20,1,14,1,8,140737000000000.0,0,0,0,0,0,0,0,0,0,0,0,0,0,0,0,0,0,0,0,0,0,0,0,0,0,0,0,0,0,0,0,0,0,0,0,0,0,0,0,0,0,0,0,0,0,0,0,1,nan,nan,nan,nan,nan,nan,nan,nan,nan,nan,nan,nan,nan,nan,nan,nan,nan,nan,nan,nan,nan,nan,nan,nan,nan,nan,nan,nan,nan,nan,nan,nan,nan,nan,nan,nan,nan,nan,nan,nan,nan,nan,nan,nan,nan,nan,nan,nan,nan,nan,nan,nan,nan,nan,nan,nan,nan,nan,nan,nan,nan,nan,nan,nan,nan,nan,nan,nan,nan,nan,nan,nan,nan,nan,nan,nan,nan,nan,nan,nan,nan,nan,nan,nan,nan,nan,nan,nan,nan,nan,nan,nan,nan,nan,nan,nan,nan,nan,nan,nan,nan,nan,nan,nan,nan,nan,nan,nan,nan,nan,nan,nan,nan,nan,nan,nan,nan,nan,nan,nan,nan,nan,nan,nan,nan,nan,nan,nan,nan,nan,nan,nan,nan,nan,nan,nan
19/6/2011,Perparim Hetemaj,8505627,768,12/12/1986,24,6,0,0,0,3750,5894,6550,145,131,449216,176,71,M RC,3,1,2,3,3,1,1,8,3,1,2,10,11,13,8,11,11,7,13,10,11,12,9,12,14,19,16,18,10,12,13,10,15,12,8,14,7,12,16,13,14,13,9,12,15,13,20,16,14,14,12,9,9,13,13,16,14,12,15,12,10,8,1,1,20,15,17,12,20,M RC,403,1,1,3,15,7,10,1,1,1,10,20,12,17,1,1,0.0,0,0,0,0,0,0,0,0,0,0,0,0,0,0,0,0,0,0,0,0,0,0,0,0,0,0,0,0,0,0,0,0,0,0,0,0,0,0,0,0,0,0,0,0,0,0,0,0,Perparim Hetemaj,ÃÂ£1.62m ,33.0,179.0,Midfielder - Central Midfield,right,Benevento Calcio,31.0,2.0,3.0,2560.0,35.0,0.0,2.0,2147.0,30.0,0.0,2.0,2382.0,34.0,0.0,4.0,2685.0,33.0,0.0,1.0,2723.0,29.0,1.0,0.0,2379.0,24.0,0.0,1.0,1966.0,32.0,3.0,4.0,2493.0,31.0,2.0,1.0,2250.0,Serie A,33.0,0.0,1.0,2349.0,4.0,0.0,0.0,99.0,29/6/2010,Perparim Hetemaj,8505627.0,768.0,12/12/1986,23.0,2.0,0.0,0.0,0.0,3025.0,5600.0,5550.0,132.0,110.0,745405.0,176.0,71.0,M RC,1.0,2.0,2.0,3.0,2.0,1.0,1.0,4.0,1.0,1.0,2.0,9.0,10.0,12.0,7.0,10.0,10.0,6.0,12.0,9.0,6.0,11.0,8.0,8.0,13.0,14.0,12.0,14.0,9.0,11.0,12.0,9.0,15.0,9.0,7.0,11.0,6.0,11.0,14.0,12.0,13.0,12.0,8.0,12.0,14.0,12.0,20.0,13.0,12.0,13.0,10.0,8.0,9.0,11.0,13.0,16.0,14.0,12.0,15.0,12.0,10.0,8.0,Perparim Hetemaj,ÃÂÃÂ£1.08m ,Serie A,19-06-17,18.3.4.28,PÃÂ«rparim Hetemaj,8505627,768,12-Dec-86,30,44,4,15,3,4500,6800,6600,140,132,232186002,175,76,M RLC,3,1,1,3,3,1,3,3,2,1,3,10,8,13,8,11,11,7,12,10,14,12,9,16,11,19,13,17,11,14,12,11,15,12,12,14,14,15,17,14,13,14,8,11,15,13,20,15,14,16,16,12,11,13,13,16,14,12,15,12,10,8,1,1,20,10,17,18,20,M RLC,406,1,1,3,10,10,10,1,1,1,10,20,18,17,1,1,0.0,0,0,0,0,0,0,0,0,0,0,0,0,0,0,0,0,0,0,0,0,0,0,0,0,0,0,0,0,0,0,0,0,0,0,0,0,0,0,0,0,0,0,0,0,0,0,0,0,Perparim Hetemaj,ÃÂ£3.15m ,33.0,179.0,Midfielder - Central Midfield,right,Benevento Calcio,24.0,0.0,1.0,1966.0,32.0,3.0,4.0,2493.0,31.0,2.0,1.0,2250.0,33.0,0.0,1.0,2349.0,4.0,0.0,0.0,99.0,Serie A,nan,nan,nan,nan,nan,nan,nan,nan,nan,nan,nan,nan,nan,nan,nan,nan,nan,nan,nan,nan,nan,nan,nan,nan,nan,nan,nan,nan,nan,nan,nan,nan,nan,nan,nan,nan,nan,nan,nan,nan,nan,nan,nan,nan,nan,nan,nan,nan,nan,nan,nan,nan,nan,nan,nan,nan,nan,nan,nan,nan,nan,nan,nan,nan,nan,nan,nan,nan,nan,nan,nan,nan,nan,nan,nan,nan,nan,nan,nan,nan,nan,nan,nan,nan,nan
19/6/2011,Per Ciljan Skjelbred,762025,786,6/16/1987,24,16,0,12,1,6000,7000,6700,147,134,5983952,177,62,M/AM C,3,2,3,2,2,3,3,3,2,3,1,10,12,13,5,15,7,4,6,8,12,16,10,11,15,18,9,14,8,12,12,10,18,14,7,15,9,17,18,16,15,8,7,15,14,14,20,17,6,13,6,18,11,8,12,16,14,14,18,15,14,2,1,1,18,20,14,11,20,M/AM C,521,1,1,1,20,11,14,1,1,1,1,18,10,13,1,1,4312793152.0,0,0,0,0,0,0,1,0,0,0,0,0,0,0,0,0,0,0,0,0,1,0,0,0,1,0,0,0,0,0,0,0,1,0,0,0,0,0,0,0,0,0,0,0,0,0,0,0,Per Ciljan Skjelbred,ÃÂ£1.35m ,33.0,175.0,Midfielder - Central Midfield,right,Rosenborg BK,27.0,1.0,2.0,2197.0,12.0,1.0,1.0,682.0,19.0,0.0,0.0,1260.0,28.0,2.0,7.0,2118.0,26.0,0.0,2.0,2239.0,36.0,0.0,2.0,3167.0,31.0,0.0,0.0,2587.0,33.0,0.0,0.0,2494.0,17.0,0.0,1.0,1098.0,Bundesliga,32.0,1.0,0.0,2253.0,3.0,0.0,0.0,270.0,nan,nan,nan,nan,nan,nan,nan,nan,nan,nan,nan,nan,nan,nan,nan,nan,nan,nan,nan,nan,nan,nan,nan,nan,nan,nan,nan,nan,nan,nan,nan,nan,nan,nan,nan,nan,nan,nan,nan,nan,nan,nan,nan,nan,nan,nan,nan,nan,nan,nan,nan,nan,nan,nan,nan,nan,nan,nan,nan,nan,nan,nan,nan,nan,nan,nan,nan,nan,nan,nan,nan,nan,nan,nan,nan,nan,nan,nan,nan,nan,nan,nan,nan,nan,19-06-17,18.3.4.28,Per Skjelbred,762025,786,16-Jun-87,30,43,1,12,1,5200,6700,6700,134,134,232186002,175,74,DM/M C,2,3,3,2,3,3,1,2,2,4,3,10,11,11,6,12,7,8,10,9,13,12,10,16,12,18,14,16,10,15,10,12,17,8,14,11,12,16,18,14,14,13,7,12,17,11,20,17,10,17,8,16,10,15,11,16,14,12,18,15,13,2,1,1,20,14,13,13,20,DM/M C,311,1,1,1,14,13,13,1,1,1,20,20,13,13,1,1,16777216.0,0,0,0,0,0,0,0,0,0,0,0,0,0,0,0,0,0,0,0,0,0,0,0,0,1,0,0,0,0,0,0,0,0,0,0,0,0,0,0,0,0,0,0,0,0,0,0,0,Per Ciljan Skjelbred,ÃÂ£3.60m ,33.0,175.0,Midfielder - Central Midfield,right,Rosenborg BK,31.0,0.0,0.0,2587.0,33.0,0.0,0.0,2494.0,17.0,0.0,1.0,1098.0,32.0,1.0,0.0,2253.0,3.0,0.0,0.0,270.0,Bundesliga,15-07-16,17.3.2.23,Per Skjelbred,762025.0,786.0,16-Jun-87,29.0,40.0,1.0,12.0,1.0,6197.0,6697.0,6697.0,134.0,134.0,9600499.0,175.0,74.0,DM/M C,2.0,1.0,1.0,2.0,2.0,1.0,3.0,2.0,3.0,1.0,1.0,10.0,11.0,13.0,6.0,12.0,7.0,8.0,8.0,9.0,13.0,13.0,10.0,16.0,12.0,18.0,14.0,16.0,10.0,16.0,10.0,12.0,17.0,8.0,14.0,12.0,12.0,17.0,18.0,14.0,14.0,12.0,7.0,12.0,17.0,12.0,20.0,17.0,9.0,17.0,8.0,16.0,10.0,15.0,11.0,16.0,14.0,12.0,18.0,15.0,13.0,2.0,Per Ciljan Skjelbred,ÃÂ£3.60m ,Bundesliga
19/6/2011,Moritz Stoppelkamp,8728271,771,12/11/1986,24,0,0,0,0,4000,6500,6500,137,130,921099,180,79,M/AM RC,1,3,1,3,1,1,1,10,3,1,2,10,11,12,11,11,9,8,12,11,9,12,10,11,11,11,13,14,11,12,11,11,10,6,10,12,11,17,15,13,13,12,10,16,11,13,20,17,10,13,8,12,7,13,9,5,14,13,13,10,9,8,1,1,19,20,20,14,18,M/AM RC,523,1,1,1,18,14,20,1,1,1,12,16,14,19,1,1,0.0,0,0,0,0,0,0,0,0,0,0,0,0,0,0,0,0,0,0,0,0,0,0,0,0,0,0,0,0,0,0,0,0,0,0,0,0,0,0,0,0,0,0,0,0,0,0,0,0,Moritz Stoppelkamp,ÃÂ£900Th. ,33.0,180.0,Forward - Right Winger,right,MSV Duisburg,24.0,0.0,0.0,1091.0,28.0,2.0,0.0,721.0,36.0,9.0,12.0,3039.0,36.0,7.0,13.0,3201.0,28.0,4.0,2.0,2299.0,31.0,6.0,2.0,2233.0,24.0,4.0,2.0,2134.0,33.0,9.0,8.0,2825.0,29.0,3.0,2.0,2039.0,Bundesliga,36.0,19.0,12.0,3118.0,nan,nan,nan,nan,29/6/2010,Moritz Stoppelkamp,8728271.0,771.0,12/11/1986,23.0,0.0,0.0,0.0,0.0,2000.0,5950.0,5950.0,135.0,119.0,2656877.0,180.0,75.0,M/AM C,1.0,1.0,3.0,1.0,3.0,2.0,3.0,3.0,1.0,1.0,2.0,10.0,11.0,12.0,10.0,10.0,10.0,8.0,12.0,5.0,7.0,12.0,10.0,9.0,11.0,14.0,13.0,11.0,11.0,9.0,10.0,13.0,10.0,13.0,8.0,11.0,7.0,12.0,11.0,12.0,11.0,11.0,10.0,16.0,11.0,13.0,20.0,13.0,10.0,10.0,15.0,7.0,8.0,10.0,14.0,18.0,9.0,7.0,13.0,16.0,8.0,15.0,Moritz Stoppelkamp,ÃÂÃÂ£1.13m ,Bundesliga
19/6/2011,Mohamed DiamÃÂ©,8434183,41,6/14/1987,24,3,0,0,0,4750,7000,6750,153,140,1537029,181,71,DM/M C,2,3,3,2,3,3,3,1,3,2,1,4,11,13,6,14,4,13,11,5,12,14,4,17,12,14,15,16,15,8,13,7,15,6,8,6,18,15,18,14,12,17,11,9,15,15,20,18,19,11,12,10,12,8,15,12,12,11,15,10,8,10,10,1,20,1,1,1,20,DM/M C,311,1,1,1,1,1,1,10,1,1,20,20,1,1,1,1,9075270000000.0,0,0,0,0,0,0,0,0,0,0,0,0,0,0,0,0,0,0,0,0,0,0,0,0,0,0,0,0,0,0,0,0,1,0,0,0,0,0,1,0,0,0,0,1,0,0,0,0,Mohamed DiamÃÂ©,ÃÂ£4.50m ,33.0,184.0,Midfielder - Central Midfield,right,Al-Ahli SC,40.0,3.0,3.0,2997.0,26.0,3.0,0.0,1595.0,34.0,3.0,0.0,2670.0,41.0,4.0,4.0,2816.0,16.0,4.0,0.0,1053.0,45.0,10.0,4.0,3143.0,41.0,6.0,3.0,2773.0,33.0,2.0,0.0,2181.0,29.0,0.0,0.0,2165.0,Premier League,22.0,0.0,2.0,1980.0,4.0,0.0,0.0,350.0,29/6/2010,Mohamed DiamÃÂ©,8434183.0,769.0,6/14/1987,23.0,0.0,0.0,0.0,0.0,4750.0,6209.0,6500.0,153.0,138.0,8172646.0,181.0,71.0,DM/M C,3.0,1.0,2.0,1.0,1.0,2.0,2.0,1.0,1.0,3.0,2.0,4.0,11.0,13.0,6.0,12.0,4.0,13.0,11.0,5.0,12.0,14.0,4.0,17.0,12.0,15.0,15.0,16.0,14.0,8.0,8.0,7.0,15.0,6.0,8.0,6.0,18.0,15.0,18.0,14.0,12.0,17.0,11.0,9.0,15.0,15.0,20.0,18.0,19.0,11.0,12.0,10.0,12.0,8.0,15.0,12.0,12.0,11.0,15.0,10.0,8.0,7.0,Mohamed DiamÃÂÃÂ©,ÃÂÃÂ£3.15m ,Premier League,19-06-17,18.3.4.28,Mohamed DiamÃÂÃÂ¼ÃÂ,8434183,41,14-Jun-87,30,36,1,0,0,5500,6750,6800,132,127,31077039,184,71,M/AM C,2,3,1,1,2,1,1,1,3,2,1,4,10,12,10,12,6,10,11,5,10,13,7,10,13,13,15,13,16,10,14,11,17,14,8,13,15,9,11,13,14,16,11,12,13,12,20,14,16,12,13,14,12,12,15,12,15,13,15,10,8,6,8,1,19,20,9,11,20,M/AM C,521,1,1,9,20,6,1,8,1,1,12,19,11,9,1,1,9075270000000.0,0,0,1,0,0,0,0,0,1,0,0,0,0,0,0,0,0,0,0,0,0,0,0,0,0,0,0,0,0,0,0,0,1,0,0,0,0,0,1,0,0,0,0,1,0,0,0,0,Mohamed DiamÃÂ©,ÃÂ£4.50m ,33.0,184.0,Midfielder - Central Midfield,right,Al-Ahli SC,41.0,6.0,3.0,2773.0,33.0,2.0,0.0,2181.0,29.0,0.0,0.0,2165.0,22.0,0.0,2.0,1980.0,4.0,0.0,0.0,350.0,Premier League,nan,nan,nan,nan,nan,nan,nan,nan,nan,nan,nan,nan,nan,nan,nan,nan,nan,nan,nan,nan,nan,nan,nan,nan,nan,nan,nan,nan,nan,nan,nan,nan,nan,nan,nan,nan,nan,nan,nan,nan,nan,nan,nan,nan,nan,nan,nan,nan,nan,nan,nan,nan,nan,nan,nan,nan,nan,nan,nan,nan,nan,nan,nan,nan,nan,nan,nan,nan,nan,nan,nan,nan,nan,nan,nan,nan,nan,nan,nan,nan,nan,nan,nan,nan,nan
19/6/2011,Miguel PallardÃÂ³,67004759,796,9/5/1986,24,0,0,0,0,4264,6271,6271,142,126,187929,173,73,DM/M C,2,2,1,3,2,2,1,2,3,2,3,7,8,10,7,13,10,8,8,5,13,13,12,15,11,12,15,15,12,16,11,15,13,11,8,11,15,15,16,12,13,14,8,5,14,13,20,16,13,15,12,14,6,11,12,12,12,14,16,15,12,8,1,1,19,1,5,1,19,DM/M C,311,1,1,1,1,1,1,1,1,1,20,19,1,5,1,1,4294967360.0,0,0,0,0,0,0,1,0,0,0,0,0,0,0,0,0,0,0,0,0,0,0,0,0,0,0,0,0,0,0,0,0,1,0,0,0,0,0,0,0,0,0,0,0,0,0,0,0,Miguel PallardÃÂ³,ÃÂ£1.35m ,34.0,174.0,Midfielder - Central Midfield,right,Without Club,29.0,0.0,0.0,1996.0,14.0,1.0,1.0,590.0,24.0,0.0,0.0,725.0,4.0,0.0,0.0,145.0,24.0,1.0,3.0,1792.0,19.0,0.0,0.0,1091.0,4.0,0.0,0.0,160.0,6.0,0.0,0.0,203.0,nan,nan,nan,nan,LaLiga,nan,nan,nan,nan,nan,nan,nan,nan,29/6/2010,Miguel PallardÃÂ³,67004759.0,796.0,9/5/1986,23.0,0.0,0.0,0.0,0.0,4225.0,6000.0,6000.0,146.0,130.0,2862162.0,173.0,73.0,DM/M C,2.0,2.0,3.0,3.0,3.0,2.0,3.0,2.0,3.0,2.0,3.0,7.0,8.0,11.0,7.0,13.0,10.0,8.0,8.0,5.0,13.0,14.0,12.0,15.0,13.0,12.0,15.0,15.0,12.0,16.0,11.0,15.0,13.0,11.0,8.0,11.0,15.0,15.0,16.0,12.0,13.0,14.0,8.0,5.0,14.0,13.0,20.0,16.0,13.0,15.0,12.0,14.0,6.0,11.0,12.0,12.0,12.0,14.0,16.0,15.0,12.0,8.0,Miguel PallardÃÂÃÂ³,ÃÂÃÂ£1.80m ,LaLiga
19/6/2011,McDonald Mariga,8117342,25,4/4/1987,24,27,3,0,0,5000,6500,6750,150,135,162458,188,86,DM/M C,2,3,3,3,1,1,1,2,3,1,2,9,10,10,12,10,6,14,13,10,13,13,7,17,11,16,13,15,13,12,10,12,14,10,8,13,13,15,15,12,10,16,14,10,16,14,20,17,18,14,14,14,13,8,15,14,15,13,15,14,12,4,1,1,20,5,10,1,20,DM/M C,421,1,1,1,5,1,5,1,1,1,16,20,1,10,1,1,137440000000.0,0,0,0,0,0,0,0,0,1,0,0,0,0,0,0,0,0,0,0,0,1,0,0,0,0,0,0,0,0,0,0,0,0,0,0,0,0,1,0,0,0,0,0,0,0,0,0,0,McDonald Mariga,ÃÂ£5.40m ,33.0,183.0,Midfielder - Defensive Midfield,right,Retired,21.0,1.0,0.0,684.0,29.0,1.0,1.0,2080.0,5.0,0.0,0.0,159.0,1.0,0.0,0.0,45.0,11.0,0.0,0.0,569.0,13.0,2.0,2.0,985.0,29.0,0.0,0.0,2102.0,15.0,0.0,1.0,909.0,nan,nan,nan,nan,Serie A,nan,nan,nan,nan,nan,nan,nan,nan,29/6/2010,McDonald Mariga,8117342.0,25.0,4/4/1987,23.0,27.0,3.0,0.0,0.0,4900.0,7250.0,6800.0,165.0,140.0,10272022.0,188.0,86.0,DM/M C,2.0,2.0,3.0,2.0,1.0,1.0,3.0,8.0,1.0,1.0,3.0,9.0,10.0,10.0,13.0,12.0,6.0,15.0,15.0,10.0,12.0,14.0,7.0,17.0,11.0,16.0,13.0,17.0,11.0,12.0,11.0,12.0,14.0,12.0,9.0,13.0,13.0,15.0,15.0,13.0,11.0,16.0,14.0,10.0,16.0,14.0,20.0,17.0,18.0,15.0,14.0,14.0,13.0,8.0,15.0,14.0,15.0,13.0,15.0,14.0,12.0,4.0,McDonald Mariga,ÃÂÃÂ£6.30m ,Serie A
19/6/2011,Mario SuÃÂ¡rez,7458309,796,2/24/1987,24,0,0,5,0,4869,6763,6763,151,139,19180069,185,77,DM/M C,3,2,2,3,3,2,2,5,3,2,1,9,8,12,12,13,9,13,14,7,11,14,2,12,13,15,13,16,14,15,12,13,12,11,8,12,14,16,15,12,13,16,13,11,17,13,20,16,14,12,15,14,5,13,5,13,14,10,13,12,11,8,5,1,18,8,10,7,18,DM/M C,311,1,1,1,8,1,1,5,1,1,20,18,7,10,1,1,64.0,0,0,0,0,0,0,1,0,0,0,0,0,0,0,0,0,0,0,0,0,0,0,0,0,0,0,0,0,0,0,0,0,0,0,0,0,0,0,0,0,0,0,0,0,0,0,0,0,Mario SuÃÂ¡rez,ÃÂ£4.50m ,33.0,189.0,Midfielder - Defensive Midfield,right,Rayo Vallecano,35.0,2.0,2.0,2125.0,42.0,0.0,0.0,3131.0,43.0,1.0,2.0,3190.0,25.0,0.0,0.0,2100.0,35.0,2.0,1.0,2353.0,30.0,1.0,0.0,1600.0,36.0,3.0,5.0,2796.0,18.0,2.0,2.0,1569.0,14.0,2.0,0.0,1026.0,LaLiga,37.0,7.0,2.0,2708.0,3.0,0.0,0.0,141.0,29/6/2010,Mario SuÃÂ¡rez,7458309.0,796.0,2/24/1987,23.0,0.0,0.0,5.0,0.0,4761.0,6750.0,6750.0,153.0,138.0,10099603.0,185.0,77.0,DM/M C,1.0,2.0,3.0,1.0,2.0,3.0,2.0,6.0,3.0,1.0,2.0,9.0,8.0,12.0,11.0,13.0,9.0,13.0,14.0,7.0,11.0,13.0,2.0,12.0,13.0,16.0,12.0,16.0,13.0,15.0,11.0,13.0,11.0,11.0,8.0,11.0,14.0,17.0,15.0,12.0,13.0,16.0,13.0,12.0,17.0,13.0,20.0,16.0,13.0,12.0,15.0,14.0,5.0,13.0,12.0,15.0,10.0,6.0,15.0,12.0,14.0,9.0,Mario SuÃÂÃÂ¡rez,ÃÂÃÂ£3.60m ,LaLiga
19/6/2011,Manuel Curto,744632,788,7/9/1986,24,0,0,0,0,1500,5100,6000,112,108,607189,187,78,DM/M C,2,1,3,2,2,3,1,3,3,2,1,11,11,11,12,10,10,13,11,9,8,12,12,9,11,11,12,11,10,10,12,11,10,12,10,12,10,11,10,10,11,13,14,14,12,9,20,12,14,10,8,10,12,10,7,14,14,3,3,8,7,6,1,1,17,7,1,1,17,DM/M C,311,1,1,7,7,1,1,1,1,1,20,17,1,1,1,1,0.0,0,0,0,0,0,0,0,0,0,0,0,0,0,0,0,0,0,0,0,0,0,0,0,0,0,0,0,0,0,0,0,0,0,0,0,0,0,0,0,0,0,0,0,0,0,0,0,0,Manuel Curto,ÃÂ£720Th. ,34.0,187.0,Midfielder - Defensive Midfield,right,Retired,19.0,2.0,1.0,1519.0,22.0,1.0,1.0,1522.0,13.0,4.0,3.0,1025.0,17.0,1.0,1.0,1309.0,6.0,0.0,0.0,377.0,13.0,2.0,0.0,874.0,nan,nan,nan,nan,nan,nan,nan,nan,nan,nan,nan,nan,Liga NOS,nan,nan,nan,nan,nan,nan,nan,nan,29/6/2010,Manuel Curto,744632.0,788.0,7/9/1986,23.0,0.0,0.0,0.0,0.0,1250.0,5000.0,5000.0,110.0,98.0,97605.0,187.0,78.0,M/AM C,2.0,1.0,2.0,3.0,1.0,3.0,2.0,3.0,1.0,1.0,1.0,10.0,10.0,10.0,11.0,9.0,9.0,12.0,10.0,8.0,7.0,11.0,11.0,8.0,10.0,11.0,11.0,11.0,9.0,9.0,11.0,10.0,10.0,12.0,10.0,11.0,9.0,10.0,9.0,10.0,10.0,12.0,13.0,14.0,12.0,10.0,20.0,11.0,13.0,10.0,8.0,10.0,12.0,10.0,13.0,14.0,14.0,9.0,9.0,5.0,11.0,6.0,Manuel Curto,ÃÂÃÂ£135Th. ,Liga NOS
19/6/2011,Luigi Giorgi,1400873,776,4/19/1987,24,0,0,0,0,2549,6000,6000,140,123,433327,186,74,M/AM C,2,1,2,3,1,3,2,1,2,2,3,10,8,12,12,12,10,14,11,6,8,15,8,13,14,10,13,14,12,13,15,15,10,12,12,13,13,13,13,12,12,15,12,5,14,12,20,12,10,15,8,14,4,10,11,4,7,17,8,14,9,12,1,1,18,20,1,1,20,M/AM C,521,1,1,1,20,1,1,1,1,1,1,18,1,1,1,1,0.0,0,0,0,0,0,0,0,0,0,0,0,0,0,0,0,0,0,0,0,0,0,0,0,0,0,0,0,0,0,0,0,0,0,0,0,0,0,0,0,0,0,0,0,0,0,0,0,0,Luigi Giorgi,ÃÂ£495Th. ,33.0,186.0,Midfielder - Central Midfield,right,Without Club,36.0,4.0,0.0,2682.0,26.0,1.0,2.0,1416.0,26.0,5.0,0.0,1540.0,2.0,0.0,0.0,107.0,27.0,0.0,3.0,2077.0,24.0,5.0,2.0,1656.0,27.0,0.0,5.0,1892.0,6.0,0.0,0.0,173.0,10.0,0.0,0.0,307.0,Serie A,18.0,1.0,2.0,1177.0,nan,nan,nan,nan,nan,nan,nan,nan,nan,nan,nan,nan,nan,nan,nan,nan,nan,nan,nan,nan,nan,nan,nan,nan,nan,nan,nan,nan,nan,nan,nan,nan,nan,nan,nan,nan,nan,nan,nan,nan,nan,nan,nan,nan,nan,nan,nan,nan,nan,nan,nan,nan,nan,nan,nan,nan,nan,nan,nan,nan,nan,nan,nan,nan,nan,nan,nan,nan,nan,nan,nan,nan,nan,nan,nan,nan,nan,nan,nan,nan,nan,nan,nan,nan,nan,nan,nan,nan
19/6/2011,Lucas Leiva,8833577,1651,1/9/1987,24,16,0,9,4,7000,8200,7750,162,155,4840741,179,74,DM/M C,1,2,2,3,3,3,2,7,1,1,3,11,13,13,8,14,10,8,8,5,15,14,7,16,15,11,15,13,15,15,14,14,15,11,9,14,16,16,17,13,15,13,12,12,15,14,20,17,14,16,8,15,3,14,15,16,15,16,14,10,12,10,1,1,20,14,10,1,20,DM/M C,311,1,1,1,14,1,1,1,1,1,20,20,1,10,1,1,17592200000000.0,0,0,0,0,1,0,0,0,0,0,0,0,0,0,0,0,0,0,0,1,0,0,1,0,0,0,0,0,0,0,0,0,0,0,0,0,0,0,0,0,0,0,0,0,1,0,0,0,Lucas Leiva,ÃÂ£13.50m ,33.0,179.0,Midfielder - Defensive Midfield,right,SS Lazio,47.0,1.0,2.0,3882.0,15.0,0.0,1.0,1295.0,32.0,0.0,1.0,2315.0,30.0,0.0,0.0,2100.0,32.0,0.0,0.0,2281.0,40.0,0.0,1.0,2850.0,32.0,1.0,3.0,1778.0,50.0,4.0,5.0,4031.0,36.0,0.0,4.0,2711.0,Premier League,30.0,0.0,1.0,2143.0,6.0,0.0,0.0,400.0,29/6/2010,Lucas,8833577.0,1651.0,1/9/1987,23.0,5.0,0.0,9.0,4.0,5625.0,8200.0,7400.0,162.0,150.0,21591301.0,179.0,74.0,DM/M C,3.0,3.0,2.0,3.0,1.0,3.0,3.0,4.0,1.0,1.0,3.0,11.0,13.0,13.0,8.0,14.0,10.0,8.0,8.0,5.0,15.0,14.0,7.0,16.0,15.0,11.0,14.0,15.0,15.0,14.0,14.0,13.0,15.0,11.0,8.0,15.0,15.0,13.0,17.0,13.0,15.0,13.0,12.0,10.0,15.0,14.0,20.0,17.0,14.0,14.0,8.0,12.0,7.0,12.0,15.0,16.0,15.0,16.0,14.0,10.0,12.0,10.0,nan,nan,nan,19-06-17,18.3.4.28,Lucas Leiva,8833577,1651,09-Jan-87,30,24,0,9,4,6200,7100,7200,154,144,232186002,179,74,D/DM/M C,1,2,3,3,1,2,1,1,3,2,3,3,4,11,5,15,4,11,4,4,15,15,9,17,14,15,18,14,16,16,11,14,16,10,12,14,17,16,16,11,13,14,12,9,14,10,20,15,13,15,11,14,7,11,18,13,19,16,19,12,16,8,16,1,17,10,1,1,17,D/DM/M C,331,1,1,1,10,1,1,16,1,1,20,17,1,1,1,1,17592200000000.0,0,0,0,0,0,0,1,0,0,0,0,0,0,0,0,0,0,0,0,1,0,0,1,0,0,0,0,0,0,0,0,0,0,0,0,0,0,0,0,0,0,0,0,0,1,0,0,0,Lucas Leiva,ÃÂ£9.00m ,33.0,179.0,Midfielder - Defensive Midfield,right,SS Lazio,32.0,1.0,3.0,1778.0,50.0,4.0,5.0,4031.0,36.0,0.0,4.0,2711.0,30.0,0.0,1.0,2143.0,6.0,0.0,0.0,400.0,Serie A,15-07-16,17.3.2.23,Lucas Leiva,8833577.0,1651.0,09-Jan-87,29.0,24.0,0.0,9.0,4.0,6200.0,7100.0,7150.0,154.0,144.0,23862123.0,179.0,74.0,DM C,2.0,2.0,2.0,2.0,3.0,1.0,3.0,2.0,1.0,3.0,2.0,7.0,8.0,11.0,5.0,15.0,8.0,12.0,4.0,5.0,15.0,16.0,9.0,15.0,14.0,15.0,18.0,14.0,16.0,16.0,9.0,15.0,16.0,10.0,11.0,14.0,17.0,16.0,16.0,11.0,14.0,14.0,12.0,10.0,14.0,10.0,20.0,15.0,13.0,15.0,11.0,14.0,8.0,11.0,18.0,14.0,18.0,16.0,17.0,12.0,15.0,6.0,Lucas Leiva,ÃÂ£6.30m ,Premier League
19/6/2011,Luca Cigarini,7990880,776,6/20/1986,24,0,0,29,1,5250,6515,6950,153,137,334967,175,72,M C,1,2,3,3,2,1,1,4,3,1,3,15,13,13,9,12,16,10,14,13,12,18,16,13,15,14,12,11,12,12,16,12,9,14,10,14,12,15,13,13,14,10,8,10,14,13,20,14,9,13,6,12,8,10,15,12,12,9,15,13,15,8,1,1,20,5,1,1,20,M C,401,1,1,1,5,1,1,1,1,1,15,20,1,1,1,1,0.0,0,0,0,0,0,0,0,0,0,0,0,0,0,0,0,0,0,0,0,0,0,0,0,0,0,0,0,0,0,0,0,0,0,0,0,0,0,0,0,0,0,0,0,0,0,0,0,0,Luca Cigarini,ÃÂ£4.95m ,34.0,175.0,Midfielder - Defensive Midfield,right,FC Crotone,18.0,3.0,2.0,893.0,32.0,1.0,2.0,2547.0,30.0,2.0,5.0,2491.0,36.0,2.0,8.0,2618.0,34.0,1.0,3.0,2774.0,26.0,2.0,2.0,1902.0,7.0,0.0,0.0,471.0,27.0,2.0,3.0,2153.0,28.0,0.0,1.0,1933.0,Serie A,22.0,0.0,4.0,1604.0,5.0,0.0,1.0,391.0,29/6/2010,Luca Cigarini,7990880.0,776.0,6/20/1986,24.0,0.0,0.0,29.0,1.0,4830.0,7100.0,7100.0,161.0,139.0,7701911.0,175.0,72.0,M C,1.0,1.0,1.0,3.0,3.0,3.0,2.0,5.0,2.0,3.0,2.0,15.0,13.0,13.0,9.0,12.0,16.0,10.0,14.0,13.0,12.0,18.0,16.0,13.0,15.0,11.0,12.0,10.0,12.0,12.0,16.0,12.0,9.0,12.0,10.0,14.0,12.0,15.0,13.0,13.0,14.0,10.0,10.0,10.0,14.0,13.0,20.0,14.0,9.0,13.0,6.0,12.0,8.0,10.0,15.0,12.0,12.0,9.0,15.0,16.0,18.0,6.0,Luca Cigarini,ÃÂÃÂ£4.05m ,LaLiga,19-06-17,18.3.4.28,Luca Cigarini,7990880,776,20-Jun-86,31,0,0,29,1,4900,6200,6200,145,124,232186002,175,72,DM/M C,2,3,3,2,3,1,3,3,2,1,1,10,10,12,8,12,13,8,11,4,12,15,13,14,15,16,13,13,13,12,15,13,15,14,15,10,11,14,11,11,11,12,8,12,14,10,20,14,11,14,15,14,8,10,15,12,16,10,15,13,7,14,1,1,20,1,1,1,20,DM/M C,421,1,1,1,1,1,1,1,1,1,18,20,1,1,1,1,137444000000.0,0,0,0,0,0,0,0,0,0,0,0,0,0,0,0,0,0,1,0,1,0,0,1,0,0,0,0,0,0,0,0,0,0,0,0,0,0,1,0,0,0,0,0,0,0,0,0,0,Luca Cigarini,ÃÂ£1.35m ,34.0,175.0,Midfielder - Defensive Midfield,right,FC Crotone,7.0,0.0,0.0,471.0,27.0,2.0,3.0,2153.0,28.0,0.0,1.0,1933.0,22.0,0.0,4.0,1604.0,5.0,0.0,1.0,391.0,Serie A,15-07-16,17.3.2.23,Luca Cigarini,7990880.0,776.0,20-Jun-86,30.0,0.0,0.0,29.0,1.0,5250.0,6500.0,6450.0,145.0,128.0,232186002.0,175.0,72.0,DM/M C,3.0,4.0,3.0,3.0,3.0,3.0,2.0,2.0,1.0,4.0,3.0,10.0,10.0,13.0,8.0,14.0,14.0,8.0,12.0,4.0,12.0,16.0,14.0,14.0,15.0,16.0,13.0,13.0,13.0,12.0,15.0,13.0,15.0,14.0,15.0,10.0,11.0,14.0,11.0,11.0,11.0,12.0,8.0,13.0,14.0,10.0,20.0,14.0,11.0,14.0,15.0,14.0,8.0,10.0,15.0,12.0,16.0,10.0,15.0,13.0,7.0,14.0,Luca Cigarini,ÃÂ£1.80m ,Serie A
19/6/2011,Lorenzo Davids,859350,784,9/4/1986,24,0,0,0,0,5020,5923,6100,137,122,158103,180,69,DM/M LC,2,1,1,1,3,3,3,5,2,1,3,7,9,12,6,14,7,11,7,10,14,13,10,13,15,15,14,13,11,11,13,12,14,13,10,16,14,13,16,11,11,12,11,20,14,11,10,15,12,14,6,15,3,12,14,15,9,15,17,10,12,12,11,13,20,12,9,17,20,DM/M LC,424,1,1,1,8,12,6,10,11,1,17,20,17,9,13,5,0.0,0,0,0,0,0,0,0,0,0,0,0,0,0,0,0,0,0,0,0,0,0,0,0,0,0,0,0,0,0,0,0,0,0,0,0,0,0,0,0,0,0,0,0,0,0,0,0,0,Lorenzo Davids,ÃÂ£900Th. ,34.0,180.0,Midfielder - Defensive Midfield,left,SV Nijmegen,30.0,2.0,3.0,2238.0,23.0,0.0,0.0,1760.0,10.0,0.0,0.0,684.0,7.0,0.0,0.0,185.0,nan,nan,nan,nan,nan,nan,nan,nan,nan,nan,nan,nan,1.0,0.0,0.0,90.0,8.0,0.0,0.0,750.0,Bundesliga,nan,nan,nan,nan,nan,nan,nan,nan,nan,nan,nan,nan,nan,nan,nan,nan,nan,nan,nan,nan,nan,nan,nan,nan,nan,nan,nan,nan,nan,nan,nan,nan,nan,nan,nan,nan,nan,nan,nan,nan,nan,nan,nan,nan,nan,nan,nan,nan,nan,nan,nan,nan,nan,nan,nan,nan,nan,nan,nan,nan,nan,nan,nan,nan,nan,nan,nan,nan,nan,nan,nan,nan,nan,nan,nan,nan,nan,nan,nan,nan,nan,nan,nan,nan,nan,nan,nan,nan,nan,nan,nan,nan
19/6/2011,Leandro Greco,7984090,776,7/19/1986,24,0,0,0,0,4400,6000,6000,135,124,208017,177,73,M/AM LC,1,1,1,1,1,1,1,1,1,1,1,2,11,14,9,14,4,8,11,1,8,14,4,9,15,8,14,9,12,14,14,12,12,13,7,13,13,14,15,13,14,11,8,8,11,14,20,12,13,11,11,12,18,11,12,18,10,10,15,15,12,9,1,1,20,18,12,18,20,M/AM LC,414,1,1,1,18,18,12,1,1,1,13,20,15,12,1,1,320.0,0,0,0,0,0,0,1,0,1,0,0,0,0,0,0,0,0,0,0,0,0,0,0,0,0,0,0,0,0,0,0,0,0,0,0,0,0,0,0,0,0,0,0,0,0,0,0,0,Leandro Greco,ÃÂ£2.25m ,34.0,184.0,Midfielder - Central Midfield,left,FC SÃÂ¼dtirol,19.0,1.0,2.0,983.0,21.0,0.0,2.0,975.0,38.0,1.0,4.0,2145.0,32.0,4.0,2.0,2408.0,28.0,0.0,2.0,1767.0,28.0,1.0,1.0,2033.0,11.0,0.0,0.0,574.0,18.0,0.0,1.0,1200.0,27.0,2.0,1.0,2039.0,Serie A,13.0,0.0,0.0,702.0,7.0,0.0,1.0,480.0,nan,nan,nan,nan,nan,nan,nan,nan,nan,nan,nan,nan,nan,nan,nan,nan,nan,nan,nan,nan,nan,nan,nan,nan,nan,nan,nan,nan,nan,nan,nan,nan,nan,nan,nan,nan,nan,nan,nan,nan,nan,nan,nan,nan,nan,nan,nan,nan,nan,nan,nan,nan,nan,nan,nan,nan,nan,nan,nan,nan,nan,nan,nan,nan,nan,nan,nan,nan,nan,nan,nan,nan,nan,nan,nan,nan,nan,nan,nan,nan,nan,nan,nan,nan
19/6/2011,Kevin-Prince Boateng,8723705,21,3/6/1987,24,9,1,6,0,6250,7500,7800,166,156,5267286,185,86,M/AM C,3,1,2,3,2,3,3,5,3,2,1,5,12,14,13,14,8,11,11,10,13,12,11,12,14,18,15,16,13,14,13,13,17,14,14,16,10,14,15,14,16,15,13,14,13,15,20,16,17,12,17,13,12,16,12,18,8,13,14,11,9,14,1,1,20,18,14,12,20,M/AM C,411,1,1,1,18,10,13,1,1,1,9,20,12,14,1,1,2233380000000.0,0,0,0,1,1,0,0,0,0,0,0,0,0,0,0,0,0,0,0,0,0,0,0,0,0,0,0,0,0,0,0,0,0,0,0,1,0,0,0,0,0,1,0,0,0,0,0,0,Kevin-Prince Boateng,ÃÂ£20.70m ,33.0,186.0,Midfielder - Attacking Midfield,right,AC Monza,34.0,3.0,3.0,2110.0,27.0,9.0,6.0,1874.0,37.0,3.0,7.0,2780.0,37.0,9.0,4.0,3188.0,25.0,0.0,5.0,1511.0,14.0,1.0,0.0,369.0,29.0,10.0,5.0,2009.0,36.0,6.0,2.0,2794.0,19.0,5.0,1.0,1389.0,Serie A,26.0,4.0,1.0,1283.0,2.0,0.0,0.0,90.0,29/6/2010,Kevin-Prince Boateng,8723705.0,21.0,3/6/1987,23.0,6.0,1.0,6.0,0.0,5112.0,7500.0,7000.0,154.0,143.0,11400000.0,185.0,86.0,M/AM C,1.0,2.0,3.0,1.0,2.0,1.0,3.0,4.0,3.0,1.0,2.0,7.0,11.0,13.0,12.0,14.0,11.0,10.0,14.0,8.0,7.0,14.0,11.0,10.0,14.0,16.0,13.0,11.0,13.0,12.0,15.0,11.0,9.0,14.0,8.0,14.0,4.0,6.0,15.0,14.0,13.0,14.0,13.0,14.0,13.0,14.0,20.0,13.0,15.0,11.0,19.0,13.0,12.0,16.0,6.0,18.0,6.0,11.0,8.0,5.0,9.0,18.0,Kevin-Prince Boateng,ÃÂÃÂ£13.50m ,Serie A,19-06-17,18.3.4.28,Kevin-Prince Boateng,8723705,21,06-Mar-87,30,14,2,0,0,6600,7100,7100,158,142,232186002,185,86,M/AM/S C,1,1,3,1,2,1,3,2,2,3,3,9,12,14,12,15,9,13,14,10,10,13,11,11,14,15,11,17,11,10,13,12,17,15,14,16,10,10,15,11,13,18,13,16,15,12,20,12,16,11,14,16,16,14,12,14,7,15,10,8,7,17,1,1,18,20,14,12,20,M/AM/S C,531,1,1,16,20,12,14,1,1,1,10,18,12,14,1,1,2233380000000.0,0,0,0,0,0,0,0,0,0,0,0,0,0,0,0,0,0,0,0,0,0,0,0,0,0,0,0,0,0,0,0,0,0,0,0,1,0,0,0,0,0,1,0,0,0,0,0,0,Kevin-Prince Boateng,ÃÂ£6.30m ,33.0,186.0,Midfielder - Attacking Midfield,right,AC Monza,29.0,10.0,5.0,2009.0,36.0,6.0,2.0,2794.0,19.0,5.0,1.0,1389.0,26.0,4.0,1.0,1283.0,3.0,1.0,0.0,135.0,Bundesliga,15-07-16,17.3.2.23,Kevin-Prince Boateng,8723705.0,21.0,06-Mar-87,29.0,14.0,2.0,0.0,0.0,5800.0,6850.0,6850.0,158.0,138.0,8114080.0,185.0,86.0,M/AM RLC,1.0,3.0,3.0,3.0,2.0,2.0,2.0,1.0,3.0,2.0,3.0,9.0,12.0,13.0,11.0,14.0,7.0,13.0,14.0,9.0,10.0,13.0,12.0,11.0,14.0,15.0,12.0,17.0,12.0,10.0,13.0,12.0,16.0,15.0,14.0,14.0,11.0,10.0,14.0,11.0,13.0,18.0,12.0,16.0,14.0,13.0,20.0,13.0,16.0,11.0,14.0,16.0,16.0,12.0,12.0,13.0,8.0,15.0,10.0,8.0,8.0,15.0,Kevin-Prince Boateng,ÃÂ£4.50m ,LaLiga
19/6/2011,KÃÂ©vin Constant,8435076,22,5/10/1987,24,12,2,0,0,5000,6519,6900,150,138,895578,184,78,M/AM LC,3,3,2,1,3,3,3,8,3,2,2,14,11,14,11,14,13,9,15,6,8,12,14,6,16,11,14,11,12,14,13,12,10,13,7,14,9,11,12,15,14,14,10,20,15,14,10,16,14,13,11,15,7,14,14,15,12,10,9,13,13,12,1,1,18,20,1,16,20,M/AM LC,524,1,1,1,20,16,1,1,1,1,13,18,15,1,1,1,4194308.0,0,0,1,0,0,0,0,0,0,0,0,0,0,0,0,0,0,0,0,0,0,0,1,0,0,0,0,0,0,0,0,0,0,0,0,0,0,0,0,0,0,0,0,0,0,0,0,0,KÃÂ©vin Constant,ÃÂ£4.50m ,33.0,184.0,Midfielder - Central Midfield,left,Retired,36.0,2.0,5.0,2486.0,23.0,1.0,1.0,1472.0,31.0,0.0,2.0,2289.0,26.0,0.0,1.0,1973.0,22.0,2.0,1.0,1691.0,18.0,0.0,2.0,1257.0,13.0,2.0,1.0,903.0,17.0,0.0,2.0,1340.0,3.0,0.0,0.0,262.0,Serie A,nan,nan,nan,nan,nan,nan,nan,nan,29/6/2010,KÃÂÃÂ©vin Constant,8435076.0,22.0,5/10/1987,23.0,8.0,1.0,0.0,0.0,3906.0,6250.0,5600.0,140.0,125.0,882579.0,183.0,78.0,M/AM C,1.0,1.0,3.0,1.0,1.0,2.0,1.0,3.0,1.0,1.0,1.0,14.0,11.0,14.0,11.0,14.0,13.0,9.0,15.0,6.0,8.0,12.0,14.0,6.0,16.0,11.0,11.0,11.0,12.0,12.0,13.0,12.0,7.0,13.0,7.0,12.0,8.0,11.0,9.0,15.0,13.0,14.0,10.0,20.0,15.0,13.0,10.0,13.0,14.0,13.0,11.0,15.0,7.0,12.0,11.0,15.0,12.0,10.0,9.0,13.0,13.0,12.0,KÃÂÃÂ©vin Constant,ÃÂÃÂ£4.95m ,Serie A
19/6/2011,Kemy Agustien,860297,784,8/20/1986,24,0,0,6,2,3350,5750,6000,131,106,438412,178,73,M RC,3,3,1,3,2,1,1,4,3,1,2,7,10,10,5,11,6,8,7,2,5,14,9,4,14,6,14,7,9,13,13,10,9,12,10,7,7,11,10,13,14,9,10,10,13,14,20,12,10,11,12,10,10,12,8,12,14,10,13,12,12,8,1,1,20,14,15,12,20,M RC,403,1,1,1,14,1,10,1,1,1,12,20,12,15,1,1,34359738368.0,0,0,0,0,0,0,0,0,0,0,0,0,0,0,0,0,0,0,0,0,0,0,0,0,0,0,0,0,0,0,0,0,0,0,0,1,0,0,0,0,0,0,0,0,0,0,0,0,Kemy Agustien,ÃÂ£900Th. ,34.0,178.0,Midfielder - Defensive Midfield,right,Mickleover Sports FC,19.0,0.0,2.0,969.0,18.0,0.0,2.0,1068.0,21.0,0.0,1.0,736.0,14.0,0.0,1.0,751.0,5.0,0.0,0.0,274.0,10.0,1.0,0.0,346.0,9.0,1.0,0.0,607.0,10.0,0.0,0.0,848.0,13.0,2.0,2.0,912.0,Premier League,nan,nan,nan,nan,nan,nan,nan,nan,nan,nan,nan,nan,nan,nan,nan,nan,nan,nan,nan,nan,nan,nan,nan,nan,nan,nan,nan,nan,nan,nan,nan,nan,nan,nan,nan,nan,nan,nan,nan,nan,nan,nan,nan,nan,nan,nan,nan,nan,nan,nan,nan,nan,nan,nan,nan,nan,nan,nan,nan,nan,nan,nan,nan,nan,nan,nan,nan,nan,nan,nan,nan,nan,nan,nan,nan,nan,nan,nan,nan,nan,nan,nan,nan,nan,nan,nan,nan,nan,nan,nan,nan,nan
19/6/2011,Kamil Vacek,5653968,763,5/18/1987,24,0,0,2,0,3250,6250,6250,135,120,1169960,183,81,AM RC,3,3,3,1,2,3,1,1,1,1,1,12,10,12,10,14,14,5,4,5,8,16,12,7,14,9,14,8,3,9,15,10,12,16,5,15,14,8,14,12,12,8,9,16,5,15,20,14,9,14,10,4,14,8,2,12,6,6,12,18,10,10,1,1,15,20,15,1,20,AM RC,503,1,1,1,20,1,15,1,1,1,15,15,1,15,1,1,0.0,0,0,0,0,0,0,0,0,0,0,0,0,0,0,0,0,0,0,0,0,0,0,0,0,0,0,0,0,0,0,0,0,0,0,0,0,0,0,0,0,0,0,0,0,0,0,0,0,Kamil Vacek,ÃÂ£1.35m ,33.0,184.0,Midfielder - Central Midfield,right,FC Bohemians Prag 1905,34.0,2.0,1.0,2887.0,31.0,4.0,2.0,1773.0,12.0,0.0,0.0,750.0,25.0,2.0,2.0,819.0,38.0,0.0,2.0,2175.0,33.0,5.0,8.0,2870.0,28.0,0.0,1.0,2186.0,25.0,0.0,1.0,1399.0,25.0,2.0,1.0,1760.0,Serie A,23.0,4.0,2.0,1395.0,6.0,0.0,0.0,464.0,nan,nan,nan,nan,nan,nan,nan,nan,nan,nan,nan,nan,nan,nan,nan,nan,nan,nan,nan,nan,nan,nan,nan,nan,nan,nan,nan,nan,nan,nan,nan,nan,nan,nan,nan,nan,nan,nan,nan,nan,nan,nan,nan,nan,nan,nan,nan,nan,nan,nan,nan,nan,nan,nan,nan,nan,nan,nan,nan,nan,nan,nan,nan,nan,nan,nan,nan,nan,nan,nan,nan,nan,nan,nan,nan,nan,nan,nan,nan,nan,nan,nan,nan,nan
19/6/2011,Juraj Kucka,63001138,794,2/26/1987,24,16,0,11,0,5500,6750,7000,155,142,1247466,186,87,M C,3,1,2,1,3,1,2,4,2,2,2,10,10,12,8,10,11,9,15,5,11,15,12,13,13,12,14,15,12,16,12,12,14,14,11,9,13,11,14,12,11,14,11,11,16,12,20,16,16,14,15,10,12,13,13,11,18,16,14,12,10,2,1,1,20,5,1,1,20,M C,401,1,1,1,5,1,1,1,1,1,15,20,1,1,1,1,4194824.0,0,0,0,1,0,0,0,0,0,1,0,0,0,0,0,0,0,0,0,0,0,0,1,0,0,0,0,0,0,0,0,0,0,0,0,0,0,0,0,0,0,0,0,0,0,0,0,0,Juraj Kucka,ÃÂ£4.32m ,33.0,186.0,Midfielder - Central Midfield,right,Parma Calcio 1913,42.0,5.0,1.0,3417.0,29.0,2.0,1.0,2019.0,33.0,3.0,3.0,2819.0,12.0,2.0,0.0,853.0,34.0,2.0,2.0,1861.0,35.0,1.0,4.0,2495.0,33.0,4.0,2.0,2369.0,28.0,3.0,6.0,2213.0,28.0,4.0,3.0,1964.0,Serie A,28.0,6.0,4.0,2049.0,5.0,1.0,0.0,441.0,nan,nan,nan,nan,nan,nan,nan,nan,nan,nan,nan,nan,nan,nan,nan,nan,nan,nan,nan,nan,nan,nan,nan,nan,nan,nan,nan,nan,nan,nan,nan,nan,nan,nan,nan,nan,nan,nan,nan,nan,nan,nan,nan,nan,nan,nan,nan,nan,nan,nan,nan,nan,nan,nan,nan,nan,nan,nan,nan,nan,nan,nan,nan,nan,nan,nan,nan,nan,nan,nan,nan,nan,nan,nan,nan,nan,nan,nan,nan,nan,nan,nan,nan,nan
19/6/2011,JosÃÂ© Manuel Jurado,7451707,796,6/29/1986,24,0,0,13,5,6250,7000,6650,150,143,2818203,173,72,M/AM C,2,1,3,3,1,1,1,6,3,2,2,13,12,16,14,19,13,5,14,6,5,17,13,7,18,6,13,7,11,7,17,10,6,17,6,15,7,12,7,14,16,9,8,17,12,13,20,11,8,8,4,16,10,13,11,8,10,10,12,13,12,7,1,1,16,20,11,14,20,M/AM C,521,1,1,6,20,14,11,1,1,1,5,16,13,7,1,1,68159620.0,0,0,1,0,0,0,0,1,0,0,0,1,0,0,0,0,0,0,0,0,1,0,0,0,0,0,1,0,0,0,0,0,0,0,0,0,0,0,0,0,0,0,0,0,0,0,0,0,JosÃÂ© Manuel Jurado,ÃÂ£5.40m ,34.0,176.0,Midfielder - Attacking Midfield,right,Without Club,46.0,9.0,5.0,3174.0,28.0,1.0,7.0,1584.0,24.0,3.0,5.0,1681.0,32.0,8.0,2.0,2734.0,20.0,3.0,4.0,1226.0,31.0,0.0,3.0,2274.0,32.0,3.0,4.0,2579.0,31.0,0.0,3.0,1678.0,26.0,1.0,5.0,2061.0,Bundesliga,15.0,0.0,0.0,479.0,nan,nan,nan,nan,29/6/2010,JosÃÂÃÂ© Manuel Jurado,7451707.0,796.0,6/29/1986,24.0,0.0,0.0,13.0,5.0,5476.0,7000.0,7000.0,165.0,148.0,39603465.0,173.0,72.0,M/AM LC,3.0,1.0,3.0,2.0,1.0,3.0,1.0,5.0,2.0,3.0,2.0,13.0,13.0,16.0,12.0,19.0,13.0,6.0,13.0,6.0,4.0,17.0,11.0,7.0,18.0,6.0,12.0,8.0,14.0,10.0,18.0,13.0,12.0,16.0,6.0,15.0,8.0,12.0,8.0,15.0,17.0,9.0,8.0,13.0,12.0,13.0,20.0,13.0,11.0,10.0,7.0,13.0,10.0,13.0,11.0,14.0,10.0,10.0,12.0,13.0,12.0,7.0,JosÃÂÃÂ© Manuel Jurado,ÃÂÃÂ£8.55m ,LaLiga,19-06-17,18.3.4.28,JosÃÂÃÂ¼ÃÂ Manuel Jurado,7451707,796,29-Jun-86,30,0,0,13,5,5900,6850,6850,147,137,8601621,176,72,M/AM LC,4,2,2,2,2,2,2,2,3,1,1,15,14,15,12,16,15,6,14,6,5,17,13,6,16,7,13,7,11,7,15,13,10,17,5,14,6,11,10,14,14,12,8,16,13,13,20,11,8,10,4,12,10,13,14,8,10,12,12,11,14,7,1,1,19,20,14,15,20,M/AM LC,524,1,1,6,20,15,14,1,1,1,1,19,15,11,1,1,140737000000000.0,0,0,1,0,0,0,0,0,0,0,0,1,0,0,0,0,0,0,0,0,1,0,0,0,0,0,0,0,0,0,0,0,0,0,0,0,0,0,0,0,0,0,0,0,0,0,0,1,JosÃÂ© Manuel Jurado,ÃÂ£2.25m ,34.0,176.0,Midfielder - Attacking Midfield,right,Without Club,32.0,3.0,4.0,2579.0,31.0,0.0,3.0,1678.0,26.0,1.0,5.0,2061.0,15.0,0.0,0.0,479.0,nan,nan,nan,nan,LaLiga,nan,nan,nan,nan,nan,nan,nan,nan,nan,nan,nan,nan,nan,nan,nan,nan,nan,nan,nan,nan,nan,nan,nan,nan,nan,nan,nan,nan,nan,nan,nan,nan,nan,nan,nan,nan,nan,nan,nan,nan,nan,nan,nan,nan,nan,nan,nan,nan,nan,nan,nan,nan,nan,nan,nan,nan,nan,nan,nan,nan,nan,nan,nan,nan,nan,nan,nan,nan,nan,nan,nan,nan,nan,nan,nan,nan,nan,nan,nan,nan,nan,nan,nan,nan,nan
19/6/2011,John Obi Mikel,5116933,38,4/22/1987,24,34,2,6,1,7500,7519,8000,170,159,36363636,188,86,DM/M C,3,3,1,2,3,2,3,5,2,2,1,10,12,11,6,18,10,8,4,3,14,17,13,14,16,14,17,14,19,13,16,15,18,10,10,13,17,14,15,9,13,16,12,15,17,10,20,18,20,14,11,16,8,12,18,19,10,16,10,8,12,15,1,1,18,10,1,1,18,DM/M C,311,1,1,1,10,1,1,1,1,1,20,18,1,1,1,1,17593300000000.0,0,0,0,0,0,0,0,0,0,0,0,0,0,0,0,0,0,1,0,1,0,0,1,0,0,0,0,0,0,0,1,0,0,0,0,0,0,0,0,0,0,0,0,0,1,0,0,0,nan,nan,nan,nan,nan,nan,nan,nan,nan,nan,nan,nan,nan,nan,nan,nan,nan,nan,nan,nan,nan,nan,nan,nan,nan,nan,nan,nan,nan,nan,nan,nan,nan,nan,nan,nan,nan,nan,nan,nan,nan,nan,nan,nan,nan,nan,nan,nan,nan,nan,nan,nan,29/6/2010,John Obi Mikel,5116933.0,38.0,4/22/1987,23.0,29.0,2.0,6.0,1.0,6084.0,7500.0,8000.0,175.0,156.0,105617647.0,188.0,86.0,DM/M C,2.0,3.0,2.0,3.0,1.0,1.0,2.0,6.0,3.0,3.0,1.0,10.0,12.0,11.0,6.0,18.0,10.0,8.0,4.0,3.0,14.0,15.0,13.0,14.0,16.0,14.0,16.0,14.0,18.0,13.0,16.0,15.0,18.0,10.0,10.0,13.0,17.0,14.0,15.0,9.0,13.0,16.0,12.0,15.0,17.0,10.0,20.0,18.0,20.0,14.0,11.0,16.0,8.0,12.0,18.0,19.0,10.0,16.0,10.0,8.0,12.0,15.0,nan,nan,nan
19/6/2011,JoÃÂ£o Moutinho,744539,788,9/8/1986,24,34,1,15,2,6100,7200,7550,159,151,3701558,171,66,M C,1,1,2,1,1,3,1,9,1,2,2,13,13,12,11,15,14,8,14,8,12,16,14,13,15,15,15,16,17,17,15,16,17,12,15,16,15,17,17,12,12,9,8,9,13,12,20,15,11,17,7,15,5,17,12,18,11,16,17,17,17,6,1,1,20,13,8,8,20,M C,401,1,1,1,13,5,5,1,1,1,13,20,8,8,1,1,1095761928.0,0,0,0,1,0,0,0,0,0,0,0,0,0,0,0,0,0,0,0,0,1,0,1,0,1,0,0,0,0,0,1,0,0,0,0,0,0,0,0,0,0,0,0,0,0,0,0,0,JoÃÂ£o Moutinho,ÃÂ£20.70m ,34.0,170.0,Midfielder - Central Midfield,right,Wolverhampton Wanderers,53.0,2.0,8.0,4129.0,44.0,3.0,8.0,3622.0,43.0,5.0,15.0,3514.0,34.0,1.0,8.0,2878.0,52.0,5.0,8.0,4473.0,37.0,1.0,8.0,3076.0,52.0,3.0,8.0,3236.0,44.0,1.0,7.0,3571.0,44.0,1.0,8.0,3444.0,Liga NOS,57.0,1.0,13.0,4598.0,6.0,0.0,0.0,345.0,29/6/2010,JoÃÂ£o Moutinho,744539.0,788.0,9/8/1986,23.0,27.0,1.0,15.0,2.0,5184.0,7200.0,7200.0,159.0,144.0,59049830.0,171.0,66.0,M C,2.0,1.0,3.0,1.0,3.0,2.0,2.0,3.0,1.0,2.0,2.0,13.0,13.0,12.0,11.0,13.0,14.0,9.0,13.0,8.0,11.0,15.0,14.0,11.0,14.0,15.0,15.0,16.0,17.0,17.0,14.0,16.0,17.0,11.0,15.0,16.0,15.0,17.0,17.0,12.0,12.0,9.0,8.0,9.0,13.0,11.0,20.0,15.0,11.0,17.0,7.0,14.0,5.0,17.0,12.0,18.0,11.0,16.0,17.0,17.0,17.0,6.0,JoÃÂÃÂ£o Moutinho,ÃÂÃÂ£18.00m ,Liga NOS,19-06-17,18.3.4.28,JoÃÂÃÂ¼ÃÂo Moutinho,744539,788,08-Sep-86,30,102,7,17,2,6500,7750,7650,160,153,232186002,170,61,M/AM C,2,3,3,3,3,4,1,2,1,4,2,16,15,15,10,16,16,7,13,4,11,17,14,12,17,14,15,15,13,16,17,14,16,15,14,12,14,17,15,13,14,14,8,10,14,11,20,14,10,14,9,17,8,14,13,17,15,16,17,15,16,7,1,1,20,16,12,12,20,M/AM C,411,1,1,1,16,1,1,1,1,1,14,20,12,12,1,1,21512320.0,0,0,0,0,0,0,0,1,0,0,0,0,0,0,1,0,0,0,0,1,0,0,1,0,1,0,0,0,0,0,0,0,0,0,0,0,0,0,0,0,0,0,0,0,0,0,0,0,JoÃÂ£o Moutinho,ÃÂ£9.00m ,34.0,170.0,Midfielder - Central Midfield,right,Wolverhampton Wanderers,52.0,3.0,8.0,3236.0,44.0,1.0,7.0,3571.0,44.0,1.0,8.0,3444.0,57.0,1.0,13.0,4598.0,6.0,0.0,0.0,345.0,Ligue 1,nan,nan,nan,nan,nan,nan,nan,nan,nan,nan,nan,nan,nan,nan,nan,nan,nan,nan,nan,nan,nan,nan,nan,nan,nan,nan,nan,nan,nan,nan,nan,nan,nan,nan,nan,nan,nan,nan,nan,nan,nan,nan,nan,nan,nan,nan,nan,nan,nan,nan,nan,nan,nan,nan,nan,nan,nan,nan,nan,nan,nan,nan,nan,nan,nan,nan,nan,nan,nan,nan,nan,nan,nan,nan,nan,nan,nan,nan,nan,nan,nan,nan,nan,nan,nan
19/6/2011,Jamie O'Hara,5113930,765,9/25/1986,24,0,0,7,0,4800,6400,6650,155,136,1272727,181,78,M LC,1,1,3,2,3,2,1,6,2,3,3,14,13,11,10,14,15,8,15,5,10,15,11,11,13,11,13,14,15,14,14,14,16,14,7,11,9,15,15,14,12,11,8,20,14,12,12,15,10,12,8,14,7,11,9,13,12,15,15,9,14,5,12,12,20,10,5,15,20,M LC,404,1,1,1,10,10,1,1,12,1,10,20,15,5,12,3,16384.0,0,0,0,0,0,0,0,0,0,0,0,0,0,0,1,0,0,0,0,0,0,0,0,0,0,0,0,0,0,0,0,0,0,0,0,0,0,0,0,0,0,0,0,0,0,0,0,0,Jamie O'Hara,ÃÂ£4.50m ,34.0,180.0,Midfielder - Central Midfield,left,Retired,14.0,3.0,1.0,1117.0,21.0,3.0,3.0,1730.0,21.0,0.0,4.0,1404.0,12.0,3.0,1.0,941.0,28.0,2.0,6.0,2442.0,39.0,1.0,3.0,2895.0,3.0,0.0,0.0,92.0,nan,nan,nan,nan,1.0,0.0,0.0,20.0,Premier League,0.0,0.0,0.0,0.0,nan,nan,nan,nan,29/6/2010,Jamie O'Hara,5113930.0,789.0,9/25/1986,23.0,0.0,0.0,7.0,0.0,4624.0,6400.0,6400.0,155.0,136.0,9462799.0,181.0,78.0,M LC,2.0,3.0,1.0,3.0,1.0,2.0,1.0,3.0,1.0,3.0,1.0,14.0,13.0,11.0,10.0,14.0,14.0,8.0,14.0,5.0,10.0,14.0,11.0,11.0,13.0,11.0,13.0,14.0,15.0,14.0,14.0,14.0,16.0,14.0,7.0,11.0,9.0,15.0,16.0,14.0,12.0,11.0,8.0,20.0,14.0,12.0,12.0,15.0,10.0,13.0,8.0,14.0,7.0,11.0,9.0,13.0,12.0,15.0,15.0,9.0,14.0,5.0,Jamie O'Hara,ÃÂÃÂ£4.05m ,Premier League
19/6/2011,Jamel Saihi,8445738,51,1/21/1987,24,4,1,0,0,4550,6350,5700,140,127,483015,181,73,DM C,3,2,1,3,1,2,2,1,2,1,1,9,9,11,6,13,11,11,14,8,11,13,8,12,13,12,14,15,13,13,13,12,15,9,9,8,13,16,16,12,13,14,10,8,13,11,20,16,12,13,12,14,11,8,16,13,17,13,14,14,14,6,1,1,15,1,1,1,15,DM C,301,1,1,1,1,1,1,1,1,1,20,15,1,1,1,1,0.0,0,0,0,0,0,0,0,0,0,0,0,0,0,0,0,0,0,0,0,0,0,0,0,0,0,0,0,0,0,0,0,0,0,0,0,0,0,0,0,0,0,0,0,0,0,0,0,0,Jamel Saihi,ÃÂ£3.15m ,33.0,182.0,Midfielder - Defensive Midfield,right,Retired,18.0,1.0,0.0,848.0,33.0,0.0,1.0,2610.0,15.0,0.0,0.0,1262.0,14.0,0.0,0.0,793.0,21.0,0.0,0.0,1468.0,15.0,0.0,0.0,707.0,9.0,0.0,0.0,473.0,nan,nan,nan,nan,nan,nan,nan,nan,Ligue 1,nan,nan,nan,nan,nan,nan,nan,nan,29/6/2010,Jamel Saihi,8445738.0,51.0,1/21/1987,23.0,4.0,1.0,0.0,0.0,3300.0,5900.0,5300.0,140.0,118.0,2933132.0,181.0,73.0,DM C,3.0,2.0,2.0,2.0,1.0,1.0,1.0,1.0,1.0,3.0,2.0,8.0,8.0,11.0,7.0,11.0,11.0,11.0,14.0,8.0,10.0,14.0,8.0,12.0,14.0,12.0,14.0,14.0,13.0,13.0,13.0,12.0,14.0,8.0,11.0,8.0,12.0,16.0,14.0,10.0,12.0,14.0,10.0,5.0,14.0,12.0,20.0,16.0,12.0,13.0,12.0,14.0,10.0,10.0,9.0,13.0,16.0,13.0,14.0,14.0,14.0,6.0,Jamel Saihi,ÃÂÃÂ£900Th. ,Ligue 1
19/6/2011,Graham Dorrans,5207960,793,5/5/1987,24,5,0,6,0,5000,7000,6601,148,137,1059623,181,73,M/AM RLC,3,3,1,2,3,2,3,5,2,1,3,11,12,14,12,13,13,9,13,6,10,14,11,9,14,9,12,11,13,12,14,15,16,13,12,15,12,14,15,14,13,13,8,12,14,14,20,14,10,13,8,10,5,14,17,13,14,13,15,11,13,3,1,2,20,20,15,15,20,M/AM RLC,416,1,1,10,20,15,15,1,1,1,14,20,15,15,1,2,2260600000000000.0,0,0,0,0,0,0,0,0,0,0,0,0,0,0,0,0,0,0,0,1,0,0,1,0,0,0,0,0,0,0,0,0,0,0,0,0,0,0,0,0,0,0,0,1,0,0,0,0,Graham Dorrans,ÃÂ£2.25m ,33.0,177.0,Midfielder - Central Midfield,right,Dundee FC,25.0,1.0,3.0,1778.0,37.0,4.0,3.0,2061.0,28.0,1.0,3.0,1940.0,17.0,2.0,0.0,1405.0,40.0,4.0,4.0,2794.0,27.0,0.0,3.0,1726.0,24.0,6.0,1.0,1925.0,20.0,5.0,4.0,1628.0,3.0,0.0,0.0,88.0,Premier League,23.0,1.0,5.0,2007.0,3.0,1.0,1.0,270.0,29/6/2010,Graham Dorrans,5207960.0,793.0,5/5/1987,23.0,3.0,0.0,6.0,0.0,4900.0,7000.0,6900.0,160.0,140.0,13460152.0,181.0,73.0,M/AM RLC,3.0,2.0,1.0,2.0,1.0,1.0,1.0,2.0,2.0,3.0,2.0,11.0,12.0,14.0,11.0,14.0,13.0,8.0,11.0,5.0,8.0,14.0,12.0,9.0,15.0,11.0,12.0,13.0,14.0,12.0,15.0,14.0,16.0,15.0,14.0,14.0,12.0,15.0,14.0,14.0,12.0,13.0,7.0,14.0,14.0,13.0,20.0,13.0,10.0,16.0,10.0,12.0,1.0,15.0,17.0,13.0,14.0,13.0,15.0,11.0,13.0,3.0,Graham Dorrans,ÃÂÃÂ£2.70m ,Premier League
19/6/2011,Gonzalo Castro,8723487,771,6/11/1987,24,5,0,21,3,5500,6850,6850,160,142,3194925,171,74,D/WB/DM/M/AM RLC,1,1,2,2,3,3,2,4,3,2,2,13,13,14,8,14,13,8,11,11,12,15,12,11,14,12,13,12,11,11,13,11,12,13,7,12,9,13,13,15,16,13,6,15,12,13,20,12,10,8,8,12,4,19,10,11,17,11,12,12,14,4,20,16,20,16,20,16,20,D/WB/DM/M/AM RLC,146,1,1,1,10,16,10,1,16,20,16,20,16,12,12,16,1048584.0,0,0,0,1,0,0,0,0,0,0,0,0,0,0,0,0,0,0,0,0,1,0,0,0,0,0,0,0,0,0,0,0,0,0,0,0,0,0,0,0,0,0,0,0,0,0,0,0,Gonzalo Castro,ÃÂ£8.10m ,33.0,172.0,Midfielder - Central Midfield,right,VfB Stuttgart,32.0,6.0,9.0,2262.0,40.0,2.0,8.0,3474.0,40.0,8.0,9.0,3140.0,39.0,5.0,12.0,3176.0,32.0,2.0,11.0,2772.0,41.0,7.0,11.0,2679.0,42.0,4.0,8.0,2885.0,28.0,1.0,3.0,1840.0,28.0,2.0,4.0,1892.0,Bundesliga,31.0,3.0,7.0,2321.0,6.0,1.0,1.0,466.0,29/6/2010,Gonzalo Castro,8723487.0,771.0,6/11/1987,23.0,5.0,0.0,21.0,3.0,4500.0,6900.0,6900.0,168.0,138.0,13523993.0,171.0,72.0,D/WB/DM/M RC,1.0,3.0,1.0,2.0,2.0,2.0,2.0,1.0,2.0,2.0,3.0,13.0,13.0,14.0,8.0,13.0,13.0,8.0,11.0,11.0,12.0,15.0,12.0,11.0,14.0,12.0,13.0,11.0,11.0,11.0,13.0,11.0,12.0,12.0,7.0,12.0,10.0,13.0,13.0,16.0,16.0,13.0,6.0,15.0,12.0,13.0,20.0,12.0,10.0,12.0,8.0,12.0,4.0,16.0,10.0,11.0,17.0,11.0,12.0,12.0,14.0,4.0,Gonzalo Castro,ÃÂÃÂ£8.10m ,Bundesliga,19-06-17,18.3.4.28,Gonzalo Castro,8723487,771,11-Jun-87,30,5,0,21,3,4643,6158,7100,150,142,24612204,172,74,M/AM RC,2,1,2,1,1,2,4,1,3,4,4,13,12,13,12,15,12,8,13,10,9,14,11,11,15,11,14,11,16,10,14,16,9,13,10,13,10,17,12,12,15,14,6,12,18,12,20,15,9,12,6,12,2,20,7,11,16,15,17,17,10,5,14,14,20,16,15,13,20,M/AM RC,413,1,1,1,16,13,15,1,10,14,12,20,13,15,10,14,4296015872.0,0,0,0,0,0,0,0,0,0,0,0,0,0,0,0,0,0,0,0,0,1,0,0,0,0,0,0,0,0,0,0,0,1,0,0,0,0,0,0,0,0,0,0,0,0,0,0,0,Gonzalo Castro,ÃÂ£7.20m ,33.0,172.0,Midfielder - Central Midfield,right,VfB Stuttgart,42.0,4.0,8.0,2885.0,28.0,1.0,3.0,1840.0,28.0,2.0,4.0,1892.0,31.0,3.0,7.0,2321.0,6.0,1.0,1.0,466.0,Bundesliga,15-07-16,17.3.2.23,Gonzalo Castro,8723487.0,771.0,11-Jun-87,29.0,5.0,0.0,21.0,3.0,4989.0,6501.0,7450.0,150.0,149.0,52492005.0,172.0,74.0,M/AM RC,3.0,1.0,3.0,2.0,1.0,2.0,1.0,2.0,3.0,2.0,3.0,13.0,12.0,13.0,12.0,15.0,12.0,8.0,13.0,10.0,9.0,14.0,11.0,10.0,15.0,11.0,14.0,12.0,16.0,10.0,15.0,16.0,9.0,13.0,10.0,14.0,10.0,17.0,12.0,12.0,16.0,14.0,6.0,12.0,18.0,12.0,20.0,16.0,9.0,12.0,6.0,12.0,2.0,20.0,7.0,11.0,16.0,15.0,17.0,17.0,10.0,5.0,Gonzalo Castro,ÃÂ£13.50m ,Bundesliga
19/6/2011,Gojko Kacar,5779401,802,1/26/1987,24,22,0,15,8,6250,6808,6628,157,142,8304880,183,77,D/DM/M C,3,2,3,1,2,2,3,1,1,2,3,7,10,14,15,10,9,17,13,12,17,10,9,17,14,18,14,18,12,8,14,16,18,10,13,17,9,12,19,10,13,17,15,11,6,15,20,10,13,11,9,15,12,20,16,17,8,12,9,10,7,6,16,11,20,12,14,1,20,D/DM/M C,431,1,1,10,12,1,1,16,1,10,19,20,1,14,1,11,8933530000000.0,0,0,1,0,0,1,0,0,0,1,0,0,0,0,0,0,0,0,0,0,0,0,0,0,0,0,0,0,0,0,0,0,0,0,0,0,0,1,0,0,0,0,0,1,0,0,0,0,Gojko Kacar,ÃÂ£3.60m ,33.0,185.0,Midfielder - Defensive Midfield,right,Without Club,23.0,2.0,1.0,1592.0,23.0,1.0,1.0,1319.0,7.0,0.0,0.0,356.0,26.0,3.0,1.0,2114.0,15.0,3.0,0.0,829.0,19.0,1.0,0.0,1117.0,23.0,0.0,1.0,1184.0,6.0,1.0,0.0,225.0,6.0,0.0,0.0,275.0,Bundesliga,nan,nan,nan,nan,nan,nan,nan,nan,29/6/2010,Gojko Kacar,5779401.0,802.0,1/26/1987,23.0,18.0,0.0,15.0,8.0,5041.0,6900.0,6750.0,163.0,142.0,12432500.0,183.0,77.0,DM/M C,1.0,2.0,3.0,1.0,2.0,2.0,2.0,4.0,3.0,2.0,1.0,7.0,10.0,14.0,16.0,9.0,9.0,17.0,13.0,12.0,17.0,10.0,9.0,17.0,14.0,18.0,14.0,18.0,12.0,8.0,15.0,16.0,18.0,10.0,13.0,17.0,9.0,12.0,19.0,10.0,13.0,17.0,16.0,11.0,6.0,15.0,20.0,10.0,13.0,11.0,9.0,15.0,12.0,20.0,16.0,17.0,8.0,12.0,9.0,10.0,7.0,6.0,Gojko Kacar,ÃÂÃÂ£6.75m ,Bundesliga,19-06-17,18.3.4.28,Gojko Kacar,5779401,802,26-Jan-87,30,25,0,15,7,4750,5750,6250,140,125,4313612,185,85,DM/M C,1,2,3,3,2,1,3,3,2,3,2,8,10,12,15,10,9,16,14,12,14,12,10,15,11,17,13,18,10,11,11,11,18,11,12,16,10,12,17,9,12,16,14,10,10,12,20,10,13,10,12,15,16,20,16,8,6,14,10,10,7,12,15,10,20,12,11,1,20,DM/M C,311,1,1,14,12,1,11,15,1,10,20,20,1,11,1,10,137439000000.0,0,0,0,0,0,0,0,0,0,1,0,0,0,0,0,0,0,0,0,0,0,0,0,0,0,0,0,0,0,0,0,0,0,0,0,0,0,1,0,0,0,0,0,0,0,0,0,0,Gojko Kacar,ÃÂ£450Th. ,33.0,185.0,Midfielder - Defensive Midfield,right,Without Club,23.0,0.0,1.0,1184.0,6.0,1.0,0.0,225.0,6.0,0.0,0.0,275.0,nan,nan,nan,nan,nan,nan,nan,nan,Bundesliga,15-07-16,17.3.2.23,Gojko Kacar,5779401.0,802.0,26-Jan-87,29.0,25.0,0.0,15.0,7.0,3750.0,5900.0,6250.0,140.0,125.0,3978451.0,183.0,77.0,DM/M C,1.0,3.0,3.0,2.0,3.0,3.0,1.0,2.0,3.0,3.0,1.0,8.0,10.0,12.0,15.0,10.0,9.0,16.0,14.0,12.0,14.0,12.0,10.0,15.0,11.0,17.0,13.0,18.0,10.0,11.0,11.0,11.0,18.0,11.0,12.0,16.0,10.0,12.0,17.0,9.0,12.0,16.0,14.0,10.0,10.0,12.0,20.0,10.0,13.0,10.0,12.0,15.0,16.0,20.0,16.0,8.0,6.0,14.0,10.0,10.0,7.0,12.0,Gojko Kacar,ÃÂ£900Th. ,Bundesliga
19/6/2011,Fredy GuarÃÂ­n,5262184,1653,6/30/1986,24,25,0,32,6,5500,7250,6900,150,138,1135339,183,77,M C,1,1,1,3,3,3,1,6,3,2,2,14,12,13,13,16,17,13,18,14,11,17,16,12,16,12,12,12,14,12,13,12,15,11,11,12,11,13,12,11,12,16,13,10,14,11,20,16,17,13,12,13,12,10,12,14,12,11,13,13,15,7,5,1,20,10,10,5,20,M C,401,1,5,1,10,1,5,5,1,1,14,20,5,10,1,1,768.0,0,0,0,0,0,0,0,0,1,1,0,0,0,0,0,0,0,0,0,0,0,0,0,0,0,0,0,0,0,0,0,0,0,0,0,0,0,0,0,0,0,0,0,0,0,0,0,0,Fredy GuarÃÂ­n,ÃÂ£10.80m ,34.0,183.0,Midfielder - Central Midfield,right,Without Club,44.0,10.0,8.0,2587.0,17.0,1.0,4.0,1071.0,47.0,10.0,12.0,3520.0,35.0,4.0,13.0,2448.0,37.0,7.0,9.0,2898.0,46.0,6.0,7.0,3495.0,23.0,12.0,5.0,1883.0,31.0,9.0,7.0,2754.0,28.0,5.0,4.0,2193.0,Serie A,1.0,0.0,0.0,44.0,nan,nan,nan,nan,29/6/2010,Fredy GuarÃÂ­n,5262184.0,1653.0,6/30/1986,23.0,25.0,0.0,32.0,6.0,3969.0,6350.0,6300.0,140.0,126.0,4893239.0,183.0,77.0,M C,2.0,1.0,2.0,1.0,1.0,2.0,1.0,5.0,2.0,3.0,2.0,13.0,11.0,12.0,7.0,13.0,14.0,12.0,16.0,13.0,10.0,13.0,10.0,11.0,14.0,12.0,11.0,12.0,13.0,11.0,12.0,11.0,15.0,11.0,11.0,11.0,10.0,12.0,11.0,11.0,11.0,14.0,12.0,10.0,14.0,11.0,20.0,15.0,14.0,13.0,12.0,13.0,12.0,11.0,12.0,14.0,12.0,11.0,13.0,13.0,15.0,7.0,Fredy GuarÃÂÃÂ­n,ÃÂÃÂ£8.55m ,Liga NOS
19/6/2011,Fernando Tissone,1408776,1649,7/24/1986,24,0,0,0,0,4000,6017,6900,141,127,551474,180,77,DM/M C,2,3,3,1,3,2,2,2,2,1,2,11,12,12,12,13,12,8,14,6,10,13,10,11,13,11,14,14,13,13,13,14,15,11,10,9,14,13,13,12,12,10,7,10,16,11,20,14,10,15,9,16,7,15,15,15,13,16,15,14,15,5,1,1,20,12,10,10,20,DM/M C,311,1,1,1,12,1,1,1,1,1,20,20,10,10,1,1,4194304.0,0,0,0,0,0,0,0,0,0,0,0,0,0,0,0,0,0,0,0,0,0,0,1,0,0,0,0,0,0,0,0,0,0,0,0,0,0,0,0,0,0,0,0,0,0,0,0,0,Fernando Tissone,ÃÂ£2.25m ,34.0,182.0,Midfielder - Central Midfield,right,Without Club,27.0,1.0,1.0,1705.0,29.0,0.0,0.0,1961.0,27.0,0.0,2.0,1693.0,28.0,1.0,2.0,2287.0,8.0,0.0,0.0,348.0,13.0,0.0,0.0,1087.0,nan,nan,nan,nan,27.0,1.0,0.0,2191.0,12.0,1.0,0.0,844.0,LaLiga,nan,nan,nan,nan,nan,nan,nan,nan,29/6/2010,Fernando Tissone,1408776.0,1649.0,7/24/1986,23.0,0.0,0.0,0.0,0.0,4900.0,7000.0,7000.0,159.0,140.0,8630562.0,180.0,77.0,DM/M C,1.0,1.0,3.0,2.0,1.0,1.0,2.0,8.0,3.0,1.0,1.0,12.0,13.0,13.0,13.0,14.0,13.0,9.0,15.0,7.0,11.0,14.0,11.0,12.0,14.0,11.0,15.0,14.0,14.0,14.0,14.0,15.0,15.0,11.0,10.0,10.0,15.0,14.0,14.0,13.0,13.0,11.0,8.0,10.0,16.0,12.0,20.0,15.0,11.0,15.0,9.0,16.0,7.0,15.0,15.0,15.0,13.0,16.0,15.0,14.0,15.0,5.0,Fernando Tissone,ÃÂÃÂ£2.16m ,Serie A,19-06-17,18.3.4.28,Fernando Tissone,1408776,1649,24-Jul-86,30,0,0,0,0,3150,6350,6350,131,130,232186002,181,80,DM/M C,2,4,3,2,1,1,2,2,4,1,4,10,11,11,10,13,12,9,12,6,11,9,10,12,12,11,15,14,14,14,12,14,15,9,10,10,15,15,15,13,12,11,11,9,13,11,20,16,15,6,9,16,14,15,15,15,13,16,15,14,15,5,1,1,18,1,1,1,18,DM/M C,311,1,1,1,1,1,1,1,1,1,20,18,1,1,1,1,8796100000000.0,0,0,0,0,0,0,0,0,0,0,0,0,0,0,0,0,0,0,0,0,0,0,1,0,0,0,0,0,0,0,0,0,0,0,0,0,0,0,0,0,0,0,0,1,0,0,0,0,Fernando Tissone,ÃÂ£360Th. ,34.0,182.0,Midfielder - Central Midfield,right,Without Club,nan,nan,nan,nan,27.0,1.0,0.0,2191.0,12.0,1.0,0.0,844.0,nan,nan,nan,nan,nan,nan,nan,nan,Liga NOS,nan,nan,nan,nan,nan,nan,nan,nan,nan,nan,nan,nan,nan,nan,nan,nan,nan,nan,nan,nan,nan,nan,nan,nan,nan,nan,nan,nan,nan,nan,nan,nan,nan,nan,nan,nan,nan,nan,nan,nan,nan,nan,nan,nan,nan,nan,nan,nan,nan,nan,nan,nan,nan,nan,nan,nan,nan,nan,nan,nan,nan,nan,nan,nan,nan,nan,nan,nan,nan,nan,nan,nan,nan,nan,nan,nan,nan,nan,nan,nan,nan,nan,nan,nan,nan
19/6/2011,Fabien Lemoine,8431727,769,3/16/1987,24,0,0,1,0,4650,5800,5800,140,129,474308,175,67,DM/M C,2,1,3,3,2,2,2,3,3,1,3,12,11,9,6,12,12,9,11,6,12,13,7,13,12,13,14,15,12,13,12,13,15,7,12,7,12,16,17,14,12,13,8,10,13,13,20,16,11,14,13,15,10,8,10,13,16,14,16,13,13,7,5,5,16,10,10,1,16,DM/M C,311,1,1,1,1,1,10,1,1,5,20,16,1,10,1,5,0.0,0,0,0,0,0,0,0,0,0,0,0,0,0,0,0,0,0,0,0,0,0,0,0,0,0,0,0,0,0,0,0,0,0,0,0,0,0,0,0,0,0,0,0,0,0,0,0,0,Fabien Lemoine,ÃÂ£4.05m ,33.0,175.0,Midfielder - Defensive Midfield,right,FC Lorient,20.0,0.0,2.0,805.0,30.0,0.0,5.0,2288.0,41.0,1.0,3.0,3032.0,40.0,2.0,3.0,3319.0,48.0,2.0,4.0,3963.0,43.0,0.0,1.0,3294.0,24.0,1.0,0.0,1422.0,35.0,2.0,3.0,3055.0,33.0,1.0,2.0,2796.0,Ligue 1,26.0,0.0,0.0,2260.0,7.0,0.0,0.0,451.0,nan,nan,nan,nan,nan,nan,nan,nan,nan,nan,nan,nan,nan,nan,nan,nan,nan,nan,nan,nan,nan,nan,nan,nan,nan,nan,nan,nan,nan,nan,nan,nan,nan,nan,nan,nan,nan,nan,nan,nan,nan,nan,nan,nan,nan,nan,nan,nan,nan,nan,nan,nan,nan,nan,nan,nan,nan,nan,nan,nan,nan,nan,nan,nan,nan,nan,nan,nan,nan,nan,nan,nan,nan,nan,nan,nan,nan,nan,nan,nan,nan,nan,nan,nan
19/6/2011,Didier Digard,917372,769,7/12/1986,24,0,0,10,0,4850,6095,6095,145,134,584355,184,81,DM C,1,2,2,3,3,3,2,1,2,2,3,12,10,9,6,11,8,13,12,7,12,13,8,14,11,15,14,16,13,13,12,14,15,6,13,9,14,14,16,14,13,15,11,8,12,13,20,15,15,13,15,15,13,15,8,15,13,14,15,13,11,9,12,10,15,8,10,1,15,DM C,301,1,1,1,8,1,1,12,1,10,20,15,1,1,1,10,8796090000000.0,0,0,1,0,0,0,0,0,0,1,0,0,0,0,0,0,0,0,0,0,0,0,0,0,0,0,0,0,0,0,0,0,0,0,0,0,0,0,0,0,0,0,0,1,0,0,0,0,Didier Digard,ÃÂ£2.70m ,34.0,183.0,Midfielder - Defensive Midfield,right,Retired,28.0,0.0,3.0,2300.0,33.0,0.0,3.0,2704.0,40.0,2.0,2.0,3428.0,35.0,2.0,1.0,2908.0,16.0,1.0,1.0,964.0,10.0,0.0,0.0,444.0,3.0,0.0,0.0,194.0,6.0,0.0,0.0,363.0,nan,nan,nan,nan,Ligue 1,nan,nan,nan,nan,nan,nan,nan,nan,29/6/2010,Didier Digard,917372.0,769.0,7/12/1986,23.0,0.0,0.0,10.0,0.0,4489.0,6000.0,6000.0,150.0,134.0,5746809.0,184.0,81.0,DM/M C,1.0,1.0,1.0,2.0,3.0,3.0,1.0,3.0,3.0,3.0,2.0,13.0,11.0,10.0,7.0,12.0,9.0,14.0,13.0,8.0,13.0,14.0,9.0,15.0,12.0,14.0,15.0,14.0,14.0,14.0,13.0,15.0,14.0,6.0,13.0,10.0,15.0,15.0,16.0,13.0,14.0,16.0,12.0,8.0,13.0,14.0,20.0,16.0,14.0,13.0,14.0,15.0,12.0,15.0,8.0,15.0,13.0,14.0,15.0,13.0,11.0,9.0,Didier Digard,ÃÂÃÂ£2.07m ,Ligue 1
19/6/2011,Dennis Aogo,8718399,771,1/14/1987,24,7,0,25,4,6350,7350,7350,149,137,3039111,184,84,D/WB/M LC,1,3,2,2,3,2,1,1,2,1,1,16,17,11,7,16,13,7,12,13,9,15,16,10,15,6,14,8,15,8,14,15,6,15,9,11,10,16,8,11,16,14,12,20,13,15,9,14,13,12,7,8,5,17,6,15,15,13,16,11,14,13,20,17,18,12,10,20,18,D/WB/M LC,124,1,1,1,12,1,1,8,20,9,14,18,14,10,17,1,4644340000000000.0,0,0,0,1,0,0,0,0,0,0,0,1,0,0,0,0,0,0,0,0,0,0,0,0,0,0,0,0,0,0,0,0,1,0,0,0,0,0,0,0,0,0,0,0,0,0,0,1,Dennis Aogo,ÃÂ£5.85m ,33.0,184.0,Midfielder - Defensive Midfield,left,Retired,20.0,0.0,1.0,1786.0,33.0,1.0,4.0,3000.0,28.0,2.0,6.0,2048.0,18.0,0.0,3.0,1447.0,32.0,1.0,3.0,2599.0,30.0,0.0,1.0,2350.0,14.0,2.0,1.0,901.0,30.0,0.0,6.0,2030.0,17.0,0.0,0.0,1243.0,Bundesliga,4.0,0.0,0.0,272.0,nan,nan,nan,nan,29/6/2010,Dennis Aogo,8718399.0,771.0,1/14/1987,23.0,0.0,0.0,25.0,4.0,4000.0,7250.0,7250.0,153.0,135.0,6180339.0,184.0,84.0,D/WB/M LC,2.0,2.0,2.0,3.0,3.0,3.0,2.0,6.0,1.0,1.0,1.0,16.0,17.0,11.0,7.0,16.0,14.0,7.0,12.0,13.0,8.0,15.0,16.0,9.0,15.0,6.0,14.0,8.0,16.0,7.0,14.0,15.0,8.0,15.0,9.0,11.0,10.0,16.0,8.0,11.0,16.0,14.0,12.0,20.0,13.0,15.0,9.0,14.0,13.0,12.0,7.0,8.0,5.0,17.0,12.0,15.0,15.0,6.0,15.0,10.0,11.0,19.0,Dennis Aogo,ÃÂÃÂ£7.20m ,Bundesliga,19-06-17,18.3.4.28,Dennis Aogo,8718399,771,14-Jan-87,30,12,0,25,4,4650,6650,6650,141,133,232186002,184,84,D/WB/M LC,1,3,2,1,2,2,4,3,1,1,1,12,16,11,8,13,12,8,11,13,10,14,15,11,14,8,12,10,15,11,13,12,9,14,8,10,10,13,10,12,14,12,11,20,15,14,10,15,13,13,8,13,5,17,8,12,14,12,14,13,10,10,20,20,17,11,10,20,17,D/WB/M LC,124,1,1,1,8,11,10,8,20,1,14,17,11,10,20,1,140742000000000.0,0,0,0,0,0,0,0,0,0,0,0,1,0,0,0,0,0,0,0,0,0,0,0,0,0,0,0,0,0,0,0,0,1,0,0,0,0,0,0,0,0,0,0,0,0,0,0,1,Dennis Aogo,ÃÂ£1.35m ,33.0,184.0,Midfielder - Defensive Midfield,left,Retired,14.0,2.0,1.0,901.0,30.0,0.0,6.0,2030.0,17.0,0.0,0.0,1243.0,4.0,0.0,0.0,272.0,nan,nan,nan,nan,Bundesliga,15-07-16,17.3.2.23,Dennis Aogo,8718399.0,771.0,14-Jan-87,29.0,12.0,0.0,25.0,4.0,4449.0,6699.0,6449.0,141.0,134.0,2761751.0,184.0,84.0,D/WB/M LC,2.0,1.0,2.0,1.0,2.0,3.0,2.0,3.0,1.0,4.0,1.0,12.0,16.0,11.0,8.0,13.0,12.0,8.0,11.0,13.0,10.0,14.0,15.0,11.0,14.0,8.0,12.0,10.0,15.0,11.0,13.0,12.0,9.0,14.0,8.0,11.0,10.0,13.0,10.0,12.0,14.0,12.0,11.0,20.0,15.0,14.0,10.0,15.0,13.0,13.0,8.0,13.0,5.0,17.0,8.0,12.0,14.0,12.0,13.0,13.0,10.0,10.0,Dennis Aogo,ÃÂ£1.35m ,Bundesliga
19/6/2011,David Zurutuza,1507535,796,8/7/1986,24,0,0,0,0,4650,6750,6750,155,140,1036675,184,70,M/AM C,3,3,2,3,3,3,2,3,2,2,1,11,12,15,11,13,10,11,11,4,5,15,10,11,17,13,13,12,16,12,16,14,15,14,14,13,8,14,15,12,12,16,9,13,12,13,20,9,12,10,6,12,12,9,14,15,18,15,14,14,7,5,1,1,19,20,9,12,20,M/AM C,521,1,1,1,20,12,9,1,1,1,9,19,10,7,1,1,4194304.0,0,0,0,0,0,0,0,0,0,0,0,0,0,0,0,0,0,0,0,0,0,0,1,0,0,0,0,0,0,0,0,0,0,0,0,0,0,0,0,0,0,0,0,0,0,0,0,0,David Zurutuza,ÃÂ£3.60m ,34.0,186.0,Midfielder - Central Midfield,right,Retired,36.0,2.0,4.0,2517.0,37.0,3.0,4.0,2773.0,22.0,2.0,4.0,1196.0,38.0,1.0,3.0,2432.0,22.0,3.0,0.0,1382.0,16.0,1.0,3.0,1128.0,37.0,3.0,1.0,3015.0,37.0,1.0,2.0,2645.0,24.0,2.0,1.0,1409.0,LaLiga,5.0,0.0,0.0,155.0,nan,nan,nan,nan,29/6/2010,David Zurutuza,1507535.0,796.0,8/7/1986,23.0,0.0,0.0,0.0,0.0,4290.0,6050.0,6050.0,146.0,131.0,4776212.0,184.0,70.0,M/AM C,1.0,2.0,3.0,1.0,2.0,1.0,1.0,2.0,2.0,3.0,3.0,11.0,12.0,13.0,12.0,13.0,9.0,11.0,11.0,4.0,4.0,14.0,8.0,10.0,16.0,13.0,13.0,12.0,13.0,13.0,16.0,14.0,15.0,14.0,14.0,12.0,6.0,12.0,14.0,11.0,12.0,16.0,9.0,13.0,12.0,12.0,20.0,13.0,13.0,12.0,6.0,12.0,12.0,8.0,14.0,15.0,18.0,15.0,14.0,14.0,7.0,5.0,David Zurutuza,ÃÂÃÂ£3.60m ,LaLiga,19-06-17,18.3.4.28,David Zurutuza,1507535,796,07-Aug-86,30,0,0,0,0,4900,7050,7050,141,141,232186002,186,78,M/AM C,1,3,1,3,3,1,1,3,1,2,2,11,12,14,12,15,9,11,11,2,11,15,10,13,17,14,14,16,16,12,16,13,15,12,14,13,14,14,17,10,14,11,9,13,9,13,20,11,14,14,6,14,14,5,14,15,18,15,14,14,7,5,1,1,20,19,1,13,20,M/AM C,411,1,1,1,19,13,1,1,1,1,1,20,1,1,1,1,70368700000000.0,0,0,0,0,0,0,0,0,0,0,0,0,0,0,0,0,0,0,0,0,0,0,1,0,0,0,0,0,0,0,0,0,0,0,0,0,0,0,0,0,0,0,0,0,0,0,1,0,David Zurutuza,ÃÂ£2.70m ,34.0,186.0,Midfielder - Central Midfield,right,Retired,37.0,3.0,1.0,3015.0,37.0,1.0,2.0,2645.0,24.0,2.0,1.0,1409.0,5.0,0.0,0.0,155.0,nan,nan,nan,nan,LaLiga,15-07-16,17.3.2.23,David Zurutuza,1507535.0,796.0,07-Aug-86,29.0,0.0,0.0,0.0,0.0,4900.0,6750.0,6750.0,141.0,141.0,6453779.0,186.0,78.0,M/AM C,2.0,1.0,1.0,1.0,3.0,1.0,3.0,3.0,2.0,1.0,2.0,11.0,12.0,15.0,11.0,15.0,9.0,11.0,11.0,2.0,8.0,15.0,10.0,13.0,17.0,14.0,14.0,15.0,16.0,11.0,16.0,13.0,15.0,14.0,14.0,12.0,14.0,14.0,17.0,10.0,14.0,11.0,9.0,13.0,9.0,13.0,20.0,11.0,14.0,14.0,6.0,14.0,13.0,5.0,14.0,15.0,18.0,15.0,14.0,14.0,7.0,5.0,David Zurutuza,ÃÂ£2.70m ,LaLiga
19/6/2011,Danny Guthrie,5118005,765,4/18/1987,24,0,0,0,0,3250,6250,6250,144,127,617648,171,73,M C,1,3,2,3,2,3,3,4,2,2,3,14,12,12,7,14,13,9,13,5,10,15,13,12,14,11,14,10,14,11,14,13,12,10,6,13,9,15,12,10,14,16,6,11,10,11,20,14,11,10,9,13,11,12,13,13,13,9,16,14,11,7,1,1,20,5,13,5,20,M C,401,1,1,1,5,1,5,1,1,1,8,20,5,13,1,1,550830000000.0,0,0,0,0,0,0,0,0,0,0,0,0,0,0,0,0,0,0,0,0,0,0,0,0,0,0,0,0,0,0,1,0,0,0,0,0,0,0,0,1,0,0,0,0,0,0,0,0,Danny Guthrie,ÃÂ£3.60m ,33.0,176.0,Midfielder - Central Midfield,right,Walsall FC,17.0,0.0,1.0,1204.0,21.0,2.0,0.0,1556.0,26.0,1.0,1.0,1862.0,33.0,3.0,3.0,2696.0,17.0,0.0,0.0,941.0,19.0,0.0,0.0,969.0,27.0,1.0,0.0,1936.0,30.0,2.0,2.0,2685.0,nan,nan,nan,nan,Premier League,28.0,1.0,2.0,1509.0,7.0,0.0,0.0,374.0,29/6/2010,Danny Guthrie,5118005.0,765.0,4/18/1987,23.0,0.0,0.0,0.0,0.0,3250.0,6250.0,6250.0,150.0,127.0,5132250.0,171.0,73.0,M C,2.0,1.0,2.0,3.0,3.0,1.0,3.0,5.0,1.0,2.0,3.0,14.0,12.0,12.0,7.0,14.0,13.0,9.0,13.0,5.0,10.0,15.0,13.0,12.0,14.0,11.0,14.0,10.0,14.0,13.0,14.0,13.0,12.0,10.0,6.0,13.0,9.0,15.0,12.0,10.0,14.0,16.0,6.0,11.0,10.0,11.0,20.0,14.0,11.0,10.0,9.0,13.0,7.0,12.0,11.0,13.0,13.0,11.0,16.0,14.0,11.0,7.0,Danny Guthrie,ÃÂÃÂ£3.15m ,Premier League
19/6/2011,Craig Gardner,5123512,765,11/25/1986,24,0,0,14,2,4600,6100,6100,144,129,2181818,178,72,M RC,1,2,2,1,2,1,3,5,2,3,2,14,11,11,12,12,13,8,14,9,6,12,12,12,12,18,11,18,11,12,10,12,12,12,8,14,12,14,16,14,12,14,8,11,15,12,20,17,12,12,14,9,9,14,5,14,7,12,12,7,10,6,14,1,20,14,16,14,20,M RC,403,1,1,1,14,1,1,1,1,14,1,20,14,16,1,1,35321800000000.0,0,0,0,0,0,0,0,0,1,0,0,0,0,0,0,0,0,0,0,0,0,0,0,0,0,0,0,0,0,0,0,0,0,0,0,0,0,1,0,0,0,0,0,0,0,1,0,0,Craig Gardner,ÃÂ£5.40m ,33.0,176.0,Midfielder - Central Midfield,right,Retired,37.0,10.0,0.0,2764.0,38.0,4.0,1.0,2846.0,37.0,8.0,2.0,3192.0,26.0,3.0,2.0,1271.0,38.0,3.0,5.0,2949.0,38.0,3.0,3.0,2454.0,30.0,2.0,1.0,1914.0,30.0,2.0,2.0,2067.0,22.0,1.0,1.0,768.0,Premier League,1.0,0.0,0.0,90.0,nan,nan,nan,nan,29/6/2010,Craig Gardner,5123512.0,765.0,11/25/1986,23.0,0.0,0.0,14.0,2.0,3969.0,6100.0,6100.0,145.0,126.0,6900000.0,178.0,72.0,M RC,2.0,1.0,3.0,2.0,1.0,2.0,2.0,6.0,1.0,2.0,1.0,14.0,11.0,10.0,12.0,12.0,13.0,7.0,12.0,9.0,6.0,13.0,12.0,12.0,13.0,18.0,11.0,18.0,11.0,12.0,12.0,12.0,12.0,12.0,8.0,14.0,12.0,14.0,15.0,16.0,12.0,14.0,8.0,9.0,15.0,12.0,20.0,16.0,10.0,11.0,14.0,9.0,9.0,14.0,6.0,14.0,13.0,12.0,12.0,11.0,14.0,6.0,Craig Gardner,ÃÂÃÂ£3.60m ,Premier League
19/6/2011,Cheick TiotÃÂ©,8170194,24,6/21/1986,24,14,0,0,0,5250,7000,7000,163,148,4688422,180,76,DM/M C,2,1,2,2,3,3,3,8,2,2,2,8,13,13,7,14,10,13,11,7,14,13,4,13,14,17,15,16,16,10,12,13,18,12,10,12,16,16,18,14,14,18,10,12,14,12,20,13,15,15,13,10,6,10,14,15,9,12,5,8,8,5,14,14,20,1,14,1,20,DM/M C,311,1,1,1,1,1,1,14,1,14,20,20,1,1,1,14,21743271936.0,0,0,0,0,0,0,0,0,0,0,0,0,0,0,0,0,0,0,0,0,0,0,0,0,0,0,0,0,1,0,0,0,1,0,1,0,0,0,0,0,0,0,0,0,0,0,0,0,Cheik TiotÃÂ©,ÃÂ£11.25m ,nan,180.0,Midfielder - Defensive Midfield,right,---,31.0,1.0,1.0,2612.0,24.0,0.0,3.0,2044.0,31.0,0.0,1.0,2255.0,36.0,0.0,2.0,3064.0,12.0,0.0,2.0,987.0,22.0,0.0,0.0,1397.0,14.0,0.0,0.0,1105.0,nan,nan,nan,nan,nan,nan,nan,nan,Premier League,nan,nan,nan,nan,nan,nan,nan,nan,29/6/2010,Cheick TiotÃÂ©,8170194.0,24.0,6/21/1986,24.0,14.0,0.0,0.0,0.0,4225.0,6150.0,6350.0,145.0,130.0,8000040.0,180.0,76.0,DM/M C,1.0,2.0,3.0,3.0,3.0,1.0,2.0,7.0,2.0,2.0,2.0,10.0,11.0,13.0,7.0,12.0,10.0,13.0,11.0,6.0,12.0,12.0,10.0,11.0,14.0,17.0,13.0,16.0,15.0,14.0,12.0,13.0,15.0,12.0,10.0,12.0,10.0,12.0,16.0,12.0,14.0,13.0,10.0,12.0,14.0,12.0,20.0,13.0,15.0,10.0,17.0,1.0,5.0,10.0,13.0,9.0,5.0,10.0,9.0,5.0,5.0,12.0,Cheik TiotÃÂÃÂ©,ÃÂÃÂ£4.50m ,Premier League
19/6/2011,Cesc FÃÂ bregas,5120110,796,5/4/1987,24,58,6,11,2,8750,8750,9000,186,177,25536741,177,70,M/AM C,2,2,3,1,2,1,3,4,1,3,1,13,10,14,15,17,13,8,12,5,10,19,13,12,18,12,18,16,18,15,19,17,20,14,14,18,12,17,16,12,15,17,9,15,13,11,20,16,11,16,11,17,8,12,17,20,14,16,16,8,12,13,1,1,20,18,12,1,20,M/AM C,411,1,1,1,18,1,1,1,1,1,11,20,1,12,1,1,5898368.0,0,0,0,0,0,0,0,1,0,0,0,0,0,0,0,0,0,1,0,1,1,0,1,0,0,0,0,0,0,0,0,0,0,0,0,0,0,0,0,0,0,0,0,0,0,0,0,0,Cesc FÃÂ bregas,ÃÂ£49.50m ,33.0,179.0,Midfielder - Central Midfield,right,AS Monaco,36.0,9.0,16.0,2544.0,48.0,15.0,20.0,3327.0,48.0,14.0,13.0,3253.0,55.0,13.0,17.0,3767.0,47.0,5.0,24.0,3923.0,49.0,6.0,9.0,3951.0,38.0,7.0,15.0,1952.0,49.0,3.0,9.0,3687.0,31.0,2.0,2.0,2083.0,LaLiga,22.0,0.0,3.0,1097.0,6.0,0.0,0.0,374.0,29/6/2010,Cesc FÃÂ bregas,5120110.0,796.0,5/4/1987,23.0,54.0,6.0,11.0,2.0,8010.0,8750.0,9000.0,186.0,179.0,-1.0,177.0,70.0,M C,3.0,3.0,3.0,3.0,2.0,3.0,3.0,8.0,3.0,3.0,3.0,14.0,10.0,12.0,14.0,17.0,13.0,8.0,12.0,5.0,12.0,19.0,13.0,12.0,18.0,12.0,18.0,16.0,18.0,15.0,19.0,17.0,20.0,14.0,14.0,18.0,12.0,17.0,16.0,12.0,17.0,17.0,9.0,15.0,14.0,11.0,20.0,16.0,11.0,16.0,11.0,17.0,5.0,12.0,17.0,20.0,18.0,17.0,17.0,12.0,13.0,8.0,Cesc FÃÂÃÂ bregas,ÃÂÃÂ£49.50m ,Premier League,19-06-17,18.3.4.28,Cesc FÃÂÃÂ¼ÃÂbregas,5120110,796,04-May-87,30,110,15,12,8,8300,8300,8300,174,156,232186002,179,77,M/AM C,2,1,2,3,1,1,3,3,1,2,3,14,11,13,14,18,13,10,13,5,8,19,15,9,19,10,18,13,18,15,18,15,13,15,13,18,7,12,14,10,10,12,9,15,12,10,20,15,10,14,11,12,12,14,17,15,13,15,14,8,12,13,1,1,20,19,11,10,20,M/AM C,411,1,1,8,19,7,9,1,1,1,11,20,10,11,1,1,8798250000000.0,0,0,0,0,0,0,0,1,0,0,0,0,0,0,0,0,0,0,0,1,1,0,1,0,0,0,0,0,0,0,0,1,0,0,0,0,0,0,0,0,0,0,0,1,0,0,0,0,Cesc FÃÂ bregas,ÃÂ£27.00m ,33.0,179.0,Midfielder - Central Midfield,right,AS Monaco,38.0,7.0,15.0,1952.0,49.0,3.0,9.0,3687.0,31.0,2.0,2.0,2083.0,22.0,0.0,3.0,1097.0,6.0,0.0,0.0,374.0,Premier League,nan,nan,nan,nan,nan,nan,nan,nan,nan,nan,nan,nan,nan,nan,nan,nan,nan,nan,nan,nan,nan,nan,nan,nan,nan,nan,nan,nan,nan,nan,nan,nan,nan,nan,nan,nan,nan,nan,nan,nan,nan,nan,nan,nan,nan,nan,nan,nan,nan,nan,nan,nan,nan,nan,nan,nan,nan,nan,nan,nan,nan,nan,nan,nan,nan,nan,nan,nan,nan,nan,nan,nan,nan,nan,nan,nan,nan,nan,nan,nan,nan,nan,nan,nan,nan
19/6/2011,Carlos Carmona,8835439,1652,2/21/1987,24,23,0,0,0,5000,7040,6450,145,128,141350,178,76,DM/M C,1,1,3,3,1,2,2,8,2,3,2,9,10,9,8,12,9,10,12,10,13,14,8,15,11,15,12,12,8,14,12,14,14,9,14,8,14,15,15,13,13,12,11,9,16,13,20,16,14,15,15,15,6,10,18,13,15,12,13,15,13,8,1,1,20,1,5,5,20,DM/M C,421,1,1,1,1,1,1,1,1,1,19,20,5,5,1,1,137443000000.0,0,0,0,0,0,0,1,0,0,0,0,0,0,0,0,0,0,0,0,0,0,0,1,0,0,0,0,0,0,0,0,0,0,0,0,0,0,1,0,0,0,0,0,0,0,0,0,0,Carlos Carmona,ÃÂ£1.80m ,33.0,178.0,Midfielder - Defensive Midfield,right,CSD Colo Colo,32.0,0.0,3.0,2606.0,29.0,1.0,0.0,2045.0,23.0,2.0,2.0,1705.0,33.0,2.0,0.0,2636.0,34.0,0.0,0.0,2898.0,9.0,0.0,0.0,558.0,35.0,2.0,1.0,2996.0,29.0,1.0,3.0,2421.0,2.0,0.0,0.0,177.0,Serie A,10.0,0.0,0.0,655.0,nan,nan,nan,nan,nan,nan,nan,nan,nan,nan,nan,nan,nan,nan,nan,nan,nan,nan,nan,nan,nan,nan,nan,nan,nan,nan,nan,nan,nan,nan,nan,nan,nan,nan,nan,nan,nan,nan,nan,nan,nan,nan,nan,nan,nan,nan,nan,nan,nan,nan,nan,nan,nan,nan,nan,nan,nan,nan,nan,nan,nan,nan,nan,nan,nan,nan,nan,nan,nan,nan,nan,nan,nan,nan,nan,nan,nan,nan,nan,nan,nan,nan,nan,nan,nan,nan,nan,nan
19/6/2011,Bradley Johnson,5133341,765,4/28/1987,24,0,0,0,0,4000,6000,6250,137,120,716034,178,69,M LC,3,3,3,2,2,1,1,2,2,1,2,11,14,12,13,12,13,16,17,6,10,13,13,10,11,14,12,11,13,14,11,12,11,12,8,12,14,16,16,13,12,13,15,20,13,13,7,16,13,11,14,12,8,13,10,15,10,12,13,8,10,9,7,7,20,12,7,17,20,M LC,404,1,1,1,1,12,1,1,7,1,1,20,17,7,7,1,131840.0,0,0,0,0,0,0,0,0,1,1,0,0,0,0,0,0,0,1,0,0,0,0,0,0,0,0,0,0,0,0,0,0,0,0,0,0,0,0,0,0,0,0,0,0,0,0,0,0,Bradley Johnson,ÃÂ£1.80m ,33.0,178.0,Midfielder - Central Midfield,right,Blackburn Rovers,49.0,6.0,4.0,3982.0,30.0,2.0,6.0,2207.0,40.0,1.0,3.0,3497.0,36.0,3.0,1.0,2798.0,45.0,15.0,2.0,3887.0,38.0,5.0,2.0,3007.0,38.0,3.0,2.0,3268.0,35.0,4.0,5.0,2530.0,34.0,2.0,4.0,2607.0,Premier League,36.0,3.0,2.0,2458.0,8.0,3.0,0.0,720.0,nan,nan,nan,nan,nan,nan,nan,nan,nan,nan,nan,nan,nan,nan,nan,nan,nan,nan,nan,nan,nan,nan,nan,nan,nan,nan,nan,nan,nan,nan,nan,nan,nan,nan,nan,nan,nan,nan,nan,nan,nan,nan,nan,nan,nan,nan,nan,nan,nan,nan,nan,nan,nan,nan,nan,nan,nan,nan,nan,nan,nan,nan,nan,nan,nan,nan,nan,nan,nan,nan,nan,nan,nan,nan,nan,nan,nan,nan,nan,nan,nan,nan,nan,nan
19/6/2011,Blaise Matuidi,8442483,769,4/9/1987,24,3,0,25,0,6513,7314,6614,160,146,5842302,175,70,DM/M C,2,2,3,1,2,1,3,4,3,2,1,6,11,12,6,12,8,7,10,8,10,13,9,17,13,12,16,14,15,13,12,14,15,8,13,8,15,16,18,15,16,13,7,20,15,13,10,18,12,16,12,14,7,14,9,14,14,14,16,16,16,5,10,10,17,1,1,10,17,DM/M C,311,1,1,1,1,1,1,10,10,1,20,17,1,1,10,1,137439000000.0,0,0,0,0,0,0,0,0,0,0,0,0,0,0,0,0,0,0,0,0,0,0,0,0,0,0,0,0,0,0,0,0,0,0,0,0,0,1,0,0,0,0,0,0,0,0,0,0,Blaise Matuidi,ÃÂ£9.00m ,33.0,175.0,Midfielder - Central Midfield,left,Inter Miami CF,37.0,0.0,2.0,3322.0,35.0,1.0,1.0,2499.0,52.0,8.0,1.0,4464.0,52.0,7.0,7.0,3769.0,53.0,5.0,5.0,3637.0,48.0,5.0,9.0,3353.0,52.0,7.0,5.0,3720.0,49.0,4.0,2.0,3257.0,42.0,3.0,3.0,3290.0,Ligue 1,57.0,1.0,2.0,3888.0,nan,nan,nan,nan,29/6/2010,Blaise Matuidi,8442483.0,769.0,4/9/1987,23.0,0.0,0.0,21.0,0.0,1450.0,6300.0,6300.0,165.0,140.0,8042850.0,175.0,70.0,DM/M C,1.0,2.0,3.0,2.0,1.0,2.0,3.0,5.0,3.0,1.0,1.0,7.0,11.0,10.0,7.0,12.0,8.0,8.0,11.0,8.0,10.0,14.0,9.0,14.0,12.0,12.0,17.0,14.0,14.0,17.0,12.0,14.0,14.0,8.0,12.0,8.0,15.0,15.0,18.0,15.0,15.0,12.0,7.0,20.0,15.0,12.0,10.0,17.0,12.0,15.0,8.0,14.0,7.0,12.0,14.0,14.0,14.0,14.0,16.0,16.0,16.0,5.0,Blaise Matuidi,ÃÂÃÂ£7.20m ,Ligue 1,19-06-17,18.3.4.28,Blaise Matuidi,8442483,769,09-Apr-87,30,58,8,10,0,6750,7650,8100,158,158,232186002,180,75,DM/M C,2,2,3,2,1,3,3,3,2,3,2,6,12,12,10,13,6,12,12,8,15,13,9,16,13,14,16,16,15,17,10,15,16,8,13,16,16,18,18,15,14,16,9,20,16,14,10,18,15,16,8,14,7,14,9,16,18,14,16,16,18,5,7,7,20,10,1,14,20,DM/M C,421,1,1,1,1,10,1,1,7,1,16,20,14,1,7,1,137439000000.0,0,0,0,1,0,1,0,0,0,0,0,0,0,0,0,0,0,0,0,0,0,0,0,0,0,0,0,0,0,0,0,0,0,0,0,0,0,1,0,0,0,0,0,0,0,0,0,0,Blaise Matuidi,ÃÂ£27.00m ,33.0,175.0,Midfielder - Central Midfield,left,Inter Miami CF,52.0,7.0,5.0,3720.0,49.0,4.0,2.0,3257.0,42.0,3.0,3.0,3290.0,57.0,1.0,2.0,3888.0,nan,nan,nan,nan,Serie A,15-07-16,17.3.2.23,Blaise Matuidi,8442483.0,769.0,09-Apr-87,29.0,51.0,8.0,24.0,0.0,7297.0,7797.0,7697.0,159.0,154.0,63400179.0,175.0,70.0,DM/M C,3.0,1.0,1.0,3.0,1.0,2.0,1.0,2.0,2.0,2.0,3.0,6.0,12.0,12.0,10.0,13.0,7.0,12.0,12.0,8.0,14.0,13.0,9.0,16.0,13.0,14.0,16.0,16.0,15.0,16.0,11.0,14.0,16.0,8.0,14.0,14.0,15.0,18.0,18.0,15.0,14.0,16.0,8.0,20.0,16.0,14.0,8.0,18.0,14.0,16.0,13.0,14.0,7.0,14.0,19.0,14.0,14.0,14.0,16.0,16.0,16.0,5.0,Blaise Matuidi,ÃÂ£27.00m ,Ligue 1
19/6/2011,Benjamin Corgnet,85063843,769,4/6/1987,24,0,0,0,0,2631,5282,4070,140,117,284156,180,74,DM/M C,3,1,3,1,1,2,1,2,1,3,1,10,13,9,6,12,10,14,11,4,9,12,10,12,13,13,13,12,12,12,14,12,10,10,9,9,13,13,12,14,12,12,11,10,14,12,20,13,10,14,12,8,3,10,9,11,12,14,17,13,13,4,12,12,20,13,12,1,20,DM/M C,421,1,1,1,13,1,1,1,1,12,18,20,1,1,1,12,0.0,0,0,0,0,0,0,0,0,0,0,0,0,0,0,0,0,0,0,0,0,0,0,0,0,0,0,0,0,0,0,0,0,0,0,0,0,0,0,0,0,0,0,0,0,0,0,0,0,Benjamin Corgnet,ÃÂ£4.05m ,33.0,179.0,Midfielder - Attacking Midfield,right,Without Club,33.0,1.0,2.0,2508.0,40.0,9.0,3.0,3207.0,34.0,8.0,5.0,2576.0,33.0,7.0,2.0,2081.0,32.0,1.0,4.0,1542.0,25.0,3.0,2.0,1022.0,11.0,1.0,0.0,397.0,18.0,0.0,2.0,1380.0,20.0,1.0,3.0,917.0,Ligue 1,11.0,2.0,0.0,593.0,nan,nan,nan,nan,nan,nan,nan,nan,nan,nan,nan,nan,nan,nan,nan,nan,nan,nan,nan,nan,nan,nan,nan,nan,nan,nan,nan,nan,nan,nan,nan,nan,nan,nan,nan,nan,nan,nan,nan,nan,nan,nan,nan,nan,nan,nan,nan,nan,nan,nan,nan,nan,nan,nan,nan,nan,nan,nan,nan,nan,nan,nan,nan,nan,nan,nan,nan,nan,nan,nan,nan,nan,nan,nan,nan,nan,nan,nan,nan,nan,nan,nan,nan,nan,nan,nan,nan,nan,19-06-17,18.3.4.28,Benjamin Corgnet,85063843,769,06-Apr-87,30,0,0,0,0,3600,6050,6050,135,121,232186002,180,74,M/AM C,2,1,1,1,1,1,2,3,1,1,4,9,13,12,10,14,10,12,12,6,8,13,8,8,13,10,13,14,13,13,13,12,11,11,7,10,10,14,14,12,13,14,12,10,14,13,20,14,11,11,10,15,8,10,15,12,14,10,14,15,15,6,10,10,19,20,14,1,20,M/AM C,521,1,1,7,20,1,14,1,1,10,14,19,1,13,1,10,2251800000000000.0,0,0,0,0,0,0,0,0,1,0,0,0,0,0,0,0,0,0,0,0,0,0,0,0,0,0,0,0,0,0,0,0,0,0,0,0,0,0,0,0,0,0,0,0,0,0,0,0,Benjamin Corgnet,ÃÂ£900Th. ,33.0,179.0,Midfielder - Attacking Midfield,right,Without Club,11.0,1.0,0.0,397.0,18.0,0.0,2.0,1380.0,20.0,1.0,3.0,917.0,11.0,2.0,0.0,593.0,nan,nan,nan,nan,Ligue 1,15-07-16,17.3.2.23,Benjamin Corgnet,85063843.0,769.0,06-Apr-87,29.0,0.0,0.0,0.0,0.0,3798.0,6148.0,6198.0,128.0,124.0,2273099.0,180.0,74.0,M/AM RC,2.0,2.0,3.0,3.0,3.0,3.0,1.0,1.0,1.0,3.0,2.0,9.0,13.0,13.0,10.0,14.0,10.0,12.0,12.0,6.0,8.0,12.0,8.0,8.0,14.0,10.0,13.0,14.0,13.0,12.0,13.0,11.0,13.0,11.0,7.0,10.0,10.0,14.0,14.0,14.0,13.0,13.0,12.0,10.0,14.0,13.0,20.0,14.0,11.0,14.0,10.0,15.0,8.0,10.0,20.0,12.0,14.0,16.0,14.0,15.0,15.0,6.0,Benjamin Corgnet,ÃÂ£900Th. ,Ligue 1
19/6/2011,BeÃÂ±at,7458307,796,2/19/1987,24,0,0,0,0,4565,6561,6561,145,131,678325,175,67,DM/M C,2,3,2,3,3,1,1,8,3,1,3,16,12,12,12,13,17,12,16,8,12,15,10,13,14,12,13,12,13,13,14,13,13,13,13,13,12,13,13,11,13,12,9,10,10,12,20,12,11,15,6,15,8,10,11,15,13,14,14,10,13,5,5,1,20,5,1,1,20,DM/M C,421,1,1,1,5,1,1,5,1,1,17,20,1,1,1,1,67109120.0,0,0,0,0,0,0,0,0,1,0,0,0,0,0,0,0,0,0,0,0,0,0,0,0,0,0,1,0,0,0,0,0,0,0,0,0,0,0,0,0,0,0,0,0,0,0,0,0,nan,nan,nan,nan,nan,nan,nan,nan,nan,nan,nan,nan,nan,nan,nan,nan,nan,nan,nan,nan,nan,nan,nan,nan,nan,nan,nan,nan,nan,nan,nan,nan,nan,nan,nan,nan,nan,nan,nan,nan,nan,nan,nan,nan,nan,nan,nan,nan,nan,nan,nan,nan,nan,nan,nan,nan,nan,nan,nan,nan,nan,nan,nan,nan,nan,nan,nan,nan,nan,nan,nan,nan,nan,nan,nan,nan,nan,nan,nan,nan,nan,nan,nan,nan,nan,nan,nan,nan,nan,nan,nan,nan,nan,nan,nan,nan,nan,nan,nan,nan,nan,nan,nan,nan,nan,nan,nan,nan,nan,nan,nan,nan,nan,nan,nan,nan,nan,nan,nan,nan,nan,nan,nan,nan,nan,nan,nan,nan,nan,nan,nan,nan,nan,nan,nan,nan,19-06-17,18.3.4.28,BeÃÂÃÂ¼ÃÂat,7458307,796,19-Feb-87,30,4,0,0,0,5750,7150,7150,150,143,232186002,175,72,M C,3,2,3,3,3,3,2,3,1,2,3,14,12,12,11,15,15,13,15,8,8,15,13,12,15,11,14,13,14,13,15,13,17,14,13,14,12,16,14,13,14,14,8,12,12,11,20,13,12,15,12,15,12,10,8,15,14,15,12,10,14,5,1,1,20,15,9,10,20,M C,401,1,1,1,15,1,1,1,1,1,14,20,10,9,1,1,149536000000000.0,0,0,0,0,0,0,0,0,0,0,0,0,0,0,0,0,0,0,0,0,0,0,0,0,0,0,0,0,0,0,0,1,0,0,0,0,0,0,0,0,0,0,0,1,0,0,0,1,nan,nan,nan,nan,nan,nan,nan,nan,nan,nan,nan,nan,nan,nan,nan,nan,nan,nan,nan,nan,nan,nan,nan,nan,nan,nan,nan,nan,nan,nan,nan,nan,nan,nan,nan,nan,nan,nan,nan,nan,nan,nan,nan,nan,nan,nan,nan,nan,nan,nan,nan,nan,nan,nan,nan,nan,nan,nan,nan,nan,nan,nan,nan,nan,nan,nan,nan,nan,nan,nan,nan,nan,nan,nan,nan,nan,nan,nan,nan,nan,nan,nan,nan,nan,nan,nan,nan,nan,nan,nan,nan,nan,nan,nan,nan,nan,nan,nan,nan,nan,nan,nan,nan,nan,nan,nan,nan,nan,nan,nan,nan,nan,nan
19/6/2011,Arturo Vidal,75000273,1652,5/22/1987,24,35,3,6,2,6000,7350,7850,171,157,3647694,180,74,DM/M C,3,3,2,2,1,2,2,10,3,2,1,12,14,13,9,16,9,15,12,11,17,16,19,17,16,19,15,17,18,7,14,9,17,17,13,9,10,5,19,13,17,16,12,14,18,13,20,18,11,13,17,15,4,18,9,19,5,18,10,3,6,14,13,13,20,14,13,13,20,DM/M C,421,1,7,1,14,1,1,10,13,13,19,20,12,12,13,13,176098000000.0,0,0,0,0,0,0,0,0,0,0,0,0,0,0,0,0,0,0,0,1,0,0,1,0,0,0,0,0,0,0,0,0,1,0,0,1,0,1,0,0,0,0,0,0,0,0,0,0,Arturo Vidal,ÃÂ£21.60m ,33.0,180.0,Midfielder - Central Midfield,right,Inter Milan,44.0,13.0,10.0,3505.0,35.0,7.0,4.0,2845.0,45.0,15.0,12.0,3753.0,46.0,18.0,5.0,3601.0,45.0,8.0,4.0,3625.0,48.0,7.0,12.0,3234.0,41.0,9.0,4.0,2946.0,35.0,6.0,2.0,2309.0,53.0,3.0,7.0,2744.0,Serie A,43.0,8.0,3.0,2245.0,6.0,0.0,0.0,393.0,29/6/2010,Arturo Vidal,75000273.0,1652.0,5/22/1987,23.0,27.0,1.0,0.0,0.0,5500.0,7350.0,7700.0,174.0,152.0,10532183.0,180.0,74.0,DM/M C,3.0,3.0,1.0,1.0,1.0,2.0,2.0,8.0,1.0,3.0,3.0,8.0,13.0,14.0,7.0,15.0,11.0,12.0,13.0,8.0,14.0,15.0,18.0,16.0,16.0,19.0,15.0,18.0,12.0,14.0,14.0,12.0,18.0,14.0,12.0,8.0,14.0,14.0,18.0,13.0,16.0,12.0,11.0,10.0,15.0,14.0,20.0,14.0,12.0,18.0,17.0,15.0,4.0,18.0,13.0,18.0,11.0,17.0,15.0,4.0,5.0,12.0,Arturo Vidal,ÃÂÃÂ£18.00m ,Bundesliga,19-06-17,18.3.4.28,Arturo Vidal,75000273,1652,22-May-87,30,95,23,14,8,7850,8350,8350,176,167,232186002,180,75,DM/M C,1,3,3,3,3,3,4,1,2,2,2,10,12,12,13,14,9,15,13,10,15,14,18,18,15,20,14,18,16,16,13,13,20,13,16,18,12,14,20,12,14,16,12,14,18,11,20,18,13,17,14,18,7,18,12,19,12,18,9,7,10,16,14,10,20,14,12,12,20,DM/M C,311,1,1,10,14,12,12,14,10,10,20,20,12,12,10,10,2199020000000.0,0,0,0,0,0,0,0,0,0,0,1,0,0,0,0,0,0,0,0,0,0,0,0,0,0,0,0,0,0,0,0,0,0,0,0,0,0,0,0,0,0,1,0,0,0,0,0,0,Arturo Vidal,ÃÂ£31.50m ,33.0,180.0,Midfielder - Central Midfield,right,Inter Milan,41.0,9.0,4.0,2946.0,35.0,6.0,2.0,2309.0,53.0,3.0,7.0,2744.0,43.0,8.0,3.0,2245.0,6.0,0.0,0.0,393.0,Bundesliga,15-07-16,17.3.2.23,Arturo Vidal,75000273.0,1652.0,22-May-87,29.0,80.0,17.0,14.0,8.0,7850.0,8350.0,8350.0,176.0,167.0,118837773.0,180.0,75.0,DM/M C,2.0,3.0,1.0,2.0,2.0,2.0,1.0,2.0,3.0,1.0,1.0,10.0,12.0,12.0,13.0,14.0,9.0,15.0,13.0,10.0,15.0,14.0,18.0,18.0,15.0,20.0,14.0,18.0,16.0,16.0,13.0,13.0,20.0,13.0,16.0,18.0,12.0,14.0,20.0,12.0,14.0,16.0,12.0,14.0,18.0,11.0,20.0,18.0,13.0,17.0,14.0,18.0,7.0,18.0,12.0,19.0,12.0,18.0,9.0,8.0,10.0,16.0,Arturo Vidal,ÃÂ£31.50m ,Bundesliga
19/6/2011,Antonio Candreva,1400480,776,2/28/1987,24,2,0,14,0,5250,6650,6650,155,137,311029,180,72,M/AM C,1,3,2,3,2,2,3,1,3,1,3,13,13,14,13,15,14,11,14,4,7,16,13,8,16,12,14,13,15,13,14,13,14,15,11,13,11,11,12,13,14,13,9,12,14,12,20,12,12,13,5,15,7,15,13,16,11,14,18,15,16,3,1,1,19,20,13,14,20,M/AM C,521,1,1,1,20,14,13,1,1,1,11,19,12,10,1,1,549756000000.0,0,0,0,0,0,0,0,0,0,0,0,0,0,0,0,0,0,0,0,0,0,0,0,0,0,0,0,0,0,0,0,0,0,0,0,0,0,0,0,1,0,0,0,0,0,0,0,0,Antonio Candreva,ÃÂ£4.95m ,33.0,180.0,Midfielder - Right Midfield,right,UC Sampdoria,33.0,3.0,1.0,2409.0,38.0,9.0,6.0,2724.0,49.0,7.0,13.0,3697.0,44.0,12.0,10.0,3471.0,38.0,11.0,15.0,2968.0,44.0,12.0,4.0,3141.0,45.0,8.0,11.0,3514.0,37.0,0.0,8.0,2693.0,29.0,3.0,3.0,1048.0,Serie A,40.0,7.0,9.0,2537.0,3.0,0.0,1.0,207.0,29/6/2010,Antonio Candreva,1400480.0,776.0,2/28/1987,23.0,2.0,0.0,14.0,0.0,1000.0,6500.0,6500.0,158.0,140.0,4787896.0,180.0,72.0,M/AM C,1.0,3.0,1.0,2.0,2.0,2.0,2.0,3.0,1.0,2.0,1.0,13.0,13.0,14.0,13.0,15.0,14.0,11.0,14.0,4.0,7.0,17.0,13.0,8.0,16.0,12.0,14.0,13.0,15.0,13.0,14.0,13.0,14.0,15.0,11.0,13.0,11.0,12.0,12.0,13.0,14.0,13.0,9.0,12.0,14.0,12.0,20.0,12.0,12.0,13.0,5.0,15.0,7.0,15.0,13.0,16.0,11.0,14.0,18.0,15.0,16.0,3.0,Antonio Candreva,ÃÂÃÂ£5.40m ,Serie A,19-06-17,18.3.4.28,Antonio Candreva,1400480,776,28-Feb-87,30,47,6,13,0,6150,7750,7550,158,151,232186002,180,72,M/AM RC,3,1,2,3,1,1,1,3,4,1,2,16,16,14,13,16,14,6,16,6,6,15,14,6,16,10,13,13,14,12,13,13,16,16,14,16,8,11,12,15,14,11,10,13,15,15,20,13,11,12,8,16,8,17,13,15,13,14,17,11,13,9,1,11,19,20,20,13,15,M/AM RC,523,1,1,5,15,13,20,1,1,1,1,10,12,19,1,11,2.88e+17,0,0,0,0,0,0,0,0,1,1,0,0,0,0,0,0,0,0,0,0,0,0,0,0,0,0,0,0,0,0,0,0,0,0,0,0,0,0,0,0,0,0,0,0,1,0,0,0,Antonio Candreva,ÃÂ£12.60m ,33.0,180.0,Midfielder - Right Midfield,right,UC Sampdoria,45.0,8.0,11.0,3514.0,37.0,0.0,8.0,2693.0,29.0,3.0,3.0,1048.0,40.0,7.0,9.0,2537.0,3.0,0.0,1.0,207.0,Serie A,15-07-16,17.3.2.23,Antonio Candreva,1400480.0,776.0,28-Feb-87,29.0,44.0,6.0,13.0,0.0,6250.0,7700.0,7700.0,160.0,154.0,57457695.0,181.0,72.0,M/AM RLC,1.0,1.0,2.0,1.0,1.0,1.0,2.0,3.0,3.0,3.0,2.0,16.0,15.0,14.0,13.0,16.0,15.0,6.0,15.0,6.0,7.0,15.0,16.0,6.0,16.0,10.0,14.0,14.0,14.0,12.0,14.0,14.0,17.0,16.0,15.0,16.0,8.0,11.0,12.0,14.0,15.0,12.0,10.0,12.0,15.0,15.0,20.0,15.0,12.0,13.0,7.0,16.0,8.0,17.0,13.0,15.0,14.0,15.0,17.0,9.0,13.0,9.0,Antonio Candreva,ÃÂ£18.00m ,Serie A
19/6/2011,Anton Putsila,7485429,758,6/10/1987,24,21,4,11,1,5271,7260,6500,147,132,786366,180,74,M/AM LC,3,3,1,1,2,3,3,1,2,3,3,14,12,16,12,14,14,8,10,10,7,14,13,11,16,15,10,14,11,10,14,8,14,14,11,12,10,13,13,14,15,12,12,20,15,14,10,14,11,8,7,14,4,15,8,11,11,14,16,11,14,11,1,1,20,20,14,16,20,M/AM LC,414,1,1,13,20,16,14,1,1,1,10,20,16,13,1,1,26388300000000.0,0,0,1,0,0,0,0,0,0,0,0,0,0,0,0,0,0,0,0,0,1,0,0,0,0,0,0,0,0,0,0,0,0,0,0,0,0,0,0,0,0,0,0,1,1,0,0,0,Anton Putsila,ÃÂ£2.03m ,33.0,180.0,Midfielder - Attacking Midfield,right,Altay SK,31.0,2.0,5.0,2260.0,19.0,0.0,1.0,1297.0,13.0,0.0,0.0,962.0,26.0,2.0,2.0,2052.0,20.0,4.0,1.0,1599.0,21.0,2.0,2.0,1333.0,19.0,1.0,0.0,1047.0,25.0,4.0,6.0,1933.0,22.0,0.0,5.0,1507.0,Bundesliga,32.0,5.0,4.0,2695.0,2.0,0.0,0.0,180.0,29/6/2010,Anton Putsila,7485429.0,758.0,6/10/1987,23.0,12.0,3.0,8.0,1.0,4750.0,7590.0,5750.0,159.0,138.0,7008968.0,180.0,74.0,M/AM LC,1.0,3.0,2.0,2.0,1.0,3.0,1.0,4.0,1.0,2.0,3.0,14.0,13.0,16.0,12.0,14.0,14.0,8.0,12.0,10.0,7.0,14.0,13.0,11.0,16.0,15.0,10.0,14.0,12.0,10.0,14.0,8.0,14.0,14.0,11.0,12.0,10.0,14.0,15.0,14.0,15.0,13.0,12.0,20.0,15.0,14.0,10.0,15.0,12.0,8.0,7.0,14.0,4.0,15.0,8.0,11.0,11.0,14.0,16.0,11.0,14.0,11.0,Anton Putsila,ÃÂÃÂ£1.80m ,Bundesliga
19/6/2011,Andrew Surman,5109929,765,8/20/1986,24,0,0,4,1,3400,5764,5854,140,124,580604,178,73,D/M LC,3,2,1,2,1,3,3,1,1,3,1,10,12,11,11,13,13,10,13,4,10,14,12,11,13,9,12,8,12,10,13,11,11,12,14,11,13,13,14,12,11,13,10,20,14,12,13,12,10,11,5,13,6,11,14,14,13,12,13,14,12,7,17,14,20,10,14,20,15,D/M LC,424,1,1,1,1,10,1,1,17,1,1,15,20,14,14,1,549756000000.0,0,0,0,0,0,0,0,0,0,0,1,0,0,0,0,0,0,0,0,0,0,0,0,0,0,0,0,0,0,0,0,0,0,0,0,0,0,0,0,1,0,0,0,0,0,0,0,0,Andrew Surman,ÃÂ£2.25m ,34.0,178.0,Midfielder - Central Midfield,left,Without Club,22.0,3.0,4.0,1513.0,31.0,5.0,4.0,2455.0,7.0,0.0,1.0,516.0,39.0,0.0,3.0,2829.0,43.0,3.0,4.0,3750.0,38.0,0.0,3.0,3420.0,23.0,0.0,2.0,1892.0,28.0,2.0,5.0,2119.0,20.0,0.0,1.0,1618.0,Premier League,9.0,0.0,0.0,593.0,nan,nan,nan,nan,nan,nan,nan,nan,nan,nan,nan,nan,nan,nan,nan,nan,nan,nan,nan,nan,nan,nan,nan,nan,nan,nan,nan,nan,nan,nan,nan,nan,nan,nan,nan,nan,nan,nan,nan,nan,nan,nan,nan,nan,nan,nan,nan,nan,nan,nan,nan,nan,nan,nan,nan,nan,nan,nan,nan,nan,nan,nan,nan,nan,nan,nan,nan,nan,nan,nan,nan,nan,nan,nan,nan,nan,nan,nan,nan,nan,nan,nan,nan,nan,nan,nan,nan,nan,19-06-17,18.3.4.28,Andrew Surman,5109929,765,20-Aug-86,30,0,0,4,1,5000,6800,6800,136,136,232186002,178,73,DM/M C,2,2,2,2,2,1,3,2,3,1,3,8,10,12,10,14,13,11,12,4,12,17,11,12,12,10,14,12,13,13,13,14,11,12,15,12,13,13,14,11,12,14,9,20,14,11,10,16,14,15,5,13,6,11,14,14,13,13,13,14,12,7,1,1,20,1,1,1,20,DM/M C,311,1,1,1,1,1,1,1,1,1,20,20,1,1,1,1,549756000000.0,0,0,0,0,0,0,0,0,0,0,1,0,0,0,0,0,0,0,0,0,0,0,0,0,0,0,0,0,0,0,0,0,0,0,0,0,0,0,0,1,0,0,0,0,0,0,0,0,Andrew Surman,ÃÂ£2.25m ,34.0,178.0,Midfielder - Central Midfield,left,Without Club,23.0,0.0,2.0,1892.0,28.0,2.0,5.0,2119.0,20.0,0.0,1.0,1618.0,9.0,0.0,0.0,593.0,nan,nan,nan,nan,Premier League,15-07-16,17.3.2.23,Andrew Surman,5109929.0,765.0,20-Aug-86,29.0,0.0,0.0,4.0,1.0,5000.0,6800.0,6800.0,136.0,136.0,12614583.0,178.0,73.0,DM/M C,2.0,2.0,3.0,3.0,3.0,1.0,1.0,3.0,2.0,3.0,4.0,8.0,10.0,12.0,10.0,14.0,13.0,11.0,12.0,4.0,12.0,17.0,11.0,12.0,12.0,10.0,14.0,12.0,13.0,13.0,13.0,14.0,11.0,12.0,15.0,12.0,13.0,13.0,14.0,11.0,12.0,14.0,9.0,20.0,14.0,11.0,10.0,16.0,14.0,15.0,5.0,13.0,6.0,11.0,14.0,14.0,13.0,13.0,13.0,14.0,12.0,7.0,Andrew Surman,ÃÂ£1.80m ,Premier League
19/6/2011,Almen Abdi,5725575,798,10/21/1986,24,6,0,5,0,4800,6400,6700,142,137,820614,182,75,M/AM C,2,3,3,2,1,3,3,5,2,1,2,12,12,12,11,14,14,8,16,4,8,14,13,12,14,13,14,12,14,11,15,11,11,14,7,12,10,14,15,12,12,12,10,11,12,13,20,12,11,14,8,13,9,15,9,14,10,10,10,14,13,9,1,1,19,20,1,1,20,M/AM C,521,1,1,1,20,1,1,1,1,1,14,19,1,1,1,1,0.0,0,0,0,0,0,0,0,0,0,0,0,0,0,0,0,0,0,0,0,0,0,0,0,0,0,0,0,0,0,0,0,0,0,0,0,0,0,0,0,0,0,0,0,0,0,0,0,0,Almen Abdi,ÃÂ£1.35m ,34.0,181.0,Midfielder - Central Midfield,right,Without Club,21.0,0.0,1.0,869.0,33.0,1.0,1.0,1531.0,44.0,12.0,9.0,3657.0,16.0,2.0,3.0,982.0,33.0,9.0,2.0,2268.0,38.0,2.0,0.0,2335.0,16.0,1.0,0.0,742.0,7.0,0.0,0.0,325.0,nan,nan,nan,nan,Serie A,nan,nan,nan,nan,nan,nan,nan,nan,29/6/2010,Almen Abdi,5725575.0,798.0,10/21/1986,23.0,6.0,0.0,3.0,0.0,3969.0,6400.0,6050.0,147.0,126.0,6623896.0,182.0,72.0,M/AM C,3.0,1.0,2.0,2.0,1.0,3.0,3.0,4.0,1.0,2.0,2.0,12.0,12.0,12.0,10.0,14.0,15.0,9.0,17.0,5.0,7.0,14.0,13.0,12.0,14.0,11.0,13.0,12.0,14.0,10.0,15.0,11.0,11.0,14.0,7.0,11.0,10.0,14.0,14.0,12.0,12.0,13.0,11.0,10.0,12.0,13.0,20.0,11.0,11.0,14.0,7.0,12.0,9.0,15.0,9.0,14.0,9.0,10.0,8.0,12.0,10.0,11.0,Almen Abdi,ÃÂÃÂ£1.80m ,Serie A
19/6/2011,Alejandro Faurlin,956670,1649,8/9/1986,24,0,0,10,2,3250,5250,6550,152,138,841690,185,79,DM/M C,2,2,1,1,2,1,1,2,2,2,2,14,13,15,10,16,12,9,13,5,11,18,15,12,15,9,13,12,15,12,13,16,14,15,10,11,12,14,13,14,12,13,12,20,16,12,6,12,14,12,7,14,4,9,12,11,13,12,13,13,15,6,1,1,20,14,1,1,20,DM/M C,421,1,1,1,14,1,1,1,1,1,17,20,1,1,1,1,17196646400.0,0,0,0,0,0,0,0,0,0,0,0,0,0,0,0,0,0,0,0,0,0,0,0,0,1,0,0,0,0,0,0,0,0,0,1,0,0,0,0,0,0,0,0,0,0,0,0,0,Alejandro FaurlÃÂ­n,ÃÂ£4.05m ,34.0,185.0,Midfielder - Central Midfield,left,Without Club,41.0,3.0,3.0,3553.0,21.0,1.0,2.0,1890.0,21.0,0.0,3.0,1442.0,9.0,0.0,1.0,582.0,3.0,0.0,0.0,150.0,30.0,0.0,6.0,2469.0,31.0,5.0,1.0,2300.0,17.0,0.0,0.0,851.0,20.0,0.0,0.0,1480.0,Premier League,13.0,0.0,1.0,882.0,nan,nan,nan,nan,nan,nan,nan,nan,nan,nan,nan,nan,nan,nan,nan,nan,nan,nan,nan,nan,nan,nan,nan,nan,nan,nan,nan,nan,nan,nan,nan,nan,nan,nan,nan,nan,nan,nan,nan,nan,nan,nan,nan,nan,nan,nan,nan,nan,nan,nan,nan,nan,nan,nan,nan,nan,nan,nan,nan,nan,nan,nan,nan,nan,nan,nan,nan,nan,nan,nan,nan,nan,nan,nan,nan,nan,nan,nan,nan,nan,nan,nan,nan,nan,nan,nan,nan,nan
19/6/2011,Alberto Lora,67011231,796,3/25/1987,24,0,0,0,0,4500,6534,6534,151,141,707375,165,66,D/M RC,3,2,1,2,3,3,2,5,2,3,2,9,13,12,9,13,4,13,13,13,13,15,11,13,14,12,13,14,11,14,9,13,12,11,10,13,13,16,16,13,14,14,8,7,15,14,20,16,14,18,10,12,10,12,14,10,14,13,18,17,8,15,20,15,19,15,20,5,19,D/M RC,113,1,1,5,13,5,15,1,5,20,5,19,5,15,5,15,0.0,0,0,0,0,0,0,0,0,0,0,0,0,0,0,0,0,0,0,0,0,0,0,0,0,0,0,0,0,0,0,0,0,0,0,0,0,0,0,0,0,0,0,0,0,0,0,0,0,Alberto Lora,ÃÂ£2.52m ,33.0,164.0,Midfielder - Central Midfield,right,Marino Luanco,37.0,0.0,5.0,3261.0,28.0,3.0,1.0,2331.0,32.0,0.0,4.0,2381.0,37.0,0.0,4.0,2866.0,41.0,1.0,0.0,3637.0,32.0,0.0,4.0,2501.0,7.0,0.0,0.0,376.0,10.0,1.0,0.0,683.0,16.0,0.0,0.0,1129.0,LaLiga,27.0,0.0,0.0,2400.0,2.0,0.0,0.0,66.0,29/6/2010,Alberto Lora,67011231.0,796.0,3/25/1987,23.0,0.0,0.0,0.0,0.0,1250.0,2000.0,2000.0,147.0,135.0,2040026.0,165.0,66.0,D/M RC,3.0,1.0,3.0,3.0,1.0,3.0,1.0,3.0,1.0,2.0,1.0,10.0,13.0,14.0,14.0,14.0,5.0,17.0,14.0,14.0,14.0,16.0,12.0,14.0,13.0,12.0,14.0,13.0,11.0,15.0,14.0,15.0,11.0,11.0,10.0,14.0,13.0,17.0,17.0,14.0,15.0,13.0,5.0,1.0,14.0,14.0,20.0,16.0,16.0,16.0,10.0,12.0,10.0,12.0,7.0,10.0,9.0,8.0,8.0,18.0,16.0,14.0,Alberto Lora,ÃÂÃÂ£3.15m ,LaLiga
19/6/2011,Yohan Cabaye,919628,769,1/14/1986,25,4,0,16,3,6650,7400,6913,160,148,4796050,175,72,DM/M C,1,3,2,1,2,1,2,4,1,3,1,14,14,13,10,14,15,9,16,7,8,17,15,12,14,12,15,14,14,14,14,14,16,9,14,10,13,16,15,14,14,13,8,10,15,12,20,16,12,15,12,14,8,8,14,17,13,15,11,12,12,10,1,1,20,12,1,1,20,DM/M C,311,1,1,1,12,1,1,1,1,1,20,20,1,1,1,1,8813270000000.0,0,0,0,0,0,0,0,0,1,0,0,0,0,0,0,0,0,0,0,0,0,0,0,0,0,0,0,0,0,0,0,0,0,0,1,0,0,0,0,0,0,0,0,1,0,0,0,0,Yohan Cabaye,ÃÂ£14.85m ,34.0,173.0,Midfielder - Central Midfield,right,Without Club,50.0,5.0,11.0,3975.0,38.0,5.0,9.0,3254.0,35.0,6.0,2.0,2689.0,41.0,8.0,6.0,2577.0,36.0,2.0,1.0,1634.0,40.0,6.0,2.0,3178.0,35.0,4.0,3.0,2339.0,34.0,0.0,1.0,2577.0,12.0,1.0,2.0,1070.0,Premier League,21.0,1.0,1.0,1173.0,nan,nan,nan,nan,29/6/2010,Yohan Cabaye,919628.0,769.0,1/14/1986,24.0,0.0,0.0,15.0,3.0,5150.0,6479.0,6450.0,160.0,144.0,4709342.0,175.0,72.0,DM/M C,2.0,2.0,2.0,3.0,2.0,3.0,1.0,6.0,2.0,1.0,3.0,14.0,14.0,12.0,10.0,13.0,15.0,9.0,16.0,7.0,7.0,15.0,17.0,13.0,14.0,14.0,15.0,14.0,13.0,13.0,14.0,13.0,16.0,9.0,14.0,10.0,14.0,15.0,15.0,14.0,14.0,13.0,7.0,10.0,15.0,12.0,20.0,16.0,13.0,14.0,11.0,14.0,6.0,8.0,9.0,17.0,11.0,15.0,11.0,12.0,12.0,10.0,Yohan Cabaye,ÃÂÃÂ£9.90m ,Ligue 1,19-06-17,18.3.4.28,Yohan Cabaye,919628,769,14-Jan-86,31,48,4,16,3,6150,6900,7000,160,138,232186002,173,72,M C,3,1,1,1,1,3,2,2,3,2,1,14,12,11,11,13,14,5,12,2,2,14,13,11,17,12,15,13,13,13,14,13,16,12,13,13,14,18,18,11,15,15,6,11,17,12,20,17,12,8,16,14,8,12,13,15,12,15,15,11,7,6,1,1,20,15,1,1,20,M C,401,1,1,1,15,1,1,1,1,1,15,20,1,1,1,1,43997600000000.0,0,0,0,0,0,0,0,1,0,0,0,0,0,0,0,0,0,0,0,0,0,0,0,0,0,0,0,0,0,0,0,0,0,0,1,0,0,0,0,0,0,0,0,1,0,1,0,0,Yohan Cabaye,ÃÂ£9.00m ,34.0,173.0,Midfielder - Central Midfield,right,Without Club,35.0,4.0,3.0,2339.0,34.0,0.0,1.0,2577.0,12.0,1.0,2.0,1070.0,21.0,1.0,1.0,1173.0,nan,nan,nan,nan,Premier League,15-07-16,17.3.2.23,Yohan Cabaye,919628.0,769.0,14-Jan-86,30.0,48.0,4.0,16.0,3.0,6300.0,7300.0,7400.0,160.0,148.0,232186002.0,173.0,72.0,M C,2.0,1.0,4.0,3.0,3.0,2.0,3.0,2.0,4.0,3.0,3.0,14.0,12.0,14.0,13.0,15.0,15.0,5.0,14.0,2.0,2.0,16.0,14.0,11.0,17.0,12.0,15.0,13.0,13.0,16.0,14.0,13.0,16.0,12.0,13.0,16.0,14.0,18.0,18.0,11.0,15.0,15.0,6.0,11.0,17.0,12.0,20.0,17.0,12.0,8.0,17.0,14.0,8.0,12.0,13.0,15.0,12.0,15.0,15.0,11.0,7.0,6.0,Yohan Cabaye,ÃÂ£13.50m ,Premier League
19/6/2011,VinÃÂ­cius,316102,1651,5/16/1986,25,0,0,0,0,2058,4904,5450,122,109,62373,186,68,M C,1,2,1,2,3,1,3,1,1,3,3,10,10,10,9,9,9,12,12,10,10,10,12,10,11,14,12,13,12,13,10,11,14,7,11,14,12,15,17,11,13,14,13,8,16,11,20,15,14,13,8,12,7,14,14,11,14,10,13,13,13,8,1,1,20,5,10,7,20,M C,401,1,1,1,5,1,1,1,1,1,13,20,7,10,1,1,0.0,0,0,0,0,0,0,0,0,0,0,0,0,0,0,0,0,0,0,0,0,0,0,0,0,0,0,0,0,0,0,0,0,0,0,0,0,0,0,0,0,0,0,0,0,0,0,0,0,Vinicius,ÃÂ£720Th. ,34.0,186.0,Midfielder - Central Midfield,both,Nea Salamina Famagusta,18.0,0.0,0.0,1357.0,9.0,0.0,1.0,269.0,33.0,3.0,0.0,2781.0,40.0,5.0,0.0,3174.0,26.0,2.0,0.0,2054.0,38.0,5.0,0.0,3095.0,41.0,7.0,3.0,3355.0,19.0,0.0,0.0,1423.0,14.0,0.0,2.0,1098.0,Liga NOS,19.0,0.0,0.0,1431.0,3.0,0.0,0.0,270.0,29/6/2010,VinÃÂ­cius,316102.0,1651.0,5/16/1986,24.0,0.0,0.0,0.0,0.0,1000.0,3000.0,4000.0,114.0,103.0,222499.0,186.0,68.0,M C,1.0,1.0,2.0,2.0,3.0,3.0,3.0,3.0,1.0,2.0,3.0,10.0,10.0,10.0,9.0,9.0,9.0,12.0,12.0,10.0,10.0,10.0,12.0,10.0,11.0,12.0,12.0,12.0,11.0,11.0,10.0,11.0,14.0,7.0,11.0,14.0,11.0,14.0,16.0,11.0,13.0,11.0,12.0,8.0,13.0,11.0,20.0,13.0,11.0,12.0,8.0,12.0,11.0,14.0,14.0,11.0,14.0,6.0,13.0,13.0,13.0,8.0,Vinicius,ÃÂÃÂ£450Th. ,Liga NOS
19/6/2011,Vincent Kompany,8152558,757,4/10/1986,25,39,1,0,0,7000,8250,8250,175,164,18181818,191,91,D/DM C,1,2,1,1,1,3,1,6,3,3,3,5,5,9,7,14,12,18,10,12,16,12,10,17,13,14,15,18,16,15,12,14,17,11,16,9,17,14,15,15,15,16,16,10,12,13,20,15,16,17,8,15,10,14,15,18,16,18,16,17,16,15,20,1,15,1,12,1,20,D/DM C,111,1,1,1,1,1,1,20,1,12,17,15,1,1,1,1,0.0,0,0,0,0,0,0,0,0,0,0,0,0,0,0,0,0,0,0,0,0,0,0,0,0,0,0,0,0,0,0,0,0,0,0,0,0,0,0,0,0,0,0,0,0,0,0,0,0,Vincent Kompany,ÃÂ£31.50m ,34.0,190.0,Defender - Centre-Back,right,Retired,50.0,0.0,2.0,4279.0,42.0,3.0,2.0,3608.0,37.0,1.0,0.0,3179.0,37.0,5.0,1.0,3129.0,33.0,0.0,0.0,2753.0,22.0,2.0,0.0,1661.0,15.0,3.0,0.0,1167.0,21.0,2.0,1.0,1756.0,26.0,1.0,1.0,1782.0,Premier League,18.0,1.0,1.0,1484.0,nan,nan,nan,nan,29/6/2010,Vincent Kompany,8152558.0,757.0,4/10/1986,24.0,31.0,1.0,0.0,0.0,5476.0,7750.0,7400.0,156.0,148.0,14692290.0,191.0,91.0,D/DM C,3.0,2.0,1.0,2.0,2.0,1.0,3.0,1.0,2.0,1.0,2.0,5.0,5.0,9.0,7.0,14.0,12.0,15.0,10.0,12.0,14.0,12.0,10.0,16.0,12.0,14.0,15.0,14.0,14.0,12.0,12.0,12.0,15.0,11.0,14.0,9.0,15.0,14.0,14.0,15.0,15.0,16.0,16.0,10.0,6.0,13.0,20.0,15.0,16.0,11.0,8.0,15.0,17.0,14.0,14.0,13.0,11.0,18.0,8.0,17.0,14.0,12.0,Vincent Kompany,ÃÂÃÂ£18.00m ,Premier League,19-06-17,18.3.4.28,Vincent Kompany,8152558,757,10-Apr-86,31,74,4,0,0,8000,8500,8500,168,159,232186002,193,85,D/DM C,3,2,3,1,2,1,3,3,2,2,1,5,5,10,7,14,6,16,7,10,16,13,8,16,14,14,16,17,15,15,11,14,17,11,18,7,16,17,15,13,12,15,16,9,10,13,20,13,16,17,8,16,18,14,13,19,16,18,18,17,16,15,20,1,12,1,12,1,20,D/DM C,111,1,1,1,1,1,1,20,1,12,17,12,1,1,1,1,4294967296.0,0,0,0,0,0,0,0,0,0,0,0,0,0,0,0,0,0,0,0,0,0,0,0,0,0,0,0,0,0,0,0,0,1,0,0,0,0,0,0,0,0,0,0,0,0,0,0,0,Vincent Kompany,ÃÂ£9.00m ,34.0,190.0,Defender - Centre-Back,right,Retired,15.0,3.0,0.0,1167.0,21.0,2.0,1.0,1756.0,26.0,1.0,1.0,1782.0,18.0,1.0,1.0,1484.0,nan,nan,nan,nan,Premier League,15-07-16,17.3.2.23,Vincent Kompany,8152558.0,757.0,10-Apr-86,30.0,71.0,4.0,0.0,0.0,8000.0,8500.0,8500.0,168.0,164.0,232186002.0,193.0,91.0,D/DM C,3.0,1.0,3.0,1.0,2.0,3.0,3.0,2.0,1.0,1.0,3.0,5.0,5.0,10.0,7.0,14.0,7.0,16.0,7.0,10.0,16.0,12.0,9.0,18.0,14.0,14.0,16.0,17.0,15.0,15.0,12.0,14.0,17.0,11.0,18.0,9.0,16.0,17.0,16.0,14.0,12.0,15.0,16.0,9.0,10.0,13.0,20.0,14.0,16.0,15.0,8.0,15.0,17.0,14.0,13.0,19.0,16.0,18.0,18.0,17.0,16.0,15.0,Vincent Kompany,ÃÂ£19.80m ,Premier League
19/6/2011,Vedran Corluka,126527,761,3/31/1986,25,36,1,0,0,6250,7810,7200,155,142,9071504,192,89,D RC,2,2,3,2,1,1,1,2,1,2,3,3,11,12,9,13,5,15,5,15,13,11,6,15,15,14,17,13,18,12,10,12,17,5,12,10,12,15,14,12,13,16,15,13,14,11,20,14,16,15,4,16,11,12,13,14,15,13,16,17,15,8,20,14,15,1,20,10,16,D RC,103,1,12,1,1,1,1,16,10,20,12,15,1,1,1,14,143881000000.0,0,0,0,1,0,1,0,0,0,0,0,0,0,0,0,0,0,0,0,0,0,0,0,0,0,0,0,0,0,0,0,1,1,0,0,0,0,1,0,0,0,0,0,0,0,0,0,0,Vedran Corluka,ÃÂ£6.75m ,34.0,192.0,Defender - Centre-Back,right,Lokomotiv Moscow,24.0,0.0,1.0,1933.0,16.0,0.0,2.0,1302.0,28.0,1.0,2.0,2493.0,28.0,1.0,1.0,2520.0,32.0,2.0,1.0,2921.0,29.0,3.0,0.0,2540.0,21.0,0.0,2.0,1688.0,8.0,0.0,0.0,662.0,30.0,1.0,1.0,2619.0,Premier League,34.0,0.0,0.0,2965.0,13.0,1.0,1.0,1071.0,29/6/2010,Vedran Corluka,126527.0,761.0,3/31/1986,24.0,36.0,1.0,0.0,0.0,5184.0,7920.0,7400.0,164.0,144.0,43486185.0,192.0,89.0,D RC,1.0,1.0,2.0,3.0,2.0,1.0,2.0,5.0,2.0,1.0,2.0,3.0,11.0,11.0,9.0,13.0,5.0,15.0,5.0,15.0,13.0,11.0,6.0,15.0,15.0,14.0,15.0,13.0,17.0,12.0,10.0,12.0,17.0,5.0,12.0,8.0,12.0,15.0,14.0,14.0,13.0,16.0,15.0,13.0,14.0,12.0,20.0,14.0,16.0,15.0,4.0,16.0,11.0,12.0,13.0,14.0,15.0,13.0,16.0,17.0,15.0,8.0,Vedran Corluka,ÃÂÃÂ£10.80m ,Premier League
19/6/2011,Tobias Weis,8707889,771,7/30/1985,25,1,0,0,0,4750,6700,6700,143,136,498886,170,68,M/AM RLC,1,3,2,2,2,1,1,5,2,1,2,11,12,13,5,12,8,6,6,8,18,13,10,12,14,19,11,20,7,10,12,9,18,13,10,14,8,14,18,17,18,15,5,15,12,13,20,16,8,9,15,10,13,17,13,13,10,10,11,12,8,5,1,1,20,18,20,18,19,M/AM RLC,416,1,1,12,14,14,18,1,1,1,14,19,18,20,1,1,16875650.0,0,1,0,0,0,0,0,1,0,0,0,0,0,0,0,1,1,0,0,0,0,0,0,0,1,0,0,0,0,0,0,0,0,0,0,0,0,0,0,0,0,0,0,0,0,0,0,0,Tobias Weis,ÃÂ£1.35m ,35.0,170.0,Midfielder - Central Midfield,both,Retired,20.0,0.0,0.0,1298.0,16.0,0.0,1.0,1206.0,22.0,2.0,4.0,1649.0,5.0,0.0,0.0,100.0,13.0,2.0,0.0,860.0,6.0,0.0,0.0,156.0,nan,nan,nan,nan,0.0,0.0,0.0,0.0,nan,nan,nan,nan,Bundesliga,nan,nan,nan,nan,nan,nan,nan,nan,29/6/2010,Tobias Weis,8707889.0,771.0,7/30/1985,24.0,1.0,0.0,0.0,0.0,3450.0,7100.0,7100.0,148.0,141.0,6472391.0,170.0,68.0,M/AM RLC,2.0,3.0,2.0,3.0,2.0,2.0,3.0,6.0,3.0,1.0,1.0,10.0,11.0,12.0,4.0,11.0,7.0,5.0,5.0,7.0,17.0,12.0,9.0,11.0,13.0,19.0,11.0,20.0,6.0,8.0,12.0,9.0,18.0,13.0,10.0,13.0,7.0,14.0,17.0,16.0,17.0,14.0,4.0,15.0,12.0,13.0,20.0,16.0,7.0,10.0,15.0,10.0,13.0,17.0,14.0,13.0,7.0,10.0,11.0,12.0,8.0,13.0,Tobias Weis,ÃÂÃÂ£2.25m ,Bundesliga
19/6/2011,Tiberio Guarente,7990140,776,11/1/1985,25,0,0,3,0,4900,6800,6500,152,136,4743083,182,74,DM/M C,1,2,1,1,2,1,1,4,2,3,1,12,14,10,8,14,13,6,13,10,12,14,11,13,14,15,15,14,10,11,14,14,16,13,14,12,12,15,13,13,12,14,10,20,6,14,12,13,13,12,13,15,18,9,13,15,14,13,14,13,10,16,1,1,20,8,1,1,20,DM/M C,421,1,1,1,8,1,1,1,1,1,19,20,1,1,1,1,68719476864.0,0,0,0,0,0,0,0,1,0,0,0,0,0,0,0,0,0,0,0,0,0,0,0,0,0,0,0,0,0,0,0,0,0,0,0,0,1,0,0,0,0,0,0,0,0,0,0,0,Tiberio Guarente,ÃÂ£2.70m ,34.0,182.0,Midfielder - Central Midfield,left,Retired,10.0,0.0,1.0,522.0,3.0,0.0,0.0,32.0,23.0,2.0,1.0,1263.0,24.0,0.0,2.0,1415.0,1.0,0.0,0.0,7.0,nan,nan,nan,nan,nan,nan,nan,nan,nan,nan,nan,nan,nan,nan,nan,nan,LaLiga,nan,nan,nan,nan,nan,nan,nan,nan,29/6/2010,Tiberio Guarente,7990140.0,776.0,11/1/1985,24.0,0.0,0.0,3.0,0.0,4692.0,6800.0,6700.0,152.0,137.0,17627999.0,182.0,74.0,DM/M C,1.0,2.0,1.0,2.0,3.0,3.0,3.0,7.0,1.0,2.0,1.0,12.0,14.0,10.0,8.0,14.0,13.0,6.0,13.0,10.0,12.0,16.0,11.0,13.0,14.0,15.0,15.0,13.0,10.0,11.0,14.0,14.0,16.0,14.0,14.0,12.0,12.0,15.0,13.0,13.0,12.0,14.0,10.0,20.0,16.0,14.0,10.0,13.0,13.0,12.0,13.0,15.0,10.0,9.0,13.0,15.0,14.0,13.0,14.0,13.0,10.0,16.0,Tiberio Guarente,ÃÂÃÂ£4.95m ,LaLiga
19/6/2011,Stuart Holden,72000199,390,8/1/1985,25,17,2,7,1,6000,6750,6750,150,138,2201382,180,73,M C,1,1,1,1,1,9,1,1,1,1,1,15,13,11,11,13,15,9,13,4,11,14,11,12,13,13,12,15,12,11,14,11,14,12,10,13,13,14,15,12,12,14,10,16,15,12,20,16,13,10,3,13,14,13,17,14,12,12,13,12,14,9,1,1,20,11,11,11,20,M C,401,1,1,1,11,11,11,1,1,1,5,20,11,11,1,1,141734000000.0,0,0,0,0,0,0,0,0,0,0,1,0,0,0,0,0,0,0,0,1,0,0,0,0,0,0,0,0,0,0,0,0,1,0,0,0,0,1,0,0,0,0,0,0,0,0,0,0,Stuart Holden,ÃÂ£4.95m ,35.0,178.0,Midfielder - Central Midfield,both,Retired,30.0,2.0,2.0,2515.0,3.0,0.0,0.0,258.0,10.0,0.0,0.0,466.0,1.0,0.0,0.0,23.0,nan,nan,nan,nan,nan,nan,nan,nan,nan,nan,nan,nan,nan,nan,nan,nan,nan,nan,nan,nan,Premier League,nan,nan,nan,nan,nan,nan,nan,nan,29/6/2010,Stuart Holden,72000199.0,390.0,8/1/1985,24.0,15.0,2.0,7.0,1.0,4032.0,6350.0,6650.0,138.0,127.0,6291530.0,178.0,73.0,M/AM RLC,1.0,1.0,1.0,1.0,1.0,9.0,1.0,1.0,1.0,1.0,1.0,12.0,12.0,10.0,11.0,10.0,13.0,9.0,12.0,3.0,7.0,11.0,12.0,8.0,10.0,13.0,9.0,15.0,10.0,6.0,12.0,9.0,14.0,12.0,7.0,10.0,12.0,14.0,14.0,12.0,11.0,13.0,9.0,16.0,15.0,12.0,20.0,14.0,12.0,9.0,3.0,13.0,16.0,12.0,17.0,14.0,12.0,12.0,13.0,12.0,14.0,9.0,Stuart Holden,ÃÂÃÂ£3.60m ,Premier League
19/6/2011,Paulo Machado,744562,788,3/31/1986,25,0,0,9,3,4900,6243,6190,155,138,606164,174,74,M RLC,1,2,1,1,1,1,1,3,1,1,1,13,13,12,10,15,15,8,15,10,8,14,12,10,15,11,13,14,13,13,14,12,17,11,11,12,12,16,14,15,12,12,7,10,14,13,20,13,12,13,11,14,6,15,11,14,13,13,13,13,13,3,1,1,20,14,15,15,20,M RLC,406,1,1,1,14,10,10,1,1,1,10,20,15,15,1,1,4194880.0,0,0,0,0,0,0,1,0,0,1,0,0,0,0,0,0,0,0,0,0,0,0,1,0,0,0,0,0,0,0,0,0,0,0,0,0,0,0,0,0,0,0,0,0,0,0,0,0,Paulo Machado,ÃÂ£4.05m ,34.0,174.0,Midfielder - Central Midfield,right,LeixÃÂµes SC,33.0,4.0,5.0,2453.0,25.0,3.0,0.0,1491.0,42.0,3.0,6.0,3075.0,25.0,3.0,0.0,1173.0,44.0,4.0,8.0,3202.0,44.0,2.0,10.0,3294.0,33.0,1.0,3.0,1835.0,27.0,5.0,4.0,1780.0,20.0,2.0,4.0,1754.0,Ligue 1,9.0,1.0,1.0,641.0,3.0,0.0,0.0,150.0,29/6/2010,Paulo Machado,744562.0,788.0,3/31/1986,24.0,0.0,0.0,9.0,3.0,1450.0,6150.0,6150.0,155.0,137.0,6999999.0,174.0,74.0,M RLC,1.0,1.0,1.0,3.0,1.0,3.0,3.0,7.0,2.0,1.0,1.0,13.0,12.0,12.0,10.0,15.0,15.0,8.0,15.0,10.0,8.0,14.0,12.0,10.0,15.0,11.0,13.0,14.0,13.0,13.0,14.0,12.0,17.0,11.0,11.0,12.0,12.0,16.0,14.0,15.0,12.0,12.0,7.0,10.0,14.0,13.0,20.0,13.0,12.0,13.0,11.0,14.0,6.0,15.0,11.0,14.0,13.0,13.0,13.0,13.0,13.0,3.0,Paulo Machado,ÃÂÃÂ£3.83m ,Ligue 1,19-06-17,18.3.4.28,Paulo Machado,744562,788,31-Mar-86,31,4,0,24,6,4000,6000,6000,138,120,206361,174,80,M/AM C,3,3,2,1,1,1,3,1,2,1,2,14,14,14,11,14,14,8,12,8,8,14,12,8,15,8,11,13,12,11,13,10,10,12,9,12,12,11,14,13,14,12,7,10,13,12,20,11,11,10,9,13,8,6,14,14,14,9,10,13,14,12,1,1,20,17,14,14,20,M/AM C,411,1,1,1,17,14,14,1,1,1,10,20,7,10,1,1,4194560.0,0,0,0,0,0,0,0,0,1,0,0,0,0,0,0,0,0,0,0,0,0,0,1,0,0,0,0,0,0,0,0,0,0,0,0,0,0,0,0,0,0,0,0,0,0,0,0,0,Paulo Machado,ÃÂ£270Th. ,34.0,174.0,Midfielder - Central Midfield,right,LeixÃÂµes SC,33.0,1.0,3.0,1835.0,27.0,5.0,4.0,1780.0,20.0,2.0,4.0,1754.0,9.0,1.0,1.0,641.0,3.0,0.0,0.0,150.0,Liga NOS,nan,nan,nan,nan,nan,nan,nan,nan,nan,nan,nan,nan,nan,nan,nan,nan,nan,nan,nan,nan,nan,nan,nan,nan,nan,nan,nan,nan,nan,nan,nan,nan,nan,nan,nan,nan,nan,nan,nan,nan,nan,nan,nan,nan,nan,nan,nan,nan,nan,nan,nan,nan,nan,nan,nan,nan,nan,nan,nan,nan,nan,nan,nan,nan,nan,nan,nan,nan,nan,nan,nan,nan,nan,nan,nan,nan,nan,nan,nan,nan,nan,nan,nan,nan,nan
19/6/2011,Pape Diop,8440901,41,3/19/1986,25,1,0,0,0,4264,6271,6271,133,127,454545,180,73,DM C,2,1,3,2,3,1,1,2,2,2,3,10,11,8,11,10,6,13,12,10,12,11,8,14,9,18,14,18,5,15,9,10,15,8,8,8,12,16,19,15,15,15,11,7,17,14,20,17,14,12,16,13,11,8,14,12,13,10,16,7,4,8,1,1,15,1,1,1,15,DM C,301,1,1,1,1,1,1,1,1,1,20,15,1,1,1,1,32.0,0,0,0,0,0,1,0,0,0,0,0,0,0,0,0,0,0,0,0,0,0,0,0,0,0,0,0,0,0,0,0,0,0,0,0,0,0,0,0,0,0,0,0,0,0,0,0,0,Pape Diop,ÃÂ£2.70m ,34.0,180.0,Midfielder - Defensive Midfield,right,SD Eibar,20.0,0.0,2.0,1149.0,36.0,1.0,4.0,3046.0,41.0,1.0,0.0,3280.0,36.0,4.0,1.0,2772.0,19.0,0.0,1.0,1544.0,32.0,3.0,1.0,2652.0,19.0,0.0,0.0,981.0,22.0,0.0,0.0,1351.0,29.0,1.0,1.0,2401.0,LaLiga,30.0,1.0,0.0,2256.0,4.0,0.0,1.0,340.0,29/6/2010,Pape Diop,8440901.0,41.0,3/19/1986,24.0,0.0,0.0,0.0,0.0,4225.0,6500.0,6250.0,140.0,130.0,3681118.0,180.0,73.0,DM C,2.0,3.0,1.0,3.0,3.0,2.0,3.0,1.0,1.0,2.0,3.0,10.0,11.0,8.0,12.0,10.0,6.0,13.0,12.0,10.0,12.0,11.0,8.0,15.0,9.0,16.0,14.0,18.0,6.0,15.0,9.0,10.0,15.0,8.0,8.0,8.0,12.0,18.0,18.0,15.0,15.0,15.0,11.0,7.0,17.0,14.0,20.0,18.0,15.0,15.0,11.0,13.0,11.0,8.0,14.0,12.0,13.0,10.0,16.0,11.0,8.0,6.0,Pape Diop,ÃÂÃÂ£2.70m ,LaLiga,19-06-17,18.3.4.28,Pape Diop,8440901,41,19-Mar-86,31,1,0,0,0,5000,6700,6700,144,133,232186002,180,73,DM/M C,2,3,2,2,1,2,3,1,3,3,2,9,9,8,9,11,13,13,11,11,11,13,10,14,11,15,14,18,10,13,14,12,15,8,10,10,13,17,18,14,14,13,11,8,16,14,20,15,14,14,14,13,8,8,14,12,13,12,16,12,7,8,1,1,20,8,1,1,20,DM/M C,311,1,1,1,8,1,1,1,1,1,20,20,1,1,1,1,131744.0,0,0,0,0,0,1,0,1,0,1,0,0,0,0,0,0,0,1,0,0,0,0,0,0,0,0,0,0,0,0,0,0,0,0,0,0,0,0,0,0,0,0,0,0,0,0,0,0,Pape Diop,ÃÂ£900Th. ,34.0,180.0,Midfielder - Defensive Midfield,right,SD Eibar,19.0,0.0,0.0,981.0,22.0,0.0,0.0,1351.0,29.0,1.0,1.0,2401.0,30.0,1.0,0.0,2256.0,4.0,0.0,1.0,340.0,LaLiga,15-07-16,17.3.2.23,Pape Diop,8440901.0,41.0,19-Mar-86,30.0,1.0,0.0,0.0,0.0,5000.0,6850.0,6850.0,144.0,137.0,5266742.0,180.0,73.0,DM/M C,2.0,1.0,2.0,2.0,4.0,4.0,1.0,2.0,2.0,2.0,3.0,11.0,11.0,8.0,11.0,11.0,13.0,13.0,12.0,11.0,11.0,13.0,10.0,14.0,11.0,16.0,14.0,18.0,9.0,15.0,14.0,12.0,15.0,8.0,10.0,11.0,13.0,18.0,19.0,14.0,14.0,13.0,11.0,8.0,16.0,14.0,20.0,16.0,14.0,14.0,14.0,13.0,8.0,8.0,14.0,12.0,13.0,12.0,16.0,12.0,7.0,8.0,Pape Diop,ÃÂ£1.35m ,LaLiga
19/6/2011,Miguel Veloso,744536,788,5/11/1986,25,14,1,12,3,6250,7500,6900,155,139,1895157,180,79,DM/M C,1,1,1,2,2,2,2,7,3,1,1,15,12,11,10,15,17,10,14,7,11,15,13,13,17,11,16,11,15,15,15,13,10,10,12,11,16,14,14,11,12,15,11,20,11,11,8,13,13,14,9,13,6,13,14,15,12,17,11,14,12,8,10,9,18,1,1,10,18,DM/M C,311,1,8,1,1,1,1,10,10,1,20,18,10,1,9,1,73018638848.0,0,0,0,0,0,0,0,0,0,1,0,0,0,0,0,0,0,0,0,0,0,0,1,0,0,0,0,0,0,0,0,0,1,0,0,0,1,0,0,0,0,0,0,0,0,0,0,0,Miguel Veloso,ÃÂ£9.00m ,34.0,180.0,Midfielder - Defensive Midfield,left,Hellas Verona,23.0,0.0,5.0,1433.0,31.0,2.0,1.0,2273.0,37.0,3.0,8.0,3223.0,32.0,2.0,5.0,2678.0,28.0,6.0,1.0,1714.0,30.0,3.0,6.0,2282.0,25.0,1.0,5.0,1993.0,23.0,1.0,0.0,1861.0,22.0,0.0,1.0,1294.0,Serie A,35.0,3.0,6.0,2936.0,2.0,0.0,0.0,180.0,29/6/2010,Miguel Veloso,744536.0,788.0,5/11/1986,24.0,14.0,1.0,12.0,3.0,5625.0,7500.0,7500.0,175.0,150.0,31380133.0,180.0,79.0,DM/M C,1.0,2.0,1.0,1.0,2.0,1.0,1.0,7.0,1.0,2.0,1.0,13.0,14.0,13.0,10.0,16.0,15.0,13.0,14.0,12.0,14.0,16.0,13.0,13.0,17.0,11.0,16.0,11.0,15.0,15.0,15.0,14.0,12.0,10.0,13.0,11.0,16.0,14.0,14.0,11.0,12.0,15.0,11.0,20.0,11.0,11.0,8.0,13.0,14.0,14.0,9.0,13.0,6.0,13.0,15.0,19.0,12.0,17.0,12.0,14.0,14.0,8.0,Miguel Veloso,ÃÂÃÂ£8.55m ,Serie A,19-06-17,18.3.4.28,Miguel Veloso,744536,788,11-May-86,31,56,3,18,5,5500,6700,6700,148,134,232186002,180,79,DM/M C,1,3,1,2,1,3,3,2,3,2,1,15,10,12,11,15,15,10,13,7,12,16,13,14,15,11,15,10,14,13,15,13,10,10,12,11,14,14,13,11,12,15,9,20,11,11,8,13,12,14,9,13,8,13,14,15,12,17,16,14,12,8,10,9,18,1,1,10,18,DM/M C,311,1,8,1,1,1,1,10,10,1,20,18,10,1,9,1,73018638848.0,0,0,0,0,0,0,0,0,0,1,0,0,0,0,0,0,0,0,0,0,0,0,1,0,0,0,0,0,0,0,0,0,1,0,0,0,1,0,0,0,0,0,0,0,0,0,0,0,Miguel Veloso,ÃÂ£2.25m ,34.0,180.0,Midfielder - Defensive Midfield,left,Hellas Verona,25.0,1.0,5.0,1993.0,23.0,1.0,0.0,1861.0,22.0,0.0,1.0,1294.0,35.0,3.0,6.0,2936.0,2.0,0.0,0.0,180.0,Serie A,15-07-16,17.3.2.23,Miguel Veloso,744536.0,788.0,11-May-86,30.0,56.0,3.0,18.0,5.0,6250.0,6700.0,6900.0,148.0,138.0,232186002.0,180.0,79.0,DM/M C,2.0,2.0,1.0,1.0,1.0,2.0,1.0,1.0,3.0,2.0,2.0,15.0,10.0,13.0,11.0,15.0,15.0,10.0,14.0,7.0,13.0,16.0,13.0,14.0,15.0,11.0,15.0,10.0,14.0,13.0,15.0,13.0,10.0,10.0,12.0,11.0,14.0,14.0,13.0,11.0,12.0,15.0,9.0,20.0,11.0,11.0,8.0,13.0,12.0,14.0,9.0,13.0,8.0,13.0,14.0,15.0,12.0,17.0,16.0,14.0,12.0,8.0,Miguel Veloso,ÃÂ£3.60m ,Serie A
19/6/2011,Michu,1509232,796,3/21/1986,25,0,0,0,0,3700,5700,5700,130,116,237154,191,78,M/AM C,3,3,3,1,2,1,3,7,2,2,3,11,10,11,10,13,13,13,13,5,7,13,11,9,13,8,12,9,9,9,12,12,14,13,10,12,9,12,14,12,10,14,16,20,12,12,10,14,15,13,5,9,7,12,8,10,8,10,13,15,16,9,1,1,20,17,1,1,20,M/AM C,411,1,1,9,17,1,1,1,1,1,12,20,1,1,1,1,2147483904.0,0,0,0,0,0,0,0,0,1,0,0,0,0,0,0,0,0,0,0,0,0,0,0,0,0,0,0,0,0,0,0,1,0,0,0,0,0,0,0,0,0,0,0,0,0,0,0,0,Michu,ÃÂ£5.40m ,34.0,185.0,Forward - Second Striker,left,Retired,35.0,7.0,0.0,1947.0,39.0,17.0,4.0,3405.0,43.0,22.0,5.0,3566.0,24.0,6.0,6.0,1852.0,6.0,0.0,1.0,240.0,nan,nan,nan,nan,28.0,3.0,1.0,1299.0,nan,nan,nan,nan,nan,nan,nan,nan,LaLiga,nan,nan,nan,nan,nan,nan,nan,nan,nan,nan,nan,nan,nan,nan,nan,nan,nan,nan,nan,nan,nan,nan,nan,nan,nan,nan,nan,nan,nan,nan,nan,nan,nan,nan,nan,nan,nan,nan,nan,nan,nan,nan,nan,nan,nan,nan,nan,nan,nan,nan,nan,nan,nan,nan,nan,nan,nan,nan,nan,nan,nan,nan,nan,nan,nan,nan,nan,nan,nan,nan,nan,nan,nan,nan,nan,nan,nan,nan,nan,nan,nan,nan,nan,nan,nan,nan,nan,nan,nan,nan,nan,nan
19/6/2011,MÃÂ­chel,1507887,796,11/8/1985,25,0,0,0,0,3350,6300,6300,137,126,162747,183,74,M C,2,2,1,2,1,1,3,5,3,3,2,9,8,11,10,12,8,12,14,11,13,14,10,14,12,14,11,16,13,11,12,12,12,8,11,10,12,14,12,12,13,13,11,12,14,12,20,13,13,13,12,12,7,12,8,13,13,10,10,9,8,6,1,1,20,10,1,1,20,M C,401,1,1,1,10,1,1,1,1,1,14,20,1,1,1,1,64.0,0,0,0,0,0,0,1,0,0,0,0,0,0,0,0,0,0,0,0,0,0,0,0,0,0,0,0,0,0,0,0,0,0,0,0,0,0,0,0,0,0,0,0,0,0,0,0,0,MÃÂ­chel,ÃÂ£2.25m ,34.0,183.0,Midfielder - Central Midfield,right,Marino Luanco,21.0,1.0,1.0,1375.0,24.0,1.0,1.0,1818.0,19.0,0.0,0.0,1244.0,17.0,0.0,0.0,1112.0,26.0,1.0,0.0,1537.0,25.0,4.0,0.0,1712.0,34.0,6.0,5.0,2643.0,35.0,6.0,3.0,2785.0,36.0,8.0,5.0,2700.0,LaLiga,25.0,1.0,4.0,1933.0,2.0,0.0,0.0,66.0,nan,nan,nan,nan,nan,nan,nan,nan,nan,nan,nan,nan,nan,nan,nan,nan,nan,nan,nan,nan,nan,nan,nan,nan,nan,nan,nan,nan,nan,nan,nan,nan,nan,nan,nan,nan,nan,nan,nan,nan,nan,nan,nan,nan,nan,nan,nan,nan,nan,nan,nan,nan,nan,nan,nan,nan,nan,nan,nan,nan,nan,nan,nan,nan,nan,nan,nan,nan,nan,nan,nan,nan,nan,nan,nan,nan,nan,nan,nan,nan,nan,nan,nan,nan
19/6/2011,Mathieu Coutadeur,8431809,769,3/20/1986,25,0,0,7,0,2100,6350,6350,160,140,1155969,170,69,M C,1,3,1,3,1,1,1,4,1,1,1,13,11,11,8,13,12,6,14,9,7,15,14,12,13,10,14,14,14,14,14,14,15,12,16,8,14,15,17,14,12,12,5,10,15,13,20,17,12,16,10,14,5,7,14,16,15,13,16,16,14,7,1,1,20,12,1,1,20,M C,401,1,1,1,12,1,1,1,1,1,14,20,1,1,1,1,4194304.0,0,0,0,0,0,0,0,0,0,0,0,0,0,0,0,0,0,0,0,0,0,0,1,0,0,0,0,0,0,0,0,0,0,0,0,0,0,0,0,0,0,0,0,0,0,0,0,0,Mathieu Coutadeur,ÃÂ£2.25m ,34.0,170.0,Midfielder - Central Midfield,right,AC Ajaccio,21.0,2.0,2.0,1206.0,35.0,3.0,3.0,2614.0,5.0,0.0,0.0,359.0,18.0,1.0,1.0,1256.0,12.0,0.0,0.0,802.0,32.0,1.0,1.0,2812.0,39.0,5.0,4.0,3277.0,40.0,6.0,4.0,3334.0,33.0,5.0,3.0,2947.0,Ligue 1,28.0,2.0,6.0,2466.0,6.0,0.0,0.0,469.0,29/6/2010,Mathieu Coutadeur,8431809.0,769.0,3/20/1986,24.0,0.0,0.0,7.0,0.0,2850.0,6389.0,6350.0,160.0,142.0,11251091.0,170.0,69.0,M C,3.0,2.0,3.0,3.0,2.0,2.0,1.0,4.0,3.0,2.0,1.0,13.0,11.0,11.0,8.0,13.0,12.0,6.0,14.0,9.0,7.0,15.0,14.0,12.0,13.0,10.0,14.0,14.0,14.0,14.0,14.0,14.0,15.0,12.0,16.0,8.0,14.0,15.0,17.0,14.0,12.0,12.0,5.0,10.0,15.0,13.0,20.0,17.0,12.0,16.0,10.0,14.0,5.0,7.0,18.0,16.0,15.0,13.0,16.0,16.0,14.0,7.0,Mathieu Coutadeur,ÃÂÃÂ£2.70m ,Ligue 1
19/6/2011,Markel,7458284,796,5/5/1986,25,0,0,0,0,4300,6050,6050,135,126,634342,180,74,DM/M C,3,2,2,1,2,2,1,2,3,2,1,4,6,11,9,12,5,11,7,5,13,12,9,16,11,13,14,13,12,11,10,12,10,7,10,8,14,15,17,13,12,12,10,11,13,13,20,17,14,11,9,10,11,9,13,13,15,12,9,7,11,5,1,1,17,1,1,1,17,DM/M C,311,1,1,1,1,1,1,1,1,1,20,17,1,1,1,1,0.0,0,0,0,0,0,0,0,0,0,0,0,0,0,0,0,0,0,0,0,0,0,0,0,0,0,0,0,0,0,0,0,0,0,0,0,0,0,0,0,0,0,0,0,0,0,0,0,0,Marcelo,ÃÂ£22.50m ,32.0,174.0,Defender - Left-Back,left,Real Madrid,50.0,5.0,10.0,4239.0,44.0,3.0,10.0,3540.0,19.0,1.0,1.0,1386.0,39.0,2.0,8.0,2998.0,53.0,4.0,10.0,4168.0,41.0,2.0,4.0,3383.0,47.0,3.0,13.0,3878.0,44.0,5.0,11.0,3671.0,34.0,3.0,6.0,2858.0,LaLiga,23.0,2.0,7.0,1884.0,3.0,0.0,1.0,270.0,29/6/2010,Markel,7458284.0,796.0,5/5/1986,24.0,0.0,0.0,0.0,0.0,3600.0,5650.0,5650.0,133.0,120.0,3134936.0,180.0,74.0,DM/M C,2.0,3.0,3.0,1.0,3.0,1.0,1.0,1.0,2.0,3.0,1.0,5.0,6.0,11.0,9.0,11.0,6.0,12.0,7.0,5.0,12.0,12.0,9.0,13.0,12.0,13.0,14.0,13.0,12.0,12.0,11.0,12.0,10.0,7.0,10.0,8.0,14.0,15.0,16.0,13.0,12.0,12.0,10.0,11.0,13.0,13.0,20.0,15.0,14.0,11.0,9.0,10.0,11.0,9.0,13.0,13.0,15.0,12.0,6.0,11.0,11.0,5.0,Marcelo,ÃÂÃÂ£18.00m ,LaLiga,19-06-17,18.3.4.28,Markel,7458284,796,05-May-86,31,0,0,0,0,4350,6550,6550,139,131,3892634,180,74,DM C,2,2,2,1,2,2,1,2,2,1,1,3,4,10,2,11,3,11,4,4,14,10,8,15,11,16,17,18,13,16,9,13,10,7,14,8,16,19,18,13,12,11,10,12,11,12,20,16,15,15,10,12,17,2,13,10,15,12,14,14,11,5,10,1,15,1,1,1,15,DM C,301,1,1,1,1,1,1,10,1,1,20,15,1,1,1,1,64.0,0,0,0,0,0,0,1,0,0,0,0,0,0,0,0,0,0,0,0,0,0,0,0,0,0,0,0,0,0,0,0,0,0,0,0,0,0,0,0,0,0,0,0,0,0,0,0,0,Marcel,ÃÂ£270Th. ,28.0,189.0,Midfielder - Defensive Midfield,right,Londrina Esporte Clube (PR),15.0,1.0,0.0,1178.0,10.0,0.0,0.0,347.0,4.0,0.0,0.0,113.0,9.0,1.0,0.0,372.0,nan,nan,nan,nan,Liga NOS,15-07-16,17.3.2.23,Markel,7458284.0,796.0,05-May-86,30.0,0.0,0.0,0.0,0.0,4350.0,6650.0,6650.0,139.0,133.0,3131502.0,180.0,74.0,DM C,3.0,3.0,3.0,1.0,3.0,3.0,1.0,2.0,2.0,3.0,1.0,3.0,4.0,10.0,2.0,11.0,3.0,11.0,4.0,4.0,15.0,10.0,8.0,16.0,11.0,16.0,17.0,18.0,13.0,16.0,9.0,13.0,10.0,7.0,14.0,8.0,16.0,19.0,18.0,13.0,12.0,11.0,10.0,12.0,11.0,12.0,20.0,16.0,15.0,15.0,10.0,12.0,17.0,2.0,13.0,10.0,15.0,12.0,14.0,14.0,11.0,5.0,Marcelo,ÃÂ£34.20m ,LaLiga
19/6/2011,Luka Modric,653054,761,9/9/1985,25,44,7,11,1,7505,9006,8262,178,170,8403632,171,66,M/AM RLC,2,2,1,2,2,2,3,8,1,1,1,13,12,16,7,17,13,7,8,11,7,17,15,9,17,12,15,13,14,15,17,18,15,15,17,14,7,18,18,15,16,16,4,15,16,14,20,18,9,13,6,17,6,14,12,17,14,17,16,15,15,3,1,1,20,20,16,18,20,M/AM RLC,416,1,1,1,20,18,16,1,1,1,1,20,15,12,1,1,551903000000.0,1,0,0,0,0,0,0,0,0,0,0,1,0,0,1,0,1,0,0,0,0,0,0,0,0,0,0,0,0,0,0,1,0,0,0,0,0,0,0,1,0,0,0,0,0,0,0,0,Luka Modric,ÃÂ£35.10m ,35.0,172.0,Midfielder - Central Midfield,both,Real Madrid,43.0,4.0,3.0,3540.0,41.0,5.0,7.0,3548.0,53.0,4.0,8.0,3284.0,51.0,2.0,9.0,4061.0,25.0,1.0,5.0,2007.0,44.0,3.0,4.0,3530.0,41.0,1.0,5.0,3304.0,43.0,2.0,8.0,3339.0,46.0,4.0,8.0,3571.0,Premier League,40.0,5.0,8.0,2631.0,7.0,2.0,0.0,430.0,29/6/2010,Luka Modric,653054.0,761.0,9/9/1985,24.0,41.0,7.0,11.0,1.0,6642.0,8965.0,7850.0,173.0,163.0,38700614.0,171.0,66.0,M/AM RLC,2.0,3.0,2.0,3.0,2.0,1.0,1.0,9.0,2.0,3.0,2.0,13.0,12.0,16.0,7.0,15.0,13.0,7.0,8.0,11.0,7.0,15.0,15.0,9.0,17.0,12.0,14.0,13.0,13.0,15.0,17.0,18.0,15.0,15.0,17.0,14.0,7.0,15.0,16.0,15.0,16.0,16.0,4.0,15.0,16.0,14.0,20.0,18.0,9.0,13.0,6.0,17.0,6.0,14.0,12.0,17.0,14.0,17.0,16.0,15.0,15.0,3.0,Luka Modric,ÃÂÃÂ£25.20m ,Premier League,19-06-17,18.3.4.28,Luka Modric,653054,761,09-Sep-85,31,97,11,15,2,8900,8800,8900,180,178,232186002,172,67,M C,2,1,1,1,3,3,1,4,3,2,2,16,16,17,9,19,13,8,12,7,8,19,14,11,18,12,17,13,15,16,18,18,16,13,13,12,12,16,17,14,17,13,7,13,13,13,20,17,8,15,12,14,11,16,10,15,13,17,16,16,17,5,1,1,20,15,5,8,20,M C,401,1,1,1,15,1,1,1,1,1,14,20,8,5,1,1,140737000000000.0,0,0,0,0,0,0,0,0,0,0,0,0,0,0,0,0,0,0,0,0,0,0,1,0,0,0,0,0,0,0,0,0,0,0,0,0,0,0,0,0,0,0,0,0,0,0,0,1,Luka Modric,ÃÂ£22.50m ,35.0,172.0,Midfielder - Central Midfield,both,Real Madrid,41.0,1.0,5.0,3304.0,43.0,2.0,8.0,3339.0,46.0,4.0,8.0,3571.0,40.0,5.0,8.0,2631.0,7.0,2.0,0.0,430.0,LaLiga,15-07-16,17.3.2.23,Luka Modric,653054.0,761.0,09-Sep-85,30.0,93.0,11.0,15.0,2.0,8900.0,9500.0,8900.0,180.0,178.0,232186002.0,173.0,65.0,M C,1.0,1.0,1.0,2.0,2.0,2.0,1.0,2.0,2.0,2.0,1.0,16.0,16.0,17.0,9.0,19.0,13.0,8.0,12.0,7.0,8.0,19.0,14.0,11.0,18.0,12.0,17.0,13.0,15.0,16.0,18.0,18.0,16.0,13.0,13.0,12.0,12.0,16.0,17.0,14.0,17.0,13.0,7.0,13.0,13.0,13.0,20.0,17.0,8.0,15.0,12.0,14.0,11.0,16.0,10.0,15.0,13.0,17.0,16.0,16.0,17.0,5.0,Luka Modric,ÃÂ£36.00m ,LaLiga
19/6/2011,Luiz Carlos,19108538,1651,7/5/1985,25,0,0,0,0,250,4450,4450,120,107,92749,175,75,M C,2,3,2,3,1,1,2,6,1,3,2,10,7,7,13,14,10,10,10,6,8,10,10,13,14,12,11,10,12,13,12,12,10,14,7,10,9,13,14,14,12,12,7,6,10,12,20,10,12,10,13,10,13,10,10,4,8,8,15,1,1,11,1,1,20,12,1,1,20,M C,401,1,1,1,12,1,1,1,1,1,12,20,1,1,1,1,0.0,0,0,0,0,0,0,0,0,0,0,0,0,0,0,0,0,0,0,0,0,0,0,0,0,0,0,0,0,0,0,0,0,0,0,0,0,0,0,0,0,0,0,0,0,0,0,0,0,Luiz Carlos,ÃÂ£270Th. ,32.0,191.0,Goalkeeper,right,Without Club,0.0,0.0,0.0,0.0,4.0,7.0,1.0,360.0,nan,nan,nan,nan,nan,nan,nan,nan,0.0,0.0,0.0,0.0,0.0,0.0,0.0,0.0,nan,nan,nan,nan,nan,nan,nan,nan,nan,nan,nan,nan,Liga NOS,nan,nan,nan,nan,nan,nan,nan,nan,nan,nan,nan,nan,nan,nan,nan,nan,nan,nan,nan,nan,nan,nan,nan,nan,nan,nan,nan,nan,nan,nan,nan,nan,nan,nan,nan,nan,nan,nan,nan,nan,nan,nan,nan,nan,nan,nan,nan,nan,nan,nan,nan,nan,nan,nan,nan,nan,nan,nan,nan,nan,nan,nan,nan,nan,nan,nan,nan,nan,nan,nan,nan,nan,nan,nan,nan,nan,nan,nan,nan,nan,nan,nan,nan,nan,nan,nan,nan,nan,nan,nan,nan,nan
19/6/2011,Landry N'Guemo,8434325,11,11/28/1985,25,21,2,0,0,5350,6600,5982,145,132,653805,173,70,DM/M C,2,3,2,2,1,3,3,1,1,1,1,10,11,11,6,12,8,12,11,6,8,13,13,13,12,12,16,15,11,13,12,11,12,9,10,9,13,15,17,16,13,13,6,8,15,14,20,17,13,14,12,14,7,8,15,15,13,14,12,15,15,5,1,1,16,12,1,1,16,DM/M C,311,1,1,1,12,1,1,1,1,1,20,16,1,1,1,1,8797170000000.0,0,0,0,0,0,0,0,0,0,0,0,0,0,0,0,0,0,0,0,0,0,0,0,0,0,0,0,0,0,0,1,0,0,0,0,0,0,0,0,0,0,0,0,1,0,0,0,0,Landry N'GuÃÂ©mo,ÃÂ£3.60m ,34.0,174.0,Midfielder - Defensive Midfield,right,Retired,37.0,2.0,2.0,2992.0,35.0,1.0,1.0,2993.0,19.0,0.0,0.0,1180.0,29.0,1.0,2.0,2261.0,17.0,1.0,0.0,1100.0,37.0,2.0,4.0,2980.0,27.0,0.0,2.0,1470.0,nan,nan,nan,nan,21.0,0.0,1.0,1570.0,Ligue 1,nan,nan,nan,nan,nan,nan,nan,nan,29/6/2010,Landry N'Guemo,8434325.0,11.0,11/28/1985,24.0,21.0,2.0,0.0,0.0,4096.0,6400.0,5750.0,145.0,128.0,2561529.0,173.0,70.0,DM/M C,3.0,1.0,2.0,2.0,3.0,2.0,1.0,2.0,1.0,3.0,3.0,11.0,11.0,11.0,6.0,12.0,8.0,12.0,11.0,6.0,8.0,13.0,12.0,12.0,12.0,12.0,16.0,14.0,11.0,11.0,12.0,10.0,12.0,9.0,10.0,9.0,13.0,15.0,16.0,15.0,13.0,13.0,6.0,10.0,13.0,14.0,20.0,17.0,13.0,12.0,13.0,13.0,7.0,8.0,15.0,15.0,13.0,14.0,12.0,15.0,15.0,5.0,Landry N'GuÃÂÃÂ©mo,ÃÂÃÂ£3.60m ,Ligue 1
19/6/2011,Juliano,19004486,1651,2/14/1986,25,0,0,0,0,2500,5500,5500,128,110,190273,173,73,M/AM LC,2,2,3,1,1,1,1,2,2,3,1,13,13,13,11,13,13,8,11,12,7,13,13,6,13,7,10,12,12,11,12,13,16,9,8,11,9,11,12,13,11,10,7,20,11,13,8,13,10,10,5,11,11,9,12,10,19,12,12,12,16,5,1,1,17,20,10,18,20,M/AM LC,524,1,1,13,20,18,10,1,1,1,1,17,16,5,1,1,17733517312.0,0,0,0,0,0,0,0,0,0,0,0,0,0,0,0,0,0,0,0,0,0,0,0,0,1,0,0,0,0,1,0,0,0,0,1,0,0,0,0,0,0,0,0,0,0,0,0,0,Julian Korb,ÃÂ£180Th. ,28.0,177.0,Defender - Right-Back,right,Without Club,29.0,2.0,1.0,2540.0,28.0,1.0,4.0,2317.0,33.0,2.0,3.0,2959.0,25.0,0.0,0.0,2216.0,31.0,0.0,1.0,2671.0,24.0,2.0,3.0,1856.0,21.0,1.0,1.0,1322.0,29.0,1.0,2.0,2431.0,12.0,0.0,0.0,1007.0,Bundesliga,27.0,1.0,4.0,2111.0,nan,nan,nan,nan,nan,nan,nan,nan,nan,nan,nan,nan,nan,nan,nan,nan,nan,nan,nan,nan,nan,nan,nan,nan,nan,nan,nan,nan,nan,nan,nan,nan,nan,nan,nan,nan,nan,nan,nan,nan,nan,nan,nan,nan,nan,nan,nan,nan,nan,nan,nan,nan,nan,nan,nan,nan,nan,nan,nan,nan,nan,nan,nan,nan,nan,nan,nan,nan,nan,nan,nan,nan,nan,nan,nan,nan,nan,nan,nan,nan,nan,nan,nan,nan,nan,nan,nan,nan
19/6/2011,JoÃÂ£o Vilela,745267,788,9/9/1985,25,0,0,0,0,1500,5000,5000,109,100,125579,181,78,M/AM C,1,2,3,3,3,3,2,4,2,3,2,12,12,12,11,12,12,11,12,8,9,11,12,8,12,10,13,10,12,11,12,11,12,13,10,13,9,10,13,12,11,13,11,5,13,11,20,11,13,11,7,10,7,11,8,14,14,12,14,14,14,6,1,1,16,20,5,5,20,M/AM C,521,1,1,1,20,5,5,1,1,1,1,16,1,5,1,1,4194304.0,0,0,0,0,0,0,0,0,0,0,0,0,0,0,0,0,0,0,0,0,0,0,1,0,0,0,0,0,0,0,0,0,0,0,0,0,0,0,0,0,0,0,0,0,0,0,0,0,JoÃÂ£o Vilela,ÃÂ£810Th. ,35.0,184.0,Midfielder - Central Midfield,right,Without Club,33.0,4.0,1.0,1905.0,12.0,3.0,0.0,749.0,23.0,2.0,0.0,1452.0,23.0,4.0,1.0,1747.0,32.0,7.0,3.0,2332.0,1.0,0.0,0.0,12.0,19.0,1.0,4.0,1071.0,nan,nan,nan,nan,nan,nan,nan,nan,Liga NOS,nan,nan,nan,nan,nan,nan,nan,nan,nan,nan,nan,nan,nan,nan,nan,nan,nan,nan,nan,nan,nan,nan,nan,nan,nan,nan,nan,nan,nan,nan,nan,nan,nan,nan,nan,nan,nan,nan,nan,nan,nan,nan,nan,nan,nan,nan,nan,nan,nan,nan,nan,nan,nan,nan,nan,nan,nan,nan,nan,nan,nan,nan,nan,nan,nan,nan,nan,nan,nan,nan,nan,nan,nan,nan,nan,nan,nan,nan,nan,nan,nan,nan,nan,nan,nan,nan,nan,nan,nan,nan,nan,nan
19/6/2011,JoÃÂ£o Luiz,19035988,1651,6/24/1985,25,0,0,0,0,1154,4814,5250,120,107,43017,182,79,DM/M C,1,3,3,1,2,3,2,4,3,3,1,8,10,11,10,12,11,12,12,10,10,12,11,12,13,12,11,13,13,12,12,11,14,10,10,12,11,13,14,11,13,13,14,8,14,11,20,12,13,11,9,10,7,12,14,13,14,6,14,14,14,5,1,1,17,7,10,5,17,DM/M C,311,1,1,1,7,1,1,1,1,1,20,17,5,10,1,1,0.0,0,0,0,0,0,0,0,0,0,0,0,0,0,0,0,0,0,0,0,0,0,0,0,0,0,0,0,0,0,0,0,0,0,0,0,0,0,0,0,0,0,0,0,0,0,0,0,0,JoÃÂ£o Luiz,ÃÂ£450Th. ,35.0,182.0,Midfielder - Defensive Midfield,right,Al-Hala,28.0,0.0,0.0,2044.0,11.0,0.0,0.0,408.0,18.0,0.0,0.0,1432.0,23.0,0.0,0.0,1584.0,17.0,1.0,0.0,936.0,nan,nan,nan,nan,nan,nan,nan,nan,nan,nan,nan,nan,nan,nan,nan,nan,Liga NOS,nan,nan,nan,nan,nan,nan,nan,nan,29/6/2010,JoÃÂ£o Luiz,19035988.0,1651.0,6/24/1985,25.0,0.0,0.0,0.0,0.0,1000.0,2000.0,5250.0,120.0,107.0,103648.0,182.0,79.0,DM/M C,2.0,2.0,1.0,2.0,3.0,2.0,2.0,6.0,2.0,2.0,3.0,8.0,10.0,11.0,10.0,12.0,11.0,12.0,12.0,10.0,10.0,12.0,11.0,12.0,13.0,12.0,11.0,13.0,13.0,12.0,12.0,11.0,14.0,10.0,10.0,12.0,11.0,13.0,14.0,11.0,13.0,13.0,14.0,8.0,14.0,11.0,20.0,12.0,13.0,11.0,9.0,10.0,7.0,12.0,14.0,13.0,14.0,7.0,14.0,14.0,14.0,5.0,JoÃÂÃÂ£o Luiz,ÃÂÃÂ£450Th. ,Liga NOS
19/6/2011,Javi MÃÂ¡rquez,1509534,796,5/11/1986,25,0,0,0,0,4750,7000,7000,150,140,1099884,174,71,DM/M LC,2,2,1,3,3,2,2,1,1,1,3,11,12,12,9,14,12,9,13,9,10,14,9,12,14,12,14,12,14,14,14,15,12,12,9,14,13,15,17,14,13,11,8,20,12,14,8,14,12,12,9,9,9,13,9,12,15,14,10,8,7,19,1,1,20,14,1,17,20,DM/M LC,424,1,1,1,14,13,1,1,1,1,17,20,17,1,1,1,0.0,0,0,0,0,0,0,0,0,0,0,0,0,0,0,0,0,0,0,0,0,0,0,0,0,0,0,0,0,0,0,0,0,0,0,0,0,0,0,0,0,0,0,0,0,0,0,0,0,Javi MÃÂ¡rquez,ÃÂ£5.40m ,34.0,179.0,Midfielder - Central Midfield,left,Without Club,33.0,2.0,1.0,2470.0,9.0,0.0,0.0,594.0,26.0,3.0,2.0,1597.0,30.0,2.0,1.0,2157.0,26.0,0.0,0.0,1487.0,21.0,0.0,1.0,1443.0,39.0,6.0,6.0,2998.0,13.0,0.0,0.0,572.0,25.0,1.0,3.0,1508.0,LaLiga,11.0,2.0,0.0,796.0,nan,nan,nan,nan,29/6/2010,Javi MÃÂ¡rquez,1509534.0,796.0,5/11/1986,24.0,0.0,0.0,0.0,0.0,3500.0,6500.0,6500.0,150.0,135.0,5070032.0,174.0,71.0,DM/M LC,3.0,1.0,2.0,3.0,1.0,1.0,1.0,2.0,3.0,3.0,3.0,11.0,11.0,9.0,9.0,13.0,10.0,9.0,11.0,9.0,9.0,14.0,10.0,10.0,13.0,11.0,14.0,12.0,12.0,12.0,14.0,13.0,12.0,12.0,9.0,13.0,13.0,15.0,17.0,14.0,13.0,10.0,8.0,20.0,12.0,14.0,8.0,14.0,11.0,12.0,9.0,9.0,9.0,13.0,5.0,17.0,6.0,13.0,17.0,1.0,12.0,12.0,Javi MÃÂÃÂ¡rquez,ÃÂÃÂ£3.60m ,LaLiga
19/6/2011,Javi LÃÂ³pez,67006184,796,1/21/1986,25,0,0,0,0,2500,5750,5750,130,120,240418,179,74,D/WB/DM/M RC,1,2,3,3,1,1,3,1,1,3,3,9,12,12,11,10,9,7,11,9,12,13,5,11,12,13,12,11,12,10,11,11,10,7,8,13,12,12,14,14,13,8,8,12,14,12,20,12,10,14,8,10,7,17,8,7,12,14,8,18,10,6,18,20,19,14,20,10,15,D/WB/DM/M RC,243,1,1,1,1,8,14,1,5,18,16,15,10,19,8,20,0.0,0,0,0,0,0,0,0,0,0,0,0,0,0,0,0,0,0,0,0,0,0,0,0,0,0,0,0,0,0,0,0,0,0,0,0,0,0,0,0,0,0,0,0,0,0,0,0,0,Javi LÃÂ³pez,ÃÂ£2.25m ,34.0,180.0,Defender - Right-Back,right,Without Club,27.0,0.0,0.0,1752.0,32.0,1.0,2.0,2412.0,33.0,1.0,0.0,2577.0,35.0,0.0,1.0,3105.0,33.0,0.0,1.0,2621.0,33.0,0.0,1.0,2613.0,20.0,0.0,1.0,1614.0,15.0,0.0,0.0,1039.0,25.0,0.0,0.0,2159.0,LaLiga,28.0,1.0,1.0,2375.0,nan,nan,nan,nan,29/6/2010,Javi LÃÂ³pez,67006184.0,796.0,1/21/1986,24.0,0.0,0.0,0.0,0.0,1250.0,4000.0,4000.0,110.0,85.0,67355.0,179.0,74.0,M/AM R,3.0,2.0,3.0,1.0,3.0,1.0,3.0,1.0,1.0,1.0,1.0,9.0,13.0,10.0,11.0,8.0,9.0,2.0,9.0,8.0,7.0,10.0,9.0,6.0,5.0,5.0,9.0,9.0,5.0,9.0,12.0,5.0,10.0,6.0,9.0,12.0,8.0,15.0,14.0,12.0,11.0,12.0,13.0,10.0,12.0,12.0,20.0,9.0,2.0,7.0,15.0,10.0,12.0,10.0,14.0,5.0,13.0,9.0,14.0,18.0,7.0,14.0,Javi LÃÂÃÂ³pez,ÃÂÃÂ£900Th. ,LaLiga,19-06-17,18.3.4.28,Javi LÃÂ³pez,67006184,796,21-Jan-86,31,0,0,0,0,4000,6250,6250,141,125,1429170,179,74,D/WB/M RC,2,2,3,2,3,3,1,3,1,2,1,9,12,11,8,11,8,7,10,11,12,13,6,13,11,13,12,14,11,13,11,11,9,8,13,14,14,15,16,12,12,13,8,12,13,12,20,13,11,15,9,10,11,17,13,11,11,12,12,12,17,2,20,18,19,14,20,10,15,D/WB/M RC,123,1,1,1,1,8,14,1,5,20,14,15,10,19,8,18,0.0,0,0,0,0,0,0,0,0,0,0,0,0,0,0,0,0,0,0,0,0,0,0,0,0,0,0,0,0,0,0,0,0,0,0,0,0,0,0,0,0,0,0,0,0,0,0,0,0,Javi LÃÂ³pez,ÃÂ£900Th. ,34.0,180.0,Defender - Right-Back,right,Without Club,20.0,0.0,1.0,1614.0,15.0,0.0,0.0,1039.0,25.0,0.0,0.0,2159.0,28.0,1.0,1.0,2375.0,nan,nan,nan,nan,LaLiga,15-07-16,17.3.2.23,Javi LÃÂ³pez,67006184.0,796.0,21-Jan-86,30.0,0.0,0.0,0.0,0.0,4000.0,6500.0,6500.0,141.0,131.0,232186002.0,179.0,74.0,D/WB/M RC,3.0,3.0,1.0,2.0,3.0,1.0,2.0,3.0,3.0,1.0,1.0,9.0,12.0,11.0,8.0,11.0,8.0,7.0,10.0,11.0,12.0,13.0,7.0,13.0,11.0,13.0,12.0,14.0,12.0,13.0,11.0,12.0,6.0,8.0,13.0,14.0,14.0,15.0,16.0,13.0,13.0,13.0,8.0,12.0,13.0,12.0,20.0,14.0,11.0,15.0,9.0,11.0,5.0,17.0,15.0,14.0,14.0,13.0,14.0,11.0,15.0,5.0,Javi LÃÂ³pez,ÃÂ£1.80m ,LaLiga
19/6/2011,Jan Rosenthal,8728478,771,4/7/1986,25,0,0,17,2,5000,6550,6550,143,132,765094,185,75,M/AM RLC,1,2,3,3,3,3,2,4,2,1,3,10,11,12,13,12,10,10,13,10,7,13,10,11,14,12,13,15,8,8,11,10,17,12,12,14,10,13,15,13,12,14,13,14,12,15,20,14,14,9,5,9,13,17,8,15,14,7,15,14,11,6,1,7,18,20,20,18,18,M/AM RLC,526,1,1,1,18,18,20,1,1,1,11,15,15,18,7,7,512.0,0,0,0,0,0,0,0,0,0,1,0,0,0,0,0,0,0,0,0,0,0,0,0,0,0,0,0,0,0,0,0,0,0,0,0,0,0,0,0,0,0,0,0,0,0,0,0,0,Jan Rosenthal,ÃÂ£2.70m ,34.0,186.0,Forward - Second Striker,right,Retired,23.0,5.0,0.0,1660.0,21.0,2.0,1.0,1349.0,24.0,5.0,5.0,1765.0,24.0,2.0,2.0,1119.0,9.0,1.0,1.0,315.0,25.0,0.0,5.0,1529.0,19.0,0.0,0.0,856.0,12.0,0.0,0.0,439.0,nan,nan,nan,nan,Bundesliga,2.0,0.0,0.0,118.0,nan,nan,nan,nan,29/6/2010,Jan Rosenthal,8728478.0,771.0,4/7/1986,24.0,0.0,0.0,17.0,2.0,3500.0,6550.0,6550.0,143.0,131.0,1099998.0,185.0,75.0,M/AM RLC,2.0,2.0,3.0,1.0,1.0,2.0,2.0,4.0,3.0,2.0,1.0,10.0,11.0,12.0,13.0,12.0,10.0,10.0,13.0,10.0,7.0,13.0,10.0,10.0,13.0,12.0,13.0,15.0,8.0,8.0,11.0,10.0,17.0,12.0,12.0,14.0,10.0,13.0,15.0,13.0,12.0,14.0,13.0,14.0,12.0,15.0,20.0,14.0,14.0,9.0,5.0,9.0,13.0,17.0,8.0,15.0,14.0,7.0,15.0,14.0,11.0,6.0,Jan Rosenthal,ÃÂÃÂ£2.70m ,Bundesliga
19/6/2011,James Morrison,5113352,793,5/25/1986,25,13,1,0,0,4750,6750,6500,142,130,993822,178,77,M/AM RC,3,2,3,3,2,2,2,1,3,2,3,9,13,15,10,14,8,8,11,3,8,13,5,9,14,9,12,8,13,12,15,12,13,14,7,15,11,12,14,14,13,13,7,16,15,12,20,13,10,14,7,12,9,14,14,15,14,12,14,13,14,6,2,3,20,20,20,14,20,M/AM RC,413,1,1,1,20,14,20,1,1,2,4,16,14,20,1,3,42.0,0,1,0,1,0,1,0,0,0,0,0,0,0,0,0,0,0,0,0,0,0,0,0,0,0,0,0,0,0,0,0,0,0,0,0,0,0,0,0,0,0,0,0,0,0,0,0,0,James Morrison,ÃÂ£4.05m ,34.0,183.0,Midfielder - Central Midfield,right,Retired,32.0,4.0,3.0,2367.0,33.0,5.0,5.0,2357.0,37.0,5.0,7.0,3026.0,35.0,1.0,4.0,2351.0,37.0,4.0,1.0,2885.0,19.0,4.0,3.0,1432.0,35.0,5.0,3.0,2092.0,6.0,1.0,0.0,373.0,27.0,0.0,1.0,1396.0,Premier League,nan,nan,nan,nan,nan,nan,nan,nan,29/6/2010,James Morrison,5113352.0,793.0,5/25/1986,24.0,5.0,0.0,0.0,0.0,4160.0,6750.0,6350.0,150.0,129.0,5931646.0,178.0,77.0,M/AM RC,1.0,2.0,2.0,3.0,1.0,1.0,2.0,4.0,1.0,2.0,3.0,8.0,12.0,14.0,9.0,13.0,7.0,7.0,9.0,2.0,7.0,12.0,5.0,9.0,14.0,9.0,12.0,8.0,12.0,11.0,14.0,12.0,13.0,14.0,8.0,15.0,9.0,11.0,12.0,12.0,12.0,12.0,6.0,17.0,15.0,12.0,20.0,11.0,9.0,14.0,7.0,12.0,9.0,13.0,14.0,15.0,14.0,12.0,14.0,13.0,14.0,6.0,James Morrison,ÃÂÃÂ£3.15m ,Premier League,19-06-17,18.3.4.28,James Morrison,5113352,793,25-May-86,31,44,3,0,0,5650,7250,7050,143,141,232186002,178,77,M/AM RC,3,3,3,1,2,1,2,2,2,2,3,9,15,15,12,13,8,8,13,3,8,14,5,10,15,8,14,8,13,12,15,12,12,15,7,17,13,14,15,14,14,13,7,15,15,13,20,13,10,15,7,12,8,16,14,15,14,11,14,13,14,6,2,3,18,20,16,13,20,M/AM RC,523,1,1,1,20,12,15,1,1,2,4,18,13,16,1,3,4398050000000.0,0,0,1,1,0,1,0,0,0,0,0,0,0,0,0,0,0,0,0,0,0,0,0,0,0,0,0,0,0,0,0,0,0,0,0,0,0,0,0,0,0,0,1,0,0,0,0,0,James Morrison,ÃÂ£3.60m ,34.0,183.0,Midfielder - Central Midfield,right,Retired,35.0,5.0,3.0,2092.0,6.0,1.0,0.0,373.0,27.0,0.0,1.0,1396.0,nan,nan,nan,nan,nan,nan,nan,nan,Premier League,15-07-16,17.3.2.23,James Morrison,5113352.0,793.0,25-May-86,30.0,41.0,3.0,0.0,0.0,5250.0,7250.0,7000.0,143.0,141.0,18154634.0,178.0,77.0,M/AM RC,2.0,1.0,3.0,2.0,2.0,1.0,2.0,2.0,3.0,2.0,3.0,9.0,15.0,15.0,12.0,13.0,8.0,8.0,13.0,3.0,8.0,14.0,5.0,10.0,15.0,8.0,14.0,8.0,13.0,12.0,15.0,12.0,12.0,15.0,7.0,17.0,13.0,14.0,15.0,14.0,14.0,13.0,7.0,15.0,15.0,13.0,20.0,13.0,10.0,15.0,7.0,12.0,8.0,16.0,14.0,15.0,14.0,11.0,14.0,13.0,14.0,6.0,James Morrison,ÃÂ£4.50m ,Premier League
19/6/2011,James Milner,5106363,765,1/4/1986,25,19,0,46,9,6400,7500,7500,160,150,18181818,176,70,M/AM RLC,3,3,3,3,3,2,1,4,2,1,2,13,14,12,12,14,15,9,13,12,9,14,12,12,12,12,15,14,14,15,14,15,17,14,14,13,10,18,19,13,15,13,8,12,18,12,20,18,11,16,4,15,4,14,7,15,15,16,18,12,14,1,10,3,20,18,18,17,20,M/AM RLC,416,1,1,8,10,17,18,1,3,10,1,20,15,15,2,3,70918500000000.0,1,1,0,0,0,0,0,1,0,0,0,0,0,0,0,0,0,0,0,0,0,0,0,0,0,0,0,0,0,0,0,0,0,0,0,0,0,0,0,1,0,0,0,0,0,0,1,0,James Milner,ÃÂ£18.90m ,34.0,175.0,Midfielder - Central Midfield,right,Liverpool FC,42.0,3.0,8.0,2688.0,37.0,3.0,5.0,2198.0,36.0,4.0,8.0,2421.0,44.0,2.0,15.0,2323.0,45.0,8.0,9.0,2704.0,45.0,7.0,14.0,3862.0,40.0,7.0,4.0,3437.0,47.0,1.0,11.0,2787.0,45.0,7.0,7.0,2836.0,Premier League,37.0,4.0,4.0,1708.0,7.0,0.0,0.0,305.0,29/6/2010,James Milner,5106363.0,765.0,1/4/1986,24.0,11.0,0.0,46.0,9.0,5929.0,8000.0,8000.0,165.0,154.0,71788041.0,176.0,70.0,M/AM RLC,3.0,2.0,2.0,2.0,3.0,1.0,1.0,7.0,1.0,1.0,2.0,13.0,14.0,12.0,12.0,14.0,15.0,9.0,13.0,12.0,9.0,14.0,12.0,12.0,12.0,12.0,15.0,14.0,14.0,15.0,14.0,15.0,17.0,14.0,14.0,13.0,10.0,18.0,19.0,15.0,15.0,13.0,8.0,12.0,18.0,12.0,20.0,18.0,11.0,16.0,4.0,15.0,4.0,14.0,13.0,15.0,15.0,16.0,18.0,12.0,14.0,1.0,James Milner,ÃÂÃÂ£18.00m ,Premier League,19-06-17,18.3.4.28,James Milner,5106363,765,04-Jan-86,31,61,1,46,9,6500,7600,7500,157,150,232186002,176,70,D/WB/DM/M/AM RLC,2,3,2,3,3,1,1,3,2,2,2,12,14,12,9,14,7,8,7,7,12,13,14,13,13,14,14,16,14,14,12,13,17,12,14,13,14,17,18,12,13,13,8,8,17,12,20,16,14,14,9,15,6,19,17,15,14,15,18,12,15,8,16,18,20,16,18,18,20,D/WB/DM/M/AM RLC,456,1,1,10,10,16,16,1,16,13,16,20,18,18,18,14,1236950000000.0,0,0,0,0,0,1,0,0,0,0,0,0,0,0,0,0,0,0,0,0,0,0,0,0,0,0,0,0,0,0,0,0,0,0,0,0,0,1,0,0,1,0,0,0,0,0,0,0,James Milner,ÃÂ£13.50m ,34.0,175.0,Midfielder - Central Midfield,right,Liverpool FC,40.0,7.0,4.0,3437.0,47.0,1.0,11.0,2787.0,45.0,7.0,7.0,2836.0,37.0,4.0,4.0,1708.0,7.0,0.0,0.0,305.0,Premier League,15-07-16,17.3.2.23,James Milner,5106363.0,765.0,04-Jan-86,30.0,61.0,1.0,46.0,9.0,6500.0,7600.0,7500.0,157.0,153.0,232186002.0,176.0,70.0,WB/DM/M/AM RLC,3.0,3.0,3.0,2.0,2.0,2.0,1.0,1.0,1.0,2.0,1.0,11.0,14.0,13.0,10.0,14.0,7.0,8.0,9.0,7.0,12.0,13.0,15.0,14.0,13.0,14.0,14.0,16.0,14.0,14.0,13.0,13.0,17.0,12.0,15.0,13.0,14.0,17.0,18.0,12.0,13.0,13.0,8.0,10.0,17.0,12.0,20.0,16.0,14.0,15.0,8.0,15.0,6.0,19.0,14.0,15.0,15.0,14.0,18.0,12.0,14.0,6.0,James Milner,ÃÂ£10.80m ,Premier League
19/6/2011,Henning Hauger,760385,786,7/17/1985,25,21,0,14,0,4750,6500,6400,138,130,142292,179,71,DM/M C,3,3,1,3,1,1,3,2,2,2,1,11,12,13,10,16,13,4,11,7,13,15,5,14,15,13,13,12,13,13,13,14,13,13,12,12,10,18,15,11,12,14,8,9,11,10,20,16,10,15,7,16,11,9,11,14,20,14,17,15,6,3,1,1,20,12,10,10,20,DM/M C,421,1,1,1,12,1,1,1,1,1,16,20,10,10,1,1,0.0,0,0,0,0,0,0,0,0,0,0,0,0,0,0,0,0,0,0,0,0,0,0,0,0,0,0,0,0,0,0,0,0,0,0,0,0,0,0,0,0,0,0,0,0,0,0,0,0,Henning Hauger,ÃÂ£900Th. ,35.0,179.0,Midfielder - Defensive Midfield,right,Without Club,16.0,0.0,2.0,1424.0,23.0,0.0,0.0,1547.0,21.0,2.0,2.0,1763.0,34.0,0.0,1.0,2922.0,33.0,1.0,0.0,2694.0,31.0,0.0,0.0,2343.0,28.0,0.0,1.0,2360.0,31.0,0.0,0.0,2506.0,15.0,0.0,1.0,756.0,Bundesliga,nan,nan,nan,nan,nan,nan,nan,nan,nan,nan,nan,nan,nan,nan,nan,nan,nan,nan,nan,nan,nan,nan,nan,nan,nan,nan,nan,nan,nan,nan,nan,nan,nan,nan,nan,nan,nan,nan,nan,nan,nan,nan,nan,nan,nan,nan,nan,nan,nan,nan,nan,nan,nan,nan,nan,nan,nan,nan,nan,nan,nan,nan,nan,nan,nan,nan,nan,nan,nan,nan,nan,nan,nan,nan,nan,nan,nan,nan,nan,nan,nan,nan,nan,nan,nan,nan,nan,nan,nan,nan,nan,nan
19/6/2011,HÃÂ©lder Castro,55008289,788,1/24/1986,25,0,0,0,0,1500,4700,4700,105,94,18360,174,71,AM C,1,3,1,2,1,1,2,1,3,1,3,11,12,13,11,14,13,9,13,9,9,13,13,10,14,10,12,10,10,11,12,12,11,14,10,13,10,10,11,12,13,10,9,3,12,12,20,12,11,11,8,10,9,12,9,13,14,12,12,13,13,7,1,1,15,20,10,10,20,AM C,501,1,1,1,20,10,10,1,1,1,1,15,1,1,1,1,0.0,0,0,0,0,0,0,0,0,0,0,0,0,0,0,0,0,0,0,0,0,0,0,0,0,0,0,0,0,0,0,0,0,0,0,0,0,0,0,0,0,0,0,0,0,0,0,0,0,HÃÂÃÂ©lder Castro,ÃÂ£540Th. ,34.0,174.0,Midfielder - Central Midfield,right,LusitÃÂÃÂ¢nia FC Lourosa,10.0,0.0,1.0,562.0,21.0,2.0,1.0,1161.0,28.0,6.0,4.0,2205.0,32.0,1.0,0.0,2169.0,6.0,0.0,0.0,289.0,4.0,1.0,0.0,185.0,nan,nan,nan,nan,26.0,5.0,0.0,1624.0,3.0,1.0,0.0,274.0,Liga NOS,3.0,1.0,0.0,127.0,nan,nan,nan,nan,nan,nan,nan,nan,nan,nan,nan,nan,nan,nan,nan,nan,nan,nan,nan,nan,nan,nan,nan,nan,nan,nan,nan,nan,nan,nan,nan,nan,nan,nan,nan,nan,nan,nan,nan,nan,nan,nan,nan,nan,nan,nan,nan,nan,nan,nan,nan,nan,nan,nan,nan,nan,nan,nan,nan,nan,nan,nan,nan,nan,nan,nan,nan,nan,nan,nan,nan,nan,nan,nan,nan,nan,nan,nan,nan,nan,nan,nan,nan,nan,nan,nan,nan,nan
19/6/2011,Hajime Hosogai,781280,116,6/10/1986,25,6,1,9,1,4650,5750,6000,137,120,111849,176,68,DM/M C,2,2,3,3,3,2,1,1,3,2,1,10,9,12,8,13,10,12,12,4,11,12,10,11,11,11,12,11,10,11,12,11,7,11,8,11,13,14,12,11,12,11,8,18,13,13,20,13,11,10,17,10,11,10,13,12,14,7,13,15,12,14,1,1,20,11,12,1,20,DM/M C,311,1,1,1,11,1,1,1,1,1,20,20,1,12,1,1,0.0,0,0,0,0,0,0,0,0,0,0,0,0,0,0,0,0,0,0,0,0,0,0,0,0,0,0,0,0,0,0,0,0,0,0,0,0,0,0,0,0,0,0,0,0,0,0,0,0,Hajime Hosogai,ÃÂ£2.70m ,34.0,177.0,Midfielder - Defensive Midfield,right,True Bangkok United,7.0,0.0,0.0,491.0,33.0,3.0,1.0,2829.0,23.0,0.0,0.0,1395.0,34.0,0.0,1.0,2889.0,22.0,0.0,1.0,1637.0,25.0,0.0,1.0,2001.0,32.0,0.0,0.0,1347.0,10.0,0.0,0.0,493.0,16.0,0.0,0.0,1204.0,Bundesliga,10.0,1.0,0.0,734.0,nan,nan,nan,nan,nan,nan,nan,nan,nan,nan,nan,nan,nan,nan,nan,nan,nan,nan,nan,nan,nan,nan,nan,nan,nan,nan,nan,nan,nan,nan,nan,nan,nan,nan,nan,nan,nan,nan,nan,nan,nan,nan,nan,nan,nan,nan,nan,nan,nan,nan,nan,nan,nan,nan,nan,nan,nan,nan,nan,nan,nan,nan,nan,nan,nan,nan,nan,nan,nan,nan,nan,nan,nan,nan,nan,nan,nan,nan,nan,nan,nan,nan,nan,nan,nan,nan,nan,nan
19/6/2011,Guillaume Loriot,8441954,769,5/21/1986,25,0,0,0,0,4300,5400,5400,135,120,167902,188,79,DM/M C,2,3,2,2,2,2,2,4,2,2,3,6,13,12,8,12,6,12,11,8,10,13,11,13,14,12,13,14,13,12,12,12,14,9,12,11,13,14,15,13,12,15,14,20,11,12,5,13,15,13,12,11,14,11,11,12,17,13,15,15,15,6,10,10,20,10,1,12,20,DM/M C,421,1,1,1,10,1,1,1,10,1,16,20,12,1,10,1,0.0,0,0,0,0,0,0,0,0,0,0,0,0,0,0,0,0,0,0,0,0,0,0,0,0,0,0,0,0,0,0,0,0,0,0,0,0,0,0,0,0,0,0,0,0,0,0,0,0,Guillaume Loriot,ÃÂ£360Th. ,34.0,188.0,Midfielder - Central Midfield,left,Retired,9.0,0.0,1.0,628.0,16.0,0.0,0.0,948.0,31.0,2.0,0.0,2656.0,17.0,3.0,0.0,1449.0,30.0,2.0,1.0,2382.0,11.0,1.0,0.0,815.0,17.0,0.0,0.0,945.0,7.0,0.0,0.0,431.0,nan,nan,nan,nan,Ligue 1,nan,nan,nan,nan,nan,nan,nan,nan,29/6/2010,Guillaume Loriot,8441954.0,769.0,5/21/1986,24.0,0.0,0.0,0.0,0.0,3721.0,5500.0,5500.0,135.0,122.0,2764325.0,188.0,79.0,DM/M C,2.0,1.0,3.0,3.0,2.0,3.0,2.0,8.0,2.0,3.0,2.0,6.0,13.0,12.0,11.0,12.0,6.0,12.0,11.0,8.0,11.0,13.0,11.0,13.0,13.0,12.0,13.0,13.0,13.0,12.0,12.0,12.0,13.0,10.0,11.0,11.0,14.0,14.0,15.0,13.0,12.0,15.0,13.0,20.0,13.0,13.0,5.0,14.0,13.0,14.0,12.0,11.0,9.0,11.0,16.0,12.0,17.0,13.0,15.0,15.0,15.0,6.0,Guillaume Loriot,ÃÂÃÂ£675Th. ,Ligue 1
19/6/2011,Fernando Gago,961083,1649,4/10/1986,25,28,0,15,0,6361,7513,7262,156,146,0,178,73,DM C,3,1,3,2,1,2,1,3,3,2,2,7,10,11,6,17,8,7,10,8,11,16,12,13,15,15,15,14,16,16,13,15,17,6,11,9,16,16,15,13,15,13,8,11,15,12,20,16,11,14,14,12,10,6,18,13,15,14,14,14,16,7,1,1,15,8,1,1,15,DM C,301,1,1,1,8,1,1,1,1,1,20,15,1,1,1,1,64.0,0,0,0,0,0,0,1,0,0,0,0,0,0,0,0,0,0,0,0,0,0,0,0,0,0,0,0,0,0,0,0,0,0,0,0,0,0,0,0,0,0,0,0,0,0,0,0,0,Fernando Gago,ÃÂ£5.85m ,34.0,177.0,Midfielder - Defensive Midfield,right,Club AtlÃÂ©tico VÃÂ©lez Sarsfield,7.0,0.0,0.0,193.0,32.0,1.0,3.0,2403.0,25.0,1.0,1.0,1747.0,26.0,0.0,5.0,2194.0,30.0,3.0,4.0,2297.0,18.0,1.0,0.0,1396.0,16.0,2.0,1.0,1434.0,11.0,0.0,0.0,660.0,8.0,0.0,0.0,720.0,Serie A,13.0,0.0,0.0,1034.0,nan,nan,nan,nan,29/6/2010,Fernando Gago,961083.0,1649.0,4/10/1986,24.0,28.0,0.0,15.0,0.0,5329.0,7750.0,7250.0,161.0,146.0,13423761.0,176.0,72.0,DM/M C,1.0,2.0,2.0,1.0,1.0,3.0,1.0,5.0,3.0,2.0,1.0,7.0,10.0,11.0,6.0,17.0,8.0,7.0,10.0,8.0,11.0,16.0,12.0,13.0,15.0,15.0,15.0,14.0,16.0,16.0,13.0,15.0,17.0,6.0,11.0,9.0,16.0,16.0,15.0,13.0,15.0,13.0,8.0,11.0,15.0,12.0,20.0,16.0,11.0,14.0,14.0,12.0,10.0,6.0,18.0,18.0,15.0,19.0,14.0,14.0,16.0,7.0,Fernando Gago,ÃÂÃÂ£8.10m ,LaLiga
19/6/2011,Fernando Alexandre,745269,788,8/2/1985,25,0,0,0,0,2750,5750,5750,118,112,593123,183,82,DM/M C,2,2,2,3,3,3,3,4,1,2,1,11,11,10,10,13,11,13,11,11,14,11,11,12,13,13,14,12,14,15,11,12,12,6,11,11,15,14,13,11,12,14,13,8,12,11,20,14,14,13,10,12,8,12,12,12,11,11,11,13,14,7,1,1,20,10,5,5,20,DM/M C,311,1,1,1,10,1,1,1,1,1,20,20,5,5,1,1,0.0,0,0,0,0,0,0,0,0,0,0,0,0,0,0,0,0,0,0,0,0,0,0,0,0,0,0,0,0,0,0,0,0,0,0,0,0,0,0,0,0,0,0,0,0,0,0,0,0,Fernando Alexandre,ÃÂ£900Th. ,35.0,184.0,Midfielder - Defensive Midfield,right,Retired,31.0,1.0,0.0,2666.0,29.0,0.0,0.0,2404.0,25.0,1.0,1.0,2159.0,29.0,3.0,0.0,2591.0,25.0,0.0,0.0,1930.0,29.0,3.0,0.0,2520.0,23.0,0.0,1.0,1982.0,10.0,1.0,0.0,378.0,16.0,1.0,0.0,959.0,Liga NOS,nan,nan,nan,nan,nan,nan,nan,nan,29/6/2010,Fernando Alexandre,745269.0,788.0,8/2/1985,24.0,0.0,0.0,0.0,0.0,2750.0,5750.0,5750.0,125.0,114.0,323592.0,183.0,82.0,DM/M C,3.0,2.0,2.0,3.0,1.0,3.0,3.0,4.0,2.0,3.0,1.0,11.0,11.0,10.0,10.0,13.0,11.0,13.0,11.0,11.0,14.0,11.0,11.0,12.0,13.0,13.0,14.0,12.0,14.0,15.0,11.0,12.0,12.0,6.0,11.0,11.0,15.0,14.0,13.0,11.0,12.0,14.0,13.0,8.0,12.0,11.0,20.0,14.0,14.0,13.0,10.0,12.0,8.0,12.0,8.0,12.0,2.0,11.0,11.0,13.0,14.0,7.0,Fernando Alexandre,ÃÂÃÂ£630Th. ,Liga NOS
19/6/2011,Eugen Polanski,894132,787,3/17/1986,25,0,0,0,0,5268,6511,6750,146,135,917928,183,73,DM/M C,3,1,2,3,1,2,3,1,3,2,2,10,8,10,8,12,11,11,14,8,15,12,12,14,11,18,12,17,8,16,11,14,17,7,16,12,9,14,18,13,13,13,11,10,16,14,20,17,17,13,12,10,7,13,10,18,9,12,14,11,13,11,1,1,20,12,12,12,20,DM/M C,421,1,1,1,12,1,1,1,1,1,18,20,12,12,1,1,1073742336.0,0,0,0,0,0,0,0,0,0,1,0,0,0,0,0,0,0,0,0,0,0,0,0,0,0,0,0,0,0,0,1,0,0,0,0,0,0,0,0,0,0,0,0,0,0,0,0,0,Eugen Polanski,ÃÂ£3.60m ,34.0,183.0,Midfielder - Defensive Midfield,right,Retired,29.0,0.0,4.0,2255.0,29.0,3.0,2.0,2245.0,26.0,0.0,3.0,1726.0,36.0,3.0,5.0,3053.0,33.0,6.0,0.0,2840.0,27.0,1.0,3.0,1758.0,14.0,0.0,0.0,631.0,14.0,0.0,1.0,579.0,nan,nan,nan,nan,Bundesliga,nan,nan,nan,nan,nan,nan,nan,nan,29/6/2010,Eugen Polanski,894132.0,771.0,3/17/1986,24.0,0.0,0.0,19.0,1.0,4000.0,6350.0,6650.0,142.0,133.0,1216095.0,183.0,73.0,DM/M C,1.0,1.0,1.0,2.0,3.0,1.0,2.0,3.0,3.0,2.0,1.0,10.0,8.0,10.0,8.0,12.0,11.0,11.0,16.0,8.0,15.0,12.0,12.0,15.0,11.0,18.0,8.0,17.0,8.0,16.0,11.0,15.0,17.0,7.0,16.0,12.0,9.0,15.0,18.0,13.0,12.0,10.0,11.0,10.0,16.0,14.0,20.0,17.0,16.0,13.0,12.0,10.0,7.0,13.0,10.0,18.0,9.0,12.0,14.0,11.0,13.0,11.0,Eugen Polanski,ÃÂÃÂ£3.60m ,Bundesliga,19-06-17,18.3.4.28,Eugen Polanski,894132,787,17-Mar-86,31,19,0,0,0,4250,6500,6250,134,130,3755196,183,73,DM/M C,2,3,2,3,3,2,1,3,1,2,2,11,10,7,8,12,11,10,12,10,13,13,14,14,11,18,13,17,12,16,10,13,18,6,15,8,15,18,13,9,9,14,11,20,16,12,16,15,15,16,16,15,7,13,10,17,12,14,16,10,9,8,1,1,20,14,10,10,20,DM/M C,311,1,1,1,14,9,9,1,1,1,20,20,10,10,1,1,512.0,0,0,0,0,0,0,0,0,0,1,0,0,0,0,0,0,0,0,0,0,0,0,0,0,0,0,0,0,0,0,0,0,0,0,0,0,0,0,0,0,0,0,0,0,0,0,0,0,Eugen Polanski,ÃÂ£900Th. ,34.0,183.0,Midfielder - Defensive Midfield,right,Retired,14.0,0.0,0.0,631.0,14.0,0.0,1.0,579.0,nan,nan,nan,nan,nan,nan,nan,nan,nan,nan,nan,nan,Bundesliga,15-07-16,17.3.2.23,Eugen Polanski,894132.0,787.0,17-Mar-86,30.0,19.0,0.0,0.0,0.0,4649.0,6149.0,6649.0,134.0,133.0,6684330.0,183.0,73.0,DM/M C,1.0,1.0,2.0,2.0,3.0,1.0,3.0,3.0,3.0,3.0,2.0,11.0,10.0,7.0,8.0,12.0,11.0,10.0,12.0,10.0,15.0,13.0,14.0,15.0,11.0,18.0,12.0,17.0,11.0,16.0,10.0,12.0,18.0,6.0,15.0,8.0,14.0,18.0,15.0,9.0,9.0,14.0,11.0,20.0,16.0,13.0,16.0,17.0,15.0,16.0,16.0,15.0,7.0,13.0,10.0,17.0,12.0,14.0,16.0,10.0,9.0,8.0,Eugen Polanski,ÃÂ£1.80m ,Bundesliga
19/6/2011,ÃÂderson,317312,1651,1/13/1986,25,1,0,0,0,5450,7150,6050,145,135,260585,181,74,M/AM LC,1,3,3,3,3,3,3,4,2,2,2,12,13,15,9,15,14,11,14,7,5,13,13,5,17,9,13,11,12,12,14,11,12,15,6,12,7,9,12,14,14,14,10,14,11,13,20,13,12,11,9,14,13,10,13,15,14,10,16,15,15,7,1,1,18,20,13,16,20,M/AM LC,524,1,1,10,20,16,13,1,1,1,7,18,16,13,1,1,1280.0,0,0,0,0,0,0,0,0,1,0,1,0,0,0,0,0,0,0,0,0,0,0,0,0,0,0,0,0,0,0,0,0,0,0,0,0,0,0,0,0,0,0,0,0,0,0,0,0,Ederson,ÃÂ£4.50m ,34.0,181.0,Midfielder - Attacking Midfield,right,Retired,8.0,2.0,0.0,428.0,25.0,2.0,0.0,1037.0,23.0,3.0,3.0,854.0,22.0,1.0,1.0,963.0,13.0,4.0,1.0,407.0,8.0,1.0,0.0,308.0,5.0,0.0,0.0,218.0,0.0,0.0,0.0,0.0,nan,nan,nan,nan,Ligue 1,nan,nan,nan,nan,nan,nan,nan,nan,nan,nan,nan,nan,nan,nan,nan,nan,nan,nan,nan,nan,nan,nan,nan,nan,nan,nan,nan,nan,nan,nan,nan,nan,nan,nan,nan,nan,nan,nan,nan,nan,nan,nan,nan,nan,nan,nan,nan,nan,nan,nan,nan,nan,nan,nan,nan,nan,nan,nan,nan,nan,nan,nan,nan,nan,nan,nan,nan,nan,nan,nan,nan,nan,nan,nan,nan,nan,nan,nan,nan,nan,nan,nan,nan,nan,nan,nan,nan,nan,nan,nan,nan,nan
19/6/2011,David Silva,7458280,796,1/8/1986,25,48,11,9,7,7750,8250,8400,175,168,18181818,170,67,AM RLC,2,1,2,1,2,1,1,1,3,2,2,15,16,18,13,19,12,8,12,7,5,18,13,8,19,10,13,11,17,15,19,17,15,19,10,18,8,14,11,16,18,10,5,20,11,13,11,14,7,15,9,13,13,13,13,16,13,15,11,12,13,7,1,1,15,20,15,19,20,AM RLC,506,1,1,9,20,19,15,1,1,1,4,15,13,10,1,1,2251820000000000.0,0,0,0,0,1,0,0,1,0,0,0,0,0,0,0,0,0,0,0,0,0,0,0,0,0,0,0,0,0,0,0,0,0,0,1,0,0,0,0,0,0,0,0,0,0,0,0,0,David Silva,ÃÂ£45.00m ,34.0,170.0,Midfielder - Attacking Midfield,left,Real Sociedad,53.0,6.0,14.0,3817.0,49.0,8.0,21.0,3876.0,41.0,5.0,13.0,3203.0,40.0,8.0,16.0,3043.0,42.0,12.0,14.0,3282.0,36.0,4.0,12.0,2793.0,45.0,8.0,11.0,3646.0,40.0,10.0,14.0,3198.0,50.0,10.0,14.0,3727.0,Premier League,40.0,6.0,11.0,2602.0,6.0,0.0,0.0,429.0,29/6/2010,David Silva,7458280.0,796.0,1/8/1986,24.0,38.0,7.0,9.0,7.0,6806.0,8250.0,8250.0,175.0,165.0,67304137.0,170.0,67.0,M/AM RLC,1.0,2.0,1.0,1.0,2.0,2.0,3.0,5.0,2.0,2.0,2.0,15.0,16.0,18.0,13.0,19.0,12.0,8.0,12.0,7.0,5.0,18.0,13.0,8.0,19.0,10.0,13.0,11.0,17.0,15.0,19.0,15.0,15.0,19.0,10.0,16.0,8.0,13.0,11.0,16.0,18.0,10.0,5.0,20.0,11.0,13.0,11.0,12.0,7.0,13.0,9.0,13.0,13.0,13.0,13.0,16.0,13.0,15.0,11.0,12.0,13.0,7.0,David Silva,ÃÂÃÂ£28.80m ,Premier League,19-06-17,18.3.4.28,David Silva,7458280,796,08-Jan-86,31,113,32,9,7,8100,8500,8650,178,178,232186002,173,67,M/AM RLC,3,2,2,3,4,2,2,2,1,1,1,13,13,18,12,19,12,7,12,7,5,19,12,9,19,10,14,11,17,15,19,18,15,19,10,18,8,15,14,13,17,19,5,20,13,13,13,13,8,16,9,13,12,13,13,16,13,15,11,12,13,7,1,1,20,20,15,15,20,M/AM RLC,416,1,1,9,20,15,15,1,1,1,4,20,15,15,1,1,2251820000000000.0,0,0,0,0,1,0,0,1,0,0,0,0,0,0,0,0,0,0,0,0,0,0,0,0,0,0,0,0,0,0,0,0,0,0,1,0,0,0,0,0,0,0,0,0,0,0,0,0,David Silva,ÃÂ£27.00m ,34.0,170.0,Midfielder - Attacking Midfield,left,Real Sociedad,45.0,8.0,11.0,3646.0,40.0,10.0,14.0,3198.0,50.0,10.0,14.0,3727.0,40.0,6.0,11.0,2602.0,7.0,0.0,2.0,505.0,Premier League,15-07-16,17.3.2.23,David Silva,7458280.0,796.0,08-Jan-86,30.0,103.0,24.0,9.0,7.0,8100.0,8500.0,8650.0,173.0,171.0,232186002.0,170.0,67.0,M/AM RLC,3.0,1.0,2.0,3.0,1.0,1.0,4.0,1.0,2.0,1.0,2.0,13.0,12.0,18.0,11.0,19.0,11.0,7.0,12.0,7.0,5.0,19.0,12.0,5.0,19.0,10.0,13.0,11.0,16.0,15.0,19.0,16.0,15.0,19.0,10.0,18.0,8.0,14.0,13.0,15.0,17.0,17.0,5.0,20.0,11.0,11.0,13.0,13.0,8.0,15.0,9.0,13.0,13.0,13.0,13.0,16.0,13.0,15.0,11.0,12.0,13.0,7.0,David Silva,ÃÂ£27.00m ,Premier League
19/6/2011,David Edwards,5111978,801,2/3/1986,25,22,3,9,1,4400,6150,5750,130,122,637573,186,71,M/AM RC,1,1,2,1,3,2,3,5,2,2,1,8,10,13,10,13,8,11,8,2,8,14,10,12,13,10,11,10,12,12,10,14,13,13,10,15,10,14,19,12,10,14,14,10,17,13,20,16,11,13,3,12,6,9,10,15,13,10,15,15,13,1,1,1,20,18,15,1,20,M/AM RC,413,1,1,4,18,1,15,1,1,1,1,20,1,15,1,1,36.0,0,0,1,0,0,1,0,0,0,0,0,0,0,0,0,0,0,0,0,0,0,0,0,0,0,0,0,0,0,0,0,0,0,0,0,0,0,0,0,0,0,0,0,0,0,0,0,0,David Edwards,ÃÂ£1.80m ,34.0,180.0,Midfielder - Central Midfield,right,Shrewsbury Town,19.0,1.0,0.0,1203.0,30.0,4.0,2.0,2192.0,27.0,2.0,1.0,1568.0,32.0,9.0,3.0,2129.0,44.0,8.0,2.0,2992.0,30.0,5.0,2.0,2360.0,49.0,10.0,4.0,4054.0,38.0,3.0,4.0,2846.0,6.0,0.0,0.0,247.0,Premier League,37.0,4.0,0.0,2612.0,1.0,0.0,0.0,74.0,29/6/2010,David Edwards,5111978.0,801.0,2/3/1986,24.0,19.0,3.0,9.0,1.0,3481.0,6150.0,5900.0,130.0,118.0,4322601.0,186.0,71.0,M/AM RC,3.0,2.0,3.0,3.0,2.0,2.0,3.0,4.0,2.0,1.0,2.0,8.0,10.0,13.0,8.0,13.0,8.0,11.0,8.0,2.0,8.0,14.0,10.0,11.0,12.0,10.0,11.0,10.0,12.0,10.0,10.0,14.0,13.0,13.0,10.0,15.0,10.0,14.0,18.0,11.0,10.0,14.0,14.0,10.0,17.0,12.0,20.0,16.0,11.0,13.0,3.0,12.0,6.0,9.0,10.0,15.0,13.0,10.0,15.0,15.0,13.0,1.0,David Edwards,ÃÂÃÂ£2.25m ,Premier League
19/6/2011,Daniel Brinkmann,8719018,771,1/29/1986,25,0,0,1,0,4000,5750,5750,122,115,420854,193,89,DM/M RC,3,3,1,3,1,2,1,2,2,2,3,14,12,13,9,14,10,9,11,10,9,12,10,13,14,13,13,12,12,9,12,13,10,13,12,13,14,13,13,11,10,15,16,7,12,12,20,12,13,12,7,12,11,9,6,11,12,11,7,10,8,7,10,12,20,13,15,1,20,DM/M RC,313,1,1,1,1,1,13,1,1,10,20,20,1,15,1,12,0.0,0,0,0,0,0,0,0,0,0,0,0,0,0,0,0,0,0,0,0,0,0,0,0,0,0,0,0,0,0,0,0,0,0,0,0,0,0,0,0,0,0,0,0,0,0,0,0,0,Daniel Brinkmann,ÃÂ£450Th. ,34.0,193.0,Midfielder - Central Midfield,right,Retired,25.0,0.0,4.0,1524.0,17.0,2.0,2.0,977.0,4.0,1.0,0.0,95.0,5.0,2.0,0.0,307.0,35.0,0.0,1.0,1821.0,7.0,0.0,0.0,630.0,15.0,0.0,0.0,800.0,26.0,3.0,5.0,1648.0,32.0,7.0,4.0,2264.0,Bundesliga,16.0,1.0,1.0,937.0,nan,nan,nan,nan,nan,nan,nan,nan,nan,nan,nan,nan,nan,nan,nan,nan,nan,nan,nan,nan,nan,nan,nan,nan,nan,nan,nan,nan,nan,nan,nan,nan,nan,nan,nan,nan,nan,nan,nan,nan,nan,nan,nan,nan,nan,nan,nan,nan,nan,nan,nan,nan,nan,nan,nan,nan,nan,nan,nan,nan,nan,nan,nan,nan,nan,nan,nan,nan,nan,nan,nan,nan,nan,nan,nan,nan,nan,nan,nan,nan,nan,nan,nan,nan,nan,nan,nan,nan
19/6/2011,Claudio Marchisio,1400716,776,1/19/1986,25,13,0,19,1,6500,7500,7350,155,147,2857735,180,71,DM/M C,3,2,1,2,2,1,2,7,1,1,3,10,13,14,14,14,6,8,14,9,9,14,15,14,14,13,15,11,14,10,14,16,12,13,15,16,14,15,13,14,14,14,10,9,13,13,20,15,13,12,6,17,7,14,7,15,12,15,12,14,14,8,1,1,20,9,11,11,20,DM/M C,421,1,1,1,8,9,1,1,1,1,18,20,11,11,1,1,549760000000.0,0,0,0,0,0,0,0,0,0,0,0,0,0,0,0,0,0,0,0,0,0,0,1,0,0,0,0,0,0,0,0,0,0,0,0,0,0,0,0,1,0,0,0,0,0,0,0,0,Claudio Marchisio,ÃÂ£20.70m ,34.0,180.0,Midfielder - Central Midfield,right,Retired,41.0,4.0,4.0,3517.0,39.0,10.0,4.0,3230.0,40.0,8.0,9.0,3401.0,43.0,4.0,2.0,2996.0,52.0,3.0,10.0,4340.0,32.0,0.0,2.0,2692.0,29.0,2.0,2.0,2043.0,20.0,0.0,1.0,1055.0,15.0,2.0,0.0,743.0,Serie A,nan,nan,nan,nan,nan,nan,nan,nan,29/6/2010,Claudio Marchisio,1400716.0,776.0,1/19/1986,24.0,6.0,0.0,19.0,1.0,5852.0,7650.0,7650.0,170.0,153.0,19866260.0,180.0,71.0,DM/M C,3.0,1.0,3.0,3.0,2.0,1.0,2.0,6.0,2.0,1.0,3.0,13.0,12.0,13.0,11.0,15.0,10.0,8.0,12.0,9.0,14.0,15.0,15.0,14.0,14.0,13.0,15.0,15.0,14.0,14.0,14.0,16.0,15.0,13.0,15.0,13.0,14.0,16.0,14.0,14.0,14.0,14.0,10.0,11.0,13.0,13.0,20.0,15.0,13.0,14.0,6.0,14.0,7.0,13.0,10.0,16.0,12.0,15.0,14.0,14.0,14.0,8.0,Claudio Marchisio,ÃÂÃÂ£16.20m ,Serie A,19-06-17,18.3.4.28,Claudio Marchisio,1400716,776,19-Jan-86,31,55,5,14,1,7000,8200,7900,172,159,232186002,180,74,DM/M C,3,2,3,3,1,1,2,2,2,1,2,5,12,12,11,15,6,8,14,7,14,16,14,15,16,13,16,15,17,14,13,16,15,13,12,14,16,18,17,12,13,15,9,12,12,13,20,14,12,16,8,13,14,13,7,15,20,15,18,15,16,6,1,1,20,9,10,10,20,DM/M C,311,1,1,1,9,5,1,1,1,1,20,20,10,10,1,1,8796100000000.0,0,0,0,1,0,0,0,0,1,0,0,0,0,0,0,0,0,0,0,0,0,0,1,0,0,0,0,0,0,0,0,0,0,0,0,0,0,0,0,0,0,0,0,1,0,0,0,0,Claudio Marchisio,ÃÂ£6.30m ,34.0,180.0,Midfielder - Central Midfield,right,Retired,29.0,2.0,2.0,2043.0,20.0,0.0,1.0,1055.0,15.0,2.0,0.0,743.0,nan,nan,nan,nan,nan,nan,nan,nan,Serie A,15-07-16,17.3.2.23,Claudio Marchisio,1400716.0,776.0,19-Jan-86,30.0,54.0,5.0,19.0,1.0,7250.0,8550.0,8450.0,172.0,168.0,232186002.0,180.0,71.0,DM/M C,1.0,3.0,3.0,2.0,4.0,1.0,1.0,1.0,4.0,2.0,2.0,5.0,12.0,13.0,11.0,16.0,6.0,8.0,14.0,7.0,14.0,17.0,12.0,15.0,16.0,13.0,16.0,15.0,17.0,14.0,15.0,17.0,15.0,13.0,14.0,14.0,16.0,18.0,18.0,14.0,13.0,15.0,9.0,12.0,11.0,13.0,20.0,14.0,13.0,15.0,6.0,15.0,12.0,13.0,7.0,15.0,18.0,15.0,16.0,15.0,16.0,6.0,Claudio Marchisio,ÃÂ£22.50m ,Serie A
19/6/2011,Christian Gentner,8707887,771,8/14/1985,25,5,0,11,1,5400,6850,6850,153,142,3566570,189,81,M/AM RLC,3,1,3,1,1,1,1,4,3,1,1,10,16,13,7,14,9,12,7,10,11,13,8,9,14,14,9,12,7,10,15,15,9,9,11,13,10,16,17,15,10,12,14,20,17,15,17,17,11,11,8,12,4,17,13,17,11,15,14,16,19,12,1,1,20,16,16,19,20,M/AM RLC,416,1,1,1,16,16,15,1,1,1,14,20,19,16,1,1,0.0,0,0,0,0,0,0,0,0,0,0,0,0,0,0,0,0,0,0,0,0,0,0,0,0,0,0,0,0,0,0,0,0,0,0,0,0,0,0,0,0,0,0,0,0,0,0,0,0,Christian Gentner,ÃÂ£4.50m ,35.0,189.0,Midfielder - Central Midfield,right,1.FC Union Berlin,42.0,8.0,3.0,2906.0,32.0,5.0,3.0,1735.0,52.0,9.0,8.0,4563.0,33.0,5.0,5.0,2970.0,34.0,5.0,4.0,3031.0,32.0,5.0,5.0,2816.0,36.0,7.0,4.0,3112.0,29.0,3.0,2.0,2595.0,32.0,1.0,5.0,2231.0,Bundesliga,34.0,4.0,3.0,2628.0,4.0,0.0,0.0,198.0,29/6/2010,Christian Gentner,8707887.0,771.0,8/14/1985,24.0,4.0,0.0,11.0,1.0,4100.0,6850.0,6850.0,156.0,145.0,18252297.0,189.0,81.0,M/AM RLC,3.0,1.0,1.0,1.0,2.0,2.0,1.0,5.0,3.0,2.0,2.0,10.0,16.0,13.0,7.0,14.0,9.0,12.0,7.0,10.0,11.0,13.0,8.0,10.0,14.0,14.0,9.0,12.0,7.0,10.0,16.0,15.0,9.0,9.0,12.0,14.0,10.0,16.0,17.0,15.0,10.0,13.0,16.0,20.0,17.0,15.0,17.0,17.0,11.0,11.0,8.0,12.0,4.0,17.0,13.0,14.0,18.0,12.0,12.0,10.0,8.0,19.0,Christian Gentner,ÃÂÃÂ£4.50m ,Bundesliga,19-06-17,18.3.4.28,Christian Gentner,8707887,771,14-Aug-85,31,5,0,11,1,5250,6750,6750,143,135,232186002,189,81,DM/M C,2,1,2,2,3,1,3,2,1,2,4,12,15,12,10,14,9,13,12,8,9,13,10,10,14,16,10,12,11,14,14,13,13,11,12,14,10,16,17,12,10,11,14,20,17,14,15,16,12,15,6,15,4,16,7,10,17,13,17,15,12,6,1,1,20,14,12,12,20,DM/M C,311,1,1,1,14,12,12,1,1,1,20,20,12,12,1,1,0.0,0,0,0,0,0,0,0,0,0,0,0,0,0,0,0,0,0,0,0,0,0,0,0,0,0,0,0,0,0,0,0,0,0,0,0,0,0,0,0,0,0,0,0,0,0,0,0,0,Christian Gentner,ÃÂ£1.80m ,35.0,189.0,Midfielder - Central Midfield,right,1.FC Union Berlin,36.0,7.0,4.0,3112.0,29.0,3.0,2.0,2595.0,32.0,1.0,5.0,2231.0,34.0,4.0,3.0,2628.0,4.0,0.0,0.0,198.0,Bundesliga,nan,nan,nan,nan,nan,nan,nan,nan,nan,nan,nan,nan,nan,nan,nan,nan,nan,nan,nan,nan,nan,nan,nan,nan,nan,nan,nan,nan,nan,nan,nan,nan,nan,nan,nan,nan,nan,nan,nan,nan,nan,nan,nan,nan,nan,nan,nan,nan,nan,nan,nan,nan,nan,nan,nan,nan,nan,nan,nan,nan,nan,nan,nan,nan,nan,nan,nan,nan,nan,nan,nan,nan,nan,nan,nan,nan,nan,nan,nan,nan,nan,nan,nan,nan,nan
19/6/2011,Charlie Adam,5208257,793,12/10/1985,25,11,1,5,1,5500,7000,7250,152,137,6482222,186,83,M/AM C,3,2,2,1,1,2,2,2,3,3,3,16,14,14,15,15,16,15,15,10,12,16,16,10,15,16,14,13,13,11,17,9,15,16,16,13,11,15,13,10,10,14,11,20,12,9,12,14,13,15,10,15,5,14,14,15,10,18,13,12,15,2,1,1,20,16,1,13,20,M/AM C,411,1,1,1,16,5,1,1,1,1,1,20,13,1,1,1,149602000000000.0,0,0,0,0,0,0,0,1,1,0,0,0,0,0,0,0,0,0,0,0,0,0,0,0,0,0,0,0,0,0,0,0,0,0,0,0,1,0,0,0,0,0,0,1,0,0,0,1,Charlie Adam,ÃÂ£7.20m ,34.0,185.0,Midfielder - Central Midfield,left,Dundee FC,37.0,13.0,8.0,3189.0,35.0,2.0,10.0,2665.0,30.0,3.0,6.0,1941.0,35.0,9.0,4.0,1972.0,36.0,7.0,1.0,1918.0,25.0,1.0,1.0,1305.0,30.0,2.0,4.0,1920.0,17.0,1.0,1.0,902.0,20.0,1.0,1.0,938.0,Premier League,28.0,2.0,4.0,1128.0,3.0,1.0,0.0,239.0,29/6/2010,Charlie Adam,5208257.0,793.0,12/10/1985,24.0,4.0,0.0,5.0,1.0,4290.0,6250.0,6350.0,140.0,131.0,7591611.0,186.0,83.0,M/AM LC,1.0,3.0,1.0,3.0,3.0,3.0,1.0,1.0,2.0,1.0,2.0,13.0,14.0,14.0,14.0,14.0,13.0,12.0,15.0,10.0,10.0,16.0,16.0,14.0,15.0,13.0,14.0,13.0,13.0,9.0,17.0,10.0,15.0,16.0,15.0,12.0,9.0,15.0,13.0,9.0,10.0,14.0,13.0,20.0,12.0,9.0,12.0,13.0,11.0,15.0,10.0,15.0,5.0,15.0,14.0,15.0,16.0,18.0,13.0,15.0,17.0,2.0,Charlie Adam,ÃÂÃÂ£4.05m ,Premier League,19-06-17,18.3.4.28,Charlie Adam,5208257,793,10-Dec-85,31,26,0,5,1,5400,6100,6550,140,126,9165059,186,83,M C,3,1,2,3,1,2,2,2,2,1,2,19,15,14,12,12,14,14,14,9,12,16,14,9,14,15,13,15,11,12,16,9,14,16,16,14,12,14,15,10,10,14,12,20,13,8,14,9,15,13,10,15,5,13,14,15,10,16,13,12,15,2,1,1,20,15,1,11,20,M C,401,1,1,1,15,5,1,1,1,1,15,20,11,1,1,1,149535000000000.0,0,0,0,0,0,0,0,1,1,0,0,0,0,0,0,0,0,0,0,0,0,0,0,0,0,0,0,0,0,0,1,0,0,0,0,0,0,0,0,0,0,0,0,1,0,0,0,1,Charlie Adam,ÃÂ£2.25m ,34.0,185.0,Midfielder - Central Midfield,left,Dundee FC,30.0,2.0,4.0,1920.0,17.0,1.0,1.0,902.0,20.0,1.0,1.0,938.0,28.0,2.0,4.0,1128.0,3.0,1.0,0.0,239.0,Premier League,15-07-16,17.3.2.23,Charlie Adam,5208257.0,793.0,10-Dec-85,30.0,26.0,0.0,5.0,1.0,5400.0,6100.0,6650.0,140.0,127.0,7656722.0,186.0,83.0,M C,2.0,1.0,2.0,3.0,1.0,3.0,2.0,3.0,1.0,2.0,2.0,19.0,15.0,14.0,12.0,12.0,14.0,14.0,14.0,9.0,12.0,16.0,14.0,9.0,14.0,15.0,13.0,15.0,11.0,12.0,16.0,9.0,14.0,16.0,16.0,14.0,12.0,14.0,15.0,10.0,10.0,14.0,12.0,20.0,13.0,8.0,14.0,13.0,15.0,13.0,10.0,15.0,5.0,13.0,14.0,15.0,10.0,16.0,13.0,12.0,15.0,2.0,Charlie Adam,ÃÂ£3.15m ,Premier League
19/6/2011,Carlos SÃÂ¡nchez,78011012,1653,2/6/1986,25,8,1,0,0,5000,6750,6500,145,125,650180,182,82,DM/M C,3,3,1,1,1,1,3,1,2,2,1,8,11,11,8,13,9,13,10,6,13,12,11,12,13,14,15,14,12,11,10,13,13,8,13,9,12,16,14,13,11,15,11,10,15,12,20,16,15,13,12,14,6,10,12,13,10,13,15,15,12,10,10,1,20,5,10,1,20,DM/M C,421,1,1,1,5,1,1,10,1,1,18,20,1,10,1,1,33554688.0,0,0,0,0,0,0,0,0,1,0,0,0,0,0,0,0,0,0,0,0,0,0,0,0,0,1,0,0,0,0,0,0,0,0,0,0,0,0,0,0,0,0,0,0,0,0,0,0,Carlos SÃÂ¡nchez,ÃÂ£2.70m ,34.0,182.0,Midfielder - Defensive Midfield,left,Without Club,31.0,2.0,1.0,2613.0,23.0,0.0,1.0,1772.0,31.0,2.0,1.0,2320.0,31.0,0.0,1.0,2216.0,34.0,1.0,1.0,2345.0,23.0,0.0,0.0,1623.0,41.0,1.0,1.0,2714.0,25.0,1.0,0.0,1664.0,9.0,0.0,0.0,313.0,Ligue 1,10.0,0.0,1.0,428.0,nan,nan,nan,nan,29/6/2010,Carlos SÃÂ¡nchez,78011012.0,1653.0,2/6/1986,24.0,8.0,1.0,0.0,0.0,4096.0,5759.0,5750.0,145.0,128.0,3141362.0,182.0,82.0,DM/M C,1.0,3.0,2.0,3.0,1.0,2.0,1.0,2.0,2.0,1.0,2.0,8.0,11.0,11.0,8.0,13.0,9.0,13.0,10.0,6.0,13.0,13.0,11.0,12.0,13.0,14.0,15.0,14.0,13.0,12.0,12.0,13.0,13.0,8.0,13.0,9.0,12.0,16.0,14.0,13.0,11.0,14.0,11.0,10.0,15.0,12.0,20.0,16.0,14.0,13.0,12.0,14.0,6.0,10.0,12.0,13.0,10.0,13.0,15.0,15.0,12.0,10.0,Carlos SÃÂÃÂ¡nchez,ÃÂÃÂ£3.33m ,Ligue 1,19-06-17,18.3.4.28,Carlos SÃÂ¡nchez,78011012,1653,06-Feb-86,31,74,0,0,0,5250,7250,6800,143,136,232186002,182,82,DM/M C,2,1,2,1,3,3,1,2,3,2,1,7,9,11,9,13,9,13,12,8,14,13,10,14,13,14,15,16,16,14,12,11,12,8,13,11,14,14,16,12,11,15,11,10,15,13,20,15,15,12,12,16,6,11,12,14,10,13,14,14,12,10,15,1,20,1,1,8,20,DM/M C,421,1,1,1,1,1,1,15,8,1,19,20,1,1,1,1,33554688.0,0,0,0,0,0,0,0,0,1,0,0,0,0,0,0,0,0,0,0,0,0,0,0,0,0,1,0,0,0,0,0,0,0,0,0,0,0,0,0,0,0,0,0,0,0,0,0,0,Carlos SÃÂ¡nchez,ÃÂ£1.80m ,34.0,182.0,Midfielder - Defensive Midfield,left,Without Club,41.0,1.0,1.0,2714.0,25.0,1.0,0.0,1664.0,9.0,0.0,0.0,313.0,10.0,0.0,1.0,428.0,nan,nan,nan,nan,Serie A,15-07-16,17.3.2.23,Carlos SÃÂ¡nchez,78011012.0,1653.0,06-Feb-86,30.0,67.0,0.0,0.0,0.0,6000.0,7000.0,6700.0,140.0,135.0,232186002.0,182.0,82.0,DM/M C,1.0,1.0,1.0,2.0,2.0,4.0,3.0,2.0,3.0,1.0,2.0,7.0,11.0,12.0,7.0,14.0,9.0,13.0,12.0,6.0,14.0,11.0,11.0,13.0,13.0,14.0,15.0,15.0,16.0,12.0,11.0,10.0,12.0,8.0,13.0,9.0,13.0,14.0,15.0,12.0,10.0,15.0,11.0,10.0,15.0,12.0,20.0,14.0,16.0,12.0,14.0,16.0,6.0,10.0,12.0,14.0,10.0,13.0,14.0,14.0,12.0,10.0,Carlos SÃÂ¡nchez,ÃÂ£2.70m ,Serie A
19/6/2011,Blerim Dzemaili,5725580,798,4/12/1986,25,13,0,0,0,3500,7500,7100,155,142,826226,179,73,DM/M C,1,2,3,1,2,3,2,4,2,1,2,8,11,12,11,15,11,10,14,12,13,16,12,15,16,11,13,13,10,12,13,13,10,8,15,15,13,16,15,13,12,14,9,8,7,12,20,16,12,13,10,14,14,16,10,6,6,6,8,13,12,17,10,1,20,1,10,10,20,DM/M C,421,1,1,1,1,1,1,10,1,1,18,20,10,10,1,1,137439000000.0,0,0,0,0,0,0,0,0,0,0,0,0,0,0,0,0,0,0,0,0,0,0,0,0,0,0,0,0,0,0,0,0,0,0,0,0,0,1,0,0,0,0,0,0,0,0,0,0,Blerim Dzemaili,ÃÂ£6.30m ,34.0,180.0,Midfielder - Central Midfield,right,Without Club,31.0,1.0,1.0,2337.0,39.0,3.0,3.0,2458.0,41.0,9.0,3.0,2512.0,29.0,6.0,4.0,1882.0,20.0,1.0,2.0,1229.0,27.0,3.0,1.0,1786.0,58.0,17.0,15.0,4885.0,15.0,1.0,1.0,1195.0,30.0,2.0,1.0,1860.0,Serie A,14.0,1.0,1.0,695.0,nan,nan,nan,nan,29/6/2010,Blerim Dzemaili,5725580.0,798.0,4/12/1986,24.0,10.0,0.0,0.0,0.0,3500.0,6250.0,6400.0,145.0,132.0,6999999.0,179.0,73.0,DM/M C,3.0,3.0,3.0,1.0,2.0,3.0,1.0,3.0,1.0,3.0,3.0,8.0,11.0,12.0,11.0,15.0,10.0,10.0,14.0,4.0,12.0,15.0,8.0,13.0,15.0,11.0,12.0,13.0,10.0,12.0,12.0,13.0,10.0,8.0,15.0,15.0,12.0,16.0,15.0,13.0,12.0,14.0,9.0,8.0,7.0,12.0,20.0,14.0,11.0,13.0,14.0,10.0,14.0,13.0,9.0,6.0,14.0,8.0,11.0,13.0,13.0,5.0,Blerim Dzemaili,ÃÂÃÂ£4.50m ,Serie A,19-06-17,18.3.4.28,Blerim Dzemaili,5725580,798,12-Apr-86,31,58,7,16,4,5500,6700,6700,144,134,232186002,179,73,DM/M C,2,3,3,1,3,4,2,2,3,1,2,10,12,12,14,14,12,12,16,13,12,14,12,14,14,12,14,14,13,15,10,14,12,10,15,15,13,15,14,9,12,14,9,10,9,11,20,15,13,13,11,14,12,14,14,14,14,14,12,11,11,10,1,1,20,13,9,9,20,DM/M C,421,1,1,1,13,1,1,1,1,1,16,20,9,9,1,1,256.0,0,0,0,0,0,0,0,0,1,0,0,0,0,0,0,0,0,0,0,0,0,0,0,0,0,0,0,0,0,0,0,0,0,0,0,0,0,0,0,0,0,0,0,0,0,0,0,0,Blerim Dzemaili,ÃÂ£2.25m ,34.0,180.0,Midfielder - Central Midfield,right,Without Club,58.0,17.0,15.0,4885.0,15.0,1.0,1.0,1195.0,30.0,2.0,1.0,1860.0,14.0,1.0,1.0,695.0,nan,nan,nan,nan,Serie A,15-07-16,17.3.2.23,Blerim Dzemaili,5725580.0,798.0,12-Apr-86,30.0,52.0,6.0,16.0,4.0,6000.0,6600.0,6600.0,144.0,133.0,232186002.0,179.0,73.0,DM/M C,1.0,3.0,3.0,3.0,3.0,1.0,1.0,3.0,2.0,2.0,2.0,9.0,12.0,12.0,14.0,14.0,12.0,12.0,16.0,12.0,12.0,14.0,12.0,13.0,14.0,12.0,14.0,14.0,13.0,15.0,10.0,14.0,12.0,10.0,15.0,15.0,12.0,15.0,14.0,9.0,12.0,15.0,9.0,10.0,9.0,11.0,20.0,15.0,13.0,13.0,11.0,14.0,12.0,14.0,14.0,14.0,14.0,14.0,12.0,11.0,11.0,10.0,Blerim Dzemaili,ÃÂ£2.70m ,Serie A
19/6/2011,Ben Watson,5113515,765,7/9/1985,25,0,0,1,0,4400,6300,6500,143,126,867359,178,69,M C,3,1,2,3,3,1,2,1,3,3,2,13,11,12,10,14,13,10,13,7,11,18,16,11,13,13,13,15,14,11,12,12,13,15,10,13,12,13,14,12,12,15,11,8,12,12,20,13,11,15,12,12,6,8,10,13,13,10,14,13,13,11,1,1,20,14,1,1,20,M C,401,1,1,1,14,1,1,1,1,1,11,20,1,1,1,1,8796160000000.0,0,0,0,0,0,0,0,1,0,0,0,0,0,0,0,0,0,0,0,0,0,0,0,0,0,0,1,0,0,0,0,0,0,0,0,0,0,0,0,0,0,0,0,1,0,0,0,0,Ben Watson,ÃÂ£2.70m ,35.0,178.0,Midfielder - Central Midfield,right,Charlton Athletic,36.0,4.0,2.0,2751.0,24.0,4.0,4.0,1465.0,15.0,2.0,3.0,842.0,33.0,5.0,4.0,2549.0,30.0,1.0,2.0,2333.0,41.0,1.0,3.0,3355.0,6.0,0.0,0.0,261.0,25.0,0.0,0.0,1880.0,21.0,0.0,0.0,1562.0,Premier League,45.0,3.0,4.0,4001.0,5.0,0.0,0.0,359.0,29/6/2010,Ben Watson,5113515.0,765.0,7/9/1985,24.0,0.0,0.0,1.0,0.0,3906.0,6150.0,6150.0,143.0,125.0,4600253.0,178.0,69.0,M C,1.0,3.0,1.0,1.0,2.0,3.0,2.0,3.0,1.0,3.0,2.0,14.0,11.0,12.0,10.0,14.0,13.0,10.0,13.0,7.0,11.0,14.0,16.0,11.0,13.0,13.0,13.0,15.0,14.0,11.0,12.0,12.0,13.0,15.0,10.0,13.0,12.0,13.0,14.0,12.0,12.0,15.0,11.0,8.0,12.0,12.0,20.0,13.0,11.0,15.0,12.0,12.0,6.0,8.0,10.0,13.0,13.0,10.0,14.0,13.0,13.0,11.0,Ben Watson,ÃÂÃÂ£2.25m ,Premier League
19/6/2011,Alexander Tettey,762026,786,4/4/1986,25,7,0,12,0,3650,5804,5800,145,129,312603,180,75,DM/M C,1,1,3,2,2,2,3,4,2,3,1,5,11,7,10,11,6,10,12,3,12,11,7,13,11,15,16,12,8,11,8,11,15,8,14,14,14,17,19,13,11,12,12,12,17,14,20,18,15,14,10,15,5,9,11,15,14,12,16,14,15,5,12,1,18,1,1,8,18,DM/M C,311,1,1,1,1,1,1,12,1,1,20,18,8,1,1,1,616.0,0,0,0,1,0,1,1,0,0,1,0,0,0,0,0,0,0,0,0,0,0,0,0,0,0,0,0,0,0,0,0,0,0,0,0,0,0,0,0,0,0,0,0,0,0,0,0,0,Alexander Tettey,ÃÂ£2.03m ,34.0,181.0,Midfielder - Defensive Midfield,right,Norwich City,20.0,4.0,2.0,1603.0,32.0,1.0,0.0,1716.0,31.0,1.0,2.0,2163.0,22.0,1.0,0.0,1608.0,39.0,1.0,1.0,3223.0,23.0,2.0,0.0,1952.0,37.0,0.0,0.0,3050.0,27.0,0.0,1.0,2125.0,32.0,1.0,0.0,2558.0,Ligue 1,32.0,1.0,1.0,2502.0,1.0,0.0,0.0,90.0,29/6/2010,Alexander Tettey,762026.0,786.0,4/4/1986,24.0,5.0,0.0,12.0,0.0,3300.0,5804.0,5800.0,145.0,129.0,8715086.0,180.0,75.0,DM/M C,3.0,3.0,3.0,1.0,2.0,1.0,3.0,8.0,2.0,2.0,3.0,5.0,11.0,7.0,10.0,11.0,6.0,10.0,12.0,3.0,12.0,11.0,7.0,13.0,11.0,15.0,16.0,12.0,8.0,11.0,8.0,11.0,15.0,8.0,14.0,14.0,14.0,17.0,19.0,13.0,11.0,12.0,12.0,12.0,17.0,14.0,20.0,18.0,15.0,14.0,10.0,15.0,5.0,9.0,12.0,15.0,14.0,12.0,16.0,14.0,15.0,5.0,Alexander Tettey,ÃÂÃÂ£2.70m ,Ligue 1
19/6/2011,Adam Nemec,7562297,794,9/2/1985,25,2,0,0,0,4014,6071,6250,134,125,192038,190,84,M/AM/S C,2,2,2,3,1,1,3,3,3,2,2,2,8,11,12,14,3,16,8,8,13,14,7,14,13,4,14,14,11,16,11,13,13,12,10,12,15,19,20,10,4,19,17,8,13,11,20,18,19,13,5,11,9,7,8,12,11,9,12,13,9,9,1,1,17,20,1,1,20,M/AM/S C,531,1,1,20,20,1,1,1,1,1,1,17,1,1,1,1,262144.0,0,0,0,0,0,0,0,0,0,0,0,0,0,0,0,0,0,0,1,0,0,0,0,0,0,0,0,0,0,0,0,0,0,0,0,0,0,0,0,0,0,0,0,0,0,0,0,0,Adam Nemec,ÃÂ£630Th. ,35.0,190.0,Forward - Centre-Forward,both,Dinamo Bucharest,27.0,4.0,2.0,1073.0,24.0,5.0,1.0,1523.0,30.0,9.0,2.0,2221.0,29.0,5.0,2.0,1661.0,18.0,2.0,1.0,1034.0,19.0,6.0,0.0,1095.0,31.0,13.0,3.0,2263.0,33.0,7.0,4.0,2188.0,28.0,16.0,2.0,2407.0,Bundesliga,14.0,1.0,3.0,1125.0,5.0,1.0,0.0,450.0,29/6/2010,Adam Nemec,7562297.0,794.0,9/2/1985,24.0,1.0,0.0,0.0,0.0,3906.0,6050.0,6250.0,134.0,125.0,2762056.0,192.0,90.0,S C,3.0,3.0,3.0,2.0,3.0,3.0,1.0,1.0,2.0,2.0,3.0,8.0,8.0,12.0,13.0,13.0,8.0,16.0,11.0,11.0,10.0,14.0,11.0,14.0,14.0,12.0,16.0,14.0,11.0,18.0,12.0,14.0,13.0,8.0,12.0,8.0,16.0,19.0,20.0,7.0,4.0,19.0,18.0,10.0,11.0,11.0,20.0,18.0,19.0,14.0,12.0,12.0,9.0,7.0,8.0,12.0,11.0,9.0,12.0,13.0,9.0,9.0,Adam Nemec,ÃÂÃÂ£1.35m ,Bundesliga
