GameDate,Name,UID,NationID,Born,Age,IntCaps,IntGoals,U21Caps,U21Goals,WorldReputation,HomeReputation,CurrentReputation,PA,CA,Price,Height,Weight,PositionsString,GK.AerialAbility,GK.CommandOfArea,GK.Communication,GK.Eccentricity,GK.Handling,GK.Kicking,GK.OneOnOnes,GK.Reflexes,GK.RushingOut,GK.TendencyToPunch,GK.Throwing,Tech.Corners,Tech.Crossing,Tech.Dribbling,Tech.Finishing,Tech.FirstTouch,Tech.Freekicks,Tech.Heading,Tech.LongShots,Tech.Longthrows,Tech.Marking,Tech.Passing,Tech.PenaltyTaking,Tech.Tackling,Tech.Technique,Mental.Aggression,Mental.Anticipation,Mental.Bravery,Mental.Composure,Mental.Concentration,Mental.Vision,Mental.Decisions,Mental.Determination,Mental.Flair,Mental.Leadership,Mental.OffTheBall,Mental.Positioning,Mental.Teamwork,Mental.Workrate,Phy.Acceleration,Phy.Agility,Phy.Balance,Phy.Jumping,Phy.LeftFoot,Phy.NaturalFitness,Phy.Pace,Phy.RightFoot,Phy.Stamina,Phy.Strength,Hidden.Consistency,Hidden.Dirtiness,Hidden.ImportantMatches,Hidden.InjuryProness,Hidden.Versatility,Personality.Adaptability,Personality.Ambition,Personality.Loyalty,Personality.Pressure,Personality.Professional,Personality.Sportsmanship,Personality.Temperament,Personality.Controversy,Positions.Defender,Positions.WingBack,Positions.Midfielder,Positions.AttackingMidfielder,Positions.Right,Positions.Left,Positions.Centre,Positions.PositionsDesc,Positions.PositionsDescVal,Positions.Goalkeeper,Positions.Sweeper,Positions.Striker,Positions.AttackingMidCentral,Positions.AttackingMidLeft,Positions.AttackingMidRight,Positions.DefenderCentral,Positions.DefenderLeft,Positions.DefenderRight,Positions.DefensiveMidfielder,Positions.MidfielderCentral,Positions.MidfielderLeft,Positions.MidfielderRight,Positions.WingBackLeft,Positions.WingBackRight,PPMVal,PPM0,PPM1,PPM2,PPM3,PPM4,PPM5,PPM6,PPM7,PPM8,PPM9,PPM10,PPM11,PPM12,PPM13,PPM14,PPM15,PPM16,PPM17,PPM18,PPM19,PPM20,PPM21,PPM22,PPM23,PPM24,PPM25,PPM26,PPM27,PPM28,PPM29,PPM30,PPM31,PPM32,PPM33,PPM34,PPM35,PPM36,PPM37,PPM38,PPM39,PPM40,PPM41,PPM42,PPM43,PPM44,PPM45,PPM46,PPM47,name,Market Value,age,height,position,foot,current club,10/11 games,10/11 goals/conceded,10/11 assists/clean,10/11 minutes,11/12 games,11/12 goals/conceded,11/12 assists/clean,11/12 minutes,12/13 games,12/13 goals/conceded,12/13 assists/clean,12/13 minutes,13/14 games,13/14 goals/conceded,13/14 assists/clean,13/14 minutes,14/15 games,14/15 goals/conceded,14/15 assists/clean,14/15 minutes,15/16 games,15/16 goals/conceded,15/16 assists/clean,15/16 minutes,16/17 games,16/17 goals/conceded,16/17 assists/clean,16/17 minutes,17/18 games,17/18 goals/conceded,17/18 assists/clean,17/18 minutes,18/19 games,18/19 goals/conceded,18/19 assists/clean,18/19 minutes,current league,19/20 games,19/20 goals/conceded,19/20 assists/clean,19/20 minutes,20/21 games,20/21 goals/conceded,20/21 assists/clean,20/21 minutes
19/6/2011,Jacopo Rubens Piacenza,43090628,776,3/25/1994,17,0,0,0,0,89,1500,1500,50,35,231,170,68,D R,2,1,3,1,1,1,2,1,2,2,3,1,6,3,1,9,3,5,4,4,8,7,3,12,5,6,6,13,5,8,7,6,10,10,6,2,8,10,11,11,10,14,7,6,12,9,20,7,5,9,5,10,9,8,10,16,7,12,13,11,9,12,20,5,1,1,20,1,1,D R,102,1,1,1,1,1,1,1,1,20,1,1,1,1,1,5,0,0,0,0,0,0,0,0,0,0,0,0,0,0,0,0,0,0,0,0,0,0,0,0,0,0,0,0,0,0,0,0,0,0,0,0,0,0,0,0,0,0,0,0,0,0,0,0,0,,,,,,,,,,,,,,,,,,,,,,,,,,,,,,,,,,,,,,,,,,,,,,,,,,,,
19/6/2011,Danny da Costa,92028423,771,7/13/1993,17,0,0,0,0,1518,5284,5284,149,105,371324,186,81,D RC,1,2,2,3,1,2,2,5,2,3,3,3,6,7,2,9,3,10,7,5,9,8,9,13,7,14,10,11,6,13,9,14,9,3,11,6,14,10,13,14,13,14,10,11,10,14,20,11,8,10,3,10,17,10,5,17,11,13,13,14,14,15,20,6,1,1,20,9,17,D RC,103,1,1,1,1,1,1,17,9,20,1,1,1,1,1,6,0,0,0,0,0,0,0,0,0,0,0,0,0,0,0,0,0,0,0,0,0,0,0,0,0,0,0,0,0,0,0,0,0,0,0,0,0,0,0,0,0,0,0,0,0,0,0,0,0,Danny da Costa,£900Th. ,27,187,Defender - Right-Back,right,Eintracht Frankfurt,28,2,2,2381,13,0,1,779,28,0,1,2445,30,0,2,2648,13,0,1,1121,23,0,4,1792,4,0,1,198,21,1,5,1417,50,4,5,4472,Bundesliga,37,4,10,2496,4,0,0,178
19/6/2011,Willi Orban,91011532,771,11/3/1992,18,0,0,0,0,50,4600,4600,135,95,190795,185,84,D RLC,3,3,2,3,3,1,3,4,3,1,3,4,7,2,3,9,4,14,4,3,10,9,10,14,9,4,12,6,9,9,9,12,10,14,8,5,12,10,14,14,11,11,13,15,11,11,20,10,6,10,7,10,9,10,10,3,14,9,13,12,12,12,20,1,1,1,17,17,20,D RLC,106,1,1,1,1,1,1,20,17,17,1,1,1,1,1,1,0,0,0,0,0,0,0,0,0,0,0,0,0,0,0,0,0,0,0,0,0,0,0,0,0,0,0,0,0,0,0,0,0,0,0,0,0,0,0,0,0,0,0,0,0,0,0,0,0,Willi Orban,£225Th. ,27,186,Defender - Centre-Back,right,RB Leipzig,29,5,0,2610,25,3,3,2163,21,5,0,1652,32,3,2,2468,34,4,1,3006,33,1,1,2934,29,3,1,2638,37,4,1,3038,39,4,1,3382,Bundesliga,18,1,1,1247,5,1,1,332
19/6/2011,Eugenio Giannetti,43086980,776,1/11/1993,18,0,0,0,0,177,2800,2800,84,64,4382,178,75,D R,3,2,1,2,2,2,1,1,1,1,3,4,3,4,2,7,1,7,3,9,10,8,3,13,9,5,9,9,12,9,5,8,8,5,4,4,6,15,11,13,10,7,6,8,16,11,20,8,3,10,12,10,10,10,14,6,12,11,12,9,9,16,20,5,1,1,20,4,1,D R,102,1,1,1,1,1,1,1,4,20,1,1,1,1,1,5,0,0,0,0,0,0,0,0,0,0,0,0,0,0,0,0,0,0,0,0,0,0,0,0,0,0,0,0,0,0,0,0,0,0,0,0,0,0,0,0,0,0,0,0,0,0,0,0,0,,,,,,,,,,,,,,,,,,,,,,,,,,,,,,,,,,,,,,,,,,,,,,,,,,,,
19/6/2011,Santiago Arias,76015950,1653,1/13/1992,19,0,0,22,0,2505,4786,5011,149,105,2102647,176,68,D/WB R,2,2,2,3,3,1,2,1,3,3,3,10,12,11,5,11,6,8,9,8,10,11,9,10,11,10,10,11,11,10,10,10,14,9,11,7,12,11,11,13,12,11,7,7,13,12,20,14,11,10,4,10,7,10,9,12,10,12,13,13,13,6,20,20,1,1,20,9,1,D/WB R,112,1,1,1,1,1,1,1,9,20,1,1,1,1,1,20,0,0,0,0,0,0,0,0,0,0,0,0,0,0,0,0,0,0,0,0,0,0,0,0,0,0,0,0,0,0,0,0,0,0,0,0,0,0,0,0,0,0,0,0,0,0,0,0,0,Santiago Arias,£900Th. ,28,177,Defender - Right-Back,right,Bayer 04 Leverkusen,7,0,0,442,8,0,1,366,30,1,5,2506,34,1,5,2989,29,1,1,2296,42,3,4,3711,34,2,6,3021,35,3,6,3144,33,1,2,2477,Liga NOS,18,0,1,1394,1,0,0,90
19/6/2011,Peter Suswam,13106386,38,9/5/1991,19,0,0,0,0,3000,5500,5000,117,108,635177,185,79,D RL,3,3,2,1,3,1,2,4,1,3,3,7,8,7,8,11,10,10,11,12,11,9,11,13,11,13,12,11,12,10,9,10,11,10,9,12,11,12,11,12,12,11,12,12,13,12,20,12,13,12,8,10,9,14,8,4,12,12,12,14,14,7,20,7,7,1,20,15,7,D RL,105,1,1,1,1,1,1,7,15,20,7,1,1,7,7,5,0,0,0,0,0,0,0,0,0,0,0,0,0,0,0,0,0,0,0,0,0,0,0,0,0,0,0,0,0,0,0,0,0,0,0,0,0,0,0,0,0,0,0,0,0,0,0,0,0,Peter Suswam,£630Th. ,29,185,Defender - Right-Back,right,Victoria Skarszew,0,0,0,0,10,0,1,742,1,0,0,90,6,0,0,242,1,0,0,90,nan,nan,nan,nan,nan,nan,nan,nan,1,0,0,90,nan,nan,nan,nan,Liga NOS,nan,nan,nan,nan,nan,nan,nan,nan
19/6/2011,Nicolas Isimat-Mirin,85042905,769,11/15/1991,19,0,0,0,0,4100,5129,5100,149,114,932632,188,83,D RC,2,3,2,2,2,3,2,3,2,3,3,5,5,8,6,10,6,14,7,7,13,7,6,10,10,12,14,13,11,11,11,10,15,7,8,6,12,13,14,15,10,16,14,5,13,14,20,13,16,12,12,14,7,10,13,13,12,9,17,14,14,6,20,1,1,1,15,10,20,D RC,103,1,1,1,1,1,1,20,10,15,1,1,1,1,1,1,2.74878E+11,0,0,0,0,0,0,0,0,0,0,0,0,0,0,0,0,0,0,0,0,0,0,0,0,0,0,0,0,0,0,0,0,0,0,0,0,0,0,1,0,0,0,0,0,0,0,0,0,Nicolas Isimat-Mirin,£2.25m ,28,187,Defender - Centre-Back,right,Besiktas JK,13,0,0,838,36,2,1,3068,31,0,1,2697,11,0,0,959,25,1,0,1639,26,0,0,1703,37,2,0,3186,37,2,1,3356,20,1,0,1558,Ligue 1,16,1,0,1440,nan,nan,nan,nan
19/6/2011,Matthias Zimmermann,35017462,771,6/16/1992,19,0,0,0,0,2400,5600,5600,158,112,3791743,178,76,D/WB/DM/M RC,3,2,1,1,3,2,3,4,1,1,3,10,12,9,6,11,6,7,6,10,14,12,6,13,11,14,13,14,11,13,11,10,15,8,12,6,11,15,14,14,13,13,8,20,13,14,5,12,8,12,7,9,6,6,4,15,13,14,15,14,13,5,20,16,16,1,20,14,16,D/WB/DM/M RC,133,1,1,1,1,1,1,1,14,20,18,16,1,8,12,16,32800,0,0,0,0,0,1,0,0,0,0,0,0,0,0,0,1,0,0,0,0,0,0,0,0,0,0,0,0,0,0,0,0,0,0,0,0,0,0,0,0,0,0,0,0,0,0,0,0,Matthias Zimmermann,£900Th. ,28,177,Defender - Right-Back,right,Fortuna Düsseldorf,34,1,1,3042,14,1,1,1124,34,2,3,2775,21,0,1,1520,34,3,7,2849,36,1,1,2941,30,1,0,1726,7,0,0,427,36,1,3,3230,Bundesliga,38,2,4,3250,5,1,0,288
19/6/2011,Jason Lowe,28027434,765,9/2/1991,19,0,0,0,0,3100,5750,6000,137,105,740561,176,75,D/M RC,3,1,1,2,3,3,2,1,2,3,2,8,4,8,7,10,10,6,8,2,9,11,5,13,10,10,11,7,14,12,13,10,14,9,8,7,9,13,17,13,11,11,9,7,15,11,20,18,13,10,12,4,6,9,6,14,7,7,13,12,11,6,16,1,20,1,16,1,20,D/M RC,423,1,1,1,1,1,1,1,1,16,12,20,1,10,1,1,67108928,0,0,0,0,0,0,1,0,0,0,0,0,0,0,0,0,0,0,0,0,0,0,0,0,0,0,1,0,0,0,0,0,0,0,0,0,0,0,0,0,0,0,0,0,0,0,0,0,Jason Lowe,£1.35m ,29,183,Midfielder - Defensive Midfield,right,Salford City,18,2,2,1581,38,0,1,3117,42,0,3,3291,42,1,3,3592,14,0,0,1071,13,0,1,1050,49,0,3,4363,11,0,0,572,37,0,0,3197,Premier League,34,0,1,2947,10,0,1,900
19/6/2011,Frederik Sørensen,27020708,764,4/14/1992,19,0,0,0,0,3271,5198,5535,141,114,374057,193,71,D RC,3,2,2,1,3,1,2,5,1,1,3,5,7,4,4,6,5,13,5,14,12,9,5,15,6,8,12,14,12,12,6,8,13,5,10,6,15,13,14,12,8,13,16,10,14,13,20,14,13,12,5,13,8,14,17,12,12,17,14,15,14,5,20,1,1,1,16,1,20,D RC,103,1,1,1,1,1,1,20,1,16,1,1,1,1,1,1,4.50374E+15,0,0,0,0,0,0,1,0,0,0,0,0,0,0,0,1,0,0,0,0,0,0,0,0,0,0,0,0,0,0,0,0,1,0,0,0,0,1,0,0,0,0,0,0,0,0,0,0,Frederik Sörensen,£2.25m ,28,194,Defender - Centre-Back,right,1. FC Köln,26,0,1,1947,6,1,0,490,27,1,1,2034,16,0,0,1217,11,0,1,729,24,0,2,1854,33,0,3,2890,35,3,2,2632,6,0,0,136,Serie A,25,1,1,1976,3,0,0,97
19/6/2011,Diogo Figueiras,55013024,788,7/1/1991,19,0,0,0,0,750,1500,1500,116,87,229848,171,62,D R,3,1,1,2,1,3,1,1,2,1,2,9,13,10,7,11,9,6,8,10,9,10,10,11,12,11,10,8,10,9,10,10,7,10,7,13,9,10,12,13,13,9,7,8,8,13,20,12,10,11,10,11,8,12,12,15,14,5,6,12,12,1,20,15,10,10,20,5,1,D R,102,1,1,1,1,5,10,1,5,20,1,1,1,10,5,15,0,0,0,0,0,0,0,0,0,0,0,0,0,0,0,0,0,0,0,0,0,0,0,0,0,0,0,0,0,0,0,0,0,0,0,0,0,0,0,0,0,0,0,0,0,0,0,0,0,Diogo Figueiras,£450Th. ,29,169,Defender - Right-Back,right,SC Braga,2,0,0,210,13,0,0,1004,24,0,1,2114,35,1,3,2720,38,2,6,2837,14,1,0,924,43,3,8,3751,28,1,4,2219,4,0,1,270,Liga NOS,23,0,2,1778,nan,nan,nan,nan
19/6/2011,Christopher Avevor,92025554,771,2/11/1992,19,0,0,0,0,2000,5100,5250,128,102,255766,184,81,D RC,2,1,2,3,1,3,2,1,1,3,1,5,7,7,6,11,5,12,6,12,13,10,8,13,11,12,11,14,10,11,7,12,10,6,6,7,11,14,11,10,12,14,12,8,14,12,20,12,14,11,9,10,8,12,6,13,12,14,12,15,11,9,20,14,1,1,15,1,20,D RC,103,1,1,1,1,1,1,20,1,15,10,1,1,1,1,14,0,0,0,0,0,0,0,0,0,0,0,0,0,0,0,0,0,0,0,0,0,0,0,0,0,0,0,0,0,0,0,0,0,0,0,0,0,0,0,0,0,0,0,0,0,0,0,0,0,Christopher Avevor,£270Th. ,28,184,Defender - Centre-Back,right,FC St. Pauli,17,1,0,1307,24,0,0,1998,30,1,1,2590,13,0,0,1165,15,0,0,1203,9,0,0,651,14,0,0,988,33,1,0,2858,26,1,0,2370,Bundesliga,4,0,0,143,5,0,0,414
19/6/2011,Cédric Soares,55012984,788,8/31/1991,19,0,0,0,0,2580,5435,5350,140,108,325259,172,66,D R,1,3,2,2,2,3,3,3,2,3,1,12,13,11,7,12,10,6,10,10,11,11,10,14,13,14,12,14,9,10,8,10,14,9,11,13,11,12,12,13,13,8,6,10,11,13,20,10,8,13,8,10,8,10,16,12,14,13,14,14,14,5,20,9,5,1,20,5,5,D R,102,1,1,1,1,1,1,1,5,20,10,5,1,1,1,9,0,0,0,0,0,0,0,0,0,0,0,0,0,0,0,0,0,0,0,0,0,0,0,0,0,0,0,0,0,0,0,0,0,0,0,0,0,0,0,0,0,0,0,0,0,0,0,0,0,Cédric Soares,£1.53m ,29,171,Defender - Right-Back,right,Arsenal FC,5,0,1,247,29,0,0,2640,25,1,5,2148,31,1,3,2790,35,0,3,2870,27,0,2,2214,34,0,3,2880,36,1,3,3157,31,1,4,2349,Liga NOS,24,2,1,1754,4,0,0,273
19/6/2011,Alexander Callens,77012995,1656,5/4/1992,19,0,0,9,1,1387,5400,5400,154,108,796983,184,76,D RC,1,3,3,3,1,3,3,1,2,1,1,6,7,8,8,9,8,13,8,13,13,13,13,13,12,14,9,13,9,8,8,9,9,9,10,13,14,15,15,13,13,14,14,5,13,14,20,13,13,13,12,12,7,13,12,13,11,9,9,8,13,6,20,1,1,1,17,1,20,D RC,103,1,13,1,1,1,1,20,1,17,1,1,1,1,1,1,0,0,0,0,0,0,0,0,0,0,0,0,0,0,0,0,0,0,0,0,0,0,0,0,0,0,0,0,0,0,0,0,0,0,0,0,0,0,0,0,0,0,0,0,0,0,0,0,0,,,,,,,,,,,,,,,,,,,,,,,,,,,,,,,,,,,,,,,,,,,,,,,,,,,,
19/6/2011,Thomas Monconduit,34012452,769,2/10/1991,20,0,0,0,0,1250,2500,2500,140,100,183031,184,80,D/WB R,1,2,2,2,2,2,2,5,2,1,3,9,12,9,6,12,6,11,9,7,11,8,6,8,12,12,10,12,11,11,7,11,13,8,11,10,10,12,13,11,9,14,12,14,13,13,20,12,14,13,12,14,9,12,14,13,14,14,14,15,15,6,20,17,12,1,20,10,1,D/WB R,112,1,1,1,1,1,1,1,10,20,15,1,1,12,10,17,32,0,0,0,0,0,1,0,0,0,0,0,0,0,0,0,0,0,0,0,0,0,0,0,0,0,0,0,0,0,0,0,0,0,0,0,0,0,0,0,0,0,0,0,0,0,0,0,0,Thomas Monconduit,£90Th. ,29,184,Midfielder - Defensive Midfield,right,FC Lorient,0,0,0,0,1,0,0,65,15,0,1,1058,31,0,2,2372,nan,nan,nan,nan,19,2,1,1303,36,3,5,3050,36,1,3,3085,35,0,1,2870,Ligue 1,23,1,0,1701,5,1,0,169
19/6/2011,Thanos Petsos,91014707,772,6/5/1991,20,0,0,2,0,500,6100,6300,152,126,783088,184,80,D/DM RLC,1,3,1,2,1,2,3,3,2,1,3,7,12,12,9,12,7,12,11,11,13,13,7,13,12,10,11,13,10,11,10,10,13,12,7,8,14,13,13,13,13,13,11,10,12,13,20,14,13,11,9,10,6,13,12,12,12,11,11,12,10,10,20,8,13,1,20,17,17,D/DM RLC,116,1,1,1,1,1,1,17,17,20,20,13,1,1,1,8,0,0,0,0,0,0,0,0,0,0,0,0,0,0,0,0,0,0,0,0,0,0,0,0,0,0,0,0,0,0,0,0,0,0,0,0,0,0,0,0,0,0,0,0,0,0,0,0,0,Thanos Petsos,£1.13m ,29,184,Midfielder - Defensive Midfield,right,WSG Tirol,28,1,1,2085,21,1,0,948,16,1,0,936,37,4,2,3100,31,1,1,2599,33,2,3,2733,4,0,0,150,21,0,1,1450,nan,nan,nan,nan,Bundesliga,15,1,2,1336,7,0,2,591
19/6/2011,Stefan Savic,62012567,62002127,1/8/1991,20,6,0,4,0,4350,6875,6400,160,125,4862918,186,74,D RC,2,1,2,3,1,3,3,7,1,2,3,7,10,8,11,10,6,16,9,10,15,10,10,13,11,13,15,12,14,15,11,10,15,8,12,8,15,11,10,10,15,14,14,8,13,10,20,13,11,12,7,13,8,6,8,14,14,16,12,12,10,7,20,1,1,1,15,10,20,D RC,103,1,1,1,1,1,1,20,10,15,1,1,1,1,1,1,32,0,0,0,0,0,1,0,0,0,0,0,0,0,0,0,0,0,0,0,0,0,0,0,0,0,0,0,0,0,0,0,0,0,0,0,0,0,0,0,0,0,0,0,0,0,0,0,0,Stefan Savic,£7.20m ,29,187,Defender - Centre-Back,right,Atlético Madrid,31,1,0,2567,20,1,0,1263,28,2,0,2383,40,0,1,3571,41,2,2,3461,24,0,0,1855,49,1,1,4186,37,0,0,3032,22,0,2,1781,Premier League,28,1,0,2482,5,0,0,450
19/6/2011,Sébastien Corchia,34002343,769,11/1/1990,20,0,0,14,2,4788,5997,5997,165,133,4508015,174,65,D/WB R,1,3,3,3,2,2,3,2,2,3,1,12,15,12,6,13,13,11,10,11,11,12,11,13,13,9,11,14,13,13,11,12,17,12,11,12,12,14,14,16,14,11,8,5,17,15,20,16,10,15,9,13,5,8,5,15,13,14,16,15,15,7,20,17,12,1,20,12,1,D/WB R,112,1,1,1,1,1,1,1,12,20,1,1,1,12,12,17,2.2518E+15,0,0,0,1,0,0,0,0,0,0,0,0,0,0,0,0,0,0,0,0,0,0,0,0,0,0,0,0,0,0,0,0,0,0,0,0,0,0,0,0,0,0,0,0,0,0,0,0,Sébastien Corchia,£2.70m ,29,176,Defender - Right-Back,right,FC Nantes,40,2,2,3572,34,0,3,2789,39,1,2,3503,36,4,4,3219,45,3,2,3706,40,2,4,3247,42,2,4,3778,20,0,3,1377,12,0,0,906,Ligue 1,7,0,1,630,1,0,0,90
19/6/2011,Salif Sané,85049933,41,8/25/1990,20,0,0,0,0,4100,5174,5150,140,115,170420,195,84,D RC,1,3,3,1,3,2,1,3,1,3,3,5,11,9,6,11,6,15,12,15,12,9,7,11,11,15,13,13,10,12,8,11,13,8,7,6,12,13,14,9,7,16,17,20,14,11,10,14,17,14,15,13,6,12,14,15,14,14,12,13,13,8,20,1,10,5,15,10,20,D RC,103,1,1,1,5,1,1,20,10,15,15,10,1,1,1,1,8.79609E+12,0,0,0,0,0,0,0,0,0,0,0,0,0,0,0,1,0,0,0,0,0,0,0,0,0,0,0,0,0,0,0,0,0,0,0,0,0,0,0,0,0,0,0,1,0,0,0,0,Salif Sané,£1.80m ,30,196,Defender - Centre-Back,right,FC Schalke 04,5,0,0,360,33,2,0,2781,37,2,4,3360,21,2,0,1584,30,4,0,2515,33,3,0,2932,31,3,2,2542,34,4,1,3060,40,4,1,3543,Ligue 1,16,2,1,1215,4,0,0,314
19/6/2011,Rolf Feltscher,69003383,798,10/6/1990,20,1,0,11,0,3036,5784,5281,135,110,644918,183,78,D/WB RC,2,3,1,3,2,3,1,6,3,1,1,6,9,8,7,9,9,12,10,9,12,10,8,13,8,13,11,7,9,12,8,12,10,3,9,8,13,14,14,13,12,11,14,11,15,13,20,13,15,12,12,9,6,6,5,1,11,12,19,13,9,12,20,19,1,1,20,6,15,D/WB RC,113,1,1,1,1,1,1,15,6,20,1,1,1,1,1,19,0,0,0,0,0,0,0,0,0,0,0,0,0,0,0,0,0,0,0,0,0,0,0,0,0,0,0,0,0,0,0,0,0,0,0,0,0,0,0,0,0,0,0,0,0,0,0,0,0,Rolf Feltscher,£270Th. ,30,184,Defender - Right-Back,right,Los Angeles Galaxy,7,0,0,583,5,0,0,327,21,0,2,1693,10,0,1,598,28,0,5,2290,29,2,4,2468,16,0,1,1202,15,1,3,1295,26,2,3,2201,Serie A,12,0,2,977,nan,nan,nan,nan
19/6/2011,Rafael,2107500,1651,7/9/1990,20,0,0,0,0,6000,7700,7750,168,148,22287857,172,65,D/WB R,3,1,2,3,2,1,3,6,2,3,3,8,15,14,10,14,7,12,8,9,12,13,8,14,14,15,13,15,12,13,9,11,16,13,6,14,12,14,16,18,17,15,9,14,14,17,20,12,10,13,14,14,10,12,15,17,12,15,16,8,10,5,20,18,12,10,20,12,8,D/WB R,112,1,1,1,1,1,10,1,12,20,1,8,1,12,10,18,1.37439E+11,0,1,0,0,0,1,0,0,0,0,0,0,0,0,0,0,0,0,0,0,0,0,0,0,0,0,0,0,0,0,0,0,0,0,0,0,0,1,0,0,0,0,0,0,0,0,0,0,Rafael,£8.10m ,30,172,Defender - Right-Back,right,Istanbul Basaksehir FK,29,0,1,2073,19,0,5,1447,40,3,4,3350,29,0,1,2243,17,1,1,1099,27,1,2,1881,41,0,6,3174,31,1,2,2359,22,0,1,1333,Premier League,20,0,0,1191,4,0,1,199
19/6/2011,Martín Montoya,67053464,796,4/14/1991,20,0,0,0,0,4500,6500,6500,168,128,1405056,175,74,D/WB R,3,1,2,2,1,3,3,1,1,1,1,5,12,10,5,12,5,7,5,12,13,12,7,13,9,12,11,15,11,15,11,13,10,9,12,12,14,15,15,14,15,12,7,9,13,14,20,15,12,13,7,13,4,6,13,8,5,15,9,13,10,9,20,18,14,10,20,10,12,D/WB R,112,1,1,1,1,1,10,12,10,20,1,1,1,14,9,18,0,0,0,0,0,0,0,0,0,0,0,0,0,0,0,0,0,0,0,0,0,0,0,0,0,0,0,0,0,0,0,0,0,0,0,0,0,0,0,0,0,0,0,0,0,0,0,0,0,Martín Montoya,£3.60m ,29,175,Defender - Right-Back,right,Real Betis Balompié,32,0,0,2686,31,1,1,2529,24,1,2,1677,19,0,6,1583,12,0,3,910,17,0,1,1513,31,2,3,2400,31,0,4,2722,29,0,1,2470,LaLiga,27,0,1,1901,2,0,0,96
19/6/2011,Mario,67066949,796,11/24/1990,20,0,0,2,0,4350,6400,6400,154,128,1652789,178,71,D R,2,2,2,2,1,3,2,1,1,1,2,8,13,10,5,11,6,7,9,12,13,12,8,15,12,13,14,13,11,16,10,12,8,9,10,12,13,15,13,15,12,11,9,8,14,14,20,15,10,17,11,13,6,10,9,13,15,9,13,7,3,8,20,15,8,1,20,3,1,D R,102,1,1,1,1,1,1,1,3,20,1,1,1,8,1,15,32,0,0,0,0,0,1,0,0,0,0,0,0,0,0,0,0,0,0,0,0,0,0,0,0,0,0,0,0,0,0,0,0,0,0,0,0,0,0,0,0,0,0,0,0,0,0,0,0,Marinho,£1.17m ,37,166,Forward - Right Winger,left,Retired,30,2,1,1883,34,7,2,2162,41,4,5,2818,32,1,2,1461,17,4,1,990,21,3,0,899,44,4,5,3411,33,6,3,2079,23,1,2,629,Liga NOS,nan,nan,nan,nan,nan,nan,nan,nan
19/6/2011,Marc Hornschuh,35011184,771,3/2/1991,20,0,0,3,0,2800,5250,5250,122,105,225945,188,71,D/DM/M RC,3,1,3,3,1,1,2,2,2,1,3,5,6,6,5,10,5,11,6,12,14,9,8,14,9,12,13,13,11,9,7,11,11,5,7,6,13,14,12,10,12,13,14,10,12,12,20,14,13,12,9,11,8,13,6,14,12,18,12,11,12,5,20,15,16,1,17,5,20,D/DM/M RC,123,1,1,1,1,1,1,20,5,17,19,16,5,5,5,15,0,0,0,0,0,0,0,0,0,0,0,0,0,0,0,0,0,0,0,0,0,0,0,0,0,0,0,0,0,0,0,0,0,0,0,0,0,0,0,0,0,0,0,0,0,0,0,0,0,Marc Hornschuh,£225Th. ,29,188,Defender - Centre-Back,right,Hamburger SV II,25,1,0,2241,17,1,0,1440,31,0,3,2466,36,2,1,3240,33,1,0,2832,27,2,2,2280,22,0,1,1908,7,0,0,609,4,0,0,341,Bundesliga,7,0,0,571,9,0,0,781
19/6/2011,Marc Bartra,67063004,796,1/15/1991,20,0,0,0,0,4766,6461,6461,160,129,1550862,181,70,D RC,2,3,3,3,3,1,2,3,2,2,1,5,8,9,5,12,7,13,7,11,14,12,8,13,13,8,13,14,13,14,10,13,10,7,12,8,14,14,13,13,12,13,11,7,14,14,20,14,12,14,10,13,7,13,6,2,10,9,11,11,13,11,20,1,1,1,16,10,20,D RC,103,1,1,1,1,1,1,20,10,16,1,1,1,1,1,1,0,0,0,0,0,0,0,0,0,0,0,0,0,0,0,0,0,0,0,0,0,0,0,0,0,0,0,0,0,0,0,0,0,0,0,0,0,0,0,0,0,0,0,0,0,0,0,0,0,Marc Bartra,£2.25m ,29,184,Defender - Centre-Back,right,Real Betis Balompié,33,3,0,2891,25,0,0,2167,16,0,0,899,30,2,1,2302,25,1,4,1848,24,2,1,1196,31,1,4,2606,36,5,1,2912,46,1,0,3960,LaLiga,33,3,1,2780,7,0,0,630
19/6/2011,Loris Néry,34012477,769,2/5/1991,20,0,0,0,0,1473,4949,2992,148,110,268922,174,73,D/WB RL,2,2,1,2,3,2,3,7,1,2,1,6,13,8,5,8,6,14,7,10,9,9,6,11,9,12,14,13,10,10,11,10,17,7,11,7,13,13,13,16,14,12,10,5,15,13,20,14,12,14,12,10,5,10,15,15,16,14,14,14,14,7,20,17,1,1,20,17,12,D/WB RL,115,1,1,1,1,1,1,12,17,20,1,1,1,1,17,15,32,0,0,0,0,0,1,0,0,0,0,0,0,0,0,0,0,0,0,0,0,0,0,0,0,0,0,0,0,0,0,0,0,0,0,0,0,0,0,0,0,0,0,0,0,0,0,0,0,Loris Néry,£900Th. ,29,174,Defender - Right-Back,right,Grenoble Foot 38,18,0,0,1255,10,0,0,755,23,1,0,1742,20,0,1,1504,18,0,2,1233,24,1,2,1888,33,0,3,2836,24,0,3,2173,20,0,2,1343,Ligue 1,17,0,1,1238,nan,nan,nan,nan
19/6/2011,Jonathan Schmid,91016490,769,6/26/1990,20,0,0,0,0,504,4454,3768,124,99,174540,179,75,AM R,1,3,2,1,3,2,3,1,1,1,3,11,13,10,8,8,9,9,8,5,9,9,9,13,11,12,10,10,7,11,9,10,10,15,13,10,7,16,13,13,13,11,9,10,14,13,20,9,3,10,10,10,6,10,8,13,6,14,11,10,12,12,15,9,15,20,20,1,1,AM R,502,1,1,1,1,1,20,1,1,15,10,1,1,15,1,9,0,0,0,0,0,0,0,0,0,0,0,0,0,0,0,0,0,0,0,0,0,0,0,0,0,0,0,0,0,0,0,0,0,0,0,0,0,0,0,0,0,0,0,0,0,0,0,0,0,Jonathan Schmid,£1.35m ,30,180,Defender - Right-Back,right,SC Freiburg,32,8,7,2543,34,5,9,2924,38,12,6,3367,33,4,11,2831,37,5,13,3120,24,4,0,1543,26,1,3,1729,26,0,0,1557,29,3,7,2640,Bundesliga,35,5,2,3050,6,1,0,518
19/6/2011,Fábio,2107501,1651,7/9/1990,20,0,0,0,0,4900,6750,7000,155,140,6975757,172,69,D/WB RL,2,3,1,1,2,2,2,2,2,2,3,9,13,13,12,14,10,10,10,9,11,12,13,13,13,13,13,14,11,11,8,12,14,15,8,14,11,11,15,17,16,14,9,15,14,17,20,10,9,12,11,14,13,15,14,16,10,16,15,14,16,6,20,18,12,12,17,20,12,D/WB RL,115,1,1,1,11,12,10,1,20,17,1,12,12,10,18,15,2.2518E+15,0,0,0,1,0,1,0,0,0,0,0,0,0,0,0,0,0,0,0,0,1,0,0,0,0,0,0,0,0,0,0,0,0,0,0,0,0,0,0,0,0,0,0,0,0,0,0,0,Fábio,£6.75m ,30,172,Defender - Right-Back,right,FC Nantes,27,2,0,1556,18,0,2,1283,23,1,0,1314,20,1,1,1392,30,0,0,2137,26,1,3,1818,30,0,1,2248,27,2,1,1798,25,0,2,1725,Premier League,10,0,0,835,6,0,0,537
19/6/2011,Davide Santon,43016424,776,1/2/1991,20,7,0,11,0,5050,6450,6450,163,129,9475518,187,77,D/WB RL,1,1,1,1,1,1,1,1,1,1,1,9,13,13,7,12,9,10,10,12,11,12,9,11,13,11,12,12,11,11,10,11,13,8,10,11,11,12,9,14,13,11,11,8,12,14,20,14,12,13,8,15,13,15,12,15,17,15,13,14,17,7,20,19,14,12,20,19,1,D/WB RL,115,1,1,1,1,12,12,1,19,20,1,1,12,14,18,19,268435458,0,1,0,0,0,0,0,0,0,0,0,0,0,0,0,0,0,0,0,0,0,0,0,0,0,0,0,0,1,0,0,0,0,0,0,0,0,0,0,0,0,0,0,0,0,0,0,0,Davide Santon,£7.20m ,29,187,Defender - Right-Back,right,AS Roma,29,0,0,1589,30,0,1,2186,38,1,4,3273,28,0,0,2312,16,0,1,1302,13,0,1,1098,15,0,1,1108,15,0,1,834,21,0,2,1293,Premier League,21,0,0,973,4,0,0,249
19/6/2011,Carlos Labrín,75003180,1652,12/2/1990,20,1,0,0,0,2250,5700,5700,139,114,412393,185,81,D RC,3,2,1,2,3,3,3,6,2,1,1,8,8,10,2,14,8,14,4,6,11,14,10,14,13,10,11,12,12,12,8,14,10,4,9,4,12,10,14,14,12,13,14,11,13,12,20,9,7,10,3,1,15,10,8,20,10,13,11,12,12,7,20,1,1,1,16,1,20,D RC,103,1,18,1,1,1,1,20,1,16,1,1,1,1,1,1,32768,0,0,0,0,0,0,0,0,0,0,0,0,0,0,0,1,0,0,0,0,0,0,0,0,0,0,0,0,0,0,0,0,0,0,0,0,0,0,0,0,0,0,0,0,0,0,0,0,Carlos Labrín,£675Th. ,29,182,Defender - Centre-Back,right,Audax Italiano,14,0,0,1260,12,0,0,1001,21,0,0,1670,2,0,0,121,34,0,2,3120,29,0,0,2610,17,0,0,1302,20,0,0,1737,16,0,0,1308,Serie A,9,0,0,810,nan,nan,nan,nan
19/6/2011,Brice Dja Djédjé,34011670,24,12/23/1990,20,0,0,1,0,1301,4900,2647,125,98,95029,180,71,D/DM R,3,2,1,3,2,3,2,2,3,1,1,7,12,7,6,8,7,10,8,5,8,9,11,9,8,14,11,13,12,12,9,10,15,8,7,7,12,14,14,14,12,13,10,8,17,12,20,15,11,13,14,14,5,10,17,12,14,13,13,13,13,6,20,15,10,1,20,8,10,D/DM R,112,1,1,1,1,1,1,1,8,20,17,10,1,1,1,15,0,0,0,0,0,0,0,0,0,0,0,0,0,0,0,0,0,0,0,0,0,0,0,0,0,0,0,0,0,0,0,0,0,0,0,0,0,0,0,0,0,0,0,0,0,0,0,0,0,Brice Dja Djédjé,£2.70m ,29,176,Midfielder - Defensive Midfield,right,Without Club,20,1,2,1740,37,2,1,3247,31,2,2,2637,28,1,3,2202,35,0,5,2811,24,1,0,1764,2,0,0,99,14,0,0,1119,19,0,1,1511,Ligue 1,33,0,1,2771,nan,nan,nan,nan
19/6/2011,André Almeida,55011100,788,9/10/1990,20,0,0,0,0,1799,5300,5300,139,106,62373,186,75,D/M RC,1,3,2,1,1,2,3,1,2,3,1,12,12,12,9,13,12,8,12,8,10,13,13,9,14,10,14,10,12,12,12,13,12,11,12,12,13,13,11,12,12,10,11,6,13,12,20,11,11,9,6,10,8,12,11,15,14,12,14,14,14,5,20,7,20,13,20,10,20,D/M RC,113,1,1,1,13,10,10,5,1,20,10,20,10,10,1,7,0,0,0,0,0,0,0,0,0,0,0,0,0,0,0,0,0,0,0,0,0,0,0,0,0,0,0,0,0,0,0,0,0,0,0,0,0,0,0,0,0,0,0,0,0,0,0,0,0,André Almeida,£900Th. ,30,186,Defender - Right-Back,right,SL Benfica,22,2,0,1699,16,1,0,1188,40,1,1,2953,27,0,1,2035,31,0,3,2112,37,0,6,3090,25,2,3,1851,40,2,8,3354,53,2,12,4727,Liga NOS,27,4,5,2366,5,0,2,374
19/6/2011,Vincent Acapandié,8438696,769,2/9/1990,21,0,0,0,0,1416,4769,2877,140,106,92392,180,81,D/WB R,1,2,2,2,3,3,2,3,1,2,1,6,9,10,8,11,7,7,12,7,11,8,10,12,10,12,14,13,10,9,8,8,14,12,6,12,9,12,13,16,10,14,10,10,14,14,20,14,15,12,10,13,12,16,8,13,15,11,15,14,14,6,20,17,15,10,20,1,7,D/WB R,112,1,1,10,1,1,10,7,1,20,1,1,1,15,1,17,514,0,1,0,0,0,0,0,0,0,1,0,0,0,0,0,0,0,0,0,0,0,0,0,0,0,0,0,0,0,0,0,0,0,0,0,0,0,0,0,0,0,0,0,0,0,0,0,0,Vincent Acapandié,£360Th. ,30,180,Defender - Right-Back,right,AS Excelsior de St Joseph,1,0,0,0,17,0,4,1124,10,1,0,331,nan,nan,nan,nan,nan,nan,nan,nan,nan,nan,nan,nan,1,0,0,90,nan,nan,nan,nan,nan,nan,nan,nan,Ligue 1,nan,nan,nan,nan,nan,nan,nan,nan
19/6/2011,Tony Jantschke,29022529,771,4/7/1990,21,0,0,4,0,3800,6450,6450,143,129,1629569,177,72,D/WB/DM R,1,2,1,3,3,3,1,6,1,3,2,5,8,7,5,13,5,10,5,11,14,12,6,15,12,8,17,9,16,15,7,13,12,4,10,6,13,18,11,12,13,14,11,14,12,12,20,13,10,16,3,13,10,16,12,9,15,13,16,17,18,3,20,18,14,1,20,10,14,D/WB/DM R,122,1,1,1,1,1,1,8,10,20,17,14,1,1,1,18,4.50389E+15,0,0,0,0,0,0,1,0,0,0,0,0,0,0,0,0,0,0,0,0,0,0,0,0,0,0,0,0,0,0,0,0,1,1,0,0,0,0,1,0,0,0,0,0,0,0,0,0,Tony Jantschke,£4.50m ,30,177,Defender - Centre-Back,right,Borussia Mönchengladbach,18,0,1,1365,36,1,1,3272,40,1,1,3472,31,1,1,2745,45,1,0,4023,15,0,0,1017,35,0,0,2533,14,0,1,804,15,0,2,1020,Bundesliga,19,0,0,1128,3,0,0,112
19/6/2011,Timothy Chandler,91001071,390,3/29/1990,21,2,0,0,0,5400,6000,6500,148,130,907484,186,80,D/WB/M R,2,3,2,2,1,1,1,4,2,3,2,8,14,12,8,13,7,9,6,10,12,11,6,11,13,14,9,13,8,10,9,11,15,9,7,14,11,14,15,16,14,12,13,8,13,17,20,16,13,13,7,9,7,15,7,14,10,13,16,15,14,6,20,19,18,15,20,4,11,D/WB/M R,122,1,1,8,1,1,15,1,4,20,14,11,1,18,1,19,0,0,0,0,0,0,0,0,0,0,0,0,0,0,0,0,0,0,0,0,0,0,0,0,0,0,0,0,0,0,0,0,0,0,0,0,0,0,0,0,0,0,0,0,0,0,0,0,0,Timothy Chandler,£4.05m ,30,186,Defender - Right-Back,right,Eintracht Frankfurt,32,5,3,2507,33,1,3,2785,31,1,3,2646,22,1,2,1715,29,1,2,2332,14,0,1,820,38,0,6,3237,25,3,4,1983,1,0,0,16,Bundesliga,33,5,1,1575,4,0,0,66
19/6/2011,Rémy Vasseur,34009554,769,8/30/1989,21,0,0,0,0,1300,2600,2600,135,104,45150,174,70,D/WB R,2,1,1,2,1,3,2,5,2,2,3,10,10,8,6,8,7,8,7,10,12,8,6,11,11,12,13,14,12,12,9,11,17,6,8,9,12,16,14,14,13,12,7,5,15,13,20,14,11,14,12,14,5,12,10,13,15,14,16,14,14,5,20,16,12,1,20,10,1,D/WB R,112,1,1,1,1,1,1,1,10,20,1,1,1,12,10,16,0,0,0,0,0,0,0,0,0,0,0,0,0,0,0,0,0,0,0,0,0,0,0,0,0,0,0,0,0,0,0,0,0,0,0,0,0,0,0,0,0,0,0,0,0,0,0,0,0,,,,,,,,,,,,,,,,,,,,,,,,,,,,,,,,,,,,,,,,,,,,,,,,,,,,
19/6/2011,Ousmane Coulibaly,85046572,769,7/9/1989,21,0,0,0,0,1570,4327,3275,125,96,96828,183,75,D/WB R,1,1,1,1,2,2,1,2,1,2,1,7,10,8,5,8,6,11,7,6,12,9,6,9,11,13,12,13,11,11,7,10,13,7,7,7,11,14,12,14,12,13,11,5,13,13,20,14,13,11,13,14,9,10,17,12,10,10,11,14,14,6,20,16,1,1,20,9,12,D/WB R,112,1,1,1,1,1,1,12,9,20,12,1,1,1,1,16,0,0,0,0,0,0,0,0,0,0,0,0,0,0,0,0,0,0,0,0,0,0,0,0,0,0,0,0,0,0,0,0,0,0,0,0,0,0,0,0,0,0,0,0,0,0,0,0,0,Ousmane Coulibaly,£810Th. ,31,183,Defender - Centre-Back,right,Al-Wakrah SC,7,0,0,397,20,0,0,1683,16,0,0,1281,32,0,1,2662,24,2,1,1917,28,2,2,2462,28,0,1,2395,20,0,1,1654,18,0,2,1411,Ligue 1,18,1,1,1594,3,0,0,270
19/6/2011,Miguel Vítor,55004194,788,6/30/1989,21,0,0,13,1,3500,5850,5850,138,117,577884,183,73,D RC,3,3,1,1,2,1,1,3,3,3,1,7,10,11,10,10,9,14,9,10,13,9,10,13,11,11,13,14,15,11,10,12,17,10,9,10,14,12,15,11,12,9,13,7,14,11,20,13,12,11,9,14,10,10,12,17,18,16,17,15,17,5,20,5,1,1,15,5,20,D RC,103,1,5,1,1,1,1,20,5,15,5,1,1,1,1,5,0,0,0,0,0,0,0,0,0,0,0,0,0,0,0,0,0,0,0,0,0,0,0,0,0,0,0,0,0,0,0,0,0,0,0,0,0,0,0,0,0,0,0,0,0,0,0,0,0,Miguel Vítor,£1.35m ,31,184,Defender - Centre-Back,right,Hapoel Beer Sheva,17,3,0,1275,10,0,0,455,12,3,0,998,36,5,0,2938,41,2,0,3648,39,2,2,3264,30,3,1,2387,14,2,1,1041,10,1,0,760,Liga NOS,39,4,2,3296,7,1,0,619
19/6/2011,Martin Kelly,28010835,765,4/27/1990,21,0,0,2,1,4900,6500,6500,155,130,3728157,191,78,D RC,1,1,3,2,2,3,2,7,1,3,3,4,11,9,5,13,5,14,6,7,13,12,4,15,13,11,13,15,15,15,10,12,14,4,9,9,13,12,12,9,10,12,15,11,11,15,20,15,13,14,9,14,14,15,20,12,14,10,14,14,10,5,20,14,1,1,19,10,20,D RC,103,1,1,1,1,1,1,20,10,19,1,1,1,1,1,14,0,0,0,0,0,0,0,0,0,0,0,0,0,0,0,0,0,0,0,0,0,0,0,0,0,0,0,0,0,0,0,0,0,0,0,0,0,0,0,0,0,0,0,0,0,0,0,0,0,Martin Kelly,£4.50m ,30,191,Defender - Right-Back,right,Crystal Palace,23,0,1,1925,20,1,1,1621,7,0,1,560,13,0,1,699,34,0,1,2741,17,1,0,1462,34,0,2,2559,19,0,0,1554,20,0,0,1712,Premier League,21,0,1,1685,2,0,0,151
19/6/2011,Marco Höger,92014217,771,9/16/1989,21,0,0,0,0,4500,6550,6550,146,131,535365,186,78,D/DM/M RC,3,3,3,2,3,1,1,1,2,2,1,9,16,8,9,14,11,12,15,5,9,14,16,10,14,11,13,12,15,11,13,15,16,9,12,10,10,15,12,10,11,12,13,17,9,11,20,13,12,12,8,11,12,12,5,15,12,12,15,9,14,8,18,14,20,12,18,1,20,D/DM/M RC,433,1,1,1,1,1,12,1,1,18,17,20,1,15,1,14,0,0,0,0,0,0,0,0,0,0,0,0,0,0,0,0,0,0,0,0,0,0,0,0,0,0,0,0,0,0,0,0,0,0,0,0,0,0,0,0,0,0,0,0,0,0,0,0,0,Marco HÃ¶ger,£3.60m ,31,182,Midfielder - Defensive Midfield,right,1. FC KÃ¶ln,37,10,9,3235,43,1,5,2983,30,3,2,1858,14,2,1,1039,34,1,3,2756,6,0,0,219,32,0,1,2124,26,0,0,1876,28,1,3,2155,Bundesliga,16,0,0,727,3,0,0,109
19/6/2011,Kyle Walker,28009441,765,5/28/1990,21,0,0,7,0,5000,6700,6750,165,132,4925404,178,74,D RC,1,3,3,3,2,1,2,1,2,1,2,2,13,14,7,13,4,12,10,16,10,11,1,14,12,11,13,15,14,10,11,12,12,10,7,12,10,12,15,17,15,14,10,8,12,18,20,16,14,11,5,12,6,18,9,15,10,10,11,8,10,2,20,5,10,10,20,2,15,D RC,103,1,1,10,1,1,10,15,2,20,1,1,1,10,1,5,134217760,0,0,0,0,0,1,0,0,0,0,0,0,0,0,0,0,0,0,0,0,0,0,0,0,0,0,0,1,0,0,0,0,0,0,0,0,0,0,0,0,0,0,0,0,0,0,0,0,Kyle Walker,£14.40m ,30,183,Defender - Right-Back,right,Manchester City,39,2,7,3328,47,2,2,4027,50,0,6,4349,34,1,4,2991,22,0,0,1824,35,1,3,3123,39,0,5,3176,48,0,7,3842,52,2,1,4301,Premier League,42,1,6,3454,8,0,0,684
19/6/2011,Kévin Théophile-Catherine,8449438,769,10/28/1989,21,0,0,0,0,4450,5641,5620,150,125,896945,180,77,D/WB RL,3,1,3,1,2,1,3,6,1,2,1,7,12,9,6,9,7,13,13,9,13,10,7,12,11,12,13,14,12,12,10,11,14,11,8,8,13,13,14,16,12,14,11,5,15,15,20,15,14,14,12,15,5,10,8,10,14,9,6,13,9,7,20,18,1,1,18,20,10,D/WB RL,115,1,1,1,1,1,1,10,20,18,12,1,1,1,15,18,32,0,0,0,0,0,1,0,0,0,0,0,0,0,0,0,0,0,0,0,0,0,0,0,0,0,0,0,0,0,0,0,0,0,0,0,0,0,0,0,0,0,0,0,0,0,0,0,0,Kévin Théophile-Catherine,£4.05m ,30,183,Defender - Centre-Back,right,GNK Dinamo Zagreb,30,2,0,2655,46,0,1,4063,33,1,2,2970,33,0,0,2805,43,0,0,3822,31,1,1,2772,42,0,2,3719,27,0,1,2374,32,1,0,2898,Ligue 1,26,1,2,2307,9,0,0,689
19/6/2011,Jean-Christophe Coubronne,34001520,769,7/30/1989,21,0,0,0,0,858,4184,4524,101,93,344460,180,72,D/WB RL,3,2,2,3,2,2,1,5,2,1,3,5,10,7,2,10,2,12,6,8,8,8,2,10,10,11,13,10,12,12,7,11,13,2,3,6,12,12,12,11,10,13,9,5,13,13,20,15,13,14,11,10,9,10,15,10,14,11,14,14,14,6,20,16,1,1,20,15,1,D/WB RL,115,1,1,1,1,1,1,1,15,20,1,1,1,1,1,16,0,0,0,0,0,0,0,0,0,0,0,0,0,0,0,0,0,0,0,0,0,0,0,0,0,0,0,0,0,0,0,0,0,0,0,0,0,0,0,0,0,0,0,0,0,0,0,0,0,Jean-Christophe Coubronne,£45Th. ,31,180,Defender - Right-Back,right,FC Lahti,9,1,0,661,1,0,0,21,nan,nan,nan,nan,7,0,0,606,17,0,0,1169,33,1,0,2784,37,2,3,3301,24,2,2,2109,30,2,5,2697,Serie A,25,1,4,2155,nan,nan,nan,nan
19/6/2011,Ivo Pinto,55012998,788,1/7/1990,21,0,0,0,0,1585,5150,5150,122,109,184996,184,73,D R,3,3,3,3,3,3,1,1,1,2,2,10,11,10,8,10,8,12,9,12,12,8,10,13,10,11,10,12,11,11,8,10,14,8,8,14,10,12,13,13,12,13,13,8,13,13,20,13,14,11,8,10,7,11,10,11,13,13,13,13,13,6,20,6,5,1,20,7,7,D R,102,1,1,1,1,1,1,7,7,20,1,1,1,5,1,6,2,0,1,0,0,0,0,0,0,0,0,0,0,0,0,0,0,0,0,0,0,0,0,0,0,0,0,0,0,0,0,0,0,0,0,0,0,0,0,0,0,0,0,0,0,0,0,0,0,Ivo Pinto,£990Th. ,30,182,Defender - Right-Back,right,Rio Ave FC,26,0,0,2135,26,0,1,2340,45,0,4,4024,45,0,7,3811,46,0,7,4116,31,0,2,2592,39,1,4,3333,41,2,1,3501,6,0,2,495,Liga NOS,26,0,1,1900,7,0,0,649
19/6/2011,Giuseppe Bellusci,43000005,776,8/21/1989,21,0,0,6,0,4000,5850,5850,150,117,287761,185,81,D RC,2,3,2,3,3,2,2,1,1,3,3,5,10,8,5,5,5,15,5,11,15,10,5,15,10,16,13,12,10,12,10,13,16,5,8,9,15,11,11,12,13,11,13,5,18,10,20,11,15,10,16,10,2,12,7,15,13,10,16,11,9,7,20,1,1,1,15,1,20,D RC,103,1,1,1,1,1,1,20,1,15,1,1,1,1,1,1,32768,0,0,0,0,0,0,0,0,0,0,0,0,0,0,0,1,0,0,0,0,0,0,0,0,0,0,0,0,0,0,0,0,0,0,0,0,0,0,0,0,0,0,0,0,0,0,0,0,Giuseppe Bellusci,£1.98m ,31,184,Defender - Centre-Back,right,AC Monza,10,0,0,616,33,0,0,2794,29,0,1,2410,20,0,0,1554,30,2,0,2577,31,0,0,2631,33,1,0,2970,27,0,0,2263,32,1,0,2885,Serie A,22,1,0,1960,4,0,0,360
19/6/2011,Dennis Diekmeier,35016422,771,10/20/1989,21,0,0,1,0,4700,6500,6500,158,125,10009544,188,80,D/WB R,3,3,3,2,3,3,2,5,2,1,3,11,14,12,7,10,6,7,9,15,9,11,6,12,11,13,8,15,9,9,11,11,8,7,7,16,7,14,18,16,12,16,13,7,10,18,20,17,13,10,6,10,5,10,3,18,6,5,6,15,8,15,20,20,15,12,20,9,1,D/WB R,112,1,1,1,1,1,12,1,9,20,1,1,1,15,1,20,1.09951E+12,0,1,0,1,0,0,0,0,0,0,0,0,0,0,0,0,0,0,0,0,0,0,0,0,0,0,0,0,0,0,0,0,0,0,0,0,0,0,0,0,1,0,0,0,0,0,0,0,Dennis Diekmeier,£3.60m ,31,188,Defender - Right-Back,right,SV Sandhausen,12,1,0,1024,27,0,2,2310,32,0,4,2841,23,0,2,2001,24,0,1,1905,22,0,0,1440,26,0,1,1883,22,0,3,1869,16,0,6,1440,Bundesliga,34,2,4,2974,6,0,1,540
19/6/2011,Dejan Lovren,24000971,761,7/5/1989,21,0,0,21,1,4800,6029,6000,165,134,1766630,188,84,D RC,3,3,2,2,1,3,2,8,2,3,3,5,8,11,7,13,9,14,10,14,13,12,10,15,13,14,14,16,11,9,10,10,17,9,13,8,12,15,15,12,13,14,15,16,15,14,20,15,14,13,14,13,7,14,11,18,15,15,14,11,12,8,20,13,1,1,18,13,20,D RC,103,1,14,1,1,1,1,20,13,18,1,1,1,1,10,13,3.51844E+13,0,0,0,0,0,0,0,0,0,0,0,0,0,0,0,0,0,1,0,0,0,0,0,0,0,0,0,0,0,0,0,0,0,0,0,0,0,0,0,0,0,0,0,0,0,1,0,0,Dejan Lovren,£7.20m ,31,188,Defender - Centre-Back,right,Zenit St. Petersburg,37,1,0,3194,31,1,1,2671,24,1,1,2019,31,2,1,2788,38,1,0,2987,39,1,0,3250,33,2,1,2899,43,2,2,3354,18,1,1,1261,Ligue 1,15,1,1,1190,14,1,1,1215
19/6/2011,Dan Gosling,29007273,765,2/1/1990,21,0,0,2,0,3500,6250,6250,150,122,2565562,178,70,D/DM/M RC,1,3,1,2,2,3,1,5,1,3,3,7,9,13,11,12,8,10,8,8,10,13,9,10,12,9,11,12,14,14,13,12,14,7,14,14,13,13,14,12,12,10,9,12,15,11,20,14,12,15,4,14,11,14,12,12,8,15,15,13,14,2,16,10,20,13,18,1,20,D/DM/M RC,333,1,1,1,10,1,13,1,1,16,20,20,1,18,1,10,1.75922E+13,0,1,0,0,0,0,1,0,0,0,0,0,0,0,0,0,0,0,0,0,0,0,0,0,0,0,0,0,0,0,0,0,0,0,0,0,0,0,0,0,0,0,0,0,1,0,0,0,Dan Gosling,£1.35m ,30,180,Midfielder - Central Midfield,right,AFC Bournemouth,2,0,1,90,22,5,5,941,14,2,1,831,26,3,1,1799,24,5,2,814,37,4,2,2595,30,3,1,1600,32,3,1,2331,26,2,1,1827,Premier League,25,3,1,1350,8,2,0,509
19/6/2011,Chris Smalling,30022142,765,11/22/1989,21,0,0,14,1,5050,7400,7250,166,144,5421067,192,81,D RC,1,3,1,2,3,1,3,9,1,3,3,8,8,7,6,12,5,15,5,8,13,13,5,14,12,14,15,16,13,13,9,12,14,5,12,8,15,15,15,12,12,13,17,11,12,14,20,16,15,12,8,13,6,8,13,14,13,13,15,15,17,11,20,1,1,1,19,1,20,D RC,103,1,1,1,1,1,1,20,1,19,1,1,1,1,1,1,0,0,0,0,0,0,0,0,0,0,0,0,0,0,0,0,0,0,0,0,0,0,0,0,0,0,0,0,0,0,0,0,0,0,0,0,0,0,0,0,0,0,0,0,0,0,0,0,0,Chris Smalling,£13.50m ,30,194,Defender - Centre-Back,right,AS Roma,33,1,2,2262,31,3,0,2223,23,0,0,1724,38,2,0,3001,29,4,0,2238,55,2,0,4975,36,2,2,2609,46,4,0,3975,34,1,0,3028,Premier League,37,3,2,3196,nan,nan,nan,nan
19/6/2011,César Azpilicueta,67033300,796,8/28/1989,21,0,0,19,1,5600,6900,6212,165,138,2266656,178,70,D/WB R,1,1,1,2,1,1,3,3,3,3,2,8,14,12,6,13,7,9,10,18,12,12,8,14,13,12,12,16,13,14,10,13,16,8,13,12,13,17,16,15,12,12,9,8,17,14,20,17,11,14,12,13,5,20,12,13,18,12,18,14,11,7,20,18,14,1,20,12,10,D/WB R,112,1,1,1,1,1,1,1,12,20,10,10,10,14,12,18,1.12617E+15,0,0,0,0,0,1,0,0,0,0,0,0,0,0,0,0,0,0,0,0,0,0,0,0,0,0,0,0,0,0,0,0,0,0,0,0,0,0,1,0,0,0,0,0,0,0,0,0,César Azpilicueta,£6.75m ,31,178,Defender - Right-Back,right,Chelsea FC,21,1,2,1578,44,1,4,3821,51,0,6,4113,44,1,4,3575,40,0,4,3367,49,2,5,4260,47,2,7,4098,52,3,7,4755,57,1,9,4867,Ligue 1,49,4,7,4312,7,0,1,499
19/6/2011,Cédric Mongongu,8432567,53,6/22/1989,21,4,0,0,0,5050,6250,5600,150,125,750296,189,78,D RC,1,1,2,2,1,3,1,3,2,3,1,5,9,8,6,11,6,16,8,7,15,12,10,12,11,13,15,14,12,8,9,12,10,6,11,7,14,14,14,14,9,16,14,7,16,11,20,14,16,14,13,10,7,10,12,6,9,14,17,2,5,5,20,15,1,1,15,1,20,D RC,103,1,1,1,1,1,1,20,1,15,14,1,1,1,1,15,0,0,0,0,0,0,0,0,0,0,0,0,0,0,0,0,0,0,0,0,0,0,0,0,0,0,0,0,0,0,0,0,0,0,0,0,0,0,0,0,0,0,0,0,0,0,0,0,0,Cédric Mongongu,£1.58m ,31,189,Defender - Centre-Back,right,Without Club,22,0,0,1500,15,3,0,1202,21,1,0,1871,37,4,1,3183,25,0,0,1860,5,0,0,365,4,0,0,71,nan,nan,nan,nan,nan,nan,nan,nan,Ligue 1,nan,nan,nan,nan,nan,nan,nan,nan
19/6/2011,Andrea Mazzarani,43006567,776,11/6/1989,21,0,0,0,0,1841,5024,5024,135,107,99162,174,66,WB/M/AM RC,2,3,3,3,1,2,1,1,3,2,2,14,14,13,8,11,10,9,7,5,10,11,10,12,11,8,12,8,11,10,6,10,10,6,6,13,12,7,7,14,11,7,7,11,18,13,20,15,8,13,5,12,4,14,8,18,13,11,14,12,18,6,10,16,20,16,20,1,15,WB/M/AM RC,433,1,1,1,15,1,16,1,1,10,1,1,1,20,1,16,0,0,0,0,0,0,0,0,0,0,0,0,0,0,0,0,0,0,0,0,0,0,0,0,0,0,0,0,0,0,0,0,0,0,0,0,0,0,0,0,0,0,0,0,0,0,0,0,0,Andrea Mazzarani,£900Th. ,30,180,Midfielder - Attacking Midfield,right,Calcio Catania,39,10,1,2854,22,1,3,1041,18,6,3,1006,37,9,5,1795,37,9,1,2455,16,4,1,805,29,9,1,2180,37,8,5,2321,17,1,3,842,Serie A,33,7,0,1764,nan,nan,nan,nan
19/6/2011,Álvaro,67093060,796,1/8/1990,21,0,0,0,0,3750,6000,6000,145,130,815925,180,68,D RC,1,2,3,1,1,2,2,2,3,2,2,4,4,5,5,7,5,15,6,13,15,9,7,14,7,17,14,19,9,14,6,12,15,7,14,5,13,15,17,14,16,14,12,6,15,14,20,14,13,14,12,15,6,11,10,12,15,15,15,10,8,8,20,1,1,1,19,7,20,D RC,103,1,1,1,1,1,1,20,7,19,1,1,1,1,1,1,8589967360,0,0,0,0,0,0,0,0,0,0,0,0,0,0,0,1,0,0,0,0,0,0,0,0,0,0,0,0,0,0,0,0,0,1,0,0,0,0,0,0,0,0,0,0,0,0,0,0,,,,,,,,,,,,,,,,,,,,,,,,,,,,,,,,,,,,,,,,,,,,,,,,,,,,
19/6/2011,Abdoulaye Bamba,43013866,24,4/25/1990,21,0,0,0,0,2482,5129,3724,122,114,114772,182,68,D/WB R,2,1,1,1,1,3,3,1,2,3,1,7,12,9,5,10,6,12,7,15,13,9,6,12,10,12,13,14,11,11,9,10,13,7,6,10,11,14,15,16,13,13,11,5,15,15,20,14,10,12,12,13,7,12,12,14,14,15,13,14,14,7,20,18,10,1,20,9,1,D/WB R,112,1,1,1,1,1,1,1,9,20,1,1,1,10,1,18,32,0,0,0,0,0,1,0,0,0,0,0,0,0,0,0,0,0,0,0,0,0,0,0,0,0,0,0,0,0,0,0,0,0,0,0,0,0,0,0,0,0,0,0,0,0,0,0,0,Abdoulaye Bamba,£1.13m ,30,182,Defender - Right-Back,right,SCO Angers,24,0,1,1827,28,0,1,2402,28,0,1,2122,19,1,3,1426,34,0,1,3050,29,1,0,2527,12,0,2,791,21,0,0,1803,30,0,4,2574,Ligue 1,11,0,1,943,7,0,0,572
19/6/2011,Stefano Celozzi,35000513,771,11/2/1988,22,0,0,3,0,4000,5750,6250,136,125,3259232,171,65,D/WB R,1,3,1,1,3,3,2,3,1,3,2,11,12,14,4,12,6,7,10,12,11,12,7,13,15,14,14,12,14,13,11,10,15,13,8,11,10,14,13,15,14,12,9,6,14,16,20,15,10,12,6,14,13,12,12,16,12,12,16,12,13,6,20,18,10,8,20,6,1,D/WB R,112,1,1,1,1,1,8,1,6,20,10,1,1,10,1,18,40,0,0,0,1,0,1,0,0,0,0,0,0,0,0,0,0,0,0,0,0,0,0,0,0,0,0,0,0,0,0,0,0,0,0,0,0,0,0,0,0,0,0,0,0,0,0,0,0,Stefano Celozzi,£720Th. ,31,171,Defender - Right-Back,right,Without Club,12,0,1,1008,3,0,0,240,28,0,3,1008,16,0,1,583,34,0,4,3045,38,0,2,3408,7,1,0,492,27,0,1,2252,23,0,1,1539,Bundesliga,10,0,0,535,nan,nan,nan,nan
19/6/2011,Seamus Coleman,56001681,789,8/3/1988,22,4,0,13,1,4250,7000,6750,148,128,1693114,177,67,D/WB/M R,3,3,1,3,1,1,3,5,1,1,1,5,13,15,9,12,8,14,9,12,14,11,8,14,11,15,12,14,12,11,8,12,14,13,11,13,11,14,14,15,10,13,12,7,14,14,20,15,14,13,10,13,3,8,10,13,18,12,15,15,12,7,20,17,20,10,20,9,1,D/WB/M R,122,1,1,1,1,1,10,1,9,20,1,1,1,20,1,17,7.04031E+13,0,1,0,0,0,1,0,0,0,0,0,0,0,0,0,0,0,0,0,0,0,0,0,0,0,0,0,0,0,0,0,0,0,0,0,1,0,0,0,0,0,0,0,0,0,0,1,0,Seamus Coleman,£4.50m ,32,177,Defender - Right-Back,right,Everton FC,41,6,4,2892,28,1,2,1757,31,1,6,2614,41,7,2,3635,42,5,3,3725,34,1,3,2842,28,4,4,2497,12,0,1,1035,30,2,2,2650,Premier League,30,0,1,2082,6,0,1,407
19/6/2011,Samba Diakité,85010614,769,1/24/1989,22,0,0,0,0,4300,5400,5400,135,120,339730,186,76,D/WB/DM R,3,3,1,1,2,3,1,3,3,1,1,5,7,8,6,11,6,12,7,9,13,9,6,13,11,15,14,14,13,12,8,10,16,7,8,7,11,15,17,16,12,15,13,5,15,13,20,17,14,14,15,14,5,10,11,12,10,14,13,12,12,7,16,16,12,1,16,1,12,D/WB/DM R,332,1,1,1,1,1,1,12,1,16,20,12,1,1,1,16,1073741824,0,0,0,0,0,0,0,0,0,0,0,0,0,0,0,0,0,0,0,0,0,0,0,0,0,0,0,0,0,0,1,0,0,0,0,0,0,0,0,0,0,0,0,0,0,0,0,0,Samba Diakité,£4.05m ,31,186,Midfielder - Defensive Midfield,right,Al-Tadamon SC,25,2,0,1745,25,2,0,1886,15,0,1,943,9,0,0,341,7,1,1,540,0,0,0,0,nan,nan,nan,nan,16,0,0,941,20,0,0,781,Premier League,nan,nan,nan,nan,nan,nan,nan,nan
19/6/2011,Ryan Shotton,5129388,765,9/30/1988,22,0,0,0,0,3000,5550,5900,138,111,1272614,191,85,D RC,2,3,1,1,3,2,3,5,2,3,3,3,12,11,10,9,4,13,8,17,12,8,4,13,10,15,12,14,12,11,9,11,12,5,10,11,13,13,14,11,11,12,13,12,12,11,20,12,12,11,10,11,3,11,12,14,17,8,16,13,3,4,20,1,1,1,18,1,20,D RC,103,1,1,10,1,1,1,20,1,18,1,1,1,1,1,1,1.1259E+15,0,0,0,0,0,0,0,0,0,0,0,0,0,0,0,0,0,0,0,0,0,0,0,0,0,0,0,0,0,0,0,0,0,0,0,0,0,0,0,0,0,0,0,0,0,0,0,0,Ryan Shotton,£2.25m ,32,189,Defender - Centre-Back,right,Without Club,4,0,0,260,38,2,3,2293,27,0,1,2152,14,1,0,1075,30,2,3,2489,16,1,0,1109,45,2,1,4005,31,1,2,2658,35,0,1,2949,Premier League,22,0,0,1799,nan,nan,nan,nan
19/6/2011,Ritchie De Laet,8189806,757,11/28/1988,22,2,0,4,0,3750,6000,5950,140,119,274565,186,78,D RLC,3,3,2,1,2,3,2,3,2,2,2,2,6,9,4,11,2,15,4,8,13,8,8,15,11,14,12,12,9,11,5,9,17,6,12,6,12,14,14,14,11,12,14,11,14,15,20,12,14,14,10,10,5,15,15,10,10,13,14,15,14,5,20,12,1,1,18,17,20,D RLC,106,1,12,1,1,1,1,20,17,18,6,1,1,1,10,12,1.37439E+11,0,0,0,0,0,0,0,0,0,0,0,0,0,0,0,0,0,0,0,0,0,0,0,0,0,0,0,0,0,0,0,0,0,0,0,0,0,1,0,0,0,0,0,0,0,0,0,0,Ritchie De Laet,£1.13m ,31,186,Defender - Right-Back,right,Royal Antwerp FC,36,0,0,3050,19,3,3,1563,48,2,3,3975,38,2,6,3196,28,0,1,2062,25,1,1,1741,4,0,0,317,24,0,2,1512,28,7,1,2310,Premier League,28,1,0,2325,11,0,0,934
19/6/2011,Michel Morganella,69002448,798,5/17/1989,22,0,0,3,0,773,5415,5900,140,120,129792,183,74,D/WB R,1,1,1,2,3,3,1,3,1,2,2,12,14,7,8,12,9,11,9,13,12,12,8,13,13,12,11,10,10,12,11,12,17,9,5,6,10,11,11,11,15,11,10,10,10,16,20,16,11,12,11,10,1,12,15,11,12,13,17,12,14,1,20,18,15,1,20,8,1,D/WB R,112,1,1,1,1,1,1,1,8,20,1,1,1,15,1,18,1.09951E+12,0,0,0,0,0,0,0,0,0,0,0,0,0,0,0,0,0,0,0,0,0,0,0,0,0,0,0,0,0,0,0,0,0,0,0,0,0,0,0,0,1,0,0,0,0,0,0,0,Michel Morganella,£720Th. ,31,183,Defender - Right-Back,right,FC Chiasso,37,0,3,3151,34,0,2,2916,31,0,3,2581,16,1,0,1216,20,1,1,1725,15,0,1,1061,12,0,0,739,12,0,0,932,19,1,0,1500,Serie A,11,0,0,724,2,0,0,139
19/6/2011,Micah Richards,5005673,765,6/24/1988,22,12,1,15,3,5600,7150,7300,158,146,6180167,181,83,D RC,2,2,3,2,1,2,1,1,3,2,3,3,7,8,7,8,5,18,4,15,14,8,6,15,7,15,11,19,9,12,6,13,11,4,11,7,11,17,17,19,13,9,14,8,17,18,20,19,18,10,8,12,12,16,5,16,18,14,10,13,11,8,20,12,10,1,20,5,18,D RC,103,1,1,5,1,1,1,18,5,20,10,10,1,1,1,12,32808,0,0,0,1,0,1,0,0,0,0,0,0,0,0,0,1,0,0,0,0,0,0,0,0,0,0,0,0,0,0,0,0,0,0,0,0,0,0,0,0,0,0,0,0,0,0,0,0,Micah Richards,£16.65m ,32,180,Defender - Right-Back,right,Retired,31,3,2,2482,37,1,6,2760,10,0,0,843,10,0,2,742,20,0,1,1236,28,2,1,2398,3,0,0,218,0,0,0,0,nan,nan,nan,nan,Premier League,nan,nan,nan,nan,nan,nan,nan,nan
19/6/2011,Matias Ezequiel Schelotto,43048983,776,5/23/1989,22,0,0,7,0,5000,6400,6400,153,130,472039,187,76,WB/M/AM R,3,3,3,2,1,3,2,1,1,3,1,10,13,13,14,8,12,8,12,14,10,14,10,8,14,9,13,14,14,10,11,9,19,14,6,15,9,13,9,15,9,10,13,13,17,14,20,16,15,13,8,12,4,14,18,19,18,6,17,13,8,6,14,16,20,18,20,1,1,WB/M/AM R,432,1,1,1,1,1,18,1,1,14,1,1,1,20,1,16,1.09951E+12,0,1,0,0,0,0,0,0,0,0,0,0,0,0,0,0,0,0,0,0,0,0,0,0,0,0,0,0,0,0,0,0,0,0,0,0,0,0,0,0,1,0,0,0,0,0,0,0,Ezequiel Schelotto,£5.85m ,31,187,Defender - Right-Back,right,Without Club,32,2,2,1826,38,2,7,2866,31,1,1,1856,27,5,2,1367,29,0,0,2123,17,0,3,1284,26,0,5,2148,24,0,1,1690,4,0,0,143,Serie A,9,0,0,451,nan,nan,nan,nan
19/6/2011,Matías Aguirregaray,78020879,1657,4/1/1989,22,0,0,15,1,3000,5354,5250,145,119,269149,183,78,D/WB/M R,3,2,2,3,1,2,1,4,3,2,1,5,10,15,8,8,8,10,9,7,13,10,5,12,15,15,9,15,12,11,7,8,12,15,13,13,12,14,15,14,15,13,11,9,12,12,20,15,15,9,16,11,3,14,12,16,4,9,9,6,5,10,18,20,19,1,20,1,1,D/WB/M R,232,1,1,1,1,1,1,1,1,18,14,1,1,19,1,20,2.3222E+15,0,0,0,0,0,1,0,0,0,0,0,0,0,0,0,0,0,0,0,0,0,0,0,0,0,0,0,0,0,0,0,0,0,0,0,1,0,0,0,0,0,0,0,0,0,0,1,0,MatÃ­as Aguirregaray,£720Th. ,31,174,Defender - Right-Back,right,Without Club,7,0,2,564,13,0,1,729,34,5,6,2493,16,1,1,973,30,2,2,2369,37,5,4,3273,28,6,0,2124,30,0,0,2373,26,1,3,2300,Serie A,25,2,0,1893,nan,nan,nan,nan
19/6/2011,Mapou Yanga Mbiwa,34000001,769,5/15/1989,22,0,0,4,0,4950,6200,6200,165,138,1366250,184,77,D/WB RLC,3,2,2,2,2,2,2,4,3,2,2,5,11,9,5,9,6,15,8,12,15,8,7,14,9,13,15,15,12,12,6,12,17,9,9,7,14,14,16,14,11,15,13,10,14,13,20,16,15,14,13,15,7,12,10,14,14,14,16,14,14,6,20,17,1,1,17,17,20,D/WB RLC,116,1,1,1,1,1,1,20,17,17,1,1,1,1,17,17,0,0,0,0,0,0,0,0,0,0,0,0,0,0,0,0,0,0,0,0,0,0,0,0,0,0,0,0,0,0,0,0,0,0,0,0,0,0,0,0,0,0,0,0,0,0,0,0,0,Mapou Yanga-Mbiwa,£8.10m ,31,184,Defender - Centre-Back,right,Without Club,42,1,0,3799,38,1,1,3440,46,0,0,3946,26,0,0,1797,38,1,1,2914,35,2,0,3027,34,0,0,2865,3,0,0,217,5,0,0,378,Ligue 1,2,0,0,180,nan,nan,nan,nan
19/6/2011,Manuel Schmiedebach,35008171,771,12/5/1988,22,0,0,0,0,4100,6700,6700,151,139,1030925,170,70,D/WB/DM/M RC,3,3,3,3,1,1,3,5,2,3,3,9,13,12,6,13,7,5,6,16,17,14,7,12,14,17,9,16,12,10,12,13,13,13,10,8,9,15,18,16,17,14,6,10,12,12,20,18,8,15,9,12,7,16,12,12,11,10,12,13,14,6,18,18,19,15,18,1,19,D/WB/DM/M RC,343,1,1,1,1,1,15,1,1,18,20,19,1,16,1,18,16809984,0,0,0,0,0,0,0,0,0,0,0,0,0,0,0,1,0,0,0,0,0,0,0,0,1,0,0,0,0,0,0,0,0,0,0,0,0,0,0,0,0,0,0,0,0,0,0,0,Manuel Schmiedebach,£4.95m ,31,171,Midfielder - Defensive Midfield,right,Without Club,33,0,6,2693,44,0,2,3344,36,1,1,2144,28,2,2,1936,28,0,1,2343,24,1,1,1967,28,0,2,2366,7,0,0,226,36,0,2,3032,Bundesliga,6,0,0,255,nan,nan,nan,nan
19/6/2011,Leon Balogun,92002651,771,6/28/1988,22,0,0,0,0,3000,5050,5250,117,103,475048,190,81,D RC,1,2,2,3,2,3,3,3,2,3,2,3,6,5,5,9,5,11,7,14,13,9,7,14,9,12,13,14,8,9,5,11,10,5,8,6,12,14,10,9,8,13,14,10,12,13,20,15,14,12,11,9,8,6,13,13,11,13,14,6,15,10,20,15,1,1,16,1,20,D RC,103,1,1,1,1,1,1,20,1,16,1,1,1,1,1,15,0,0,0,0,0,0,0,0,0,0,0,0,0,0,0,0,0,0,0,0,0,0,0,0,0,0,0,0,0,0,0,0,0,0,0,0,0,0,0,0,0,0,0,0,0,0,0,0,0,Leon Balogun,£135Th. ,32,190,Defender - Centre-Back,right,Rangers FC,32,1,0,2624,20,3,0,1752,20,1,2,1728,14,0,0,1016,21,4,0,1681,23,1,0,1611,21,0,0,1317,15,0,0,1198,10,1,0,801,Bundesliga,13,0,0,944,6,0,0,435
19/6/2011,Lamine Koné,34000665,769,2/1/1989,22,0,0,3,0,2519,5219,3959,150,116,311866,186,83,D RC,3,1,3,2,3,3,3,6,3,2,3,5,7,8,6,9,6,14,8,6,14,8,6,11,9,14,14,15,13,13,6,12,14,8,9,9,13,13,14,11,9,16,14,20,13,13,8,16,16,14,14,14,10,8,12,13,14,13,15,15,15,6,20,14,1,1,20,14,18,D RC,103,1,1,1,1,1,1,18,14,20,1,1,1,1,14,14,32,0,0,0,0,0,1,0,0,0,0,0,0,0,0,0,0,0,0,0,0,0,0,0,0,0,0,0,0,0,0,0,0,0,0,0,0,0,0,0,0,0,0,0,0,0,0,0,0,Lamine KonÃ©,£1.35m ,31,189,Defender - Centre-Back,right,RC Strasbourg Alsace,9,1,0,683,26,1,0,2247,34,3,1,2895,19,1,0,1370,31,1,1,2790,35,2,1,3076,31,1,0,2635,26,0,0,2221,32,2,1,2545,Ligue 1,27,1,0,2263,4,0,0,234
19/6/2011,Kyle Naughton,152937,765,11/11/1988,22,0,0,9,0,4000,6150,6150,144,126,580751,180,73,D RL,3,3,2,3,3,1,3,4,2,1,2,10,12,12,13,11,7,10,15,16,11,13,10,11,14,10,11,10,13,10,10,12,14,10,12,13,12,14,14,14,14,13,10,10,18,15,20,14,10,15,4,13,7,15,17,16,10,12,16,13,10,14,20,15,13,1,20,15,10,D RL,105,1,1,7,1,1,1,1,15,20,1,10,10,13,12,15,512,0,0,0,0,0,0,0,0,0,1,0,0,0,0,0,0,0,0,0,0,0,0,0,0,0,0,0,0,0,0,0,0,0,0,0,0,0,0,0,0,0,0,0,0,0,0,0,0,Kyle Naughton,£3.60m ,31,181,Defender - Right-Back,right,Swansea City,37,5,4,3360,32,0,1,2701,27,0,1,2129,34,0,4,2801,21,0,1,1724,28,0,3,1782,34,1,0,2959,39,1,2,3399,38,1,2,3025,Premier League,35,3,0,2720,2,0,0,171
19/6/2011,Júnior Caiçara,19074784,1651,4/27/1989,22,0,0,0,0,1750,5150,5450,130,109,39900,173,65,D/WB RL,2,3,2,2,1,3,3,1,3,1,1,9,10,9,7,11,7,5,7,9,10,9,9,11,11,13,12,14,11,10,8,10,13,9,9,15,10,10,13,15,14,6,6,14,10,15,20,10,6,11,9,10,7,16,11,12,6,11,14,13,13,6,20,16,1,1,20,15,1,D/WB RL,115,1,1,1,1,1,1,1,15,20,1,1,1,1,15,16,3,1,1,0,0,0,0,0,0,0,0,0,0,0,0,0,0,0,0,0,0,0,0,0,0,0,0,0,0,0,0,0,0,0,0,0,0,0,0,0,0,0,0,0,0,0,0,0,0,Júnior Caiçara,£990Th. ,31,173,Defender - Right-Back,right,Istanbul Basaksehir FK,35,2,1,3130,35,1,0,3101,32,1,3,2865,53,0,12,4680,44,0,9,3806,32,0,5,2652,27,1,5,2112,42,0,8,3743,37,0,2,3224,Liga NOS,44,0,7,3990,6,0,0,477
19/6/2011,Jukka Raitala,33000888,768,9/15/1988,22,2,0,25,0,3500,5500,5900,137,118,122000,180,77,D/WB RLC,2,3,1,3,1,2,3,1,2,1,3,7,12,10,5,11,5,13,4,16,13,10,6,14,11,12,11,14,10,12,8,10,12,8,10,8,12,12,14,13,13,13,12,10,13,13,20,11,11,12,7,11,8,6,17,17,10,13,14,14,10,10,20,17,5,1,18,20,16,D/WB RLC,116,1,1,1,1,1,1,16,20,18,5,4,5,5,16,17,4294967296,0,0,0,0,0,0,0,0,0,0,0,0,0,0,0,0,0,0,0,0,0,0,0,0,0,0,0,0,0,0,0,0,1,0,0,0,0,0,0,0,0,0,0,0,0,0,0,0,Jukka Raitala,£1.08m ,32,181,Defender - Left-Back,both,Montreal Impact,31,0,0,2711,20,0,0,1258,31,0,1,2514,16,1,1,1354,35,1,0,2840,34,1,6,2822,30,0,1,2057,30,1,2,2432,31,0,0,2452,LaLiga,16,0,0,1349,nan,nan,nan,nan
19/6/2011,João Aurélio,55011464,788,8/17/1988,22,0,0,5,1,2500,5500,5500,130,111,170128,185,75,D/AM R,1,1,3,3,1,3,2,1,3,2,3,13,13,14,12,12,10,10,10,7,7,10,11,8,14,12,11,13,10,10,10,11,14,13,9,13,8,10,12,13,13,12,12,8,14,13,20,11,12,11,7,12,9,12,13,12,14,13,14,14,14,5,17,7,7,20,20,13,10,D/AM R,522,1,1,14,10,13,20,1,7,17,1,7,7,7,7,7,0,0,0,0,0,0,0,0,0,0,0,0,0,0,0,0,0,0,0,0,0,0,0,0,0,0,0,0,0,0,0,0,0,0,0,0,0,0,0,0,0,0,0,0,0,0,0,0,0,João Aurélio,£720Th. ,32,182,Defender - Right-Back,right,Pafos FC,24,0,1,1115,22,0,0,1631,26,1,1,1865,29,2,2,1886,42,1,4,3713,38,0,5,3298,31,0,5,1923,32,0,3,2429,21,2,5,1860,Liga NOS,30,2,3,2515,7,0,0,491
19/6/2011,Jerry Vandam,8440118,21,12/8/1988,22,0,0,0,0,4250,5309,5300,140,118,73054,186,77,D R,2,1,3,1,1,2,2,2,2,1,1,5,13,9,5,9,7,13,9,12,13,10,7,12,11,10,14,14,12,11,10,11,12,7,6,9,10,13,16,15,12,15,13,5,16,14,20,16,14,13,10,13,5,10,15,13,16,13,11,15,15,8,20,15,10,1,20,10,10,D R,102,1,1,1,1,1,1,1,10,20,13,10,1,1,10,15,0,0,0,0,0,0,0,0,0,0,0,0,0,0,0,0,0,0,0,0,0,0,0,0,0,0,0,0,0,0,0,0,0,0,0,0,0,0,0,0,0,0,0,0,0,0,0,0,0,Jerry Vandam,£1.58m ,31,186,Defender - Right-Back,right,Unknown,6,0,0,371,39,1,0,3461,6,0,0,449,30,0,1,2550,11,0,1,663,5,0,0,404,4,0,0,189,nan,nan,nan,nan,nan,nan,nan,nan,Ligue 1,26,1,3,2159,nan,nan,nan,nan
19/6/2011,Jérôme Boateng,35002579,771,9/3/1988,22,13,0,15,1,6900,7500,7500,175,147,36363636,192,90,D/WB RLC,2,2,3,3,2,3,2,5,2,3,3,8,16,11,4,14,6,9,8,18,12,13,7,12,14,8,14,9,17,7,15,13,9,11,10,6,12,13,5,13,12,16,17,18,10,18,20,13,17,8,6,13,7,19,4,13,7,14,10,12,8,11,20,17,10,8,18,16,20,D/WB RLC,116,1,1,3,1,8,8,20,16,18,12,10,10,10,15,17,1.49813E+14,0,0,0,0,0,0,0,0,0,0,0,0,0,0,0,0,0,0,0,0,0,0,0,0,0,0,0,0,0,0,0,0,1,0,0,0,0,0,1,0,0,0,0,1,0,0,0,1,Jérôme Boateng,£13.50m ,32,192,Defender - Centre-Back,right,Bayern Munich,24,0,0,1952,48,0,2,4136,40,2,2,3341,43,1,4,3691,44,3,3,3726,31,0,4,2400,21,0,1,1465,31,2,4,2621,28,0,2,2419,Bundesliga,38,0,2,2806,6,0,0,441
19/6/2011,Felipe Mattioni,8833559,1651,10/15/1988,22,0,0,0,0,4750,6000,6500,150,132,781919,177,72,D/WB R,1,2,3,2,2,3,2,6,1,2,1,12,13,15,7,12,11,8,10,12,12,13,5,12,16,14,13,12,12,12,13,11,13,14,6,14,11,10,12,17,15,8,10,7,10,15,20,13,9,12,11,10,10,14,12,15,8,12,14,15,11,17,18,20,15,9,20,1,1,D/WB R,222,1,1,1,1,1,9,1,1,18,1,1,1,15,1,20,32,0,0,0,0,0,1,0,0,0,0,0,0,0,0,0,0,0,0,0,0,0,0,0,0,0,0,0,0,0,0,0,0,0,0,0,0,0,0,0,0,0,0,0,0,0,0,0,0,Felipe Mattioni,£1.80m ,32,178,Defender - Right-Back,right,Esporte Clube SÃ£o JosÃ© (RS),nan,nan,nan,nan,nan,nan,nan,nan,7,0,0,373,3,0,0,254,8,0,0,209,9,0,1,663,3,0,1,198,22,1,1,1897,10,0,1,740,LaLiga,3,0,0,179,nan,nan,nan,nan
19/6/2011,Federico Fernández,14011214,1649,2/21/1989,22,2,1,7,0,3000,4500,5500,150,119,935599,190,83,D RC,1,2,1,2,1,1,1,5,1,3,1,4,5,4,5,6,5,16,4,10,15,11,5,17,8,12,14,12,8,13,6,12,7,6,9,9,15,12,12,12,9,12,15,5,14,11,20,13,15,13,12,8,3,12,13,10,5,11,10,10,12,2,20,1,1,1,17,1,20,D RC,103,1,1,1,1,1,1,20,1,17,1,1,1,1,1,1,0,0,0,0,0,0,0,0,0,0,0,0,0,0,0,0,0,0,0,0,0,0,0,0,0,0,0,0,0,0,0,0,0,0,0,0,0,0,0,0,0,0,0,0,0,0,0,0,0,Federico Fernández,£2.70m ,31,190,Defender - Centre-Back,right,Newcastle United,41,2,0,3526,19,2,0,1175,23,1,1,1859,36,0,1,3110,32,0,0,2825,32,1,1,2880,30,0,2,2654,34,1,1,2933,23,0,1,1842,Serie A,35,2,2,2918,7,0,0,630
19/6/2011,Daniel Williams,91003280,771,3/8/1989,22,0,0,0,0,3400,5500,5500,138,117,635854,182,79,D/DM RL,1,3,3,1,1,1,1,3,3,3,3,9,8,14,7,15,9,13,7,16,14,13,10,13,15,12,13,10,9,12,11,8,10,9,8,14,12,15,10,10,9,11,14,20,12,13,15,11,10,11,8,10,5,12,6,14,9,11,18,2,12,10,16,1,8,1,15,16,10,D/DM RL,325,1,1,1,1,1,1,10,16,15,20,8,1,1,1,1,8.79609E+12,0,0,0,0,0,0,0,0,0,0,0,0,0,0,0,0,0,0,0,0,0,0,0,0,0,0,0,0,0,0,0,0,0,0,0,0,0,0,0,0,0,0,0,1,0,0,0,0,Danny Williams,£1.80m ,31,182,Midfielder - Defensive Midfield,right,Without Club,15,0,1,796,28,0,1,1855,22,1,0,1622,32,3,2,2295,32,1,0,2493,46,6,3,3736,47,4,1,3865,24,1,0,1422,6,0,0,162,Bundesliga,11,0,0,733,nan,nan,nan,nan
19/6/2011,Daniel Wass,936891,764,5/31/1989,22,2,0,14,0,4500,6000,5500,137,122,125133,181,74,D/WB/M/AM R,1,3,3,2,2,1,2,1,3,1,3,6,13,12,11,11,13,11,10,13,10,13,8,13,11,16,12,16,10,10,8,7,10,10,9,12,8,8,11,16,13,13,10,12,11,15,20,14,10,12,13,13,7,18,6,16,13,13,14,13,8,8,20,18,17,17,20,3,13,D/WB/M/AM R,132,1,1,11,10,1,17,10,3,20,14,13,1,17,1,18,1.37439E+11,0,0,0,0,0,1,0,0,0,0,0,0,0,0,0,0,0,0,0,0,0,0,0,0,0,0,0,0,0,0,0,0,0,0,0,0,0,1,0,0,0,0,0,0,0,0,0,0,Daniel Wass,£2.70m ,31,178,Defender - Right-Back,right,Valencia CF,39,7,4,3116,31,4,4,2540,39,2,2,3492,42,11,3,3520,35,10,4,2673,43,3,6,3177,54,7,5,3722,39,4,9,3081,50,2,7,3742,Ligue 1,45,2,6,3632,7,1,1,619
19/6/2011,Daniel Schwaab,35008048,771,8/23/1988,22,0,0,24,1,4600,6650,6650,150,133,271378,186,76,D/WB RC,3,2,1,2,1,2,2,3,2,1,3,10,9,12,4,13,6,13,6,14,12,13,15,12,13,6,13,13,11,11,14,12,17,8,9,11,13,14,14,14,12,12,13,12,14,13,20,17,11,11,3,13,6,15,11,18,15,10,19,19,14,4,20,16,1,1,20,12,19,D/WB RC,113,1,1,1,1,1,1,19,12,20,7,1,1,1,10,16,0,0,0,0,0,0,0,0,0,0,0,0,0,0,0,0,0,0,0,0,0,0,0,0,0,0,0,0,0,0,0,0,0,0,0,0,0,0,0,0,0,0,0,0,0,0,0,0,0,Daniel Schwaab,£3.15m ,32,186,Defender - Centre-Back,right,Retired,40,0,4,3322,28,0,0,2234,22,0,2,1284,38,0,1,3412,32,1,1,2436,32,0,1,2598,31,0,0,2020,36,2,4,3249,39,1,0,3530,Bundesliga,24,2,2,2011,nan,nan,nan,nan
19/6/2011,César,67037262,796,1/30/1989,22,0,0,0,0,2000,4750,4750,125,95,219184,182,75,D RC,3,2,2,2,2,3,1,1,2,3,2,6,8,7,5,9,5,14,3,14,11,9,5,12,10,13,11,15,10,11,12,13,12,5,10,5,9,14,13,10,10,12,14,5,13,13,20,13,12,14,8,12,7,13,7,12,10,13,12,6,14,20,20,8,5,1,20,5,20,D RC,103,1,14,1,1,1,1,20,5,20,10,5,1,1,1,8,32768,0,0,0,0,0,0,0,0,0,0,0,0,0,0,0,1,0,0,0,0,0,0,0,0,0,0,0,0,0,0,0,0,0,0,0,0,0,0,0,0,0,0,0,0,0,0,0,0,,,,,,,,,,,,,,,,,,,,,,,,,,,,,,,,,,,,,,,,,,,,,,,,,,,,
19/6/2011,Basso,43041214,1651,4/14/1989,22,0,0,0,0,750,2750,2950,125,84,23510,186,85,D R,1,2,3,2,2,1,2,1,2,2,3,5,10,1,1,11,7,11,8,9,13,11,7,13,13,16,9,5,9,12,7,9,8,9,11,5,13,9,12,12,12,12,12,8,17,13,20,8,5,10,6,10,11,10,2,12,8,7,8,10,8,11,20,6,1,1,20,9,1,D R,102,1,1,1,1,1,1,1,9,20,1,1,1,1,1,6,0,0,0,0,0,0,0,0,0,0,0,0,0,0,0,0,0,0,0,0,0,0,0,0,0,0,0,0,0,0,0,0,0,0,0,0,0,0,0,0,0,0,0,0,0,0,0,0,0,,,,,,,,,,,,,,,,,,,,,,,,,,,,,,,,,,,,,,,,,,,,,,,,,,,,
19/6/2011,Sokratis Papastathopoulos,1804808,772,6/9/1988,23,20,0,8,2,6500,7000,6950,161,139,1412490,185,82,D RC,1,2,2,1,3,3,2,7,1,2,1,5,9,12,4,9,4,13,5,16,18,10,6,18,11,17,14,18,12,10,7,11,16,4,14,9,11,16,17,13,9,18,15,8,17,17,20,16,15,13,14,8,5,14,14,15,12,11,13,15,7,5,20,13,9,1,16,3,20,D RC,103,1,10,1,1,1,1,20,3,16,12,1,1,9,1,13,1.23695E+12,0,1,0,0,0,0,1,0,0,0,0,0,0,0,0,1,0,0,0,0,0,0,0,0,0,0,0,0,0,0,0,0,0,0,0,0,0,1,0,0,1,0,0,0,0,0,0,0,,,,,,,,,,,,,,,,,,,,,,,,,,,,,,,,,,,,,,,,,,,,,,,,,,,,
19/6/2011,Sílvio,55011718,788,9/28/1987,23,4,0,0,0,4520,6765,6530,146,142,6324111,178,72,D RL,1,1,2,3,2,2,3,3,2,1,2,10,13,11,8,13,9,9,11,15,12,11,12,15,14,15,14,13,13,13,10,12,14,12,10,14,12,14,15,15,14,11,9,14,13,15,20,15,11,15,9,12,7,15,19,12,13,14,14,14,15,6,20,14,1,1,20,17,1,D RL,105,1,1,1,1,1,1,1,17,20,1,1,1,1,12,14,0,0,0,0,0,0,0,0,0,0,0,0,0,0,0,0,0,0,0,0,0,0,0,0,0,0,0,0,0,0,0,0,0,0,0,0,0,0,0,0,0,0,0,0,0,0,0,0,0,Sílvio,£7.20m ,33,176,Defender - Right-Back,right,Vitória Guimarães SC,38,1,2,3374,15,0,1,1042,24,2,1,1957,21,0,3,1732,4,0,1,253,14,0,0,1159,7,0,0,625,12,2,0,1071,8,0,0,684,LaLiga,34,0,1,3048,4,0,0,356
19/6/2011,Rico Schlimpert,35026135,771,2/23/1988,23,0,0,0,0,371,3500,3500,80,70,12107,188,68,D RC,2,3,3,3,2,3,2,1,1,1,2,5,5,5,2,11,2,10,9,4,14,11,3,11,8,11,12,11,8,11,6,10,6,6,3,10,9,8,11,10,12,13,14,3,12,14,20,7,6,8,7,7,5,10,7,13,10,11,13,13,7,13,20,14,1,1,15,1,20,D RC,103,1,1,1,1,1,1,20,1,15,1,1,1,1,1,14,0,0,0,0,0,0,0,0,0,0,0,0,0,0,0,0,0,0,0,0,0,0,0,0,0,0,0,0,0,0,0,0,0,0,0,0,0,0,0,0,0,0,0,0,0,0,0,0,0,,,,,,,,,,,,,,,,,,,,,,,,,,,,,,,,,,,,,,,,,,,,,,,,,,,,
19/6/2011,Richard Stearman,5112614,765,8/19/1987,23,0,0,4,0,3650,6000,6250,144,125,777237,188,78,D RC,3,1,2,3,2,1,1,5,1,3,3,4,9,11,11,11,5,13,4,13,11,13,8,15,11,10,11,12,12,10,9,10,16,14,11,4,12,12,15,16,11,13,12,9,14,16,20,14,14,11,4,13,4,13,12,10,15,15,13,13,16,5,20,10,10,1,18,1,20,D RC,103,1,1,12,1,1,1,20,1,18,1,9,1,10,1,10,1.37439E+11,0,0,1,0,0,0,0,0,0,0,0,0,0,0,0,0,0,0,0,0,0,0,0,0,0,0,0,0,0,0,0,0,0,0,0,0,0,1,0,0,0,0,0,0,0,0,0,0,Richard Stearman,£2.25m ,33,191,Defender - Centre-Back,right,Huddersfield Town,36,1,0,3007,34,0,0,2765,31,1,0,2373,44,2,1,3824,45,0,1,3801,35,0,0,3015,21,1,0,1920,30,2,0,2566,17,1,0,526,Premier League,20,1,0,1662,7,0,1,622
19/6/2011,Philipp Klingmann,35023847,771,4/22/1988,23,0,0,0,0,1000,4400,4100,104,88,21437,178,78,D R,3,1,1,2,3,1,2,4,2,3,2,8,10,10,7,10,8,6,7,15,10,10,7,10,10,7,11,10,11,11,8,11,8,5,9,12,13,11,13,11,10,11,9,6,10,11,20,14,11,11,5,10,5,16,8,8,11,10,10,10,10,5,20,9,15,10,20,9,1,D R,102,1,1,1,1,1,10,1,9,20,1,1,1,15,1,9,0,0,0,0,0,0,0,0,0,0,0,0,0,0,0,0,0,0,0,0,0,0,0,0,0,0,0,0,0,0,0,0,0,0,0,0,0,0,0,0,0,0,0,0,0,0,0,0,0,Philipp Klement,£90Th. ,28,175,Midfielder - Attacking Midfield,left,VfB Stuttgart,18,3,15,1578,18,3,6,1308,26,2,5,1708,28,6,7,2189,32,5,8,1626,18,6,3,1323,24,5,4,1844,20,3,5,1374,35,16,9,3003,Bundesliga,21,0,4,1213,5,0,1,85
19/6/2011,Pereirinha,55001512,788,3/2/1988,23,0,0,11,0,2250,5750,5750,130,115,126606,173,68,D/WB/M/AM R,3,3,3,2,3,1,2,4,3,3,2,13,13,13,9,11,8,7,10,10,10,10,10,13,12,11,10,13,13,11,12,9,11,13,9,14,9,10,11,16,14,7,8,8,13,16,20,11,8,10,8,11,7,16,11,11,15,12,16,16,16,3,18,17,20,18,20,10,12,D/WB/M/AM R,442,1,1,1,10,8,18,1,1,18,1,12,10,20,1,17,19,1,1,0,0,1,0,0,0,0,0,0,0,0,0,0,0,0,0,0,0,0,0,0,0,0,0,0,0,0,0,0,0,0,0,0,0,0,0,0,0,0,0,0,0,0,0,0,0,Bruno Pereirinha,£2.25m ,32,174,Forward - Right Winger,right,Without Club,24,1,2,1067,24,0,1,1192,14,0,1,784,11,0,1,767,16,1,0,527,0,0,0,0,nan,nan,nan,nan,18,0,0,960,18,0,0,1167,Liga NOS,nan,nan,nan,nan,nan,nan,nan,nan
19/6/2011,Pedro,67043441,796,3/6/1988,23,0,0,0,0,1554,3824,3784,101,85,121644,175,68,D R,1,1,1,3,1,3,2,3,1,1,3,4,3,9,2,12,3,11,4,4,13,8,3,12,9,8,11,11,11,13,8,11,8,3,8,4,13,7,11,13,12,13,7,9,13,13,20,7,3,10,10,10,4,10,10,8,5,15,6,6,10,2,20,9,1,1,20,5,1,D R,102,1,1,1,1,1,1,1,5,20,1,1,1,1,1,9,0,0,0,0,0,0,0,0,0,0,0,0,0,0,0,0,0,0,0,0,0,0,0,0,0,0,0,0,0,0,0,0,0,0,0,0,0,0,0,0,0,0,0,0,0,0,0,0,0,Pedro,£25.20m ,33,167,Forward - Right Winger,both,AS Roma,53,22,13,3588,48,13,6,2774,45,10,11,3413,54,19,13,3320,50,11,9,2199,43,9,3,2781,43,13,12,2723,48,7,5,2509,52,13,5,3099,LaLiga,23,2,3,1273,5,2,1,400
19/6/2011,Paul Baysse,8448625,769,5/18/1988,23,0,0,9,1,4600,5773,5773,145,128,531058,184,85,D RC,2,3,1,3,2,1,2,1,1,1,3,5,10,7,7,11,6,16,13,11,13,9,7,12,11,14,13,16,12,15,10,13,14,6,12,7,15,12,14,12,9,15,13,6,13,11,20,15,15,15,14,14,8,6,9,15,12,14,14,14,14,5,20,15,1,1,20,12,18,D RC,103,1,1,1,1,1,1,18,12,20,1,1,1,1,1,15,32,0,0,0,0,0,1,0,0,0,0,0,0,0,0,0,0,0,0,0,0,0,0,0,0,0,0,0,0,0,0,0,0,0,0,0,0,0,0,0,0,0,0,0,0,0,0,0,0,Paul Baysse,£2.70m ,32,185,Defender - Centre-Back,right,FC Girondins Bordeaux,39,3,1,3508,36,1,0,3166,19,2,0,1710,0,0,0,0,14,1,0,1058,33,0,0,2914,25,2,1,2126,24,1,0,1896,26,0,0,2273,Ligue 1,0,0,0,0,7,0,0,512
19/6/2011,Pablo Pintos,78015289,1657,7/1/1987,23,0,0,0,0,4000,6500,6400,143,128,971423,182,78,D/WB/M R,3,1,3,2,2,2,3,3,2,1,2,4,13,12,6,12,4,10,8,10,12,12,5,11,14,14,13,13,12,8,12,7,13,15,7,13,11,15,15,16,13,14,13,10,17,17,20,15,14,11,14,12,4,18,10,10,10,12,14,7,8,6,20,19,17,1,20,9,1,D/WB/M R,122,1,1,1,1,1,1,1,9,20,1,1,1,17,1,19,32,0,0,0,0,0,1,0,0,0,0,0,0,0,0,0,0,0,0,0,0,0,0,0,0,0,0,0,0,0,0,0,0,0,0,0,0,0,0,0,0,0,0,0,0,0,0,0,0,Pablo Barrientos,£3.60m ,35,176,Forward - Right Winger,left,Without Club,21,2,3,1137,26,4,5,1753,35,5,5,2922,31,5,5,2346,41,3,5,2033,17,3,1,747,41,8,5,2843,43,6,8,3019,33,2,6,1900,Serie A,nan,nan,nan,nan,nan,nan,nan,nan
19/6/2011,Nenad Tomovic,5768029,802,8/30/1987,23,5,0,20,1,4750,6106,6550,147,131,287378,184,74,D RC,2,2,1,3,3,2,1,4,1,3,3,8,12,10,8,14,11,12,9,10,14,14,13,14,13,16,10,12,16,11,11,13,13,13,11,14,13,14,16,14,13,13,12,5,15,15,20,13,15,13,9,13,7,16,13,15,15,14,11,11,13,6,20,15,15,1,20,9,18,D RC,103,1,1,1,1,1,1,18,9,20,1,1,1,15,1,15,8.79609E+12,0,0,0,0,0,1,0,0,0,0,0,0,0,0,0,0,0,0,0,0,0,0,0,0,0,0,0,0,0,0,0,0,0,0,0,0,0,0,0,0,0,0,0,1,0,0,0,0,Nenad Tomović,£1.17m ,33,184,Defender - Centre-Back,right,SPAL,19,0,0,1770,34,1,0,2978,30,0,1,2470,35,0,1,2779,37,1,2,3006,33,0,0,2380,35,0,1,2559,29,0,0,2437,11,1,0,831,Serie A,25,0,1,1911,5,0,1,434
19/6/2011,Mauricio Isla,75000523,1652,6/12/1988,23,24,1,1,0,4700,7450,7450,164,150,2330937,175,72,D/WB/DM/M RC,2,3,1,2,2,3,2,3,2,1,3,7,10,14,8,14,6,6,7,7,11,13,10,15,12,18,16,16,12,15,14,12,15,10,13,17,12,17,18,15,14,14,6,9,15,15,20,18,11,14,12,13,3,19,17,15,13,13,12,12,9,6,16,20,17,1,20,7,17,D/WB/DM/M RC,243,1,1,1,1,1,1,1,1,16,17,17,1,14,7,20,1048608,0,0,0,0,0,1,0,0,0,0,0,0,0,0,0,0,0,0,0,0,1,0,0,0,0,0,0,0,0,0,0,0,0,0,0,0,0,0,0,0,0,0,0,0,0,0,0,0,Mauricio Isla,£12.60m ,32,176,Defender - Right-Back,right,Clube de Regatas do Flamengo,35,3,7,2938,28,3,2,2239,21,0,3,1302,27,0,2,1582,27,0,2,2161,39,2,2,3125,35,1,8,2958,29,0,3,1942,37,0,7,3001,Serie A,37,0,7,2900,nan,nan,nan,nan
19/6/2011,Matthew Connolly,5119972,765,9/24/1987,23,0,0,0,0,3500,6000,6000,142,128,595968,189,84,D RLC,3,2,2,3,3,1,1,3,2,2,1,2,9,10,5,12,6,16,8,3,15,14,5,15,13,11,14,14,15,13,9,13,15,7,14,11,17,13,12,10,8,10,15,10,12,11,20,10,13,13,7,10,10,12,16,13,10,12,14,14,16,3,20,1,1,1,15,15,20,D RLC,106,1,1,1,1,1,1,20,15,15,8,1,1,1,1,1,4294967552,0,0,0,0,0,0,0,0,1,0,0,0,0,0,0,0,0,0,0,0,0,0,0,0,0,0,0,0,0,0,0,0,1,0,0,0,0,0,0,0,0,0,0,0,0,0,0,0,Matthew Connolly,£1.35m ,33,188,Defender - Centre-Back,right,Without Club,37,0,2,3060,13,0,1,1052,36,5,2,3160,4,0,0,360,32,1,2,2427,45,1,1,4025,29,1,1,2434,5,0,0,450,1,0,0,90,Premier League,nan,nan,nan,nan,nan,nan,nan,nan
19/6/2011,Marcelo Tchê,55041957,1651,3/11/1988,23,0,0,0,0,337,4094,1575,110,91,4946,181,78,D R,2,3,3,3,2,3,1,1,2,2,2,7,12,7,2,10,3,5,7,9,13,9,4,13,13,17,11,6,8,10,5,13,10,6,7,1,13,16,13,11,10,12,11,10,13,13,20,8,4,10,10,10,11,10,11,7,4,8,8,7,10,18,20,8,1,1,20,2,1,D R,102,1,1,1,1,1,1,1,2,20,1,1,1,1,1,8,0,0,0,0,0,0,0,0,0,0,0,0,0,0,0,0,0,0,0,0,0,0,0,0,0,0,0,0,0,0,0,0,0,0,0,0,0,0,0,0,0,0,0,0,0,0,0,0,0,Marcelo Tchê,£450Th. ,32,180,Defender - Right-Back,right,Without Club,nan,nan,nan,nan,16,0,0,1211,nan,nan,nan,nan,nan,nan,nan,nan,nan,nan,nan,nan,nan,nan,nan,nan,nan,nan,nan,nan,nan,nan,nan,nan,nan,nan,nan,nan,Liga NOS,nan,nan,nan,nan,nan,nan,nan,nan
19/6/2011,Marc Wilson,5114764,789,8/17/1987,23,1,0,0,0,4417,6275,6650,146,130,1636364,188,80,DM/M RC,2,1,1,2,3,3,1,2,1,1,1,12,15,11,8,13,14,12,8,6,8,14,16,12,12,14,12,12,15,12,14,13,16,10,13,10,12,10,14,11,10,14,14,17,14,12,20,14,13,14,8,11,7,12,14,12,15,10,12,9,9,14,15,8,18,1,15,12,18,DM/M RC,313,1,1,1,1,1,1,15,12,15,20,18,8,8,8,8,1.49538E+14,0,0,0,0,0,0,0,0,0,0,0,0,0,0,0,0,0,0,0,0,0,0,1,0,0,0,0,0,0,0,0,0,1,0,0,0,0,0,0,0,0,0,0,1,0,0,0,1,Marc Wilson,£4.50m ,33,188,Defender - Centre-Back,both,Retired,41,1,2,2942,45,0,1,3801,20,0,0,1611,38,0,0,3121,30,0,1,2394,11,1,0,929,8,1,0,526,22,0,0,1779,17,0,0,1267,Premier League,nan,nan,nan,nan,nan,nan,nan,nan
19/6/2011,Lorenzo De Silvestri,1401054,776,5/23/1988,23,1,0,18,0,5000,6600,6600,153,132,423862,185,78,D/WB R,1,1,1,1,1,1,1,1,1,1,1,5,11,7,4,7,3,13,7,7,12,11,5,14,9,15,13,16,10,12,7,12,13,4,10,16,13,15,14,15,15,15,14,6,16,17,20,17,18,15,12,14,11,11,15,12,14,12,15,16,13,10,20,17,13,11,20,14,1,D/WB R,112,1,1,1,1,1,11,1,14,20,1,1,1,13,11,17,1.37439E+12,0,0,0,0,0,0,0,0,0,0,0,0,0,0,0,0,0,0,0,0,1,0,0,0,0,0,0,0,0,0,0,0,0,0,0,0,0,0,1,0,1,0,0,0,0,0,0,0,Lorenzo De Silvestri,£3.60m ,32,186,Defender - Right-Back,right,Bologna FC 1909,28,1,0,2255,24,0,2,1617,25,2,0,1956,36,2,3,3175,35,4,3,3044,17,1,2,1397,19,1,3,1557,39,7,2,3253,34,2,4,2606,Serie A,37,3,1,2984,5,1,0,411
19/6/2011,Larrys Mabiala,8444104,53,10/8/1987,23,8,0,0,0,4700,5850,5250,140,117,212185,189,84,D RC,2,1,2,2,2,3,1,1,1,2,1,6,10,7,6,9,8,15,11,8,13,8,6,14,9,10,14,15,11,11,7,11,14,7,7,7,12,13,14,8,11,16,14,10,10,11,20,15,16,12,10,13,14,8,11,13,14,9,12,15,15,7,20,1,1,1,15,1,20,D RC,103,1,1,5,1,1,1,20,1,15,1,1,1,1,1,1,0,0,0,0,0,0,0,0,0,0,0,0,0,0,0,0,0,0,0,0,0,0,0,0,0,0,0,0,0,0,0,0,0,0,0,0,0,0,0,0,0,0,0,0,0,0,0,0,0,Larrys Mabiala,£1.53m ,33,189,Defender - Centre-Back,right,Portland Timbers,12,0,0,838,26,2,2,2294,29,0,0,2538,32,1,3,2820,38,0,1,3510,34,1,0,2757,47,3,0,4065,36,5,1,3122,27,2,0,2354,Ligue 1,17,2,0,1399,nan,nan,nan,nan
19/6/2011,Juan Guillermo Cuadrado,76010707,1653,5/26/1988,23,7,1,0,0,4250,6400,6200,142,126,251185,176,66,D/WB/M R,2,3,1,1,3,3,1,6,2,1,1,11,12,16,8,12,14,10,15,15,9,12,9,10,14,10,12,13,11,7,14,8,11,14,8,11,7,12,13,16,17,9,7,12,15,15,20,14,7,11,9,15,8,13,10,10,14,12,14,14,14,6,18,20,19,15,20,1,5,D/WB/M R,232,1,1,1,1,1,15,1,1,18,1,5,1,19,1,20,3.51844E+13,0,0,0,0,0,0,0,0,0,1,0,0,0,0,0,0,0,0,0,0,0,0,0,0,0,0,0,0,0,0,0,0,0,0,0,0,0,0,0,0,0,0,0,0,0,1,0,0,,,,,,,,,,,,,,,,,,,,,,,,,,,,,,,,,,,,,,,,,,,,,,,,,,,,
19/6/2011,José Picón,67053078,796,3/13/1988,23,0,0,0,0,2045,4634,4315,135,103,80551,182,74,D RC,2,2,1,1,3,1,2,2,1,3,3,3,5,4,4,7,4,13,3,10,13,8,6,11,7,12,11,12,11,13,5,12,13,8,9,7,12,11,12,13,13,13,12,6,13,13,20,13,13,11,12,10,7,10,13,13,13,11,15,9,9,9,20,5,1,1,20,2,18,D RC,103,1,1,1,1,1,1,18,2,20,1,1,1,1,1,5,0,0,0,0,0,0,0,0,0,0,0,0,0,0,0,0,0,0,0,0,0,0,0,0,0,0,0,0,0,0,0,0,0,0,0,0,0,0,0,0,0,0,0,0,0,0,0,0,0,José Picón,£180Th. ,32,184,Defender - Centre-Back,right,Barakaldo CF,25,0,0,1938,5,0,0,286,7,0,0,577,23,1,0,1962,23,0,0,1818,24,1,0,2022,29,3,0,2279,26,0,0,2172,32,1,0,2860,LaLiga,3,0,0,225,0,0,0,0
19/6/2011,João Gonçalves,55003168,788,1/18/1988,23,0,0,8,0,2000,5500,5500,132,110,83071,180,73,D R,1,3,1,1,2,3,1,1,1,2,1,11,12,10,8,12,10,10,10,12,11,10,12,13,12,12,12,12,12,12,11,11,12,9,10,14,12,12,12,12,12,12,11,8,12,12,20,12,12,13,8,10,13,10,17,11,15,13,14,15,15,5,20,7,10,1,20,5,10,D R,102,1,1,1,1,1,1,1,5,20,10,10,1,10,1,7,0,0,0,0,0,0,0,0,0,0,0,0,0,0,0,0,0,0,0,0,0,0,0,0,0,0,0,0,0,0,0,0,0,0,0,0,0,0,0,0,0,0,0,0,0,0,0,0,0,João Gonçalves,£990Th. ,32,180,Defender - Right-Back,right,Retired,29,1,0,2463,13,0,1,1167,6,0,0,394,nan,nan,nan,nan,nan,nan,nan,nan,nan,nan,nan,nan,nan,nan,nan,nan,nan,nan,nan,nan,nan,nan,nan,nan,Liga NOS,nan,nan,nan,nan,nan,nan,nan,nan
19/6/2011,Ion Echaide,67013743,796,1/5/1988,23,0,0,1,0,3600,5600,5600,128,112,222332,179,78,D RL,2,2,1,1,2,1,3,4,2,2,1,7,12,8,5,10,6,13,7,9,12,10,8,13,11,13,12,13,8,14,7,9,9,6,5,9,12,14,14,13,12,10,11,10,14,12,20,15,13,10,9,10,5,10,9,6,12,11,15,7,7,10,20,8,1,1,20,18,13,D RL,105,1,5,1,1,1,1,13,18,20,7,1,1,1,8,6,0,0,0,0,0,0,0,0,0,0,0,0,0,0,0,0,0,0,0,0,0,0,0,0,0,0,0,0,0,0,0,0,0,0,0,0,0,0,0,0,0,0,0,0,0,0,0,0,0,Jon Echaide,£630Th. ,32,181,Defender - Centre-Back,right,Haro Deportivo,38,0,0,3157,3,0,0,104,25,0,1,2189,18,0,0,1546,21,0,0,1366,40,1,0,3522,38,1,0,3116,29,0,0,2269,25,0,0,2047,LaLiga,15,0,0,841,2,0,0,135
19/6/2011,Hélder,19026681,1651,4/13/1988,23,0,0,0,0,3000,5039,5031,135,112,333395,175,68,D/WB R,2,1,2,2,1,1,1,7,2,2,2,10,11,9,6,9,7,8,8,13,8,9,7,11,9,10,12,12,11,11,11,9,12,8,6,13,10,13,14,17,14,12,7,8,14,18,20,14,9,10,10,13,8,10,11,10,8,11,11,9,9,7,20,16,12,1,20,10,1,D/WB R,112,1,1,1,1,1,1,1,10,20,10,1,1,12,10,16,134217730,0,1,0,0,0,0,0,0,0,0,0,0,0,0,0,0,0,0,0,0,0,0,0,0,0,0,0,1,0,0,0,0,0,0,0,0,0,0,0,0,0,0,0,0,0,0,0,0,Helder,£810Th. ,32,175,Defender - Right-Back,right,Without Club,26,1,4,2209,11,0,0,597,11,0,1,735,2,0,0,105,nan,nan,nan,nan,13,0,2,969,1,0,0,45,20,4,1,1688,2,0,0,180,Ligue 1,nan,nan,nan,nan,nan,nan,nan,nan
19/6/2011,Gary Medel,75000560,1652,8/3/1987,23,31,3,0,0,5800,7250,7000,160,144,1441490,172,71,D/WB/DM/M RC,2,3,1,2,2,2,3,5,3,1,1,8,10,9,13,10,6,15,13,13,16,12,4,17,11,17,16,19,6,14,11,12,14,12,13,10,15,14,19,13,14,14,8,9,17,13,20,18,11,14,12,16,4,18,13,15,16,12,12,9,7,14,17,16,17,1,17,1,17,D/WB/DM/M RC,343,1,1,1,1,1,1,17,1,16,20,16,1,17,1,16,33088,0,0,0,0,0,0,1,0,1,0,0,0,0,0,0,1,0,0,0,0,0,0,0,0,0,0,0,0,0,0,0,0,0,0,0,0,0,0,0,0,0,0,0,0,0,0,0,0,Gary Medel,£5.40m ,33,171,Midfielder - Defensive Midfield,right,Bologna FC 1909,35,0,0,2866,37,2,0,3071,39,7,3,3226,35,0,1,2918,44,0,3,3739,34,1,3,2790,31,0,0,2576,40,1,2,3043,35,0,0,2826,LaLiga,26,0,0,2015,2,0,1,45
19/6/2011,Garry Bocaly,8439529,769,4/19/1988,23,0,0,14,0,4700,5900,5900,155,132,493470,180,74,D/WB RC,2,3,1,1,1,2,3,1,3,2,1,12,11,11,7,11,7,13,10,10,12,9,7,15,12,14,13,14,12,13,10,13,16,8,10,12,12,12,15,15,13,14,10,5,15,14,20,15,14,15,12,14,6,10,14,16,14,14,14,14,14,6,20,18,10,1,20,8,16,D/WB RC,113,1,1,1,1,1,1,16,8,20,12,8,1,10,8,18,32,0,0,0,0,0,1,0,0,0,0,0,0,0,0,0,0,0,0,0,0,0,0,0,0,0,0,0,0,0,0,0,0,0,0,0,0,0,0,0,0,0,0,0,0,0,0,0,0,Garry Bocaly,£4.50m ,32,180,Defender - Right-Back,right,L'Aiglon du Lamentin,31,3,0,2650,37,0,4,3232,10,0,0,800,3,0,0,234,14,0,0,1056,nan,nan,nan,nan,nan,nan,nan,nan,nan,nan,nan,nan,1,0,0,5,Ligue 1,nan,nan,nan,nan,nan,nan,nan,nan
19/6/2011,Fabian Johnson,8726381,390,12/11/1987,23,0,0,0,0,3800,5950,5950,137,119,836785,183,70,D/M RL,3,1,3,3,3,2,2,4,1,2,3,9,11,12,6,12,10,6,9,13,9,10,7,10,13,7,8,7,8,11,9,9,9,10,5,14,9,14,16,17,16,10,10,20,13,15,15,14,8,10,7,10,5,18,10,11,17,10,9,12,19,8,20,14,17,10,18,20,1,D/M RL,115,1,1,1,1,8,10,1,20,18,1,1,15,17,14,9,11,1,1,0,1,0,0,0,0,0,0,0,0,0,0,0,0,0,0,0,0,0,0,0,0,0,0,0,0,0,0,0,0,0,0,0,0,0,0,0,0,0,0,0,0,0,0,0,0,Fabian Johnson,£3.15m ,32,183,Forward - Left Winger,right,Without Club,7,0,0,256,33,3,8,2554,33,3,3,2856,28,0,5,2187,34,1,8,1911,34,8,6,2809,35,4,4,2038,12,1,0,479,18,1,1,1008,Bundesliga,7,0,0,298,nan,nan,nan,nan
19/6/2011,Efraín Juárez,51000041,379,2/22/1988,23,35,1,4,1,4500,7150,6500,145,130,880925,178,68,WB/DM/M RC,1,2,3,1,2,3,3,1,3,2,2,5,9,10,6,11,5,6,9,5,13,12,11,13,14,13,12,12,13,12,11,13,14,13,13,12,8,14,13,17,13,13,9,10,14,15,20,15,12,15,11,16,4,18,14,16,12,15,10,12,12,6,15,19,16,1,19,1,16,WB/DM/M RC,333,1,1,1,1,1,1,1,1,15,20,16,1,14,1,19,32,0,0,0,0,0,1,0,0,0,0,0,0,0,0,0,0,0,0,0,0,0,0,0,0,0,0,0,0,0,0,0,0,0,0,0,0,0,0,0,0,0,0,0,0,0,0,0,0,Efraín Juárez,£1.35m ,32,178,Defender - Right-Back,right,Retired,20,2,1,1144,16,1,1,1394,16,0,0,974,26,1,0,2138,30,0,1,2495,33,2,2,2820,28,1,0,1475,34,1,1,2406,21,0,4,1661,LaLiga,nan,nan,nan,nan,nan,nan,nan,nan
19/6/2011,Damián Suárez,78001192,1657,4/27/1988,23,0,0,26,0,3800,5129,5750,133,114,407560,173,74,D/WB/M RL,1,1,3,3,2,2,1,3,2,1,1,13,13,13,7,12,13,7,13,12,10,13,3,9,13,14,9,13,9,7,12,10,10,11,11,13,10,14,14,14,14,8,7,13,15,12,20,14,9,8,14,10,3,15,10,14,7,6,8,7,7,5,16,19,20,9,20,15,1,D/WB/M RL,435,1,1,1,1,1,9,1,15,16,8,1,1,20,15,19,32,0,0,0,0,0,1,0,0,0,0,0,0,0,0,0,0,0,0,0,0,0,0,0,0,0,0,0,0,0,0,0,0,0,0,0,0,0,0,0,0,0,0,0,0,0,0,0,0,Damián Suárez,£900Th. ,32,173,Defender - Right-Back,right,Getafe CF,25,1,2,2030,20,0,1,1484,33,1,3,2947,32,1,1,2851,37,1,1,3310,33,0,3,2769,42,0,6,3780,33,1,4,2878,42,0,3,3709,LaLiga,34,1,4,2958,6,0,0,523
19/6/2011,Christian Träsch,35003512,771,8/1/1987,23,7,0,0,0,6300,7450,7450,151,148,9172104,180,74,D/WB/DM/M RLC,1,3,1,1,2,2,3,1,2,2,3,9,14,11,6,7,9,6,15,15,18,9,9,17,7,16,15,17,9,17,7,12,13,5,14,7,13,19,18,15,10,10,11,16,17,13,20,19,11,18,4,15,6,18,9,7,12,5,15,11,13,9,18,17,19,1,18,16,19,D/WB/DM/M RLC,346,1,1,1,1,1,1,10,16,18,20,19,12,14,15,17,1.54619E+11,0,0,0,0,0,0,1,0,0,1,0,0,0,0,0,1,0,0,0,0,0,0,0,0,0,0,0,0,0,0,0,0,0,0,1,0,0,1,0,0,0,0,0,0,0,0,0,0,Christian Träsch,£6.30m ,33,180,Midfielder - Defensive Midfield,right,Retired,45,1,3,4005,34,0,5,2716,21,1,0,1079,26,0,2,2184,22,1,2,1376,38,0,3,2720,14,0,1,891,26,1,0,2166,11,0,0,758,Bundesliga,1,0,0,75,nan,nan,nan,nan
19/6/2011,Charles Kaboré,34013978,9,2/9/1988,23,26,2,0,0,5550,6900,6200,160,138,704117,181,75,DM/M RC,3,1,2,3,2,1,2,5,3,3,2,7,8,12,6,12,6,13,13,10,11,12,10,13,13,15,16,15,13,12,10,13,16,8,13,9,14,14,17,14,13,14,10,8,17,14,20,17,15,13,14,14,5,11,15,15,15,16,13,14,16,7,15,15,20,1,15,1,20,DM/M RC,423,1,1,1,1,1,1,8,1,15,17,20,1,10,1,15,320,0,0,0,0,0,0,1,0,1,0,0,0,0,0,0,0,0,0,0,0,0,0,0,0,0,0,0,0,0,0,0,0,0,0,0,0,0,0,0,0,0,0,0,0,0,0,0,0,Charles Kaboré,£4.50m ,32,183,Midfielder - Defensive Midfield,right,Dynamo Moscow,44,0,3,2857,38,0,1,2061,39,0,5,3178,35,1,7,2999,31,0,4,2649,32,0,1,2770,33,1,2,2765,22,0,0,1657,37,1,2,3073,Ligue 1,21,0,0,1368,11,0,0,732
19/6/2011,Atsuto Uchida,788633,116,3/27/1988,23,40,1,12,0,6300,6500,6400,151,133,2132708,176,62,D/WB R,1,2,1,2,1,1,1,4,2,2,3,10,16,12,6,15,10,9,5,13,11,14,8,13,15,14,12,16,8,10,11,13,13,12,7,16,9,17,18,16,17,8,7,10,17,14,20,16,6,12,7,10,12,10,13,13,17,14,14,7,6,6,20,18,12,1,20,9,1,D/WB R,112,1,1,1,1,1,1,1,9,20,1,1,1,12,1,18,1.09965E+12,0,1,0,1,0,0,0,0,0,0,0,0,0,0,0,0,0,0,0,0,1,0,0,0,0,0,0,1,0,0,0,0,0,0,0,0,0,0,0,0,1,0,0,0,0,0,0,0,Atsuto Uchida,£3.60m ,32,176,Defender - Right-Back,right,Retired,43,0,4,3552,26,0,3,2104,30,1,3,2510,27,1,5,2313,27,0,3,2240,nan,nan,nan,nan,1,0,0,7,23,1,4,1537,15,0,1,952,Bundesliga,3,0,0,203,nan,nan,nan,nan
19/6/2011,Allan Nyom,34009070,769,5/10/1988,23,0,0,0,0,4250,5651,5764,140,125,92425,188,78,D/WB R,2,1,2,3,2,1,3,1,2,2,2,5,14,13,6,9,6,14,8,11,12,14,7,12,12,12,12,14,11,11,7,11,15,10,9,14,14,15,13,16,10,14,14,5,15,15,20,16,16,13,12,10,5,10,16,14,13,11,16,6,13,1,20,20,1,1,20,10,14,D/WB R,112,1,1,1,1,1,1,14,10,20,1,1,1,1,10,20,134217760,0,0,0,0,0,1,0,0,0,0,0,0,0,0,0,0,0,0,0,0,0,0,0,0,0,0,0,1,0,0,0,0,0,0,0,0,0,0,0,0,0,0,0,0,0,0,0,0,Allan Nyom,£3.60m ,32,189,Defender - Right-Back,right,Getafe CF,45,1,0,4098,33,0,0,2944,36,0,2,3039,36,0,2,3074,38,1,1,3352,36,0,1,2826,34,0,2,2802,34,0,1,2758,27,1,2,1986,LaLiga,44,2,1,3245,6,0,1,510
19/6/2011,Ahmed Elmohamady,12009828,16,9/9/1987,23,42,1,0,0,3900,6400,6400,137,127,1225455,180,75,D/WB/M/AM R,2,1,3,3,2,1,1,3,2,2,2,13,16,12,11,13,13,14,12,14,9,11,10,12,14,13,12,8,11,8,11,13,8,13,12,13,8,12,10,15,13,9,14,7,15,15,20,12,11,9,12,4,7,13,12,12,12,10,9,5,8,8,16,19,16,20,20,1,1,D/WB/M/AM R,542,1,1,10,1,1,20,1,1,16,1,1,1,16,1,19,1.09991E+12,0,1,0,0,0,0,0,0,0,0,0,0,0,0,0,0,0,0,0,0,0,0,0,0,0,0,0,1,1,0,0,0,0,0,0,0,0,0,0,0,1,0,0,0,0,0,0,0,Ahmed Elmohamady,£2.70m ,33,182,Defender - Right-Back,right,Aston Villa,38,0,3,2573,22,1,1,969,43,3,9,3686,45,2,3,3930,43,3,6,3728,51,3,7,3765,37,0,2,2800,45,0,5,3340,42,2,8,3259,Premier League,25,2,4,1552,4,0,0,280
19/6/2011,Yuto Nagatomo,45005331,116,9/12/1986,24,42,3,6,1,5250,7000,7000,159,144,2223125,170,65,D/WB RL,1,2,1,2,3,2,2,1,1,2,2,11,13,11,8,11,6,9,10,12,12,11,8,13,11,15,14,14,13,14,8,11,13,11,11,16,13,15,16,17,15,10,8,14,14,14,20,17,10,16,9,14,6,13,5,4,9,12,17,12,4,7,20,18,13,1,19,20,1,D/WB RL,115,1,1,1,1,1,1,1,20,19,1,1,13,12,17,18,0,0,0,0,0,0,0,0,0,0,0,0,0,0,0,0,0,0,0,0,0,0,0,0,0,0,0,0,0,0,0,0,0,0,0,0,0,0,0,0,0,0,0,0,0,0,0,0,0,Yuto Nagatomo,£8.55m ,34,170,Defender - Left-Back,both,Olympique Marseille,35,2,1,2729,43,2,5,3432,35,2,4,2610,36,5,7,3024,18,0,2,1198,26,0,0,2039,20,0,0,1379,29,0,3,2472,25,1,4,2254,Serie A,24,2,0,1997,2,0,0,137
19/6/2011,Vasco Fernandes,727458,788,11/12/1986,24,0,0,1,0,4000,5250,5250,120,106,117520,181,74,D RC,3,1,3,1,2,3,3,1,3,2,1,6,9,8,6,11,9,9,9,7,9,12,9,12,11,12,13,11,13,9,8,13,8,12,11,9,11,14,12,12,12,10,9,11,13,14,20,10,12,9,16,8,6,12,7,5,15,16,11,14,15,14,20,9,1,1,20,10,16,D RC,103,1,10,1,1,1,1,16,10,20,15,1,1,1,1,9,34,0,1,0,0,0,1,0,0,0,0,0,0,0,0,0,0,0,0,0,0,0,0,0,0,0,0,0,0,0,0,0,0,0,0,0,0,0,0,0,0,0,0,0,0,0,0,0,0,Gelson Fernandes,£3.15m ,34,180,Midfielder - Defensive Midfield,right,Retired,30,2,2,2365,35,2,3,2240,28,0,0,2211,38,1,2,2906,36,0,0,3002,37,1,1,3203,28,0,0,1881,22,0,0,1168,37,1,0,3056,Serie A,22,0,0,1356,nan,nan,nan,nan
19/6/2011,Tomoaki Makino,784465,116,5/11/1987,24,5,0,9,1,3700,5709,5900,140,119,759236,182,76,D RLC,3,1,2,1,1,2,2,4,2,1,3,8,9,10,7,10,13,12,12,13,10,11,9,13,11,11,10,16,12,10,12,10,12,15,8,9,10,12,13,13,14,13,11,16,11,12,20,12,12,10,7,11,7,14,6,12,11,10,13,9,7,8,20,10,8,1,17,17,20,D RLC,106,1,10,1,1,1,1,20,17,17,15,8,4,4,10,10,32,0,0,0,0,0,1,0,0,0,0,0,0,0,0,0,0,0,0,0,0,0,0,0,0,0,0,0,0,0,0,0,0,0,0,0,0,0,0,0,0,0,0,0,0,0,0,0,0,Tomoaki Makino,£900Th. ,33,182,Defender - Centre-Back,right,Urawa Red Diamonds,5,0,0,133,44,6,1,3541,45,6,4,3900,39,6,0,3384,43,4,3,3930,39,3,1,3502,48,3,0,4202,42,5,1,3780,49,3,0,4365,Bundesliga,20,1,0,1665,nan,nan,nan,nan
19/6/2011,Sueliton,19000770,1651,8/19/1986,24,0,0,0,0,500,5250,5250,124,105,658555,176,63,D/WB R,2,1,1,2,1,1,2,2,1,2,2,9,11,10,8,9,10,9,8,12,10,10,10,14,10,7,14,5,14,13,8,8,10,7,4,13,14,15,15,12,14,14,11,20,15,13,7,14,8,12,11,10,6,10,11,10,3,1,9,7,11,7,18,20,1,1,20,14,1,D/WB R,222,1,1,1,1,1,1,1,14,18,1,1,1,1,14,20,33,1,0,0,0,0,1,0,0,0,0,0,0,0,0,0,0,0,0,0,0,0,0,0,0,0,0,0,0,0,0,0,0,0,0,0,0,0,0,0,0,0,0,0,0,0,0,0,0,Sueliton,£90Th. ,34,178,Defender - Right-Back,right,Without Club,nan,nan,nan,nan,1,0,0,54,31,2,2,2605,38,0,9,3255,16,0,2,828,15,0,2,1112,12,1,1,992,23,0,1,1901,3,1,0,126,LaLiga,nan,nan,nan,nan,nan,nan,nan,nan
19/6/2011,Sebastian Boenisch,35001645,787,2/1/1987,24,0,0,13,0,4750,6250,6300,137,126,204488,191,86,D/WB RL,3,3,1,3,2,3,1,6,3,3,1,7,9,10,6,8,9,11,9,16,13,8,10,13,7,16,9,16,9,10,7,8,18,7,11,14,10,15,18,13,8,15,14,20,14,18,19,17,16,12,12,10,11,16,12,13,14,13,15,11,8,5,20,20,12,1,15,20,12,D/WB RL,115,1,1,1,1,1,1,12,20,15,1,1,12,1,20,15,131593,1,0,0,1,0,0,0,0,0,1,0,0,0,0,0,0,0,1,0,0,0,0,0,0,0,0,0,0,0,0,0,0,0,0,0,0,0,0,0,0,0,0,0,0,0,0,0,0,Sebastian Boenisch,£1.13m ,33,191,Defender - Left-Back,right,Without Club,4,0,1,160,7,1,0,386,19,1,4,1367,31,1,6,2709,19,0,2,1432,8,1,0,549,15,0,1,1218,nan,nan,nan,nan,nan,nan,nan,nan,Bundesliga,9,1,2,555,nan,nan,nan,nan
19/6/2011,Rômulo,8833765,1651,5/22/1987,24,0,0,0,0,2566,6268,6268,135,125,161833,178,73,D/WB/M/AM R,2,2,1,1,1,1,1,1,3,2,3,12,12,12,12,13,10,12,14,10,9,12,10,9,13,12,12,12,11,11,12,12,14,13,11,12,8,12,14,15,13,7,9,10,13,15,20,14,6,12,12,12,10,14,6,13,10,12,11,8,8,12,20,18,18,19,20,9,1,D/WB/M/AM R,132,1,1,13,1,1,19,1,9,20,1,1,1,18,1,18,0,0,0,0,0,0,0,0,0,0,0,0,0,0,0,0,0,0,0,0,0,0,0,0,0,0,0,0,0,0,0,0,0,0,0,0,0,0,0,0,0,0,0,0,0,0,0,0,0,Rômulo,£1.35m ,33,178,Midfielder - Central Midfield,right,Without Club,5,0,0,405,10,0,0,455,24,2,2,1242,33,6,8,2633,5,0,0,278,10,0,2,288,41,4,10,3565,41,3,6,3562,32,1,3,2560,Serie A,24,1,3,1755,nan,nan,nan,nan
19/6/2011,Romain Danzé,8428673,769,7/3/1986,24,0,0,3,0,4700,5900,5900,140,132,875035,184,72,D/WB RL,2,3,1,3,2,1,3,5,3,3,1,8,13,11,7,11,7,12,8,10,12,10,9,10,12,7,14,13,11,13,10,12,16,9,7,11,13,14,16,15,13,14,12,8,13,14,20,17,12,13,7,14,8,15,14,13,16,14,16,16,16,5,20,17,14,14,20,15,1,D/WB RL,115,1,1,1,1,10,14,1,15,20,1,1,10,14,15,17,32,0,0,0,0,0,1,0,0,0,0,0,0,0,0,0,0,0,0,0,0,0,0,0,0,0,0,0,0,0,0,0,0,0,0,0,0,0,0,0,0,0,0,0,0,0,0,0,0,Romain Danzé,£3.60m ,34,184,Defender - Right-Back,right,Retired,41,1,1,3664,44,1,4,3836,37,1,1,2768,40,0,0,3356,35,0,3,3052,24,0,3,1909,36,0,2,3181,16,0,0,1042,0,0,0,0,Ligue 1,nan,nan,nan,nan,nan,nan,nan,nan
19/6/2011,Rodrigo Galo,19027606,1651,9/19/1986,24,0,0,0,0,2250,5500,5500,132,110,278845,176,66,D/WB R,1,2,3,3,3,1,2,2,3,1,1,11,13,10,8,11,12,8,12,12,10,11,13,11,11,13,13,13,11,12,9,12,12,8,11,14,10,13,14,14,13,10,10,8,9,15,20,12,10,11,10,10,10,13,13,11,15,11,13,12,12,10,20,16,10,13,20,12,13,D/WB R,112,1,1,1,13,10,7,1,12,20,1,10,1,10,1,16,0,0,0,0,0,0,0,0,0,0,0,0,0,0,0,0,0,0,0,0,0,0,0,0,0,0,0,0,0,0,0,0,0,0,0,0,0,0,0,0,0,0,0,0,0,0,0,0,0,Rodrigo Galo,£450Th. ,34,174,Defender - Right-Back,right,Atromitos Athen,35,4,0,3035,21,3,0,1781,28,0,4,2303,34,2,5,2963,12,1,0,888,37,1,6,3289,36,1,3,2974,46,2,4,3528,41,4,6,2696,Liga NOS,24,3,3,1889,5,0,1,450
19/6/2011,Pau Cendrós,67006021,796,4/1/1987,24,0,0,0,0,4050,6250,6250,135,127,1207463,176,72,D/WB R,2,1,3,2,1,3,3,6,1,1,1,9,12,11,5,11,7,9,8,13,14,11,6,13,10,14,14,14,11,11,9,12,14,7,9,12,14,14,14,13,12,12,8,12,10,15,20,16,11,13,15,11,6,13,12,15,11,12,15,14,14,5,20,16,1,1,20,10,1,D/WB R,112,1,1,1,1,1,1,1,10,20,1,1,1,1,6,16,1.41734E+11,0,0,0,0,0,0,0,0,0,0,0,0,0,0,0,0,0,0,0,0,0,0,0,0,0,0,0,0,0,0,0,0,1,0,0,0,0,1,0,0,0,0,0,0,0,0,0,0,Pau Cendrós,£1.80m ,33,180,Defender - Right-Back,right,UD Poblense,32,0,0,2533,30,0,0,2144,22,0,0,1843,18,1,0,1493,35,2,2,2963,25,0,0,1981,3,0,0,219,14,0,0,1201,12,0,0,1054,LaLiga,1,0,0,10,2,0,0,103
19/6/2011,Onyekachi Apam,8632613,38,12/30/1986,24,12,0,10,1,5400,6700,6050,155,134,1270189,177,67,D RC,1,1,2,1,3,2,1,1,3,1,3,5,11,8,6,10,7,12,8,11,14,6,7,15,10,16,16,15,9,12,6,12,15,6,11,9,13,13,16,16,13,15,9,10,10,14,20,15,14,11,16,15,10,10,13,16,12,13,11,11,11,11,20,15,1,1,15,13,20,D RC,103,1,1,1,1,1,1,20,13,15,1,1,1,1,13,15,1.37439E+11,0,0,0,0,0,0,0,0,0,0,0,0,0,0,0,1,0,0,0,0,0,0,0,0,0,0,0,0,0,0,0,0,0,0,0,0,0,1,0,0,0,0,0,0,0,0,0,0,Onyekachi Apam,£2.70m ,33,180,Defender - Centre-Back,right,Without Club,nan,nan,nan,nan,16,0,0,1307,15,0,0,1021,1,0,0,90,nan,nan,nan,nan,nan,nan,nan,nan,nan,nan,nan,nan,nan,nan,nan,nan,nan,nan,nan,nan,Ligue 1,nan,nan,nan,nan,nan,nan,nan,nan
19/6/2011,Niko Bungert,8728048,771,10/24/1986,24,0,0,3,0,4150,6600,6600,135,132,21143,188,68,D RC,3,3,3,2,2,3,3,1,1,1,2,3,11,5,5,13,3,12,5,7,16,13,5,13,11,11,16,11,10,13,11,13,13,11,9,7,15,14,12,14,16,13,15,5,12,14,20,12,13,11,6,10,6,10,12,14,7,8,11,15,8,7,20,1,1,1,16,12,20,D RC,103,1,1,1,1,1,1,20,12,16,8,1,1,1,1,1,2.74878E+11,0,0,0,0,0,0,0,0,0,0,0,0,0,0,0,0,0,0,0,0,0,0,0,0,0,0,0,0,0,0,0,0,0,0,0,0,0,0,1,0,0,0,0,0,0,0,0,0,Niko Bungert,£3.15m ,34,188,Defender - Centre-Back,right,Retired,29,1,1,2364,34,4,1,2963,11,0,0,859,10,1,0,500,27,2,1,2176,24,1,0,2008,14,2,0,1147,0,0,0,0,8,0,0,288,Bundesliga,nan,nan,nan,nan,nan,nan,nan,nan
19/6/2011,Nicolò Cherubin,1402118,776,12/2/1986,24,0,0,0,0,3250,5950,5950,138,121,356658,188,83,D RC,1,1,1,1,1,1,1,1,1,1,1,4,6,6,6,10,6,17,7,10,14,9,7,16,10,12,14,11,8,11,8,11,14,6,12,5,13,14,14,12,11,14,16,6,14,12,20,12,15,15,12,13,4,16,6,12,18,10,14,12,8,4,20,1,1,1,15,14,20,D RC,103,1,10,1,1,1,1,20,14,15,1,1,1,1,1,1,0,0,0,0,0,0,0,0,0,0,0,0,0,0,0,0,0,0,0,0,0,0,0,0,0,0,0,0,0,0,0,0,0,0,0,0,0,0,0,0,0,0,0,0,0,0,0,0,0,Nicolò Cherubin,£900Th. ,33,188,Defender - Centre-Back,left,SS Arezzo,15,0,2,1147,23,1,0,1650,30,1,1,2626,15,1,0,1134,13,0,0,1010,16,1,0,1208,5,0,1,450,10,0,0,809,15,0,0,1305,Serie A,5,0,0,229,1,0,0,90
19/6/2011,Nicola Belmonte,7990575,776,4/15/1987,24,0,0,0,0,3000,6000,6000,137,120,409880,183,77,D RC,3,3,1,2,1,1,1,2,3,3,3,5,9,8,5,9,5,13,7,12,14,10,7,14,7,13,14,11,8,13,6,12,14,5,8,13,14,11,12,13,12,12,13,10,12,13,20,12,14,13,7,10,12,15,12,15,12,10,15,9,10,2,20,7,1,1,20,14,18,D RC,103,1,1,1,1,1,1,18,14,20,1,1,1,1,1,7,64,0,0,0,0,0,0,1,0,0,0,0,0,0,0,0,0,0,0,0,0,0,0,0,0,0,0,0,0,0,0,0,0,0,0,0,0,0,0,0,0,0,0,0,0,0,0,0,0,Nicola Belmonte,£540Th. ,33,183,Defender - Centre-Back,right,Retired,28,0,0,2263,7,0,0,422,8,0,0,587,21,1,0,1771,13,0,1,872,31,2,0,2632,28,1,2,2166,24,1,2,1906,3,0,0,270,Serie A,nan,nan,nan,nan,nan,nan,nan,nan
19/6/2011,Nedum Onuoha,5114013,765,11/30/1986,24,0,0,21,2,4500,6505,6505,152,135,1382297,183,93,D RC,3,3,2,1,2,1,3,1,2,1,3,4,4,7,4,7,4,15,5,13,14,7,5,15,8,12,10,13,10,13,8,10,12,4,11,7,14,13,10,20,14,12,12,7,16,18,20,17,14,11,2,8,16,12,11,14,15,13,18,16,15,2,20,10,1,1,18,10,20,D RC,103,1,1,1,1,1,1,20,10,18,1,1,1,1,1,10,0,0,0,0,0,0,0,0,0,0,0,0,0,0,0,0,0,0,0,0,0,0,0,0,0,0,0,0,0,0,0,0,0,0,0,0,0,0,0,0,0,0,0,0,0,0,0,0,0,Nedum Onuoha,£3.60m ,33,183,Defender - Centre-Back,right,Real Salt Lake City,32,1,2,2758,19,0,1,1629,26,0,0,1809,31,2,0,2616,25,0,0,2106,48,3,2,4320,47,3,2,4168,36,0,1,3040,30,1,0,2528,Premier League,12,0,0,1080,nan,nan,nan,nan
19/6/2011,Mouhamadou Dabo,919771,769,11/28/1986,24,0,0,17,0,5479,6233,6567,152,126,341045,176,67,D/WB RL,3,2,3,3,3,1,3,2,3,3,2,9,10,11,5,11,8,8,10,12,11,10,7,13,10,11,11,13,11,13,10,10,16,11,9,10,11,13,13,15,12,12,7,13,12,13,20,15,10,14,11,15,8,18,10,16,11,14,15,14,14,9,20,18,13,13,20,18,10,D/WB RL,115,1,1,5,1,11,13,10,18,20,10,5,12,13,18,18,2.2518E+15,0,0,0,0,0,1,1,0,0,0,0,0,0,0,0,0,0,0,0,0,0,0,0,0,0,0,0,0,0,0,0,0,0,0,0,0,0,0,0,0,0,0,0,0,0,0,0,0,Mouhamadou Dabo,£2.70m ,33,176,Defender - Right-Back,right,Retired,37,0,2,3037,26,0,2,1748,34,0,1,2907,16,0,0,981,15,1,0,1158,18,0,0,1185,3,0,0,192,0,0,0,0,0,0,0,0,Ligue 1,nan,nan,nan,nan,nan,nan,nan,nan
19/6/2011,Modibo Diakité,1408579,769,3/2/1987,24,0,0,0,0,3000,5714,6350,146,127,318634,192,84,D RC,2,3,3,3,2,3,3,1,2,2,3,2,2,6,6,4,2,16,4,14,14,8,6,16,6,15,13,14,10,12,4,10,12,3,6,8,14,11,14,14,11,17,17,7,7,13,20,15,18,12,15,12,10,11,9,12,11,12,11,12,14,8,20,1,1,1,15,1,20,D RC,103,1,10,1,1,1,1,20,1,15,1,1,1,1,1,1,2.92058E+11,0,0,0,0,0,0,1,0,0,0,0,0,0,0,0,1,0,0,0,0,0,0,0,0,0,0,0,0,0,0,0,0,0,0,1,0,0,0,1,0,0,0,0,0,0,0,0,0,Modibo Diakité,£4.50m ,33,192,Defender - Centre-Back,right,Ternana Calcio,10,0,0,513,36,1,3,2830,1,0,0,83,20,0,0,1744,12,0,1,985,27,1,0,2390,15,1,0,1182,11,0,0,717,28,2,0,2356,Serie A,14,0,0,844,5,0,0,427
19/6/2011,Miguel Lopes,8877170,788,12/19/1986,24,0,0,2,0,3006,6012,6012,145,126,137038,181,79,D R,2,1,3,1,2,3,1,5,3,3,2,12,14,13,10,12,10,11,10,12,12,12,10,12,13,13,12,13,12,13,11,12,14,13,10,14,12,12,12,15,13,11,10,8,13,13,20,13,13,14,9,12,12,11,13,14,13,14,13,12,13,7,20,15,10,14,20,10,1,D R,102,1,1,1,1,10,14,1,9,20,1,1,1,10,1,15,134217728,0,0,0,0,0,0,0,0,0,0,0,0,0,0,0,0,0,0,0,0,0,0,0,0,0,0,0,1,0,0,0,0,0,0,0,0,0,0,0,0,0,0,0,0,0,0,0,0,Miguel Lopes,£2.25m ,33,183,Defender - Right-Back,right,Kayserispor,23,0,0,1539,13,0,1,909,21,1,5,1693,31,0,2,2685,19,0,4,1463,29,0,1,2178,34,3,4,2919,35,1,2,3006,31,1,1,2487,Liga NOS,28,0,0,2282,4,0,0,360
19/6/2011,Mehdi Benatia,8443128,34,4/17/1987,24,15,1,0,0,4267,6915,7200,160,143,1230480,189,84,D RC,3,3,3,2,3,1,2,8,3,1,1,4,8,8,8,11,6,15,8,7,17,12,7,14,12,14,16,16,14,14,10,12,16,8,14,8,13,13,15,13,12,16,15,8,13,12,20,15,15,14,13,16,11,10,13,17,10,13,14,14,11,12,20,8,1,1,16,1,20,D RC,103,1,13,1,1,1,1,20,1,16,5,1,1,1,1,8,0,0,0,0,0,0,0,0,0,0,0,0,0,0,0,0,0,0,0,0,0,0,0,0,0,0,0,0,0,0,0,0,0,0,0,0,0,0,0,0,0,0,0,0,0,0,0,0,0,Medhi Benatia,£12.15m ,33,190,Defender - Centre-Back,right,Al-Duhail SC,34,3,0,3043,38,2,0,3238,25,2,1,2114,37,5,0,3131,24,2,1,1860,22,1,2,1333,21,1,0,1456,32,4,0,2637,20,2,0,1604,Serie A,24,0,0,2033,3,0,0,225
19/6/2011,Martín Cáceres,78010878,1657,4/7/1987,24,33,1,11,0,6000,7550,7100,156,145,7905138,182,77,D RC,1,1,3,2,3,2,1,1,3,1,1,6,9,10,8,11,5,15,9,14,14,11,7,15,11,16,14,16,11,14,8,12,14,7,13,9,13,14,15,15,14,15,12,12,13,15,20,15,14,13,12,14,16,16,16,12,12,10,14,13,12,5,20,13,6,1,19,13,20,D RC,103,1,12,1,1,1,1,20,13,19,1,1,1,6,5,13,1.37439E+11,0,0,0,0,0,0,0,0,0,0,0,0,0,0,0,0,0,0,0,0,0,0,0,0,0,0,0,0,0,0,0,0,0,0,0,0,0,1,0,0,0,0,0,0,0,0,0,0,Martín Cáceres,£8.55m ,33,180,Defender - Centre-Back,right,ACF Fiorentina,37,1,4,3132,32,4,2,2455,22,1,0,1494,30,1,1,2377,14,1,1,1047,9,0,0,719,4,0,0,360,25,4,1,2001,17,0,0,1278,Serie A,30,2,0,2480,5,0,0,450
19/6/2011,Lamine Sané,85032367,41,3/22/1987,24,3,0,0,0,5050,6250,5600,145,125,505280,192,77,D/DM RC,3,3,2,1,2,3,3,8,2,2,1,5,7,8,6,8,5,15,10,11,14,7,7,13,9,14,14,15,12,10,9,11,16,6,9,7,12,13,16,15,11,16,17,5,14,14,20,15,16,13,14,14,7,8,15,14,11,13,12,14,14,7,20,10,10,1,15,1,20,D/DM RC,113,1,1,1,1,1,1,20,1,15,17,10,1,1,1,10,4.50387E+15,0,0,0,0,0,0,0,0,0,0,0,0,0,0,0,0,0,0,0,0,0,0,0,0,0,0,0,0,0,0,0,0,0,0,0,0,0,0,1,0,0,0,0,0,0,0,0,0,Lamine Sané,£4.05m ,33,192,Defender - Centre-Back,right,Without Club,37,2,2,3278,34,2,2,2933,48,2,0,4324,45,2,0,4080,25,1,1,2140,21,0,1,1562,28,1,1,2454,29,2,0,2368,30,0,0,2694,Ligue 1,1,0,0,1,nan,nan,nan,nan
19/6/2011,Juri Judt,8718376,771,7/24/1986,24,0,0,4,0,4500,6350,6107,139,127,445881,173,67,D/WB/DM R,3,1,2,1,1,3,1,7,3,2,1,10,13,11,6,11,8,12,9,9,13,11,8,14,11,14,12,16,12,14,8,13,14,10,9,9,13,14,15,12,12,14,8,7,15,13,20,15,13,14,13,13,12,15,13,14,11,14,16,15,14,6,20,19,13,4,20,14,12,D/WB/DM R,122,1,1,1,4,1,1,1,14,20,18,12,1,13,13,19,1.40884E+14,0,0,0,0,0,0,0,0,0,0,0,0,0,0,0,0,0,0,0,0,0,0,0,0,0,1,0,0,0,0,0,0,0,1,0,0,0,1,0,0,0,0,0,0,0,0,0,1,Juri Judt,£315Th. ,34,176,Midfielder - Defensive Midfield,both,SV Burggrafenhof,28,0,1,2367,16,1,0,1311,20,1,2,1693,14,0,0,1054,28,0,0,2113,31,0,1,1899,3,0,0,270,nan,nan,nan,nan,nan,nan,nan,nan,Bundesliga,nan,nan,nan,nan,nan,nan,nan,nan
19/6/2011,José Ángel Crespo,1507727,796,2/9/1987,24,0,0,4,0,4500,6250,6250,140,125,946524,185,72,D/WB RLC,2,3,2,1,2,2,2,3,1,1,2,9,9,10,7,11,6,15,6,14,13,10,5,12,7,14,14,15,11,12,7,11,13,7,10,7,13,15,15,14,15,13,14,8,14,13,20,14,13,11,11,13,12,13,13,12,13,11,13,12,12,7,20,16,1,1,20,18,15,D/WB RLC,116,1,1,1,1,1,1,15,18,20,1,1,1,1,15,16,0,0,0,0,0,0,0,0,0,0,0,0,0,0,0,0,0,0,0,0,0,0,0,0,0,0,0,0,0,0,0,0,0,0,0,0,0,0,0,0,0,0,0,0,0,0,0,0,0,José Crespo,£900Th. ,33,183,Defender - Centre-Back,right,PAOK Thessaloniki,43,1,3,3555,10,0,0,622,17,0,0,1156,11,1,0,665,29,0,0,2298,14,0,0,1169,49,1,0,4108,32,2,3,2720,49,1,1,4249,Serie A,20,2,2,1731,6,0,0,339
19/6/2011,João Dias,744082,788,12/23/1986,24,0,0,0,0,1585,4775,4775,105,98,115941,179,69,D RC,1,2,2,1,3,2,3,2,1,1,2,10,11,7,7,10,8,10,8,9,10,7,10,12,9,12,12,12,13,14,8,9,14,6,9,12,11,13,13,11,11,9,10,8,12,11,20,12,11,13,6,11,6,10,10,10,14,14,14,11,11,6,20,5,7,1,20,5,15,D RC,103,1,1,1,1,1,1,15,5,20,8,1,1,7,1,5,0,0,0,0,0,0,0,0,0,0,0,0,0,0,0,0,0,0,0,0,0,0,0,0,0,0,0,0,0,0,0,0,0,0,0,0,0,0,0,0,0,0,0,0,0,0,0,0,0,João Dias,£450Th. ,33,180,Defender - Right-Back,right,União de Leiria,30,1,0,2674,11,0,0,865,28,0,1,2354,8,0,0,595,26,0,0,2089,42,1,0,3755,25,1,0,2276,36,0,5,3270,6,0,0,490,Liga NOS,1,0,0,90,nan,nan,nan,nan
19/6/2011,Isidoro,67006172,796,8/1/1986,24,0,0,0,0,3250,6100,6100,133,122,382928,180,71,D/WB RLC,3,3,1,1,3,1,1,6,2,1,3,4,11,6,4,10,4,11,10,13,12,11,7,14,8,13,13,17,12,12,5,11,9,8,11,11,12,17,18,14,11,8,10,10,12,14,20,13,12,9,11,13,6,13,10,14,18,7,15,10,12,5,20,18,1,1,20,15,15,D/WB RLC,116,1,1,1,1,1,1,15,15,20,1,1,1,1,1,18,4294967296,0,0,0,0,0,0,0,0,0,0,0,0,0,0,0,0,0,0,0,0,0,0,0,0,0,0,0,0,0,0,0,0,1,0,0,0,0,0,0,0,0,0,0,0,0,0,0,0,Isidoro,£1.08m ,34,180,Defender - Right-Back,right,Retired,37,1,0,3172,11,0,0,892,13,0,0,834,17,0,0,1321,37,0,1,3235,25,0,0,1980,10,0,0,627,24,0,2,2036,5,1,0,318,LaLiga,nan,nan,nan,nan,nan,nan,nan,nan
19/6/2011,Ignazio Abate,7983987,776,11/12/1986,24,0,0,19,2,5750,7150,7150,154,146,31426871,180,73,D/WB R,2,3,3,3,2,1,1,2,3,1,3,5,12,14,6,13,6,11,8,12,15,13,8,13,12,15,14,14,12,13,10,13,16,7,8,17,13,14,15,17,17,13,10,8,12,16,20,14,12,14,11,9,11,13,10,15,16,12,17,14,13,7,20,18,15,13,20,1,7,D/WB R,112,1,1,1,1,1,13,1,1,20,1,7,1,15,1,18,1.09951E+12,0,1,0,0,0,1,0,0,0,0,0,0,0,0,0,0,0,0,0,0,0,0,0,0,0,0,0,0,0,0,0,0,0,0,0,0,0,0,0,0,1,0,0,0,0,0,0,0,Ignazio Abate,£10.80m ,33,180,Defender - Right-Back,right,Without Club,37,0,1,2930,40,0,3,3524,33,0,3,2777,28,1,1,2120,25,0,7,2063,28,1,1,2373,26,0,2,2170,27,1,1,1713,24,0,0,1688,Serie A,nan,nan,nan,nan,nan,nan,nan,nan
19/6/2011,Gonzalo Castro,8723487,771,6/11/1987,24,5,0,21,3,5500,6850,6850,160,142,3194925,171,74,D/WB/DM/M/AM RLC,1,1,2,2,3,3,2,4,3,2,2,13,13,14,8,14,13,8,11,11,12,15,12,11,14,12,13,12,11,11,13,11,12,13,7,12,9,13,13,15,16,13,6,15,12,13,20,12,10,8,8,12,4,19,10,11,17,11,12,12,14,4,20,16,20,16,20,16,20,D/WB/DM/M/AM RLC,146,1,1,1,10,16,10,1,16,20,16,20,16,12,12,16,1048584,0,0,0,1,0,0,0,0,0,0,0,0,0,0,0,0,0,0,0,0,1,0,0,0,0,0,0,0,0,0,0,0,0,0,0,0,0,0,0,0,0,0,0,0,0,0,0,0,Gonzalo Castro,£8.10m ,33,172,Midfielder - Central Midfield,right,VfB Stuttgart,32,6,9,2262,40,2,8,3474,40,8,9,3140,39,5,12,3176,32,2,11,2772,41,7,11,2679,42,4,8,2885,28,1,3,1840,28,2,4,1892,Bundesliga,31,3,7,2321,6,1,1,466
19/6/2011,Gianni Zuiverloon,859941,784,12/30/1986,24,0,0,18,0,4750,6250,5783,130,125,350035,178,70,D R,3,3,1,2,3,1,1,3,3,1,3,5,13,12,6,13,8,14,5,13,11,12,5,14,14,12,13,14,13,7,12,9,13,11,10,14,11,13,14,16,13,13,10,11,15,15,20,14,14,10,8,12,8,13,14,14,13,15,15,17,14,6,20,15,10,1,20,4,12,D R,102,1,8,1,1,1,1,12,4,20,5,3,1,10,1,15,1.75922E+13,0,1,0,0,0,0,0,0,0,0,0,0,0,0,0,0,0,0,0,0,0,0,0,0,0,0,0,0,0,0,0,0,0,0,0,0,0,0,0,0,0,0,0,0,1,0,0,0,Gianni Zuiverloon,£2.25m ,33,178,Defender - Centre-Back,right,Without Club,20,1,0,1692,11,0,0,781,21,2,0,1636,27,0,0,2329,33,1,0,2778,28,2,2,2138,30,2,0,2445,26,0,0,1947,20,2,0,1775,LaLiga,8,0,2,619,nan,nan,nan,nan
19/6/2011,Fabiano Santacroce,1400569,776,8/24/1986,24,0,0,6,0,4750,6500,6500,150,131,771165,181,72,D RC,2,3,2,2,1,2,2,6,1,3,3,4,11,11,4,11,4,14,4,14,16,8,6,16,12,14,16,15,12,11,8,14,15,9,6,9,12,12,11,15,16,12,12,7,8,14,20,14,12,13,15,16,18,10,14,14,15,16,14,12,5,3,20,1,1,1,15,1,20,D RC,103,1,1,1,1,1,1,20,1,15,1,1,1,1,1,1,1.40737E+14,0,0,0,0,0,0,0,0,0,0,0,0,0,0,0,0,0,0,0,0,0,0,0,0,0,0,0,0,0,0,0,0,0,0,0,0,0,0,0,0,0,0,0,0,0,0,0,1,Fabiano Santacroce,£720Th. ,34,181,Defender - Centre-Back,right,Without Club,14,0,0,1080,13,0,0,602,9,0,1,469,20,0,0,1667,17,0,1,1078,3,0,1,213,10,0,0,758,nan,nan,nan,nan,30,0,0,2413,Serie A,8,0,0,473,nan,nan,nan,nan
19/6/2011,Eros Pisano,43005147,776,3/31/1987,24,0,0,0,0,2514,6168,6168,138,125,1968449,185,77,D/WB RL,1,3,3,2,3,2,2,3,3,1,1,9,14,10,10,11,10,15,9,15,14,14,4,13,12,10,11,10,9,12,9,12,10,7,12,11,11,11,12,13,12,12,14,20,9,12,13,12,13,11,8,12,10,11,13,14,13,13,6,9,2,8,20,17,11,1,20,15,13,D/WB RL,115,1,1,1,1,1,1,13,15,20,1,1,11,11,15,17,0,0,0,0,0,0,0,0,0,0,0,0,0,0,0,0,0,0,0,0,0,0,0,0,0,0,0,0,0,0,0,0,0,0,0,0,0,0,0,0,0,0,0,0,0,0,0,0,0,Eros Pisano,£1.98m ,33,186,Defender - Right-Back,right,AC Pisa 1909,43,7,0,3850,28,0,0,2356,23,1,0,1417,36,3,1,2515,20,0,0,1766,37,5,1,3175,27,3,1,2424,17,0,0,1239,17,2,0,1209,Serie A,16,1,1,551,4,0,0,136
19/6/2011,Edu Oriol,67006859,796,11/5/1986,24,0,0,0,0,3700,6200,6200,132,122,466759,177,72,M/AM RL,3,1,2,2,3,1,1,1,3,3,2,8,13,12,7,10,6,6,10,5,9,11,8,11,12,9,10,12,11,12,11,10,10,11,6,13,9,13,13,15,14,7,9,11,14,14,20,13,10,8,8,10,5,11,16,6,3,10,20,14,11,7,11,15,16,20,20,18,10,M/AM RL,525,1,1,12,10,18,20,1,1,11,1,1,16,16,1,15,0,0,0,0,0,0,0,0,0,0,0,0,0,0,0,0,0,0,0,0,0,0,0,0,0,0,0,0,0,0,0,0,0,0,0,0,0,0,0,0,0,0,0,0,0,0,0,0,0,Edu Oriol,£900Th. ,33,177,Forward - Left Winger,both,Atlético Sanluqueño,31,6,0,2048,22,2,0,1090,23,0,1,992,25,5,0,1114,24,2,0,1635,13,0,2,852,5,0,0,256,nan,nan,nan,nan,34,6,0,2725,LaLiga,13,0,0,1021,2,0,0,180
19/6/2011,Danny Simpson,5116936,765,1/4/1987,24,0,0,0,0,3350,6500,6500,142,130,5715482,173,77,D R,1,1,1,1,1,1,1,1,1,1,1,4,12,11,6,13,1,8,6,8,11,10,6,14,12,8,11,12,12,11,9,10,14,12,4,11,13,15,16,18,14,14,7,14,14,16,20,16,10,11,8,10,5,7,18,14,13,14,10,13,13,6,20,14,8,1,20,14,10,D R,102,1,1,1,1,1,1,10,14,20,1,1,1,8,1,14,134217762,0,1,0,0,0,1,0,0,0,0,0,0,0,0,0,0,0,0,0,0,0,0,0,0,0,0,0,1,0,0,0,0,0,0,0,0,0,0,0,0,0,0,0,0,0,0,0,0,Danny Simpson,£4.95m ,33,176,Defender - Right-Back,right,Without Club,34,0,3,3009,40,1,1,3580,26,0,4,2148,39,1,2,3483,20,0,1,1703,32,0,0,2826,45,0,2,3893,31,0,0,2597,13,0,0,907,Premier League,25,0,0,2083,nan,nan,nan,nan
19/6/2011,Daniele Capelli,7991195,776,6/20/1986,24,0,0,0,0,2779,6250,6250,139,125,765765,184,78,D/WB RC,2,2,3,1,1,2,2,2,2,2,3,7,11,7,5,9,7,14,7,10,16,11,7,15,11,15,13,12,6,13,9,12,16,6,15,7,14,13,12,12,12,13,13,8,14,13,20,12,14,14,7,14,5,9,5,15,20,17,18,19,7,9,20,16,1,1,19,1,20,D/WB RC,113,1,1,1,1,1,1,20,1,19,1,1,1,1,1,16,0,0,0,0,0,0,0,0,0,0,0,0,0,0,0,0,0,0,0,0,0,0,0,0,0,0,0,0,0,0,0,0,0,0,0,0,0,0,0,0,0,0,0,0,0,0,0,0,0,Daniele Capelli,£900Th. ,34,186,Defender - Centre-Back,both,Without Club,33,1,0,2772,11,0,1,879,4,0,0,314,34,1,0,2902,32,0,0,2710,26,0,0,1968,18,0,0,1556,19,0,0,912,19,1,2,1642,Serie A,3,0,0,51,nan,nan,nan,nan
19/6/2011,Dani Estrada,1507539,796,1/3/1987,24,0,0,0,0,4250,6000,6000,132,126,273006,177,68,D R,2,2,1,3,3,1,1,1,3,3,3,12,17,12,12,9,12,12,14,9,11,11,7,13,13,11,15,13,12,12,11,10,11,10,8,14,8,12,11,14,13,12,11,12,9,14,20,14,9,11,6,9,5,14,13,10,15,11,14,14,15,3,20,15,11,15,20,9,1,D R,102,1,1,1,1,9,15,1,7,20,1,1,1,11,1,15,1.09951E+12,0,0,0,0,0,0,0,0,0,1,0,0,0,0,0,0,0,0,0,0,0,0,0,0,0,0,0,0,0,0,0,0,0,0,0,0,0,0,0,0,1,0,0,0,0,0,0,0,Dani Estrada,£2.25m ,33,179,Defender - Right-Back,right,Barakaldo CF,21,1,1,1806,32,2,1,2531,20,0,1,1060,5,0,0,405,1,0,0,0,21,1,0,1133,19,2,2,1670,35,1,0,2974,39,2,0,3510,LaLiga,26,3,0,2283,1,0,0,90
19/6/2011,Cristian Ansaldi,964420,1649,9/20/1986,24,1,0,0,0,5620,7367,7370,159,147,4234994,181,76,D/WB RL,1,3,1,1,3,2,1,4,3,1,3,13,16,14,6,13,12,7,15,15,13,15,14,13,15,13,12,10,14,15,13,12,18,14,9,9,13,12,13,15,15,12,9,20,14,13,10,15,12,15,8,10,7,14,16,11,16,13,16,15,12,8,19,20,14,1,18,20,10,D/WB RL,225,1,1,1,1,1,1,10,19,17,1,1,14,13,20,18,2.12206E+14,0,0,0,0,0,1,0,0,0,0,0,0,0,0,0,0,0,0,0,0,0,0,0,0,0,0,0,0,0,0,0,0,0,0,0,0,0,0,0,0,1,0,0,0,0,0,1,1,Cristiano Ronaldo,£81.00m ,35,187,Forward - Left Winger,both,Juventus FC,54,53,18,4618,55,60,15,4902,55,55,13,4631,47,51,17,4030,54,61,23,4640,48,51,15,4293,46,42,12,4126,44,44,8,3678,43,28,11,3646,LaLiga,46,37,7,4081,2,3,0,180
19/6/2011,Coke,1511783,796,4/26/1987,24,0,0,0,0,4200,6500,6500,156,132,761031,182,78,D/WB R,2,2,3,3,1,2,3,3,3,2,1,8,13,11,10,11,7,14,14,13,12,10,5,12,10,13,16,16,12,13,10,12,17,9,15,14,13,13,17,13,12,12,13,10,13,14,20,15,13,15,6,14,9,16,11,15,14,12,15,13,12,7,20,18,10,1,20,13,10,D/WB R,112,1,5,1,1,1,1,10,13,20,10,9,1,10,8,18,800,0,0,0,0,0,1,0,0,1,1,0,0,0,0,0,0,0,0,0,0,0,0,0,0,0,0,0,0,0,0,0,0,0,0,0,0,0,0,0,0,0,0,0,0,0,0,0,0,Coke,£2.70m ,33,176,Defender - Right-Back,right,Levante UD,39,6,0,3441,32,0,1,2529,27,3,4,2020,38,5,2,3139,34,2,4,2671,42,5,3,3446,8,1,0,629,20,3,0,1566,30,5,1,2084,LaLiga,20,3,0,1288,1,0,0,5
19/6/2011,Billy Jones,5111880,765,3/24/1987,24,0,0,0,0,3750,6150,6150,135,121,433522,180,83,D/WB R,1,2,1,2,3,3,2,2,2,2,2,7,12,11,11,13,11,13,11,2,14,12,11,15,12,11,11,14,12,12,11,12,19,8,11,12,13,15,16,11,11,12,12,14,12,12,20,14,13,15,8,12,7,17,16,14,12,16,15,17,16,4,20,16,10,1,20,14,10,D/WB R,112,1,8,1,1,1,1,10,14,20,12,10,1,9,12,16,3.51844E+13,0,0,0,0,0,0,0,0,1,1,0,0,0,0,0,0,0,0,0,0,0,0,0,0,0,0,0,0,0,0,0,0,0,0,0,0,0,0,0,0,0,0,0,0,0,1,0,0,Billy Jones,£1.35m ,33,182,Defender - Right-Back,right,Rotherham United,46,6,3,4083,25,0,2,2268,32,1,3,2640,23,0,1,1897,18,0,1,1597,26,1,0,2148,31,1,0,2603,24,1,0,1749,22,0,1,1677,Premier League,12,0,1,914,3,0,1,180
19/6/2011,Benjamin Angoua,38001740,24,11/28/1986,24,7,0,4,0,4917,6121,5469,140,122,378141,183,72,D/DM RC,1,3,1,2,1,3,3,1,2,1,1,5,9,6,6,7,5,14,7,10,13,8,6,14,7,13,15,14,15,13,9,12,13,9,6,8,13,15,13,11,12,14,12,10,13,14,20,15,13,14,13,12,8,10,14,12,13,13,14,11,11,7,20,15,10,1,15,12,20,D/DM RC,113,1,1,1,1,1,1,20,12,15,18,10,1,1,12,15,0,0,0,0,0,0,0,0,0,0,0,0,0,0,0,0,0,0,0,0,0,0,0,0,0,0,0,0,0,0,0,0,0,0,0,0,0,0,0,0,0,0,0,0,0,0,0,0,0,Benjamin Angoua,£2.25m ,33,183,Defender - Centre-Back,right,Stade Briochin,34,1,0,3010,22,0,0,1908,25,0,1,2228,17,1,0,1485,30,0,0,2326,20,1,0,1477,39,1,2,3434,nan,nan,nan,nan,7,0,0,532,Ligue 1,17,1,0,1487,9,1,0,810
19/6/2011,Baiano,55012136,1651,2/23/1987,24,0,0,0,0,2535,5264,5850,135,117,699221,173,65,D/WB R,2,3,1,1,3,1,1,2,1,2,3,11,13,12,8,12,11,9,12,12,10,11,12,12,12,11,11,10,12,10,9,10,10,10,8,13,10,11,12,15,13,11,11,6,14,14,20,11,11,11,10,10,9,9,8,12,11,11,12,12,12,5,20,17,10,1,20,10,1,D/WB R,112,1,1,1,1,1,1,1,10,20,1,1,1,10,1,17,2,0,1,0,0,0,0,0,0,0,0,0,0,0,0,0,0,0,0,0,0,0,0,0,0,0,0,0,0,0,0,0,0,0,0,0,0,0,0,0,0,0,0,0,0,0,0,0,0,Baiano,£3.15m ,33,178,Defender - Right-Back,right,Without Club,35,2,3,3142,18,0,2,1470,25,1,1,2018,26,1,0,2280,36,0,6,3184,42,0,9,3769,40,1,0,3527,36,0,1,3138,30,0,3,2614,Liga NOS,14,0,2,1132,nan,nan,nan,nan
19/6/2011,Antonio Barragán,1504803,796,6/12/1987,24,0,0,1,0,4515,6221,6221,140,125,467800,183,76,D/WB R,1,3,3,1,2,1,3,3,3,2,1,9,13,7,7,13,8,12,10,14,12,12,8,13,14,14,11,15,12,12,8,10,12,11,9,13,12,13,14,14,13,10,11,9,13,15,20,15,13,13,14,12,15,10,11,13,6,10,13,14,13,8,20,17,11,1,20,7,3,D/WB R,112,1,1,1,1,1,1,3,7,20,1,1,1,11,5,17,290,0,1,0,0,0,1,0,0,1,0,0,0,0,0,0,0,0,0,0,0,0,0,0,0,0,0,0,0,0,0,0,0,0,0,0,0,0,0,0,0,0,0,0,0,0,0,0,0,Antonio Barragán,£1.35m ,33,186,Defender - Right-Back,right,Elche CF,29,1,0,2341,27,0,1,2226,23,0,0,1503,31,1,4,2158,36,1,5,2946,35,0,0,2546,27,0,0,2286,31,0,6,2426,24,0,1,1699,LaLiga,14,0,2,847,2,0,0,180
19/6/2011,Andreas Beck,8723862,771,3/13/1987,24,9,0,27,2,6050,7000,7000,153,141,1805536,180,70,D/WB RL,3,3,3,3,2,3,1,6,2,3,1,7,10,12,5,11,5,8,7,10,11,12,8,16,13,16,15,14,10,11,13,14,16,8,12,15,10,17,18,16,14,10,9,14,16,14,20,18,9,13,5,12,6,13,15,12,12,10,17,16,18,2,20,17,1,1,20,15,10,D/WB RL,115,1,1,1,1,1,1,10,15,20,12,1,1,1,12,17,2.74896E+11,0,1,0,1,0,0,0,0,0,0,0,0,0,0,0,0,0,0,0,0,1,0,0,0,1,0,0,0,0,0,0,0,0,0,0,0,0,0,1,0,0,0,0,0,0,0,0,0,Andreas Beck,£4.50m ,33,nan,Defender - Right-Back,nan,KAS Eupen,37,0,4,3319,35,1,1,3180,34,1,3,3060,37,1,3,3348,36,0,4,3266,42,0,1,3561,30,1,3,1926,29,1,2,2363,24,0,2,1777,Bundesliga,28,1,1,2490,3,0,0,89
19/6/2011,Alberto Lora,67011231,796,3/25/1987,24,0,0,0,0,4500,6534,6534,151,141,707375,165,66,D/M RC,3,2,1,2,3,3,2,5,2,3,2,9,13,12,9,13,4,13,13,13,13,15,11,13,14,12,13,14,11,14,9,13,12,11,10,13,13,16,16,13,14,14,8,7,15,14,20,16,14,18,10,12,10,12,14,10,14,13,18,17,8,15,20,15,19,15,20,5,19,D/M RC,113,1,1,5,13,5,15,1,5,20,5,19,5,15,5,15,0,0,0,0,0,0,0,0,0,0,0,0,0,0,0,0,0,0,0,0,0,0,0,0,0,0,0,0,0,0,0,0,0,0,0,0,0,0,0,0,0,0,0,0,0,0,0,0,0,Alberto Lora,£2.52m ,33,164,Midfielder - Central Midfield,right,Marino Luanco,37,0,5,3261,28,3,1,2331,32,0,4,2381,37,0,4,2866,41,1,0,3637,32,0,4,2501,7,0,0,376,10,1,0,683,16,0,0,1129,LaLiga,27,0,0,2400,2,0,0,66
19/6/2011,Younes Kaboul,918434,769,1/4/1986,25,2,1,20,1,5650,6696,7150,166,148,2552000,191,85,D RC,3,2,3,1,2,3,3,4,3,3,2,7,13,8,10,14,10,15,14,8,13,11,8,14,12,15,11,14,13,12,13,14,14,6,12,9,15,12,12,14,9,16,17,12,11,15,20,14,19,12,10,12,12,8,13,16,15,12,15,14,13,8,20,1,10,1,15,1,20,D RC,103,1,1,1,1,1,1,20,1,15,14,10,1,1,1,1,4.39848E+13,0,1,0,0,0,0,0,0,0,0,0,0,0,0,0,0,0,0,0,0,0,0,0,0,0,0,0,0,0,0,0,0,1,0,0,0,0,0,0,0,0,0,0,1,0,1,0,0,Younès Kaboul,£13.50m ,34,192,Defender - Centre-Back,right,Retired,24,2,1,1902,41,1,1,3533,3,0,0,198,20,1,1,1583,15,0,0,1350,23,0,1,2009,25,2,0,2065,2,0,0,152,nan,nan,nan,nan,Premier League,nan,nan,nan,nan,nan,nan,nan,nan
19/6/2011,Vedran Corluka,126527,761,3/31/1986,25,36,1,0,0,6250,7810,7200,155,142,9071504,192,89,D RC,2,2,3,2,1,1,1,2,1,2,3,3,11,12,9,13,5,15,5,15,13,11,6,15,15,14,17,13,18,12,10,12,17,5,12,10,12,15,14,12,13,16,15,13,14,11,20,14,16,15,4,16,11,12,13,14,15,13,16,17,15,8,20,14,15,1,20,10,16,D RC,103,1,12,1,1,1,1,16,10,20,12,15,1,1,1,14,1.43881E+11,0,0,0,1,0,1,0,0,0,0,0,0,0,0,0,0,0,0,0,0,0,0,0,0,0,0,0,0,0,0,0,1,1,0,0,0,0,1,0,0,0,0,0,0,0,0,0,0,Vedran Corluka,£6.75m ,34,192,Defender - Centre-Back,right,Lokomotiv Moscow,24,0,1,1933,16,0,2,1302,28,1,2,2493,28,1,1,2520,32,2,1,2921,29,3,0,2540,21,0,2,1688,8,0,0,662,30,1,1,2619,Premier League,34,0,0,2965,13,1,1,1071
19/6/2011,Tito,7451317,796,7/11/1985,25,0,0,0,0,2750,5000,5000,118,105,368762,174,62,D/WB R,1,3,1,3,2,2,2,3,3,3,3,8,11,8,6,12,11,6,8,14,10,11,7,10,13,9,12,14,10,13,8,15,10,10,6,12,11,13,14,13,9,7,6,5,14,15,20,15,8,13,6,8,10,11,5,11,10,13,15,4,7,17,20,17,13,6,20,7,1,D/WB R,112,1,1,1,1,1,6,1,7,20,1,1,1,13,5,17,1.11669E+12,0,0,0,0,0,0,0,0,0,0,0,0,0,0,0,0,0,0,0,0,0,0,0,0,0,0,0,0,0,0,0,0,0,0,1,0,0,0,0,0,1,0,0,0,0,0,0,0,Tito,£1.35m ,35,174,Defender - Right-Back,right,Without Club,12,1,0,959,37,1,1,3251,34,1,2,2763,25,0,1,1973,35,0,2,2951,32,1,3,2610,23,0,3,1876,17,1,0,1322,16,0,0,1182,LaLiga,28,0,0,2177,nan,nan,nan,nan
19/6/2011,Steven Taylor,5114243,765,1/23/1986,25,0,0,29,4,4750,6550,6550,144,131,1962746,188,81,D RC,1,2,2,3,2,1,3,1,2,1,3,5,8,9,9,9,3,18,3,8,14,10,5,15,9,17,15,18,10,9,8,8,18,5,14,9,13,11,18,13,11,14,16,8,11,15,20,15,16,13,14,16,12,10,10,15,9,14,12,6,9,7,20,1,1,1,18,10,20,D RC,103,1,1,1,1,1,1,20,10,18,1,1,1,1,1,1,2.19902E+12,0,0,0,0,0,1,0,0,0,0,0,0,0,0,0,1,1,0,0,0,0,0,0,0,0,0,0,0,0,0,0,0,0,0,0,0,0,0,0,0,0,1,0,0,0,0,0,0,Steven Taylor,£5.40m ,34,186,Defender - Centre-Back,right,Odisha FC,17,3,1,1202,15,0,1,1335,33,0,0,2724,12,1,0,910,12,1,0,861,21,2,0,1799,6,0,0,431,51,4,2,4544,23,2,1,2070,Premier League,27,1,0,2385,nan,nan,nan,nan
19/6/2011,Sergio Sánchez,1507596,796,4/3/1986,25,0,0,4,0,4500,6900,6900,150,138,1492831,185,78,D RC,1,2,2,1,1,2,1,8,3,2,3,5,6,6,8,12,6,14,7,9,15,12,8,14,11,16,14,14,13,12,8,12,13,7,12,12,15,14,16,14,12,15,13,10,14,13,20,16,14,13,13,10,8,14,13,13,14,11,9,9,9,10,20,6,1,1,20,8,18,D RC,103,1,1,1,1,1,1,18,8,20,10,1,1,1,1,6,0,0,0,0,0,0,0,0,0,0,0,0,0,0,0,0,0,0,0,0,0,0,0,0,0,0,0,0,0,0,0,0,0,0,0,0,0,0,0,0,0,0,0,0,0,0,0,0,0,Sergio Sánchez,£3.60m ,34,185,Defender - Centre-Back,right,Without Club,12,0,1,896,21,1,2,1592,26,0,1,2046,28,1,1,2420,21,0,0,1706,14,0,0,997,20,0,0,1736,4,0,0,236,22,1,1,1918,LaLiga,2,0,0,180,nan,nan,nan,nan
19/6/2011,Sergio Ramos,7458272,796,3/30/1986,25,67,5,6,0,7500,7950,7950,168,161,0,183,75,D/WB RC,1,3,3,3,3,3,1,2,2,3,1,10,15,13,11,15,13,17,13,16,15,13,10,17,14,16,15,17,10,13,12,10,16,13,12,13,15,15,16,13,15,14,13,13,16,15,20,17,12,14,15,13,3,15,8,18,12,13,12,8,8,13,20,16,9,1,20,10,18,D/WB RC,113,1,12,1,1,1,1,18,10,20,13,9,1,9,6,16,3.51844E+13,0,0,0,0,0,1,0,0,0,0,0,0,0,0,0,0,0,0,0,0,0,0,0,0,0,0,0,0,0,0,0,0,0,0,0,0,0,0,0,0,0,0,0,0,0,1,0,0,Sergio Ramos,£30.60m ,34,184,Defender - Centre-Back,right,Real Madrid,46,4,3,4050,51,4,6,4497,40,5,2,3539,51,7,4,4352,42,7,1,3552,33,3,3,2842,44,10,2,3988,42,5,1,3731,42,11,2,3662,LaLiga,44,13,1,3828,6,2,0,495
19/6/2011,Russell Martin,5119966,793,1/4/1986,25,1,0,0,0,3250,5414,5800,135,120,576453,183,74,D R,1,3,2,3,2,1,2,1,3,2,3,6,13,12,8,12,12,9,8,6,13,12,2,14,12,9,11,13,13,12,13,13,13,10,13,11,13,13,13,12,12,11,11,7,14,12,20,13,12,13,5,9,5,13,9,11,12,13,18,10,11,5,20,12,9,5,20,4,13,D R,102,1,1,1,1,1,5,13,4,20,9,4,1,9,1,12,32,0,0,0,0,0,1,0,0,0,0,0,0,0,0,0,0,0,0,0,0,0,0,0,0,0,0,0,0,0,0,0,0,0,0,0,0,0,0,0,0,0,0,0,0,0,0,0,0,Russell Martin,£2.70m ,34,183,Defender - Centre-Back,right,Retired,49,5,3,4392,37,2,2,3210,34,3,2,2960,35,0,0,3005,49,2,5,4410,32,3,1,2878,40,2,2,3535,31,1,0,2643,31,1,0,2747,Premier League,16,1,0,1303,nan,nan,nan,nan
19/6/2011,Ronald Zubar,919995,769,9/20/1985,25,0,0,15,2,3763,5849,6021,145,130,637271,186,80,D RC,3,2,2,3,1,3,3,4,2,2,1,6,10,8,7,11,7,15,12,9,14,10,8,15,11,12,14,16,7,10,8,12,17,9,13,9,12,14,15,11,9,16,13,10,13,15,20,16,16,13,12,14,10,14,14,14,13,9,16,14,14,5,20,7,1,1,20,10,18,D RC,103,1,1,1,1,1,1,18,10,20,1,1,1,1,1,7,0,0,0,0,0,0,0,0,0,0,0,0,0,0,0,0,0,0,0,0,0,0,0,0,0,0,0,0,0,0,0,0,0,0,0,0,0,0,0,0,0,0,0,0,0,0,0,0,0,Ronald Zubar,£1.80m ,35,186,Defender - Centre-Back,right,Retired,19,1,1,1627,22,1,0,1691,29,2,1,2518,16,1,1,1343,26,2,0,1726,23,2,0,1694,nan,nan,nan,nan,nan,nan,nan,nan,nan,nan,nan,nan,Premier League,nan,nan,nan,nan,nan,nan,nan,nan
19/6/2011,Rafinha,8833533,1651,9/7/1985,25,1,0,15,3,6600,7251,7550,156,153,3529159,172,68,D/WB R,1,3,1,3,2,1,2,5,3,1,1,10,13,14,9,14,8,7,11,3,12,14,17,15,16,17,17,15,13,10,14,17,18,13,6,15,12,10,17,16,17,8,6,14,15,15,20,16,6,11,19,12,4,7,10,7,9,16,6,2,9,17,20,19,14,1,20,8,12,D/WB R,112,1,1,1,1,1,1,1,8,20,9,12,1,14,8,19,1245194,0,1,0,1,0,0,0,0,0,0,0,0,0,0,0,0,1,1,0,0,1,0,0,0,0,0,0,0,0,0,0,0,0,0,0,0,0,0,0,0,0,0,0,0,0,0,0,0,Rafinha,£1.80m ,27,174,Midfielder - Attacking Midfield,left,Paris Saint-Germain,9,1,0,424,41,8,0,3384,37,10,8,3215,33,4,7,2508,36,2,3,1687,11,2,0,502,28,7,5,1567,18,2,3,1062,8,1,0,348,LaLiga,33,4,2,2344,3,0,1,154
19/6/2011,Phil Bardsley,5107572,793,6/28/1985,25,5,0,0,0,3250,6550,6650,132,130,6326898,180,74,D RL,2,3,3,2,2,1,2,4,2,3,2,5,12,11,7,10,8,11,13,12,14,10,6,14,11,18,15,17,10,15,7,14,18,5,12,10,12,14,15,14,12,12,9,6,16,12,20,16,13,12,14,9,4,9,7,16,15,9,13,6,9,10,20,7,4,1,20,18,1,D RL,105,1,1,1,1,1,1,1,18,20,3,1,1,4,1,7,1.54619E+11,0,1,0,0,0,0,0,0,0,0,0,0,0,0,0,0,0,0,0,0,0,0,0,0,0,0,0,0,0,0,0,0,0,0,1,0,0,1,0,0,0,0,0,0,0,0,0,0,Phil Bardsley,£5.40m ,35,180,Defender - Right-Back,right,Burnley FC,37,3,2,3021,37,2,1,3050,23,1,0,1417,34,4,1,2798,30,0,2,2532,17,1,2,1341,17,1,0,1350,15,0,0,1335,23,0,0,2092,Premier League,22,0,1,1968,4,0,0,281
19/6/2011,Miguel Torres,67011252,796,1/28/1986,25,0,0,12,0,4800,6650,6650,151,136,901888,184,74,D RL,1,1,3,2,1,2,1,2,1,3,1,7,11,8,5,10,6,13,10,16,16,11,6,14,10,14,14,16,13,17,8,11,13,4,11,8,15,17,16,13,11,14,12,8,15,14,20,15,12,17,13,14,8,19,13,9,18,14,15,13,17,4,20,13,8,1,20,19,10,D RL,105,1,5,1,1,1,1,10,19,20,8,3,8,8,13,13,0,0,0,0,0,0,0,0,0,0,0,0,0,0,0,0,0,0,0,0,0,0,0,0,0,0,0,0,0,0,0,0,0,0,0,0,0,0,0,0,0,0,0,0,0,0,0,0,0,Miguel Torres,£2.70m ,34,184,Defender - Right-Back,right,Retired,39,0,0,3197,23,1,1,1629,25,0,0,2099,10,0,0,780,19,0,1,1445,24,0,2,2048,23,0,0,1654,8,0,0,676,1,0,0,22,LaLiga,nan,nan,nan,nan,nan,nan,nan,nan
19/6/2011,Mathieu Debuchy,915351,769,7/28/1985,25,0,0,3,0,5200,6534,6534,150,144,752207,177,74,D/WB/M R,1,3,1,3,3,1,3,2,3,2,2,10,12,11,7,12,13,13,14,10,11,13,13,15,12,12,13,18,13,15,12,14,18,11,14,11,14,16,17,14,13,14,9,10,12,12,20,18,13,16,14,15,12,18,6,12,17,13,16,13,13,6,20,16,18,12,20,10,14,D/WB/M R,122,5,1,1,8,10,12,1,4,20,14,14,10,18,1,16,34,0,1,0,0,0,1,0,0,0,0,0,0,0,0,0,0,0,0,0,0,0,0,0,0,0,0,0,0,0,0,0,0,0,0,0,0,0,0,0,0,0,0,0,0,0,0,0,0,Mathieu Debuchy,£9.90m ,35,177,Defender - Right-Back,right,AS Saint-Étienne,49,2,5,4349,43,5,1,3857,34,0,1,2965,32,1,4,2795,15,1,0,1260,16,0,0,1295,4,2,0,266,23,5,1,2012,24,4,3,1947,Ligue 1,32,2,3,2693,3,0,0,189
19/6/2011,Marco Motta,7990132,776,5/14/1986,25,1,0,38,1,4750,6250,6250,138,127,773240,183,76,D/WB/M R,1,1,1,1,1,1,1,1,1,1,1,8,12,13,8,12,5,11,11,16,11,13,5,12,14,17,14,15,8,8,11,8,16,11,13,15,10,15,16,15,12,13,11,16,13,15,20,15,13,13,8,15,7,16,13,15,17,14,18,19,13,12,19,20,16,1,20,13,5,D/WB/M R,232,1,1,1,1,1,1,5,13,19,1,1,12,16,13,20,32,0,0,0,0,0,1,0,0,0,0,0,0,0,0,0,0,0,0,0,0,0,0,0,0,0,0,0,0,0,0,0,0,0,0,0,0,0,0,0,0,0,0,0,0,0,0,0,0,Marco Motta,£1.98m ,34,186,Defender - Right-Back,right,Persija Jakarta,32,0,2,2114,13,0,1,1018,22,1,2,1726,16,0,1,1073,9,0,0,500,12,0,2,862,15,0,1,1199,31,3,1,2498,8,0,0,645,Serie A,2,0,1,180,nan,nan,nan,nan
19/6/2011,Marco Andreolli,7984570,776,6/10/1986,25,0,0,22,0,4050,6400,6400,145,128,513374,187,81,D RC,2,3,3,3,1,2,1,3,3,2,3,5,12,8,8,10,8,15,9,11,15,11,6,14,9,10,14,12,12,13,10,15,15,5,8,10,13,14,13,13,13,11,14,5,15,13,20,15,12,13,13,10,15,14,14,15,10,10,10,10,10,10,20,1,1,1,16,10,20,D RC,103,1,1,1,1,1,1,20,10,16,10,1,1,1,1,1,0,0,0,0,0,0,0,0,0,0,0,0,0,0,0,0,0,0,0,0,0,0,0,0,0,0,0,0,0,0,0,0,0,0,0,0,0,0,0,0,0,0,0,0,0,0,0,0,0,Marco Andreolli,£3.15m ,34,187,Defender - Centre-Back,right,Without Club,29,0,0,2440,24,1,0,1977,28,2,0,2493,6,1,0,384,13,0,0,1023,9,0,0,734,9,1,0,559,24,0,0,1947,12,0,0,841,Serie A,nan,nan,nan,nan,nan,nan,nan,nan
19/6/2011,Loïc Perrin,8433507,769,8/7/1985,25,0,0,4,0,2050,5900,5900,150,132,482172,180,76,D/WB/DM R,3,1,3,2,2,2,1,8,1,1,1,6,12,10,6,12,7,14,13,9,11,13,7,13,12,11,14,15,14,14,11,14,14,7,14,8,14,14,17,13,11,13,10,8,9,12,20,13,13,15,11,14,16,15,12,13,17,13,16,15,15,5,20,18,14,10,20,2,12,D/WB/DM R,122,1,1,1,1,1,10,12,2,20,16,12,1,14,1,18,256,0,0,0,0,0,0,0,0,1,0,0,0,0,0,0,0,0,0,0,0,0,0,0,0,0,0,0,0,0,0,0,0,0,0,0,0,0,0,0,0,0,0,0,0,0,0,0,0,Loïc Perrin,£2.70m ,35,181,Defender - Centre-Back,right,Retired,28,4,1,2442,12,0,1,870,41,2,0,3695,38,7,2,3370,42,1,0,3743,34,3,1,3003,40,4,2,3446,28,0,1,2465,32,2,1,2790,Ligue 1,30,0,0,2464,nan,nan,nan,nan
19/6/2011,Jean Sony,55017618,375,1/23/1986,25,19,3,0,0,2007,5500,3115,125,100,3274,176,74,D/M R,3,1,3,3,1,3,1,4,1,1,1,9,9,10,8,9,8,9,9,11,9,8,9,11,10,13,10,12,10,10,8,8,13,11,8,14,8,9,13,16,13,8,9,10,14,16,20,8,8,10,8,11,10,12,13,11,11,12,14,14,13,5,20,14,20,12,20,9,1,D/M R,112,1,1,1,1,1,12,1,9,20,1,1,1,20,1,14,2.2518E+15,0,0,0,0,0,1,0,0,0,0,0,0,0,0,0,0,0,0,0,0,0,0,0,0,0,0,0,0,0,0,0,0,0,0,0,0,0,0,0,0,0,0,0,0,0,0,0,0,,,,,,,,,,,,,,,,,,,,,,,,,,,,,,,,,,,,,,,,,,,,,,,,,,,,
19/6/2011,Javi López,67006184,796,1/21/1986,25,0,0,0,0,2500,5750,5750,130,120,240418,179,74,D/WB/DM/M RC,1,2,3,3,1,1,3,1,1,3,3,9,12,12,11,10,9,7,11,9,12,13,5,11,12,13,12,11,12,10,11,11,10,7,8,13,12,12,14,14,13,8,8,12,14,12,20,12,10,14,8,10,7,17,8,7,12,14,8,18,10,6,18,20,19,14,20,10,15,D/WB/DM/M RC,243,1,1,1,1,8,14,1,5,18,16,15,10,19,8,20,0,0,0,0,0,0,0,0,0,0,0,0,0,0,0,0,0,0,0,0,0,0,0,0,0,0,0,0,0,0,0,0,0,0,0,0,0,0,0,0,0,0,0,0,0,0,0,0,0,Javi López,£2.25m ,34,180,Defender - Right-Back,right,Without Club,27,0,0,1752,32,1,2,2412,33,1,0,2577,35,0,1,3105,33,0,1,2621,33,0,1,2613,20,0,1,1614,15,0,0,1039,25,0,0,2159,LaLiga,28,1,1,2375,nan,nan,nan,nan
19/6/2011,Gonzalo Jara,5250132,1652,8/23/1985,25,38,3,0,0,5400,7000,6400,145,133,803432,178,76,D/DM R,3,1,2,2,2,2,2,1,2,1,2,5,10,10,8,13,7,13,10,10,14,13,5,15,13,16,13,15,11,11,12,12,15,11,13,11,16,15,16,10,13,13,12,14,14,11,20,14,14,12,16,13,8,17,14,14,13,12,13,12,7,6,20,15,13,1,20,11,14,D/DM R,112,1,15,1,1,1,1,14,11,20,16,13,1,10,10,15,16810048,0,0,0,0,0,0,1,0,0,0,0,0,0,0,0,1,0,0,0,0,0,0,0,0,1,0,0,0,0,0,0,0,0,0,0,0,0,0,0,0,0,0,0,0,0,0,0,0,Gonzalo Jara,£1.58m ,35,178,Defender - Centre-Back,right,Mazatlán FC,32,1,1,2225,22,0,1,1629,19,0,2,1489,39,0,0,3176,20,0,0,1203,18,0,0,1443,34,0,0,2735,19,0,1,1673,16,0,1,1408,Premier League,14,0,0,1220,7,0,0,514
19/6/2011,Francesco Pisano,7988382,776,4/29/1986,25,0,0,12,0,3250,6300,6300,131,126,1542389,170,65,D/WB RL,2,2,1,2,3,2,1,2,2,1,2,7,12,12,9,9,5,8,10,15,12,11,6,14,10,17,16,14,10,12,9,12,14,5,14,13,12,12,11,15,15,12,5,7,15,14,20,16,12,12,11,10,15,10,10,8,10,10,12,10,11,12,20,18,1,1,20,16,1,D/WB RL,115,1,1,1,1,1,1,1,16,20,1,1,1,1,13,18,2.74878E+11,0,0,0,0,0,0,1,0,0,0,0,0,0,0,0,1,0,0,0,0,0,0,0,0,0,0,0,0,0,0,0,0,0,0,0,0,0,0,1,0,0,0,0,0,0,0,0,0,Francesco Pisano,£1.80m ,34,171,Defender - Right-Back,right,Olbia Calcio 1905,18,0,1,1338,35,0,0,2940,29,1,0,2518,26,0,3,2035,14,0,0,985,16,0,1,1059,23,1,0,1700,24,1,1,1910,22,1,0,1500,Serie A,29,1,0,2479,5,0,0,396
19/6/2011,Ernesto Galán,1512134,796,6/17/1986,25,0,0,0,0,3029,6271,6271,136,131,293027,181,79,D RC,2,2,1,3,2,3,1,7,3,3,1,9,11,11,7,10,8,11,7,11,13,11,10,13,9,12,12,14,12,13,9,12,10,11,9,12,14,15,14,15,15,13,11,7,13,13,20,15,12,12,8,13,15,13,12,13,9,10,10,14,10,9,20,15,1,1,19,1,20,D RC,103,1,1,1,1,1,1,20,1,19,1,1,1,1,1,15,0,0,0,0,0,0,0,0,0,0,0,0,0,0,0,0,0,0,0,0,0,0,0,0,0,0,0,0,0,0,0,0,0,0,0,0,0,0,0,0,0,0,0,0,0,0,0,0,0,Ernesto Galán,£1.35m ,34,181,Defender - Right-Back,right,Without Club,21,1,0,1743,14,0,0,1221,14,0,0,1181,9,0,0,698,16,1,1,1309,37,4,1,3048,24,2,0,1953,8,0,0,604,29,0,0,2316,LaLiga,nan,nan,nan,nan,nan,nan,nan,nan
19/6/2011,Edson Ramos,19008137,1651,5/31/1986,25,0,0,0,0,3250,6000,5750,135,125,119142,170,64,D/WB/M R,2,1,3,2,1,2,1,4,2,1,1,6,12,14,6,13,6,7,6,10,11,10,6,11,14,12,11,12,10,10,12,10,10,13,5,15,10,13,15,17,17,10,6,10,12,17,20,15,8,14,10,13,5,10,8,10,9,12,7,12,12,12,20,18,17,10,20,9,1,D/WB/M R,122,1,1,1,1,1,10,1,9,20,1,1,1,17,1,18,34,0,1,0,0,0,1,0,0,0,0,0,0,0,0,0,0,0,0,0,0,0,0,0,0,0,0,0,0,0,0,0,0,0,0,0,0,0,0,0,0,0,0,0,0,0,0,0,0,,,,,,,,,,,,,,,,,,,,,,,,,,,,,,,,,,,,,,,,,,,,,,,,,,,,
19/6/2011,Éder Sciola,19008536,1651,9/25/1985,25,0,0,0,0,3250,5500,5500,125,110,532522,181,80,D/WB/DM R,3,2,3,1,1,1,3,1,3,1,2,10,11,11,9,10,9,9,9,15,12,10,10,12,11,15,11,14,13,13,12,12,13,10,11,13,11,12,10,14,12,13,9,9,11,14,20,13,13,11,11,12,6,12,12,11,12,11,3,8,12,12,18,20,15,1,20,1,13,D/WB/DM R,232,1,1,1,1,1,1,1,1,18,16,13,1,15,1,20,0,0,0,0,0,0,0,0,0,0,0,0,0,0,0,0,0,0,0,0,0,0,0,0,0,0,0,0,0,0,0,0,0,0,0,0,0,0,0,0,0,0,0,0,0,0,0,0,0,Éder Sciola,£450Th. ,35,183,Defender - Right-Back,right,Oeste Futebol Clube (SP),nan,nan,nan,nan,15,0,0,1009,19,0,0,1179,2,0,0,210,32,0,7,2630,31,0,1,2679,25,2,1,2204,34,6,2,2941,34,1,5,2925,Liga NOS,19,1,0,1538,nan,nan,nan,nan
19/6/2011,Carlos Martínez,1511410,796,4/9/1986,25,0,0,0,0,4400,6300,6300,136,130,617329,188,78,D R,3,3,3,1,2,2,3,5,2,3,2,5,10,12,6,8,5,10,4,10,12,10,5,14,9,16,14,18,14,12,9,13,12,12,10,13,15,15,19,11,8,11,15,12,12,14,20,18,15,13,10,11,9,13,13,14,15,13,14,14,10,6,20,15,9,1,20,5,12,D R,102,1,1,1,1,1,1,12,5,20,1,1,1,9,1,15,32,0,0,0,0,0,1,0,0,0,0,0,0,0,0,0,0,0,0,0,0,0,0,0,0,0,0,0,0,0,0,0,0,0,0,0,0,0,0,0,0,0,0,0,0,0,0,0,0,Carlos Martínez,£2.70m ,34,189,Defender - Right-Back,right,Retired,25,0,2,2205,21,0,2,1683,29,1,5,2586,32,0,0,2815,16,0,2,1267,12,0,2,718,11,0,3,959,2,0,0,92,15,0,1,1085,LaLiga,17,0,0,1027,nan,nan,nan,nan
19/6/2011,Andrea Masiello,7984549,776,2/5/1986,25,0,0,0,0,3500,7425,7500,150,135,480317,185,75,D RC,2,2,1,3,2,1,1,6,2,2,2,3,8,7,5,8,5,15,5,3,15,10,4,16,8,13,16,15,14,13,8,14,16,5,16,8,16,14,13,13,13,14,13,5,14,13,20,16,15,14,8,14,7,10,14,16,16,15,16,17,16,3,20,1,1,1,18,9,20,D RC,103,1,13,1,1,1,1,20,9,18,1,1,1,1,1,1,0,0,0,0,0,0,0,0,0,0,0,0,0,0,0,0,0,0,0,0,0,0,0,0,0,0,0,0,0,0,0,0,0,0,0,0,0,0,0,0,0,0,0,0,0,0,0,0,0,Andrea Masiello,£1.80m ,34,184,Defender - Centre-Back,right,Genoa CFC,39,2,0,3355,18,1,1,1539,nan,nan,nan,nan,nan,nan,nan,nan,14,0,0,1106,31,0,1,2578,38,3,0,3137,41,5,0,3565,33,1,3,2593,Serie A,27,0,1,2149,2,0,0,180
