GameDate,Name,UID,NationID,Born,Age,IntCaps,IntGoals,U21Caps,U21Goals,WorldReputation,HomeReputation,CurrentReputation,PA,CA,Price,Height,Weight,PositionsString,GK.AerialAbility,GK.CommandOfArea,GK.Communication,GK.Eccentricity,GK.Handling,GK.Kicking,GK.OneOnOnes,GK.Reflexes,GK.RushingOut,GK.TendencyToPunch,GK.Throwing,Tech.Corners,Tech.Crossing,Tech.Dribbling,Tech.Finishing,Tech.FirstTouch,Tech.Freekicks,Tech.Heading,Tech.LongShots,Tech.Longthrows,Tech.Marking,Tech.Passing,Tech.PenaltyTaking,Tech.Tackling,Tech.Technique,Mental.Aggression,Mental.Anticipation,Mental.Bravery,Mental.Composure,Mental.Concentration,Mental.Vision,Mental.Decisions,Mental.Determination,Mental.Flair,Mental.Leadership,Mental.OffTheBall,Mental.Positioning,Mental.Teamwork,Mental.Workrate,Phy.Acceleration,Phy.Agility,Phy.Balance,Phy.Jumping,Phy.LeftFoot,Phy.NaturalFitness,Phy.Pace,Phy.RightFoot,Phy.Stamina,Phy.Strength,Hidden.Consistency,Hidden.Dirtiness,Hidden.ImportantMatches,Hidden.InjuryProness,Hidden.Versatility,Personality.Adaptability,Personality.Ambition,Personality.Loyalty,Personality.Pressure,Personality.Professional,Personality.Sportsmanship,Personality.Temperament,Personality.Controversy,Positions.Defender,Positions.WingBack,Positions.Midfielder,Positions.AttackingMidfielder,Positions.Right,Positions.Left,Positions.Centre,Positions.PositionsDesc,Positions.PositionsDescVal,Positions.Goalkeeper,Positions.Sweeper,Positions.Striker,Positions.AttackingMidCentral,Positions.AttackingMidLeft,Positions.AttackingMidRight,Positions.DefenderCentral,Positions.DefenderLeft,Positions.DefenderRight,Positions.DefensiveMidfielder,Positions.MidfielderCentral,Positions.MidfielderLeft,Positions.MidfielderRight,Positions.WingBackLeft,Positions.WingBackRight,PPMVal,PPM0,PPM1,PPM2,PPM3,PPM4,PPM5,PPM6,PPM7,PPM8,PPM9,PPM10,PPM11,PPM12,PPM13,PPM14,PPM15,PPM16,PPM17,PPM18,PPM19,PPM20,PPM21,PPM22,PPM23,PPM24,PPM25,PPM26,PPM27,PPM28,PPM29,PPM30,PPM31,PPM32,PPM33,PPM34,PPM35,PPM36,PPM37,PPM38,PPM39,PPM40,PPM41,PPM42,PPM43,PPM44,PPM45,PPM46,PPM47,name,Market Value,age,height,position,foot,current club,10/11 games,10/11 goals/conceded,10/11 assists/clean,10/11 minutes,11/12 games,11/12 goals/conceded,11/12 assists/clean,11/12 minutes,12/13 games,12/13 goals/conceded,12/13 assists/clean,12/13 minutes,13/14 games,13/14 goals/conceded,13/14 assists/clean,13/14 minutes,14/15 games,14/15 goals/conceded,14/15 assists/clean,14/15 minutes,15/16 games,15/16 goals/conceded,15/16 assists/clean,15/16 minutes,16/17 games,16/17 goals/conceded,16/17 assists/clean,16/17 minutes,17/18 games,17/18 goals/conceded,17/18 assists/clean,17/18 minutes,18/19 games,18/19 goals/conceded,18/19 assists/clean,18/19 minutes,current league,19/20 games,19/20 goals/conceded,19/20 assists/clean,19/20 minutes,20/21 games,20/21 goals/conceded,20/21 assists/clean,20/21 minutes
19/6/2011,Lenny Nangis,85043913,769,3/24/1994,17,0,0,0,0,1255,4184,2558,159,93,1042279,174,71,S R,1,2,3,1,3,2,2,2,2,1,2,6,10,12,10,10,7,5,9,5,1,8,10,2,12,8,8,9,11,8,8,7,14,13,5,13,4,7,11,16,14,11,7,5,15,14,20,11,9,13,8,14,5,7,18,14,13,14,14,15,15,5,1,1,15,15,15,10,1,S R,602,1,1,20,1,10,15,1,1,1,1,1,10,15,1,1,18,0,1,0,0,1,0,0,0,0,0,0,0,0,0,0,0,0,0,0,0,0,0,0,0,0,0,0,0,0,0,0,0,0,0,0,0,0,0,0,0,0,0,0,0,0,0,0,0,Lenny Nangis,£720Th. ,26,172,Forward - Left Winger,right,RWD Molenbeek,nan,nan,nan,nan,14,1,0,766,8,1,0,386,24,2,1,1242,37,4,4,2414,17,0,3,736,32,0,2,1525,22,0,4,1099,29,1,3,1790,Ligue 1,nan,nan,nan,nan,5,0,0,431
19/6/2011,Julian Draxler,92030193,771,9/20/1993,17,0,0,0,0,4750,6750,6750,134,125,9389919,183,68,AM RLC,1,2,3,1,1,2,3,5,2,3,2,11,13,12,13,17,10,5,15,8,5,15,10,6,16,8,14,7,7,8,14,11,8,15,5,13,5,10,13,11,10,9,10,18,11,14,20,11,7,10,5,14,4,14,7,13,11,9,11,6,17,12,1,1,12,20,17,18,20,AM RLC,506,1,1,1,20,18,17,1,1,1,1,12,1,1,1,1,4.50415E+15,0,0,0,0,0,0,0,0,1,0,0,0,0,0,0,0,0,0,0,0,1,0,0,0,0,0,0,0,0,0,0,0,0,0,0,0,0,0,0,1,0,0,0,0,0,0,0,0,Julian Draxler,£9.90m ,27,187,Midfielder - Attacking Midfield,right,Paris Saint-Germain,36,12,2,1810,46,5,9,2779,39,13,7,2762,38,6,10,3101,19,2,2,1068,35,9,8,2584,39,10,5,2721,47,5,10,2630,46,5,12,2977,Bundesliga,22,0,7,1194,6,2,0,400
19/6/2011,Ibrahima Tandia,85028025,769,7/12/1993,17,0,0,0,0,1345,4544,2691,131,101,1060038,169,65,AM RL,2,3,2,1,3,3,1,1,2,1,1,8,10,14,8,12,6,6,8,5,1,9,11,3,14,6,10,7,12,9,9,9,10,14,5,11,5,8,11,16,14,9,5,5,12,15,20,11,6,13,6,9,6,8,11,6,8,13,8,13,11,13,1,1,12,20,16,20,14,AM RL,505,1,1,10,14,20,16,1,1,1,1,10,12,12,1,1,0,0,0,0,0,0,0,0,0,0,0,0,0,0,0,0,0,0,0,0,0,0,0,0,0,0,0,0,0,0,0,0,0,0,0,0,0,0,0,0,0,0,0,0,0,0,0,0,0,Ibrahima Tandia,£360Th. ,27,171,Forward - Left Winger,right,Al-Hazm,nan,nan,nan,nan,3,0,0,124,nan,nan,nan,nan,nan,nan,nan,nan,22,3,3,1168,30,5,1,1414,9,0,0,345,23,5,2,1662,34,11,5,3002,Ligue 1,27,3,1,1621,nan,nan,nan,nan
19/6/2011,Ryo Miyaichi,28060849,116,12/14/1992,18,0,0,0,0,3266,5552,5788,146,122,20428192,180,71,AM RL,1,2,3,2,3,2,3,5,2,2,1,7,10,15,10,13,8,7,7,9,3,11,9,3,13,8,11,13,9,9,13,9,8,16,5,14,4,12,11,15,14,10,7,12,10,15,20,11,5,11,15,7,13,10,15,9,17,14,6,9,14,5,1,1,9,20,19,20,1,AM RL,505,1,1,1,1,20,19,1,1,1,1,1,9,1,1,1,0,0,0,0,0,0,0,0,0,0,0,0,0,0,0,0,0,0,0,0,0,0,0,0,0,0,0,0,0,0,0,0,0,0,0,0,0,0,0,0,0,0,0,0,0,0,0,0,0,Ryo Miyaichi,£2.70m ,27,183,Forward - Right Winger,right,FC St. Pauli,12,3,5,1030,24,2,4,1457,7,0,1,182,11,1,1,720,25,3,1,1730,5,2,1,114,20,0,1,804,1,0,0,13,29,5,1,1721,Premier League,30,1,7,2634,nan,nan,nan,nan
19/6/2011,Pablo Hervías,67115983,796,3/8/1993,18,0,0,0,0,1750,4150,4150,119,90,235491,167,66,M/AM RC,3,2,3,3,3,1,2,3,3,3,2,12,12,12,9,8,10,7,11,2,1,11,10,4,14,8,9,8,9,10,12,11,12,14,9,12,3,10,4,14,10,9,6,10,12,13,20,11,10,11,6,9,9,13,8,14,6,9,6,11,10,7,1,1,16,20,20,13,18,M/AM RC,523,1,1,4,18,13,20,1,1,1,4,16,13,14,1,1,4,0,0,1,0,0,0,0,0,0,0,0,0,0,0,0,0,0,0,0,0,0,0,0,0,0,0,0,0,0,0,0,0,0,0,0,0,0,0,0,0,0,0,0,0,0,0,0,0,,,,,,,,,,,,,,,,,,,,,,,,,,,,,,,,,,,,,,,,,,,,,,,,,,,,
19/6/2011,Moritz Leitner,16020473,771,12/8/1992,18,0,0,0,0,3150,6000,6000,139,120,18181818,174,65,M/AM RLC,1,2,2,1,3,1,2,4,3,3,2,9,13,14,7,13,13,5,13,2,5,14,6,5,14,9,10,14,11,11,13,11,12,13,4,13,4,13,14,14,16,8,7,15,12,13,20,10,7,8,3,8,4,17,9,14,11,9,13,12,13,9,1,1,19,20,18,18,20,M/AM RLC,526,1,1,1,20,16,16,1,1,1,12,19,18,18,1,1,268435456,0,0,0,0,0,0,0,0,0,0,0,0,0,0,0,0,0,0,0,0,0,0,0,0,0,0,0,0,1,0,0,0,0,0,0,0,0,0,0,0,0,0,0,0,0,0,0,0,Moritz Leitner,£3.60m ,27,174,Midfielder - Central Midfield,right,Norwich City,27,0,5,1318,25,0,3,998,31,0,3,1222,24,1,2,1751,21,1,2,1208,21,3,6,1087,8,0,0,248,12,0,0,863,31,2,2,1802,Bundesliga,10,0,0,805,1,0,0,45
19/6/2011,Markus Mendler,91100204,771,1/7/1993,18,0,0,0,0,4527,5935,6036,146,118,2085958,173,67,M/AM RLC,2,1,2,2,1,2,3,2,3,3,1,11,12,13,7,12,6,5,11,5,9,11,10,11,12,16,11,8,9,12,14,6,8,9,12,10,7,14,13,13,12,12,6,20,18,13,12,13,9,10,10,10,10,10,10,8,12,6,12,17,17,12,1,1,18,20,20,18,18,M/AM RLC,526,1,1,1,16,18,20,1,1,1,1,18,14,16,1,1,0,0,0,0,0,0,0,0,0,0,0,0,0,0,0,0,0,0,0,0,0,0,0,0,0,0,0,0,0,0,0,0,0,0,0,0,0,0,0,0,0,0,0,0,0,0,0,0,0,Markus Mendler,£720Th. ,27,173,Forward - Left Winger,left,1.FC Saarbrücken,25,5,1,1740,17,2,1,1002,11,4,0,855,11,0,0,711,20,3,0,876,30,4,1,1611,23,4,5,1184,32,12,18,2233,34,9,11,2196,Bundesliga,28,9,5,1679,4,2,0,114
19/6/2011,Luc Castaignos,37005404,784,9/27/1992,18,0,0,0,0,5034,6142,5790,162,115,2889247,188,78,AM/S R,3,3,2,3,3,1,1,2,3,3,1,10,7,9,13,13,11,12,11,4,4,9,8,3,14,4,13,16,12,13,11,9,11,14,4,16,4,11,13,12,13,14,12,12,13,12,20,12,13,10,11,12,7,10,8,9,14,15,14,9,12,8,1,1,1,16,16,13,13,AM/S R,622,1,1,20,13,13,16,1,1,1,1,1,1,1,1,1,0,0,0,0,0,0,0,0,0,0,0,0,0,0,0,0,0,0,0,0,0,0,0,0,0,0,0,0,0,0,0,0,0,0,0,0,0,0,0,0,0,0,0,0,0,0,0,0,0,Luc Castaignos,£4.05m ,28,188,Forward - Centre-Forward,right,Gyeongnam FC,37,15,2,2646,11,3,0,426,51,16,6,3715,31,14,5,2639,35,14,0,2794,21,5,3,1028,14,0,0,430,36,3,1,1288,30,4,4,1824,Serie A,8,2,0,498,nan,nan,nan,nan
19/6/2011,Kostas Fortounis,36042095,772,10/16/1992,18,0,0,8,0,2000,5174,5750,138,115,1655519,182,69,AM RLC,1,2,3,2,2,3,3,2,3,1,3,12,11,13,8,14,12,9,12,7,8,13,10,8,14,11,13,11,10,12,13,13,14,12,7,14,8,9,12,13,14,11,11,8,14,13,20,10,10,10,6,8,5,10,12,17,19,14,14,20,8,6,1,1,14,20,18,17,20,AM RLC,506,1,1,5,20,17,18,1,1,1,1,14,10,12,1,1,0,0,0,0,0,0,0,0,0,0,0,0,0,0,0,0,0,0,0,0,0,0,0,0,0,0,0,0,0,0,0,0,0,0,0,0,0,0,0,0,0,0,0,0,0,0,0,0,0,Konstantinos Fortounis,£2.25m ,28,183,Midfielder - Attacking Midfield,both,Olympiacos Piraeus,26,1,2,783,30,0,5,1907,26,3,4,1665,21,0,1,697,37,10,5,1653,39,21,17,2761,40,8,8,3044,37,11,14,2475,43,17,16,3300,Bundesliga,21,3,4,1093,6,1,2,228
19/6/2011,Julian Wießmeier,91100203,771,11/4/1992,18,0,0,0,0,4250,5500,5500,136,110,1641611,171,71,AM/S RC,1,3,1,3,3,1,3,5,3,3,2,12,14,14,10,14,8,10,10,3,7,14,6,7,12,12,12,8,13,9,13,12,9,16,9,14,10,16,13,10,12,11,6,16,17,12,20,10,5,10,9,9,4,10,9,17,13,8,11,17,12,12,1,1,14,18,18,1,16,AM/S RC,623,1,1,20,16,1,18,1,1,1,1,1,1,14,1,1,0,0,0,0,0,0,0,0,0,0,0,0,0,0,0,0,0,0,0,0,0,0,0,0,0,0,0,0,0,0,0,0,0,0,0,0,0,0,0,0,0,0,0,0,0,0,0,0,0,Julian Wießmeier,£720Th. ,27,171,Midfielder - Attacking Midfield,both,SV Ried,30,20,0,2421,24,7,5,1553,21,1,3,1367,21,4,2,1622,31,11,1,1973,29,15,3,2526,22,12,6,1843,38,8,9,2972,30,10,6,2146,Bundesliga,31,10,3,2318,5,2,0,154
19/6/2011,Joel Campbell,80010074,366,6/26/1992,18,19,4,0,0,5500,5250,5250,125,107,1192207,178,70,AM/S RL,2,3,3,1,1,2,1,1,2,2,1,9,12,10,13,13,9,11,8,8,8,10,9,8,9,7,7,7,7,7,10,4,12,11,12,13,6,11,15,13,13,13,9,20,12,13,10,11,3,10,10,10,7,9,11,12,11,10,13,13,10,10,1,1,9,20,20,20,1,AM/S RL,515,1,1,20,1,20,20,1,1,1,1,1,9,1,1,1,0,0,0,0,0,0,0,0,0,0,0,0,0,0,0,0,0,0,0,0,0,0,0,0,0,0,0,0,0,0,0,0,0,0,0,0,0,0,0,0,0,0,0,0,0,0,0,0,0,Joel Campbell,£1.35m ,28,178,Forward - Right Winger,left,Club León FC,8,0,0,416,27,4,3,1252,33,2,3,1889,43,11,11,3185,33,1,1,1832,31,4,6,1696,29,3,4,1246,9,2,1,232,38,4,4,2399,Ligue 1,23,1,3,1210,14,0,0,525
19/6/2011,Jean-Christophe Bahebeck,85057300,769,5/1/1993,18,0,0,0,0,4000,5016,5016,144,111,795916,182,76,AM RL,1,1,2,1,2,3,3,2,1,1,2,9,9,12,11,10,11,12,13,5,3,8,10,2,13,6,12,10,11,9,7,9,14,14,6,12,4,8,9,14,13,13,11,12,13,16,20,10,13,13,6,14,10,12,9,14,15,13,15,13,13,6,1,1,10,20,15,20,1,AM RL,505,1,1,12,1,20,15,1,1,1,1,1,10,10,1,1,5.49756E+11,0,0,0,0,0,0,0,0,0,1,0,0,0,0,0,0,0,0,0,0,0,0,0,0,0,0,0,0,0,0,0,0,0,0,0,0,0,0,0,1,0,0,0,0,0,0,0,0,Jean-Christophe Bahebeck,£1.35m ,27,182,Forward - Centre-Forward,right,FK Partizan Belgrade,13,1,1,281,15,2,1,402,33,6,3,1728,21,2,1,1259,24,3,5,868,24,3,0,1183,15,4,1,822,7,3,1,372,15,5,6,814,Ligue 1,19,5,1,767,1,0,0,37
19/6/2011,Heung-Min Son,92020288,135,7/8/1992,18,5,1,0,0,5250,6150,6650,178,132,36363636,183,76,AM/S RC,1,3,3,1,3,2,2,3,1,1,1,6,7,13,16,13,12,10,14,5,4,8,12,5,14,9,15,10,13,8,7,9,12,14,5,14,5,8,10,16,15,9,8,17,10,14,20,11,10,9,5,7,13,13,14,16,14,11,18,15,17,2,1,1,1,17,15,14,17,AM/S RC,623,1,1,20,17,14,15,1,1,1,1,1,1,1,1,1,1.81419E+13,0,0,0,0,1,0,0,0,0,1,0,0,0,1,0,0,0,0,0,0,0,0,0,0,0,0,0,0,0,0,0,0,0,0,0,0,0,0,0,1,0,0,0,0,1,0,0,0,Heung-min Son,£4.05m ,28,184,Forward - Left Winger,both,Tottenham Hotspur,14,3,0,748,30,5,1,1431,34,12,2,2786,43,12,7,3225,42,17,4,3181,42,8,5,2001,47,21,9,2972,53,18,11,3379,48,20,10,3292,Bundesliga,41,18,12,3174,8,9,4,586
19/6/2011,Connor Wickham,28030306,765,3/31/1993,18,0,0,3,0,3900,6215,6500,166,113,18181818,191,90,S RL,2,2,3,3,1,2,1,1,1,1,3,4,8,13,12,14,2,11,5,18,3,13,12,8,12,10,8,12,10,10,11,12,15,10,9,12,10,12,12,13,10,10,15,8,12,14,20,7,17,10,3,12,9,10,10,15,14,10,12,10,12,6,1,1,1,15,15,15,1,S RL,605,1,1,20,1,15,15,1,1,1,1,1,1,1,1,1,1.1259E+15,0,0,1,0,0,0,0,0,0,1,0,0,0,0,0,0,0,0,0,0,0,0,0,0,0,0,0,0,0,0,0,0,0,0,0,0,0,0,0,0,0,0,0,0,0,0,0,0,Connor Wickham,£5.40m ,27,189,Forward - Centre-Forward,right,Crystal Palace,41,9,2,2727,19,1,1,670,25,7,0,1282,36,15,7,2531,40,6,1,2974,24,6,3,1586,10,3,0,545,nan,nan,nan,nan,8,1,1,159,Premier League,21,3,1,1135,nan,nan,nan,nan
19/6/2011,Yunus Malli,91017783,771,2/24/1992,19,0,0,0,0,2500,5250,5250,146,105,424054,179,70,M/AM RC,3,3,3,3,2,2,1,4,2,1,2,9,10,13,8,13,14,4,12,2,6,12,13,4,15,9,12,6,7,11,14,11,6,13,6,14,4,9,8,14,17,7,3,10,11,15,20,13,4,8,7,7,8,10,13,1,3,14,13,6,6,6,1,1,18,20,16,10,20,M/AM RC,523,1,1,1,20,10,16,1,1,1,10,18,10,15,1,1,0,0,0,0,0,0,0,0,0,0,0,0,0,0,0,0,0,0,0,0,0,0,0,0,0,0,0,0,0,0,0,0,0,0,0,0,0,0,0,0,0,0,0,0,0,0,0,0,0,Yunus Malli,£720Th. ,28,179,Midfielder - Attacking Midfield,right,VfL Wolfsburg,30,7,9,2412,22,5,3,1305,23,3,2,1390,29,5,5,1676,34,6,4,2416,36,11,5,2946,43,9,9,3377,37,6,5,2704,23,1,2,773,Bundesliga,15,0,1,726,1,0,0,58
19/6/2011,Tae-Hee Nam,28016969,135,7/3/1991,19,0,0,0,0,3950,5500,4950,140,110,1816398,174,72,AM RC,2,3,3,2,2,2,3,2,3,3,3,8,9,14,7,14,10,6,11,6,2,11,10,3,16,5,10,11,11,12,11,7,14,14,5,11,5,7,13,17,14,9,7,5,13,15,20,13,10,12,5,14,8,10,14,15,13,13,15,15,15,6,1,1,15,20,20,10,17,AM RC,503,1,1,12,17,10,20,1,1,1,1,12,10,15,1,1,2.2518E+15,0,0,0,0,0,0,0,0,0,0,0,0,0,0,0,0,0,0,0,0,0,0,0,0,0,0,0,0,0,0,0,0,0,0,0,0,0,0,0,0,0,0,0,0,0,0,0,0,Tae-hee Nam,£765Th. ,29,174,Midfielder - Attacking Midfield,right,Al-Sadd SC,21,0,3,1187,29,6,2,1572,27,6,7,2236,31,14,10,2758,35,13,16,2822,32,12,10,2734,33,18,12,2835,30,13,6,2482,16,8,5,1388,Ligue 1,28,4,5,2268,4,3,0,346
19/6/2011,Sissoko,55024969,24,11/29/1991,19,0,0,3,0,2250,4500,4500,128,90,145663,177,67,AM RL,2,1,3,3,3,2,1,7,1,1,2,11,12,13,11,13,10,6,10,6,6,11,11,6,14,9,9,8,9,8,11,9,8,15,7,12,6,9,10,13,13,9,8,20,13,13,5,9,8,7,8,10,8,10,13,15,9,13,9,13,12,10,1,1,10,20,17,20,13,AM RL,505,1,1,5,13,20,17,1,1,1,1,1,10,1,1,1,1.81763E+13,0,0,0,0,0,0,0,1,0,0,0,0,0,0,0,0,0,0,0,0,0,0,0,0,0,0,0,0,0,0,0,0,0,0,0,1,0,0,0,1,0,0,0,0,1,0,0,0,,,,,,,,,,,,,,,,,,,,,,,,,,,,,,,,,,,,,,,,,,,,,,,,,,,,
19/6/2011,Serdar Gürler,34007438,799,9/14/1991,19,0,0,2,0,2410,5350,4820,155,107,441510,170,60,AM R,3,3,3,1,2,3,3,1,2,2,3,8,10,13,8,13,11,7,9,5,1,8,11,3,13,7,10,12,11,11,9,7,14,13,9,13,7,11,13,16,15,10,5,5,15,15,20,11,6,14,7,11,5,8,19,14,14,13,13,17,17,5,1,1,12,20,20,14,1,AM R,502,1,1,12,1,14,20,1,1,1,1,1,12,12,1,1,8194,0,1,0,0,0,0,0,0,0,0,0,0,0,1,0,0,0,0,0,0,0,0,0,0,0,0,0,0,0,0,0,0,0,0,0,0,0,0,0,0,0,0,0,0,0,0,0,0,Serdar Gürler,£135Th. ,29,175,Forward - Right Winger,right,Antalyaspor,1,0,0,13,1,0,0,5,25,8,2,1752,40,4,14,3185,21,3,5,1367,12,1,0,400,36,17,6,3078,33,13,6,2624,33,3,3,2025,Ligue 1,28,7,6,2289,nan,nan,nan,nan
19/6/2011,Saphir Taïder,85041832,769,2/29/1992,19,0,0,0,0,3238,4923,4915,147,108,389439,180,73,M RC,1,1,3,2,3,2,2,1,3,2,1,8,8,13,8,13,13,6,12,5,7,12,11,5,15,8,12,11,12,12,13,9,14,12,7,11,9,13,14,14,14,13,9,8,14,11,20,14,11,13,8,14,7,8,12,15,14,13,13,15,15,7,1,1,20,1,15,10,20,M RC,403,1,1,1,1,1,1,1,1,1,14,20,10,15,1,1,1073741824,0,0,0,0,0,0,0,0,0,0,0,0,0,0,0,0,0,0,0,0,0,0,0,0,0,0,0,0,0,0,1,0,0,0,0,0,0,0,0,0,0,0,0,0,0,0,0,0,Saphir Taider,£2.70m ,28,180,Midfielder - Central Midfield,right,Al-Ain,26,1,0,1682,19,2,1,1362,35,5,2,2967,26,2,2,1140,28,4,3,1773,29,0,0,2111,25,4,0,1992,45,7,9,3423,37,10,9,3033,Serie A,14,5,5,1158,1,1,0,90
19/6/2011,Salvador Agra,55021884,788,11/11/1991,19,0,0,0,0,1080,4500,4500,125,100,504065,166,60,AM RL,1,3,2,2,2,3,3,1,1,2,1,9,10,12,11,12,8,4,9,5,5,9,10,6,11,10,11,11,7,7,7,7,14,14,5,12,5,8,9,14,13,7,6,10,13,13,20,7,7,9,8,8,8,12,13,13,15,13,14,15,15,6,1,1,9,20,20,20,5,AM RL,505,1,1,7,5,20,20,1,1,1,1,1,9,1,1,1,0,0,0,0,0,0,0,0,0,0,0,0,0,0,0,0,0,0,0,0,0,0,0,0,0,0,0,0,0,0,0,0,0,0,0,0,0,0,0,0,0,0,0,0,0,0,0,0,0,Salvador Agra,£720Th. ,28,166,Forward - Right Winger,right,CD Tondela,36,2,0,2218,31,4,4,2335,23,1,3,1095,27,4,2,1342,35,4,4,1287,41,13,14,3167,31,3,4,2535,36,3,3,2545,15,0,1,632,Liga NOS,6,0,0,292,5,0,1,431
19/6/2011,Ruben Pinto,55022438,788,4/24/1992,19,0,0,0,0,1568,4307,4307,150,90,206514,181,69,M/AM RC,3,3,1,3,1,3,2,9,1,1,1,10,11,11,9,11,9,7,9,6,7,11,10,6,11,9,12,10,12,12,12,12,10,12,10,12,9,10,11,11,11,9,9,8,12,11,20,8,8,13,7,11,14,12,9,19,13,14,15,7,12,19,1,1,20,17,17,13,20,M/AM RC,413,1,1,1,17,13,17,1,1,1,8,20,5,10,1,1,0,0,0,0,0,0,0,0,0,0,0,0,0,0,0,0,0,0,0,0,0,0,0,0,0,0,0,0,0,0,0,0,0,0,0,0,0,0,0,0,0,0,0,0,0,0,0,0,0,Rúben Pinto,£450Th. ,28,183,Midfielder - Defensive Midfield,right,MOL Fehérvár FC,nan,nan,nan,nan,0,0,0,0,5,0,0,233,34,4,4,2814,36,7,2,3118,46,3,2,3481,29,2,1,2301,30,4,1,2309,43,5,1,3461,Liga NOS,15,1,2,1188,0,0,0,0
19/6/2011,Pajtim Kasami,28027647,798,6/2/1992,19,0,0,10,1,3500,5500,6250,160,120,1510795,187,70,M/AM RC,1,1,1,1,1,1,1,1,1,1,1,10,14,13,14,12,5,9,13,3,9,13,11,14,8,7,13,14,12,10,11,9,10,17,8,11,9,13,11,15,13,14,12,20,12,14,8,11,13,10,12,10,17,6,14,5,11,6,10,5,11,8,1,1,20,20,17,13,20,M/AM RC,413,1,1,8,20,13,17,1,1,1,14,20,13,17,1,1,0,0,0,0,0,0,0,0,0,0,0,0,0,0,0,0,0,0,0,0,0,0,0,0,0,0,0,0,0,0,0,0,0,0,0,0,0,0,0,0,0,0,0,0,0,0,0,0,0,Pajtim Kasami,£2.25m ,28,188,Midfielder - Right Midfield,left,FC Basel 1893,23,0,3,866,24,3,2,1216,24,2,2,1665,35,3,1,2321,36,5,6,2440,30,4,3,2213,27,2,2,1974,26,6,4,2225,38,11,8,3068,Premier League,39,15,4,3234,nan,nan,nan,nan
19/6/2011,Pablo Ceppelini,78034945,1657,9/11/1991,19,0,0,0,0,2296,5077,5042,141,112,732886,176,70,M/AM RC,2,3,2,3,1,2,1,5,2,3,3,15,14,14,12,16,14,4,12,11,7,15,14,6,15,12,13,9,12,8,12,12,10,12,6,15,9,12,12,12,16,7,7,10,17,10,20,13,8,12,8,12,2,13,14,10,15,14,15,14,8,10,1,1,16,20,16,12,20,M/AM RC,523,1,1,8,20,12,16,1,1,1,1,16,8,12,1,1,0,0,0,0,0,0,0,0,0,0,0,0,0,0,0,0,0,0,0,0,0,0,0,0,0,0,0,0,0,0,0,0,0,0,0,0,0,0,0,0,0,0,0,0,0,0,0,0,0,Pablo Ceppelini,£1.35m ,29,178,Midfielder - Attacking Midfield,right,CD Cruz Azul,18,1,4,1217,18,5,0,1101,18,2,1,1131,3,0,0,94,29,5,2,1988,9,0,2,370,55,12,11,4938,34,6,6,2348,46,9,9,2797,Serie A,7,1,0,278,0,0,0,0
19/6/2011,Mario Götze,35017438,771,6/3/1992,19,6,0,2,0,7500,7700,7700,182,155,18181818,176,64,AM RLC,1,2,1,3,3,3,3,6,3,3,2,12,13,17,9,18,12,10,9,4,5,17,11,7,18,11,16,11,12,8,17,17,14,18,7,17,7,15,14,17,18,14,8,9,13,13,20,12,8,14,7,14,11,15,11,13,13,11,14,10,8,7,1,1,14,20,19,20,19,AM RLC,506,1,1,12,19,20,19,1,1,1,10,13,14,14,1,1,5.49774E+11,0,0,0,0,1,0,0,1,0,0,0,0,0,0,0,0,0,0,0,0,1,0,0,0,1,0,0,0,0,0,0,0,0,0,0,0,0,0,0,1,0,0,0,0,0,0,0,0,Mario Götze,£27.00m ,28,176,Midfielder - Attacking Midfield,right,PSV Eindhoven,41,8,16,3055,26,7,8,1818,44,16,20,3231,45,15,13,2807,48,15,7,3362,21,6,4,1279,16,2,2,1175,32,2,7,2202,34,7,7,2266,Bundesliga,21,3,1,609,2,2,0,112
19/6/2011,Julián Luque,67103360,796,3/27/1992,19,0,0,1,0,3500,5500,5500,160,113,2280235,175,73,M/AM RLC,1,2,2,1,3,3,1,1,2,1,1,12,12,13,12,12,11,5,11,5,3,13,11,5,15,6,8,8,13,12,14,13,12,15,6,13,6,11,11,13,12,7,7,13,12,13,20,10,7,13,4,13,6,12,12,13,12,11,14,18,17,5,1,1,18,20,18,20,15,M/AM RLC,526,1,1,6,15,20,18,1,1,1,1,1,18,17,1,1,8,0,0,0,1,0,0,0,0,0,0,0,0,0,0,0,0,0,0,0,0,0,0,0,0,0,0,0,0,0,0,0,0,0,0,0,0,0,0,0,0,0,0,0,0,0,0,0,0,Julián Luque,£450Th. ,28,176,Midfielder - Attacking Midfield,right,Cultural Leonesa,7,0,1,220,17,0,0,691,7,0,0,143,16,1,0,657,35,2,0,2288,36,1,0,2343,38,4,0,2707,34,2,0,2444,36,6,0,3236,LaLiga,26,3,3,1570,1,0,0,10
19/6/2011,Jose Baxter,28016410,765,2/7/1992,19,0,0,0,0,2750,4724,4500,114,105,419368,179,74,S RC,1,2,3,1,2,1,3,4,1,1,3,8,8,11,14,12,9,7,10,9,4,12,10,4,13,8,12,9,13,10,12,11,13,10,6,13,11,11,10,11,11,8,7,12,13,11,20,14,7,9,13,13,4,6,8,12,15,12,12,13,13,8,1,1,13,15,15,14,15,S RC,603,1,1,20,15,14,15,1,1,1,1,13,1,1,1,1,1.75922E+13,0,0,0,0,0,0,0,0,0,0,1,0,0,0,0,0,0,0,0,1,0,0,0,0,0,0,0,0,0,0,0,0,0,0,0,0,0,0,0,0,0,0,0,0,1,0,0,0,Jose Baxter,- ,28,179,Midfielder - Central Midfield,right,Memphis 901 FC,16,5,3,1215,31,9,7,2558,45,15,8,3653,50,10,3,3495,48,13,4,3040,28,7,5,1852,nan,nan,nan,nan,10,0,2,629,34,4,2,1572,Premier League,20,2,2,1067,nan,nan,nan,nan
19/6/2011,Gökhan Töre,35017569,799,1/20/1992,19,0,0,2,0,4750,6400,6550,150,119,3812103,176,80,AM RLC,3,3,1,3,3,3,3,9,1,2,3,13,15,16,9,12,13,3,10,6,3,14,9,5,15,14,7,15,8,7,8,7,10,17,4,8,5,3,10,17,17,16,6,20,12,14,14,10,12,10,13,15,13,5,10,17,6,8,7,6,5,14,1,1,15,20,17,20,18,AM RLC,506,1,1,14,18,20,17,1,1,1,1,8,15,10,1,1,2.39312E+15,0,0,0,0,0,0,0,0,0,0,0,0,0,0,0,0,0,0,0,0,0,0,0,0,0,0,0,0,0,0,1,0,0,0,0,1,0,0,0,1,0,0,0,0,0,0,0,1,Gökhan Töre,£4.50m ,28,176,Forward - Right Winger,left,Besiktas JK,16,3,1,1374,24,0,6,1642,7,0,0,278,33,4,8,2329,43,9,11,3425,35,6,9,2164,8,0,1,449,1,0,0,8,8,0,1,210,Bundesliga,28,2,5,1792,3,1,0,141
19/6/2011,Gaël Kakuta,34001371,769,6/21/1991,19,0,0,0,0,5000,5400,6150,164,120,2062953,173,65,AM RLC,1,3,3,2,3,1,1,7,3,3,2,8,11,16,12,15,12,7,13,1,2,9,14,2,17,5,12,9,13,12,15,11,12,17,4,11,8,9,10,15,13,12,7,20,14,14,6,10,10,12,2,12,6,8,15,15,11,15,16,13,18,5,1,1,9,20,15,18,20,AM RLC,506,1,1,12,20,18,15,1,1,1,1,9,1,1,1,1,51539607808,0,0,0,0,0,0,0,0,1,0,0,0,0,0,0,0,0,0,0,0,0,0,0,0,0,0,0,0,0,0,0,0,0,0,1,1,0,0,0,0,0,0,0,0,0,0,0,0,Gaël Kakuta,£3.60m ,29,173,Midfielder - Attacking Midfield,left,RC Lens,21,1,1,742,24,6,1,1606,29,2,6,2335,20,4,0,679,35,5,7,3061,29,3,4,1679,10,2,1,542,38,6,6,3198,12,1,0,720,Premier League,24,2,5,2010,7,4,1,519
19/6/2011,Florian Trinks,92002691,771,3/11/1992,19,0,0,0,0,3250,5250,5750,143,108,1212135,185,74,M/AM RLC,2,2,1,2,3,2,1,4,2,2,3,13,14,16,10,14,16,6,14,6,4,11,12,5,14,13,10,7,8,7,12,6,5,15,3,14,5,7,11,14,13,7,10,13,12,12,20,10,9,8,14,13,10,13,9,18,8,12,6,3,5,18,1,1,17,20,19,19,20,M/AM RLC,526,1,1,13,20,19,19,1,1,1,5,17,15,15,1,1,0,0,0,0,0,0,0,0,0,0,0,0,0,0,0,0,0,0,0,0,0,0,0,0,0,0,0,0,0,0,0,0,0,0,0,0,0,0,0,0,0,0,0,0,0,0,0,0,0,Florian Trinks,£540Th. ,28,185,Midfielder - Attacking Midfield,right,Without Club,14,0,2,743,23,1,0,1593,22,4,9,1797,32,4,7,1626,20,1,0,932,17,1,2,773,13,4,2,879,10,1,1,529,24,9,4,1771,Bundesliga,nan,nan,nan,nan,nan,nan,nan,nan
19/6/2011,Christian Clemens,35014354,771,8/4/1991,19,0,0,1,0,4000,6100,6100,150,122,7122616,180,81,AM RL,2,1,1,1,1,2,3,1,1,1,2,12,13,12,8,12,11,8,10,10,7,12,10,8,13,14,8,9,9,10,10,8,11,12,7,13,7,10,12,15,14,13,9,10,9,16,20,14,9,7,7,9,9,13,13,12,14,8,12,11,12,5,1,5,15,20,20,17,11,AM RL,505,1,1,5,11,17,20,1,1,1,5,9,10,15,3,5,0,0,0,0,0,0,0,0,0,0,0,0,0,0,0,0,0,0,0,0,0,0,0,0,0,0,0,0,0,0,0,0,0,0,0,0,0,0,0,0,0,0,0,0,0,0,0,0,0,Christian Clemens,£2.70m ,29,179,Midfielder - Right Midfield,right,1. FC Köln,31,2,4,2048,33,5,3,2167,33,7,5,2563,18,0,2,885,19,1,0,753,29,6,5,1800,18,1,1,1222,20,2,1,914,21,2,7,1461,Bundesliga,1,0,0,15,2,0,0,154
19/6/2011,Alexander Merkel,35017440,771,2/22/1992,19,0,0,0,0,1922,5039,5533,142,112,292258,179,70,M/AM RC,2,2,1,1,3,2,1,1,1,3,1,13,14,10,8,12,14,9,12,7,4,13,8,5,14,9,13,11,9,11,14,10,14,9,7,14,7,9,11,13,14,9,9,11,14,15,20,11,8,12,7,7,8,16,17,14,15,11,15,18,16,10,1,1,20,17,16,12,20,M/AM RC,413,1,1,1,17,9,14,1,1,1,1,20,12,16,1,1,16,0,0,0,0,1,0,0,0,0,0,0,0,0,0,0,0,0,0,0,0,0,0,0,0,0,0,0,0,0,0,0,0,0,0,0,0,0,0,0,0,0,0,0,0,0,0,0,0,Alexander Merkel,£4.50m ,28,179,Midfielder - Central Midfield,right,Al-Faisaly Harmah,19,1,1,1132,17,0,3,1139,12,1,0,462,12,1,2,640,11,0,1,405,2,0,0,109,11,0,1,628,18,1,4,1247,36,0,2,2947,Serie A,28,2,4,2341,2,0,0,180
19/6/2011,Adrien Régattin,85044861,769,8/22/1991,19,0,0,0,0,3850,4859,4850,150,108,337724,166,67,M/AM RL,3,2,2,2,3,3,3,1,1,3,3,10,12,14,6,14,8,5,9,5,1,11,8,2,16,6,8,8,12,12,13,11,7,15,5,14,3,6,9,16,16,8,3,8,14,12,20,12,8,13,6,7,7,10,13,14,6,11,11,14,13,13,1,1,17,20,20,17,10,M/AM RL,525,1,1,1,10,17,20,1,1,1,1,10,17,15,1,1,2.2518E+15,0,0,0,0,0,0,0,0,0,0,0,0,0,0,0,0,0,0,0,0,0,0,0,0,0,0,0,0,0,0,0,0,0,0,0,0,0,0,0,0,0,0,0,0,0,0,0,0,Adrien Regattin,£900Th. ,29,168,Forward - Right Winger,right,Altay SK,4,0,0,50,23,2,6,1287,30,3,0,1337,23,1,1,1036,35,3,6,1795,40,2,5,1941,42,1,3,2838,35,6,2,2478,39,7,3,2350,Ligue 1,11,0,2,689,4,0,1,226
19/6/2011,Wilson Eduardo,55009688,788,7/8/1990,20,0,0,0,0,2526,5530,5500,142,116,396001,176,72,AM RL,1,1,3,1,3,3,2,9,2,1,3,12,13,13,13,13,10,9,13,6,7,10,13,8,13,11,14,9,14,9,10,11,11,14,8,13,8,9,9,14,13,9,10,11,13,13,20,11,12,10,6,10,10,11,7,10,13,10,14,14,15,5,1,1,9,20,20,17,10,AM RL,505,1,1,10,10,17,20,1,1,1,1,1,1,9,1,1,0,0,0,0,0,0,0,0,0,0,0,0,0,0,0,0,0,0,0,0,0,0,0,0,0,0,0,0,0,0,0,0,0,0,0,0,0,0,0,0,0,0,0,0,0,0,0,0,0,Wilson Eduardo,£1.71m ,30,179,Forward - Left Winger,right,Al-Ain FC,32,5,2,1511,30,7,2,2505,37,11,3,2817,24,5,7,1328,31,3,2,1796,31,6,1,1650,30,8,14,2233,21,8,3,1473,42,16,6,2914,Liga NOS,31,8,2,1352,1,1,0,90
19/6/2011,Victor Moses,5007466,38,12/12/1990,20,0,0,0,0,4500,6300,6700,144,130,2985205,180,75,AM RL,2,3,3,2,1,3,1,8,2,1,1,8,12,14,12,12,9,9,10,16,4,12,9,5,12,7,9,8,12,6,11,7,8,15,6,12,8,9,11,16,13,12,9,13,10,16,20,10,13,5,10,6,13,13,11,14,12,11,11,8,12,7,1,1,9,20,20,20,13,AM RL,505,1,1,13,13,20,20,1,1,1,1,1,9,1,1,1,34368127504,0,0,0,0,1,0,0,0,0,1,0,0,0,0,0,0,0,0,0,0,0,0,0,1,0,0,0,0,0,0,0,0,0,0,0,1,0,0,0,0,0,0,0,0,0,0,0,0,Victor Moses,£5.85m ,29,177,Midfielder - Right Midfield,right,Spartak Moscow,28,2,3,1231,39,6,6,3229,44,10,5,2480,22,2,0,853,23,4,6,1666,27,2,2,1333,40,4,4,3045,38,4,4,3038,22,4,1,1250,Premier League,27,1,6,1243,2,1,0,102
19/6/2011,Sören Bertram,91018461,771,6/5/1991,20,0,0,0,0,2250,5700,5700,135,114,1316822,183,70,M/AM RC,1,2,1,1,1,2,3,5,1,3,3,11,12,12,9,13,10,7,12,10,9,12,10,8,12,11,12,15,9,10,13,10,10,13,8,14,9,12,14,13,13,10,11,20,8,13,11,9,9,11,7,4,5,10,5,1,7,11,13,14,5,8,1,1,20,20,20,12,17,M/AM RC,413,1,1,1,1,1,20,1,1,1,14,17,12,20,1,1,0,0,0,0,0,0,0,0,0,0,0,0,0,0,0,0,0,0,0,0,0,0,0,0,0,0,0,0,0,0,0,0,0,0,0,0,0,0,0,0,0,0,0,0,0,0,0,0,0,Sören Bertram,£360Th. ,29,185,Forward - Left Winger,left,1.FC Magdeburg,19,2,0,790,25,6,6,2187,16,3,1,960,37,12,6,2925,30,3,11,2175,35,10,8,2983,8,0,0,217,25,7,1,1247,21,1,2,924,Bundesliga,35,10,4,2790,6,0,0,299
19/6/2011,Robert Mak,28018617,794,3/8/1991,20,0,0,11,0,4750,2500,6000,145,124,1697019,179,71,M/AM RL,1,1,3,1,1,2,1,3,2,3,1,7,10,11,13,11,8,7,9,5,4,9,10,6,11,9,11,12,12,9,10,9,10,11,8,15,8,11,13,16,13,11,8,16,14,15,20,14,11,8,8,12,6,11,15,13,7,10,7,7,10,4,1,1,18,20,20,18,1,M/AM RL,525,1,1,14,1,18,20,1,1,1,1,1,16,18,1,1,0,0,0,0,0,0,0,0,0,0,0,0,0,0,0,0,0,0,0,0,0,0,0,0,0,0,0,0,0,0,0,0,0,0,0,0,0,0,0,0,0,0,0,0,0,0,0,0,0,Robert Mak,£1.58m ,29,179,Forward - Left Winger,right,Ferencvárosi TC,22,3,1,789,21,4,3,1178,26,6,3,1462,20,0,2,879,35,8,5,2658,46,20,3,3760,27,6,5,1431,36,5,6,2121,35,6,5,2123,Bundesliga,14,2,3,423,4,0,2,129
19/6/2011,Peniel Mlapa,91012819,771,2/20/1991,20,0,0,7,0,4550,6350,6350,157,123,1112795,193,85,AM/S R,2,2,3,1,1,2,2,5,1,2,3,6,12,13,9,14,8,7,10,6,5,11,10,9,13,16,8,15,10,9,13,9,10,11,5,8,7,16,14,14,10,13,14,10,13,17,20,10,16,10,17,10,6,12,13,13,12,12,11,12,16,6,1,1,1,18,18,12,14,AM/S R,622,1,1,20,14,12,18,1,1,1,1,1,1,1,1,1,1.77298E+13,0,0,0,0,0,0,0,0,0,0,0,0,0,0,0,0,0,0,0,0,0,0,0,0,0,0,0,1,0,0,0,0,0,0,0,0,0,1,0,0,0,0,0,0,1,0,0,0,Peniel Mlapa,£2.70m ,29,193,Forward - Centre-Forward,right,Al Ittihad Kalba Sports Club,34,5,4,1820,31,1,1,1456,30,3,3,977,7,2,0,226,25,3,2,953,31,5,1,1176,33,8,3,2445,24,4,0,1086,32,15,3,2589,Bundesliga,18,11,1,1620,1,0,0,90
19/6/2011,Odhise Rroshi,11007620,752,5/22/1991,20,0,0,10,7,1610,5021,5550,145,111,445207,187,78,AM RC,3,2,3,3,2,3,2,1,1,3,2,6,9,10,10,10,7,12,10,10,5,9,11,6,10,11,10,7,9,8,10,9,12,10,11,11,7,10,10,16,14,10,13,7,9,17,20,9,10,10,10,10,10,11,11,11,13,13,10,10,10,9,3,8,15,20,20,10,15,AM RC,503,1,1,15,15,10,20,1,3,3,1,8,7,15,3,8,0,0,0,0,0,0,0,0,0,0,0,0,0,0,0,0,0,0,0,0,0,0,0,0,0,0,0,0,0,0,0,0,0,0,0,0,0,0,0,0,0,0,0,0,0,0,0,0,0,Odise Roshi,£900Th. ,29,187,Forward - Right Winger,right,Akhmat Grozny,22,5,0,1486,20,1,1,555,32,2,1,891,25,1,3,874,22,3,2,1422,25,2,1,636,21,1,7,1167,21,1,3,1265,13,0,0,594,Bundesliga,28,8,1,1983,6,2,0,250
19/6/2011,Michael Ortega,76014488,1653,4/6/1991,20,0,0,4,1,2000,4859,5000,150,108,281957,176,75,AM RC,3,2,2,2,1,2,1,1,3,2,2,7,12,13,11,12,8,7,11,6,6,13,10,6,14,6,11,11,12,12,13,11,7,11,10,11,12,13,12,13,11,12,7,10,12,12,20,12,11,10,7,10,12,10,7,6,13,7,10,8,5,8,1,1,9,20,20,1,20,AM RC,503,1,1,1,20,1,20,1,1,1,1,9,1,1,1,1,0,0,0,0,0,0,0,0,0,0,0,0,0,0,0,0,0,0,0,0,0,0,0,0,0,0,0,0,0,0,0,0,0,0,0,0,0,0,0,0,0,0,0,0,0,0,0,0,0,Michael Ortega,£900Th. ,29,172,Midfielder - Attacking Midfield,right,Without Club,17,1,1,1053,7,0,0,280,12,1,1,357,13,1,0,929,24,2,1,1275,7,0,0,135,2,0,0,173,11,2,1,721,25,6,3,2046,Bundesliga,14,2,0,982,nan,nan,nan,nan
19/6/2011,Mehdi Courgnaud,85081239,769,11/22/1990,20,0,0,0,0,1250,2550,2550,129,102,110857,182,65,AM R,1,2,3,1,2,3,1,1,1,2,1,8,10,14,9,12,7,7,10,6,3,11,9,2,14,9,10,8,11,11,11,9,10,13,6,11,5,8,9,15,13,13,10,5,14,14,20,12,9,13,9,10,6,10,7,19,12,10,15,10,10,7,1,1,14,20,20,12,1,AM R,502,1,1,14,1,12,20,1,1,1,1,1,12,14,1,1,2.2518E+15,0,0,0,0,0,0,0,0,0,0,0,0,0,0,0,0,0,0,0,0,0,0,0,0,0,0,0,0,0,0,0,0,0,0,0,0,0,0,0,0,0,0,0,0,0,0,0,0,Mehdi Courgnaud,£360Th. ,29,182,Forward - Right Winger,right,Avoine Olympique Chinon Cinais,4,1,0,76,20,0,3,846,nan,nan,nan,nan,14,2,0,989,8,1,0,497,nan,nan,nan,nan,nan,nan,nan,nan,nan,nan,nan,nan,nan,nan,nan,nan,Ligue 1,nan,nan,nan,nan,nan,nan,nan,nan
19/6/2011,Mathew Leckie,29065287,1435,2/4/1991,20,0,0,13,3,2523,5500,6000,154,116,614068,180,78,M/AM/S R,3,3,3,3,1,2,3,3,1,2,2,7,9,14,11,7,3,9,8,4,7,10,10,8,10,9,12,13,11,10,10,13,13,10,4,14,8,11,14,17,11,14,10,6,15,15,20,12,11,9,5,10,7,12,9,15,12,11,14,13,11,3,1,1,18,20,20,1,1,M/AM/S R,532,1,1,16,1,1,20,1,1,1,1,1,1,18,1,1,0,0,0,0,0,0,0,0,0,0,0,0,0,0,0,0,0,0,0,0,0,0,0,0,0,0,0,0,0,0,0,0,0,0,0,0,0,0,0,0,0,0,0,0,0,0,0,0,0,Mathew Leckie,£630Th. ,29,181,Forward - Right Winger,right,Hertha BSC,15,5,0,995,21,3,0,985,35,9,6,2212,33,12,9,2733,32,7,7,2583,32,3,0,2476,32,0,3,2327,29,6,3,2026,19,2,1,938,Bundesliga,10,0,0,383,3,0,2,128
19/6/2011,Mario Balotelli,43001238,776,8/12/1990,20,2,0,14,6,7000,8250,7250,178,150,8935695,189,88,AM/S RL,1,1,1,1,1,1,1,1,1,1,1,14,13,15,14,12,14,11,15,6,7,14,18,7,16,12,10,12,16,7,14,10,10,16,8,15,6,5,4,15,15,11,13,12,14,16,20,13,15,9,17,14,8,15,5,14,3,8,3,3,3,19,1,1,8,16,16,15,11,AM/S RL,625,1,1,20,11,15,16,1,1,1,1,1,8,8,1,1,34359935232,0,0,0,0,0,0,0,0,1,0,0,0,0,0,0,0,1,1,0,0,0,0,0,0,0,0,0,0,0,0,0,0,0,0,0,1,0,0,0,0,0,0,0,0,0,0,0,0,Mario Balotelli,£28.80m ,30,189,Forward - Centre-Forward,right,Without Club,28,10,2,1712,32,17,2,1881,33,15,3,1964,41,18,8,3161,28,4,0,1510,23,3,1,994,28,17,0,2106,38,26,2,3043,25,8,1,1699,Premier League,19,5,0,1409,nan,nan,nan,nan
19/6/2011,Lukas Rupp,91012163,771,1/8/1991,20,0,0,0,0,1500,5400,5400,132,108,243145,179,67,M/AM RC,3,3,3,1,3,2,1,5,1,2,2,9,9,13,10,14,10,6,12,3,4,15,12,4,14,8,12,11,13,11,15,9,13,12,9,14,7,13,9,13,14,9,10,6,12,12,20,14,7,11,6,9,6,8,9,12,9,10,14,14,12,7,1,1,16,20,18,14,20,M/AM RC,523,1,1,10,20,14,18,1,1,1,6,15,12,16,1,1,8.81328E+12,0,0,0,0,0,0,0,1,0,0,0,0,0,0,0,0,0,0,0,0,0,0,1,0,0,0,0,0,0,0,0,0,0,0,1,0,0,0,0,0,0,0,0,1,0,0,0,0,Lukas Rupp,£900Th. ,29,178,Midfielder - Central Midfield,right,Norwich City,27,4,0,1561,26,4,6,1605,28,0,4,1652,15,1,0,394,32,4,2,2050,32,6,6,2324,17,3,0,955,25,3,3,1466,4,0,3,238,Bundesliga,24,0,0,1319,7,0,0,527
19/6/2011,Jonathan Schmid,91016490,769,6/26/1990,20,0,0,0,0,504,4454,3768,124,99,174540,179,75,AM R,1,3,2,1,3,2,3,1,1,1,3,11,13,10,8,8,9,9,8,5,9,9,9,13,11,12,10,10,7,11,9,10,10,15,13,10,7,16,13,13,13,11,9,10,14,13,20,9,3,10,10,10,6,10,8,13,6,14,11,10,12,12,15,9,15,20,20,1,1,AM R,502,1,1,1,1,1,20,1,1,15,10,1,1,15,1,9,0,0,0,0,0,0,0,0,0,0,0,0,0,0,0,0,0,0,0,0,0,0,0,0,0,0,0,0,0,0,0,0,0,0,0,0,0,0,0,0,0,0,0,0,0,0,0,0,0,Jonathan Schmid,£1.35m ,30,180,Defender - Right-Back,right,SC Freiburg,32,8,7,2543,34,5,9,2924,38,12,6,3367,33,4,11,2831,37,5,13,3120,24,4,0,1543,26,1,3,1729,26,0,0,1557,29,3,7,2640,Bundesliga,35,5,2,3050,6,1,0,518
19/6/2011,Joel Acosta,14009499,1649,1/16/1991,20,0,0,0,0,2011,4049,3123,158,90,97821,177,76,AM/S RC,3,1,2,3,1,3,3,2,3,1,1,9,9,14,11,8,8,7,10,4,4,10,10,5,12,14,8,10,10,9,10,10,10,14,8,10,6,9,8,15,11,9,8,6,11,13,20,12,11,12,8,10,10,14,16,11,8,8,9,8,9,11,1,1,10,20,15,1,20,AM/S RC,513,1,1,17,20,1,15,1,1,1,1,9,1,10,1,1,0,0,0,0,0,0,0,0,0,0,0,0,0,0,0,0,0,0,0,0,0,0,0,0,0,0,0,0,0,0,0,0,0,0,0,0,0,0,0,0,0,0,0,0,0,0,0,0,0,Joel Acosta,£540Th. ,29,176,Forward - Right Winger,right,Liverpool FC Montevideo,1,0,0,2,15,3,0,1308,6,0,0,486,8,0,0,430,27,1,1,1563,11,1,1,321,29,3,2,1946,15,5,3,1162,22,0,0,1153,Serie A,2,0,0,64,nan,nan,nan,nan
19/6/2011,Jean Pierre Barrientos,78035213,1657,9/16/1990,20,0,0,0,0,2750,5624,5400,143,125,1658973,178,74,AM/S R,2,1,3,3,2,2,3,5,3,2,3,14,14,14,12,10,13,10,12,10,7,13,13,7,14,13,11,9,12,9,12,10,14,14,6,13,8,8,10,14,14,9,8,12,12,14,20,14,10,11,7,12,12,15,12,11,13,10,11,12,12,3,1,1,9,20,20,14,8,AM/S R,512,1,1,18,8,14,20,1,1,1,1,1,1,9,1,1,0,0,0,0,0,0,0,0,0,0,0,0,0,0,0,0,0,0,0,0,0,0,0,0,0,0,0,0,0,0,0,0,0,0,0,0,0,0,0,0,0,0,0,0,0,0,0,0,0,Jean Barrientos,£1.17m ,30,174,Midfielder - Attacking Midfield,right,Volos NPS,28,9,0,2391,34,1,2,1794,25,4,0,1345,34,3,3,2373,25,1,1,1359,34,5,3,2256,27,1,1,1646,22,4,1,932,16,0,1,1127,Liga NOS,27,3,1,1459,6,2,1,443
19/6/2011,James McCarthy,61002273,789,11/12/1990,20,3,0,6,1,4250,6000,6350,156,132,2942728,181,63,DM/M RC,1,2,3,3,2,3,1,2,1,3,2,12,12,14,14,14,5,11,13,4,7,16,8,11,17,12,14,13,14,7,12,13,10,12,5,15,11,13,14,14,12,10,8,10,14,13,20,16,5,11,8,14,5,10,12,5,18,14,15,1,10,17,1,1,20,13,15,1,20,DM/M RC,423,1,1,1,13,1,1,1,1,1,17,20,1,15,1,1,51539609760,0,0,0,0,0,1,0,1,0,0,0,1,0,0,0,0,0,0,0,0,0,0,0,0,0,0,0,0,0,0,0,0,0,0,1,1,0,0,0,0,0,0,0,0,0,0,0,0,James McCarthy,£4.95m ,29,180,Midfielder - Central Midfield,right,Crystal Palace,27,3,2,2044,34,0,3,2973,42,3,2,3645,45,1,3,3841,37,2,3,2936,37,2,2,3045,13,1,2,678,6,0,0,356,2,0,0,104,Premier League,35,0,0,1847,4,0,0,319
19/6/2011,Gilles Sunu,34003025,769,3/30/1991,20,0,0,0,0,4000,5000,5000,136,111,329031,181,75,AM/S R,3,3,3,2,1,2,2,3,3,3,3,5,7,13,10,13,7,9,11,5,3,11,10,3,15,5,10,9,10,7,12,9,14,14,7,11,6,10,10,15,13,13,9,10,12,14,20,8,13,11,5,15,10,8,11,15,16,13,14,14,14,7,1,1,12,18,18,12,14,AM/S R,622,1,1,20,14,12,18,1,1,1,1,10,12,12,1,1,2.2518E+15,0,0,0,0,0,0,0,0,0,0,0,0,0,0,0,0,0,0,0,0,0,0,0,0,0,0,0,0,0,0,0,0,0,0,0,0,0,0,0,0,0,0,0,0,0,0,0,0,Gilles Sunu,£1.35m ,29,181,Forward - Centre-Forward,right,LB ChÃ¢teauroux,17,2,3,793,18,2,2,974,22,4,0,590,20,1,1,776,28,4,2,1679,35,2,1,2584,27,0,0,964,23,1,1,842,28,4,2,1951,Premier League,14,3,1,712,8,1,1,592
19/6/2011,Franco Zuculini,14006042,1649,9/5/1990,20,1,0,9,0,3900,6750,6250,144,123,476360,176,70,DM/M RC,2,2,2,3,1,3,2,6,1,3,2,6,10,12,6,15,6,8,7,12,18,14,8,12,14,18,7,19,7,9,10,8,18,9,11,10,7,15,19,17,15,14,7,8,12,13,20,18,12,9,14,12,6,12,2,9,12,10,7,9,7,14,1,1,20,1,15,14,20,DM/M RC,423,1,1,1,1,1,1,1,1,1,18,20,14,15,1,1,1.37439E+11,0,0,0,0,0,0,0,0,0,0,0,0,0,0,0,1,0,0,0,0,0,0,0,0,0,0,0,0,0,0,0,0,0,0,0,0,0,1,0,0,0,0,0,0,0,0,0,0,Franco Zuculini,£2.70m ,30,176,Midfielder - Central Midfield,right,Defensor Sporting Club,23,0,1,1145,23,0,3,1161,20,2,1,1190,19,0,1,857,28,3,6,1805,3,1,0,174,16,1,1,565,14,0,0,592,20,0,0,1117,LaLiga,21,1,2,1239,nan,nan,nan,nan
19/6/2011,Ezequiel,67131753,796,1/12/1991,20,0,0,0,0,3600,6100,6100,155,122,273193,168,60,M/AM RLC,1,2,1,1,1,2,2,3,2,3,1,10,11,15,7,14,6,4,6,2,2,13,16,5,17,6,13,12,12,10,14,8,12,18,5,13,7,8,12,16,16,7,3,12,14,15,20,10,4,10,3,13,5,18,8,16,13,15,12,13,12,6,1,1,16,20,19,20,19,M/AM RLC,526,1,1,1,19,20,19,1,1,1,1,1,16,1,1,1,7.09529E+13,0,0,0,0,0,0,0,0,0,0,0,0,0,0,0,0,0,0,0,0,0,0,0,0,0,0,0,0,0,0,0,0,0,0,0,1,0,0,0,1,0,0,0,0,0,0,1,0,,,,,,,,,,,,,,,,,,,,,,,,,,,,,,,,,,,,,,,,,,,,,,,,,,,,
19/6/2011,Diego Fabbrini,1414266,776,7/31/1990,20,0,0,11,1,2075,5501,5501,162,117,313457,181,66,AM/S RLC,1,1,1,3,2,3,3,2,1,3,2,7,10,12,8,13,9,10,9,4,3,13,9,3,12,9,11,9,11,11,11,10,10,16,13,10,9,10,14,13,13,13,9,12,14,13,20,10,9,11,12,10,13,10,8,12,8,9,7,11,12,18,1,1,10,20,20,18,18,AM/S RLC,516,1,1,18,18,18,20,1,1,1,1,5,10,10,1,1,0,0,0,0,0,0,0,0,0,0,0,0,0,0,0,0,0,0,0,0,0,0,0,0,0,0,0,0,0,0,0,0,0,0,0,0,0,0,0,0,0,0,0,0,0,0,0,0,0,Diego Fabbrini,£2.70m ,30,181,Midfielder - Attacking Midfield,right,Dinamo Bucharest,28,2,0,1783,25,2,2,1152,22,2,1,1255,35,2,3,1638,21,1,2,1486,40,6,4,2238,27,1,0,1543,17,1,0,802,32,5,5,2513,Serie A,30,1,2,1952,7,0,1,332
19/6/2011,Caetano,55013009,788,4/20/1991,20,0,0,0,0,1109,4724,5250,129,105,575533,165,57,AM/S R,2,2,1,2,3,1,3,1,1,2,1,10,11,12,12,11,6,5,9,7,6,9,11,6,12,15,12,14,10,11,10,10,15,13,8,13,7,15,16,13,13,5,5,12,12,13,20,6,5,11,6,10,8,12,13,13,15,15,15,15,15,6,1,1,1,17,17,13,1,AM/S R,622,1,1,20,1,13,17,1,1,1,1,1,1,1,1,1,0,0,0,0,0,0,0,0,0,0,0,0,0,0,0,0,0,0,0,0,0,0,0,0,0,0,0,0,0,0,0,0,0,0,0,0,0,0,0,0,0,0,0,0,0,0,0,0,0,Caetano,£1.35m ,29,165,Midfielder - Attacking Midfield,left,Varzim SC,16,1,2,661,23,1,0,864,34,3,1,1010,29,2,2,1509,27,2,2,1498,40,1,2,2831,25,1,2,973,19,1,0,580,19,4,0,592,Liga NOS,8,0,0,285,2,0,0,14
19/6/2011,André Carrillo,77012583,1656,6/14/1991,20,2,0,9,2,1500,5750,5250,145,115,1296291,181,68,AM/S R,2,2,2,2,3,1,1,3,2,3,1,8,11,12,7,6,7,7,6,9,5,10,11,5,11,5,7,9,5,7,6,7,12,14,6,11,5,14,12,16,13,8,11,13,9,16,20,13,8,13,5,12,7,15,13,16,13,12,14,15,8,2,1,1,5,20,20,7,7,AM/S R,512,1,1,18,7,7,20,1,1,1,1,1,1,5,1,1,0,0,0,0,0,0,0,0,0,0,0,0,0,0,0,0,0,0,0,0,0,0,0,0,0,0,0,0,0,0,0,0,0,0,0,0,0,0,0,0,0,0,0,0,0,0,0,0,0,André Carrillo,£3.33m ,29,180,Forward - Right Winger,right,Al-Hilal Riyadh,9,3,1,411,46,3,9,2454,31,3,4,1778,32,2,5,1740,46,7,18,3091,7,1,3,609,32,3,3,1250,30,2,2,1662,33,6,8,2787,Liga NOS,35,6,7,2432,1,1,0,90
19/6/2011,Anderson Melo,19132613,1651,8/14/1990,20,0,0,0,0,1500,5250,5250,124,105,11455,179,69,AM/S RC,3,1,1,3,3,1,3,1,3,2,3,9,6,13,13,13,9,13,13,5,4,10,9,6,13,7,12,3,13,9,10,10,6,12,7,13,6,10,9,13,10,7,10,11,16,12,20,7,5,11,5,10,5,10,9,15,11,7,10,4,6,11,1,1,10,20,19,1,20,AM/S RC,513,1,1,18,20,1,19,1,1,1,1,10,1,10,1,1,0,0,0,0,0,0,0,0,0,0,0,0,0,0,0,0,0,0,0,0,0,0,0,0,0,0,0,0,0,0,0,0,0,0,0,0,0,0,0,0,0,0,0,0,0,0,0,0,0,Uanderson Melo,£180Th. ,30,179,Forward - Centre-Forward,right,Grêmio Esportivo Anápolis (GO),nan,nan,nan,nan,3,0,0,95,nan,nan,nan,nan,nan,nan,nan,nan,nan,nan,nan,nan,nan,nan,nan,nan,nan,nan,nan,nan,nan,nan,nan,nan,nan,nan,nan,nan,Liga NOS,nan,nan,nan,nan,nan,nan,nan,nan
19/6/2011,Alexandre Lacazette,34011687,769,5/28/1991,20,0,0,0,0,1645,5241,5219,160,116,318188,174,69,S R,1,1,1,3,3,2,3,4,2,3,3,6,8,14,11,12,8,6,10,5,2,9,12,2,14,7,10,7,13,13,11,11,14,14,6,13,5,6,8,18,15,12,7,5,15,16,20,11,9,14,7,8,8,6,9,16,17,16,14,14,14,5,1,1,10,15,15,1,1,S R,602,1,1,20,1,1,15,1,1,1,1,1,1,10,1,1,2,0,1,0,0,0,0,0,0,0,0,0,0,0,0,0,0,0,0,0,0,0,0,0,0,0,0,0,0,0,0,0,0,0,0,0,0,0,0,0,0,0,0,0,0,0,0,0,0,Alexandre Lacazette,£5.40m ,29,176,Forward - Centre-Forward,right,Arsenal FC,11,2,2,185,43,10,6,2206,37,4,10,2756,54,22,8,4409,40,31,8,3468,44,23,4,3743,45,37,5,3477,39,17,5,2758,49,19,13,3327,Ligue 1,39,12,7,2581,7,3,0,440
19/6/2011,Alexander Zahavi,67022043,775,1/21/1991,20,0,0,5,1,2250,5000,5000,125,103,48868,173,69,AM RL,3,3,1,1,1,2,2,2,2,1,1,11,11,14,13,14,12,8,13,5,5,13,10,5,13,8,11,9,10,7,10,7,14,12,7,9,7,8,15,13,10,9,6,14,11,12,20,7,5,7,9,7,12,8,12,17,9,11,16,13,8,6,1,1,10,20,17,20,10,AM RL,505,1,1,15,10,20,17,1,1,1,1,10,10,10,1,1,5.49756E+11,0,0,0,0,0,0,0,0,0,0,0,0,0,0,0,0,0,0,0,0,0,0,0,0,0,0,0,0,0,0,0,0,0,0,0,0,0,0,0,1,0,0,0,0,0,0,0,0,Alex Zahavi,£180Th. ,29,175,Forward - Right Winger,right,Retired,10,0,0,267,1,0,0,10,nan,nan,nan,nan,nan,nan,nan,nan,nan,nan,nan,nan,nan,nan,nan,nan,nan,nan,nan,nan,nan,nan,nan,nan,nan,nan,nan,nan,Liga NOS,nan,nan,nan,nan,nan,nan,nan,nan
19/6/2011,Alberto Perea,67120790,796,12/19/1990,20,0,0,0,0,1801,4550,4550,130,96,323541,177,68,M/AM RL,3,1,2,2,1,3,3,7,1,1,3,10,11,14,12,11,8,8,12,8,10,11,7,4,10,17,13,2,11,11,11,8,6,13,8,10,10,16,11,12,13,13,7,5,15,13,20,9,4,9,10,10,11,10,5,8,7,7,11,13,6,6,1,1,16,20,20,15,6,M/AM RL,525,1,1,1,6,15,20,1,1,1,1,1,10,16,1,1,0,0,0,0,0,0,0,0,0,0,0,0,0,0,0,0,0,0,0,0,0,0,0,0,0,0,0,0,0,0,0,0,0,0,0,0,0,0,0,0,0,0,0,0,0,0,0,0,0,Alberto Perea,£270Th. ,29,175,Forward - Left Winger,right,Cádiz CF,26,0,0,1663,21,5,0,1528,24,7,0,1547,10,1,0,554,20,1,0,777,31,11,4,2248,38,10,8,2540,23,2,1,1069,28,1,1,1675,LaLiga,33,5,2,2225,2,0,0,46
19/6/2011,Yoric Ravet,85033191,769,9/12/1989,21,0,0,0,0,4150,5219,5200,140,115,430813,178,74,AM RL,1,1,1,1,2,2,1,3,2,3,1,7,10,14,10,13,12,9,13,6,4,10,11,4,14,8,12,10,12,11,11,10,14,14,6,13,6,9,12,16,13,12,9,20,13,14,5,12,12,12,8,13,9,8,10,16,15,11,9,13,13,12,1,1,14,20,17,20,12,AM RL,505,1,1,12,12,20,17,1,1,1,1,1,14,14,1,1,2097152,0,0,0,0,0,0,0,0,0,0,0,0,0,0,0,0,0,0,0,0,0,1,0,0,0,0,0,0,0,0,0,0,0,0,0,0,0,0,0,0,0,0,0,0,0,0,0,0,Yoric Ravet,£450Th. ,31,178,Forward - Right Winger,right,Grenoble Foot 38,21,3,2,1183,2,0,0,67,31,3,3,1570,32,9,10,2604,43,10,8,3035,38,13,17,3135,44,10,20,3438,20,2,7,1181,21,3,1,1413,Ligue 1,0,0,0,0,7,1,2,599
19/6/2011,Yohan Mollo,34001050,769,7/18/1989,21,0,0,7,0,4650,5894,5850,165,131,316205,175,74,M/AM RL,1,1,1,3,2,3,3,2,3,3,2,13,12,15,7,15,13,8,12,5,3,12,10,3,17,12,11,10,11,10,13,8,15,16,6,13,5,10,9,17,15,12,7,10,13,14,20,14,12,11,10,14,9,8,14,17,8,12,14,12,12,15,1,1,17,20,17,20,10,M/AM RL,525,1,1,10,10,20,17,1,1,1,1,1,17,14,1,1,2.25183E+15,0,0,0,0,0,0,0,0,0,0,0,0,0,0,1,0,0,0,0,0,0,0,0,0,0,0,0,0,0,0,0,0,0,0,0,1,0,0,0,0,0,0,0,0,0,0,0,0,Yohan Mollo,£2.70m ,31,175,Forward - Left Winger,right,Panathinaikos Athens,38,4,2,2547,26,3,6,1769,43,7,13,2779,21,1,3,1119,31,4,3,1765,28,0,7,2231,20,6,4,1317,12,0,2,692,23,2,4,1570,LaLiga,12,1,4,678,1,0,0,22
19/6/2011,Yacine Brahimi,34002647,769,2/8/1990,21,0,0,5,1,4350,5450,5450,160,121,276095,175,65,AM RLC,2,1,1,1,3,2,1,5,2,1,1,12,12,15,7,16,13,5,10,5,1,13,12,2,16,6,10,7,13,11,14,10,13,16,7,13,5,7,10,16,15,12,7,10,15,13,20,14,7,13,6,14,6,8,8,16,14,11,12,14,14,8,1,1,15,20,18,18,20,AM RLC,506,1,1,1,20,18,18,1,1,1,1,15,12,12,1,1,2.25183E+15,0,0,0,0,0,0,0,0,0,0,0,0,0,0,0,0,0,0,0,0,1,0,0,0,0,0,0,0,0,0,0,0,0,0,0,1,0,0,0,0,0,0,0,0,0,0,0,0,Yacine Brahimi,£2.70m ,30,175,Forward - Left Winger,right,Al-Rayyan SC,26,6,3,1509,28,3,2,1130,28,0,2,1916,36,3,3,2858,42,13,10,2835,44,9,10,3245,31,7,4,1927,49,12,10,3914,49,13,9,3429,Ligue 1,23,15,5,2040,3,1,1,270
19/6/2011,Vladimir Weiss,4001874,794,11/30/1989,21,18,1,7,0,5300,6800,6800,169,131,1475550,176,69,M/AM RLC,1,3,2,3,2,3,1,2,2,2,1,13,14,15,12,15,13,3,12,3,3,13,9,5,15,9,15,10,11,11,15,10,15,15,7,15,5,11,11,16,15,16,6,4,13,15,20,14,9,12,8,13,7,13,15,14,9,14,14,9,15,7,1,1,17,20,20,17,15,M/AM RLC,526,1,1,7,15,14,20,1,1,1,1,15,17,15,1,1,7.04206E+13,0,1,0,0,0,0,0,0,0,0,0,0,0,0,0,0,0,0,0,0,0,0,0,0,0,0,0,0,1,0,0,0,0,0,1,1,0,0,0,0,0,0,0,0,0,0,1,0,Vladimir Weiss,£3.15m ,30,173,Forward - Left Winger,right,Slovan Bratislava,35,5,15,1858,33,4,5,2146,23,5,5,1492,39,11,10,2585,31,10,7,2060,24,10,5,1882,21,10,4,1821,7,5,1,500,20,8,2,1431,LaLiga,8,1,0,292,6,0,2,188
19/6/2011,Vincent Acapandié,8438696,769,2/9/1990,21,0,0,0,0,1416,4769,2877,140,106,92392,180,81,D/WB R,1,2,2,2,3,3,2,3,1,2,1,6,9,10,8,11,7,7,12,7,11,8,10,12,10,12,14,13,10,9,8,8,14,12,6,12,9,12,13,16,10,14,10,10,14,14,20,14,15,12,10,13,12,16,8,13,15,11,15,14,14,6,20,17,15,10,20,1,7,D/WB R,112,1,1,10,1,1,10,7,1,20,1,1,1,15,1,17,514,0,1,0,0,0,0,0,0,0,1,0,0,0,0,0,0,0,0,0,0,0,0,0,0,0,0,0,0,0,0,0,0,0,0,0,0,0,0,0,0,0,0,0,0,0,0,0,0,Vincent Acapandié,£360Th. ,30,180,Defender - Right-Back,right,AS Excelsior de St Joseph,1,0,0,0,17,0,4,1124,10,1,0,331,nan,nan,nan,nan,nan,nan,nan,nan,nan,nan,nan,nan,1,0,0,90,nan,nan,nan,nan,nan,nan,nan,nan,Ligue 1,nan,nan,nan,nan,nan,nan,nan,nan
19/6/2011,Víctor Ibarbo,76007685,1653,5/19/1990,21,1,0,9,0,4750,5250,5000,147,114,469433,186,72,AM R,2,2,2,1,2,1,2,7,3,3,1,11,12,12,10,12,11,14,12,7,6,12,8,7,12,14,11,11,11,10,11,10,9,15,11,12,12,10,12,13,11,11,14,20,15,14,11,12,12,7,9,10,13,14,11,12,13,9,11,10,12,12,1,1,14,20,20,14,10,AM R,502,1,1,10,10,10,20,1,1,1,1,10,14,14,1,1,0,0,0,0,0,0,0,0,0,0,0,0,0,0,0,0,0,0,0,0,0,0,0,0,0,0,0,0,0,0,0,0,0,0,0,0,0,0,0,0,0,0,0,0,0,0,0,0,0,Víctor Ibarbo,£2.70m ,30,188,Forward - Second Striker,right,V-Varen Nagasaki,22,2,1,1402,39,3,5,1913,37,6,3,2259,32,4,3,2182,25,2,6,1766,17,2,3,838,51,9,11,3525,9,4,1,568,22,3,3,691,Serie A,20,2,4,764,nan,nan,nan,nan
19/6/2011,Urreta,78016324,1657,3/19/1990,21,0,0,6,2,4000,5950,5750,143,127,354720,174,62,AM RL,3,1,2,1,1,2,3,1,2,1,2,13,13,13,11,10,13,7,9,7,4,10,13,4,13,12,9,7,9,5,11,8,12,15,9,12,4,8,6,17,15,6,5,10,14,14,20,13,3,8,9,10,9,13,11,15,5,10,10,8,14,13,1,1,11,20,20,16,10,AM RL,505,1,1,15,10,16,20,1,1,1,1,1,7,11,1,1,1.41837E+14,0,0,0,0,1,0,0,0,0,0,0,0,0,0,0,0,0,0,0,0,0,0,0,0,0,0,0,1,0,0,0,0,0,0,0,0,0,0,0,0,1,0,0,0,0,0,0,1,,,,,,,,,,,,,,,,,,,,,,,,,,,,,,,,,,,,,,,,,,,,,,,,,,,,
19/6/2011,Tunay Torun,35018672,799,4/21/1990,21,1,0,5,0,3750,5750,5950,142,109,473144,179,72,AM/S RLC,2,3,2,2,2,1,2,6,2,2,2,10,9,14,11,14,8,6,7,4,4,13,7,6,15,8,10,5,11,8,12,10,10,14,4,12,6,7,8,14,13,9,8,20,11,12,10,9,11,5,11,4,10,10,14,17,9,9,10,5,7,2,1,1,14,20,16,15,20,AM/S RLC,516,1,1,17,20,15,16,1,1,1,1,10,10,14,1,1,0,0,0,0,0,0,0,0,0,0,0,0,0,0,0,0,0,0,0,0,0,0,0,0,0,0,0,0,0,0,0,0,0,0,0,0,0,0,0,0,0,0,0,0,0,0,0,0,0,Tunay Torun,£1.13m ,30,176,Forward - Right Winger,right,Caykur Rizespor,10,3,2,645,25,5,0,1214,16,1,1,723,17,3,1,550,31,5,9,2287,32,2,6,1874,29,3,7,2041,11,0,1,554,26,0,2,1316,Bundesliga,9,1,0,426,3,0,0,79
19/6/2011,Tom Cleverley,28000906,765,8/12/1989,21,0,0,16,0,4850,7100,7100,160,136,3081614,175,67,M/AM RLC,2,2,2,2,2,2,2,2,2,2,2,11,15,13,13,14,6,9,14,9,9,14,4,10,14,13,13,13,14,10,10,10,18,12,9,14,9,15,15,14,11,12,8,13,15,14,20,14,11,14,10,10,9,16,7,11,14,16,16,12,12,2,1,1,19,20,18,18,20,M/AM RLC,526,1,1,1,20,18,17,1,1,1,1,19,18,18,1,1,2.2518E+15,0,0,0,1,0,1,0,0,0,0,0,0,0,0,0,0,0,0,0,0,0,0,0,0,0,0,0,0,1,0,0,0,0,0,0,0,0,0,0,0,0,0,0,0,0,0,0,0,Tom Cleverley,£7.65m ,31,175,Midfielder - Central Midfield,right,Watford FC,25,4,2,1632,17,0,4,944,33,4,4,2353,31,1,1,2227,38,3,0,3098,30,2,6,2319,29,0,3,1958,25,1,3,2008,17,1,1,662,Premier League,19,1,0,1000,7,1,0,506
19/6/2011,Timothy Chandler,91001071,390,3/29/1990,21,2,0,0,0,5400,6000,6500,148,130,907484,186,80,D/WB/M R,2,3,2,2,1,1,1,4,2,3,2,8,14,12,8,13,7,9,6,10,12,11,6,11,13,14,9,13,8,10,9,11,15,9,7,14,11,14,15,16,14,12,13,8,13,17,20,16,13,13,7,9,7,15,7,14,10,13,16,15,14,6,20,19,18,15,20,4,11,D/WB/M R,122,1,1,8,1,1,15,1,4,20,14,11,1,18,1,19,0,0,0,0,0,0,0,0,0,0,0,0,0,0,0,0,0,0,0,0,0,0,0,0,0,0,0,0,0,0,0,0,0,0,0,0,0,0,0,0,0,0,0,0,0,0,0,0,0,Timothy Chandler,£4.05m ,30,186,Defender - Right-Back,right,Eintracht Frankfurt,32,5,3,2507,33,1,3,2785,31,1,3,2646,22,1,2,1715,29,1,2,2332,14,0,1,820,38,0,6,3237,25,3,4,1983,1,0,0,16,Bundesliga,33,5,1,1575,4,0,0,66
19/6/2011,Thomas Müller,35011448,771,9/13/1989,21,18,7,6,1,7250,8700,8700,172,164,36363636,186,74,AM RLC,3,3,1,1,3,1,2,8,3,3,1,7,10,11,14,13,7,12,9,8,7,12,11,8,12,15,18,12,17,13,15,18,18,16,7,19,10,18,17,16,14,17,13,11,18,14,20,17,11,12,9,16,7,18,4,12,17,18,14,12,17,4,1,1,14,20,19,16,20,AM RLC,506,1,1,15,20,16,19,1,1,1,1,10,14,14,1,1,1573936,0,0,0,0,1,1,0,0,0,0,1,0,0,0,0,0,0,0,0,1,1,0,0,0,0,0,0,0,0,0,0,0,0,0,0,0,0,0,0,0,0,0,0,0,0,0,0,0,Thomas MÃ¼ller,£28.80m ,31,186,Forward - Second Striker,right,Bayern Munich,48,19,19,3942,53,11,20,3913,47,23,17,3571,51,26,14,3575,48,21,18,3579,49,32,12,3820,42,9,17,3004,45,15,18,3125,45,9,16,3251,Bundesliga,50,14,26,3499,9,5,5,775
19/6/2011,Ryad Boudebouz,8449112,5,2/19/1990,21,8,0,0,0,5533,6820,6136,160,137,4385735,172,59,AM RL,1,2,1,2,2,2,3,3,2,2,3,13,12,16,9,16,14,5,14,5,1,14,15,4,18,8,11,7,13,12,13,11,14,16,5,15,5,8,9,17,15,12,6,20,16,13,10,14,6,11,8,15,8,10,10,16,13,11,9,12,12,13,1,1,10,20,20,17,12,AM RL,505,1,1,1,12,17,20,1,1,1,8,10,10,10,1,1,2.25238E+15,0,0,0,0,0,0,0,0,0,0,0,0,0,0,0,0,0,0,0,0,0,0,0,0,0,0,0,0,0,0,0,0,0,0,0,1,0,0,0,1,0,0,0,0,0,0,0,0,Ryad Boudebouz,£6.30m ,30,177,Midfielder - Attacking Midfield,left,AS Saint-Étienne,40,8,8,3423,40,6,5,3405,35,5,7,2681,37,4,6,2884,38,5,3,3217,39,2,12,3277,34,11,10,3015,29,3,3,1516,23,1,2,1340,Ligue 1,30,2,4,1911,nan,nan,nan,nan
19/6/2011,Rodney Strasser,43037061,43,3/30/1990,21,3,0,0,0,1500,5264,5400,141,117,96929,178,80,DM/M RC,2,3,2,3,1,2,2,3,2,3,1,4,6,7,8,9,5,12,9,15,14,11,8,14,11,17,12,14,13,12,12,12,16,4,6,9,15,14,14,13,13,15,10,7,15,14,20,13,15,13,16,7,8,12,17,14,15,12,14,15,16,4,1,1,20,1,15,12,20,DM/M RC,423,1,1,1,1,1,1,1,1,1,17,20,12,15,1,1,0,0,0,0,0,0,0,0,0,0,0,0,0,0,0,0,0,0,0,0,0,0,0,0,0,0,0,0,0,0,0,0,0,0,0,0,0,0,0,0,0,0,0,0,0,0,0,0,0,Rodney Strasser,£1.80m ,30,181,Midfielder - Defensive Midfield,right,Turun Palloseura,8,1,0,463,15,1,0,970,4,0,0,166,22,0,0,1684,2,0,0,61,28,1,1,2259,13,0,0,911,nan,nan,nan,nan,14,0,1,1106,Serie A,9,0,0,515,nan,nan,nan,nan
19/6/2011,Rasmus Jönsson,68007433,797,1/27/1990,21,0,0,9,2,6000,6000,6000,158,122,3087894,191,67,AM/S R,2,1,3,3,2,2,2,2,2,3,3,6,11,12,13,14,6,9,8,4,5,13,8,6,14,5,14,7,14,15,15,14,11,11,8,14,8,12,12,12,13,9,15,7,14,15,20,12,7,15,5,11,3,6,9,10,17,13,16,15,17,4,1,1,14,16,16,12,10,AM/S R,622,1,1,20,10,12,16,1,1,1,1,1,8,14,1,1,1.75922E+13,0,0,0,0,1,0,0,0,0,0,0,0,0,0,0,0,0,0,0,0,0,0,0,0,0,0,0,0,0,0,0,0,0,0,0,0,0,0,0,0,0,0,0,0,1,0,0,0,Rasmus Jönsson,£2.03m ,30,192,Forward - Centre-Forward,right,Helsingborgs IF,25,10,4,2167,15,1,1,710,12,1,0,404,20,6,6,1299,16,1,0,822,36,4,4,2403,38,13,4,2887,37,5,5,2624,16,4,0,1253,Bundesliga,23,3,0,1542,nan,nan,nan,nan
19/6/2011,Pizzi,55012829,788,10/6/1989,21,0,0,2,0,3500,6000,6000,149,126,181777,180,66,AM RL,2,1,1,2,3,3,1,1,3,1,2,12,13,14,12,14,12,6,10,6,6,11,12,9,15,10,11,10,13,10,10,11,14,17,8,14,9,10,11,14,14,10,9,13,13,13,20,10,11,11,6,12,7,11,14,13,14,13,14,14,14,6,1,1,9,20,20,20,13,AM RL,505,1,1,5,13,20,20,1,1,1,1,1,9,1,1,1,0,0,0,0,0,0,0,0,0,0,0,0,0,0,0,0,0,0,0,0,0,0,0,0,0,0,0,0,0,0,0,0,0,0,0,0,0,0,0,0,0,0,0,0,0,0,0,0,0,Pizzi,£4.05m ,31,177,Midfielder - Right Midfield,right,SL Benfica,35,11,3,2599,18,1,1,639,36,8,7,3160,34,4,1,1857,31,4,8,1883,47,8,12,3225,52,13,12,4251,45,6,12,3534,55,15,23,4215,LaLiga,51,30,19,4111,6,2,0,411
19/6/2011,Marco Höger,92014217,771,9/16/1989,21,0,0,0,0,4500,6550,6550,146,131,535365,186,78,D/DM/M RC,3,3,3,2,3,1,1,1,2,2,1,9,16,8,9,14,11,12,15,5,9,14,16,10,14,11,13,12,15,11,13,15,16,9,12,10,10,15,12,10,11,12,13,17,9,11,20,13,12,12,8,11,12,12,5,15,12,12,15,9,14,8,18,14,20,12,18,1,20,D/DM/M RC,433,1,1,1,1,1,12,1,1,18,17,20,1,15,1,14,0,0,0,0,0,0,0,0,0,0,0,0,0,0,0,0,0,0,0,0,0,0,0,0,0,0,0,0,0,0,0,0,0,0,0,0,0,0,0,0,0,0,0,0,0,0,0,0,0,Marco HÃ¶ger,£3.60m ,31,182,Midfielder - Defensive Midfield,right,1. FC KÃ¶ln,37,10,9,3235,43,1,5,2983,30,3,2,1858,14,2,1,1039,34,1,3,2756,6,0,0,219,32,0,1,2124,26,0,0,1876,28,1,3,2155,Bundesliga,16,0,0,727,3,0,0,109
19/6/2011,Marcel Risse,35017367,771,12/17/1989,21,0,0,2,0,4050,6450,6450,136,133,249493,183,78,M/AM RL,2,3,2,2,1,2,2,1,2,2,3,10,12,13,11,13,14,9,11,7,8,13,8,9,13,12,13,12,11,11,11,12,12,10,6,12,8,13,14,16,14,10,11,10,14,16,20,11,9,12,3,13,3,13,14,12,12,10,11,14,16,4,1,1,17,20,20,15,1,M/AM RL,525,1,1,12,1,15,20,1,1,1,1,1,15,17,1,1,2.2518E+15,0,0,0,0,0,0,0,0,0,0,0,0,0,0,0,0,0,0,0,0,0,0,0,0,0,0,0,0,0,0,0,0,0,0,0,0,0,0,0,0,0,0,0,0,0,0,0,0,Marcel Risse,£2.03m ,30,183,Midfielder - Right Midfield,right,FC Viktoria KÃ¶ln,27,1,7,1414,14,2,4,1008,25,1,2,823,34,11,4,2473,31,5,4,2421,35,3,7,3143,15,4,5,1314,18,1,3,1284,23,2,7,1771,Bundesliga,7,0,2,183,3,0,0,126
19/6/2011,Marc Albrighton,29010506,765,11/18/1989,21,0,0,8,1,4000,6500,6500,152,128,1241680,175,67,M/AM RL,3,3,2,2,1,1,3,6,3,1,2,12,18,12,10,12,12,5,10,3,6,12,10,6,12,10,11,12,12,11,12,9,14,12,7,13,5,15,18,15,14,14,6,8,16,12,20,16,6,12,7,10,6,11,5,12,18,11,13,16,15,5,1,1,17,20,20,15,4,M/AM RL,525,1,1,5,4,15,20,1,1,1,1,1,14,17,1,1,1.09965E+12,0,1,0,0,0,0,0,0,0,0,0,0,0,0,0,0,0,0,0,0,0,0,0,0,0,0,0,1,0,0,0,0,0,0,0,0,0,0,0,0,1,0,0,0,0,0,0,0,Marc Albrighton,£4.50m ,30,175,Midfielder - Right Midfield,right,Leicester City,36,7,13,2298,33,4,5,2106,14,1,1,726,26,0,4,1416,24,3,4,1467,42,2,7,3006,47,4,9,3522,42,2,7,2968,32,3,4,1936,Premier League,28,0,5,1439,4,0,0,125
19/6/2011,Karim Bellarabi,92017768,771,4/8/1990,21,0,0,0,0,1616,6000,6000,135,115,467647,183,76,AM/S R,2,3,3,1,1,3,3,5,3,2,3,10,13,14,12,13,8,13,7,6,10,12,10,9,12,6,14,6,9,12,11,12,10,9,7,14,10,15,15,15,14,14,10,3,12,14,20,11,6,10,14,10,5,10,10,12,7,9,7,19,9,9,1,1,14,20,20,1,1,AM/S R,512,1,1,18,1,1,20,1,1,1,1,1,1,14,1,1,0,0,0,0,0,0,0,0,0,0,0,0,0,0,0,0,0,0,0,0,0,0,0,0,0,0,0,0,0,0,0,0,0,0,0,0,0,0,0,0,0,0,0,0,0,0,0,0,0,Karim Bellarabi,£900Th. ,30,184,Forward - Right Winger,right,Bayer 04 Leverkusen,36,8,17,2944,14,2,0,386,11,2,3,658,29,3,5,1940,46,13,14,3939,49,12,14,3922,19,4,6,1349,29,2,4,1385,24,9,6,1428,Bundesliga,39,6,12,2233,6,2,1,353
19/6/2011,Junior Hoilett,28000482,364,6/5/1990,21,0,0,0,0,5000,7500,7250,158,137,3371929,173,70,AM/S RLC,2,3,2,3,1,1,1,7,2,3,2,7,7,14,10,11,7,3,12,5,3,10,10,3,14,8,9,10,9,11,10,7,12,16,4,13,7,11,11,17,14,9,6,11,16,16,20,12,8,10,3,10,5,14,10,19,8,10,14,15,15,14,1,1,14,20,20,15,16,AM/S RLC,516,1,1,17,16,15,20,1,1,1,1,1,12,14,1,1,2.25455E+15,0,0,0,0,0,0,0,0,1,0,0,0,0,0,0,0,0,0,0,0,0,0,0,0,0,0,0,1,0,0,0,0,0,0,0,0,0,0,0,1,0,1,0,0,0,0,0,0,Junior Hoilett,£8.10m ,30,174,Forward - Left Winger,right,Cardiff City,35,8,3,2457,37,7,7,3095,28,3,3,1598,39,4,7,2484,24,0,1,1013,31,6,2,2083,33,2,5,2421,50,11,12,4034,33,3,1,2142,Premier League,45,7,2,2696,8,0,1,557
19/6/2011,Jordan Henderson,28005568,765,6/17/1990,21,1,0,10,1,5500,7150,7000,155,133,8863636,183,67,M/AM RC,1,1,3,3,3,3,2,7,3,2,1,13,17,14,11,13,13,6,13,4,7,15,4,8,13,6,13,8,14,10,13,10,10,15,10,14,8,11,14,13,13,12,9,10,16,15,20,16,8,10,7,8,4,14,8,12,15,10,15,9,9,6,1,1,20,19,19,10,20,M/AM RC,413,1,1,5,10,10,19,1,1,1,3,20,10,18,1,1,4.40033E+12,0,0,0,0,0,1,0,0,0,0,0,0,0,0,0,0,0,0,0,0,0,0,0,0,0,0,0,1,0,0,0,1,0,0,0,0,0,0,0,0,0,0,1,0,0,0,0,0,Jordan Henderson,£13.50m ,30,187,Midfielder - Central Midfield,right,Liverpool FC,39,3,5,3319,48,2,4,3499,44,6,5,2642,40,5,7,3483,54,7,15,4739,26,2,3,1950,27,1,4,2355,41,1,2,3308,44,1,5,2811,Premier League,40,4,5,3167,5,0,0,335
19/6/2011,Jô,55042167,1651,9/19/1989,21,0,0,0,0,500,2000,2000,129,110,81300,170,70,AM/S RL,3,2,3,3,3,3,2,7,3,3,1,9,10,12,10,12,8,5,9,5,4,9,10,5,13,10,13,9,9,8,9,9,13,15,6,14,5,8,10,15,14,6,4,10,14,15,20,8,6,9,5,10,9,11,12,6,7,9,6,13,14,6,1,1,9,20,20,17,13,AM/S RL,515,1,1,17,13,17,20,1,1,1,1,1,1,9,1,1,0,0,0,0,0,0,0,0,0,0,0,0,0,0,0,0,0,0,0,0,0,0,0,0,0,0,0,0,0,0,0,0,0,0,0,0,0,0,0,0,0,0,0,0,0,0,0,0,0,Jô,£720Th. ,32,170,Forward - Second Striker,both,NK Krsko,nan,nan,nan,nan,15,0,1,869,1,0,0,12,34,1,7,2510,23,2,2,1637,11,0,0,502,17,2,1,978,nan,nan,nan,nan,nan,nan,nan,nan,Liga NOS,nan,nan,nan,nan,3,0,0,165
19/6/2011,Jefferson Montero,80001392,1654,9/1/1989,21,9,2,0,0,4700,6700,6650,161,134,146196,169,64,AM RL,1,3,3,1,3,3,1,4,2,2,3,11,13,16,10,14,10,6,12,7,5,13,11,6,16,10,11,8,11,7,13,9,13,18,5,13,5,9,10,16,15,8,6,15,14,14,20,12,6,11,9,15,8,12,13,16,10,12,13,12,13,9,1,1,13,20,19,20,11,AM RL,505,1,1,15,11,20,19,1,1,1,1,1,13,13,1,1,5.49756E+11,0,0,0,0,1,0,0,0,0,0,0,0,0,0,0,0,0,0,0,0,0,0,0,0,0,0,0,0,0,0,0,0,0,0,0,0,0,0,0,1,0,0,0,0,0,0,0,0,Jefferson Montero,£2.25m ,31,170,Forward - Left Winger,right,Without Club,30,2,3,1224,33,1,3,2189,43,8,7,2537,29,7,5,1901,34,1,8,1867,25,1,2,1519,15,0,1,523,18,1,3,655,17,1,3,505,LaLiga,18,0,1,568,nan,nan,nan,nan
19/6/2011,Igor Martínez,67046027,796,7/19/1989,21,0,0,0,0,3750,5500,5500,142,114,525476,170,65,AM/S RC,1,3,2,1,3,1,1,4,2,1,2,8,12,12,12,10,5,11,10,5,7,11,6,6,12,12,11,12,10,10,12,12,12,14,9,13,7,12,13,14,13,11,6,8,12,14,20,13,11,9,5,9,7,11,12,13,12,14,14,11,12,16,1,1,6,20,16,13,20,AM/S RC,513,1,1,18,20,13,16,1,1,1,1,6,1,1,1,1,0,0,0,0,0,0,0,0,0,0,0,0,0,0,0,0,0,0,0,0,0,0,0,0,0,0,0,0,0,0,0,0,0,0,0,0,0,0,0,0,0,0,0,0,0,0,0,0,0,Igor Martínez,£720Th. ,31,170,Midfielder - Attacking Midfield,right,Retired,29,1,2,2045,6,0,0,188,14,2,0,700,29,2,1,1507,41,3,4,2981,21,1,1,790,13,1,0,487,34,1,0,1671,43,1,0,2173,LaLiga,5,0,1,382,nan,nan,nan,nan
19/6/2011,Ibai Gómez,67087553,796,11/11/1989,21,0,0,0,0,2500,5300,5300,130,117,181185,179,71,AM/S RL,3,2,2,3,1,2,2,5,2,3,2,12,12,12,11,10,14,9,12,2,3,9,11,3,12,8,10,13,10,9,10,10,8,13,8,12,2,9,12,14,12,9,9,13,13,13,20,10,7,11,11,10,6,12,13,13,11,14,4,10,16,12,1,1,9,20,17,20,11,AM/S RL,515,1,1,18,11,20,17,1,1,1,1,1,9,1,1,1,4,0,0,1,0,0,0,0,0,0,0,0,0,0,0,0,0,0,0,0,0,0,0,0,0,0,0,0,0,0,0,0,0,0,0,0,0,0,0,0,0,0,0,0,0,0,0,0,0,Ibai Gómez,£900Th. ,30,178,Forward - Right Winger,right,Athletic Bilbao,15,4,0,888,45,12,6,2595,46,5,12,2472,24,8,2,1020,34,2,4,1674,9,0,1,339,35,7,3,2111,38,7,6,2560,34,3,4,2133,LaLiga,20,1,1,899,nan,nan,nan,nan
19/6/2011,Guido Marilungo,43000093,776,8/9/1989,21,0,0,7,2,4600,6350,6350,162,127,676029,176,69,AM/S RL,1,3,2,3,2,1,3,2,2,3,2,10,12,16,13,13,8,12,9,5,4,10,10,6,14,15,9,15,9,8,10,12,17,14,8,15,12,8,15,16,14,8,9,9,13,15,20,11,6,10,11,15,7,12,13,18,12,13,12,13,11,9,1,1,11,18,15,18,13,AM/S RL,625,1,1,20,13,18,15,1,1,1,1,1,11,9,1,1,532480,0,0,0,0,0,0,0,0,0,0,0,0,0,1,0,0,0,0,0,1,0,0,0,0,0,0,0,0,0,0,0,0,0,0,0,0,0,0,0,0,0,0,0,0,0,0,0,0,Guido Marilungo,£3.15m ,31,174,Forward - Centre-Forward,right,SS Monopoli 1966,36,2,6,2087,19,4,2,869,4,0,0,159,33,5,5,1973,9,2,0,810,34,7,6,2642,21,0,4,1013,39,10,3,2493,39,10,2,2958,Serie A,32,3,2,1604,6,0,0,283
19/6/2011,Gonçalo Graça,55021880,788,3/28/1990,21,0,0,0,0,1000,3500,3500,120,100,112485,174,68,AM R,3,1,1,3,2,1,1,1,1,2,2,11,12,14,9,13,8,7,10,7,7,11,12,8,13,10,12,9,10,9,10,9,6,13,7,13,7,10,11,12,12,9,7,6,11,13,20,8,9,8,6,7,9,10,12,12,14,10,9,9,7,5,1,1,9,20,20,14,7,AM R,502,1,1,12,7,14,20,1,1,1,1,1,1,9,1,1,0,0,0,0,0,0,0,0,0,0,0,0,0,0,0,0,0,0,0,0,0,0,0,0,0,0,0,0,0,0,0,0,0,0,0,0,0,0,0,0,0,0,0,0,0,0,0,0,0,Gonçalo Graça,£360Th. ,30,175,Forward - Right Winger,right,AD Esposende,28,8,0,1539,5,0,0,156,38,2,0,2630,0,0,0,0,47,1,1,4120,38,1,1,3002,nan,nan,nan,nan,nan,nan,nan,nan,nan,nan,nan,nan,Liga NOS,nan,nan,nan,nan,nan,nan,nan,nan
19/6/2011,Gaëtan Sidney,85028019,769,5/13/1990,21,0,0,0,0,1418,4814,2881,125,107,24105,186,77,AM RL,3,2,1,2,2,3,3,4,3,1,3,9,12,13,7,13,8,7,11,6,4,8,8,3,14,11,10,12,10,11,9,9,13,12,6,11,5,9,12,15,13,13,13,5,14,14,20,12,13,11,8,12,7,10,11,12,14,13,13,13,13,6,1,1,15,20,20,17,1,AM RL,505,1,1,1,1,17,20,1,1,1,1,1,15,15,1,1,2.2518E+15,0,0,0,0,0,0,0,0,0,1,0,0,0,0,0,0,0,0,0,0,0,0,0,0,0,0,0,0,0,0,0,0,0,0,0,0,0,0,0,0,0,0,0,0,0,0,0,0,,,,,,,,,,,,,,,,,,,,,,,,,,,,,,,,,,,,,,,,,,,,,,,,,,,,
19/6/2011,Emmanuel Rivière,34002601,769,3/3/1990,21,0,0,12,4,4500,5624,5600,145,124,1897233,182,76,AM/S R,1,3,3,2,1,2,2,1,1,3,1,5,11,11,11,11,9,11,12,5,5,9,12,6,12,8,12,13,9,11,9,10,15,12,6,13,9,12,14,16,15,14,12,8,14,15,20,14,14,11,8,14,7,10,14,16,13,8,12,14,14,10,8,8,12,18,18,10,1,AM/S R,622,1,1,20,1,10,18,1,1,8,1,1,10,12,1,8,16,0,0,0,0,1,0,0,0,0,0,0,0,0,0,0,0,0,0,0,0,0,0,0,0,0,0,0,0,0,0,0,0,0,0,0,0,0,0,0,0,0,0,0,0,0,0,0,0,Emmanuel Rivière,£4.50m ,30,182,Forward - Centre-Forward,right,FC Crotone,38,8,11,2943,26,5,1,1657,35,9,3,1441,36,13,2,2158,28,3,1,1553,3,0,0,63,17,0,1,895,31,6,2,2139,16,3,0,541,Ligue 1,31,13,3,2269,2,1,0,60
19/6/2011,Emilio Nsué,1504124,796,9/30/1989,21,0,0,0,0,4750,6600,6600,150,137,1897233,178,75,AM/S RL,1,2,1,2,1,2,1,6,1,2,3,10,12,13,11,13,8,10,12,5,4,12,12,6,14,9,10,14,11,9,13,10,10,16,9,17,9,12,13,15,12,15,9,10,16,16,20,15,12,12,7,14,7,11,9,13,19,14,10,10,12,13,1,1,9,19,19,15,12,AM/S RL,625,1,1,20,12,15,19,1,1,1,1,1,3,9,1,1,134217744,0,0,0,0,1,0,0,0,0,0,0,0,0,0,0,0,0,0,0,0,0,0,0,0,0,0,0,1,0,0,0,0,0,0,0,0,0,0,0,0,0,0,0,0,0,0,0,0,Emilio Nsue,£2.70m ,31,178,Defender - Right-Back,right,APOEL Nicosia,42,6,3,3243,34,4,4,2228,35,2,3,2354,41,4,2,3545,29,0,3,1384,46,3,2,3730,23,1,0,2012,37,7,4,3039,13,3,1,1137,LaLiga,16,1,0,984,6,0,2,570
19/6/2011,Eduardo Salvio,14000699,1649,5/13/1990,21,1,0,23,6,4750,6500,6500,160,134,2681023,173,71,AM/S R,1,3,2,3,3,3,2,2,1,1,2,11,13,14,13,13,10,5,11,4,5,13,14,7,15,11,9,16,11,10,13,11,16,18,7,13,6,8,8,16,17,12,6,8,13,14,20,14,8,13,5,13,11,11,11,14,15,16,13,13,12,9,1,1,15,20,20,1,11,AM/S R,512,1,1,16,11,1,20,1,1,1,1,1,1,15,1,1,34359738368,0,0,0,0,0,0,0,0,0,0,0,0,0,0,0,0,0,0,0,0,0,0,0,0,0,0,0,0,0,0,0,0,0,0,0,1,0,0,0,0,0,0,0,0,0,0,0,0,Eduardo Salvio,£9.00m ,30,173,Forward - Right Winger,right,Club Atlético Boca Juniors,39,10,7,2446,48,8,5,2351,51,13,11,4044,22,2,4,1117,38,13,11,3148,12,0,0,362,42,9,11,2902,34,9,6,2279,34,7,5,1703,LaLiga,22,12,3,1543,nan,nan,nan,nan
19/6/2011,Dennis Diekmeier,35016422,771,10/20/1989,21,0,0,1,0,4700,6500,6500,158,125,10009544,188,80,D/WB R,3,3,3,2,3,3,2,5,2,1,3,11,14,12,7,10,6,7,9,15,9,11,6,12,11,13,8,15,9,9,11,11,8,7,7,16,7,14,18,16,12,16,13,7,10,18,20,17,13,10,6,10,5,10,3,18,6,5,6,15,8,15,20,20,15,12,20,9,1,D/WB R,112,1,1,1,1,1,12,1,9,20,1,1,1,15,1,20,1.09951E+12,0,1,0,1,0,0,0,0,0,0,0,0,0,0,0,0,0,0,0,0,0,0,0,0,0,0,0,0,0,0,0,0,0,0,0,0,0,0,0,0,1,0,0,0,0,0,0,0,Dennis Diekmeier,£3.60m ,31,188,Defender - Right-Back,right,SV Sandhausen,12,1,0,1024,27,0,2,2310,32,0,4,2841,23,0,2,2001,24,0,1,1905,22,0,0,1440,26,0,1,1883,22,0,3,1869,16,0,6,1440,Bundesliga,34,2,4,2974,6,0,1,540
19/6/2011,Daniel Royer,16018632,755,5/22/1990,21,2,0,5,0,1405,5459,4385,140,121,316205,177,72,M/AM RLC,1,1,1,3,2,3,3,3,1,1,3,9,13,13,10,13,10,10,11,5,11,11,7,11,14,8,9,13,9,8,11,11,10,15,8,11,12,11,11,13,14,10,11,17,14,13,20,14,12,8,6,4,9,11,7,2,9,11,7,10,9,9,1,11,20,20,20,20,20,M/AM RLC,416,1,1,1,1,20,17,1,1,1,1,20,20,20,11,11,2.74878E+12,0,0,0,0,0,0,0,0,0,0,0,0,0,0,0,0,0,0,0,0,1,0,0,0,0,0,0,0,0,0,0,0,0,0,0,0,0,0,0,1,0,1,0,0,0,0,0,0,Daniel Royer,£720Th. ,30,177,Forward - Left Winger,both,New York Red Bulls,41,5,7,3019,24,2,3,1899,29,3,2,1354,41,7,9,2656,36,7,5,2259,43,3,5,2622,34,15,3,2442,41,16,4,2899,37,14,8,2808,Bundesliga,18,4,2,1297,nan,nan,nan,nan
19/6/2011,Dan Gosling,29007273,765,2/1/1990,21,0,0,2,0,3500,6250,6250,150,122,2565562,178,70,D/DM/M RC,1,3,1,2,2,3,1,5,1,3,3,7,9,13,11,12,8,10,8,8,10,13,9,10,12,9,11,12,14,14,13,12,14,7,14,14,13,13,14,12,12,10,9,12,15,11,20,14,12,15,4,14,11,14,12,12,8,15,15,13,14,2,16,10,20,13,18,1,20,D/DM/M RC,333,1,1,1,10,1,13,1,1,16,20,20,1,18,1,10,1.75922E+13,0,1,0,0,0,0,1,0,0,0,0,0,0,0,0,0,0,0,0,0,0,0,0,0,0,0,0,0,0,0,0,0,0,0,0,0,0,0,0,0,0,0,0,0,1,0,0,0,Dan Gosling,£1.35m ,30,180,Midfielder - Central Midfield,right,AFC Bournemouth,2,0,1,90,22,5,5,941,14,2,1,831,26,3,1,1799,24,5,2,814,37,4,2,2595,30,3,1,1600,32,3,1,2331,26,2,1,1827,Premier League,25,3,1,1350,8,2,0,509
19/6/2011,Damien Le Tallec,34004620,769,4/19/1990,21,0,0,4,0,3500,5050,5600,141,112,563330,185,77,AM/S R,3,1,3,3,2,1,3,4,2,1,3,7,9,13,12,12,9,13,10,4,3,10,11,6,13,9,12,11,10,8,11,9,12,12,5,13,6,13,9,14,13,12,11,10,10,12,20,14,11,10,7,14,15,13,12,12,12,10,13,12,11,11,1,1,14,18,18,14,14,AM/S R,622,1,1,20,14,14,18,1,1,1,1,1,13,14,1,1,131072,0,0,0,0,0,0,0,0,0,0,0,0,0,0,0,0,0,1,0,0,0,0,0,0,0,0,0,0,0,0,0,0,0,0,0,0,0,0,0,0,0,0,0,0,0,0,0,0,Damien Le Tallec,£135Th. ,30,187,Midfielder - Defensive Midfield,right,Montpellier HSC,27,11,2,1946,19,1,0,1190,22,5,3,1510,22,2,4,1583,31,0,0,2687,29,3,5,2426,48,4,2,4163,42,1,0,3796,37,3,1,2902,Bundesliga,33,2,1,2875,8,0,0,587
19/6/2011,Chula,55009981,788,2/13/1990,21,0,0,0,0,1808,5000,5000,122,107,196963,174,65,AM R,2,1,3,3,2,1,2,1,1,1,3,12,12,12,5,13,7,5,5,6,3,10,12,3,14,10,9,11,10,8,8,8,14,15,7,13,4,10,6,14,13,6,5,10,13,14,20,9,6,11,6,12,12,9,8,12,13,11,14,14,14,5,1,1,10,20,20,13,1,AM R,502,1,1,1,1,13,20,1,1,1,1,1,1,10,1,1,1.09951E+12,0,0,0,0,0,0,0,0,0,0,0,0,0,0,0,0,0,0,0,0,0,0,0,0,0,0,0,0,0,0,0,0,0,0,0,0,0,0,0,0,1,0,0,0,0,0,0,0,,,,,,,,,,,,,,,,,,,,,,,,,,,,,,,,,,,,,,,,,,,,,,,,,,,,
19/6/2011,Anthony Bova,85041526,769,3/7/1990,21,0,0,0,0,1379,4691,2805,135,104,22750,170,64,AM RL,3,1,3,3,2,3,3,1,2,1,3,8,9,12,7,12,8,6,8,7,1,9,10,2,14,7,10,11,11,11,11,10,14,13,7,11,5,8,13,16,14,9,4,5,14,15,20,13,6,12,7,14,6,8,8,13,12,11,13,15,15,6,1,1,10,20,20,17,12,AM RL,505,1,1,14,12,17,20,1,1,1,1,1,10,10,1,1,2.2518E+15,0,0,0,0,1,0,0,0,0,0,0,0,0,0,0,0,0,0,0,0,0,0,0,0,0,0,0,0,0,0,0,0,0,0,0,0,0,0,0,0,0,0,0,0,0,0,0,0,Anthony Ujah,£1.58m ,30,180,Forward - Centre-Forward,right,1.FC Union Berlin,13,13,4,1200,16,2,0,675,31,13,3,2626,37,11,4,2394,35,12,3,2602,52,19,8,3883,24,5,4,2070,12,0,0,253,23,4,0,843,Bundesliga,28,4,4,1181,nan,nan,nan,nan
19/6/2011,Andrea Mazzarani,43006567,776,11/6/1989,21,0,0,0,0,1841,5024,5024,135,107,99162,174,66,WB/M/AM RC,2,3,3,3,1,2,1,1,3,2,2,14,14,13,8,11,10,9,7,5,10,11,10,12,11,8,12,8,11,10,6,10,10,6,6,13,12,7,7,14,11,7,7,11,18,13,20,15,8,13,5,12,4,14,8,18,13,11,14,12,18,6,10,16,20,16,20,1,15,WB/M/AM RC,433,1,1,1,15,1,16,1,1,10,1,1,1,20,1,16,0,0,0,0,0,0,0,0,0,0,0,0,0,0,0,0,0,0,0,0,0,0,0,0,0,0,0,0,0,0,0,0,0,0,0,0,0,0,0,0,0,0,0,0,0,0,0,0,0,Andrea Mazzarani,£900Th. ,30,180,Midfielder - Attacking Midfield,right,Calcio Catania,39,10,1,2854,22,1,3,1041,18,6,3,1006,37,9,5,1795,37,9,1,2455,16,4,1,805,29,9,1,2180,37,8,5,2321,17,1,3,842,Serie A,33,7,0,1764,nan,nan,nan,nan
19/6/2011,Alexander Esswein,29022519,771,3/25/1990,21,0,0,1,0,4550,5850,6100,137,120,114962,183,83,AM/S R,3,3,3,1,3,1,2,6,1,2,2,10,8,12,13,13,6,10,9,2,2,10,8,5,13,14,8,16,9,10,8,8,11,8,5,12,5,8,12,15,13,12,12,10,11,16,20,11,15,9,4,9,7,6,10,11,8,9,12,11,11,5,1,1,1,16,16,1,12,AM/S R,622,1,1,20,12,1,16,1,1,1,1,1,1,1,1,1,512,0,0,0,0,0,0,0,0,0,1,0,0,0,0,0,0,0,0,0,0,0,0,0,0,0,0,0,0,0,0,0,0,0,0,0,0,0,0,0,0,0,0,0,0,0,0,0,0,Alexander Esswein,£3.15m ,30,182,Forward - Right Winger,right,SV Sandhausen,33,17,8,2949,29,5,4,1982,28,3,2,1794,19,0,1,780,19,1,3,864,38,4,3,2381,30,2,3,1346,22,2,2,1013,24,2,1,1807,Bundesliga,10,1,1,492,2,0,0,89
19/6/2011,Alain Eizmendi,67055064,796,6/10/1990,21,0,0,0,0,2000,3650,3650,118,82,92358,171,65,AM/S R,2,1,1,3,2,3,2,1,1,1,1,9,10,11,11,8,7,7,8,1,2,8,10,3,13,10,9,11,7,10,8,9,10,11,7,10,2,6,5,15,13,9,6,5,17,14,20,8,5,6,12,10,9,10,10,11,10,3,13,12,9,20,1,1,14,20,20,1,1,AM/S R,512,1,1,16,1,1,20,1,1,1,1,1,1,14,1,1,0,0,0,0,0,0,0,0,0,0,0,0,0,0,0,0,0,0,0,0,0,0,0,0,0,0,0,0,0,0,0,0,0,0,0,0,0,0,0,0,0,0,0,0,0,0,0,0,0,,,,,,,,,,,,,,,,,,,,,,,,,,,,,,,,,,,,,,,,,,,,,,,,,,,,
19/6/2011,Zoltán Stieber,28000417,773,10/6/1988,22,0,0,1,0,4750,5849,6500,149,130,467800,175,67,AM/S RLC,2,2,3,2,2,1,1,2,2,1,2,10,15,14,12,13,12,4,7,5,8,11,10,8,13,10,11,9,12,10,13,12,16,16,5,13,7,11,12,16,12,11,6,20,11,15,10,13,7,10,13,10,9,15,12,13,7,13,14,14,14,7,1,1,15,20,15,20,18,AM/S RLC,516,1,1,17,18,20,15,1,1,1,1,1,15,12,1,1,1,1,0,0,0,0,0,0,0,0,0,0,0,0,0,0,0,0,0,0,0,0,0,0,0,0,0,0,0,0,0,0,0,0,0,0,0,0,0,0,0,0,0,0,0,0,0,0,0,Zoltán Stieber,£1.13m ,32,175,Forward - Left Winger,left,Újpest FC,36,10,18,2973,12,0,5,896,17,3,2,1267,36,9,12,2986,28,3,3,1696,8,1,0,257,28,3,5,1989,29,5,6,1955,9,0,0,301,Bundesliga,25,2,6,1931,5,0,0,151
19/6/2011,Zhang Chengdong,23020214,110,2/9/1989,22,1,0,0,0,1501,4950,4500,130,90,6817,184,73,AM/S RL,1,2,2,2,1,1,3,1,1,2,3,7,9,11,10,10,7,11,2,5,7,8,7,1,11,8,6,8,10,8,9,7,14,13,1,10,3,10,13,14,12,9,10,8,13,14,20,8,9,7,10,10,7,10,14,12,8,13,16,16,16,4,1,1,1,17,17,17,7,AM/S RL,625,1,1,20,7,17,17,1,1,1,1,1,1,1,1,1,0,0,0,0,0,0,0,0,0,0,0,0,0,0,0,0,0,0,0,0,0,0,0,0,0,0,0,0,0,0,0,0,0,0,0,0,0,0,0,0,0,0,0,0,0,0,0,0,0,,,,,,,,,,,,,,,,,,,,,,,,,,,,,,,,,,,,,,,,,,,,,,,,,,,,
19/6/2011,Timo Gebhart,35014477,771,4/12/1989,22,0,0,3,1,4750,6650,6650,157,133,3549968,182,78,M/AM RLC,3,3,1,1,3,3,3,8,3,1,1,11,14,16,12,15,12,6,10,8,10,13,14,8,16,16,7,15,14,6,7,7,14,17,9,10,6,3,14,17,18,15,10,6,6,15,20,12,10,8,14,10,10,12,4,17,9,13,8,9,7,15,1,1,17,20,18,16,20,M/AM RLC,526,1,1,15,20,16,18,1,1,1,1,10,15,17,1,1,2.32274E+15,0,0,0,0,0,0,0,0,0,0,0,0,0,0,0,0,0,0,0,0,0,0,0,0,0,0,0,0,0,0,1,0,0,0,1,0,0,0,0,1,0,0,0,0,0,0,1,0,Timo Gebhart,£2.25m ,31,183,Midfielder - Attacking Midfield,right,FC Memmingen,34,6,8,2151,13,0,0,313,19,2,2,1172,7,0,0,206,9,1,1,555,7,0,0,324,21,6,4,1394,12,5,4,793,13,3,5,778,Bundesliga,31,5,2,1273,1,0,0,90
19/6/2011,Theo Walcott,5125014,765,3/16/1989,22,17,3,21,6,6600,7650,7700,172,155,4671152,176,71,AM/S R,1,2,2,3,3,1,3,7,2,3,3,7,12,14,13,12,10,5,6,4,7,11,10,7,13,7,12,9,11,11,12,9,15,12,3,12,7,14,13,19,16,14,7,11,16,19,20,14,9,10,4,13,13,14,12,17,15,14,16,18,18,1,1,1,14,19,19,14,1,AM/S R,622,1,1,20,1,14,19,1,1,1,1,1,12,14,1,1,7.25679E+13,0,1,0,0,0,0,0,0,0,0,0,0,0,0,0,0,0,0,0,0,0,0,0,0,0,0,0,1,0,0,0,0,0,0,0,0,0,0,0,0,0,1,0,0,0,0,1,0,Theo Walcott,£17.10m ,31,175,Forward - Right Winger,both,Southampton FC,38,13,9,2272,46,11,12,3518,43,21,16,2988,18,6,7,1203,22,7,1,795,42,9,7,2076,37,19,2,2495,30,7,8,2069,40,6,2,2168,Premier League,29,2,4,1449,3,0,1,192
19/6/2011,Stephan Hain,91002834,771,9/27/1988,22,0,0,0,0,4000,6050,6050,137,121,569578,178,72,AM/S RLC,1,1,2,1,3,1,3,3,1,1,1,12,11,13,12,12,10,7,8,4,6,12,13,8,12,9,10,13,8,8,9,10,10,10,7,14,5,12,13,14,16,8,8,17,11,13,20,10,8,10,5,9,6,17,8,4,14,12,11,14,16,6,1,1,9,20,18,18,20,AM/S RLC,516,1,1,20,20,18,18,1,1,1,1,9,1,1,1,1,24,0,0,0,1,1,0,0,0,0,0,0,0,0,0,0,0,0,0,0,0,0,0,0,0,0,0,0,0,0,0,0,0,0,0,0,0,0,0,0,0,0,0,0,0,0,0,0,0,Stephan Hain,£1.13m ,32,178,Forward - Centre-Forward,both,SpVgg Unterhaching,27,10,5,1873,14,1,0,395,18,2,0,755,13,0,0,700,12,1,0,520,8,2,0,440,34,35,6,2740,40,20,2,3466,30,14,4,2628,Bundesliga,25,5,1,1326,nan,nan,nan,nan
19/6/2011,Shinji Kagawa,45001639,116,3/17/1989,22,22,5,6,0,7000,7600,7700,171,154,7649763,172,63,AM RLC,1,1,1,1,2,2,2,6,1,2,3,10,9,17,14,18,11,12,13,4,6,13,11,7,17,12,14,9,13,8,8,13,13,15,5,17,6,10,15,18,20,10,7,18,12,13,20,12,6,12,5,11,8,13,9,16,9,12,12,12,14,11,1,1,12,20,17,18,20,AM RLC,506,1,1,14,20,18,17,1,1,1,1,10,12,12,1,1,5.49757E+11,0,0,0,0,1,0,0,0,0,0,1,0,1,0,0,0,0,0,0,0,1,0,0,0,0,0,0,0,0,0,0,0,0,0,0,0,0,0,0,1,0,0,0,0,0,0,0,0,Shinji Kagawa,£19.80m ,31,175,Midfielder - Attacking Midfield,right,Without Club,28,12,2,2125,43,17,14,3282,26,6,6,1701,30,0,4,1992,39,6,10,2681,46,13,13,3122,30,6,8,2046,27,6,7,1776,19,4,8,842,Bundesliga,36,4,2,2180,nan,nan,nan,nan
19/6/2011,Seamus Coleman,56001681,789,8/3/1988,22,4,0,13,1,4250,7000,6750,148,128,1693114,177,67,D/WB/M R,3,3,1,3,1,1,3,5,1,1,1,5,13,15,9,12,8,14,9,12,14,11,8,14,11,15,12,14,12,11,8,12,14,13,11,13,11,14,14,15,10,13,12,7,14,14,20,15,14,13,10,13,3,8,10,13,18,12,15,15,12,7,20,17,20,10,20,9,1,D/WB/M R,122,1,1,1,1,1,10,1,9,20,1,1,1,20,1,17,7.04031E+13,0,1,0,0,0,1,0,0,0,0,0,0,0,0,0,0,0,0,0,0,0,0,0,0,0,0,0,0,0,0,0,0,0,0,0,1,0,0,0,0,0,0,0,0,0,0,1,0,Seamus Coleman,£4.50m ,32,177,Defender - Right-Back,right,Everton FC,41,6,4,2892,28,1,2,1757,31,1,6,2614,41,7,2,3635,42,5,3,3725,34,1,3,2842,28,4,4,2497,12,0,1,1035,30,2,2,2650,Premier League,30,0,1,2082,6,0,1,407
19/6/2011,Scott Sinclair,5008069,765,3/25/1989,22,0,0,7,1,4750,6350,6350,140,125,930917,177,69,AM RLC,3,1,3,2,2,3,1,2,1,2,2,6,9,14,14,7,7,8,8,1,3,6,15,4,11,9,8,10,10,7,7,7,14,15,7,9,4,10,9,15,12,12,6,12,14,18,20,12,6,10,3,13,6,8,3,18,10,14,18,15,18,4,1,1,9,20,16,20,15,AM RLC,506,1,1,15,15,20,16,1,1,1,1,1,9,1,1,1,134217729,1,0,0,0,0,0,0,0,0,0,0,0,0,0,0,0,0,0,0,0,0,0,0,0,0,0,0,1,0,0,0,0,0,0,0,0,0,0,0,0,0,0,0,0,0,0,0,0,Scott Sinclair,£7.20m ,31,177,Forward - Left Winger,right,Preston North End,50,27,3,4146,40,8,5,3145,18,2,1,537,11,0,1,531,16,3,0,604,33,6,0,2049,50,25,13,4055,55,18,17,3768,55,17,6,3484,Premier League,25,5,0,1071,10,4,1,610
19/6/2011,Pierre-Emerick Aubameyang,43017197,19,6/18/1989,22,16,4,0,0,5000,6250,5600,145,126,132301,185,74,AM/S R,2,3,1,1,1,2,3,4,3,1,1,5,9,12,9,10,9,11,10,7,4,10,12,3,12,7,11,9,9,10,11,9,15,14,5,13,6,11,13,18,14,14,12,8,14,16,20,15,13,11,7,14,6,8,13,14,12,11,13,15,15,7,1,1,10,17,17,13,1,AM/S R,622,1,1,20,1,13,17,1,1,1,1,1,10,10,1,1,8208,0,0,0,0,1,0,0,0,0,0,0,0,0,1,0,0,0,0,0,0,0,0,0,0,0,0,0,0,0,0,0,0,0,0,0,0,0,0,0,0,0,0,0,0,0,0,0,0,Pierre-Emerick Aubameyang,£6.30m ,31,187,Forward - Centre-Forward,right,Arsenal FC,37,4,3,2529,38,18,11,3299,45,21,14,3850,48,16,5,2653,46,25,11,3813,49,39,12,3931,46,40,5,3959,38,31,7,3316,51,31,8,3859,Ligue 1,44,29,3,3725,8,3,1,659
19/6/2011,Philipp Bargfrede,92012217,771,3/3/1989,22,0,0,4,1,4500,6600,6600,155,129,805283,174,71,DM/M RC,2,3,3,2,2,3,1,5,1,1,2,11,13,12,7,11,8,10,9,11,14,9,11,14,13,14,17,14,12,15,8,8,13,7,11,8,16,18,17,15,15,14,8,12,12,12,20,16,10,13,7,9,11,15,8,10,12,8,14,12,13,7,1,1,20,10,15,8,20,DM/M RC,423,1,1,1,10,5,5,1,1,1,18,20,8,15,1,1,0,0,0,0,0,0,0,0,0,0,0,0,0,0,0,0,0,0,0,0,0,0,0,0,0,0,0,0,0,0,0,0,0,0,0,0,0,0,0,0,0,0,0,0,0,0,0,0,0,Philipp Bargfrede,£3.15m ,31,174,Midfielder - Defensive Midfield,right,SV Werder Bremen II,38,0,2,2676,24,0,1,1944,14,0,1,644,20,3,0,1579,16,1,0,1253,17,0,1,1455,11,1,1,449,30,2,1,2048,17,1,0,1238,Bundesliga,17,0,1,716,nan,nan,nan,nan
19/6/2011,Pablo Piatti,14004181,1649,3/31/1989,22,1,0,6,0,5600,6587,7100,165,146,5795059,163,58,AM/S RLC,2,2,2,1,2,2,1,5,3,2,3,11,15,15,14,15,12,5,13,2,6,15,14,6,16,9,14,13,13,12,15,14,18,18,8,16,4,13,12,15,16,12,4,20,11,14,8,14,7,11,4,15,11,14,13,16,14,17,13,14,15,9,1,1,10,20,16,19,20,AM/S RLC,516,1,1,18,20,19,16,1,1,1,1,1,10,7,1,1,2.2518E+15,0,0,0,1,0,0,0,0,0,0,1,0,0,0,0,0,0,0,0,0,0,0,0,0,0,0,0,0,0,0,0,0,0,0,0,0,0,0,0,0,0,0,0,0,0,0,0,0,Pablo Piatti,£7.20m ,31,163,Forward - Left Winger,both,Toronto FC,41,10,5,3264,47,6,5,2106,19,1,4,1081,29,7,5,1555,30,7,8,2044,37,2,8,1759,31,10,12,2475,31,2,4,1812,26,2,2,1237,LaLiga,25,4,4,1624,nan,nan,nan,nan
19/6/2011,Óscar De Marcos,67065930,796,4/14/1989,22,0,0,1,0,4250,6150,6150,145,125,336537,180,76,AM RLC,1,3,1,3,3,2,2,1,1,1,2,10,13,13,12,11,10,12,13,4,4,12,12,6,14,12,12,14,13,11,13,12,13,14,9,13,8,12,11,14,13,12,10,20,14,12,15,12,12,11,5,11,4,14,9,15,12,12,7,9,10,7,9,5,10,20,16,20,18,AM RLC,506,1,1,14,18,20,16,1,1,9,1,10,9,1,1,5,0,0,0,0,0,0,0,0,0,0,0,0,0,0,0,0,0,0,0,0,0,0,0,0,0,0,0,0,0,0,0,0,0,0,0,0,0,0,0,0,0,0,0,0,0,0,0,0,0,Óscar de Marcos,£5.40m ,31,182,Defender - Right-Back,right,Athletic Bilbao,15,0,3,565,56,9,11,4776,46,7,5,3989,39,5,2,2162,52,2,5,4416,54,2,5,4484,32,1,4,2588,28,2,5,2293,34,1,3,2650,LaLiga,13,0,2,538,1,0,0,90
19/6/2011,Michel Morganella,69002448,798,5/17/1989,22,0,0,3,0,773,5415,5900,140,120,129792,183,74,D/WB R,1,1,1,2,3,3,1,3,1,2,2,12,14,7,8,12,9,11,9,13,12,12,8,13,13,12,11,10,10,12,11,12,17,9,5,6,10,11,11,11,15,11,10,10,10,16,20,16,11,12,11,10,1,12,15,11,12,13,17,12,14,1,20,18,15,1,20,8,1,D/WB R,112,1,1,1,1,1,1,1,8,20,1,1,1,15,1,18,1.09951E+12,0,0,0,0,0,0,0,0,0,0,0,0,0,0,0,0,0,0,0,0,0,0,0,0,0,0,0,0,0,0,0,0,0,0,0,0,0,0,0,0,1,0,0,0,0,0,0,0,Michel Morganella,£720Th. ,31,183,Defender - Right-Back,right,FC Chiasso,37,0,3,3151,34,0,2,2916,31,0,3,2581,16,1,0,1216,20,1,1,1725,15,0,1,1061,12,0,0,739,12,0,0,932,19,1,0,1500,Serie A,11,0,0,724,2,0,0,139
19/6/2011,Matias Ezequiel Schelotto,43048983,776,5/23/1989,22,0,0,7,0,5000,6400,6400,153,130,472039,187,76,WB/M/AM R,3,3,3,2,1,3,2,1,1,3,1,10,13,13,14,8,12,8,12,14,10,14,10,8,14,9,13,14,14,10,11,9,19,14,6,15,9,13,9,15,9,10,13,13,17,14,20,16,15,13,8,12,4,14,18,19,18,6,17,13,8,6,14,16,20,18,20,1,1,WB/M/AM R,432,1,1,1,1,1,18,1,1,14,1,1,1,20,1,16,1.09951E+12,0,1,0,0,0,0,0,0,0,0,0,0,0,0,0,0,0,0,0,0,0,0,0,0,0,0,0,0,0,0,0,0,0,0,0,0,0,0,0,0,1,0,0,0,0,0,0,0,Ezequiel Schelotto,£5.85m ,31,187,Defender - Right-Back,right,Without Club,32,2,2,1826,38,2,7,2866,31,1,1,1856,27,5,2,1367,29,0,0,2123,17,0,3,1284,26,0,5,2148,24,0,1,1690,4,0,0,143,Serie A,9,0,0,451,nan,nan,nan,nan
19/6/2011,Matías Aguirregaray,78020879,1657,4/1/1989,22,0,0,15,1,3000,5354,5250,145,119,269149,183,78,D/WB/M R,3,2,2,3,1,2,1,4,3,2,1,5,10,15,8,8,8,10,9,7,13,10,5,12,15,15,9,15,12,11,7,8,12,15,13,13,12,14,15,14,15,13,11,9,12,12,20,15,15,9,16,11,3,14,12,16,4,9,9,6,5,10,18,20,19,1,20,1,1,D/WB/M R,232,1,1,1,1,1,1,1,1,18,14,1,1,19,1,20,2.3222E+15,0,0,0,0,0,1,0,0,0,0,0,0,0,0,0,0,0,0,0,0,0,0,0,0,0,0,0,0,0,0,0,0,0,0,0,1,0,0,0,0,0,0,0,0,0,0,1,0,MatÃ­as Aguirregaray,£720Th. ,31,174,Defender - Right-Back,right,Without Club,7,0,2,564,13,0,1,729,34,5,6,2493,16,1,1,973,30,2,2,2369,37,5,4,3273,28,6,0,2124,30,0,0,2373,26,1,3,2300,Serie A,25,2,0,1893,nan,nan,nan,nan
19/6/2011,Mathieu Dossevi,34003999,769,12/2/1988,22,0,0,4,1,4700,5850,5850,155,130,736165,172,65,M/AM R,3,3,2,3,3,3,1,6,1,3,2,11,13,13,9,14,8,6,12,5,2,11,11,4,14,7,12,11,11,12,10,11,15,13,5,14,7,11,13,17,15,11,6,8,11,16,20,13,8,11,7,13,8,8,8,16,12,14,14,14,13,9,1,1,16,20,20,14,1,M/AM R,522,1,1,12,1,14,20,1,1,1,1,1,12,16,1,1,2.25235E+15,0,0,0,0,0,0,0,0,0,0,0,0,0,0,0,0,0,0,0,0,0,0,0,0,0,0,0,0,0,0,0,0,0,0,0,0,0,0,0,1,0,0,0,0,0,0,0,0,Mathieu Dossevi,£1.13m ,32,174,Forward - Right Winger,right,Denizlispor,30,4,0,1953,23,3,1,1324,38,4,6,2766,33,6,5,2179,34,5,3,2294,34,7,15,2695,28,1,6,2158,37,2,15,3067,38,5,3,2607,Ligue 1,27,1,1,1847,1,0,0,1
19/6/2011,Marko Marin,156766,771,3/13/1989,22,16,1,12,1,7100,7000,7000,170,145,4694043,170,63,AM RLC,3,1,2,2,3,3,2,8,1,3,3,14,15,18,8,17,13,8,10,6,4,13,12,5,18,5,9,8,13,10,12,7,12,19,6,14,4,5,7,18,20,6,6,15,13,14,20,11,4,14,12,10,6,12,8,10,9,15,12,7,14,5,1,1,12,20,18,20,16,AM RLC,506,1,1,15,16,20,18,1,1,1,1,8,11,12,1,1,7.09196E+13,1,1,0,0,0,0,0,0,0,0,0,0,0,0,0,0,0,0,0,0,0,0,0,0,0,0,0,0,0,0,1,0,0,0,0,0,0,0,0,1,0,0,0,0,0,0,1,0,Marko Marin,£11.70m ,31,170,Midfielder - Attacking Midfield,right,Al-Ahli Jeddah,44,5,12,3293,22,1,5,1434,19,3,2,621,30,2,7,1530,12,2,0,713,29,2,5,1844,23,4,5,1361,36,8,5,2356,31,7,13,2405,Bundesliga,42,6,13,3336,2,0,0,165
19/6/2011,Marko Arnautovic,37003555,755,4/19/1989,22,11,4,4,2,6150,6524,6750,170,145,4839759,192,83,AM/S R,1,3,2,2,1,3,3,3,1,1,3,8,15,16,10,18,14,9,12,5,3,13,10,6,18,14,8,15,6,6,14,7,5,18,4,9,6,3,11,14,13,18,14,18,12,17,20,11,15,6,13,9,9,14,14,17,3,7,3,10,6,18,1,1,9,20,20,14,14,AM/S R,512,1,1,19,14,14,20,1,1,1,1,1,1,9,1,1,7.04031E+13,0,0,0,0,0,0,0,1,0,0,0,1,0,0,0,0,0,1,0,0,0,0,0,0,0,0,0,0,0,0,0,0,0,0,0,1,0,0,0,0,0,0,0,0,0,0,1,0,Marko Arnautovic,£5.85m ,31,189,Forward - Centre-Forward,both,Shanghai SIPG,34,5,4,2046,20,6,0,991,27,5,9,2020,38,5,12,2768,35,2,8,2389,40,12,6,3304,35,7,6,2966,35,11,8,2472,45,20,7,3079,Bundesliga,17,8,1,1208,nan,nan,nan,nan
19/6/2011,Marco Reus,91013383,771,5/31/1989,22,0,0,2,0,5500,7400,7400,158,148,2845850,180,67,M/AM RL,3,2,3,2,3,2,3,5,2,2,2,10,9,15,16,14,10,5,13,6,6,11,9,8,14,11,9,10,14,9,13,14,14,13,6,15,6,10,15,18,17,13,8,14,14,16,20,14,6,15,6,15,5,16,3,9,16,17,12,15,11,5,1,1,16,20,20,18,14,M/AM RL,525,1,1,14,14,18,20,1,1,1,1,1,15,16,1,1,5.49757E+11,0,0,1,0,1,0,0,0,0,1,0,0,0,0,0,0,0,0,0,0,1,0,0,0,0,0,0,0,0,0,0,0,0,0,0,0,0,0,0,1,0,0,0,0,0,0,0,0,Marco Reus,£18.00m ,31,180,Midfielder - Attacking Midfield,right,Borussia Dortmund,37,12,10,3325,37,21,14,3316,49,19,16,3734,44,23,23,3494,29,11,6,2256,43,23,8,3282,24,13,8,1703,15,7,1,1163,36,21,13,3053,Bundesliga,26,12,7,2120,8,2,0,334
19/6/2011,Marco Gallozzi,1413286,776,7/27/1988,22,0,0,0,0,1512,4618,4618,124,102,13877,185,66,M/AM RC,1,2,2,1,3,3,1,3,2,2,1,11,14,11,7,13,9,8,10,10,8,14,4,13,14,8,14,5,14,10,11,14,9,17,10,10,9,17,14,13,12,11,13,5,11,13,20,9,4,10,11,10,10,10,13,18,8,13,15,13,12,16,1,1,20,17,20,1,17,M/AM RC,413,1,1,1,1,1,17,1,1,1,1,17,1,20,1,1,0,0,0,0,0,0,0,0,0,0,0,0,0,0,0,0,0,0,0,0,0,0,0,0,0,0,0,0,0,0,0,0,0,0,0,0,0,0,0,0,0,0,0,0,0,0,0,0,0,Marco Gallozzi,£270Th. ,32,185,Midfielder - Right Midfield,right,Tolentino Calcio,28,1,0,1838,6,0,0,303,6,0,0,332,20,2,0,984,16,1,0,916,3,0,0,177,1,0,0,37,24,0,2,1542,29,1,3,1928,Serie A,18,1,2,1146,3,0,0,143
19/6/2011,Manuel Schmiedebach,35008171,771,12/5/1988,22,0,0,0,0,4100,6700,6700,151,139,1030925,170,70,D/WB/DM/M RC,3,3,3,3,1,1,3,5,2,3,3,9,13,12,6,13,7,5,6,16,17,14,7,12,14,17,9,16,12,10,12,13,13,13,10,8,9,15,18,16,17,14,6,10,12,12,20,18,8,15,9,12,7,16,12,12,11,10,12,13,14,6,18,18,19,15,18,1,19,D/WB/DM/M RC,343,1,1,1,1,1,15,1,1,18,20,19,1,16,1,18,16809984,0,0,0,0,0,0,0,0,0,0,0,0,0,0,0,1,0,0,0,0,0,0,0,0,1,0,0,0,0,0,0,0,0,0,0,0,0,0,0,0,0,0,0,0,0,0,0,0,Manuel Schmiedebach,£4.95m ,31,171,Midfielder - Defensive Midfield,right,Without Club,33,0,6,2693,44,0,2,3344,36,1,1,2144,28,2,2,1936,28,0,1,2343,24,1,1,1967,28,0,2,2366,7,0,0,226,36,0,2,3032,Bundesliga,6,0,0,255,nan,nan,nan,nan
19/6/2011,Leocísio Sami,55011410,23,12/18/1988,22,0,0,0,0,1250,5000,4500,132,111,109170,184,78,AM RL,3,3,2,2,2,2,1,4,2,2,3,10,11,11,12,11,11,12,12,7,8,9,12,8,11,14,10,15,11,10,8,9,14,12,7,13,8,10,14,14,12,13,12,10,14,13,20,14,14,11,8,11,7,11,13,14,14,13,14,14,14,6,1,1,9,20,20,17,10,AM RL,505,1,1,14,10,17,20,1,1,1,1,1,1,9,1,1,0,0,0,0,0,0,0,0,0,0,0,0,0,0,0,0,0,0,0,0,0,0,0,0,0,0,0,0,0,0,0,0,0,0,0,0,0,0,0,0,0,0,0,0,0,0,0,0,0,,,,,,,,,,,,,,,,,,,,,,,,,,,,,,,,,,,,,,,,,,,,,,,,,,,,
19/6/2011,Lars Stindl,35011818,771,8/26/1988,22,0,0,1,0,4150,6550,6550,149,131,656115,180,73,M/AM RC,1,2,1,1,1,3,3,3,2,3,2,13,12,12,13,14,13,8,14,4,6,14,15,7,14,7,12,12,13,13,15,13,14,12,10,14,8,16,14,13,11,12,10,8,13,14,20,15,13,11,9,11,5,13,9,14,13,11,15,14,13,9,1,1,20,19,18,14,20,M/AM RC,413,1,1,5,19,14,18,1,1,1,13,20,14,18,1,1,4.39805E+12,0,0,0,0,0,0,0,1,0,0,0,0,0,0,0,0,0,0,0,0,0,0,1,0,0,0,0,0,0,0,0,0,0,0,0,0,0,0,0,0,0,0,1,0,0,0,0,0,Lars Stindl,£5.40m ,32,181,Forward - Second Striker,right,Borussia Mönchengladbach,34,2,5,2302,43,6,7,3766,29,4,9,2435,33,3,3,2837,22,11,4,1884,39,14,15,3384,44,18,9,3811,34,6,5,3001,22,3,3,1602,Bundesliga,30,11,3,1712,7,2,1,438
19/6/2011,Kevin Monnet-Paquet,8440065,769,8/19/1988,22,0,0,6,0,4600,5770,5770,140,128,779666,183,73,AM RL,2,1,1,2,3,2,2,2,2,2,3,10,11,14,10,13,10,7,11,6,5,11,12,4,14,8,12,11,13,13,9,10,11,13,6,14,9,12,14,14,13,13,10,8,14,17,20,14,12,12,8,14,6,8,11,14,16,8,14,14,14,8,1,1,13,20,20,17,14,AM RL,505,1,1,14,14,17,20,1,1,1,1,10,13,13,1,1,2.2518E+15,0,0,0,0,0,0,0,0,0,0,0,0,0,0,0,0,0,0,0,0,0,0,0,0,0,0,0,0,0,0,0,0,0,0,0,0,0,0,0,0,0,0,0,0,0,0,0,0,Kévin Monnet-Paquet,£2.25m ,32,184,Forward - Left Winger,right,AS Saint-Étienne,39,0,3,2484,40,7,2,3392,41,6,7,3175,38,4,4,2969,43,5,1,2538,43,5,2,3020,48,5,4,3355,31,2,2,1835,26,2,1,1695,Ligue 1,0,0,0,0,5,0,0,151
19/6/2011,Kevin Großkreutz,35021340,771,7/19/1988,22,3,0,1,1,5600,7150,7150,144,137,6008935,186,72,M/AM RL,1,1,1,1,2,3,1,2,3,1,1,7,9,12,14,11,6,12,9,11,12,11,9,13,11,16,15,19,13,12,10,14,12,11,9,14,11,19,19,13,10,14,12,11,13,15,20,19,12,15,12,13,5,18,11,13,20,14,12,5,6,15,13,14,17,20,18,20,14,M/AM RL,525,1,1,13,14,20,18,1,13,12,12,14,17,16,14,13,2.74878E+12,0,0,0,1,0,0,0,0,0,0,0,0,0,0,0,0,0,0,0,0,0,0,0,0,0,0,0,0,0,0,0,0,0,0,0,0,0,0,0,1,0,1,0,0,0,0,0,0,Kevin Großkreutz,£7.20m ,32,186,Defender - Right-Back,right,Without Club,43,9,7,3306,43,8,10,3258,44,2,7,2676,50,3,6,4357,25,0,4,1650,15,0,0,1350,17,1,0,1115,28,3,3,2260,36,0,3,3054,Bundesliga,15,1,1,1075,nan,nan,nan,nan
19/6/2011,Karim Aït Fana,8442298,34,2/25/1989,22,0,0,0,0,4700,5939,5900,160,132,573780,175,65,AM RL,1,2,3,3,2,1,3,4,3,3,3,9,11,16,12,14,8,6,11,5,2,12,10,3,16,7,13,8,12,12,13,12,14,14,5,14,5,9,12,17,16,12,7,20,14,14,8,14,7,13,7,16,11,8,5,16,13,11,15,15,15,7,1,1,12,20,18,20,10,AM RL,505,1,1,14,10,20,18,1,1,1,1,1,12,12,1,1,2.2518E+15,0,0,0,0,0,0,0,0,0,0,0,0,0,0,0,0,0,0,0,0,0,0,0,0,0,0,0,0,0,0,0,0,0,0,0,0,0,0,0,0,0,0,0,0,0,0,0,0,Karim Aït-Fana,£1.80m ,31,175,Forward - Left Winger,right,Without Club,25,0,4,1518,15,2,2,779,10,1,2,356,4,1,1,110,nan,nan,nan,nan,nan,nan,nan,nan,23,0,1,1073,3,0,0,91,nan,nan,nan,nan,Ligue 1,nan,nan,nan,nan,nan,nan,nan,nan
19/6/2011,João Aurélio,55011464,788,8/17/1988,22,0,0,5,1,2500,5500,5500,130,111,170128,185,75,D/AM R,1,1,3,3,1,3,2,1,3,2,3,13,13,14,12,12,10,10,10,7,7,10,11,8,14,12,11,13,10,10,10,11,14,13,9,13,8,10,12,13,13,12,12,8,14,13,20,11,12,11,7,12,9,12,13,12,14,13,14,14,14,5,17,7,7,20,20,13,10,D/AM R,522,1,1,14,10,13,20,1,7,17,1,7,7,7,7,7,0,0,0,0,0,0,0,0,0,0,0,0,0,0,0,0,0,0,0,0,0,0,0,0,0,0,0,0,0,0,0,0,0,0,0,0,0,0,0,0,0,0,0,0,0,0,0,0,0,João Aurélio,£720Th. ,32,182,Defender - Right-Back,right,Pafos FC,24,0,1,1115,22,0,0,1631,26,1,1,1865,29,2,2,1886,42,1,4,3713,38,0,5,3298,31,0,5,1923,32,0,3,2429,21,2,5,1860,Liga NOS,30,2,3,2515,7,0,0,491
19/6/2011,Jérémy Pied,8440220,769,2/23/1989,22,0,0,5,0,4400,5550,5550,145,123,288104,173,69,AM RL,2,3,1,1,3,1,3,1,1,2,2,13,13,14,9,14,11,8,12,6,2,12,9,4,14,7,13,10,12,12,14,14,15,12,7,12,6,12,12,15,14,11,6,8,13,13,20,11,8,14,7,14,7,8,14,13,15,14,15,15,15,5,1,1,15,20,20,17,10,AM RL,505,1,1,1,10,17,20,1,1,1,1,10,15,15,1,1,2.25235E+15,0,0,0,0,0,0,0,0,0,0,0,0,0,0,0,0,0,0,0,0,0,0,0,0,0,0,0,0,0,0,0,0,0,0,0,0,0,0,0,1,0,0,0,0,0,0,0,0,Jérémy Pied,£1.58m ,31,173,Defender - Right-Back,right,LOSC Lille,36,3,4,1192,19,1,3,498,31,0,7,1817,26,2,1,1377,43,4,9,3019,35,0,3,3085,6,0,0,277,6,0,1,500,13,0,2,616,Ligue 1,9,0,0,731,3,0,0,176
19/6/2011,Jeffrey Sarpong,856984,784,8/3/1988,22,0,0,0,0,4250,5708,5708,147,125,422810,176,65,AM RLC,1,1,3,3,3,1,1,5,3,3,3,13,13,14,12,15,14,9,14,3,5,13,10,5,14,11,11,10,9,8,12,10,10,12,7,13,4,9,10,14,15,7,7,14,11,14,20,13,13,8,8,8,9,13,13,10,11,11,16,12,5,7,1,1,15,20,16,18,20,AM RLC,506,1,1,8,20,18,16,1,1,1,1,15,15,12,1,1,2.2518E+15,0,0,0,0,0,0,0,0,0,1,0,0,0,0,0,0,0,0,0,0,0,0,0,0,0,0,0,0,0,0,0,0,0,0,0,0,0,0,0,0,0,0,0,0,0,0,0,0,Jeffrey Sarpong,£900Th. ,32,176,Forward - Left Winger,right,Without Club,19,2,1,483,14,1,1,566,14,1,0,612,32,2,4,2454,36,3,6,2349,13,0,1,676,25,5,5,2031,20,1,5,1275,22,0,1,1111,LaLiga,nan,nan,nan,nan,nan,nan,nan,nan
19/6/2011,Jaime,67006023,796,6/29/1988,22,0,0,0,0,2000,4000,4000,105,80,86772,178,67,M/AM R,2,1,3,2,2,2,3,3,1,3,1,9,11,9,3,10,8,6,9,8,3,6,8,9,11,13,6,5,11,9,8,8,10,12,9,11,8,15,13,13,9,11,9,10,18,13,20,9,2,10,6,10,5,10,11,14,9,7,9,10,8,10,1,1,17,20,20,1,1,M/AM R,522,1,1,1,1,1,20,1,1,1,1,1,1,17,1,1,0,0,0,0,0,0,0,0,0,0,0,0,0,0,0,0,0,0,0,0,0,0,0,0,0,0,0,0,0,0,0,0,0,0,0,0,0,0,0,0,0,0,0,0,0,0,0,0,0,,,,,,,,,,,,,,,,,,,,,,,,,,,,,,,,,,,,,,,,,,,,,,,,,,,,
19/6/2011,Innocent Emeghara,98001614,798,5/27/1989,22,1,0,8,5,4500,6500,5750,135,119,790514,170,68,S RL,3,3,1,1,2,2,1,3,2,3,3,3,6,12,11,7,6,7,9,3,6,9,13,8,8,12,8,14,13,7,6,7,13,14,7,11,4,12,15,18,15,12,8,8,13,17,20,14,13,10,5,8,3,12,12,13,7,9,12,11,12,13,1,1,1,15,15,15,1,S RL,605,1,1,20,1,15,15,1,1,1,1,1,1,1,1,1,2.2518E+15,0,0,0,0,0,0,0,0,0,0,0,0,0,0,0,0,0,0,0,0,0,0,0,0,0,0,0,0,0,0,0,0,0,0,0,0,0,0,0,0,0,0,0,0,0,0,0,0,Innocent Emeghara,£2.03m ,31,170,Forward - Centre-Forward,right,FC Winterthur,39,10,11,2660,38,12,3,2099,18,7,2,1381,30,4,7,1583,15,6,0,1052,7,0,0,183,nan,nan,nan,nan,28,9,4,2117,18,5,2,1281,Ligue 1,32,7,0,1798,2,0,0,27
19/6/2011,Hugo Vieira,55021889,788,7/25/1988,22,0,0,0,0,3000,5500,5500,128,112,345435,172,70,AM/S RL,1,2,2,1,2,3,3,1,3,2,1,9,11,11,11,11,9,5,9,4,6,9,10,6,12,11,12,15,8,10,8,9,13,14,11,13,7,8,13,15,13,6,6,10,10,14,20,8,7,11,7,12,8,14,10,16,7,11,10,13,13,6,1,1,9,20,20,20,7,AM/S RL,515,1,1,17,7,20,20,1,1,1,1,1,9,1,1,1,0,0,0,0,0,0,0,0,0,0,0,0,0,0,0,0,0,0,0,0,0,0,0,0,0,0,0,0,0,0,0,0,0,0,0,0,0,0,0,0,0,0,0,0,0,0,0,0,0,Hugo Vieira,£1.62m ,32,178,Forward - Centre-Forward,right,Without Club,28,11,0,1582,33,7,3,2653,18,8,0,1258,20,3,2,1324,22,3,2,1356,35,20,10,2458,54,26,2,3327,44,21,5,2709,nan,nan,nan,nan,Liga NOS,13,2,1,486,nan,nan,nan,nan
19/6/2011,Hernán Pérez,79003362,1655,2/25/1989,22,10,0,0,0,4000,5750,6000,148,123,536021,180,77,AM R,3,1,3,1,2,2,1,7,2,1,1,10,10,13,12,13,10,10,9,10,5,11,10,8,12,8,12,12,11,11,13,12,10,9,6,15,7,11,13,15,13,9,8,11,10,13,20,12,9,9,6,10,13,10,8,5,10,14,14,8,18,6,1,1,8,20,20,7,13,AM R,502,1,1,15,13,7,20,1,1,1,1,1,1,8,1,1,0,0,0,0,0,0,0,0,0,0,0,0,0,0,0,0,0,0,0,0,0,0,0,0,0,0,0,0,0,0,0,0,0,0,0,0,0,0,0,0,0,0,0,0,0,0,0,0,0,Hernán Pérez,£1.80m ,31,180,Forward - Right Winger,right,Al-Ahli SC,34,4,1,2449,27,4,1,1538,16,2,2,889,27,3,3,1712,16,4,4,1250,33,7,2,2517,35,4,0,1977,17,0,0,701,21,2,2,892,LaLiga,20,4,3,1755,4,1,0,359
19/6/2011,Heldon,55014369,12,11/14/1988,22,2,1,2,1,897,5115,4518,121,93,116069,174,68,AM RL,1,3,3,1,2,2,3,1,3,1,1,9,10,11,9,10,7,5,6,4,5,7,9,4,10,8,10,11,8,9,6,9,13,14,8,12,6,6,9,13,12,5,6,12,13,13,20,7,5,11,7,14,10,10,13,17,14,12,14,14,13,6,1,1,9,20,20,17,7,AM RL,505,1,1,7,7,17,20,1,1,1,1,1,1,9,1,1,0,0,0,0,0,0,0,0,0,0,0,0,0,0,0,0,0,0,0,0,0,0,0,0,0,0,0,0,0,0,0,0,0,0,0,0,0,0,0,0,0,0,0,0,0,0,0,0,0,Héldon,£720Th. ,31,174,Forward - Left Winger,right,FC Shabab Al-Ahli Dubai,19,1,1,748,37,4,3,1710,32,5,0,2034,31,11,5,2215,18,1,1,680,27,5,4,1828,33,2,6,2313,37,6,11,2581,32,12,12,2497,Liga NOS,28,8,7,2287,1,0,0,90
19/6/2011,Giacomo Bonaventura,43006720,776,5/13/1989,22,0,0,0,0,3766,6414,6400,157,129,506351,181,75,M/AM RLC,3,1,2,2,2,3,2,3,1,3,3,11,13,14,11,14,11,9,12,7,7,14,11,10,15,9,9,12,12,12,13,12,17,14,11,13,11,12,11,15,14,8,9,10,13,14,20,13,9,15,7,15,4,15,12,16,12,12,14,12,9,12,1,1,20,19,19,19,20,M/AM RLC,416,1,1,1,19,17,16,1,1,1,12,20,19,19,1,1,144,0,0,0,0,1,0,0,1,0,0,0,0,0,0,0,0,0,0,0,0,0,0,0,0,0,0,0,0,0,0,0,0,0,0,0,0,0,0,0,0,0,0,0,0,0,0,0,0,Giacomo Bonaventura,£2.70m ,31,180,Midfielder - Central Midfield,right,ACF Fiorentina,33,9,5,1952,30,2,1,1835,36,8,4,2702,31,5,4,2520,36,7,5,2843,39,7,11,3310,22,5,5,1874,47,9,4,3557,10,3,0,797,Serie A,32,4,6,1530,5,0,1,388
19/6/2011,Gabriel Obertan,8442347,769,2/26/1989,22,0,0,11,1,4650,5849,6500,160,130,4525811,186,79,AM RL,3,1,2,3,2,1,3,6,1,3,1,9,9,14,9,14,6,6,12,4,2,9,10,1,14,5,7,6,8,7,9,5,10,18,4,11,3,8,7,17,14,12,12,13,12,16,20,10,11,8,8,8,8,7,8,16,14,7,10,15,15,6,1,1,10,20,20,17,8,AM RL,505,1,1,14,8,17,20,1,1,1,1,5,10,10,1,1,34359738368,0,0,0,0,0,0,0,0,0,0,0,0,0,0,0,0,0,0,0,0,0,0,0,0,0,0,0,0,0,0,0,0,0,0,0,1,0,0,0,0,0,0,0,0,0,0,0,0,Gabriel Obertan,£2.70m ,31,186,Midfielder - Attacking Midfield,right,Büyüksehir Belediye Erzurumspor,28,7,6,1970,27,2,4,1761,26,4,4,1433,7,0,1,289,18,1,2,1085,6,0,1,350,21,2,3,1128,36,4,9,2881,33,2,8,2901,Premier League,32,3,3,2334,4,0,1,318
19/6/2011,Florin Berenguer-Bohrer,34001556,769,4/1/1989,22,0,0,0,0,2250,3400,3400,130,103,29698,182,70,AM RL,2,1,2,3,2,2,1,1,3,1,3,10,11,13,6,11,9,6,8,7,4,9,8,3,13,9,9,11,12,12,9,12,10,12,6,11,6,8,13,12,13,13,8,10,12,15,20,13,6,13,9,10,7,8,13,12,13,10,6,10,12,12,1,1,15,20,20,18,1,AM RL,505,1,1,1,1,18,20,1,1,1,1,1,15,15,1,1,0,0,0,0,0,0,0,0,0,0,0,0,0,0,0,0,0,0,0,0,0,0,0,0,0,0,0,0,0,0,0,0,0,0,0,0,0,0,0,0,0,0,0,0,0,0,0,0,0,Florin Bérenguer,£450Th. ,31,182,Midfielder - Attacking Midfield,right,Melbourne City FC,23,2,4,1601,20,1,0,1073,38,4,5,2908,28,6,6,1965,32,6,1,2286,6,1,0,307,26,0,3,1663,29,5,5,2314,20,0,3,1488,Ligue 1,19,3,1,1426,nan,nan,nan,nan
19/6/2011,Felipe Mattioni,8833559,1651,10/15/1988,22,0,0,0,0,4750,6000,6500,150,132,781919,177,72,D/WB R,1,2,3,2,2,3,2,6,1,2,1,12,13,15,7,12,11,8,10,12,12,13,5,12,16,14,13,12,12,12,13,11,13,14,6,14,11,10,12,17,15,8,10,7,10,15,20,13,9,12,11,10,10,14,12,15,8,12,14,15,11,17,18,20,15,9,20,1,1,D/WB R,222,1,1,1,1,1,9,1,1,18,1,1,1,15,1,20,32,0,0,0,0,0,1,0,0,0,0,0,0,0,0,0,0,0,0,0,0,0,0,0,0,0,0,0,0,0,0,0,0,0,0,0,0,0,0,0,0,0,0,0,0,0,0,0,0,Felipe Mattioni,£1.80m ,32,178,Defender - Right-Back,right,Esporte Clube SÃ£o JosÃ© (RS),nan,nan,nan,nan,nan,nan,nan,nan,7,0,0,373,3,0,0,254,8,0,0,209,9,0,1,663,3,0,1,198,22,1,1,1897,10,0,1,740,LaLiga,3,0,0,179,nan,nan,nan,nan
19/6/2011,Elliott Bennett,28006433,765,12/18/1988,22,0,0,0,0,3350,5550,5900,136,111,580394,178,73,M/AM RLC,1,2,2,1,1,1,2,2,1,1,1,14,14,11,7,12,13,5,13,3,8,12,9,8,11,7,9,7,10,11,13,10,14,9,5,13,11,13,12,15,9,8,9,10,14,14,20,14,8,15,5,12,2,16,10,12,13,11,14,13,16,1,9,9,19,20,20,19,19,M/AM RLC,526,1,1,1,19,19,20,1,1,9,1,19,15,19,1,9,0,0,0,0,0,0,0,0,0,0,0,0,0,0,0,0,0,0,0,0,0,0,0,0,0,0,0,0,0,0,0,0,0,0,0,0,0,0,0,0,0,0,0,0,0,0,0,0,0,Elliott Bennett,£2.70m ,31,179,Defender - Right-Back,right,Blackburn Rovers,53,8,20,4571,37,1,7,2295,29,2,3,1284,6,1,3,442,21,0,1,1315,42,2,5,3091,31,4,2,2153,47,2,7,3962,42,1,5,3611,Premier League,42,0,4,2829,1,0,0,11
19/6/2011,Diego Perotti,14005006,1649,7/26/1988,22,1,0,0,0,6050,7250,7250,170,150,7588933,179,70,M/AM RL,1,2,1,2,1,3,1,4,1,2,1,14,15,16,13,14,12,8,13,5,4,14,11,4,15,9,13,9,11,13,15,13,13,16,13,16,4,7,11,16,15,12,8,14,9,16,20,10,9,11,8,13,11,13,17,13,14,12,15,14,12,7,1,1,16,20,15,20,10,M/AM RL,525,1,1,11,10,20,15,1,1,1,1,1,16,10,1,1,7.04031E+13,0,0,0,0,0,0,0,0,0,0,0,0,0,0,0,0,0,0,0,0,0,0,0,0,0,0,0,0,0,0,0,0,0,0,0,1,0,0,0,0,0,0,0,0,0,0,1,0,Diego Perotti,£8.10m ,32,179,Forward - Left Winger,right,Fenerbahce SK,48,4,12,3331,19,0,3,1156,20,1,1,965,20,5,2,986,28,4,6,2393,34,4,7,2571,45,10,10,2362,35,8,5,2364,15,5,1,811,LaLiga,26,6,4,1131,nan,nan,nan,nan
19/6/2011,Daniel Wass,936891,764,5/31/1989,22,2,0,14,0,4500,6000,5500,137,122,125133,181,74,D/WB/M/AM R,1,3,3,2,2,1,2,1,3,1,3,6,13,12,11,11,13,11,10,13,10,13,8,13,11,16,12,16,10,10,8,7,10,10,9,12,8,8,11,16,13,13,10,12,11,15,20,14,10,12,13,13,7,18,6,16,13,13,14,13,8,8,20,18,17,17,20,3,13,D/WB/M/AM R,132,1,1,11,10,1,17,10,3,20,14,13,1,17,1,18,1.37439E+11,0,0,0,0,0,1,0,0,0,0,0,0,0,0,0,0,0,0,0,0,0,0,0,0,0,0,0,0,0,0,0,0,0,0,0,0,0,1,0,0,0,0,0,0,0,0,0,0,Daniel Wass,£2.70m ,31,178,Defender - Right-Back,right,Valencia CF,39,7,4,3116,31,4,4,2540,39,2,2,3492,42,11,3,3520,35,10,4,2673,43,3,6,3177,54,7,5,3722,39,4,9,3081,50,2,7,3742,Ligue 1,45,2,6,3632,7,1,1,619
19/6/2011,Daniel Caligiuri,91003264,771,1/15/1989,22,0,0,0,0,3750,6000,6000,132,128,507049,182,79,AM RL,3,2,1,2,1,3,1,1,2,1,2,10,14,14,11,10,8,8,9,13,8,13,7,9,9,13,12,11,8,11,10,8,9,9,8,13,14,12,14,14,14,16,9,10,12,15,20,15,13,5,8,8,8,13,14,15,8,16,14,10,14,1,1,1,9,20,20,18,9,AM RL,505,1,1,1,9,18,20,1,1,1,1,7,9,5,1,1,7.09185E+13,0,0,0,0,1,0,0,0,0,0,0,0,0,0,0,0,0,0,0,0,0,0,0,0,0,0,0,0,0,0,0,0,0,0,0,0,0,0,0,1,0,0,0,0,0,0,1,0,Daniel Caligiuri,£2.25m ,32,182,Midfielder - Right Midfield,right,FC Augsburg,26,0,2,1288,28,7,6,1933,33,8,3,2831,27,1,3,1236,45,10,9,2718,40,3,7,2437,41,6,6,2969,37,6,11,3187,40,7,5,3516,Bundesliga,30,4,5,2466,5,2,1,421
19/6/2011,Carlitos,55012418,788,9/24/1988,22,0,0,0,0,1274,3500,3500,110,85,40929,182,70,AM RL,2,3,2,1,1,2,3,1,2,2,1,10,11,12,8,10,8,5,8,5,8,8,8,6,12,8,8,10,8,8,7,8,14,14,9,11,6,8,10,12,12,8,8,9,11,12,20,8,7,10,8,10,10,11,15,14,15,10,12,13,13,7,1,1,9,20,20,15,7,AM RL,505,1,1,7,7,15,20,1,1,1,1,1,1,9,1,1,0,0,0,0,0,0,0,0,0,0,0,0,0,0,0,0,0,0,0,0,0,0,0,0,0,0,0,0,0,0,0,0,0,0,0,0,0,0,0,0,0,0,0,0,0,0,0,0,0,Carlitos,£270Th. ,38,176,Midfielder - Left Midfield,right,Retired,9,0,0,382,5,0,0,201,25,2,2,1927,33,4,1,2396,37,6,14,3026,35,4,7,3016,33,5,10,2640,12,4,2,886,8,0,1,345,Bundesliga,nan,nan,nan,nan,nan,nan,nan,nan
19/6/2011,Benjamin Moukandjo,34001576,11,11/12/1988,22,2,0,0,0,2522,5281,4009,140,117,790514,179,76,M/AM R,2,2,2,2,3,3,2,1,3,1,3,11,11,14,9,12,6,7,9,5,5,10,10,5,14,9,11,10,12,12,11,11,14,13,5,14,7,9,12,16,14,13,8,5,11,15,20,12,12,13,9,1,13,10,7,15,10,7,6,14,7,7,1,1,16,20,20,1,1,M/AM R,522,1,1,14,1,1,20,1,1,1,1,1,1,16,1,1,2,0,1,0,0,0,0,0,0,0,0,0,0,0,0,0,0,0,0,0,0,0,0,0,0,0,0,0,0,0,0,0,0,0,0,0,0,0,0,0,0,0,0,0,0,0,0,0,0,Benjamin Moukandjo,£2.03m ,31,180,Forward - Centre-Forward,right,Valenciennes FC,35,8,2,2693,29,5,1,1560,39,9,2,2510,27,9,2,1927,32,8,1,2004,34,13,2,2372,38,21,6,3067,19,7,2,1582,nan,nan,nan,nan,Ligue 1,6,1,0,244,nan,nan,nan,nan
19/6/2011,Änis Ben-Hatira,35000569,771,7/18/1988,22,0,0,9,1,4613,6459,6268,143,125,364317,181,78,AM RC,1,1,2,1,1,3,3,1,3,2,2,13,12,15,7,16,13,6,11,6,5,14,12,6,16,10,7,12,9,6,10,7,7,17,5,8,4,5,14,13,14,15,9,20,12,16,17,15,12,6,11,10,11,10,3,5,10,12,5,11,9,14,1,1,10,20,18,14,20,AM RC,503,1,1,13,20,14,18,1,1,1,1,10,10,10,1,1,2.26063E+15,0,0,0,0,0,0,0,0,0,0,0,1,0,0,0,0,0,0,0,0,0,0,0,0,0,0,0,0,0,0,1,0,0,0,0,1,0,0,0,0,0,0,0,1,0,0,0,0,Änis Ben-Hatira,£1.35m ,32,183,Midfielder - Attacking Midfield,both,Without Club,30,10,3,2087,23,4,3,1279,19,4,3,1271,22,5,3,1659,16,4,4,847,14,3,2,912,25,3,1,1581,8,1,0,325,17,5,2,1053,Bundesliga,21,2,1,1146,nan,nan,nan,nan
19/6/2011,Alexis Sánchez,75000261,1652,12/19/1988,22,41,14,4,1,7250,8400,8400,184,169,25480545,168,69,AM/S RLC,2,3,1,3,1,3,2,9,2,3,3,10,14,19,12,16,8,12,14,7,6,14,12,12,16,15,16,18,14,8,15,8,16,17,7,14,4,9,16,19,16,15,6,7,17,16,20,16,14,13,9,14,6,14,11,19,15,15,16,11,14,4,1,1,10,20,20,15,19,AM/S RLC,516,1,1,19,19,15,20,1,1,1,1,1,1,10,1,1,7.04031E+13,0,0,0,0,1,0,0,0,0,0,0,0,0,0,0,0,0,0,0,0,0,0,0,0,0,0,0,0,0,0,0,0,0,0,0,1,0,0,0,0,0,0,0,0,0,0,1,0,Alexis Sánchez,£27.00m ,31,168,Forward - Centre-Forward,right,Inter Milan,33,12,11,2517,41,14,7,2640,46,11,14,2619,54,21,16,3418,52,25,12,4326,41,17,11,3289,51,30,18,4229,40,11,9,3252,27,2,4,1240,LaLiga,32,4,10,1392,5,0,2,165
19/6/2011,Yannick Sagbo,34001056,24,4/12/1988,23,0,0,5,2,4050,5700,5100,140,114,326476,183,78,S R,2,3,1,2,2,3,1,6,1,1,1,5,9,12,11,13,7,11,12,6,4,11,12,2,13,7,12,11,12,12,9,10,15,12,7,14,7,9,12,15,11,14,10,5,14,14,20,10,14,12,7,14,10,8,6,13,13,12,14,14,14,5,1,1,10,15,15,1,1,S R,602,1,1,20,1,1,15,1,1,1,1,1,1,10,1,1,16,0,0,0,0,1,0,0,0,0,0,0,0,0,0,0,0,0,0,0,0,0,0,0,0,0,0,0,0,0,0,0,0,0,0,0,0,0,0,0,0,0,0,0,0,0,0,0,0,Yannick Sagbo,£2.25m ,32,183,Forward - Centre-Forward,right,Without Club,34,10,5,2505,35,12,5,2778,41,8,6,2795,34,4,2,2034,13,0,0,520,13,11,0,1156,19,13,2,1698,20,10,1,1711,21,9,0,1890,Ligue 1,10,4,1,900,3,0,0,233
19/6/2011,Wesley,19040469,1651,6/24/1987,23,2,0,0,0,5600,7000,7050,156,140,3503470,179,63,DM/M RC,3,1,2,3,1,3,3,3,1,1,1,12,14,13,9,15,7,8,10,10,13,15,11,12,15,17,10,15,8,10,10,8,15,14,10,13,9,14,18,17,16,8,9,14,14,15,20,17,7,12,7,11,12,17,14,13,13,12,11,8,12,5,14,12,20,15,15,1,20,DM/M RC,423,1,1,10,15,1,10,1,1,14,18,20,1,15,1,12,1074790484,0,0,1,0,1,0,1,0,0,0,0,0,0,0,0,0,0,0,0,0,1,0,0,0,0,0,0,0,0,0,1,0,0,0,0,0,0,0,0,0,0,0,0,0,0,0,0,0,Wesley,£4.05m ,33,179,Midfielder - Central Midfield,right,Avaí Futebol Clube (SC),25,1,3,1945,10,1,1,461,34,7,9,2823,26,2,2,2089,27,1,2,1530,30,1,1,1915,12,0,0,714,17,0,1,919,33,0,1,2859,Bundesliga,1,0,0,13,nan,nan,nan,nan
19/6/2011,Vincent Nogueira,8440962,769,1/16/1988,23,0,0,1,0,4700,5877,5877,149,130,456119,170,60,DM/M/AM RC,3,2,2,1,3,2,3,1,2,2,1,11,12,13,8,14,11,6,14,8,8,13,7,7,14,7,13,12,13,13,13,13,13,12,8,12,12,14,15,15,14,11,5,10,8,13,20,15,6,13,7,15,15,15,8,13,15,15,15,15,15,5,8,8,20,16,16,10,20,DM/M/AM RC,433,1,1,1,1,10,16,1,1,8,18,20,10,16,1,8,0,0,0,0,0,0,0,0,0,0,0,0,0,0,0,0,0,0,0,0,0,0,0,0,0,0,0,0,0,0,0,0,0,0,0,0,0,0,0,0,0,0,0,0,0,0,0,0,0,Vincent Nogueira,£1.80m ,32,170,Midfielder - Central Midfield,right,Retired,26,1,1,758,31,2,1,2315,32,2,3,2511,50,3,5,4056,31,5,2,2444,9,2,0,757,27,1,4,1854,7,0,0,400,2,0,0,47,Ligue 1,5,0,0,431,nan,nan,nan,nan
19/6/2011,Victor Anichebe,5003736,38,4/23/1988,23,7,1,0,0,4150,6500,6150,140,122,934938,186,80,AM/S R,1,1,3,2,3,3,2,5,2,2,3,6,10,11,13,11,7,14,10,5,7,9,12,4,9,16,9,13,13,11,13,13,13,9,6,13,11,14,14,13,9,16,14,6,14,15,20,9,18,12,8,10,10,9,14,11,10,12,13,14,11,5,1,1,13,18,18,14,1,AM/S R,622,1,1,20,1,14,18,1,1,1,1,1,13,13,1,1,1.75922E+13,0,1,0,0,0,0,0,0,0,1,0,0,0,0,0,0,0,0,0,0,0,0,0,0,0,0,0,0,0,0,0,0,0,0,0,0,0,0,0,0,0,0,0,0,1,0,0,0,Victor Anichebe,£3.15m ,32,190,Forward - Centre-Forward,right,Without Club,22,2,1,1080,17,6,0,707,33,8,10,2187,25,3,3,1216,26,6,3,1360,14,0,0,628,29,5,2,2007,nan,nan,nan,nan,nan,nan,nan,nan,Premier League,nan,nan,nan,nan,nan,nan,nan,nan
19/6/2011,Sidney Sam,35006408,771,1/31/1988,23,0,0,7,1,5000,7000,7000,158,142,1795803,174,72,AM RL,3,2,2,2,2,3,2,8,1,2,2,9,13,16,17,16,10,5,17,7,5,12,14,6,15,11,9,10,13,9,8,8,12,18,5,10,5,6,12,18,18,9,7,20,13,16,7,13,8,10,6,13,6,12,10,14,11,13,14,13,11,8,1,1,14,20,20,16,14,AM RL,505,1,1,15,14,16,20,1,1,1,1,8,13,14,1,1,5.49756E+11,1,1,0,0,0,0,0,0,1,0,0,1,0,0,0,0,0,0,0,0,0,0,0,0,0,0,0,0,0,0,0,0,0,0,0,0,0,0,0,1,0,0,0,0,0,0,0,0,Sidney Sam,£5.85m ,32,174,Forward - Right Winger,left,Antalyaspor,40,12,8,2870,25,6,4,2045,28,5,5,1177,31,13,9,2026,16,0,1,762,8,1,0,318,23,4,3,1669,24,0,1,1726,19,2,3,1147,Bundesliga,23,6,8,1544,3,1,0,123
19/6/2011,Samir Nasri,8428584,769,6/26/1987,23,22,2,6,0,7500,8000,8450,175,164,18254545,177,75,M/AM RLC,3,3,2,1,2,3,1,7,2,1,2,12,12,17,15,17,15,5,13,2,6,15,12,9,17,12,14,12,15,12,15,15,16,17,10,16,8,13,13,15,18,18,8,15,15,14,20,15,9,13,6,14,12,14,14,16,14,14,13,14,11,10,1,1,17,20,18,18,20,M/AM RLC,526,1,1,1,20,18,18,1,1,1,10,17,16,16,1,1,5.54051E+11,0,0,0,0,0,0,0,0,0,0,1,0,0,0,0,0,0,0,0,1,0,0,0,0,0,0,0,0,0,0,0,0,1,0,0,0,0,0,0,1,0,0,0,0,0,0,0,0,Samir Nasri,£22.50m ,33,177,Midfielder - Attacking Midfield,right,Without Club,46,15,5,3416,46,6,9,3280,38,5,9,2472,46,11,12,3277,33,3,7,2100,13,2,3,619,31,3,3,2415,8,2,1,720,6,0,2,303,Premier League,9,2,0,594,nan,nan,nan,nan
19/6/2011,Roland Lamah,8168308,757,12/31/1987,23,5,0,7,2,5050,6250,5600,140,125,435968,180,71,AM RL,1,1,2,1,2,2,2,4,3,1,1,11,13,14,7,9,9,11,11,11,5,11,13,4,14,8,12,12,12,11,12,8,12,13,5,13,7,10,12,16,14,13,10,20,14,15,8,13,11,12,8,14,7,10,14,14,13,13,11,15,15,6,10,10,15,20,18,20,8,AM RL,505,1,1,12,8,20,18,1,10,1,1,1,15,15,10,1,2.2518E+15,0,0,0,0,0,0,0,0,0,0,0,0,0,0,0,0,0,0,0,0,0,0,0,0,0,0,0,0,0,0,0,0,0,0,0,0,0,0,0,0,0,0,0,0,0,0,0,0,Roland Lamah,£1.80m ,32,180,Forward - Left Winger,left,Without Club,27,3,7,1865,38,3,3,2544,24,2,2,1105,18,3,4,954,26,8,6,2044,45,8,15,3203,37,11,4,2569,32,9,5,2002,28,1,5,1783,LaLiga,nan,nan,nan,nan,nan,nan,nan,nan
19/6/2011,Renato Augusto,320569,1651,2/8/1988,23,3,0,3,0,6750,7400,7400,163,153,2099197,186,91,AM RLC,3,3,1,1,1,2,1,9,2,2,1,10,12,17,11,17,11,6,13,5,8,14,12,9,17,13,14,9,11,9,16,10,10,16,10,12,8,9,14,16,15,8,12,15,8,16,20,13,12,11,3,12,15,15,16,13,13,14,14,12,15,8,1,1,15,20,18,15,20,AM RLC,506,1,1,12,20,15,18,1,1,1,1,14,14,15,1,1,1207959556,0,0,1,0,0,0,0,0,0,0,0,0,0,0,0,0,0,0,0,0,0,0,0,0,0,0,0,1,0,0,1,0,0,0,0,0,0,0,0,0,0,0,0,0,0,0,0,0,Renato Augusto,£9.00m ,32,186,Midfielder - Central Midfield,right,Beijing Sinobo Guoan,35,8,11,2807,23,0,3,1666,32,2,2,1730,30,1,8,2093,40,5,9,3391,27,6,3,2136,30,4,6,2608,33,10,16,2996,38,16,13,3377,Bundesliga,13,2,4,724,nan,nan,nan,nan
19/6/2011,Rachid Bouallal,35020966,34,11/9/1987,23,0,0,0,0,1008,3564,3564,95,76,16652,182,80,AM RL,3,3,2,2,1,1,1,5,1,2,3,9,9,11,7,9,8,7,7,6,5,9,7,7,11,10,8,7,6,6,11,6,10,8,5,8,6,8,7,11,11,8,11,20,13,12,15,8,8,8,5,10,10,10,9,9,7,6,12,11,8,5,1,5,13,20,20,17,10,AM RL,505,1,1,15,10,17,20,1,1,1,1,7,10,13,3,5,0,0,0,0,0,0,0,0,0,0,0,0,0,0,0,0,0,0,0,0,0,0,0,0,0,0,0,0,0,0,0,0,0,0,0,0,0,0,0,0,0,0,0,0,0,0,0,0,0,,,,,,,,,,,,,,,,,,,,,,,,,,,,,,,,,,,,,,,,,,,,,,,,,,,,
19/6/2011,Philipp Klingmann,35023847,771,4/22/1988,23,0,0,0,0,1000,4400,4100,104,88,21437,178,78,D R,3,1,1,2,3,1,2,4,2,3,2,8,10,10,7,10,8,6,7,15,10,10,7,10,10,7,11,10,11,11,8,11,8,5,9,12,13,11,13,11,10,11,9,6,10,11,20,14,11,11,5,10,5,16,8,8,11,10,10,10,10,5,20,9,15,10,20,9,1,D R,102,1,1,1,1,1,10,1,9,20,1,1,1,15,1,9,0,0,0,0,0,0,0,0,0,0,0,0,0,0,0,0,0,0,0,0,0,0,0,0,0,0,0,0,0,0,0,0,0,0,0,0,0,0,0,0,0,0,0,0,0,0,0,0,0,Philipp Klement,£90Th. ,28,175,Midfielder - Attacking Midfield,left,VfB Stuttgart,18,3,15,1578,18,3,6,1308,26,2,5,1708,28,6,7,2189,32,5,8,1626,18,6,3,1323,24,5,4,1844,20,3,5,1374,35,16,9,3003,Bundesliga,21,0,4,1213,5,0,1,85
19/6/2011,Pereirinha,55001512,788,3/2/1988,23,0,0,11,0,2250,5750,5750,130,115,126606,173,68,D/WB/M/AM R,3,3,3,2,3,1,2,4,3,3,2,13,13,13,9,11,8,7,10,10,10,10,10,13,12,11,10,13,13,11,12,9,11,13,9,14,9,10,11,16,14,7,8,8,13,16,20,11,8,10,8,11,7,16,11,11,15,12,16,16,16,3,18,17,20,18,20,10,12,D/WB/M/AM R,442,1,1,1,10,8,18,1,1,18,1,12,10,20,1,17,19,1,1,0,0,1,0,0,0,0,0,0,0,0,0,0,0,0,0,0,0,0,0,0,0,0,0,0,0,0,0,0,0,0,0,0,0,0,0,0,0,0,0,0,0,0,0,0,0,Bruno Pereirinha,£2.25m ,32,174,Forward - Right Winger,right,Without Club,24,1,2,1067,24,0,1,1192,14,0,1,784,11,0,1,767,16,1,0,527,0,0,0,0,nan,nan,nan,nan,18,0,0,960,18,0,0,1167,Liga NOS,nan,nan,nan,nan,nan,nan,nan,nan
19/6/2011,Pedro,1510305,796,7/28/1987,23,13,2,1,0,7264,8016,8016,168,161,6110569,169,64,M/AM RL,3,1,2,1,3,2,2,3,3,1,1,11,14,15,15,13,9,9,13,5,5,14,11,8,14,8,14,14,15,13,14,14,16,17,8,16,6,17,16,16,15,9,6,18,14,15,20,13,7,14,9,16,7,15,6,13,16,15,17,12,17,5,1,1,17,20,20,18,11,M/AM RL,525,1,1,10,11,18,20,1,1,1,1,1,15,17,1,1,1.45136E+14,0,0,0,1,0,0,0,0,0,0,1,0,0,0,0,0,0,0,0,0,0,0,0,0,0,0,0,0,0,0,0,0,0,0,0,0,0,0,0,0,0,0,1,0,0,0,0,1,Pedro,£25.20m ,33,167,Forward - Right Winger,both,AS Roma,53,22,13,3588,48,13,6,2774,45,10,11,3413,54,19,13,3320,50,11,9,2199,43,9,3,2781,43,13,12,2723,48,7,5,2509,52,13,5,3099,LaLiga,23,2,3,1273,5,2,1,400
19/6/2011,Panagiotis Kone,693761,772,7/26/1987,23,5,0,0,0,3263,6024,5873,135,126,61545,184,75,AM RC,3,2,3,3,3,2,1,8,2,3,2,11,12,15,14,13,12,14,12,6,7,13,12,7,15,9,10,10,9,10,13,12,11,13,7,12,7,9,13,13,14,11,14,12,12,14,20,14,10,12,4,12,8,13,8,16,12,8,10,10,11,12,1,1,12,20,17,5,20,AM RC,503,1,1,14,20,5,17,1,1,1,1,12,3,10,1,1,2.25183E+15,0,0,0,0,0,0,0,0,0,0,0,0,0,0,0,0,0,0,0,0,0,0,0,0,0,0,0,0,0,0,0,0,0,0,0,1,0,0,0,0,0,0,0,0,0,0,0,0,Panagiotis Kone,£1.44m ,33,182,Midfielder - Central Midfield,right,Retired,31,1,2,2050,31,1,1,1744,35,7,1,2472,29,5,1,2426,31,2,3,1753,8,1,1,285,7,0,0,342,20,1,1,1256,nan,nan,nan,nan,Serie A,15,2,1,1152,nan,nan,nan,nan
19/6/2011,Pablo Pintos,78015289,1657,7/1/1987,23,0,0,0,0,4000,6500,6400,143,128,971423,182,78,D/WB/M R,3,1,3,2,2,2,3,3,2,1,2,4,13,12,6,12,4,10,8,10,12,12,5,11,14,14,13,13,12,8,12,7,13,15,7,13,11,15,15,16,13,14,13,10,17,17,20,15,14,11,14,12,4,18,10,10,10,12,14,7,8,6,20,19,17,1,20,9,1,D/WB/M R,122,1,1,1,1,1,1,1,9,20,1,1,1,17,1,19,32,0,0,0,0,0,1,0,0,0,0,0,0,0,0,0,0,0,0,0,0,0,0,0,0,0,0,0,0,0,0,0,0,0,0,0,0,0,0,0,0,0,0,0,0,0,0,0,0,Pablo Barrientos,£3.60m ,35,176,Forward - Right Winger,left,Without Club,21,2,3,1137,26,4,5,1753,35,5,5,2922,31,5,5,2346,41,3,5,2033,17,3,1,747,41,8,5,2843,43,6,8,3019,33,2,6,1900,Serie A,nan,nan,nan,nan,nan,nan,nan,nan
19/6/2011,Pablo Barrera,5664900,379,6/21/1987,23,36,4,8,0,5500,6800,6750,151,132,1454545,175,65,AM RL,2,1,1,2,3,2,3,5,1,3,1,8,11,14,11,12,7,6,10,8,10,13,10,8,13,7,14,12,11,11,11,12,14,14,10,14,10,11,11,16,15,11,7,10,16,15,20,14,7,13,8,12,9,12,5,14,13,12,13,13,12,11,1,1,10,20,20,15,1,AM RL,505,1,1,1,1,15,20,1,1,1,1,1,1,10,1,1,0,0,0,0,0,0,0,0,0,0,0,0,0,0,0,0,0,0,0,0,0,0,0,0,0,0,0,0,0,0,0,0,0,0,0,0,0,0,0,0,0,0,0,0,0,0,0,0,0,Pablo Barrera,£2.25m ,33,175,Forward - Right Winger,right,Atlético de San Luis,24,0,3,1567,22,1,0,1111,28,2,8,2010,18,1,0,1082,39,4,1,2270,33,1,3,1678,34,8,6,2747,26,0,6,1808,40,5,7,3144,LaLiga,26,2,7,1511,13,1,2,948
19/6/2011,Nicolás Gaitán,14005523,1649,2/23/1988,23,6,0,0,0,5500,7000,7150,163,143,1922034,172,68,AM RLC,2,1,2,3,1,2,3,2,1,3,1,14,16,16,14,16,12,6,15,4,9,15,12,7,17,10,14,11,12,11,15,12,17,17,5,15,7,10,11,16,17,9,6,20,13,16,6,12,9,11,6,12,10,16,11,14,16,15,14,15,17,7,1,1,8,20,20,20,17,AM RLC,506,1,1,10,17,20,20,1,1,1,1,1,8,8,1,1,2.25238E+15,0,0,0,0,0,0,0,0,0,0,0,1,0,0,0,0,0,0,0,0,0,0,0,0,0,0,0,0,0,0,0,0,0,0,0,1,0,0,0,1,0,0,0,0,0,0,0,0,Nico Gaitán,£13.50m ,32,174,Midfielder - Attacking Midfield,left,SC Braga,48,9,10,3513,44,4,17,2987,44,5,13,2782,43,8,12,3428,37,4,16,2956,37,11,20,3116,36,4,5,1706,43,2,9,3135,28,4,11,2104,Liga NOS,4,0,0,50,0,0,0,0
19/6/2011,Nicolai Müller,35009581,771,9/25/1987,23,0,0,0,0,3750,6350,6350,140,127,561360,175,63,AM RL,2,3,2,2,1,3,1,1,2,1,1,11,11,16,13,14,8,5,10,5,5,12,9,7,13,15,11,13,11,9,11,10,15,13,5,13,7,11,15,16,16,13,7,9,14,14,20,13,8,12,7,9,11,15,7,4,14,9,13,16,15,5,1,1,14,20,19,20,14,AM RL,505,1,1,14,14,20,19,1,1,1,1,6,14,8,1,1,5.49756E+11,0,0,0,0,0,0,0,0,0,0,0,0,1,0,0,0,0,0,0,0,0,0,0,0,0,0,0,0,0,0,0,0,0,0,0,0,0,0,0,1,0,0,0,0,0,0,0,0,Nicolai Müller,£2.70m ,33,173,Forward - Right Winger,right,Western Sydney Wanderers,35,7,7,3166,27,5,5,1712,36,9,6,2688,28,10,4,2182,29,2,4,2218,29,9,5,2161,27,5,7,2035,3,1,0,116,26,5,0,1268,Bundesliga,19,5,3,1505,nan,nan,nan,nan
19/6/2011,Nenad Tomovic,5768029,802,8/30/1987,23,5,0,20,1,4750,6106,6550,147,131,287378,184,74,D RC,2,2,1,3,3,2,1,4,1,3,3,8,12,10,8,14,11,12,9,10,14,14,13,14,13,16,10,12,16,11,11,13,13,13,11,14,13,14,16,14,13,13,12,5,15,15,20,13,15,13,9,13,7,16,13,15,15,14,11,11,13,6,20,15,15,1,20,9,18,D RC,103,1,1,1,1,1,1,18,9,20,1,1,1,15,1,15,8.79609E+12,0,0,0,0,0,1,0,0,0,0,0,0,0,0,0,0,0,0,0,0,0,0,0,0,0,0,0,0,0,0,0,0,0,0,0,0,0,0,0,0,0,0,0,1,0,0,0,0,Nenad Tomović,£1.17m ,33,184,Defender - Centre-Back,right,SPAL,19,0,0,1770,34,1,0,2978,30,0,1,2470,35,0,1,2779,37,1,2,3006,33,0,0,2380,35,0,1,2559,29,0,0,2437,11,1,0,831,Serie A,25,0,1,1911,5,0,1,434
19/6/2011,Nathan Dyer,5125009,765,11/29/1987,23,0,0,0,0,4200,6250,6250,145,124,763828,166,64,M/AM RL,3,3,1,1,3,1,1,2,3,2,1,2,11,15,8,7,2,2,7,6,5,8,6,4,11,6,7,9,8,9,9,8,10,14,4,13,5,9,15,18,9,9,2,8,11,18,20,11,9,13,3,13,4,10,12,16,10,12,10,11,14,18,1,1,16,20,20,18,1,M/AM RL,525,1,1,10,1,18,20,1,1,1,1,1,14,16,1,1,3.29853E+12,0,1,0,0,0,1,0,0,0,0,0,0,0,0,0,0,0,0,0,0,0,0,0,0,0,0,0,0,0,0,0,0,0,0,0,0,0,0,0,0,1,1,0,0,0,0,0,0,Nathan Dyer,£4.05m ,32,165,Forward - Right Winger,right,Without Club,52,2,10,4004,36,6,2,2476,44,6,5,2859,37,6,2,2295,37,5,3,2261,17,3,1,568,12,0,3,505,31,3,0,1728,24,3,2,1493,Premier League,12,1,2,685,nan,nan,nan,nan
19/6/2011,Michael Pereira,67122190,769,12/8/1987,23,0,0,0,0,4500,6120,6350,150,134,561456,180,69,M/AM RL,3,2,1,1,1,1,1,5,2,3,2,11,13,14,13,11,10,11,15,6,5,12,9,7,13,10,11,12,11,10,12,10,10,14,6,13,6,11,13,14,13,12,13,20,16,15,15,15,14,12,7,13,17,15,18,5,8,13,15,11,2,9,1,12,17,20,16,20,13,M/AM RL,525,1,1,1,13,20,16,1,1,1,1,1,17,13,12,11,5.49756E+11,0,0,0,0,0,0,0,0,0,1,0,0,0,0,0,0,0,0,0,0,0,0,0,0,0,0,0,0,0,0,0,0,0,0,0,0,0,0,0,1,0,0,0,0,0,0,0,0,Michaël Pereira,£3.15m ,32,180,Forward - Right Winger,left,CFR Cluj,39,6,6,2570,31,2,4,2381,27,1,1,1535,22,0,0,1066,37,1,4,2709,35,4,5,2394,31,6,2,2512,27,4,1,1771,29,1,2,1390,LaLiga,18,2,3,887,9,1,1,409
19/6/2011,Max Gradel,29001331,24,11/30/1987,23,1,0,0,0,3000,6000,6000,138,120,473910,181,70,M/AM/S RL,1,1,1,3,2,2,1,6,2,1,1,8,9,13,13,12,12,4,14,3,5,11,10,8,15,16,8,9,7,7,7,6,19,14,5,13,7,11,13,16,14,9,6,7,12,17,20,15,10,7,12,15,4,11,16,18,13,8,10,8,5,9,1,1,20,20,20,19,1,M/AM/S RL,425,1,1,17,1,19,20,1,1,1,1,1,17,20,1,1,7.09529E+13,0,0,0,0,0,0,0,0,0,1,0,0,0,0,0,0,0,1,0,0,0,0,0,0,0,0,0,0,0,0,0,0,0,0,0,1,0,0,0,1,0,0,0,0,0,0,1,0,Max Gradel,£2.70m ,32,175,Forward - Left Winger,right,Sivasspor,44,18,7,3520,35,7,3,2165,26,3,2,1622,20,5,5,1087,40,17,5,2999,15,1,5,989,13,1,0,333,35,11,4,2897,39,13,10,3481,Ligue 1,22,4,2,1701,5,2,0,421
19/6/2011,Mato Jajalo,24004081,761,5/25/1988,23,0,0,28,5,4000,5759,6400,145,128,710790,182,77,M RC,1,2,2,1,2,3,3,1,3,1,2,11,11,13,10,13,10,12,15,11,10,13,10,12,14,12,12,13,10,13,15,11,12,12,10,12,10,14,14,12,14,14,12,8,16,13,20,14,14,14,4,14,3,12,13,12,12,12,13,14,12,6,5,9,20,10,15,12,20,M RC,403,1,1,3,10,6,6,5,3,3,15,20,12,15,7,9,0,0,0,0,0,0,0,0,0,0,0,0,0,0,0,0,0,0,0,0,0,0,0,0,0,0,0,0,0,0,0,0,0,0,0,0,0,0,0,0,0,0,0,0,0,0,0,0,0,Mato Jajalo,£2.03m ,32,182,Midfielder - Defensive Midfield,right,Udinese Calcio,33,2,4,2423,33,5,2,2420,26,0,3,1364,21,1,5,1523,48,3,9,3507,29,0,1,2124,26,1,1,1861,41,1,5,3368,35,3,3,3103,Bundesliga,28,0,0,1831,nan,nan,nan,nan
19/6/2011,Markel Susaeta,1509699,796,12/14/1987,23,0,0,3,0,4518,6713,6713,146,139,997291,179,68,AM RLC,1,3,1,1,3,1,3,5,1,2,3,12,13,15,12,12,14,9,13,6,5,13,11,4,15,13,13,12,12,12,14,14,14,16,12,14,9,11,11,16,14,12,9,11,11,13,20,14,12,8,5,13,9,13,12,17,16,14,13,13,13,15,1,1,14,20,20,17,16,AM RLC,506,1,1,12,16,17,20,1,1,1,1,5,14,14,1,1,7.03687E+13,0,0,1,0,0,0,0,0,0,0,0,0,0,0,0,0,0,0,0,0,0,0,0,0,0,0,0,0,0,0,0,0,0,0,0,0,0,0,0,0,0,0,0,0,0,0,1,0,Markel Susaeta,£5.85m ,32,179,Forward - Right Winger,right,Without Club,31,1,4,1658,63,13,15,4913,46,11,9,3812,43,7,12,3300,48,3,9,2840,47,5,11,3409,36,1,3,1473,48,3,7,3133,32,1,4,1797,LaLiga,10,2,1,692,nan,nan,nan,nan
19/6/2011,Lossémy Karaboué,8440215,769,3/18/1988,23,0,0,0,0,2700,4050,4050,140,122,349857,170,70,M/AM R,2,3,1,2,1,2,1,5,3,3,2,10,14,14,11,12,9,6,12,8,2,13,10,3,14,7,8,7,11,11,13,11,13,13,5,13,6,8,11,16,14,11,5,8,14,15,20,11,11,12,7,15,10,7,6,12,14,14,12,15,15,5,8,8,16,20,20,13,1,M/AM R,522,1,1,10,1,13,20,1,1,8,1,1,13,16,1,8,17179869698,0,1,0,0,0,0,0,0,0,1,0,0,0,0,0,0,0,0,0,0,0,0,0,0,0,0,0,0,0,0,0,0,0,0,1,0,0,0,0,0,0,0,0,0,0,0,0,0,Lossémy Karaboué,£3.60m ,32,173,Midfielder - Central Midfield,right,Ratchaburi Mitr Phol FC,41,9,9,3187,39,2,7,3358,40,2,2,3371,31,4,2,2111,21,0,1,724,36,0,2,2591,19,1,1,1083,32,2,4,2003,33,2,1,2198,Ligue 1,9,1,1,752,nan,nan,nan,nan
19/6/2011,Livio Nabab,34006509,769,6/14/1988,23,0,0,0,0,3850,4859,4850,125,108,104598,185,72,AM/S R,1,3,1,2,2,1,1,1,1,3,3,5,8,11,9,11,8,13,11,6,3,9,10,3,11,7,10,11,7,9,8,6,13,11,5,12,5,9,11,17,13,13,12,5,13,16,20,14,11,11,7,13,11,8,8,13,12,10,9,10,10,8,1,1,12,17,17,12,1,AM/S R,622,1,1,20,1,12,17,1,1,1,1,1,12,12,1,1,16,0,0,0,0,1,0,0,0,0,0,0,0,0,0,0,0,0,0,0,0,0,0,0,0,0,0,0,0,0,0,0,0,0,0,0,0,0,0,0,0,0,0,0,0,0,0,0,0,Livio Nabab,£720Th. ,32,185,Forward - Centre-Forward,right,US Granville,22,1,0,1101,25,6,3,1867,37,5,1,2589,39,10,4,2955,31,4,0,1861,22,2,2,706,35,5,2,2809,24,1,0,750,24,5,3,1917,Ligue 1,22,4,1,1288,6,2,0,376
19/6/2011,Lionel Messi,7458500,1649,6/24/1987,23,50,13,7,6,9750,9750,9750,199,195,26080973,170,67,AM/S RLC,1,2,1,3,2,2,2,5,2,2,1,11,14,20,19,17,14,9,16,5,6,17,18,7,20,7,17,13,16,16,17,17,19,20,12,16,6,11,12,18,20,16,5,20,15,16,12,15,8,17,6,18,11,15,17,19,16,19,16,15,14,6,1,1,15,20,19,17,20,AM/S RLC,516,1,1,20,20,17,19,1,1,1,1,9,15,15,1,1,2.32217E+15,0,0,0,1,0,0,0,1,0,0,1,0,1,0,0,0,0,0,0,1,1,0,0,0,0,0,0,0,0,0,0,0,0,0,0,0,0,0,0,0,0,0,0,0,0,0,1,0,Lionel Messi,£90.00m ,33,170,Forward - Right Winger,left,FC Barcelona,55,53,24,4579,60,73,33,5221,50,60,16,4070,46,41,14,3742,57,58,30,5060,49,41,24,4229,52,54,18,4452,54,45,18,4468,50,51,20,4023,LaLiga,44,31,27,3810,6,2,3,540
19/6/2011,Lautaro Acosta,14001291,1649,3/14/1988,23,0,0,0,0,5000,6500,6016,150,131,158118,169,65,AM/S RC,1,1,3,3,1,3,3,4,2,2,3,12,16,14,10,14,9,3,11,4,4,14,12,4,16,9,8,14,9,10,14,10,9,16,5,11,5,12,12,17,16,15,4,11,8,16,20,13,5,11,4,12,17,11,10,11,14,12,16,15,17,14,1,1,14,20,19,10,20,AM/S RC,513,1,1,18,20,10,19,1,1,1,1,9,1,14,1,1,16777216,0,0,0,0,0,0,0,0,0,0,0,0,0,0,0,0,0,0,0,0,0,0,0,0,1,0,0,0,0,0,0,0,0,0,0,0,0,0,0,0,0,0,0,0,0,0,0,0,Lautaro Acosta,£1.08m ,32,169,Forward - Left Winger,right,Club Atlético Lanús,13,1,2,463,25,2,2,1467,32,1,6,1819,25,6,3,1568,45,11,9,3593,16,3,4,1438,38,8,8,3140,24,4,4,1730,30,3,4,2608,LaLiga,20,3,3,1684,nan,nan,nan,nan
19/6/2011,Juan Guillermo Cuadrado,76010707,1653,5/26/1988,23,7,1,0,0,4250,6400,6200,142,126,251185,176,66,D/WB/M R,2,3,1,1,3,3,1,6,2,1,1,11,12,16,8,12,14,10,15,15,9,12,9,10,14,10,12,13,11,7,14,8,11,14,8,11,7,12,13,16,17,9,7,12,15,15,20,14,7,11,9,15,8,13,10,10,14,12,14,14,14,6,18,20,19,15,20,1,5,D/WB/M R,232,1,1,1,1,1,15,1,1,18,1,5,1,19,1,20,3.51844E+13,0,0,0,0,0,0,0,0,0,1,0,0,0,0,0,0,0,0,0,0,0,0,0,0,0,0,0,0,0,0,0,0,0,0,0,0,0,0,0,0,0,0,0,0,0,1,0,0,,,,,,,,,,,,,,,,,,,,,,,,,,,,,,,,,,,,,,,,,,,,,,,,,,,,
19/6/2011,Jonathan de Guzman,860972,784,9/13/1987,23,0,0,4,3,6511,6863,7012,158,146,632467,173,65,M/AM RC,1,2,2,3,1,2,2,8,3,1,2,14,12,15,11,16,12,12,13,8,11,15,13,8,15,15,14,13,12,13,15,14,9,17,9,15,14,15,14,14,14,13,9,12,13,13,20,13,11,15,14,13,18,10,12,16,13,12,14,13,12,12,8,8,20,19,16,12,20,M/AM RC,413,1,1,12,19,12,16,1,8,8,12,20,12,16,8,8,3.51844E+13,0,0,0,0,0,1,0,0,0,0,1,0,0,0,0,0,0,0,0,0,1,0,1,0,0,0,0,0,0,0,0,0,0,0,0,0,0,0,0,0,0,0,0,0,0,1,0,0,Jonathan de Guzmán,£5.40m ,33,173,Midfielder - Central Midfield,right,OFI Crete,36,6,4,3072,27,1,2,1584,45,8,8,3511,48,7,5,3310,36,7,3,2021,5,1,0,111,29,2,2,1533,19,0,5,1346,39,3,9,2083,LaLiga,10,1,1,193,nan,nan,nan,nan
19/6/2011,Jonathan Biabiany,43002297,769,4/28/1988,23,0,0,6,1,5022,5625,6227,145,124,490448,175,70,AM RL,3,2,2,2,3,2,2,3,3,2,2,15,11,14,10,9,3,7,8,2,3,12,9,4,13,12,11,11,10,7,4,8,15,13,4,13,6,8,14,18,16,10,6,10,12,17,20,13,12,8,11,14,13,13,13,16,12,13,14,13,12,6,1,1,10,20,20,16,14,AM RL,505,1,1,14,14,16,20,1,1,1,1,1,10,10,1,1,2.3222E+15,0,0,0,0,0,0,0,0,0,0,0,0,0,0,0,0,0,0,0,0,1,0,0,0,0,0,0,0,0,0,0,0,0,0,0,1,0,0,0,0,0,0,0,0,0,0,1,0,Jonathan Biabiany,£7.20m ,32,177,Forward - Right Winger,right,San Fernando CD,37,2,8,1963,38,6,9,2509,34,2,7,2743,38,7,7,2903,1,0,0,73,24,1,2,1188,4,0,0,149,16,0,1,1048,19,0,0,1089,Serie A,12,0,0,638,2,0,0,180
19/6/2011,Jirès Kembo-Ekoko,8440894,769,1/8/1988,23,0,0,13,2,4497,5696,5687,150,126,257434,178,78,AM RL,1,2,3,2,2,2,3,6,1,3,3,12,11,15,8,12,13,10,12,5,3,8,11,2,15,8,13,9,12,12,9,9,14,14,5,14,5,7,11,16,14,13,9,8,14,15,20,14,13,12,8,13,6,7,10,15,13,13,8,14,14,12,1,1,10,20,20,16,1,AM RL,505,1,1,14,1,16,20,1,1,1,1,1,10,10,1,1,2.28698E+15,0,0,0,0,0,0,0,0,0,0,0,0,0,0,0,0,0,0,0,0,0,0,0,0,0,0,0,0,0,0,0,0,0,0,0,0,0,0,0,0,0,0,0,0,0,1,0,0,Jirès Kembo Ekoko,£3.60m ,32,178,Forward - Left Winger,right,Without Club,26,4,4,1486,42,13,4,2448,30,9,7,2262,33,7,1,2204,28,16,7,1893,31,10,7,2438,24,2,4,1954,25,4,3,1649,2,0,0,14,Ligue 1,nan,nan,nan,nan,nan,nan,nan,nan
19/6/2011,Jens Hegeler,92001113,771,1/21/1988,23,0,0,4,0,4700,6450,6200,146,129,332726,193,85,DM/M/AM RLC,2,1,3,3,3,1,2,4,1,3,3,4,12,12,9,11,7,14,9,6,13,12,8,14,11,12,13,12,11,14,11,14,14,8,9,11,14,14,15,13,10,14,16,9,13,13,20,15,14,16,4,13,4,15,10,12,13,12,14,15,18,2,1,1,20,18,19,15,20,DM/M/AM RLC,436,1,1,1,14,14,18,1,1,1,18,20,15,19,1,1,0,0,0,0,0,0,0,0,0,0,0,0,0,0,0,0,0,0,0,0,0,0,0,0,0,0,0,0,0,0,0,0,0,0,0,0,0,0,0,0,0,0,0,0,0,0,0,0,0,Jens Hegeler,£1.80m ,32,193,Midfielder - Central Midfield,right,Career break,38,3,5,2745,35,1,2,2033,37,5,0,1534,26,1,3,878,27,1,1,1572,21,0,0,749,21,0,0,1162,7,1,0,478,0,0,0,0,Bundesliga,nan,nan,nan,nan,nan,nan,nan,nan
19/6/2011,Jeffren,1510572,796,1/20/1988,23,0,0,2,0,5250,6800,6800,150,138,1247466,173,71,AM RL,2,2,3,1,3,3,1,1,3,3,3,13,13,14,10,13,13,7,10,7,8,13,16,8,14,7,12,8,12,9,12,9,12,12,7,14,7,12,13,16,14,8,6,20,9,15,14,12,9,12,3,10,14,12,14,13,15,10,13,7,12,8,9,13,14,20,18,20,9,AM RL,505,1,1,10,9,20,18,1,1,9,1,1,14,14,1,13,2.35739E+15,0,0,0,0,0,0,0,0,0,0,0,0,0,0,0,0,0,0,0,0,0,0,0,0,0,0,0,0,0,0,0,0,0,0,0,1,0,0,0,0,0,0,0,0,0,1,1,0,Jeffren,£4.50m ,32,176,Midfielder - Attacking Midfield,left,Slaven Belupo Koprivnica,13,1,1,369,18,3,1,657,21,2,0,968,11,0,1,458,36,3,2,1699,18,3,2,1148,31,2,0,1636,36,6,5,2613,25,1,1,1608,Liga NOS,12,1,2,724,2,0,0,77
19/6/2011,Geoffrey Tulasne,8439282,769,2/24/1988,23,0,0,2,0,4188,5264,5244,135,117,479543,175,69,M/AM RL,2,1,2,3,2,2,3,4,1,2,3,11,11,13,8,13,11,8,11,8,3,11,8,4,14,7,10,9,12,10,11,8,14,13,5,11,6,11,11,15,14,11,8,12,13,14,20,14,8,12,7,14,9,10,8,12,15,9,14,13,13,6,10,10,17,20,16,20,1,M/AM RL,525,1,1,1,1,20,16,1,10,1,8,1,17,16,10,1,2.2529E+15,0,0,0,0,0,0,0,0,0,0,0,0,0,0,0,0,0,0,0,0,0,0,0,0,0,0,0,0,0,0,0,0,0,0,0,0,0,0,0,0,1,0,0,0,0,0,0,0,,,,,,,,,,,,,,,,,,,,,,,,,,,,,,,,,,,,,,,,,,,,,,,,,,,,
19/6/2011,Gary Medel,75000560,1652,8/3/1987,23,31,3,0,0,5800,7250,7000,160,144,1441490,172,71,D/WB/DM/M RC,2,3,1,2,2,2,3,5,3,1,1,8,10,9,13,10,6,15,13,13,16,12,4,17,11,17,16,19,6,14,11,12,14,12,13,10,15,14,19,13,14,14,8,9,17,13,20,18,11,14,12,16,4,18,13,15,16,12,12,9,7,14,17,16,17,1,17,1,17,D/WB/DM/M RC,343,1,1,1,1,1,1,17,1,16,20,16,1,17,1,16,33088,0,0,0,0,0,0,1,0,1,0,0,0,0,0,0,1,0,0,0,0,0,0,0,0,0,0,0,0,0,0,0,0,0,0,0,0,0,0,0,0,0,0,0,0,0,0,0,0,Gary Medel,£5.40m ,33,171,Midfielder - Defensive Midfield,right,Bologna FC 1909,35,0,0,2866,37,2,0,3071,39,7,3,3226,35,0,1,2918,44,0,3,3739,34,1,3,2790,31,0,0,2576,40,1,2,3043,35,0,0,2826,LaLiga,26,0,0,2015,2,0,1,45
19/6/2011,Francesco Della Rocca,7983853,776,9/14/1987,23,0,0,0,0,3965,6613,6613,153,132,598744,182,77,M/AM RC,1,2,2,1,1,3,1,3,3,1,2,12,12,12,11,13,10,12,11,11,12,12,13,13,13,14,13,11,13,13,11,13,12,14,10,12,13,15,13,13,13,13,13,10,15,13,20,18,13,15,8,13,7,13,11,9,11,13,14,13,7,8,1,1,20,16,16,1,20,M/AM RC,413,1,1,1,16,1,1,1,1,1,10,20,1,16,1,1,0,0,0,0,0,0,0,0,0,0,0,0,0,0,0,0,0,0,0,0,0,0,0,0,0,0,0,0,0,0,0,0,0,0,0,0,0,0,0,0,0,0,0,0,0,0,0,0,0,Francesco Della Rocca,£2.70m ,33,182,Midfielder - Central Midfield,left,Without Club,27,0,2,2012,23,1,2,1223,19,1,0,1514,11,0,0,721,7,0,0,313,37,0,1,2611,30,2,0,2161,7,0,0,512,5,0,0,258,Serie A,nan,nan,nan,nan,nan,nan,nan,nan
19/6/2011,Fabian Johnson,8726381,390,12/11/1987,23,0,0,0,0,3800,5950,5950,137,119,836785,183,70,D/M RL,3,1,3,3,3,2,2,4,1,2,3,9,11,12,6,12,10,6,9,13,9,10,7,10,13,7,8,7,8,11,9,9,9,10,5,14,9,14,16,17,16,10,10,20,13,15,15,14,8,10,7,10,5,18,10,11,17,10,9,12,19,8,20,14,17,10,18,20,1,D/M RL,115,1,1,1,1,8,10,1,20,18,1,1,15,17,14,9,11,1,1,0,1,0,0,0,0,0,0,0,0,0,0,0,0,0,0,0,0,0,0,0,0,0,0,0,0,0,0,0,0,0,0,0,0,0,0,0,0,0,0,0,0,0,0,0,0,Fabian Johnson,£3.15m ,32,183,Forward - Left Winger,right,Without Club,7,0,0,256,33,3,8,2554,33,3,3,2856,28,0,5,2187,34,1,8,1911,34,8,6,2809,35,4,4,2038,12,1,0,479,18,1,1,1008,Bundesliga,7,0,0,298,nan,nan,nan,nan
19/6/2011,Esteban Granero,7458313,796,7/2/1987,23,0,0,8,2,5750,7350,7350,159,147,0,180,75,M/AM RLC,1,3,3,3,1,2,3,1,2,1,2,16,15,15,12,17,13,10,14,7,6,16,13,8,16,10,12,13,15,11,17,13,15,16,10,13,10,12,13,13,15,10,9,13,12,13,20,13,10,12,12,13,7,13,13,14,14,16,13,16,15,7,1,1,18,20,15,16,20,M/AM RLC,526,1,1,1,20,16,15,1,1,1,8,18,13,12,1,1,1.75922E+13,0,0,1,0,1,0,0,1,0,0,0,0,0,0,0,0,0,0,0,0,0,0,0,0,0,0,0,0,0,0,0,0,0,0,0,0,0,0,0,0,0,0,0,0,1,0,0,0,Esteban Granero,£6.30m ,33,180,Midfielder - Central Midfield,right,Marbella FC,32,2,4,1271,28,0,2,1000,27,1,1,1886,8,0,1,367,39,1,2,2791,15,0,0,872,22,0,1,736,31,2,3,1752,30,3,1,2137,LaLiga,27,1,3,1651,2,0,0,178
19/6/2011,Diego Buonanotte,962978,1649,4/19/1988,23,0,0,14,1,4950,6500,6500,160,135,1403399,161,60,AM RLC,2,3,1,2,3,3,2,5,3,2,1,13,13,16,13,14,14,1,13,1,7,13,15,7,16,10,11,13,13,11,14,11,17,17,4,14,7,13,13,16,16,5,5,20,13,16,5,12,5,9,12,15,12,11,11,15,15,11,15,11,6,16,1,1,9,20,16,17,20,AM RLC,506,1,1,15,20,17,16,1,1,1,1,9,1,1,1,1,2.2518E+15,0,0,0,0,0,0,0,0,0,0,0,0,0,0,0,0,0,1,0,0,0,0,0,0,0,0,0,0,0,0,0,0,0,0,0,0,0,0,0,0,0,0,0,0,0,0,0,0,Diego Buonanotte,£2.25m ,32,161,Midfielder - Attacking Midfield,left,CD Universidad Católica,26,2,2,1216,14,1,0,454,32,5,7,1463,25,0,1,1092,26,2,2,1478,37,11,1,1898,43,16,11,3488,26,7,2,2284,25,2,0,1094,LaLiga,8,0,2,304,nan,nan,nan,nan
19/6/2011,Daniel Candeias,55004183,788,2/25/1988,23,0,0,15,1,2808,5609,5550,135,112,193971,177,73,AM R,3,2,2,1,1,1,1,1,2,3,2,9,10,13,10,13,9,7,11,9,5,11,11,5,12,9,12,13,10,10,11,8,15,15,10,12,4,9,9,14,14,5,6,9,11,14,20,9,7,11,8,14,7,12,8,15,15,16,14,13,12,5,1,5,12,20,20,12,10,AM R,502,1,1,10,10,12,20,1,1,1,1,1,1,12,1,5,0,0,0,0,0,0,0,0,0,0,0,0,0,0,0,0,0,0,0,0,0,0,0,0,0,0,0,0,0,0,0,0,0,0,0,0,0,0,0,0,0,0,0,0,0,0,0,0,0,Daniel Candeias,£1.08m ,32,177,Forward - Right Winger,right,Genclerbirligi Ankara,30,1,5,2560,41,7,5,2573,30,5,0,1862,31,4,7,2253,27,2,2,1578,28,2,2,2056,30,4,4,2440,45,8,13,3630,52,6,12,3739,Liga NOS,33,3,7,2739,5,1,1,450
19/6/2011,Damián Suárez,78001192,1657,4/27/1988,23,0,0,26,0,3800,5129,5750,133,114,407560,173,74,D/WB/M RL,1,1,3,3,2,2,1,3,2,1,1,13,13,13,7,12,13,7,13,12,10,13,3,9,13,14,9,13,9,7,12,10,10,11,11,13,10,14,14,14,14,8,7,13,15,12,20,14,9,8,14,10,3,15,10,14,7,6,8,7,7,5,16,19,20,9,20,15,1,D/WB/M RL,435,1,1,1,1,1,9,1,15,16,8,1,1,20,15,19,32,0,0,0,0,0,1,0,0,0,0,0,0,0,0,0,0,0,0,0,0,0,0,0,0,0,0,0,0,0,0,0,0,0,0,0,0,0,0,0,0,0,0,0,0,0,0,0,0,Damián Suárez,£900Th. ,32,173,Defender - Right-Back,right,Getafe CF,25,1,2,2030,20,0,1,1484,33,1,3,2947,32,1,1,2851,37,1,1,3310,33,0,3,2769,42,0,6,3780,33,1,4,2878,42,0,3,3709,LaLiga,34,1,4,2958,6,0,0,523
19/6/2011,Clemens Walch,16003074,755,7/10/1987,23,0,0,0,0,2500,5700,5800,130,116,37147,180,74,AM RL,1,3,2,3,2,3,1,3,3,1,2,5,12,14,7,11,5,6,6,6,5,12,6,6,12,7,12,12,8,11,10,11,10,11,7,13,10,14,13,16,13,11,9,20,13,16,5,12,11,11,8,10,8,11,12,8,10,8,9,11,11,16,1,1,9,20,20,17,13,AM RL,505,1,1,10,13,17,20,1,1,1,1,1,1,9,1,1,0,0,0,0,0,0,0,0,0,0,0,0,0,0,0,0,0,0,0,0,0,0,0,0,0,0,0,0,0,0,0,0,0,0,0,0,0,0,0,0,0,0,0,0,0,0,0,0,0,Clemens Walch,£540Th. ,33,181,Midfielder - Right Midfield,both,SPG Silz/Mötz,22,0,1,1189,10,0,0,315,32,5,4,2104,29,6,6,2002,30,5,1,1943,22,2,3,1207,26,6,6,1594,23,3,2,1050,11,4,2,641,Bundesliga,17,2,1,781,nan,nan,nan,nan
19/6/2011,Boy Deul,37000104,380,8/30/1987,23,0,0,0,0,2750,4900,4900,122,102,99862,178,66,M/AM RC,3,2,2,2,3,1,1,2,2,1,2,8,12,13,12,12,8,5,7,3,5,12,10,5,12,9,12,13,12,12,13,12,10,9,8,14,11,14,14,10,13,13,8,10,18,11,20,12,11,10,14,10,11,10,12,6,12,5,10,10,7,20,1,1,18,20,16,14,20,M/AM RC,523,1,1,1,20,14,16,1,1,1,1,18,10,10,1,1,0,0,0,0,0,0,0,0,0,0,0,0,0,0,0,0,0,0,0,0,0,0,0,0,0,0,0,0,0,0,0,0,0,0,0,0,0,0,0,0,0,0,0,0,0,0,0,0,0,,,,,,,,,,,,,,,,,,,,,,,,,,,,,,,,,,,,,,,,,,,,,,,,,,,,
19/6/2011,Armiche,67058211,796,6/12/1988,23,0,0,0,0,3150,4950,4950,123,103,257297,176,70,M/AM RL,3,3,3,2,1,1,2,2,3,2,3,6,10,15,7,12,6,4,10,4,2,12,7,4,15,5,12,7,7,7,11,7,14,14,6,12,4,10,10,16,14,8,7,5,13,16,20,9,6,10,7,10,8,12,8,15,10,10,13,12,12,10,1,1,19,20,20,15,5,M/AM RL,525,1,1,5,5,15,20,1,1,1,1,1,14,19,1,1,1.09991E+12,0,1,0,0,0,0,0,0,0,0,0,0,0,0,0,0,0,0,0,0,0,0,0,0,0,0,0,1,1,0,0,0,0,0,0,0,0,0,0,0,1,0,0,0,0,0,0,0,,,,,,,,,,,,,,,,,,,,,,,,,,,,,,,,,,,,,,,,,,,,,,,,,,,,
19/6/2011,Angel Di María,14000219,1649,2/14/1988,23,14,2,13,3,7500,8250,8000,171,159,0,180,70,M/AM RL,2,2,3,1,1,1,1,8,3,2,1,15,16,17,12,15,15,11,15,8,5,14,15,7,17,9,13,12,14,10,15,12,13,18,8,15,7,13,12,15,16,10,11,20,14,17,9,13,11,12,7,11,8,12,14,14,15,16,14,8,13,9,1,9,18,20,17,20,10,M/AM RL,525,1,1,8,10,20,17,1,1,1,1,1,18,13,9,1,4.96498E+12,1,0,0,0,0,0,0,0,0,0,0,0,0,0,0,0,0,0,0,0,0,0,0,0,0,0,0,0,0,0,0,0,0,0,1,0,0,0,0,1,0,0,1,0,0,0,0,0,Ángel Di María,£27.00m ,32,180,Forward - Right Winger,left,Paris Saint-Germain,53,9,26,3569,32,7,17,1910,52,9,17,3190,52,11,25,3758,33,4,12,2017,47,15,25,3402,43,14,15,3091,45,21,12,3119,45,19,17,3498,LaLiga,41,12,23,3250,5,1,2,423
19/6/2011,Alessio Cerci,7984079,776,7/23/1987,23,0,0,6,1,5750,7200,6700,146,136,1359095,180,78,AM RL,1,3,1,1,3,2,1,3,1,2,1,12,13,15,11,12,5,8,10,4,6,13,11,6,13,11,11,11,10,8,10,12,16,14,8,13,5,9,8,15,14,12,8,20,12,16,13,13,12,12,10,10,7,12,8,18,18,13,15,17,13,8,1,1,13,20,20,16,5,AM RL,505,1,1,10,5,16,20,1,1,1,1,1,11,13,1,1,6.0143E+11,0,0,0,0,0,0,0,0,0,0,0,0,0,1,0,0,0,0,0,0,0,0,0,0,0,0,0,1,0,0,0,0,0,0,1,1,0,0,0,1,0,0,0,0,0,0,0,0,Alessio Cerci,£5.85m ,33,180,Forward - Right Winger,left,SS Arezzo,27,8,4,1689,26,8,1,1690,35,8,12,2740,38,13,11,3042,27,2,7,1085,26,4,2,1384,2,0,0,43,25,3,4,1712,16,5,3,718,Serie A,10,0,1,330,2,0,0,105
19/6/2011,Alejandro Gómez,955978,1649,2/15/1988,23,0,0,20,5,4500,6119,6600,150,136,1295211,165,65,AM RL,2,3,3,2,3,3,3,4,3,1,1,14,14,18,10,14,10,3,16,5,4,13,13,3,16,12,11,14,10,10,11,7,15,16,8,16,4,10,12,16,17,13,4,8,10,15,20,14,11,11,4,11,8,15,13,12,15,16,12,13,15,14,1,1,10,20,19,20,14,AM RL,505,1,1,14,14,20,19,1,1,1,1,1,10,10,1,1,7.03687E+13,0,0,0,0,0,0,0,0,0,0,0,0,0,0,0,0,0,0,0,0,0,0,0,0,0,0,0,0,0,0,0,0,0,0,0,0,0,0,0,0,0,0,0,0,0,0,1,0,Alejandro Gálvez,£180Th. ,31,190,Defender - Centre-Back,right,Qatar SC,34,3,0,2947,31,3,0,2664,30,0,0,2422,30,2,1,2575,22,1,1,1726,24,1,0,1481,25,0,0,1823,25,1,0,2224,18,1,0,1426,LaLiga,20,0,0,1800,3,0,0,204
19/6/2011,Ahmed Elmohamady,12009828,16,9/9/1987,23,42,1,0,0,3900,6400,6400,137,127,1225455,180,75,D/WB/M/AM R,2,1,3,3,2,1,1,3,2,2,2,13,16,12,11,13,13,14,12,14,9,11,10,12,14,13,12,8,11,8,11,13,8,13,12,13,8,12,10,15,13,9,14,7,15,15,20,12,11,9,12,4,7,13,12,12,12,10,9,5,8,8,16,19,16,20,20,1,1,D/WB/M/AM R,542,1,1,10,1,1,20,1,1,16,1,1,1,16,1,19,1.09991E+12,0,1,0,0,0,0,0,0,0,0,0,0,0,0,0,0,0,0,0,0,0,0,0,0,0,0,0,1,1,0,0,0,0,0,0,0,0,0,0,0,1,0,0,0,0,0,0,0,Ahmed Elmohamady,£2.70m ,33,182,Defender - Right-Back,right,Aston Villa,38,0,3,2573,22,1,1,969,43,3,9,3686,45,2,3,3930,43,3,6,3728,51,3,7,3765,37,0,2,2800,45,0,5,3340,42,2,8,3259,Premier League,25,2,4,1552,4,0,0,280
19/6/2011,Adam Johnson,5118412,765,7/14/1987,23,6,2,19,4,5722,7364,7264,165,149,3048936,176,62,M/AM RL,3,1,1,2,1,2,1,4,1,3,2,15,15,17,13,13,11,6,13,6,4,13,8,8,12,6,12,8,14,12,12,11,13,15,5,15,3,12,12,17,18,13,7,20,12,15,11,14,9,13,5,8,8,13,11,15,12,15,14,10,11,5,1,1,18,20,19,20,5,M/AM RL,525,1,1,1,1,20,19,1,1,1,1,5,18,18,1,1,2.32217E+15,1,0,0,0,0,1,0,0,0,0,0,0,0,0,0,0,0,0,0,0,0,0,0,0,0,0,0,0,0,0,0,0,0,0,0,0,0,0,0,0,0,0,0,0,0,0,1,0,Adam Johnson,£9.45m ,33,182,Forward - Right Winger,left,Career break,43,6,9,2394,38,7,8,1597,40,5,9,3277,45,10,10,3115,37,5,3,2456,20,2,5,1231,nan,nan,nan,nan,nan,nan,nan,nan,nan,nan,nan,nan,Premier League,nan,nan,nan,nan,nan,nan,nan,nan
19/6/2011,Adam Hammill,5006838,765,1/25/1988,23,0,0,1,0,3350,5850,5850,145,119,272727,181,74,M/AM RL,2,2,1,2,3,1,1,6,1,3,1,13,14,14,9,12,11,8,11,4,7,13,8,4,14,7,12,7,11,8,15,9,15,15,5,13,11,7,12,12,10,12,8,15,12,15,20,12,7,11,6,14,7,5,14,18,12,14,10,9,6,7,1,1,20,20,20,20,14,M/AM RL,415,1,1,12,14,16,20,1,1,1,1,1,20,19,1,1,34360786944,0,0,0,0,0,0,0,0,0,0,0,0,0,0,0,0,0,0,0,0,1,0,0,0,0,0,0,0,0,0,0,0,0,0,0,1,0,0,0,0,0,0,0,0,0,0,0,0,Adam Hammill,£900Th. ,32,180,Forward - Right Winger,left,Derry City,37,8,7,2953,27,1,1,1700,20,2,1,776,49,5,12,3717,22,0,3,844,35,9,9,2997,40,3,4,2454,42,1,3,2913,28,5,4,1798,Premier League,17,0,1,952,1,0,1,120
19/6/2011,Abdou Traoré,34010357,31,1/17/1988,23,12,2,1,1,5110,6274,5692,145,125,427227,180,74,M/AM RC,3,2,2,2,3,2,2,7,2,3,3,9,12,13,6,14,7,9,10,7,4,13,8,4,14,8,11,13,12,12,13,10,14,13,6,11,8,12,14,15,13,13,10,10,14,14,20,17,12,12,8,15,11,10,13,15,14,11,14,14,14,6,1,1,18,20,20,12,17,M/AM RC,523,1,1,1,17,12,20,1,1,1,1,17,12,18,1,1,5.49756E+11,0,0,0,0,0,0,0,0,0,0,0,0,0,0,0,0,0,0,0,0,0,0,0,0,0,0,0,0,0,0,0,0,0,0,0,0,0,0,0,1,0,0,0,0,0,0,0,0,Abdou Traoré,£900Th. ,32,180,Midfielder - Central Midfield,right,Al-Nahda,28,1,1,1733,10,1,0,285,11,0,1,699,23,1,0,1650,20,1,0,873,20,0,0,1081,10,0,0,130,nan,nan,nan,nan,nan,nan,nan,nan,Ligue 1,nan,nan,nan,nan,nan,nan,nan,nan
19/6/2011,Tomer Hemed,7862103,775,5/2/1987,24,1,0,3,0,3263,6275,5938,135,125,573072,183,81,S R,2,1,2,2,2,3,3,7,1,3,3,11,7,11,15,12,12,14,12,11,11,13,12,9,12,13,14,13,13,14,12,10,15,11,8,13,13,14,16,12,11,10,13,10,12,13,20,13,14,16,7,14,5,6,6,16,9,11,12,14,12,9,1,1,1,15,15,13,1,S R,602,1,1,20,1,13,15,1,1,1,1,1,1,1,1,1,0,0,0,0,0,0,0,0,0,0,0,0,0,0,0,0,0,0,0,0,0,0,0,0,0,0,0,0,0,0,0,0,0,0,0,0,0,0,0,0,0,0,0,0,0,0,0,0,0,Tomer Hemed,£1.80m ,33,182,Forward - Centre-Forward,right,Without Club,35,13,0,2243,34,10,1,2076,38,11,2,2485,24,2,1,1198,35,8,4,2328,48,17,5,3302,41,14,5,1997,19,2,2,1076,29,7,0,1426,LaLiga,19,0,0,826,nan,nan,nan,nan
19/6/2011,Tchô,2107518,1651,4/21/1987,24,0,0,8,3,2500,6150,6150,140,123,364393,174,70,M/AM RC,1,1,2,2,2,1,3,1,3,3,2,10,12,16,10,12,10,7,10,7,5,12,8,6,12,12,12,12,11,11,12,11,12,14,9,13,5,11,12,14,13,8,13,16,11,14,20,11,8,12,12,11,13,10,13,11,12,13,14,12,14,10,1,1,16,20,15,1,20,M/AM RC,523,1,1,11,20,1,15,1,1,1,1,16,1,12,1,1,160,0,0,0,0,0,1,0,1,0,0,0,0,0,0,0,0,0,0,0,0,0,0,0,0,0,0,0,0,0,0,0,0,0,0,0,0,0,0,0,0,0,0,0,0,0,0,0,0,Tchô,- ,33,175,Midfielder - Attacking Midfield,right,Ipatinga Futebol Clube,27,7,1,1482,9,1,0,252,20,4,5,1072,20,3,1,1114,2,0,0,26,nan,nan,nan,nan,nan,nan,nan,nan,nan,nan,nan,nan,nan,nan,nan,nan,Liga NOS,nan,nan,nan,nan,nan,nan,nan,nan
19/6/2011,Rômulo,8833765,1651,5/22/1987,24,0,0,0,0,2566,6268,6268,135,125,161833,178,73,D/WB/M/AM R,2,2,1,1,1,1,1,1,3,2,3,12,12,12,12,13,10,12,14,10,9,12,10,9,13,12,12,12,11,11,12,12,14,13,11,12,8,12,14,15,13,7,9,10,13,15,20,14,6,12,12,12,10,14,6,13,10,12,11,8,8,12,20,18,18,19,20,9,1,D/WB/M/AM R,132,1,1,13,1,1,19,1,9,20,1,1,1,18,1,18,0,0,0,0,0,0,0,0,0,0,0,0,0,0,0,0,0,0,0,0,0,0,0,0,0,0,0,0,0,0,0,0,0,0,0,0,0,0,0,0,0,0,0,0,0,0,0,0,0,Rômulo,£1.35m ,33,178,Midfielder - Central Midfield,right,Without Club,5,0,0,405,10,0,0,455,24,2,2,1242,33,6,8,2633,5,0,0,278,10,0,2,288,41,4,10,3565,41,3,6,3562,32,1,3,2560,Serie A,24,1,3,1755,nan,nan,nan,nan
19/6/2011,Romain Hamouma,8443441,769,3/29/1987,24,0,0,0,0,4900,6145,6111,145,136,1037027,177,74,M/AM R,3,3,1,2,3,2,3,9,1,3,1,12,13,15,11,15,10,7,12,6,3,11,8,4,15,6,10,7,13,12,12,12,14,14,6,14,5,8,13,17,13,11,8,10,14,15,20,14,11,12,6,16,6,10,6,12,14,14,14,15,15,6,1,1,16,20,20,12,1,M/AM R,522,1,1,1,1,12,20,1,1,1,1,1,12,16,1,1,2.2518E+15,0,0,0,0,0,0,0,0,0,0,0,0,0,0,0,0,0,0,0,0,0,0,0,0,0,0,0,0,0,0,0,0,0,0,0,0,0,0,0,0,0,0,0,0,0,0,0,0,Romain Hamouma,£4.05m ,33,179,Forward - Right Winger,right,AS Saint-Étienne,34,9,7,2835,35,4,6,2953,38,7,5,2287,39,11,4,2942,38,5,13,2896,33,8,3,2078,40,8,10,2750,32,5,3,2049,29,4,4,1677,Ligue 1,20,6,4,1307,8,3,1,523
19/6/2011,Robert Tesche,35006190,771,5/27/1987,24,0,0,0,0,4500,5750,6250,140,115,105191,180,73,DM/M RC,2,3,2,2,1,1,3,5,1,2,1,10,11,13,10,14,10,10,13,7,11,12,10,14,14,13,14,5,14,13,11,14,10,4,12,14,14,15,15,14,14,14,9,5,17,14,20,12,4,10,8,10,5,10,14,9,5,7,12,9,14,12,1,11,20,11,16,1,20,DM/M RC,423,1,1,1,10,1,11,1,1,1,18,20,1,16,1,11,0,0,0,0,0,0,0,0,0,0,0,0,0,0,0,0,0,0,0,0,0,0,0,0,0,0,0,0,0,0,0,0,0,0,0,0,0,0,0,0,0,0,0,0,0,0,0,0,0,Robert Tesche,£1.13m ,33,182,Midfielder - Central Midfield,right,VfL Bochum,12,0,0,537,26,2,1,1245,18,0,1,1112,21,2,1,1330,37,4,5,2903,25,1,1,1615,26,0,0,1852,19,2,0,1188,31,3,2,2440,Bundesliga,26,1,1,1891,6,0,0,451
19/6/2011,Razak Boukari,8431043,50,4/25/1987,24,0,0,0,0,4800,6650,6000,145,133,1247466,182,70,AM RL,1,3,3,1,2,1,2,1,2,1,3,8,12,15,9,13,11,12,12,6,3,11,12,3,15,8,12,10,12,12,12,11,14,14,6,13,5,9,10,16,14,13,12,12,13,15,20,12,11,12,8,13,9,10,16,15,13,11,13,14,14,7,1,1,12,20,17,20,1,AM RL,505,1,1,12,1,20,17,1,1,1,1,1,12,12,1,1,2.25623E+15,0,0,0,0,0,0,0,0,0,0,0,0,0,0,0,0,0,0,0,0,0,0,0,0,0,0,0,0,0,0,0,0,0,0,0,1,0,0,0,0,0,0,1,0,0,0,0,0,Razak Boukari,£3.15m ,33,187,Forward - Right Winger,right,LB ChÃ¢teauroux,40,8,1,3181,30,6,2,1438,6,0,1,280,10,0,0,181,nan,nan,nan,nan,1,0,0,31,25,7,0,1775,24,1,0,809,20,4,1,1121,Ligue 1,1,0,0,44,3,0,0,49
19/6/2011,Ramires,2114490,1651,3/24/1987,24,25,2,0,0,6500,8150,7850,168,156,36363636,178,67,M RC,2,3,3,1,3,3,1,1,1,1,2,10,11,13,11,13,7,12,13,10,13,14,12,14,13,13,13,15,14,15,13,14,16,12,13,16,14,16,18,17,15,10,10,9,16,16,20,18,11,18,10,13,9,16,13,14,16,15,18,15,16,8,11,11,20,12,17,5,20,M RC,403,1,1,1,12,1,1,1,1,11,14,20,5,17,1,11,2147524720,0,0,0,0,1,1,1,0,0,0,0,0,0,1,0,1,0,0,0,0,0,0,0,0,0,0,0,0,0,0,0,1,0,0,0,0,0,0,0,0,0,0,0,0,0,0,0,0,Ramires,£27.00m ,33,179,Midfielder - Central Midfield,right,Sociedade Esportiva Palmeiras,41,2,0,2968,47,12,7,3861,62,9,8,4739,46,4,5,3746,34,4,4,1757,59,8,8,4246,34,12,4,3033,1,0,2,84,6,0,0,159,Premier League,30,1,0,1277,nan,nan,nan,nan
19/6/2011,Perparim Hetemaj,8505627,768,12/12/1986,24,6,0,0,0,3750,5894,6550,145,131,449216,176,71,M RC,3,1,2,3,3,1,1,8,3,1,2,10,11,13,8,11,11,7,13,10,11,12,9,12,14,19,16,18,10,12,13,10,15,12,8,14,7,12,16,13,14,13,9,12,15,13,20,16,14,14,12,9,9,13,13,16,14,12,15,12,10,8,1,1,20,15,17,12,20,M RC,403,1,1,3,15,7,10,1,1,1,10,20,12,17,1,1,0,0,0,0,0,0,0,0,0,0,0,0,0,0,0,0,0,0,0,0,0,0,0,0,0,0,0,0,0,0,0,0,0,0,0,0,0,0,0,0,0,0,0,0,0,0,0,0,0,Perparim Hetemaj,£1.62m ,33,179,Midfielder - Central Midfield,right,Benevento Calcio,31,2,3,2560,35,0,2,2147,30,0,2,2382,34,0,4,2685,33,0,1,2723,29,1,0,2379,24,0,1,1966,32,3,4,2493,31,2,1,2250,Serie A,33,0,1,2349,4,0,0,99
19/6/2011,Pedro León,67005397,796,11/24/1986,24,0,0,6,1,5500,7200,7200,157,148,0,183,81,M/AM R,3,1,1,1,3,1,1,5,2,3,1,18,18,16,10,16,17,8,15,7,5,16,13,8,18,10,13,11,16,12,17,14,13,17,11,15,8,13,11,13,15,10,11,11,12,13,20,12,9,13,12,14,5,11,11,13,6,12,12,12,13,14,1,1,18,20,20,10,12,M/AM R,522,1,1,6,12,10,20,1,1,1,1,10,8,18,1,1,2178,0,1,0,0,0,0,0,1,0,0,0,1,0,0,0,0,0,0,0,0,0,0,0,0,0,0,0,0,0,0,0,0,0,0,0,0,0,0,0,0,0,0,0,0,0,0,0,0,Pedro León,£4.05m ,33,183,Forward - Right Winger,right,SD Eibar,14,2,1,573,13,1,2,619,30,3,8,2363,40,7,5,2987,29,2,8,1756,33,3,4,2026,39,11,6,3108,12,0,3,929,9,1,0,425,LaLiga,32,2,3,1934,5,0,1,291
19/6/2011,Patrick Ebert,8725761,771,3/17/1987,24,0,0,13,1,4500,6300,6300,135,126,717509,176,76,M/AM RL,3,3,1,1,1,3,3,7,2,3,2,11,14,12,7,12,13,6,12,9,4,13,12,9,13,14,7,12,9,9,10,7,14,14,9,11,8,7,16,16,17,12,7,15,15,13,20,14,10,7,10,10,4,12,6,12,16,10,6,14,15,15,1,1,20,20,20,16,1,M/AM RL,415,1,1,1,1,16,20,1,1,1,1,1,16,20,1,1,34359738370,0,1,0,0,0,0,0,0,0,0,0,0,0,0,0,0,0,0,0,0,0,0,0,0,0,0,0,0,0,0,0,0,0,0,0,1,0,0,0,0,0,0,0,0,0,0,0,0,Patrick Ebert,£1.80m ,33,175,Midfielder - Attacking Midfield,right,AO Xanthi,12,1,3,787,32,2,5,2256,23,6,7,1799,22,3,5,1511,18,0,4,1281,10,1,0,650,28,5,4,2035,5,0,1,216,29,3,2,2047,Bundesliga,22,2,2,1654,nan,nan,nan,nan
19/6/2011,Olcay Sahan,35006596,799,5/26/1987,24,0,0,0,0,2750,6200,6200,133,124,496680,177,70,M/AM RL,3,3,1,2,1,3,1,2,1,2,2,9,12,16,8,14,9,8,9,6,6,12,9,7,14,9,9,8,11,10,13,11,10,15,8,14,6,9,15,15,15,11,9,12,12,12,20,14,9,7,6,11,8,12,15,5,11,9,15,12,6,12,1,1,16,20,20,19,14,M/AM RL,525,1,1,8,14,19,20,1,1,1,1,10,15,16,1,1,0,0,0,0,0,0,0,0,0,0,0,0,0,0,0,0,0,0,0,0,0,0,0,0,0,0,0,0,0,0,0,0,0,0,0,0,0,0,0,0,0,0,0,0,0,0,0,0,0,Olcay Sahan,£1.13m ,33,179,Forward - Right Winger,right,Yeni Malatyaspor,40,7,8,3189,30,1,4,2224,37,11,6,3036,36,8,9,2877,48,9,11,3498,41,5,6,2456,37,3,10,2689,31,5,6,2020,21,2,5,974,Bundesliga,30,1,3,1722,2,0,0,89
19/6/2011,Nolito,67017094,796,10/15/1986,24,0,0,0,0,5000,6700,6800,145,136,1726875,175,73,AM RL,3,1,1,2,3,3,3,1,3,2,1,13,12,16,13,13,10,6,11,6,4,12,12,6,14,8,12,11,13,12,12,11,10,14,8,14,6,10,12,15,15,8,7,13,12,13,20,13,8,9,6,9,7,12,12,14,12,10,10,7,10,12,1,1,10,20,16,20,12,AM RL,505,1,1,7,12,20,16,1,1,1,1,1,10,10,1,1,2.25235E+15,0,0,0,0,0,0,0,0,0,0,0,1,0,0,0,0,0,0,0,0,0,0,0,0,0,0,0,0,0,0,0,0,0,0,0,0,0,0,0,1,0,0,0,0,0,0,0,0,Nolito,£7.20m ,34,175,Forward - Left Winger,right,Celta de Vigo,43,14,1,3095,48,15,12,2648,32,4,2,2122,37,14,2,2442,37,13,14,3061,29,12,7,2452,30,6,5,1349,42,5,7,2128,17,5,3,963,Liga NOS,27,7,4,1534,6,0,1,453
19/6/2011,Nicolas Farina,8440189,769,8/9/1986,24,0,0,0,0,3300,5084,5050,125,113,135329,168,62,AM RL,1,2,1,3,3,1,1,2,2,3,2,7,11,14,11,11,7,9,11,5,3,10,13,3,14,6,12,7,12,12,11,11,13,13,5,13,7,9,13,17,14,10,3,5,9,15,20,6,6,14,6,14,12,8,12,13,15,12,10,14,14,6,1,1,14,20,20,17,1,AM RL,505,1,1,12,1,17,20,1,1,1,1,1,14,14,1,1,2,0,1,0,0,0,0,0,0,0,0,0,0,0,0,0,0,0,0,0,0,0,0,0,0,0,0,0,0,0,0,0,0,0,0,0,0,0,0,0,0,0,0,0,0,0,0,0,0,Nicolas Farina,£360Th. ,34,168,Forward - Right Winger,right,Without Club,35,6,2,1999,18,0,1,437,23,2,3,1371,3,0,0,189,9,10,1,736,8,0,0,559,nan,nan,nan,nan,21,2,1,1750,nan,nan,nan,nan,Ligue 1,nan,nan,nan,nan,nan,nan,nan,nan
19/6/2011,Nani,736009,788,11/17/1986,24,45,9,10,1,7500,8000,8050,170,163,6971722,175,66,M/AM RL,1,1,1,3,3,2,1,4,2,3,1,12,15,17,12,17,13,6,15,4,6,13,15,7,17,11,11,8,12,13,13,12,14,20,5,15,8,12,14,16,16,14,7,16,15,16,20,14,12,12,9,13,7,10,15,16,13,16,13,6,8,12,1,1,17,20,20,18,11,M/AM RL,525,1,1,5,11,18,20,1,1,1,1,8,15,17,1,1,2.32275E+15,0,0,0,0,0,0,0,0,1,0,0,0,0,0,0,0,0,0,0,0,0,0,0,0,0,0,0,0,0,0,0,0,0,0,0,1,0,0,0,1,0,0,0,0,0,0,1,0,Nani,£32.85m ,33,177,Forward - Left Winger,both,Orlando City SC,49,10,20,3674,40,10,15,2855,21,3,6,1337,13,1,0,740,38,12,8,3264,47,12,13,3732,26,5,8,1930,25,3,3,660,61,21,13,4736,Premier League,20,7,5,1585,nan,nan,nan,nan
19/6/2011,Nabil El Zhar,919627,34,8/27/1986,24,8,2,0,0,4000,5750,5750,125,115,320155,170,65,M/AM R,2,3,2,3,3,2,3,1,2,1,1,6,9,14,9,12,9,6,10,6,7,10,8,6,14,9,12,8,10,10,12,10,8,14,8,13,9,8,14,14,13,10,5,10,12,15,20,14,10,14,9,14,12,14,16,15,8,7,8,8,8,10,1,1,18,20,20,14,12,M/AM R,522,1,1,12,12,14,20,1,1,1,1,7,10,18,1,1,17448304640,0,0,0,0,0,0,0,0,0,0,0,0,0,0,0,0,0,0,0,0,0,0,0,0,0,0,0,0,1,0,0,0,0,0,1,0,0,0,0,0,0,0,0,0,0,0,0,0,Nabil El Zhar,£1.35m ,34,170,Forward - Right Winger,both,Al-Ahli SC,35,2,1,1710,27,1,3,1300,38,3,2,2136,28,5,3,1625,21,1,2,921,32,2,5,1873,28,4,4,1850,38,3,1,2665,30,4,0,1181,LaLiga,22,5,2,1919,3,2,0,256
19/6/2011,Moritz Stoppelkamp,8728271,771,12/11/1986,24,0,0,0,0,4000,6500,6500,137,130,921099,180,79,M/AM RC,1,3,1,3,1,1,1,10,3,1,2,10,11,12,11,11,9,8,12,11,9,12,10,11,11,11,13,14,11,12,11,11,10,6,10,12,11,17,15,13,13,12,10,16,11,13,20,17,10,13,8,12,7,13,9,5,14,13,13,10,9,8,1,1,19,20,20,14,18,M/AM RC,523,1,1,1,18,14,20,1,1,1,12,16,14,19,1,1,0,0,0,0,0,0,0,0,0,0,0,0,0,0,0,0,0,0,0,0,0,0,0,0,0,0,0,0,0,0,0,0,0,0,0,0,0,0,0,0,0,0,0,0,0,0,0,0,0,Moritz Stoppelkamp,£900Th. ,33,180,Forward - Right Winger,right,MSV Duisburg,24,0,0,1091,28,2,0,721,36,9,12,3039,36,7,13,3201,28,4,2,2299,31,6,2,2233,24,4,2,2134,33,9,8,2825,29,3,2,2039,Bundesliga,36,19,12,3118,nan,nan,nan,nan
19/6/2011,Mike Frantz,35004501,771,10/14/1986,24,0,0,0,0,4400,6250,6008,137,125,481803,180,77,M/AM RL,3,1,3,1,1,2,1,1,2,3,1,8,12,13,8,12,8,9,10,13,8,11,8,10,12,8,11,10,11,11,11,11,9,8,10,14,9,13,14,14,11,13,9,16,15,13,20,13,13,14,5,12,14,13,11,2,12,13,9,13,17,8,1,1,19,20,16,20,12,M/AM RL,525,1,1,1,12,20,16,1,1,1,1,1,19,15,1,1,0,0,0,0,0,0,0,0,0,0,0,0,0,0,0,0,0,0,0,0,0,0,0,0,0,0,0,0,0,0,0,0,0,0,0,0,0,0,0,0,0,0,0,0,0,0,0,0,0,Mike Frantz,£1.35m ,34,182,Midfielder - Central Midfield,right,Hannover 96,16,2,1,905,19,3,5,1070,28,1,1,1629,32,1,1,2197,27,4,1,1293,33,6,8,2525,30,0,2,2502,20,0,1,1487,34,3,2,2523,Bundesliga,20,0,1,496,6,0,0,366
19/6/2011,Mauro Zárate,961289,1649,3/18/1987,24,0,0,5,2,7000,6792,7450,161,148,2439926,176,76,AM/S RLC,2,3,3,1,2,1,2,2,1,2,1,12,14,17,13,15,15,6,15,3,4,13,15,6,17,14,10,15,12,11,13,11,16,17,11,14,6,4,12,16,15,11,6,12,14,16,20,15,10,14,14,15,11,12,15,17,13,13,9,11,14,15,1,1,1,16,16,16,15,AM/S RLC,626,1,1,20,15,16,16,1,1,1,1,1,1,1,1,1,8.79621E+13,0,0,0,0,0,0,0,0,0,0,0,0,0,0,0,0,0,1,0,0,0,0,0,0,0,0,0,1,0,0,1,0,0,0,0,0,0,0,0,0,0,0,0,0,1,0,1,0,Mauro Zárate,£8.55m ,33,175,Forward - Centre-Forward,right,Club Atlético Boca Juniors,36,9,9,2583,31,3,3,1437,10,3,3,491,32,18,6,2565,12,2,1,527,38,8,4,2111,12,4,2,482,27,14,2,2097,44,11,11,2691,Serie A,13,2,2,497,nan,nan,nan,nan
19/6/2011,Martin Harnik,35002612,755,6/10/1987,24,24,5,3,1,5650,6122,6750,141,135,3626034,185,76,AM/S RC,1,3,2,2,1,3,2,6,2,2,1,6,12,14,10,14,8,7,9,4,5,12,10,6,13,10,8,11,9,10,10,9,14,15,5,13,6,11,15,17,15,9,12,16,15,17,20,13,8,14,9,10,8,10,15,15,10,10,11,12,13,9,12,14,1,18,18,14,15,AM/S RC,623,1,1,20,15,14,18,1,8,12,1,1,1,1,5,14,524306,0,1,0,0,1,0,0,0,0,0,0,0,0,0,0,0,0,0,0,1,0,0,0,0,0,0,0,0,0,0,0,0,0,0,0,0,0,0,0,0,0,0,0,0,0,0,0,0,Martin Harnik,£9.90m ,33,185,Forward - Right Winger,right,TuS Dassendorf,44,17,12,2477,38,17,10,3072,47,12,7,3656,35,10,3,2316,29,9,3,2320,21,3,0,1084,33,21,4,2554,32,11,4,2067,22,7,4,917,Bundesliga,25,3,2,1383,2,1,1,116
19/6/2011,Marquinho,55010242,1651,8/7/1986,24,0,0,0,0,1156,4724,5013,115,105,236203,177,74,AM/S R,1,1,2,1,1,2,1,2,2,1,1,10,11,12,10,11,9,9,9,8,6,10,10,8,11,11,11,11,9,10,10,10,11,13,9,13,10,10,11,14,14,10,11,8,11,14,20,10,9,9,6,10,13,12,13,11,12,11,13,14,14,6,1,1,1,17,17,13,10,AM/S R,622,1,1,20,10,13,17,1,1,1,1,1,1,1,1,1,0,0,0,0,0,0,0,0,0,0,0,0,0,0,0,0,0,0,0,0,0,0,0,0,0,0,0,0,0,0,0,0,0,0,0,0,0,0,0,0,0,0,0,0,0,0,0,0,0,Marquinho,£4.05m ,34,182,Midfielder - Attacking Midfield,left,Figueirense Futebol Clube,38,5,9,2921,15,3,1,969,30,4,2,1471,28,2,1,1573,27,10,7,2221,53,5,3,2842,5,0,0,98,nan,nan,nan,nan,7,0,0,323,Serie A,15,0,2,1178,nan,nan,nan,nan
19/6/2011,Luis Suárez,78000335,1657,1/24/1987,24,42,17,4,2,7250,8300,8300,178,163,11637412,181,81,AM/S RL,1,2,1,2,1,3,3,8,3,3,1,10,14,15,15,16,14,12,13,9,5,15,13,5,17,11,15,13,14,14,15,12,18,15,10,15,6,14,15,15,15,15,12,13,14,15,20,15,12,14,8,13,5,11,13,16,13,15,10,4,8,7,1,1,1,17,17,17,14,AM/S RL,625,1,1,20,14,17,17,1,1,1,1,1,1,1,1,1,65568,0,0,0,0,0,1,0,0,0,0,0,0,0,0,0,0,1,0,0,0,0,0,0,0,0,0,0,0,0,0,0,0,0,0,0,0,0,0,0,0,0,0,0,0,0,0,0,0,Luis Suárez,£26.10m ,33,182,Forward - Centre-Forward,right,Atlético Madrid,37,16,16,3213,39,17,10,3254,44,30,13,3720,37,31,19,3249,43,25,23,3532,53,59,24,4766,51,36,19,4302,51,31,20,4447,49,23,15,4132,Premier League,36,21,12,2658,6,4,1,382
19/6/2011,Luís Leal,55014715,40,5/29/1987,24,0,0,0,0,1373,5000,4546,125,109,7381,176,75,AM/S RL,3,1,2,2,2,2,1,1,2,2,2,9,10,12,12,10,7,9,9,6,5,10,11,8,11,10,11,10,9,8,9,9,12,13,6,12,6,9,10,13,11,13,9,13,15,13,20,10,12,9,6,9,7,13,13,11,12,11,14,14,14,5,1,1,9,20,17,20,10,AM/S RL,515,1,1,20,10,20,17,1,1,1,1,1,9,1,1,1,0,0,0,0,0,0,0,0,0,0,0,0,0,0,0,0,0,0,0,0,0,0,0,0,0,0,0,0,0,0,0,0,0,0,0,0,0,0,0,0,0,0,0,0,0,0,0,0,0,Luís Leal,£720Th. ,33,176,Forward - Right Winger,right,Club Tijuana,29,8,1,1958,19,2,1,675,35,10,4,2698,34,17,2,2686,24,6,3,1595,33,6,8,2625,21,5,3,1377,24,9,1,2029,21,4,1,1280,Liga NOS,15,5,0,1109,7,0,0,330
19/6/2011,Loris Arnaud,8428656,769,4/16/1987,24,0,0,0,0,4100,5150,5150,130,115,103681,182,80,AM/S R,3,2,3,3,1,3,2,7,3,1,1,5,8,10,11,12,9,15,13,6,4,9,12,2,11,8,14,12,12,12,8,11,14,11,5,12,7,9,12,15,12,14,12,7,13,13,20,13,14,13,8,14,8,8,11,13,16,11,14,14,14,6,1,1,10,16,16,12,1,AM/S R,622,1,1,20,1,12,16,1,1,1,1,1,10,10,1,1,262160,0,0,0,0,1,0,0,0,0,0,0,0,0,0,0,0,0,0,1,0,0,0,0,0,0,0,0,0,0,0,0,0,0,0,0,0,0,0,0,0,0,0,0,0,0,0,0,0,Loris Arnaud,£270Th. ,33,182,Forward - Centre-Forward,right,Without Club,24,1,1,1092,nan,nan,nan,nan,6,2,0,248,18,1,0,853,19,0,0,1055,nan,nan,nan,nan,2,0,1,180,29,15,7,2601,27,9,2,2335,Ligue 1,nan,nan,nan,nan,nan,nan,nan,nan
19/6/2011,Loïc Rémy,8444388,769,1/2/1987,24,11,1,11,4,6050,7500,6801,165,150,3874142,185,78,AM/S R,3,2,3,2,2,2,2,2,3,3,3,7,10,13,14,13,9,15,12,7,5,10,15,5,14,6,14,12,11,13,9,13,15,13,6,16,6,12,14,17,15,14,13,10,15,16,20,17,14,14,8,15,7,8,14,16,13,13,12,14,14,9,1,1,12,17,17,10,1,AM/S R,622,1,1,20,1,10,17,1,1,1,1,1,10,12,1,1,8720,0,0,0,0,1,0,0,0,0,1,0,0,0,1,0,0,0,0,0,0,0,0,0,0,0,0,0,0,0,0,0,0,0,0,0,0,0,0,0,0,0,0,0,0,0,0,0,0,Loïc Rémy,£17.10m ,33,185,Forward - Centre-Forward,right,Caykur Rizespor,44,18,4,3011,47,22,8,3534,37,9,1,2226,27,14,3,2108,29,9,2,1228,20,3,1,615,8,0,0,283,24,9,0,1234,29,7,2,1396,Ligue 1,30,14,0,1532,5,4,0,291
19/6/2011,Kemy Agustien,860297,784,8/20/1986,24,0,0,6,2,3350,5750,6000,131,106,438412,178,73,M RC,3,3,1,3,2,1,1,4,3,1,2,7,10,10,5,11,6,8,7,2,5,14,9,4,14,6,14,7,9,13,13,10,9,12,10,7,7,11,10,13,14,9,10,10,13,14,20,12,10,11,12,10,10,12,8,12,14,10,13,12,12,8,1,1,20,14,15,12,20,M RC,403,1,1,1,14,1,10,1,1,1,12,20,12,15,1,1,34359738368,0,0,0,0,0,0,0,0,0,0,0,0,0,0,0,0,0,0,0,0,0,0,0,0,0,0,0,0,0,0,0,0,0,0,0,1,0,0,0,0,0,0,0,0,0,0,0,0,Kemy Agustien,£900Th. ,34,178,Midfielder - Defensive Midfield,right,Mickleover Sports FC,19,0,2,969,18,0,2,1068,21,0,1,736,14,0,1,751,5,0,0,274,10,1,0,346,9,1,0,607,10,0,0,848,13,2,2,912,Premier League,nan,nan,nan,nan,nan,nan,nan,nan
19/6/2011,Kamil Vacek,5653968,763,5/18/1987,24,0,0,2,0,3250,6250,6250,135,120,1169960,183,81,AM RC,3,3,3,1,2,3,1,1,1,1,1,12,10,12,10,14,14,5,4,5,8,16,12,7,14,9,14,8,3,9,15,10,12,16,5,15,14,8,14,12,12,8,9,16,5,15,20,14,9,14,10,4,14,8,2,12,6,6,12,18,10,10,1,1,15,20,15,1,20,AM RC,503,1,1,1,20,1,15,1,1,1,15,15,1,15,1,1,0,0,0,0,0,0,0,0,0,0,0,0,0,0,0,0,0,0,0,0,0,0,0,0,0,0,0,0,0,0,0,0,0,0,0,0,0,0,0,0,0,0,0,0,0,0,0,0,0,Kamil Vacek,£1.35m ,33,184,Midfielder - Central Midfield,right,FC Bohemians Prag 1905,34,2,1,2887,31,4,2,1773,12,0,0,750,25,2,2,819,38,0,2,2175,33,5,8,2870,28,0,1,2186,25,0,1,1399,25,2,1,1760,Serie A,23,4,2,1395,6,0,0,464
19/6/2011,Julien Quercia,8428703,769,8/17/1986,24,0,0,9,2,4500,5650,5650,135,126,464747,168,65,AM/S R,1,1,1,2,3,1,3,1,3,3,3,10,10,12,12,12,8,9,12,5,1,13,12,4,14,6,13,11,12,12,12,11,16,15,6,13,7,12,13,17,15,11,5,8,9,16,20,13,7,13,6,11,14,7,2,14,14,14,14,14,16,8,1,1,10,16,16,1,1,AM/S R,622,1,1,20,1,1,16,1,1,1,1,1,1,10,1,1,1042,0,1,0,0,1,0,0,0,0,0,1,0,0,0,0,0,0,0,0,0,0,0,0,0,0,0,0,0,0,0,0,0,0,0,0,0,0,0,0,0,0,0,0,0,0,0,0,0,Julien Quercia,£1.13m ,34,168,Forward - Centre-Forward,both,FC Thionville,29,5,4,1607,3,1,0,198,8,3,1,381,nan,nan,nan,nan,nan,nan,nan,nan,nan,nan,nan,nan,2,1,1,37,6,0,1,135,nan,nan,nan,nan,Ligue 1,nan,nan,nan,nan,nan,nan,nan,nan
19/6/2011,José Callejón,67011213,796,2/11/1987,24,0,0,4,1,5000,7250,7250,157,146,0,179,73,AM/S RL,3,3,1,3,3,1,1,2,3,1,2,10,13,15,13,11,9,10,11,8,5,12,13,6,15,9,12,14,13,13,12,12,10,16,9,15,8,12,15,15,14,12,10,12,13,14,20,13,13,13,7,10,10,12,13,17,12,13,10,6,14,10,1,1,13,18,18,17,14,AM/S RL,625,1,1,20,14,17,18,1,1,1,1,1,13,13,1,1,8.79609E+12,0,0,0,0,1,0,0,0,0,0,0,0,0,1,0,0,0,0,0,0,0,0,0,0,0,0,0,0,0,0,0,0,0,0,0,0,0,0,0,0,0,0,0,1,0,0,0,0,José Callejón,£7.20m ,33,178,Forward - Right Winger,right,ACF Fiorentina,38,6,10,2982,36,13,2,1333,41,7,5,2037,52,20,11,4055,59,12,7,4337,47,13,7,3389,49,17,15,4146,50,12,13,4163,47,4,15,3708,LaLiga,45,4,10,3001,2,0,0,78
19/6/2011,Jérémy Ménez,8430773,769,5/7/1987,24,6,0,9,2,6050,7500,6750,165,150,5297871,181,77,AM RLC,3,1,1,3,1,1,2,6,3,3,1,10,13,17,10,15,12,12,12,5,3,14,11,3,17,10,12,11,13,10,14,12,14,16,7,15,7,7,9,16,17,14,10,15,15,15,20,14,13,11,10,14,6,8,14,17,14,12,11,11,11,12,1,1,12,20,20,16,18,AM RLC,506,1,1,10,18,16,20,1,1,1,1,10,12,12,1,1,2.3222E+15,0,0,0,0,0,0,0,0,0,0,0,0,0,0,0,0,0,0,0,0,0,0,0,0,0,0,0,0,0,0,1,0,0,0,0,1,0,0,0,0,0,0,0,0,0,0,1,0,Jérémy Ménez,£16.20m ,33,182,Forward - Right Winger,right,Reggina 1914,43,4,5,2416,42,9,22,3504,42,8,12,2867,26,2,3,1032,34,16,4,2788,12,4,0,413,31,3,3,1731,25,5,5,1205,6,0,0,175,Ligue 1,19,5,4,1454,4,2,0,352
19/6/2011,Ivo Ilicevic,8726196,761,11/14/1986,24,2,1,11,5,4909,6764,6764,153,141,9117066,174,65,AM RLC,2,1,1,1,2,2,3,1,2,3,2,10,13,15,13,16,10,8,17,6,5,12,14,5,15,7,9,14,13,8,8,8,6,17,5,9,5,6,11,17,18,8,7,18,10,16,20,12,7,7,15,14,14,13,13,15,9,13,8,5,7,14,1,1,14,20,18,20,16,AM RLC,506,1,1,10,16,20,18,1,1,1,1,1,14,13,1,1,5.5083E+11,1,1,0,0,0,0,0,0,1,0,0,0,0,0,0,0,0,0,0,0,0,0,0,0,0,0,0,0,0,0,1,0,0,0,0,0,0,0,0,1,0,0,0,0,0,0,0,0,Ivo Ilicevic,£4.05m ,33,174,Forward - Left Winger,right,Without Club,24,5,7,1980,24,4,1,1583,10,1,0,395,20,4,0,1154,14,1,1,1219,32,4,4,2272,32,7,5,1936,17,6,3,882,5,0,0,119,Bundesliga,nan,nan,nan,nan,nan,nan,nan,nan
19/6/2011,Itay Shechter,7868835,775,2/22/1987,24,8,2,16,5,5000,7250,7250,151,135,2381519,179,74,S RL,1,1,3,2,1,1,2,8,1,2,1,9,12,15,16,11,5,7,8,10,8,11,15,8,14,9,11,10,13,14,12,10,15,10,14,13,12,8,12,16,12,11,11,13,13,14,20,12,12,12,6,13,11,10,8,14,8,15,14,12,9,12,1,1,1,15,15,15,1,S RL,605,1,1,20,1,15,15,1,1,1,1,1,1,1,1,1,7.03689E+13,0,0,0,0,0,0,0,0,0,0,0,0,0,0,0,0,0,0,0,0,0,0,0,0,0,0,0,1,0,0,0,0,0,0,0,0,0,0,0,0,0,0,0,0,0,0,1,0,Itay Shechter,£1.80m ,33,178,Forward - Centre-Forward,both,Maccabi Tel Aviv,21,6,1,1429,26,4,0,1620,19,1,1,678,32,8,1,2067,30,5,0,1495,26,3,5,1958,47,19,9,3542,37,9,10,2527,40,8,10,2594,Bundesliga,37,6,1,1675,7,2,0,263
19/6/2011,Ignazio Abate,7983987,776,11/12/1986,24,0,0,19,2,5750,7150,7150,154,146,31426871,180,73,D/WB R,2,3,3,3,2,1,1,2,3,1,3,5,12,14,6,13,6,11,8,12,15,13,8,13,12,15,14,14,12,13,10,13,16,7,8,17,13,14,15,17,17,13,10,8,12,16,20,14,12,14,11,9,11,13,10,15,16,12,17,14,13,7,20,18,15,13,20,1,7,D/WB R,112,1,1,1,1,1,13,1,1,20,1,7,1,15,1,18,1.09951E+12,0,1,0,0,0,1,0,0,0,0,0,0,0,0,0,0,0,0,0,0,0,0,0,0,0,0,0,0,0,0,0,0,0,0,0,0,0,0,0,0,1,0,0,0,0,0,0,0,Ignazio Abate,£10.80m ,33,180,Defender - Right-Back,right,Without Club,37,0,1,2930,40,0,3,3524,33,0,3,2777,28,1,1,2120,25,0,7,2063,28,1,1,2373,26,0,2,2170,27,1,1,1713,24,0,0,1688,Serie A,nan,nan,nan,nan,nan,nan,nan,nan
19/6/2011,Hulk,2105510,1651,7/25/1986,24,3,0,0,0,6450,7189,7950,175,159,5569108,182,75,AM/S RL,3,3,3,1,2,1,1,5,1,3,2,12,14,15,15,13,16,7,17,9,6,12,15,8,14,13,13,15,12,11,10,11,16,17,10,15,8,9,9,17,15,16,8,20,19,16,4,16,18,12,10,13,6,11,16,16,15,12,14,10,7,10,1,1,1,20,20,20,10,AM/S RL,515,1,1,17,10,20,20,1,1,1,1,1,1,1,1,1,3.58544E+13,0,0,0,0,0,0,0,0,0,1,0,0,0,0,0,0,0,0,0,0,0,0,0,0,0,0,0,0,0,0,0,0,0,0,1,1,1,0,0,1,0,0,0,0,0,1,0,0,Hulk,£30.60m ,34,180,Forward - Right Winger,left,Shanghai SIPG,53,35,27,4402,39,21,14,3162,33,13,7,2753,34,21,13,2847,45,21,15,3757,47,27,26,4074,44,30,25,3958,35,17,17,3081,37,17,10,3161,Liga NOS,14,7,1,1093,nan,nan,nan,nan
19/6/2011,Hatem Ben Arfa,919707,769,3/7/1987,24,8,2,4,0,5900,6569,7000,170,146,1763340,178,65,AM RLC,2,2,1,3,2,3,3,5,3,2,2,12,12,16,9,16,13,7,13,6,2,14,14,3,18,8,13,9,13,10,15,10,14,17,6,14,5,8,9,17,15,14,9,20,14,15,15,13,8,10,8,14,8,8,10,17,11,6,7,12,12,16,1,1,10,20,16,16,20,AM RLC,506,1,1,1,20,16,16,1,1,1,1,10,8,8,1,1,35433481220,0,0,1,0,0,0,0,0,0,0,1,0,0,0,0,0,0,0,0,0,0,0,0,0,0,0,0,0,0,0,1,0,0,0,0,1,0,0,0,0,0,0,0,0,0,0,0,0,Hatem Ben Arfa,£12.15m ,33,179,Midfielder - Attacking Midfield,left,FC Girondins Bordeaux,6,1,1,274,30,6,6,1879,22,4,3,1591,30,3,7,1450,10,1,1,564,37,18,7,3100,32,4,7,1136,nan,nan,nan,nan,41,9,6,3230,Premier League,5,0,0,158,2,0,1,149
19/6/2011,Graham Dorrans,5207960,793,5/5/1987,24,5,0,6,0,5000,7000,6601,148,137,1059623,181,73,M/AM RLC,3,3,1,2,3,2,3,5,2,1,3,11,12,14,12,13,13,9,13,6,10,14,11,9,14,9,12,11,13,12,14,15,16,13,12,15,12,14,15,14,13,13,8,12,14,14,20,14,10,13,8,10,5,14,17,13,14,13,15,11,13,3,1,2,20,20,15,15,20,M/AM RLC,416,1,1,10,20,15,15,1,1,1,14,20,15,15,1,2,2.2606E+15,0,0,0,0,0,0,0,0,0,0,0,0,0,0,0,0,0,0,0,1,0,0,1,0,0,0,0,0,0,0,0,0,0,0,0,0,0,0,0,0,0,0,0,1,0,0,0,0,Graham Dorrans,£2.25m ,33,177,Midfielder - Central Midfield,right,Dundee FC,25,1,3,1778,37,4,3,2061,28,1,3,1940,17,2,0,1405,40,4,4,2794,27,0,3,1726,24,6,1,1925,20,5,4,1628,3,0,0,88,Premier League,23,1,5,2007,3,1,1,270
19/6/2011,Gonçalo Abreu,55009275,788,6/25/1986,24,0,0,0,0,1000,4500,4500,118,104,41682,190,81,AM RL,3,2,2,3,2,3,1,1,2,1,3,11,11,12,10,11,10,11,11,8,6,10,10,8,11,11,10,11,10,9,9,9,14,12,10,12,8,9,10,12,12,12,12,20,14,12,7,12,14,10,7,10,10,12,9,12,15,13,6,13,13,6,1,7,10,20,15,20,10,AM RL,505,1,1,10,10,20,15,1,1,1,1,1,10,1,7,1,0,0,0,0,0,0,0,0,0,0,0,0,0,0,0,0,0,0,0,0,0,0,0,0,0,0,0,0,0,0,0,0,0,0,0,0,0,0,0,0,0,0,0,0,0,0,0,0,0,Gonçalo Abreu,£405Th. ,34,190,Forward - Right Winger,right,Retired,24,4,0,1593,10,0,0,547,22,3,0,1631,1,0,0,24,41,5,5,3171,41,5,5,2481,42,9,7,3142,24,4,4,1666,10,0,1,325,Liga NOS,nan,nan,nan,nan,nan,nan,nan,nan
19/6/2011,Gervinho,8168166,24,5/27/1987,24,25,6,4,1,6450,7950,7150,175,159,20190211,179,68,AM RL,2,2,3,3,2,3,2,3,1,2,2,9,13,17,15,14,11,7,12,5,3,12,12,3,17,10,13,10,15,12,14,13,15,18,9,16,6,11,12,18,16,13,8,12,13,16,20,14,9,14,10,15,8,8,12,17,13,13,10,14,14,8,1,1,10,20,20,17,13,AM RL,505,1,1,14,13,17,20,1,1,1,1,1,10,10,1,1,2.25183E+15,0,0,0,0,1,0,0,0,0,0,1,0,0,0,0,0,0,0,0,0,1,0,0,0,0,0,0,0,0,0,0,0,0,0,0,1,0,0,0,0,0,0,0,0,0,0,0,0,Gervinho,£12.60m ,33,179,Forward - Left Winger,right,Parma Calcio 1913,50,18,11,3749,37,4,7,2323,26,7,5,1565,37,12,12,3010,34,7,6,2617,35,10,7,2636,4,1,1,257,7,0,3,598,30,11,3,2310,Premier League,32,9,4,2357,4,0,0,339
19/6/2011,Gabby Agbonlahor,5123498,765,10/13/1986,24,3,0,16,4,6050,7100,7100,155,146,2537365,180,79,AM/S RL,1,2,1,1,1,3,2,5,1,1,3,2,10,10,12,9,3,13,6,1,4,11,7,3,9,14,10,13,11,10,8,10,12,7,6,11,5,11,12,18,9,11,9,8,16,19,20,14,16,14,9,16,8,13,11,12,19,12,14,13,13,9,1,1,1,18,18,18,1,AM/S RL,625,1,1,20,1,18,18,1,1,1,1,1,1,1,1,1,134488080,0,0,0,0,1,0,0,0,0,0,0,0,0,1,0,0,0,0,1,0,0,0,0,0,0,0,0,1,0,0,0,0,0,0,0,0,0,0,0,0,0,0,0,0,0,0,0,0,Gabriel Agbonlahor,£10.80m ,34,183,Forward - Centre-Forward,right,Retired,32,5,2,1988,36,6,7,2968,34,12,6,2638,31,4,8,2513,36,6,1,2823,18,1,2,1195,17,1,2,763,6,1,1,284,nan,nan,nan,nan,Premier League,nan,nan,nan,nan,nan,nan,nan,nan
19/6/2011,Eljero Elia,859944,784,2/13/1987,24,22,2,7,1,7550,7250,7700,166,153,3210672,176,75,AM RL,1,3,1,2,2,2,3,1,3,2,2,10,12,18,13,18,8,5,12,7,5,11,10,6,17,8,9,7,13,6,15,14,5,19,4,8,5,5,16,18,17,16,7,8,12,18,20,13,11,7,5,12,14,14,10,16,7,9,6,13,10,15,1,1,14,20,15,20,10,AM RL,505,1,1,14,10,20,15,1,1,1,1,1,14,12,1,1,5.84116E+11,1,1,0,0,0,0,0,0,0,0,0,0,0,0,1,0,0,0,0,0,0,0,0,0,0,0,0,0,0,0,0,0,0,0,0,1,0,0,0,1,0,0,0,0,0,0,0,0,Eljero Elia,£4.50m ,33,176,Forward - Left Winger,right,FC Utrecht,25,2,3,1736,10,0,1,359,25,1,3,1798,33,4,4,2019,27,2,1,1561,41,10,6,3184,32,10,8,2350,32,8,5,2176,24,1,1,1254,Serie A,30,3,2,1677,4,0,0,54
19/6/2011,Edu Oriol,67006859,796,11/5/1986,24,0,0,0,0,3700,6200,6200,132,122,466759,177,72,M/AM RL,3,1,2,2,3,1,1,1,3,3,2,8,13,12,7,10,6,6,10,5,9,11,8,11,12,9,10,12,11,12,11,10,10,11,6,13,9,13,13,15,14,7,9,11,14,14,20,13,10,8,8,10,5,11,16,6,3,10,20,14,11,7,11,15,16,20,20,18,10,M/AM RL,525,1,1,12,10,18,20,1,1,11,1,1,16,16,1,15,0,0,0,0,0,0,0,0,0,0,0,0,0,0,0,0,0,0,0,0,0,0,0,0,0,0,0,0,0,0,0,0,0,0,0,0,0,0,0,0,0,0,0,0,0,0,0,0,0,Edu Oriol,£900Th. ,33,177,Forward - Left Winger,both,Atlético Sanluqueño,31,6,0,2048,22,2,0,1090,23,0,1,992,25,5,0,1114,24,2,0,1635,13,0,2,852,5,0,0,256,nan,nan,nan,nan,34,6,0,2725,LaLiga,13,0,0,1021,2,0,0,180
19/6/2011,Edinson Cavani,78005742,1657,2/14/1987,24,19,3,13,9,7500,7900,8250,176,165,5102987,188,72,AM/S R,1,3,3,3,2,1,3,2,2,1,3,8,8,13,17,15,6,15,15,8,4,15,15,2,14,11,12,15,15,14,12,15,14,11,15,17,12,14,19,13,13,14,14,11,18,17,20,20,15,16,7,14,7,16,13,14,14,17,15,17,15,2,1,1,1,17,17,10,6,AM/S R,622,1,1,20,6,10,17,1,1,1,1,1,1,1,1,1,4.39805E+12,0,0,0,0,0,0,0,0,0,0,0,0,0,0,0,0,0,0,0,1,0,0,0,0,0,0,0,0,0,0,0,0,0,0,0,0,0,0,0,0,0,0,1,0,0,0,0,0,Edinson Cavani,£31.50m ,33,184,Forward - Centre-Forward,right,Manchester United,47,33,7,3833,48,33,3,4064,43,38,4,3653,43,25,6,3418,53,31,2,4151,52,25,6,3629,50,49,6,4138,48,40,11,3956,33,23,9,2391,Serie A,22,7,3,1096,1,0,0,32
19/6/2011,Edgar Costa,55014155,788,4/14/1987,24,0,0,0,0,1593,5250,5250,122,107,69851,180,72,AM R,3,2,3,1,2,1,2,2,1,2,1,10,11,11,10,10,8,8,9,7,7,9,11,7,11,11,11,10,9,9,9,9,14,12,8,12,8,9,11,14,12,11,10,8,12,13,20,11,12,9,7,10,10,11,11,11,13,11,14,13,13,5,10,10,7,20,20,10,10,AM R,502,1,1,12,10,10,20,1,1,10,1,1,1,7,1,10,0,0,0,0,0,0,0,0,0,0,0,0,0,0,0,0,0,0,0,0,0,0,0,0,0,0,0,0,0,0,0,0,0,0,0,0,0,0,0,0,0,0,0,0,0,0,0,0,0,Edgar Costa,£810Th. ,33,177,Midfielder - Right Midfield,right,CS Marítimo,29,3,1,1766,18,1,0,788,8,0,0,321,19,6,0,1020,36,5,6,2452,36,6,8,2932,31,2,7,2372,28,2,4,1984,32,4,6,1981,Liga NOS,30,0,2,1860,5,0,0,289
19/6/2011,Éder,2105181,1651,11/15/1986,24,0,0,0,0,5150,5750,6100,136,129,546094,180,76,AM/S R,1,2,3,3,1,1,3,4,1,2,3,4,10,16,16,13,10,7,12,4,5,13,14,5,17,8,10,8,5,11,9,14,15,15,9,12,10,10,9,17,14,10,11,5,16,15,20,11,14,10,10,8,5,9,12,15,13,7,10,15,3,9,1,1,1,17,17,10,10,AM/S R,622,1,1,20,10,10,17,1,1,1,1,1,1,1,1,1,1.76609E+13,0,0,0,0,0,0,0,0,0,0,0,0,0,0,0,0,0,0,0,0,0,0,0,0,0,0,0,0,0,0,0,0,0,0,0,0,1,0,0,0,0,0,0,0,1,0,0,0,Éder,£2.70m ,32,190,Forward - Centre-Forward,both,Lokomotiv Moscow,27,5,2,1384,22,7,4,1858,31,16,5,2413,16,4,3,1064,38,14,3,2268,29,6,4,1582,37,7,5,2842,28,4,2,1414,35,3,1,1524,Liga NOS,30,6,1,2210,12,1,0,755
19/6/2011,Djalma,55008689,6,5/30/1987,24,10,0,0,0,3250,6450,6350,141,129,554240,175,76,AM RL,2,1,2,3,3,3,3,4,3,1,2,11,12,14,12,11,9,7,9,7,7,10,10,8,12,10,10,10,11,10,10,11,13,16,10,13,8,9,9,14,13,11,7,15,12,14,20,11,9,11,7,10,6,10,14,14,14,13,14,15,15,5,1,1,5,20,20,20,10,AM RL,505,1,1,5,10,20,20,1,1,1,1,5,5,5,1,1,0,0,0,0,0,0,0,0,0,0,0,0,0,0,0,0,0,0,0,0,0,0,0,0,0,0,0,0,0,0,0,0,0,0,0,0,0,0,0,0,0,0,0,0,0,0,0,0,0,Djalma,£3.15m ,33,176,Forward - Right Winger,right,SC Farense,33,5,6,2476,19,3,3,946,24,5,10,1777,30,7,5,2298,32,4,3,1952,28,7,8,2323,44,5,5,3212,32,7,3,1998,31,4,5,2501,Liga NOS,28,7,4,1437,nan,nan,nan,nan
19/6/2011,Dimitri Payet,8442349,769,3/29/1987,24,3,0,12,4,5810,7162,6461,165,143,2806799,174,70,AM RL,1,3,1,1,2,3,1,1,3,2,2,12,11,15,12,14,14,7,14,6,3,12,12,4,16,8,12,9,13,11,13,12,15,14,6,13,6,11,13,16,15,12,7,16,14,14,20,13,11,12,8,16,9,8,9,16,12,10,9,14,14,13,1,1,13,20,20,18,14,AM RL,505,1,1,12,14,18,20,1,1,1,1,10,13,13,1,1,2.26998E+15,0,0,0,0,0,0,0,0,0,0,0,0,0,0,0,0,0,0,0,0,0,0,0,0,0,0,0,0,0,0,0,0,0,0,0,1,0,0,0,1,0,0,0,0,1,0,0,0,Dimitri Payet,£7.65m ,33,175,Forward - Left Winger,right,Olympique Marseille,34,13,6,2613,43,6,8,2301,52,13,23,4206,45,8,8,3063,38,7,21,3203,38,12,15,3223,39,8,11,3153,47,10,23,3536,38,6,8,2461,Ligue 1,27,12,6,2400,6,1,1,424
19/6/2011,Davide Lanzafame,1414503,776,2/9/1987,24,0,0,7,1,4000,6200,6200,140,124,255831,180,75,M/AM/S RL,3,3,2,3,3,2,2,6,2,3,1,12,13,13,12,12,12,12,4,7,7,12,11,10,14,11,11,12,10,8,9,11,10,11,9,12,8,13,13,13,12,10,11,10,16,15,20,13,11,8,5,12,3,12,6,11,18,7,7,11,12,5,1,1,16,20,20,18,8,M/AM/S RL,535,1,1,16,8,18,20,1,1,1,1,1,16,16,1,1,0,0,0,0,0,0,0,0,0,0,0,0,0,0,0,0,0,0,0,0,0,0,0,0,0,0,0,0,0,0,0,0,0,0,0,0,0,0,0,0,0,0,0,0,0,0,0,0,0,Davide Lanzafame,£900Th. ,33,180,Forward - Centre-Forward,right,Adana Demirspor,22,0,0,805,13,2,0,505,28,7,6,1744,nan,nan,nan,nan,25,1,3,1589,35,1,5,1993,27,12,6,2313,41,22,15,3660,34,17,8,2614,Serie A,35,15,3,2656,5,0,0,70
19/6/2011,Dani Estrada,1507539,796,1/3/1987,24,0,0,0,0,4250,6000,6000,132,126,273006,177,68,D R,2,2,1,3,3,1,1,1,3,3,3,12,17,12,12,9,12,12,14,9,11,11,7,13,13,11,15,13,12,12,11,10,11,10,8,14,8,12,11,14,13,12,11,12,9,14,20,14,9,11,6,9,5,14,13,10,15,11,14,14,15,3,20,15,11,15,20,9,1,D R,102,1,1,1,1,9,15,1,7,20,1,1,1,11,1,15,1.09951E+12,0,0,0,0,0,0,0,0,0,1,0,0,0,0,0,0,0,0,0,0,0,0,0,0,0,0,0,0,0,0,0,0,0,0,0,0,0,0,0,0,1,0,0,0,0,0,0,0,Dani Estrada,£2.25m ,33,179,Defender - Right-Back,right,Barakaldo CF,21,1,1,1806,32,2,1,2531,20,0,1,1060,5,0,0,405,1,0,0,0,21,1,0,1133,19,2,2,1670,35,1,0,2974,39,2,0,3510,LaLiga,26,3,0,2283,1,0,0,90
19/6/2011,Craig Gardner,5123512,765,11/25/1986,24,0,0,14,2,4600,6100,6100,144,129,2181818,178,72,M RC,1,2,2,1,2,1,3,5,2,3,2,14,11,11,12,12,13,8,14,9,6,12,12,12,12,18,11,18,11,12,10,12,12,12,8,14,12,14,16,14,12,14,8,11,15,12,20,17,12,12,14,9,9,14,5,14,7,12,12,7,10,6,14,1,20,14,16,14,20,M RC,403,1,1,1,14,1,1,1,1,14,1,20,14,16,1,1,3.53218E+13,0,0,0,0,0,0,0,0,1,0,0,0,0,0,0,0,0,0,0,0,0,0,0,0,0,0,0,0,0,0,0,0,0,0,0,0,0,1,0,0,0,0,0,0,0,1,0,0,Craig Gardner,£5.40m ,33,176,Midfielder - Central Midfield,right,Retired,37,10,0,2764,38,4,1,2846,37,8,2,3192,26,3,2,1271,38,3,5,2949,38,3,3,2454,30,2,1,1914,30,2,2,2067,22,1,1,768,Premier League,1,0,0,90,nan,nan,nan,nan
19/6/2011,Ashkan Dejagah,894133,771,7/5/1986,24,0,0,20,4,4766,6511,6511,141,134,776688,181,80,AM RL,3,2,2,2,2,3,1,1,2,2,2,12,13,14,12,17,11,11,14,6,6,13,12,6,15,16,7,15,8,7,7,6,16,17,8,13,5,4,15,16,16,15,13,16,10,14,20,13,11,10,13,11,8,15,10,12,7,15,10,7,8,17,1,1,14,20,20,16,14,AM RL,505,1,1,14,14,16,20,1,1,1,1,5,12,14,1,1,7.04042E+13,0,1,0,0,0,0,0,0,0,1,0,0,0,0,0,0,0,0,0,0,0,0,0,0,0,0,0,0,0,0,1,0,0,0,0,1,0,0,0,0,0,0,0,0,0,0,1,0,Ashkan Dejagah,£4.50m ,34,181,Forward - Right Winger,right,Tractor FC,23,3,1,1072,27,3,10,2044,26,0,4,1500,25,6,2,1536,23,5,0,1670,15,2,0,1327,4,0,0,142,1,0,0,14,25,6,4,2092,Bundesliga,8,0,0,511,nan,nan,nan,nan
19/6/2011,Arda Turan,8476193,799,1/30/1987,24,44,11,2,0,6750,7750,7500,171,150,3794467,176,72,AM RLC,3,2,1,1,2,1,3,4,2,2,2,14,14,17,12,15,13,13,12,6,6,15,13,12,18,13,15,13,17,12,17,16,12,17,12,13,9,12,13,13,13,14,8,13,9,12,20,10,11,13,10,16,10,15,6,16,13,14,12,12,9,13,3,10,12,20,15,19,20,AM RLC,506,1,1,12,20,19,15,1,3,3,3,10,12,10,10,10,1.42824E+11,0,0,0,0,0,0,0,0,0,0,0,0,0,0,0,0,0,0,0,0,0,0,0,0,1,0,0,0,0,0,1,0,1,0,0,0,0,1,0,0,0,0,0,0,0,0,0,0,Arda Turan,£13.95m ,33,177,Forward - Left Winger,right,Galatasaray SK,19,6,3,1393,45,5,12,3036,41,5,8,2915,46,9,6,2991,46,3,6,3384,25,2,4,1200,30,13,7,1847,11,2,1,623,16,0,3,793,LaLiga,12,0,0,297,7,0,0,300
19/6/2011,Alexander Baumjohann,8718228,771,1/23/1987,24,0,0,2,0,4850,6600,6700,146,134,323808,178,73,AM RLC,2,1,3,1,1,3,1,4,3,1,2,13,12,15,7,17,10,9,14,8,4,16,13,6,17,6,12,6,10,7,17,9,5,16,4,8,5,5,6,16,17,9,7,17,13,14,20,11,7,5,8,14,12,12,8,16,8,15,7,12,12,6,1,1,15,20,20,15,18,AM RLC,506,1,1,8,18,15,20,1,1,1,1,10,10,15,1,1,5.50846E+11,0,0,1,0,0,0,0,1,0,0,0,0,0,0,0,0,0,0,0,0,0,0,0,0,1,0,0,0,0,0,1,0,0,0,0,0,0,0,0,1,0,0,0,0,0,0,0,0,Alexander Baumjohann,£1.13m ,33,178,Midfielder - Attacking Midfield,right,Sydney FC,17,0,3,969,17,0,5,705,28,6,11,2230,11,0,4,663,1,0,0,10,27,1,2,476,5,1,3,346,3,0,1,66,23,4,4,1641,Bundesliga,29,1,6,1973,nan,nan,nan,nan
19/6/2011,Alejandro Alfaro,1504996,796,11/23/1986,24,0,0,4,0,4750,6800,6800,153,138,254686,173,71,AM/S RC,3,2,2,2,2,1,1,6,1,1,1,10,13,14,15,15,10,13,14,5,4,13,12,5,15,8,12,9,13,9,14,15,13,16,10,16,7,11,10,14,15,8,8,13,10,14,20,12,8,12,8,15,8,12,12,14,14,12,14,15,15,6,1,1,8,20,15,12,20,AM/S RC,513,1,1,18,20,12,15,1,1,1,1,1,5,8,1,1,1424,0,0,0,0,1,0,0,1,1,0,1,0,0,0,0,0,0,0,0,0,0,0,0,0,0,0,0,0,0,0,0,0,0,0,0,0,0,0,0,0,0,0,0,0,0,0,0,0,Alejandro Alfaro,£2.70m ,33,175,Forward - Left Winger,right,Retired,27,7,2,1168,35,3,2,1745,31,7,2,1622,39,9,8,2866,7,1,1,444,13,1,1,797,33,7,1,2172,29,2,3,1209,23,5,3,1409,LaLiga,15,0,0,560,nan,nan,nan,nan
19/6/2011,Alberto Lora,67011231,796,3/25/1987,24,0,0,0,0,4500,6534,6534,151,141,707375,165,66,D/M RC,3,2,1,2,3,3,2,5,2,3,2,9,13,12,9,13,4,13,13,13,13,15,11,13,14,12,13,14,11,14,9,13,12,11,10,13,13,16,16,13,14,14,8,7,15,14,20,16,14,18,10,12,10,12,14,10,14,13,18,17,8,15,20,15,19,15,20,5,19,D/M RC,113,1,1,5,13,5,15,1,5,20,5,19,5,15,5,15,0,0,0,0,0,0,0,0,0,0,0,0,0,0,0,0,0,0,0,0,0,0,0,0,0,0,0,0,0,0,0,0,0,0,0,0,0,0,0,0,0,0,0,0,0,0,0,0,0,Alberto Lora,£2.52m ,33,164,Midfielder - Central Midfield,right,Marino Luanco,37,0,5,3261,28,3,1,2331,32,0,4,2381,37,0,4,2866,41,1,0,3637,32,0,4,2501,7,0,0,376,10,1,0,683,16,0,0,1129,LaLiga,27,0,0,2400,2,0,0,66
19/6/2011,Aaron Lennon,5109664,765,4/16/1987,24,19,0,5,0,6300,7700,7550,158,150,7444945,169,67,M/AM RL,2,2,2,3,2,2,2,5,2,1,2,9,13,15,12,14,7,7,7,5,7,14,9,7,15,5,13,9,9,9,14,10,11,15,4,13,7,13,14,18,16,16,5,14,15,17,20,13,8,10,6,15,5,14,4,15,14,11,13,10,14,4,1,1,20,20,20,15,13,M/AM RL,415,1,1,8,13,15,20,1,1,1,1,10,15,20,1,1,2,0,1,0,0,0,0,0,0,0,0,0,0,0,0,0,0,0,0,0,0,0,0,0,0,0,0,0,0,0,0,0,0,0,0,0,0,0,0,0,0,0,0,0,0,0,0,0,0,Aaron Lennon,£14.40m ,33,165,Forward - Right Winger,right,Kayserispor,47,3,8,3350,32,4,8,2141,46,4,9,3679,33,1,5,2642,31,2,3,1810,31,6,2,2086,13,1,1,667,33,0,4,2113,22,1,1,1563,Premier League,19,0,1,734,3,0,0,112
19/6/2011,Aaron Hunt,894135,771,9/4/1986,24,2,0,13,3,5505,6803,6803,150,138,3604337,183,73,AM RLC,1,1,1,3,1,1,2,4,1,2,2,10,14,13,16,15,10,7,14,6,5,15,12,7,16,6,12,7,11,7,16,16,5,17,6,17,8,9,11,12,15,10,10,20,7,14,10,12,9,7,15,11,17,17,3,16,10,14,4,7,9,18,1,1,14,20,19,18,20,AM RLC,506,1,1,15,20,18,19,1,1,1,1,14,14,1,1,1,6.01296E+11,0,0,0,0,0,0,0,0,0,0,0,0,0,0,1,0,0,0,0,0,1,0,0,0,0,0,0,0,0,0,0,0,0,0,1,1,0,0,0,1,0,0,0,0,0,0,0,0,Aaron Hunt,£4.50m ,34,183,Midfielder - Attacking Midfield,left,Hamburger SV,38,3,4,2493,19,3,4,1671,29,11,4,2433,32,7,9,2796,22,4,1,822,23,1,3,1739,26,4,2,1575,30,3,2,2246,24,5,4,1676,Bundesliga,24,8,2,1725,5,1,1,344
19/6/2011,Yoan Gouffran,8438591,769,5/25/1986,25,0,0,24,4,4650,5850,5850,145,130,747779,175,70,AM/S R,1,1,1,3,3,3,2,6,1,3,1,5,9,13,11,13,10,12,15,5,4,11,13,4,14,9,13,11,8,10,11,8,14,13,6,14,8,13,14,16,14,12,9,10,14,16,20,14,11,10,8,13,8,10,10,15,11,11,13,14,14,13,1,1,15,18,18,10,12,AM/S R,622,1,1,20,12,10,18,1,1,1,1,12,10,15,1,1,5.54051E+11,0,0,0,0,0,0,0,0,0,0,0,0,0,1,0,0,0,0,0,0,0,0,0,0,0,0,0,0,0,0,0,0,1,0,0,0,0,0,0,1,0,0,0,0,0,0,0,0,Yoan Gouffran,£5.40m ,34,175,Midfielder - Attacking Midfield,right,FC Ararat-Armenia Yerevan,24,2,1,1527,37,14,3,2874,42,15,3,3271,39,7,5,2966,33,2,1,2066,10,0,0,403,45,7,5,3267,31,1,1,2057,22,1,2,1042,Ligue 1,15,1,1,712,8,0,0,598
19/6/2011,Yannick Djaló,744161,788,5/5/1986,25,1,0,14,1,4750,6600,6600,149,132,965309,171,68,AM/S RL,3,2,3,3,1,1,2,6,1,1,1,11,12,14,11,12,9,6,11,7,7,10,10,7,14,10,10,11,7,9,9,8,14,16,10,15,8,9,12,16,14,10,7,10,16,15,20,12,11,10,6,13,6,12,13,16,15,14,13,14,14,6,1,1,1,20,20,17,10,AM/S RL,515,1,1,16,10,17,20,1,1,1,1,1,1,1,1,1,34360270860,0,0,1,1,0,0,0,0,0,0,0,0,0,1,0,0,0,0,0,1,0,0,0,0,0,0,0,0,0,0,0,0,0,0,0,1,0,0,0,0,0,0,0,0,0,0,0,0,Yannick Djaló,£4.05m ,34,171,Forward - Left Winger,right,Retired,33,9,2,2276,10,0,1,470,20,1,0,1033,18,3,1,1134,10,1,0,771,34,16,7,2378,nan,nan,nan,nan,19,4,0,955,nan,nan,nan,nan,Liga NOS,nan,nan,nan,nan,nan,nan,nan,nan
19/6/2011,Tom De Mul,537831,757,3/4/1986,25,2,0,27,5,4800,6100,6100,135,122,317059,177,71,M/AM R,2,1,2,3,3,2,1,4,1,3,3,14,17,14,12,14,11,4,9,5,3,13,9,3,15,8,9,13,14,10,13,12,14,13,5,14,8,11,10,14,14,7,8,9,8,15,20,7,7,13,7,12,16,5,9,14,9,13,14,15,17,7,1,1,17,20,20,12,5,M/AM R,522,1,1,1,5,12,20,1,1,1,1,1,8,17,1,1,2,0,1,0,0,0,0,0,0,0,0,0,0,0,0,0,0,0,0,0,0,0,0,0,0,0,0,0,0,0,0,0,0,0,0,0,0,0,0,0,0,0,0,0,0,0,0,0,0,Tom De Mul,£720Th. ,34,177,Midfielder - Right Midfield,right,Retired,nan,nan,nan,nan,0,0,0,0,nan,nan,nan,nan,nan,nan,nan,nan,nan,nan,nan,nan,nan,nan,nan,nan,nan,nan,nan,nan,nan,nan,nan,nan,nan,nan,nan,nan,LaLiga,nan,nan,nan,nan,nan,nan,nan,nan
19/6/2011,Tobias Weis,8707889,771,7/30/1985,25,1,0,0,0,4750,6700,6700,143,136,498886,170,68,M/AM RLC,1,3,2,2,2,1,1,5,2,1,2,11,12,13,5,12,8,6,6,8,18,13,10,12,14,19,11,20,7,10,12,9,18,13,10,14,8,14,18,17,18,15,5,15,12,13,20,16,8,9,15,10,13,17,13,13,10,10,11,12,8,5,1,1,20,18,20,18,19,M/AM RLC,416,1,1,12,14,14,18,1,1,1,14,19,18,20,1,1,16875650,0,1,0,0,0,0,0,1,0,0,0,0,0,0,0,1,1,0,0,0,0,0,0,0,1,0,0,0,0,0,0,0,0,0,0,0,0,0,0,0,0,0,0,0,0,0,0,0,Tobias Weis,£1.35m ,35,170,Midfielder - Central Midfield,both,Retired,20,0,0,1298,16,0,1,1206,22,2,4,1649,5,0,0,100,13,2,0,860,6,0,0,156,nan,nan,nan,nan,0,0,0,0,nan,nan,nan,nan,Bundesliga,nan,nan,nan,nan,nan,nan,nan,nan
19/6/2011,Tiago Targino,8875666,788,6/6/1986,25,0,0,6,1,3500,5750,6150,144,123,342479,180,74,AM RL,2,2,2,1,3,2,3,5,3,2,3,13,12,14,10,12,10,7,9,7,5,10,10,4,14,7,7,9,8,9,8,10,14,15,7,15,7,8,12,16,15,7,8,17,14,15,20,7,6,9,6,13,8,13,5,15,14,15,13,15,14,8,1,1,5,20,20,15,14,AM RL,505,1,1,14,14,15,20,1,1,1,1,1,5,5,1,1,7.04031E+13,1,1,0,0,0,0,0,0,0,0,0,0,0,0,0,0,0,0,0,0,0,0,0,0,0,0,0,0,0,0,0,0,0,0,0,1,0,0,0,0,0,0,0,0,0,0,1,0,Tiago Targino,£1.53m ,34,180,Forward - Right Winger,right,Comércio e Indústria,21,3,2,1016,31,2,0,1936,33,4,1,1949,14,1,0,468,nan,nan,nan,nan,nan,nan,nan,nan,nan,nan,nan,nan,8,3,3,576,2,0,0,108,Liga NOS,nan,nan,nan,nan,nan,nan,nan,nan
19/6/2011,Stiven Rivic,8718324,761,8/9/1985,25,0,0,0,0,3500,6000,6000,138,120,259046,181,79,AM RL,1,2,1,3,3,3,2,3,3,1,3,11,13,13,12,12,10,7,11,8,7,12,11,9,13,8,11,11,12,11,13,11,14,12,8,13,7,12,12,14,12,12,9,12,8,13,20,10,10,10,8,8,13,14,12,14,12,9,13,12,12,10,1,1,15,20,15,20,13,AM RL,505,1,1,13,13,20,15,1,1,1,1,1,15,15,1,1,0,0,0,0,0,0,0,0,0,0,0,0,0,0,0,0,0,0,0,0,0,0,0,0,0,0,0,0,0,0,0,0,0,0,0,0,0,0,0,0,0,0,0,0,0,0,0,0,0,,,,,,,,,,,,,,,,,,,,,,,,,,,,,,,,,,,,,,,,,,,,,,,,,,,,
19/6/2011,Sidnei,55044738,12,4/21/1986,25,5,1,0,0,1000,4950,4500,110,90,69811,173,68,AM R,2,1,1,1,3,2,3,5,3,2,3,9,9,11,8,10,6,5,8,5,6,8,10,6,11,11,11,9,8,8,8,7,12,13,7,12,6,8,11,12,12,12,5,10,8,12,20,8,8,9,7,9,7,11,10,16,11,11,13,13,13,13,1,1,9,20,20,10,7,AM R,502,1,1,7,7,10,20,1,1,1,1,1,1,9,1,1,0,0,0,0,0,0,0,0,0,0,0,0,0,0,0,0,0,0,0,0,0,0,0,0,0,0,0,0,0,0,0,0,0,0,0,0,0,0,0,0,0,0,0,0,0,0,0,0,0,Sidnei,£225Th. ,34,172,Midfielder - Central Midfield,right,Recreativo do Libolo,16,1,1,1034,3,0,0,169,7,2,0,557,nan,nan,nan,nan,nan,nan,nan,nan,nan,nan,nan,nan,nan,nan,nan,nan,nan,nan,nan,nan,nan,nan,nan,nan,Liga NOS,nan,nan,nan,nan,nan,nan,nan,nan
19/6/2011,Salomon Kalou,859510,24,8/5/1985,25,39,12,0,0,7000,8000,7600,165,147,3025953,186,79,AM/S RL,3,1,1,3,3,3,1,5,2,3,2,7,12,13,11,14,9,13,10,4,8,10,16,7,10,7,16,13,11,14,13,8,16,13,8,15,12,11,12,16,17,13,12,12,16,15,20,15,12,7,6,14,5,13,15,17,8,12,14,15,17,12,1,1,10,20,18,20,12,AM/S RL,515,1,1,16,12,20,18,1,1,1,1,1,10,10,1,1,4.43254E+12,0,0,0,1,0,0,0,0,0,0,0,0,0,0,0,0,0,0,0,0,0,0,0,0,0,0,0,1,0,0,0,0,0,0,0,1,0,0,0,0,0,0,1,0,0,0,0,0,Salomon Kalou,£5.40m ,35,184,Forward - Left Winger,right,Botafogo de Futebol e Regatas,42,13,7,2178,26,5,3,1476,37,16,6,2900,40,18,5,3285,31,6,2,2099,37,17,2,2972,31,8,5,2490,36,12,3,2535,33,8,4,2573,Premier League,20,3,0,1074,nan,nan,nan,nan
19/6/2011,Paulo Machado,744562,788,3/31/1986,25,0,0,9,3,4900,6243,6190,155,138,606164,174,74,M RLC,1,2,1,1,1,1,1,3,1,1,1,13,13,12,10,15,15,8,15,10,8,14,12,10,15,11,13,14,13,13,14,12,17,11,11,12,12,16,14,15,12,12,7,10,14,13,20,13,12,13,11,14,6,15,11,14,13,13,13,13,13,3,1,1,20,14,15,15,20,M RLC,406,1,1,1,14,10,10,1,1,1,10,20,15,15,1,1,4194880,0,0,0,0,0,0,1,0,0,1,0,0,0,0,0,0,0,0,0,0,0,0,1,0,0,0,0,0,0,0,0,0,0,0,0,0,0,0,0,0,0,0,0,0,0,0,0,0,Paulo Machado,£4.05m ,34,174,Midfielder - Central Midfield,right,Leixões SC,33,4,5,2453,25,3,0,1491,42,3,6,3075,25,3,0,1173,44,4,8,3202,44,2,10,3294,33,1,3,1835,27,5,4,1780,20,2,4,1754,Ligue 1,9,1,1,641,3,0,0,150
19/6/2011,Nildo,19135019,1651,5/1/1986,25,0,0,0,0,438,4814,3802,120,107,64052,175,62,AM RL,1,1,2,2,1,3,1,1,1,3,2,10,12,11,10,11,10,8,12,10,11,10,12,12,12,10,11,13,11,8,9,10,8,12,8,14,9,11,13,14,13,10,8,20,12,13,8,12,11,9,8,10,8,11,9,9,10,19,6,6,11,9,7,7,12,20,15,20,1,AM RL,505,1,1,1,1,20,15,1,7,1,1,1,12,1,7,1,1,1,0,0,0,0,0,0,0,0,0,0,0,0,0,0,0,0,0,0,0,0,0,0,0,0,0,0,0,0,0,0,0,0,0,0,0,0,0,0,0,0,0,0,0,0,0,0,0,Nivaldo,£450Th. ,32,179,Midfielder - Left Midfield,left,Without Club,nan,nan,nan,nan,14,0,0,1130,15,1,1,1190,29,5,7,2432,29,4,11,2292,10,0,0,494,10,1,1,564,15,1,4,757,22,2,1,1361,Liga NOS,3,0,0,270,nan,nan,nan,nan
19/6/2011,Nicolás Bertolo,963529,1649,1/2/1986,25,2,0,0,0,4000,6198,6500,144,137,926695,180,75,M/AM RL,1,3,1,3,2,2,3,6,2,1,1,12,12,16,13,15,11,9,10,8,6,14,12,8,15,10,13,12,13,8,13,13,12,17,10,16,6,9,10,13,14,10,10,14,11,16,20,10,10,9,8,14,7,14,14,12,11,12,11,11,14,13,1,1,18,20,19,20,14,M/AM RL,525,1,1,10,14,20,19,1,1,1,1,12,18,16,1,1,2.2518E+15,0,0,0,0,0,0,0,0,0,0,0,0,0,0,0,0,0,0,0,0,0,0,0,0,0,0,0,1,0,0,1,0,0,0,0,0,0,0,0,0,0,0,0,0,0,0,0,0,Nicolás Bertolo,£2.52m ,34,180,Forward - Left Winger,right,Club Atlético Banfield,37,5,2,2315,30,4,3,1615,28,2,2,1342,4,1,1,186,38,6,7,2859,11,0,2,529,25,7,4,2076,23,3,5,1888,14,2,1,829,Serie A,20,1,2,1345,nan,nan,nan,nan
19/6/2011,Miguel De las Cuevas,1507647,796,6/19/1986,25,0,0,0,0,4900,7150,7150,150,143,1862030,167,65,AM RLC,3,2,3,1,2,1,1,3,1,1,3,16,16,15,14,14,13,11,13,8,5,16,14,9,15,7,13,14,11,15,13,13,10,16,12,15,13,14,15,14,16,13,7,6,10,14,20,13,11,13,4,14,10,17,8,18,12,14,15,14,4,18,1,1,14,20,16,15,20,AM RLC,506,1,1,7,20,15,16,1,1,1,1,5,13,14,1,1,8.79953E+13,0,0,1,0,0,0,0,0,0,0,0,0,0,0,0,0,0,0,0,0,0,0,0,0,0,0,0,0,0,0,0,0,0,0,0,1,0,0,0,0,0,0,0,0,1,0,1,0,Miguel de las Cuevas,£4.50m ,34,175,Forward - Right Winger,right,Córdoba CF,38,6,3,2574,36,3,6,2924,30,2,2,1745,26,0,0,1761,34,5,1,2549,22,2,5,1287,30,0,2,1932,18,1,0,503,35,10,2,2483,LaLiga,26,7,0,2048,1,0,0,81
19/6/2011,Michael Kightly,5113816,765,1/24/1986,25,0,0,7,0,3850,6350,6350,145,130,891917,176,70,M/AM R,2,3,3,1,3,1,1,1,3,3,3,11,12,14,12,11,12,5,12,5,3,12,11,7,14,10,11,10,12,11,13,12,14,13,6,14,7,15,16,15,11,14,7,10,12,15,20,16,9,14,6,14,12,6,11,16,16,13,17,17,16,3,1,1,20,20,20,12,1,M/AM R,412,1,1,1,1,12,20,1,1,1,1,1,12,20,1,1,5.49756E+11,0,1,1,1,0,0,0,0,0,0,0,0,0,0,0,0,0,0,0,0,0,0,0,0,0,0,0,0,0,0,0,0,0,0,0,0,0,0,0,1,0,0,0,0,0,0,0,0,Michael Kightly,£1.80m ,34,173,Midfielder - Left Midfield,right,Rushall Olympic,8,1,0,436,35,6,3,2522,26,3,1,1489,38,5,6,2451,20,1,3,1212,21,0,2,1160,21,4,1,1083,30,6,2,2234,39,2,5,1941,Premier League,nan,nan,nan,nan,nan,nan,nan,nan
19/6/2011,Matt Jarvis,5113564,765,5/22/1986,25,1,0,0,0,4500,6800,6700,145,140,1007267,173,70,M/AM RL,3,2,1,3,3,1,3,8,3,3,2,12,13,14,11,11,7,3,6,1,4,11,4,7,12,4,11,8,9,7,11,10,16,13,5,13,7,12,14,17,13,11,4,12,13,15,20,14,7,12,2,12,7,6,4,15,14,10,16,16,18,2,1,1,18,20,17,20,1,M/AM RL,525,1,1,1,1,20,17,1,1,1,1,1,18,16,1,1,134217728,0,0,0,0,0,0,0,0,0,0,0,0,0,0,0,0,0,0,0,0,0,0,0,0,0,0,0,1,0,0,0,0,0,0,0,0,0,0,0,0,0,0,0,0,0,0,0,0,Matt Jarvis,£7.20m ,34,173,Forward - Left Winger,nan,Woking FC,41,5,9,3340,39,8,6,2839,36,2,2,2864,35,4,4,2219,14,0,1,630,29,2,3,1638,4,0,0,299,1,0,0,20,10,0,2,779,Premier League,2,1,0,65,3,0,0,56
19/6/2011,Mathieu Debuchy,915351,769,7/28/1985,25,0,0,3,0,5200,6534,6534,150,144,752207,177,74,D/WB/M R,1,3,1,3,3,1,3,2,3,2,2,10,12,11,7,12,13,13,14,10,11,13,13,15,12,12,13,18,13,15,12,14,18,11,14,11,14,16,17,14,13,14,9,10,12,12,20,18,13,16,14,15,12,18,6,12,17,13,16,13,13,6,20,16,18,12,20,10,14,D/WB/M R,122,5,1,1,8,10,12,1,4,20,14,14,10,18,1,16,34,0,1,0,0,0,1,0,0,0,0,0,0,0,0,0,0,0,0,0,0,0,0,0,0,0,0,0,0,0,0,0,0,0,0,0,0,0,0,0,0,0,0,0,0,0,0,0,0,Mathieu Debuchy,£9.90m ,35,177,Defender - Right-Back,right,AS Saint-Étienne,49,2,5,4349,43,5,1,3857,34,0,1,2965,32,1,4,2795,15,1,0,1260,16,0,0,1295,4,2,0,266,23,5,1,2012,24,4,3,1947,Ligue 1,32,2,3,2693,3,0,0,189
19/6/2011,Marco Motta,7990132,776,5/14/1986,25,1,0,38,1,4750,6250,6250,138,127,773240,183,76,D/WB/M R,1,1,1,1,1,1,1,1,1,1,1,8,12,13,8,12,5,11,11,16,11,13,5,12,14,17,14,15,8,8,11,8,16,11,13,15,10,15,16,15,12,13,11,16,13,15,20,15,13,13,8,15,7,16,13,15,17,14,18,19,13,12,19,20,16,1,20,13,5,D/WB/M R,232,1,1,1,1,1,1,5,13,19,1,1,12,16,13,20,32,0,0,0,0,0,1,0,0,0,0,0,0,0,0,0,0,0,0,0,0,0,0,0,0,0,0,0,0,0,0,0,0,0,0,0,0,0,0,0,0,0,0,0,0,0,0,0,0,Marco Motta,£1.98m ,34,186,Defender - Right-Back,right,Persija Jakarta,32,0,2,2114,13,0,1,1018,22,1,2,1726,16,0,1,1073,9,0,0,500,12,0,2,862,15,0,1,1199,31,3,1,2498,8,0,0,645,Serie A,2,0,1,180,nan,nan,nan,nan
19/6/2011,Luka Modric,653054,761,9/9/1985,25,44,7,11,1,7505,9006,8262,178,170,8403632,171,66,M/AM RLC,2,2,1,2,2,2,3,8,1,1,1,13,12,16,7,17,13,7,8,11,7,17,15,9,17,12,15,13,14,15,17,18,15,15,17,14,7,18,18,15,16,16,4,15,16,14,20,18,9,13,6,17,6,14,12,17,14,17,16,15,15,3,1,1,20,20,16,18,20,M/AM RLC,416,1,1,1,20,18,16,1,1,1,1,20,15,12,1,1,5.51903E+11,1,0,0,0,0,0,0,0,0,0,0,1,0,0,1,0,1,0,0,0,0,0,0,0,0,0,0,0,0,0,0,1,0,0,0,0,0,0,0,1,0,0,0,0,0,0,0,0,Luka Modric,£35.10m ,35,172,Midfielder - Central Midfield,both,Real Madrid,43,4,3,3540,41,5,7,3548,53,4,8,3284,51,2,9,4061,25,1,5,2007,44,3,4,3530,41,1,5,3304,43,2,8,3339,46,4,8,3571,Premier League,40,5,8,2631,7,2,0,430
19/6/2011,Laionel,2115585,1651,4/27/1986,25,0,0,0,0,1508,4769,5300,119,106,19517,173,65,AM R,2,3,2,1,3,3,1,1,2,3,2,11,11,15,10,14,9,5,11,9,5,10,10,4,14,7,11,10,12,9,9,10,13,16,9,14,8,8,11,13,12,11,7,5,14,13,20,10,10,10,7,12,7,11,11,11,11,12,14,15,15,6,1,1,5,20,20,14,5,AM R,502,1,1,10,5,14,20,1,1,1,1,1,5,5,1,1,0,0,0,0,0,0,0,0,0,0,0,0,0,0,0,0,0,0,0,0,0,0,0,0,0,0,0,0,0,0,0,0,0,0,0,0,0,0,0,0,0,0,0,0,0,0,0,0,0,Laionel,£585Th. ,34,177,Forward - Right Winger,right,Without Club,33,5,3,1274,27,3,0,1205,nan,nan,nan,nan,nan,nan,nan,nan,nan,nan,nan,nan,nan,nan,nan,nan,nan,nan,nan,nan,nan,nan,nan,nan,nan,nan,nan,nan,Liga NOS,nan,nan,nan,nan,nan,nan,nan,nan
19/6/2011,Jonathan Pitroipa,8718230,9,4/12/1986,25,29,2,0,0,2471,7205,6600,136,131,1091533,176,60,AM RL,3,3,2,3,3,1,1,5,3,1,2,7,8,16,6,16,5,11,6,6,6,8,7,7,13,10,7,5,6,8,7,7,8,18,5,12,5,9,14,19,18,5,10,15,10,18,20,13,4,13,3,12,9,12,10,14,4,8,7,10,15,14,1,1,14,20,18,20,14,AM RL,505,1,1,14,14,20,18,1,1,1,1,1,14,12,1,1,7.037E+13,1,1,0,0,0,0,0,0,0,0,0,0,0,0,0,0,0,0,0,0,0,0,0,0,0,0,0,1,0,0,1,0,0,0,0,0,0,0,0,0,0,0,0,0,0,0,1,0,Jonathan Pitroipa,£5.40m ,34,176,Forward - Right Winger,right,Paris FC,28,2,8,1966,50,11,13,3944,36,8,7,3177,26,0,4,1668,26,9,11,2182,36,8,14,3080,12,6,2,857,10,0,0,470,32,3,1,2527,Ligue 1,27,2,2,1776,8,0,0,556
19/6/2011,Jimmy Briand,3504311,769,8/2/1985,25,4,0,22,9,6500,6696,6688,160,148,2254900,181,84,AM/S R,3,2,2,1,1,2,2,4,2,1,2,7,12,14,11,13,8,12,11,5,6,12,13,4,14,9,14,13,9,13,13,12,17,14,7,16,9,14,16,17,14,15,11,8,14,16,20,15,15,14,9,13,7,8,15,16,13,14,13,15,15,10,1,1,12,20,20,1,1,AM/S R,512,1,1,18,1,1,20,1,1,1,1,1,1,12,1,1,18,0,1,0,0,1,0,0,0,0,0,0,0,0,0,0,0,0,0,0,0,0,0,0,0,0,0,0,0,0,0,0,0,0,0,0,0,0,0,0,0,0,0,0,0,0,0,0,0,Jimmy Briand,£6.30m ,35,183,Forward - Centre-Forward,right,FC Girondins Bordeaux,44,8,7,2874,56,14,8,3904,20,3,1,1057,40,9,7,2239,30,3,8,2155,39,8,7,3218,39,13,6,3232,40,11,2,3337,46,11,4,3258,Ligue 1,26,8,1,1774,8,1,2,206
19/6/2011,Jesús Navas,7456721,796,11/21/1985,25,9,1,5,3,6750,8000,8000,175,160,5533597,170,60,M/AM R,1,3,2,3,3,1,1,7,3,1,3,15,15,18,11,15,10,6,13,5,4,14,13,6,18,10,13,11,13,12,16,12,14,17,12,16,8,13,13,17,18,4,6,9,10,18,20,15,7,15,9,14,12,12,3,14,16,7,15,13,13,10,1,1,19,20,20,8,10,M/AM R,522,1,1,12,10,8,20,1,1,1,1,1,1,19,1,1,7.53509E+13,0,0,0,0,1,0,0,0,0,0,0,0,0,0,0,0,0,0,0,0,0,0,0,0,0,0,0,0,0,0,0,0,0,0,0,1,0,0,0,1,0,0,1,0,0,0,1,0,Jesús Navas,£18.00m ,34,172,Defender - Right-Back,right,Sevilla FC,28,2,7,2415,43,5,14,3870,44,1,10,3924,48,6,13,2852,47,1,11,3006,52,1,10,3510,36,0,5,1797,44,2,2,2845,44,2,8,3583,LaLiga,47,0,10,4149,7,0,2,660
19/6/2011,Jean Sony,55017618,375,1/23/1986,25,19,3,0,0,2007,5500,3115,125,100,3274,176,74,D/M R,3,1,3,3,1,3,1,4,1,1,1,9,9,10,8,9,8,9,9,11,9,8,9,11,10,13,10,12,10,10,8,8,13,11,8,14,8,9,13,16,13,8,9,10,14,16,20,8,8,10,8,11,10,12,13,11,11,12,14,14,13,5,20,14,20,12,20,9,1,D/M R,112,1,1,1,1,1,12,1,9,20,1,1,1,20,1,14,2.2518E+15,0,0,0,0,0,1,0,0,0,0,0,0,0,0,0,0,0,0,0,0,0,0,0,0,0,0,0,0,0,0,0,0,0,0,0,0,0,0,0,0,0,0,0,0,0,0,0,0,,,,,,,,,,,,,,,,,,,,,,,,,,,,,,,,,,,,,,,,,,,,,,,,,,,,
19/6/2011,Javi López,67006184,796,1/21/1986,25,0,0,0,0,2500,5750,5750,130,120,240418,179,74,D/WB/DM/M RC,1,2,3,3,1,1,3,1,1,3,3,9,12,12,11,10,9,7,11,9,12,13,5,11,12,13,12,11,12,10,11,11,10,7,8,13,12,12,14,14,13,8,8,12,14,12,20,12,10,14,8,10,7,17,8,7,12,14,8,18,10,6,18,20,19,14,20,10,15,D/WB/DM/M RC,243,1,1,1,1,8,14,1,5,18,16,15,10,19,8,20,0,0,0,0,0,0,0,0,0,0,0,0,0,0,0,0,0,0,0,0,0,0,0,0,0,0,0,0,0,0,0,0,0,0,0,0,0,0,0,0,0,0,0,0,0,0,0,0,0,Javi López,£2.25m ,34,180,Defender - Right-Back,right,Without Club,27,0,0,1752,32,1,2,2412,33,1,0,2577,35,0,1,3105,33,0,1,2621,33,0,1,2613,20,0,1,1614,15,0,0,1039,25,0,0,2159,LaLiga,28,1,1,2375,nan,nan,nan,nan
19/6/2011,Jan Rosenthal,8728478,771,4/7/1986,25,0,0,17,2,5000,6550,6550,143,132,765094,185,75,M/AM RLC,1,2,3,3,3,3,2,4,2,1,3,10,11,12,13,12,10,10,13,10,7,13,10,11,14,12,13,15,8,8,11,10,17,12,12,14,10,13,15,13,12,14,13,14,12,15,20,14,14,9,5,9,13,17,8,15,14,7,15,14,11,6,1,7,18,20,20,18,18,M/AM RLC,526,1,1,1,18,18,20,1,1,1,11,15,15,18,7,7,512,0,0,0,0,0,0,0,0,0,1,0,0,0,0,0,0,0,0,0,0,0,0,0,0,0,0,0,0,0,0,0,0,0,0,0,0,0,0,0,0,0,0,0,0,0,0,0,0,Jan Rosenthal,£2.70m ,34,186,Forward - Second Striker,right,Retired,23,5,0,1660,21,2,1,1349,24,5,5,1765,24,2,2,1119,9,1,1,315,25,0,5,1529,19,0,0,856,12,0,0,439,nan,nan,nan,nan,Bundesliga,2,0,0,118,nan,nan,nan,nan
19/6/2011,James Morrison,5113352,793,5/25/1986,25,13,1,0,0,4750,6750,6500,142,130,993822,178,77,M/AM RC,3,2,3,3,2,2,2,1,3,2,3,9,13,15,10,14,8,8,11,3,8,13,5,9,14,9,12,8,13,12,15,12,13,14,7,15,11,12,14,14,13,13,7,16,15,12,20,13,10,14,7,12,9,14,14,15,14,12,14,13,14,6,2,3,20,20,20,14,20,M/AM RC,413,1,1,1,20,14,20,1,1,2,4,16,14,20,1,3,42,0,1,0,1,0,1,0,0,0,0,0,0,0,0,0,0,0,0,0,0,0,0,0,0,0,0,0,0,0,0,0,0,0,0,0,0,0,0,0,0,0,0,0,0,0,0,0,0,James Morrison,£4.05m ,34,183,Midfielder - Central Midfield,right,Retired,32,4,3,2367,33,5,5,2357,37,5,7,3026,35,1,4,2351,37,4,1,2885,19,4,3,1432,35,5,3,2092,6,1,0,373,27,0,1,1396,Premier League,nan,nan,nan,nan,nan,nan,nan,nan
19/6/2011,James Milner,5106363,765,1/4/1986,25,19,0,46,9,6400,7500,7500,160,150,18181818,176,70,M/AM RLC,3,3,3,3,3,2,1,4,2,1,2,13,14,12,12,14,15,9,13,12,9,14,12,12,12,12,15,14,14,15,14,15,17,14,14,13,10,18,19,13,15,13,8,12,18,12,20,18,11,16,4,15,4,14,7,15,15,16,18,12,14,1,10,3,20,18,18,17,20,M/AM RLC,416,1,1,8,10,17,18,1,3,10,1,20,15,15,2,3,7.09185E+13,1,1,0,0,0,0,0,1,0,0,0,0,0,0,0,0,0,0,0,0,0,0,0,0,0,0,0,0,0,0,0,0,0,0,0,0,0,0,0,1,0,0,0,0,0,0,1,0,James Milner,£18.90m ,34,175,Midfielder - Central Midfield,right,Liverpool FC,42,3,8,2688,37,3,5,2198,36,4,8,2421,44,2,15,2323,45,8,9,2704,45,7,14,3862,40,7,4,3437,47,1,11,2787,45,7,7,2836,Premier League,37,4,4,1708,7,0,0,305
19/6/2011,Jakub Blaszczykowski,719793,787,12/14/1985,25,36,4,3,1,6409,7425,6760,140,135,2165023,175,71,M/AM R,1,2,1,1,3,1,3,3,1,2,3,9,10,12,7,11,10,8,7,7,5,9,6,8,12,13,10,13,9,11,11,7,13,15,12,15,7,12,14,18,18,15,6,7,10,16,20,9,9,8,10,12,15,10,8,15,11,10,12,7,10,11,8,14,19,20,20,1,1,M/AM R,522,1,1,14,1,1,20,1,1,8,1,1,1,19,1,14,7.03688E+13,0,1,0,0,0,0,0,0,0,0,0,0,0,0,1,0,0,0,0,0,0,0,0,0,1,0,0,0,0,0,0,0,0,0,0,0,0,0,0,0,0,0,0,0,0,0,1,0,Jakub Blaszczykowski,£9.00m ,34,176,Forward - Right Winger,right,Wisla Kraków,37,3,5,2004,40,7,12,2564,41,14,15,2917,25,3,2,1319,20,0,2,961,20,2,3,1007,30,0,3,1865,13,1,0,709,10,5,2,712,Bundesliga,22,7,5,1689,4,2,0,230
19/6/2011,Hugo Rodallega,8835582,1653,7/25/1985,25,40,8,22,18,5750,7700,7000,155,140,2447417,181,72,AM/S RL,2,1,1,2,1,1,2,7,2,1,3,14,7,13,13,11,12,14,11,6,4,12,15,6,13,12,13,12,13,13,15,11,12,12,13,14,6,11,14,14,13,13,12,12,14,14,20,14,13,11,7,13,10,12,12,18,10,13,14,16,13,12,1,1,1,17,17,17,2,AM/S RL,625,1,1,20,2,17,17,1,1,1,1,1,1,1,1,1,524864,0,0,0,0,0,0,1,0,0,1,0,0,0,0,0,0,0,0,0,1,0,0,0,0,0,0,0,0,0,0,0,0,0,0,0,0,0,0,0,0,0,0,0,0,0,0,0,0,Hugo Rodallega,£4.05m ,35,181,Forward - Centre-Forward,right,Denizlispor,37,9,2,3094,24,2,7,1337,33,3,3,1783,17,6,2,853,38,11,9,2834,37,21,1,3199,32,10,3,2443,28,13,1,936,37,16,3,2909,Premier League,32,6,1,2762,5,1,0,432
19/6/2011,Henry Giménez,78002298,1657,3/13/1986,25,2,0,0,0,2786,6022,6650,140,131,659947,176,69,AM/S RLC,3,3,2,2,3,2,3,2,1,2,1,13,13,14,11,12,11,11,11,11,8,12,14,8,16,12,11,9,11,8,12,13,14,15,12,14,8,10,12,15,15,8,8,20,15,13,12,14,10,12,13,11,8,12,12,8,10,12,15,14,13,6,1,1,1,18,15,15,18,AM/S RLC,626,1,1,20,18,15,15,1,1,1,1,1,1,1,1,1,5.49756E+11,0,0,0,0,0,0,0,0,0,0,0,0,0,0,0,0,0,0,0,0,0,0,0,0,0,0,0,0,0,0,0,0,0,0,0,0,0,0,0,1,0,0,0,0,0,0,0,0,Henry Giménez,£720Th. ,34,176,Forward - Centre-Forward,left,Rivera Hinterland,29,4,1,1104,18,1,3,600,17,1,2,1221,7,1,0,337,21,2,2,1346,5,0,0,186,24,2,2,1588,20,3,1,1447,14,0,0,893,Serie A,nan,nan,nan,nan,nan,nan,nan,nan
19/6/2011,Gili Vermut,7861328,775,8/5/1985,25,14,0,12,1,4500,7150,7150,142,133,304178,175,68,AM/S RLC,1,2,3,1,3,1,2,5,1,3,3,12,14,16,12,12,6,4,6,1,8,16,10,5,17,7,15,7,12,12,18,14,14,13,11,14,8,12,13,12,14,10,8,12,10,13,20,12,8,12,3,13,3,14,8,14,14,14,17,19,13,4,1,1,13,20,20,15,15,AM/S RLC,516,1,1,16,15,15,20,1,1,1,1,8,13,13,1,1,7.09529E+13,0,0,0,0,0,0,0,0,0,0,0,0,0,0,0,0,0,0,0,1,0,0,0,0,1,0,0,0,0,0,0,0,0,0,0,1,0,0,0,1,0,0,0,0,0,0,1,0,Gil Vermouth,£1.35m ,35,173,Midfielder - Right Midfield,right,Without Club,46,5,0,3860,20,2,4,1456,14,1,5,1060,38,8,0,2974,24,3,1,2002,39,2,3,2211,36,7,3,2783,31,1,4,1911,32,2,7,2011,Bundesliga,23,0,2,792,nan,nan,nan,nan
19/6/2011,Franck Dja Djédjé,8430845,24,6/2/1986,25,0,0,2,0,4250,5309,5300,130,118,357257,176,70,AM/S R,1,1,3,1,1,1,2,3,1,3,2,7,10,12,10,12,7,13,14,6,5,10,11,3,14,9,12,8,11,12,10,8,8,12,5,14,6,7,10,13,13,13,9,8,11,17,20,13,11,11,9,13,7,10,12,14,12,9,14,12,12,7,5,5,10,16,16,10,13,AM/S R,622,1,1,20,13,10,16,1,1,5,1,1,10,10,1,5,16,0,0,0,0,1,0,0,0,0,0,0,0,0,0,0,0,0,0,0,0,0,0,0,0,0,0,0,0,0,0,0,0,0,0,0,0,0,0,0,0,0,0,0,0,0,0,0,0,Franck Dja Djédjé,£1.35m ,34,175,Forward - Right Winger,both,AS Cannes,34,4,1,2478,37,5,4,2231,30,4,4,2028,57,15,3,4272,21,3,2,936,nan,nan,nan,nan,26,3,4,1347,19,2,0,711,nan,nan,nan,nan,Ligue 1,nan,nan,nan,nan,nan,nan,nan,nan
19/6/2011,Enzo Pérez,958414,1649,2/22/1986,25,3,0,0,0,4500,7050,6700,143,134,1091533,177,73,AM RLC,2,1,1,3,2,3,2,4,1,1,3,14,15,16,13,14,11,9,11,10,10,15,11,10,17,9,14,12,14,14,14,15,14,14,8,14,10,14,14,13,13,11,10,6,13,14,20,14,11,14,7,13,5,14,9,12,13,12,11,13,16,7,1,1,10,20,20,16,15,AM RLC,506,1,1,1,15,16,20,1,1,1,1,10,7,10,1,1,1.37439E+11,0,1,0,0,0,0,0,0,0,0,0,0,1,0,0,0,0,0,0,0,0,0,0,0,0,0,0,0,0,0,0,0,0,0,0,0,0,1,0,0,0,0,0,0,0,0,0,0,Enzo Pérez,£2.70m ,34,179,Midfielder - Defensive Midfield,right,Club Atlético River Plate,40,5,10,3244,18,0,0,1069,47,4,7,3477,47,5,8,3726,34,1,4,2703,30,0,1,1925,34,2,1,2679,31,0,0,2199,41,1,2,3158,Liga NOS,23,0,1,1958,nan,nan,nan,nan
19/6/2011,Emanuele Giaccherini,7990445,776,8/5/1985,25,0,0,0,0,4600,7100,7100,149,138,592095,160,67,M/AM RLC,1,1,1,1,1,1,1,1,1,1,1,12,13,15,14,8,8,10,12,5,5,13,12,9,14,16,12,15,14,10,12,11,16,17,9,14,9,14,13,16,16,15,3,15,18,14,20,16,6,16,12,13,3,18,8,18,16,10,14,11,5,11,1,1,17,20,20,19,16,M/AM RLC,526,1,1,14,16,19,20,1,1,1,1,1,17,17,1,1,4.43241E+12,0,0,0,0,1,0,0,0,0,0,0,0,0,0,0,0,0,0,0,0,0,0,0,0,0,0,0,0,0,0,0,0,0,0,0,1,0,0,0,0,0,0,1,0,0,0,0,0,Emanuele Giaccherini,£4.23m ,35,167,Midfielder - Left Midfield,right,Chievo Verona,36,7,4,2908,27,3,3,1616,25,3,4,1273,32,5,4,1967,11,0,1,477,28,7,0,2185,19,2,0,386,18,3,1,1027,28,3,2,2186,Serie A,24,5,4,1541,nan,nan,nan,nan
19/6/2011,Edson Ramos,19008137,1651,5/31/1986,25,0,0,0,0,3250,6000,5750,135,125,119142,170,64,D/WB/M R,2,1,3,2,1,2,1,4,2,1,1,6,12,14,6,13,6,7,6,10,11,10,6,11,14,12,11,12,10,10,12,10,10,13,5,15,10,13,15,17,17,10,6,10,12,17,20,15,8,14,10,13,5,10,8,10,9,12,7,12,12,12,20,18,17,10,20,9,1,D/WB/M R,122,1,1,1,1,1,10,1,9,20,1,1,1,17,1,18,34,0,1,0,0,0,1,0,0,0,0,0,0,0,0,0,0,0,0,0,0,0,0,0,0,0,0,0,0,0,0,0,0,0,0,0,0,0,0,0,0,0,0,0,0,0,0,0,0,,,,,,,,,,,,,,,,,,,,,,,,,,,,,,,,,,,,,,,,,,,,,,,,,,,,
19/6/2011,Éder Sciola,19008536,1651,9/25/1985,25,0,0,0,0,3250,5500,5500,125,110,532522,181,80,D/WB/DM R,3,2,3,1,1,1,3,1,3,1,2,10,11,11,9,10,9,9,9,15,12,10,10,12,11,15,11,14,13,13,12,12,13,10,11,13,11,12,10,14,12,13,9,9,11,14,20,13,13,11,11,12,6,12,12,11,12,11,3,8,12,12,18,20,15,1,20,1,13,D/WB/DM R,232,1,1,1,1,1,1,1,1,18,16,13,1,15,1,20,0,0,0,0,0,0,0,0,0,0,0,0,0,0,0,0,0,0,0,0,0,0,0,0,0,0,0,0,0,0,0,0,0,0,0,0,0,0,0,0,0,0,0,0,0,0,0,0,0,Éder Sciola,£450Th. ,35,183,Defender - Right-Back,right,Oeste Futebol Clube (SP),nan,nan,nan,nan,15,0,0,1009,19,0,0,1179,2,0,0,210,32,0,7,2630,31,0,1,2679,25,2,1,2204,34,6,2,2941,34,1,5,2925,Liga NOS,19,1,0,1538,nan,nan,nan,nan
19/6/2011,Diogo Cunha,726052,788,2/10/1986,25,0,0,0,0,776,4049,2003,105,90,6339,172,62,M/AM RL,1,1,1,1,1,2,2,1,2,3,2,9,13,13,7,10,9,8,8,8,9,10,9,9,13,12,11,6,9,4,8,11,9,16,1,12,8,9,12,13,13,13,5,8,17,13,20,11,3,10,10,10,4,10,10,13,14,6,16,16,7,20,1,1,17,20,20,15,12,M/AM RL,525,1,1,7,12,15,20,1,1,1,1,6,10,17,1,1,0,0,0,0,0,0,0,0,0,0,0,0,0,0,0,0,0,0,0,0,0,0,0,0,0,0,0,0,0,0,0,0,0,0,0,0,0,0,0,0,0,0,0,0,0,0,0,0,0,Diogo Cunha,£900Th. ,34,170,Midfielder - Attacking Midfield,right,LusitÃ¢nia FC Lourosa,30,3,0,1992,29,1,1,2179,45,9,1,3446,40,6,2,2442,18,1,2,1216,38,2,8,2573,40,3,5,2280,26,0,3,1368,3,0,2,300,Liga NOS,3,0,0,211,nan,nan,nan,nan
19/6/2011,David Silva,7458280,796,1/8/1986,25,48,11,9,7,7750,8250,8400,175,168,18181818,170,67,AM RLC,2,1,2,1,2,1,1,1,3,2,2,15,16,18,13,19,12,8,12,7,5,18,13,8,19,10,13,11,17,15,19,17,15,19,10,18,8,14,11,16,18,10,5,20,11,13,11,14,7,15,9,13,13,13,13,16,13,15,11,12,13,7,1,1,15,20,15,19,20,AM RLC,506,1,1,9,20,19,15,1,1,1,4,15,13,10,1,1,2.25182E+15,0,0,0,0,1,0,0,1,0,0,0,0,0,0,0,0,0,0,0,0,0,0,0,0,0,0,0,0,0,0,0,0,0,0,1,0,0,0,0,0,0,0,0,0,0,0,0,0,David Silva,£45.00m ,34,170,Midfielder - Attacking Midfield,left,Real Sociedad,53,6,14,3817,49,8,21,3876,41,5,13,3203,40,8,16,3043,42,12,14,3282,36,4,12,2793,45,8,11,3646,40,10,14,3198,50,10,14,3727,Premier League,40,6,11,2602,6,0,0,429
19/6/2011,David Edwards,5111978,801,2/3/1986,25,22,3,9,1,4400,6150,5750,130,122,637573,186,71,M/AM RC,1,1,2,1,3,2,3,5,2,2,1,8,10,13,10,13,8,11,8,2,8,14,10,12,13,10,11,10,12,12,10,14,13,13,10,15,10,14,19,12,10,14,14,10,17,13,20,16,11,13,3,12,6,9,10,15,13,10,15,15,13,1,1,1,20,18,15,1,20,M/AM RC,413,1,1,4,18,1,15,1,1,1,1,20,1,15,1,1,36,0,0,1,0,0,1,0,0,0,0,0,0,0,0,0,0,0,0,0,0,0,0,0,0,0,0,0,0,0,0,0,0,0,0,0,0,0,0,0,0,0,0,0,0,0,0,0,0,David Edwards,£1.80m ,34,180,Midfielder - Central Midfield,right,Shrewsbury Town,19,1,0,1203,30,4,2,2192,27,2,1,1568,32,9,3,2129,44,8,2,2992,30,5,2,2360,49,10,4,4054,38,3,4,2846,6,0,0,247,Premier League,37,4,0,2612,1,0,0,74
19/6/2011,Daniel Osvaldo,962383,776,1/12/1986,25,0,0,12,2,5500,6900,7500,160,152,4989864,185,78,AM/S RL,1,3,3,2,1,1,1,2,1,3,2,9,13,14,15,12,11,14,13,7,9,13,13,9,15,14,14,18,14,14,12,13,12,13,16,14,8,14,16,13,12,15,13,12,13,14,20,15,15,12,12,13,9,13,12,16,8,11,10,9,11,10,1,1,5,16,15,16,10,AM/S RL,625,1,1,20,10,16,15,1,1,1,1,1,5,1,1,1,4.43241E+12,0,0,0,0,0,0,0,0,0,0,0,0,0,0,0,0,0,0,0,0,0,0,0,1,0,0,0,0,0,0,0,0,0,0,0,1,0,0,0,0,0,0,1,0,0,0,0,0,Daniel Osvaldo,£13.50m ,34,182,Forward - Centre-Forward,right,Without Club,25,13,3,1775,26,11,5,2092,31,17,2,2385,31,6,1,1542,34,13,7,1983,17,1,2,788,nan,nan,nan,nan,nan,nan,nan,nan,nan,nan,nan,nan,Serie A,2,0,0,60,nan,nan,nan,nan
19/6/2011,Daniel Brinkmann,8719018,771,1/29/1986,25,0,0,1,0,4000,5750,5750,122,115,420854,193,89,DM/M RC,3,3,1,3,1,2,1,2,2,2,3,14,12,13,9,14,10,9,11,10,9,12,10,13,14,13,13,12,12,9,12,13,10,13,12,13,14,13,13,11,10,15,16,7,12,12,20,12,13,12,7,12,11,9,6,11,12,11,7,10,8,7,10,12,20,13,15,1,20,DM/M RC,313,1,1,1,1,1,13,1,1,10,20,20,1,15,1,12,0,0,0,0,0,0,0,0,0,0,0,0,0,0,0,0,0,0,0,0,0,0,0,0,0,0,0,0,0,0,0,0,0,0,0,0,0,0,0,0,0,0,0,0,0,0,0,0,0,Daniel Brinkmann,£450Th. ,34,193,Midfielder - Central Midfield,right,Retired,25,0,4,1524,17,2,2,977,4,1,0,95,5,2,0,307,35,0,1,1821,7,0,0,630,15,0,0,800,26,3,5,1648,32,7,4,2264,Bundesliga,16,1,1,937,nan,nan,nan,nan
19/6/2011,Christian Gentner,8707887,771,8/14/1985,25,5,0,11,1,5400,6850,6850,153,142,3566570,189,81,M/AM RLC,3,1,3,1,1,1,1,4,3,1,1,10,16,13,7,14,9,12,7,10,11,13,8,9,14,14,9,12,7,10,15,15,9,9,11,13,10,16,17,15,10,12,14,20,17,15,17,17,11,11,8,12,4,17,13,17,11,15,14,16,19,12,1,1,20,16,16,19,20,M/AM RLC,416,1,1,1,16,16,15,1,1,1,14,20,19,16,1,1,0,0,0,0,0,0,0,0,0,0,0,0,0,0,0,0,0,0,0,0,0,0,0,0,0,0,0,0,0,0,0,0,0,0,0,0,0,0,0,0,0,0,0,0,0,0,0,0,0,Christian Gentner,£4.50m ,35,189,Midfielder - Central Midfield,right,1.FC Union Berlin,42,8,3,2906,32,5,3,1735,52,9,8,4563,33,5,5,2970,34,5,4,3031,32,5,5,2816,36,7,4,3112,29,3,2,2595,32,1,5,2231,Bundesliga,34,4,3,2628,4,0,0,198
19/6/2011,Chris Eagles,5112070,765,11/19/1985,25,0,0,0,0,4100,6050,6050,145,124,827273,183,67,M/AM RLC,1,3,1,3,1,2,3,1,2,3,1,13,13,15,13,14,13,7,11,2,7,13,9,5,14,8,10,10,11,11,13,8,13,14,4,14,5,9,11,15,14,14,7,11,12,14,20,12,6,9,14,6,4,12,9,14,14,11,15,14,15,4,1,1,17,20,20,19,17,M/AM RLC,526,1,1,1,17,19,20,1,1,1,1,10,15,17,1,1,1.0308E+11,0,1,0,0,0,0,0,0,1,0,0,0,0,0,0,0,0,0,0,0,1,0,0,0,0,0,0,0,0,0,0,0,0,0,0,1,1,0,0,0,0,0,0,0,0,0,0,0,Chris Eagles,£4.95m ,34,183,Forward - Right Winger,right,Without Club,48,15,12,3699,41,6,8,2732,47,12,13,3769,18,1,4,1288,22,3,0,990,5,0,0,129,30,4,2,1775,9,0,4,498,nan,nan,nan,nan,Premier League,18,0,3,674,nan,nan,nan,nan
19/6/2011,Chinedu Obasi,766769,38,6/1/1986,25,16,4,8,3,6850,6794,7600,165,151,5021673,188,78,AM/S R,1,3,2,3,3,1,2,1,2,2,1,8,15,17,8,17,7,9,11,6,5,14,12,13,18,9,14,6,12,10,15,14,7,18,5,13,6,12,17,17,17,7,12,8,3,16,20,10,11,8,6,9,18,10,10,15,10,11,14,12,5,13,1,1,1,18,18,1,1,AM/S R,622,1,1,20,1,1,18,1,1,1,1,1,1,1,1,1,34359750672,0,0,0,0,1,0,0,0,0,0,0,0,1,1,0,0,0,0,0,0,0,0,0,0,0,0,0,0,0,0,0,0,0,0,0,1,0,0,0,0,0,0,0,0,0,0,0,0,Chinedu Obasi,£4.05m ,34,188,Forward - Centre-Forward,right,SCR Altach,6,0,1,175,30,2,4,1863,7,0,0,197,19,3,1,701,10,1,1,367,11,8,4,817,26,10,8,2112,11,5,2,950,18,5,2,1252,Bundesliga,6,1,0,305,6,3,1,359
19/6/2011,Charles N'Zogbia,8430843,769,5/28/1986,25,2,1,16,0,6000,6400,7000,162,142,3688182,171,70,AM RLC,1,1,2,3,2,3,3,1,3,1,1,12,13,15,12,12,13,6,13,1,9,12,8,11,12,10,11,11,13,9,11,11,14,14,5,11,8,10,12,16,12,12,6,20,12,16,10,11,11,11,5,11,3,12,15,14,7,14,5,15,13,11,15,1,9,20,20,20,17,AM RLC,506,1,1,1,17,20,20,1,15,1,1,1,9,1,1,1,5.84116E+11,0,0,1,0,0,0,0,0,0,0,0,0,0,0,0,0,0,0,0,0,0,0,0,0,0,0,0,0,0,0,0,0,0,0,0,1,0,0,0,1,0,0,0,0,0,0,0,0,Charles N'Zogbia,£8.10m ,34,171,Forward - Right Winger,left,Retired,38,10,11,2927,32,2,6,2154,28,3,8,1490,nan,nan,nan,nan,32,0,3,1702,2,0,0,41,nan,nan,nan,nan,nan,nan,nan,nan,nan,nan,nan,nan,Premier League,nan,nan,nan,nan,nan,nan,nan,nan
19/6/2011,Bryan Ruíz,18003360,366,8/21/1985,25,35,9,0,0,6500,7500,8000,163,158,3737318,185,78,AM RL,3,2,1,2,3,3,3,6,1,3,2,12,14,16,14,16,12,13,12,7,6,15,15,5,18,6,13,15,14,11,15,12,14,19,11,15,7,10,12,15,15,10,13,20,14,15,10,12,12,16,8,10,14,10,8,13,14,14,14,17,15,1,1,1,14,20,20,17,12,AM RL,505,1,1,15,12,17,20,1,1,1,1,1,14,14,1,1,0,0,0,0,0,0,0,0,0,0,0,0,0,0,0,0,0,0,0,0,0,0,0,0,0,0,0,0,0,0,0,0,0,0,0,0,0,0,0,0,0,0,0,0,0,0,0,0,0,Bryan Ruíz,£9.00m ,35,188,Midfielder - Attacking Midfield,left,LD Alajuelense,40,10,11,3268,38,7,9,2409,31,5,9,2544,28,6,7,2055,32,5,4,2189,46,13,15,3611,42,3,8,2707,47,2,5,2241,nan,nan,nan,nan,Premier League,nan,nan,nan,nan,8,2,1,562
19/6/2011,Barreto,7987008,1651,7/12/1985,25,0,0,0,0,4000,7040,6400,135,128,623293,171,72,S RL,1,3,2,3,1,2,3,5,3,1,3,5,9,15,14,14,14,4,12,9,7,13,12,5,15,12,9,8,13,7,12,10,18,17,6,14,8,12,13,16,17,9,8,8,10,15,20,14,6,12,4,15,14,11,16,18,13,17,12,14,10,6,1,1,1,15,15,15,1,S RL,605,1,1,20,1,15,15,1,1,1,1,1,1,1,1,1,16,0,0,0,0,1,0,0,0,0,0,0,0,0,0,0,0,0,0,0,0,0,0,0,0,0,0,0,0,0,0,0,0,0,0,0,0,0,0,0,0,0,0,0,0,0,0,0,0,Barreto,£2.25m ,35,171,Forward - Second Striker,right,Without Club,13,4,1,988,9,1,0,346,20,3,2,1214,11,0,1,508,6,1,0,280,5,0,0,217,nan,nan,nan,nan,nan,nan,nan,nan,nan,nan,nan,nan,Serie A,5,0,0,72,nan,nan,nan,nan
19/6/2011,Ayoze,1501582,796,11/22/1985,25,0,0,0,0,3900,6050,6050,129,121,684817,172,65,M/AM RL,3,3,2,2,3,2,1,1,1,1,3,12,12,12,12,11,13,9,14,5,7,12,14,7,12,14,13,15,11,13,10,11,16,11,14,14,10,12,14,14,14,6,7,20,10,15,5,14,10,14,13,14,15,13,10,13,17,10,12,11,8,13,1,5,19,20,15,20,1,M/AM RL,525,1,1,5,1,20,15,1,1,1,1,1,19,5,5,1,1.11683E+12,0,0,0,0,0,0,0,0,1,0,0,0,0,0,0,0,0,0,0,0,0,0,0,0,0,0,0,1,0,0,0,0,0,0,1,0,0,0,0,0,1,0,0,0,0,0,0,0,Ayoze,£810Th. ,34,172,Defender - Left-Back,left,Indy Eleven,14,1,0,609,17,0,0,827,14,0,1,1147,17,1,2,1523,31,1,4,2773,35,1,3,3033,30,5,5,2583,30,4,8,2676,33,3,5,2843,LaLiga,10,1,3,694,nan,nan,nan,nan
19/6/2011,Ashley Young,5113149,765,7/9/1985,25,15,2,10,0,6400,7700,7750,165,152,12375207,175,65,AM RLC,2,3,2,2,1,1,2,3,2,1,1,16,15,14,14,16,12,6,11,3,3,13,12,4,14,7,14,8,13,12,12,10,13,14,5,15,7,11,13,18,15,12,7,10,15,16,20,14,6,14,5,15,5,13,4,12,8,12,13,7,14,4,1,1,14,20,18,20,19,AM RLC,506,1,1,15,19,20,18,1,1,1,1,1,14,14,1,1,7.09185E+13,1,0,0,0,0,0,0,0,0,0,1,1,0,0,0,0,0,0,0,0,0,0,0,0,0,0,0,0,0,0,0,0,0,0,0,0,0,0,0,1,0,0,0,0,0,0,1,0,Ashley Young,£24.30m ,35,175,Midfielder - Left Midfield,both,Inter Milan,40,9,13,3538,33,8,12,2222,23,0,5,1471,30,3,5,1489,30,2,6,2256,27,1,3,1627,23,0,1,1469,39,2,7,3156,41,2,3,3509,Premier League,43,5,6,3005,3,0,1,152
19/6/2011,Antonio Valencia,8830032,1654,8/5/1985,25,44,6,0,0,6500,7750,7650,165,158,3010641,181,78,M/AM R,3,3,1,2,2,1,2,7,2,3,2,14,16,14,10,14,10,7,11,7,9,13,10,8,13,12,13,15,10,14,11,12,17,15,3,15,14,16,17,18,15,16,9,7,14,18,20,17,14,15,6,14,6,8,16,15,12,12,16,16,17,4,1,5,18,20,20,11,13,M/AM R,522,1,1,1,12,11,20,1,1,1,1,13,8,18,1,5,17314103298,0,1,0,0,0,0,0,0,0,0,0,0,0,0,1,0,0,0,0,0,0,0,0,0,0,0,0,1,0,0,0,0,0,0,1,0,0,0,0,0,0,0,0,0,0,0,0,0,Antonio Valencia,£24.75m ,35,180,Defender - Right-Back,right,Without Club,20,3,5,1408,38,6,16,3010,40,1,8,2763,44,4,6,3029,35,0,3,2852,23,0,4,1342,43,1,6,3773,39,3,1,3422,34,1,3,2929,Premier League,7,0,0,630,nan,nan,nan,nan
