GameDate_2012,Name_2012,UID_2012,NationID_2012,Born_2012,Age_2012,IntCaps_2012,IntGoals_2012,U21Caps_2012,U21Goals_2012,WorldReputation_2012,HomeReputation_2012,CurrentReputation_2012,PA_2012,CA_2012,Price_2012,Height_2012,Weight_2012,PositionsString_2012,GK.AerialAbility_2012,GK.CommandOfArea_2012,GK.Communication_2012,GK.Eccentricity_2012,GK.Handling_2012,GK.Kicking_2012,GK.OneOnOnes_2012,GK.Reflexes_2012,GK.RushingOut_2012,GK.TendencyToPunch_2012,GK.Throwing_2012,Tech.Corners_2012,Tech.Crossing_2012,Tech.Dribbling_2012,Tech.Finishing_2012,Tech.FirstTouch_2012, Tech.Freekicks_2012,Tech.Heading_2012,Tech.LongShots_2012,Tech.Longthrows_2012,Tech.Marking_2012,Tech.Passing_2012,Tech.PenaltyTaking_2012, Tech.Tackling_2012,Tech.Technique_2012,Mental.Aggression_2012,Mental.Anticipation_2012,Mental.Bravery_2012,Mental.Composure_2012,Mental.Concentration_2012,Mental.Vision_2012,Mental.Decisions_2012,Mental.Determination_2012,Mental.Flair_2012,Mental.Leadership_2012, Mental.OffTheBall_2012,Mental.Positioning_2012,Mental.Teamwork_2012,Mental.Workrate_2012,Phy.Acceleration_2012,Phy.Agility_2012,Phy.Balance_2012,Phy.Jumping_2012,Phy.LeftFoot_2012,Phy.NaturalFitness_2012,Phy.Pace_2012,Phy.RightFoot_2012,Phy.Stamina_2012,Phy.Strength_2012, Hidden.Consistency_2012,Hidden.Dirtiness_2012,Hidden.ImportantMatches_2012,Hidden.InjuryProness_2012,Hidden.Versatility_2012,Personality.Adaptability_2012,Personality.Ambition_2012,Personality.Loyalty_2012,Personality.Pressure_2012,Personality.Professional_2012,Personality.Sportsmanship_2012,Personality.Temperament_2012,Personality.Controversy_2012,Positions.Defender_2012,Positions.WingBack_2012,Positions.Midfielder_2012,Positions.AttackingMidfielder_2012,Positions.Right_2012,Positions.Left_2012,Positions.Centre_2012,Positions.PositionsDesc_2012,Positions.PositionsDescVal_2012,Positions.Goalkeeper_2012,Positions.Sweeper_2012,Positions.Striker_2012,Positions.AttackingMidCentral_2012,Positions.AttackingMidLeft_2012,Positions.AttackingMidRight_2012,Positions.DefenderCentral_2012,Positions.DefenderLeft_2012, Positions.DefenderRight_2012,Positions.DefensiveMidfielder_2012,Positions.MidfielderCentral_2012,Positions.MidfielderLeft_2012,Positions.MidfielderRight_2012,Positions.WingBackLeft_2012,Positions.WingBackRight_2012,PPMVal_2012,PPM0_2012,PPM1_2012,PPM2_2012,PPM3_2012,PPM4_2012,PPM5_2012,PPM6_2012,PPM7_2012,PPM8_2012,PPM9_2012,PPM10_2012,PPM11_2012,PPM12_2012,PPM13_2012,PPM14_2012,PPM15_2012,PPM16_2012,PPM17_2012,PPM18_2012,PPM19_2012,PPM20_2012,PPM21_2012,PPM22_2012,PPM23_2012,PPM24_2012,PPM25_2012,PPM26_2012,PPM27_2012,PPM28_2012,PPM29_2012,PPM30_2012,PPM31_2012,PPM32_2012,PPM33_2012,PPM34_2012,PPM35_2012,PPM36_2012,PPM37_2012,PPM38_2012,PPM39_2012,PPM40_2012,PPM41_2012,PPM42_2012,PPM43_2012,PPM44_2012,PPM45_2012,PPM46_2012,PPM47_2012,name_2012,Market Value_2012,age_2012,height_2012,position_2012,foot_2012,current club_2012,10/11 games_2012,10/11 goals/conceded_2012,10/11 assists/clean_2012,10/11 minutes_2012,11/12 games_2012,11/12 goals/conceded_2012,11/12 assists/clean_2012,11/12 minutes_2012,12/13 games_2012,12/13 goals/conceded_2012,12/13 assists/clean_2012,12/13 minutes_2012,13/14 games_2012,13/14 goals/conceded_2012,13/14 assists/clean_2012,13/14 minutes_2012,14/15 games_2012,14/15 goals/conceded_2012,14/15 assists/clean_2012,14/15 minutes_2012,15/16 games_2012,15/16 goals/conceded_2012,15/16 assists/clean_2012,15/16 minutes_2012,16/17 games_2012,16/17 goals/conceded_2012,16/17 assists/clean_2012,16/17 minutes_2012,17/18 games_2012,17/18 goals/conceded_2012,17/18 assists/clean_2012,17/18 minutes_2012,18/19 games_2012,18/19 goals/conceded_2012,18/19 assists/clean_2012,18/19 minutes_2012,current league_2012,19/20 games_2012,19/20 goals/conceded_2012,19/20 assists/clean_2012,19/20 minutes_2012,20/21 games_2012,20/21 goals/conceded_2012,20/21 assists/clean_2012,20/21 minutes_2012,GameDate_2011,Name_2011,UID_2011,NationID_2011,Born_2011,Age_2011,IntCaps_2011,IntGoals_2011,U21Caps_2011,U21Goals_2011,WorldReputation_2011,HomeReputation_2011,CurrentReputation_2011,PA_2011,CA_2011,Price_2011,Height_2011,Weight_2011,PositionsString_2011,GK.AerialAbility_2011,GK.CommandOfArea_2011,GK.Communication_2011,GK.Eccentricity_2011,GK.Handling_2011,GK.Kicking_2011,GK.OneOnOnes_2011,GK.Reflexes_2011,GK.RushingOut_2011,GK.TendencyToPunch_2011,GK.Throwing_2011,Tech.Corners_2011,Tech.Crossing_2011,Tech.Dribbling_2011,Tech.Finishing_2011,Tech.FirstTouch_2011,Tech.Freekicks_2011,Tech.Heading_2011,Tech.LongShots_2011,Tech.Longthrows_2011,Tech.Marking_2011,Tech.Passing_2011,Tech.PenaltyTaking_2011,Tech.Tackling_2011,Tech.Technique_2011,Mental.Aggression_2011,Mental.Anticipation_2011,Mental.Bravery_2011,Mental.Composure_2011,Mental.Concentration_2011,Mental.Vision_2011,Mental.Decisions_2011,Mental.Determination_2011,Mental.Flair_2011,Mental.Leadership_2011,Mental.OffTheBall_2011,Mental.Positioning_2011,Mental.Teamwork_2011,Mental.Workrate_2011,Phy.Acceleration_2011,Phy.Agility_2011,Phy.Balance_2011,Phy.Jumping_2011,Phy.LeftFoot_2011,Phy.NaturalFitness_2011,Phy.Pace_2011,Phy.RightFoot_2011,Phy.Stamina_2011,Phy.Strength_2011,Hidden.Consistency_2011,Hidden.Dirtiness_2011,Hidden.ImportantMatches_2011,Hidden.InjuryProness_2011,Hidden.Versatility_2011,Personality.Adaptability_2011,Personality.Ambition_2011,Personality.Loyalty_2011,Personality.Pressure_2011,Personality.Professional_2011,Personality.Sportsmanship_2011,Personality.Temperament_2011,Personality.Controversy_2011,name_2011,Market Value_2011,current league_2011
19/6/2011,Pasquale De Vita,43081378,776,3/3/1994,17,0,0,0,0,219,3259,3259,130,69,38313,182,78,DM/M C,2,1,1,1,1,1,3,1,2,1,2,6,8,4,9,13,9,6,9,5,5,13,9,13,13,12,7,2,7,11,10,7,8,4,7,7,10,8,12,13,12,11,7,8,11,12,20,8,4,10,10,10,5,10,7,13,5,13,6,19,6,19,1,1,20,1,1,1,20,DM/M C,311,1,1,1,1,1,1,1,1,1,20,20,1,1,1,1,0.0,0,0,0,0,0,0,0,0,0,0,0,0,0,0,0,0,0,0,0,0,0,0,0,0,0,0,0,0,0,0,0,0,0,0,0,0,0,0,0,0,0,0,0,0,0,0,0,0,nan,nan,nan,nan,nan,nan,nan,nan,nan,nan,nan,nan,nan,nan,nan,nan,nan,nan,nan,nan,nan,nan,nan,nan,nan,nan,nan,nan,nan,nan,nan,nan,nan,nan,nan,nan,nan,nan,nan,nan,nan,nan,nan,nan,nan,nan,nan,nan,nan,nan,nan,nan
19/6/2011,Andrea Barberis,43078258,776,12/11/1993,17,0,0,0,0,50,2600,2600,113,60,22529,184,81,M C,1,1,3,2,2,1,2,1,1,2,3,8,7,2,7,10,8,7,11,1,8,8,3,11,12,14,11,2,9,4,8,11,7,4,1,5,7,10,11,9,12,10,8,8,8,12,20,8,5,10,12,10,5,9,8,10,8,9,7,12,6,10,1,1,20,1,1,1,20,M C,401,1,1,1,1,1,1,1,1,1,15,20,1,1,1,1,0.0,0,0,0,0,0,0,0,0,0,0,0,0,0,0,0,0,0,0,0,0,0,0,0,0,0,0,0,0,0,0,0,0,0,0,0,0,0,0,0,0,0,0,0,0,0,0,0,0,Andrea Barberis,Â£113Th. ,26.0,177.0,Midfielder - Central Midfield,right,AC Monza,25.0,0.0,0.0,1672.0,25.0,2.0,0.0,2174.0,29.0,3.0,0.0,1430.0,24.0,1.0,2.0,1478.0,27.0,1.0,1.0,1544.0,29.0,1.0,1.0,2456.0,27.0,0.0,3.0,2153.0,39.0,2.0,2.0,3108.0,33.0,2.0,1.0,2813.0,Serie A,39.0,2.0,9.0,3335.0,4.0,0.0,0.0,280.0
19/6/2011,Yannick M'Bone,85096682,11,4/16/1993,18,0,0,0,0,1250,4499,2500,111,100,94913,185,80,DM ,2,1,3,3,3,3,2,1,3,1,2,10,9,5,8,10,5,13,9,6,11,10,10,10,11,12,10,12,7,8,11,10,10,7,5,6,12,13,13,12,14,13,12,7,17,14,20,8,14,10,6,5,14,10,5,14,7,9,7,13,15,6,13,1,12,1,1,1,13,DM ,300,1,1,1,1,1,1,13,1,1,20,12,1,1,1,1,0.0,0,0,0,0,0,0,0,0,0,0,0,0,0,0,0,0,0,0,0,0,0,0,0,0,0,0,0,0,0,0,0,0,0,0,0,0,0,0,0,0,0,0,0,0,0,0,0,0,Yannick M'Bone,Â£270Th. ,27.0,184.0,Defender - Centre-Back,right,LB ChÃ¢teauroux,nan,nan,nan,nan,9.0,0.0,0.0,436.0,5.0,0.0,0.0,257.0,12.0,0.0,0.0,991.0,30.0,0.0,0.0,2673.0,35.0,1.0,0.0,3150.0,38.0,3.0,0.0,3426.0,37.0,1.0,2.0,3290.0,39.0,0.0,0.0,3510.0,Ligue 1,29.0,2.0,0.0,2636.0,8.0,0.0,0.0,720.0
19/6/2011,RaphaÃ«l Varane,85075627,769,4/25/1993,18,0,0,3,0,4883,6623,6623,169,134,0,190,85,D/DM C,3,2,2,2,2,1,2,2,2,3,3,5,8,9,6,13,6,15,8,7,13,13,6,12,13,9,13,13,15,11,11,13,15,7,11,8,14,14,14,15,13,16,15,8,14,14,20,14,15,16,9,14,6,10,5,15,14,17,16,16,16,5,20,10,1,1,10,1,20,D/DM C,111,1,1,1,1,1,1,20,1,10,17,1,1,1,1,10,274878000000.0,0,0,0,0,0,0,0,0,0,0,0,0,0,0,0,0,0,0,0,0,0,0,0,0,0,0,0,0,0,0,0,0,0,0,0,0,0,0,1,0,0,0,0,0,0,0,0,0,RaphaÃ«l Varane,Â£7.20m ,27.0,191.0,Defender - Centre-Back,right,Real Madrid,24.0,2.0,0.0,2066.0,15.0,2.0,1.0,1220.0,33.0,2.0,0.0,2623.0,23.0,0.0,1.0,1597.0,46.0,2.0,0.0,3419.0,33.0,0.0,0.0,2619.0,39.0,4.0,2.0,3381.0,44.0,0.0,2.0,3801.0,43.0,2.0,0.0,3775.0,LaLiga,43.0,3.0,1.0,3843.0,7.0,0.0,0.0,630.0,29/6/2010,RaphaÃ«l Varane,85075627,769,4/25/1993,17,0,0,0,0,1400,4589,2800,153,102,2056370,190,85,D C,1,2,1,1,3,1,2,2,3,2,3,5,5,7,6,12,6,14,7,7,12,11,6,9,12,10,13,13,14,11,10,12,14,5,6,6,11,13,13,10,8,15,15,5,14,9,20,14,15,16,10,10,6,10,12,13,14,13,15,17,17,5,RaphaÃÂ«l Varane,ÃÂ£3.60m ,Ligue 1
19/6/2011,Rafael LeÃ£o,28065671,1651,4/6/1993,18,0,0,0,0,1251,2750,2750,127,63,37091,176,64,DM C,1,2,1,2,2,3,3,6,1,2,3,8,6,7,10,12,3,8,8,3,10,12,8,12,12,5,8,9,12,5,9,7,6,5,11,4,8,9,9,9,8,8,5,10,12,8,20,6,2,10,3,10,7,8,13,7,8,5,5,10,14,2,1,1,15,1,1,1,15,DM C,301,1,1,8,1,1,1,1,1,1,20,15,1,1,1,1,0.0,0,0,0,0,0,0,0,0,0,0,0,0,0,0,0,0,0,0,0,0,0,0,0,0,0,0,0,0,0,0,0,0,0,0,0,0,0,0,0,0,0,0,0,0,0,0,0,0,nan,nan,nan,nan,nan,nan,nan,nan,nan,nan,nan,nan,nan,nan,nan,nan,nan,nan,nan,nan,nan,nan,nan,nan,nan,nan,nan,nan,nan,nan,nan,nan,nan,nan,nan,nan,nan,nan,nan,nan,nan,nan,nan,nan,nan,nan,nan,nan,nan,nan,nan,nan
19/6/2011,Ivan Varone,43074244,776,10/11/1992,18,0,0,0,0,50,1450,1100,65,36,795,181,82,DM ,1,3,3,2,3,3,3,1,2,3,2,4,7,3,4,7,2,8,10,2,8,6,1,7,8,9,4,2,3,7,8,4,8,11,4,2,8,6,10,12,9,11,10,8,7,11,20,6,3,7,10,10,5,9,15,19,9,6,12,8,13,5,1,1,8,1,1,1,8,DM ,300,1,1,1,1,1,1,1,1,1,20,8,1,1,1,1,0.0,0,0,0,0,0,0,0,0,0,0,0,0,0,0,0,0,0,0,0,0,0,0,0,0,0,0,0,0,0,0,0,0,0,0,0,0,0,0,0,0,0,0,0,0,0,0,0,0,nan,nan,nan,nan,nan,nan,nan,nan,nan,nan,nan,nan,nan,nan,nan,nan,nan,nan,nan,nan,nan,nan,nan,nan,nan,nan,nan,nan,nan,nan,nan,nan,nan,nan,nan,nan,nan,nan,nan,nan,nan,nan,nan,nan,nan,nan,nan,nan,nan,nan,nan,nan
19/6/2011,ZÃ© Eduardo,19070329,1651,8/16/1991,19,0,0,7,0,2505,5350,5011,144,105,196378,186,80,DM/M/AM C,1,3,1,1,1,3,2,3,2,2,1,1,9,12,10,10,4,12,9,4,12,11,11,13,12,12,11,15,11,11,9,11,11,5,11,11,11,12,12,14,13,13,13,6,15,14,20,14,13,11,11,11,12,15,3,16,5,9,10,11,7,15,1,1,20,16,11,1,20,DM/M/AM C,431,1,1,1,16,1,7,1,1,1,19,20,1,11,1,1,34.0,0,1,0,0,0,1,0,0,0,0,0,0,0,0,0,0,0,0,0,0,0,0,0,0,0,0,0,0,0,0,0,0,0,0,0,0,0,0,0,0,0,0,0,0,0,0,0,0,ZÃ© Eduardo,Â£450Th. ,29.0,186.0,Midfielder - Defensive Midfield,right,Sandefjord Fotball,14.0,0.0,0.0,1140.0,20.0,0.0,0.0,1328.0,35.0,4.0,3.0,2778.0,41.0,3.0,5.0,3331.0,14.0,1.0,1.0,735.0,16.0,0.0,1.0,1104.0,nan,nan,nan,nan,27.0,4.0,1.0,2019.0,30.0,0.0,1.0,2455.0,Serie A,4.0,1.0,0.0,166.0,nan,nan,nan,nan,29/6/2010,ZÃÂ© Eduardo,19070329,1651,8/16/1991,18,0,0,7,0,2500,5350,5350,155,107,2186391,186,80,DM/M/AM C,1,3,3,3,3,2,3,6,2,1,3,1,9,12,10,10,4,12,9,4,12,11,11,13,12,12,11,15,11,12,9,11,11,5,11,11,11,12,12,14,13,13,13,6,15,15,20,14,13,11,11,11,12,15,9,16,5,9,10,11,7,15,ZÃÂ© Eduardo,ÃÂ£270Th. ,Serie A
19/6/2011,Tolga Cigerci,91107170,771,3/23/1992,19,0,0,0,0,4250,5850,5850,175,117,2818169,185,75,M/AM C,2,1,1,3,3,3,2,2,3,2,3,11,12,13,12,13,11,11,10,6,12,13,10,12,13,10,12,9,12,11,12,13,11,10,2,11,12,13,12,12,13,10,12,9,13,13,20,12,11,10,10,10,9,10,3,10,10,10,10,11,10,5,1,1,20,17,1,1,20,M/AM C,411,1,1,1,17,1,1,1,1,1,15,20,1,1,1,1,0.0,0,0,0,0,0,0,0,0,0,0,0,0,0,0,0,0,0,0,0,0,0,0,0,0,0,0,0,0,0,0,0,0,0,0,0,0,0,0,0,0,0,0,0,0,0,0,0,0,Tolga Cigerci,Â£720Th. ,28.0,185.0,Midfielder - Central Midfield,right,Fenerbahce SK,22.0,3.0,3.0,1579.0,17.0,3.0,1.0,1160.0,19.0,1.0,0.0,1274.0,20.0,1.0,3.0,1577.0,2.0,0.0,0.0,76.0,21.0,0.0,2.0,1221.0,25.0,0.0,0.0,1922.0,24.0,6.0,0.0,1605.0,2.0,0.0,0.0,90.0,Bundesliga,33.0,2.0,4.0,2093.0,3.0,0.0,0.0,174.0
19/6/2011,Phil Jones,28027433,765,2/21/1992,19,0,0,9,0,5500,7400,7400,170,145,14653081,181,71,D/DM C,1,2,1,2,2,3,1,1,2,1,2,2,5,8,5,14,6,13,4,10,15,12,8,16,10,15,15,16,14,13,11,14,18,14,15,9,14,13,13,14,12,11,13,12,18,14,20,15,17,15,10,18,6,14,18,18,8,18,18,14,16,8,20,1,15,1,14,1,20,D/DM C,111,1,1,1,1,1,1,20,1,14,18,15,1,1,1,1,143074000000000.0,0,0,1,0,0,1,0,0,0,0,0,0,0,0,0,0,0,0,0,0,0,0,0,0,0,0,0,0,0,0,0,0,0,0,0,0,0,1,0,0,0,1,0,0,0,0,0,1,Phil Jones,Â£16.20m ,28.0,185.0,Defender - Centre-Back,right,Manchester United,29.0,0.0,0.0,2339.0,42.0,2.0,4.0,3076.0,24.0,0.0,2.0,1788.0,39.0,3.0,2.0,3099.0,25.0,0.0,2.0,2074.0,18.0,0.0,0.0,1045.0,26.0,0.0,0.0,2222.0,25.0,0.0,0.0,2152.0,24.0,0.0,1.0,1713.0,Premier League,8.0,1.0,0.0,562.0,nan,nan,nan,nan,29/6/2010,Phil Jones,28027433,765,2/21/1992,18,0,0,1,0,3100,6350,6350,168,116,11793468,186,71,D C,3,1,2,2,2,1,2,5,1,2,3,2,5,8,5,11,6,13,2,10,11,9,8,13,9,17,14,17,13,13,7,11,17,4,12,7,13,14,16,14,11,12,13,10,16,14,20,13,14,16,11,18,3,16,5,14,15,17,18,15,16,4,Phil Jones,ÃÂ£3.15m ,Premier League
19/6/2011,Nadir Minotti,43058969,776,5/16/1992,19,0,0,0,0,50,4500,4500,160,95,176359,182,75,M/AM C,1,1,2,3,1,1,1,2,2,3,2,10,9,11,13,11,7,11,12,5,6,12,12,11,12,13,11,10,11,9,12,10,14,12,12,8,10,10,11,11,11,10,10,8,12,12,20,11,13,14,10,11,5,13,10,13,14,15,12,14,16,6,1,1,18,20,1,1,20,M/AM C,521,1,1,1,20,1,1,1,1,1,15,18,1,1,1,1,0.0,0,0,0,0,0,0,0,0,0,0,0,0,0,0,0,0,0,0,0,0,0,0,0,0,0,0,0,0,0,0,0,0,0,0,0,0,0,0,0,0,0,0,0,0,0,0,0,0,Nadir Minotti,Â£675Th. ,28.0,188.0,Midfielder - Defensive Midfield,right,FC Lumezzane,29.0,13.0,0.0,2301.0,12.0,1.0,0.0,852.0,25.0,1.0,0.0,1413.0,25.0,2.0,0.0,1549.0,28.0,1.0,2.0,2013.0,26.0,1.0,0.0,1674.0,32.0,4.0,2.0,2394.0,nan,nan,nan,nan,nan,nan,nan,nan,Serie A,nan,nan,nan,nan,nan,nan,nan,nan
19/6/2011,Matthias Zimmermann,35017462,771,6/16/1992,19,0,0,0,0,2400,5600,5600,158,112,3791743,178,76,D/WB/DM/M RC,3,2,1,1,3,2,3,4,1,1,3,10,12,9,6,11,6,7,6,10,14,12,6,13,11,14,13,14,11,13,11,10,15,8,12,6,11,15,14,14,13,13,8,20,13,14,5,12,8,12,7,9,6,6,4,15,13,14,15,14,13,5,20,16,16,1,20,14,16,D/WB/DM/M RC,133,1,1,1,1,1,1,1,14,20,18,16,1,8,12,16,32800.0,0,0,0,0,0,1,0,0,0,0,0,0,0,0,0,1,0,0,0,0,0,0,0,0,0,0,0,0,0,0,0,0,0,0,0,0,0,0,0,0,0,0,0,0,0,0,0,0,Matthias Zimmermann,Â£900Th. ,28.0,177.0,Defender - Right-Back,right,Fortuna DÃ¼sseldorf,34.0,1.0,1.0,3042.0,14.0,1.0,1.0,1124.0,34.0,2.0,3.0,2775.0,21.0,0.0,1.0,1520.0,34.0,3.0,7.0,2849.0,36.0,1.0,1.0,2941.0,30.0,1.0,0.0,1726.0,7.0,0.0,0.0,427.0,36.0,1.0,3.0,3230.0,Bundesliga,38.0,2.0,4.0,3250.0,5.0,1.0,0.0,288.0
19/6/2011,Manuel Giandonato,43052125,776,10/10/1991,19,0,0,1,0,2022,5428,5027,142,120,134610,184,82,DM/M C,2,3,1,2,3,2,3,4,3,2,3,10,10,7,11,14,10,10,12,4,14,14,10,14,14,11,13,4,5,11,10,13,7,5,8,8,14,17,12,14,14,14,11,20,11,14,11,9,11,10,5,10,5,10,14,10,9,10,11,7,5,4,1,1,18,1,1,1,18,DM/M C,311,1,1,1,1,1,1,1,1,1,20,18,1,1,1,1,0.0,0,0,0,0,0,0,0,0,0,0,0,0,0,0,0,0,0,0,0,0,0,0,0,0,0,0,0,0,0,0,0,0,0,0,0,0,0,0,0,0,0,0,0,0,0,0,0,0,Manuel Giandonato,Â£450Th. ,29.0,188.0,Midfielder - Central Midfield,right,Olbia Calcio 1905,17.0,5.0,0.0,1138.0,8.0,0.0,0.0,208.0,25.0,1.0,4.0,1261.0,11.0,0.0,0.0,345.0,27.0,2.0,1.0,1512.0,22.0,0.0,4.0,639.0,17.0,0.0,2.0,1335.0,25.0,0.0,0.0,1389.0,33.0,3.0,1.0,2367.0,Serie A,24.0,0.0,3.0,1650.0,5.0,0.0,0.0,403.0
19/6/2011,Kyriakos Papadopoulos,36017184,772,2/23/1992,19,2,1,13,2,6000,6250,6900,166,132,10986072,182,79,D/DM C,2,1,1,2,2,3,3,2,1,2,2,4,6,7,5,7,4,13,5,15,19,9,6,18,8,20,12,20,7,10,7,9,19,3,13,6,10,18,19,15,8,18,14,9,10,15,20,16,17,14,12,15,3,6,5,16,12,15,14,9,7,10,20,1,10,1,5,1,20,D/DM C,111,1,5,1,1,1,1,20,1,5,17,10,1,1,1,1,137439000000.0,0,0,0,0,0,0,1,0,0,0,0,0,0,0,0,1,0,0,0,0,0,0,0,0,0,0,0,0,0,0,0,0,0,0,0,0,0,1,0,0,0,0,0,0,0,0,0,0,Kyriakos Papadopoulos,Â£10.80m ,28.0,185.0,Defender - Centre-Back,right,Without Club,31.0,0.0,1.0,1865.0,46.0,5.0,1.0,4077.0,16.0,2.0,0.0,1237.0,6.0,0.0,0.0,203.0,20.0,4.0,1.0,1180.0,31.0,1.0,0.0,2011.0,18.0,2.0,0.0,1416.0,30.0,1.0,1.0,2700.0,2.0,0.0,0.0,180.0,Bundesliga,4.0,0.0,0.0,284.0,nan,nan,nan,nan
19/6/2011,JoÃ«l Matip,91018389,11,8/8/1991,19,7,0,0,0,5400,6750,6900,141,128,7183847,193,88,D/DM C,1,1,2,3,2,3,3,4,2,1,1,4,10,8,7,9,5,15,6,13,15,9,7,16,10,10,15,14,7,12,10,7,10,5,7,8,16,17,13,12,9,11,18,12,14,16,20,15,13,10,6,11,5,15,13,5,14,12,9,7,12,9,20,1,11,1,8,10,20,D/DM C,111,1,1,1,1,1,1,20,8,8,16,11,10,1,1,1,1048576.0,0,0,0,0,0,0,0,0,0,0,0,0,0,0,0,0,0,0,0,0,1,0,0,0,0,0,0,0,0,0,0,0,0,0,0,0,0,0,0,0,0,0,0,0,0,0,0,0,Joel Matip,Â£9.00m ,29.0,195.0,Defender - Centre-Back,right,Liverpool FC,43.0,1.0,1.0,2400.0,47.0,5.0,5.0,4117.0,39.0,3.0,1.0,3457.0,42.0,4.0,2.0,3688.0,25.0,3.0,0.0,1904.0,41.0,4.0,5.0,3690.0,32.0,1.0,0.0,2725.0,35.0,1.0,0.0,2819.0,31.0,1.0,1.0,2342.0,Bundesliga,13.0,2.0,0.0,1075.0,2.0,0.0,0.0,91.0,29/6/2010,JoÃ«l Matip,91018389,11,8/8/1991,18,5,0,0,0,3250,6750,6750,153,125,18995757,193,88,D/DM C,2,3,2,1,1,1,3,4,3,1,3,4,9,9,6,12,5,15,6,13,15,9,7,16,13,10,14,15,9,11,12,8,10,7,6,7,16,17,13,12,8,12,18,12,14,15,20,14,13,13,6,11,5,16,6,7,6,13,14,11,9,14,Joel Matip,ÃÂ£2.70m ,Bundesliga
19/6/2011,Gustavo Campanharo,19102519,1651,4/4/1992,19,0,0,0,0,1750,5000,5000,136,100,97965,173,66,DM ,3,2,3,2,3,1,1,1,1,3,1,9,8,6,10,13,4,9,13,3,10,13,9,10,13,14,6,9,11,11,13,13,14,5,10,9,10,16,14,12,12,10,5,8,8,13,20,10,9,10,11,10,10,10,13,12,9,12,14,12,12,9,1,1,12,1,1,1,12,DM ,300,1,1,1,1,1,1,1,1,1,20,12,1,1,1,1,0.0,0,0,0,0,0,0,0,0,0,0,0,0,0,0,0,0,0,0,0,0,0,0,0,0,0,0,0,0,0,0,0,0,0,0,0,0,0,0,0,0,0,0,0,0,0,0,0,0,nan,nan,nan,nan,nan,nan,nan,nan,nan,nan,nan,nan,nan,nan,nan,nan,nan,nan,nan,nan,nan,nan,nan,nan,nan,nan,nan,nan,nan,nan,nan,nan,nan,nan,nan,nan,nan,nan,nan,nan,nan,nan,nan,nan,nan,nan,nan,nan,nan,nan,nan,nan
19/6/2011,FlÃ¡vio Ferreira,55022003,788,10/19/1991,19,0,0,0,0,500,1500,1500,109,90,58202,176,76,DM/M C,2,2,1,2,3,1,3,4,2,3,3,8,8,9,7,10,8,11,8,10,13,9,10,13,10,12,12,12,12,12,10,12,12,7,10,10,12,12,12,10,10,9,11,8,11,10,20,10,10,12,9,8,9,10,12,10,13,10,9,10,10,8,14,1,20,1,1,1,20,DM/M C,421,1,1,1,1,1,1,14,1,1,17,20,1,1,1,1,0.0,0,0,0,0,0,0,0,0,0,0,0,0,0,0,0,0,0,0,0,0,0,0,0,0,0,0,0,0,0,0,0,0,0,0,0,0,0,0,0,0,0,0,0,0,0,0,0,0,FlÃ¡vio Ferreira,Â£360Th. ,29.0,180.0,Defender - Centre-Back,right,Retired,22.0,0.0,0.0,1868.0,22.0,0.0,0.0,1253.0,38.0,1.0,1.0,3450.0,16.0,0.0,0.0,1325.0,0.0,0.0,0.0,0.0,nan,nan,nan,nan,nan,nan,nan,nan,nan,nan,nan,nan,nan,nan,nan,nan,Liga NOS,nan,nan,nan,nan,nan,nan,nan,nan
19/6/2011,Fanol Perdedaj,91018525,771,7/16/1991,19,0,0,0,0,693,5000,5000,130,100,178910,172,66,DM C,3,1,1,2,1,3,1,4,3,3,1,9,7,6,4,10,9,11,8,3,12,10,10,13,10,15,11,17,10,12,10,10,18,3,11,9,11,17,18,10,12,12,6,5,17,12,20,13,15,10,12,10,3,9,12,12,7,14,16,15,14,2,1,1,15,1,1,1,15,DM C,301,1,1,1,1,1,1,1,1,1,20,15,1,1,1,1,137439000000.0,0,0,0,0,0,0,0,0,0,1,0,0,0,0,0,0,0,0,0,0,0,0,0,0,0,0,0,0,0,0,0,0,0,0,0,0,0,1,0,0,0,0,0,0,0,0,0,0,Fanol Perdedaj,Â£720Th. ,29.0,173.0,Midfielder - Central Midfield,right,1.FC SaarbrÃ¼cken,21.0,0.0,1.0,1169.0,27.0,2.0,0.0,2073.0,26.0,1.0,2.0,1917.0,21.0,0.0,2.0,1425.0,38.0,1.0,2.0,3330.0,32.0,3.0,5.0,2862.0,17.0,0.0,0.0,1275.0,14.0,2.0,0.0,875.0,30.0,6.0,5.0,2035.0,Bundesliga,24.0,5.0,8.0,1871.0,1.0,0.0,0.0,23.0
19/6/2011,Danilo Pereira,55013032,788,9/9/1991,19,0,0,0,0,2043,5000,5000,135,100,306312,186,70,DM/M C,1,2,3,3,2,3,3,1,2,1,3,10,11,10,9,11,10,11,10,7,10,10,11,11,11,12,11,11,11,10,10,11,12,11,11,11,10,12,11,11,12,11,14,8,14,12,20,11,11,12,8,12,8,12,12,14,12,10,15,16,16,3,10,1,20,10,10,1,20,DM/M C,421,1,1,1,10,1,1,10,1,1,18,20,1,10,1,1,0.0,0,0,0,0,0,0,0,0,0,0,0,0,0,0,0,0,0,0,0,0,0,0,0,0,0,0,0,0,0,0,0,0,0,0,0,0,0,0,0,0,0,0,0,0,0,0,0,0,Danilo Pereira,Â£450Th. ,29.0,188.0,Midfielder - Defensive Midfield,right,Paris Saint-Germain,15.0,2.0,0.0,1125.0,10.0,1.0,0.0,486.0,36.0,1.0,1.0,3056.0,32.0,1.0,1.0,2611.0,38.0,3.0,1.0,3390.0,45.0,6.0,2.0,3497.0,41.0,4.0,1.0,3599.0,30.0,4.0,3.0,2435.0,43.0,3.0,1.0,3523.0,Serie A,40.0,2.0,1.0,3149.0,5.0,0.0,0.0,450.0
19/6/2011,Daniel Kofi Agyei,43026881,21,1/1/1992,19,0,0,0,0,1000,5500,5000,159,105,208774,181,75,DM C,2,1,1,3,2,2,3,3,3,3,2,7,6,9,7,12,6,9,9,14,14,14,5,13,13,12,15,11,12,12,10,10,18,6,8,12,10,10,12,11,12,12,9,5,15,13,20,13,12,12,8,14,5,8,18,16,17,14,16,18,14,4,1,1,15,1,1,1,15,DM C,301,1,1,1,1,1,1,1,1,1,20,15,1,1,1,1,1077936384.0,0,0,0,0,0,0,0,0,1,0,0,0,0,0,0,0,0,0,0,0,0,0,1,0,0,0,0,0,0,0,1,0,0,0,0,0,0,0,0,0,0,0,0,0,0,0,0,0,Daniel Kofi Agyei,Â£270Th. ,28.0,178.0,Midfielder - Defensive Midfield,both,Carrarese Calcio 1908,24.0,0.0,0.0,1771.0,33.0,1.0,0.0,3028.0,20.0,0.0,0.0,1143.0,20.0,0.0,0.0,1275.0,33.0,2.0,0.0,2139.0,25.0,2.0,0.0,2024.0,35.0,1.0,2.0,2617.0,30.0,1.0,0.0,2027.0,24.0,1.0,1.0,1841.0,Serie A,15.0,0.0,0.0,346.0,8.0,0.0,0.0,627.0,29/6/2010,Daniel Kofi Agyei,43026881,21,1/1/1992,18,0,0,0,0,1000,5500,4850,165,115,10336499,181,75,DM C,1,3,3,2,3,2,3,3,3,3,3,7,6,9,7,14,6,9,11,14,14,16,5,13,14,12,15,11,12,12,11,10,18,6,8,12,10,10,14,13,12,12,9,5,15,14,20,13,12,12,8,14,5,8,18,16,17,14,16,18,14,4,Daniel Kofi Agyei,ÃÂ£225Th. ,Serie A
19/6/2011,Cristian Battocchio,43072700,1649,2/10/1992,19,0,0,0,0,1550,5450,5400,145,108,406871,160,55,M C,2,2,1,2,2,3,3,2,2,1,2,12,8,15,8,14,12,1,13,3,8,16,12,11,14,14,10,8,13,8,15,9,13,15,7,6,7,11,13,14,15,8,1,12,10,12,20,9,5,10,7,12,4,10,16,13,12,12,11,14,16,3,1,1,20,1,1,1,20,M C,401,1,1,1,1,1,1,1,1,1,15,20,1,1,1,1,4194304.0,0,0,0,0,0,0,0,0,0,0,0,0,0,0,0,0,0,0,0,0,0,0,1,0,0,0,0,0,0,0,0,0,0,0,0,0,0,0,0,0,0,0,0,0,0,0,0,0,Cristian Battocchio,Â£720Th. ,28.0,177.0,Midfielder - Central Midfield,right,Stade Brest 29,23.0,5.0,0.0,1945.0,15.0,1.0,0.0,955.0,26.0,2.0,2.0,1577.0,41.0,5.0,3.0,2557.0,32.0,0.0,3.0,2328.0,33.0,5.0,4.0,2591.0,38.0,8.0,6.0,3316.0,36.0,1.0,2.0,2297.0,14.0,2.0,3.0,648.0,Serie A,27.0,3.0,2.0,1506.0,5.0,0.0,0.0,177.0
19/6/2011,Yann M'Vila,8449433,769,6/29/1990,20,10,0,8,0,6250,7500,6750,175,150,6975513,178,78,DM ,3,1,3,2,3,2,3,3,2,1,2,8,8,11,6,13,10,13,12,6,14,16,11,14,13,14,17,15,15,15,13,14,16,9,12,11,14,18,18,13,13,15,10,8,14,11,20,16,15,14,14,16,6,6,13,14,14,17,14,12,12,7,1,1,10,1,1,1,10,DM ,300,1,1,1,1,1,1,1,1,1,20,10,1,1,1,1,0.0,0,0,0,0,0,0,0,0,0,0,0,0,0,0,0,0,0,0,0,0,0,0,0,0,0,0,0,0,0,0,0,0,0,0,0,0,0,0,0,0,0,0,0,0,0,0,0,0,Yann M'Vila,Â£18.90m ,30.0,182.0,Midfielder - Defensive Midfield,right,Olympiacos Piraeus,41.0,3.0,2.0,3646.0,50.0,1.0,3.0,4371.0,25.0,0.0,2.0,1744.0,32.0,0.0,4.0,2693.0,14.0,0.0,0.0,747.0,41.0,1.0,6.0,3470.0,23.0,1.0,1.0,1850.0,37.0,2.0,1.0,3272.0,40.0,0.0,1.0,3528.0,Ligue 1,33.0,0.0,2.0,2824.0,8.0,0.0,1.0,456.0,29/6/2010,Yann M'Vila,8449433,769,6/29/1990,20,0,0,8,0,4830,6254,6250,175,139,15307332,178,78,DM C,3,1,3,2,2,3,3,3,3,3,1,8,8,11,6,12,10,12,12,6,14,14,8,14,12,14,17,15,14,14,13,14,16,12,9,11,13,15,17,10,13,15,10,8,14,13,20,16,15,13,14,16,6,6,16,14,14,16,14,11,11,7,Yann M'Vila,ÃÂ£14.85m ,Ligue 1
19/6/2011,Thomas Monconduit,34012452,769,2/10/1991,20,0,0,0,0,1250,2500,2500,140,100,183031,184,80,D/WB R,1,2,2,2,2,2,2,5,2,1,3,9,12,9,6,12,6,11,9,7,11,8,6,8,12,12,10,12,11,11,7,11,13,8,11,10,10,12,13,11,9,14,12,14,13,13,20,12,14,13,12,14,9,12,14,13,14,14,14,15,15,6,20,17,12,1,20,10,1,D/WB R,112,1,1,1,1,1,1,1,10,20,15,1,1,12,10,17,32.0,0,0,0,0,0,1,0,0,0,0,0,0,0,0,0,0,0,0,0,0,0,0,0,0,0,0,0,0,0,0,0,0,0,0,0,0,0,0,0,0,0,0,0,0,0,0,0,0,Thomas Monconduit,Â£90Th. ,29.0,184.0,Midfielder - Defensive Midfield,right,FC Lorient,0.0,0.0,0.0,0.0,1.0,0.0,0.0,65.0,15.0,0.0,1.0,1058.0,31.0,0.0,2.0,2372.0,nan,nan,nan,nan,19.0,2.0,1.0,1303.0,36.0,3.0,5.0,3050.0,36.0,1.0,3.0,3085.0,35.0,0.0,1.0,2870.0,Ligue 1,23.0,1.0,0.0,1701.0,5.0,1.0,0.0,169.0
19/6/2011,Thanos Petsos,91014707,772,6/5/1991,20,0,0,2,0,500,6100,6300,152,126,783088,184,80,D/DM RLC,1,3,1,2,1,2,3,3,2,1,3,7,12,12,9,12,7,12,11,11,13,13,7,13,12,10,11,13,10,11,10,10,13,12,7,8,14,13,13,13,13,13,11,10,12,13,20,14,13,11,9,10,6,13,12,12,12,11,11,12,10,10,20,8,13,1,20,17,17,D/DM RLC,116,1,1,1,1,1,1,17,17,20,20,13,1,1,1,8,0.0,0,0,0,0,0,0,0,0,0,0,0,0,0,0,0,0,0,0,0,0,0,0,0,0,0,0,0,0,0,0,0,0,0,0,0,0,0,0,0,0,0,0,0,0,0,0,0,0,Thanos Petsos,Â£1.13m ,29.0,184.0,Midfielder - Defensive Midfield,right,WSG Tirol,28.0,1.0,1.0,2085.0,21.0,1.0,0.0,948.0,16.0,1.0,0.0,936.0,37.0,4.0,2.0,3100.0,31.0,1.0,1.0,2599.0,33.0,2.0,3.0,2733.0,4.0,0.0,0.0,150.0,21.0,0.0,1.0,1450.0,nan,nan,nan,nan,Bundesliga,15.0,1.0,2.0,1336.0,7.0,0.0,2.0,591.0,29/6/2010,Thanos Petsos,91014707,772,6/5/1991,19,0,0,1,0,500,4000,4000,125,85,376639,184,80,D RLC,3,1,1,3,3,3,3,1,2,2,3,10,8,8,10,7,5,14,4,4,11,8,5,14,12,9,12,14,9,13,4,6,10,4,11,5,9,11,13,9,8,7,12,20,10,13,9,9,8,4,9,10,11,10,8,13,10,16,7,9,7,9,Thanos Petsos,ÃÂ£1.35m ,Bundesliga
19/6/2011,Salif SanÃ©,85049933,41,8/25/1990,20,0,0,0,0,4100,5174,5150,140,115,170420,195,84,D RC,1,3,3,1,3,2,1,3,1,3,3,5,11,9,6,11,6,15,12,15,12,9,7,11,11,15,13,13,10,12,8,11,13,8,7,6,12,13,14,9,7,16,17,20,14,11,10,14,17,14,15,13,6,12,14,15,14,14,12,13,13,8,20,1,10,5,15,10,20,D RC,103,1,1,1,5,1,1,20,10,15,15,10,1,1,1,1,8796090000000.0,0,0,0,0,0,0,0,0,0,0,0,0,0,0,0,1,0,0,0,0,0,0,0,0,0,0,0,0,0,0,0,0,0,0,0,0,0,0,0,0,0,0,0,1,0,0,0,0,Salif SanÃ©,Â£1.80m ,30.0,196.0,Defender - Centre-Back,right,FC Schalke 04,5.0,0.0,0.0,360.0,33.0,2.0,0.0,2781.0,37.0,2.0,4.0,3360.0,21.0,2.0,0.0,1584.0,30.0,4.0,0.0,2515.0,33.0,3.0,0.0,2932.0,31.0,3.0,2.0,2542.0,34.0,4.0,1.0,3060.0,40.0,4.0,1.0,3543.0,Ligue 1,16.0,2.0,1.0,1215.0,4.0,0.0,0.0,314.0,29/6/2010,Salif SanÃ©,85049933,769,8/25/1990,19,0,0,0,0,1200,2450,2450,132,99,3461302,194,84,D C,2,1,2,2,1,3,1,4,3,2,2,5,5,9,6,11,5,14,11,5,13,8,6,8,11,15,10,13,10,10,8,11,13,7,2,6,11,12,14,9,6,15,17,5,14,10,20,14,15,14,10,8,3,10,12,15,14,13,12,13,13,8,Salif SanÃÂ©,ÃÂ£315Th. ,Ligue 1
19/6/2011,Robert Gucher,28018443,755,2/20/1991,20,0,0,0,0,2047,4746,4545,148,105,187155,183,80,DM/M C,3,3,3,1,1,3,2,1,1,1,1,7,7,10,6,12,10,8,11,1,12,13,9,11,12,11,12,12,10,9,14,9,10,8,8,11,11,14,14,11,13,11,9,5,14,12,20,14,14,9,12,10,10,10,15,4,13,11,9,11,8,12,1,1,20,1,8,1,20,DM/M C,311,1,1,1,1,1,1,1,1,1,20,20,1,8,1,1,0.0,0,0,0,0,0,0,0,0,0,0,0,0,0,0,0,0,0,0,0,0,0,0,0,0,0,0,0,0,0,0,0,0,0,0,0,0,0,0,0,0,0,0,0,0,0,0,0,0,Robert Tesche,Â£1.13m ,33.0,182.0,Midfielder - Central Midfield,right,VfL Bochum,12.0,0.0,0.0,537.0,26.0,2.0,1.0,1245.0,18.0,0.0,1.0,1112.0,21.0,2.0,1.0,1330.0,37.0,4.0,5.0,2903.0,25.0,1.0,1.0,1615.0,26.0,0.0,0.0,1852.0,19.0,2.0,0.0,1188.0,31.0,3.0,2.0,2440.0,Bundesliga,26.0,1.0,1.0,1891.0,6.0,0.0,0.0,451.0
19/6/2011,Recio,67138565,796,1/11/1991,20,0,0,1,0,3750,5900,5900,142,120,1242458,184,75,DM/M C,3,3,1,2,1,2,2,5,3,2,2,7,10,9,9,12,9,12,9,9,12,14,4,14,12,13,15,13,13,13,13,13,12,7,9,10,13,13,12,12,12,10,9,7,12,13,20,14,12,10,7,12,7,12,12,15,11,12,11,11,13,8,1,1,20,1,1,1,20,DM/M C,421,1,1,1,1,1,1,1,1,1,18,20,1,1,1,1,96.0,0,0,0,0,0,1,1,0,0,0,0,0,0,0,0,0,0,0,0,0,0,0,0,0,0,0,0,0,0,0,0,0,0,0,0,0,0,0,0,0,0,0,0,0,0,0,0,0,Recio,Â£1.80m ,29.0,183.0,Midfielder - Central Midfield,right,SD Eibar,25.0,2.0,2.0,1778.0,8.0,0.0,0.0,318.0,22.0,2.0,0.0,1616.0,32.0,2.0,0.0,2473.0,36.0,3.0,3.0,1932.0,34.0,0.0,5.0,2840.0,18.0,3.0,2.0,1358.0,23.0,2.0,2.0,1932.0,22.0,0.0,0.0,1647.0,LaLiga,26.0,0.0,0.0,1601.0,4.0,0.0,0.0,175.0
19/6/2011,Prince Segbefia,12012410,50,3/11/1991,20,0,0,0,0,2450,4904,4900,133,109,98884,176,70,DM/M C,3,3,2,3,3,2,3,5,3,1,2,6,10,11,6,12,7,9,12,6,7,10,8,14,11,11,13,15,11,11,13,10,10,11,7,9,11,13,15,15,14,12,8,5,13,13,20,14,11,13,11,10,8,8,12,14,10,8,17,2,16,7,7,7,17,8,7,1,17,DM/M C,311,1,1,1,8,1,1,1,1,7,20,17,1,1,1,7,34359738496.0,0,0,0,0,0,0,0,1,0,0,0,0,0,0,0,0,0,0,0,0,0,0,0,0,0,0,0,0,0,0,0,0,0,0,0,1,0,0,0,0,0,0,0,0,0,0,0,0,Prince Segbefia,Â£630Th. ,29.0,179.0,Midfielder - Central Midfield,right,Tuzlaspor,4.0,0.0,0.0,307.0,19.0,0.0,0.0,1348.0,23.0,0.0,0.0,1176.0,24.0,3.0,1.0,1777.0,14.0,1.0,0.0,877.0,24.0,5.0,0.0,2136.0,32.0,4.0,0.0,2483.0,14.0,0.0,1.0,790.0,32.0,3.0,1.0,2561.0,Ligue 1,2.0,0.0,0.0,74.0,7.0,0.0,0.0,418.0
19/6/2011,Mubarak Wakaso,12006112,21,7/25/1990,20,0,0,0,0,4250,5489,6250,148,122,680661,169,67,DM/M LC,1,1,1,3,3,3,3,3,1,1,1,12,13,12,8,11,11,5,14,8,10,13,9,13,12,18,11,16,7,8,12,9,14,12,6,12,8,13,17,16,16,13,6,20,17,14,7,18,11,12,14,10,5,9,9,11,9,7,8,8,7,14,10,12,20,9,1,15,20,DM/M LC,424,1,1,1,8,9,1,1,10,1,16,20,15,1,12,1,137573000000.0,0,0,0,0,0,0,0,0,0,0,0,0,0,0,0,0,0,1,0,0,0,0,0,0,0,0,0,1,0,0,0,0,0,0,0,0,0,1,0,0,0,0,0,0,0,0,0,0,Mubarak Wakaso,Â£1.80m ,30.0,171.0,Midfielder - Central Midfield,left,Jiangsu Suning,38.0,3.0,1.0,2011.0,10.0,0.0,0.0,311.0,27.0,3.0,6.0,1917.0,18.0,2.0,2.0,841.0,13.0,1.0,1.0,849.0,24.0,2.0,2.0,1204.0,27.0,2.0,3.0,2158.0,24.0,0.0,2.0,1374.0,29.0,1.0,1.0,1663.0,LaLiga,32.0,0.0,1.0,2466.0,nan,nan,nan,nan
19/6/2011,MickaÃ«l Firmin,8448718,769,9/21/1990,20,0,0,0,0,1250,2500,2500,135,101,40459,185,72,D/DM C,1,1,1,2,2,1,1,3,1,3,2,5,9,8,6,11,6,12,7,7,11,10,6,9,11,10,13,14,13,13,9,12,15,6,8,6,12,14,16,9,12,13,12,5,15,12,20,17,13,14,10,10,5,15,5,12,14,12,16,14,14,6,18,12,14,1,12,10,18,D/DM C,321,1,1,1,1,1,1,18,10,12,20,14,1,1,10,12,0.0,0,0,0,0,0,0,0,0,0,0,0,0,0,0,0,0,0,0,0,0,0,0,0,0,0,0,0,0,0,0,0,0,0,0,0,0,0,0,0,0,0,0,0,0,0,0,0,0,MickaÃ«l Firmin,Â£540Th. ,30.0,179.0,Defender - Centre-Back,right,Without Club,0.0,0.0,0.0,0.0,8.0,0.0,0.0,437.0,15.0,0.0,0.0,1108.0,7.0,0.0,0.0,538.0,2.0,0.0,0.0,43.0,nan,nan,nan,nan,nan,nan,nan,nan,32.0,0.0,0.0,2811.0,nan,nan,nan,nan,Ligue 1,nan,nan,nan,nan,nan,nan,nan,nan
19/6/2011,Maurinho,19158519,1651,10/31/1990,20,0,0,0,0,583,4050,4050,111,81,7144,178,79,DM ,1,3,1,3,2,1,1,4,3,1,3,7,6,6,7,12,3,9,13,6,12,11,9,10,13,13,9,6,9,11,10,10,8,3,8,9,9,10,12,13,11,11,7,10,14,9,20,8,4,9,5,4,13,10,8,9,3,11,8,8,12,6,1,1,10,1,1,1,10,DM ,300,1,1,1,1,1,1,1,1,1,20,10,1,1,1,1,0.0,0,0,0,0,0,0,0,0,0,0,0,0,0,0,0,0,0,0,0,0,0,0,0,0,0,0,0,0,0,0,0,0,0,0,0,0,0,0,0,0,0,0,0,0,0,0,0,0,Marinho,Â£1.17m ,37.0,166.0,Forward - Right Winger,left,Retired,30.0,2.0,1.0,1883.0,34.0,7.0,2.0,2162.0,41.0,4.0,5.0,2818.0,32.0,1.0,2.0,1461.0,17.0,4.0,1.0,990.0,21.0,3.0,0.0,899.0,44.0,4.0,5.0,3411.0,33.0,6.0,3.0,2079.0,23.0,1.0,2.0,629.0,Liga NOS,nan,nan,nan,nan,nan,nan,nan,nan
19/6/2011,Marc Hornschuh,35011184,771,3/2/1991,20,0,0,3,0,2800,5250,5250,122,105,225945,188,71,D/DM/M RC,3,1,3,3,1,1,2,2,2,1,3,5,6,6,5,10,5,11,6,12,14,9,8,14,9,12,13,13,11,9,7,11,11,5,7,6,13,14,12,10,12,13,14,10,12,12,20,14,13,12,9,11,8,13,6,14,12,18,12,11,12,5,20,15,16,1,17,5,20,D/DM/M RC,123,1,1,1,1,1,1,20,5,17,19,16,5,5,5,15,0.0,0,0,0,0,0,0,0,0,0,0,0,0,0,0,0,0,0,0,0,0,0,0,0,0,0,0,0,0,0,0,0,0,0,0,0,0,0,0,0,0,0,0,0,0,0,0,0,0,Marc Hornschuh,Â£225Th. ,29.0,188.0,Defender - Centre-Back,right,Hamburger SV II,25.0,1.0,0.0,2241.0,17.0,1.0,0.0,1440.0,31.0,0.0,3.0,2466.0,36.0,2.0,1.0,3240.0,33.0,1.0,0.0,2832.0,27.0,2.0,2.0,2280.0,22.0,0.0,1.0,1908.0,7.0,0.0,0.0,609.0,4.0,0.0,0.0,341.0,Bundesliga,7.0,0.0,0.0,571.0,9.0,0.0,0.0,781.0
19/6/2011,Manuel Zeitz,91016944,771,8/1/1990,20,0,0,0,0,3000,5250,5250,139,105,419575,180,74,DM/M C,3,3,3,3,1,2,1,1,1,1,3,12,11,11,11,12,10,9,11,5,11,14,12,11,12,14,12,12,12,11,12,13,13,12,10,12,11,14,15,11,12,10,10,7,11,10,20,12,7,11,6,10,5,13,9,15,10,12,11,11,11,7,11,1,18,13,1,1,18,DM/M C,311,1,1,1,13,1,1,11,1,1,20,18,1,1,1,1,0.0,0,0,0,0,0,0,0,0,0,0,0,0,0,0,0,0,0,0,0,0,0,0,0,0,0,0,0,0,0,0,0,0,0,0,0,0,0,0,0,0,0,0,0,0,0,0,0,0,Manuel Zeitz,Â£360Th. ,30.0,181.0,Midfielder - Defensive Midfield,right,1.FC SaarbrÃ¼cken,31.0,6.0,6.0,2621.0,26.0,4.0,1.0,2246.0,25.0,2.0,0.0,1197.0,27.0,0.0,0.0,1596.0,23.0,6.0,0.0,2039.0,33.0,2.0,1.0,2780.0,32.0,3.0,2.0,2770.0,34.0,4.0,3.0,2914.0,34.0,5.0,1.0,3000.0,Bundesliga,29.0,3.0,2.0,2604.0,6.0,0.0,0.0,540.0
19/6/2011,Josuha Guilavogui,34009731,769,9/19/1990,20,0,0,6,0,4225,5295,5281,150,117,471856,187,77,DM ,1,3,1,1,3,2,1,6,2,1,3,5,7,9,6,11,10,16,12,6,13,11,6,11,11,13,14,14,12,12,12,9,15,8,9,8,12,16,15,15,11,16,14,5,13,12,20,16,14,15,13,12,8,10,9,13,13,14,13,14,14,6,14,8,12,1,8,1,14,DM ,300,1,1,1,1,1,1,14,1,8,20,12,1,1,1,8,32.0,0,0,0,0,0,1,0,0,0,0,0,0,0,0,0,0,0,0,0,0,0,0,0,0,0,0,0,0,0,0,0,0,0,0,0,0,0,0,0,0,0,0,0,0,0,0,0,0,Josuha Guilavogui,Â£3.60m ,30.0,188.0,Midfielder - Defensive Midfield,right,VfL Wolfsburg,24.0,1.0,0.0,1691.0,34.0,3.0,3.0,2479.0,45.0,5.0,2.0,3284.0,20.0,0.0,1.0,1305.0,42.0,2.0,1.0,2790.0,42.0,2.0,1.0,3317.0,21.0,0.0,0.0,1703.0,35.0,3.0,2.0,2857.0,20.0,2.0,1.0,1659.0,Ligue 1,32.0,0.0,1.0,2618.0,8.0,2.0,0.0,661.0,29/6/2010,Josuha Guilavogui,34009731,769,9/19/1990,19,0,0,0,0,2600,5264,5250,150,117,4788224,187,77,DM C,1,2,2,3,3,1,3,2,2,2,3,5,7,9,6,11,10,16,12,6,13,11,6,11,11,13,14,14,12,12,12,9,15,8,9,8,12,16,15,15,11,16,14,5,13,12,20,16,14,15,13,12,8,10,10,13,13,14,13,14,14,6,Josuha Guilavogui,ÃÂ£1.08m ,Ligue 1
19/6/2011,Jonathan Mensah,65002338,21,7/13/1990,20,11,1,0,0,6000,7040,5750,150,128,3442232,188,83,D/DM C,2,3,1,3,3,1,3,3,2,3,2,10,11,7,3,10,5,13,6,2,13,10,10,14,10,9,12,15,12,12,14,12,16,7,12,7,12,14,15,14,14,14,14,11,15,14,20,15,14,10,8,16,11,18,15,12,9,14,16,5,6,13,20,13,10,1,13,13,20,D/DM C,111,1,3,1,1,1,1,20,13,13,18,10,1,1,13,13,16777216.0,0,0,0,0,0,0,0,0,0,0,0,0,0,0,0,0,0,0,0,0,0,0,0,0,1,0,0,0,0,0,0,0,0,0,0,0,0,0,0,0,0,0,0,0,0,0,0,0,Jonathan Mensah,Â£540Th. ,30.0,188.0,Defender - Centre-Back,right,Columbus Crew SC,15.0,1.0,0.0,1202.0,1.0,0.0,0.0,90.0,6.0,0.0,0.0,481.0,27.0,1.0,0.0,1916.0,12.0,1.0,0.0,1006.0,15.0,0.0,1.0,1088.0,42.0,2.0,1.0,3429.0,30.0,1.0,0.0,2647.0,24.0,0.0,0.0,2151.0,Ligue 1,20.0,0.0,0.0,1800.0,nan,nan,nan,nan
19/6/2011,James McCarthy,61002273,789,11/12/1990,20,3,0,6,1,4250,6000,6350,156,132,2942728,181,63,DM/M RC,1,2,3,3,2,3,1,2,1,3,2,12,12,14,14,14,5,11,13,4,7,16,8,11,17,12,14,13,14,7,12,13,10,12,5,15,11,13,14,14,12,10,8,10,14,13,20,16,5,11,8,14,5,10,12,5,18,14,15,1,10,17,1,1,20,13,15,1,20,DM/M RC,423,1,1,1,13,1,1,1,1,1,17,20,1,15,1,1,51539609760.0,0,0,0,0,0,1,0,1,0,0,0,1,0,0,0,0,0,0,0,0,0,0,0,0,0,0,0,0,0,0,0,0,0,0,1,1,0,0,0,0,0,0,0,0,0,0,0,0,James McCarthy,Â£4.95m ,29.0,180.0,Midfielder - Central Midfield,right,Crystal Palace,27.0,3.0,2.0,2044.0,34.0,0.0,3.0,2973.0,42.0,3.0,2.0,3645.0,45.0,1.0,3.0,3841.0,37.0,2.0,3.0,2936.0,37.0,2.0,2.0,3045.0,13.0,1.0,2.0,678.0,6.0,0.0,0.0,356.0,2.0,0.0,0.0,104.0,Premier League,35.0,0.0,0.0,1847.0,4.0,0.0,0.0,319.0,29/6/2010,James McCarthy,61002273,789,11/12/1990,19,1,0,5,0,3906,6000,6350,156,125,13534989,181,63,DM/M/AM RC,1,3,2,1,3,1,1,3,3,1,2,10,11,13,14,12,5,10,13,4,7,15,8,11,17,10,11,11,11,7,12,11,10,12,5,15,11,13,14,14,12,10,8,10,14,13,20,15,5,11,8,14,5,10,12,5,18,14,15,10,10,17,James McCarthy,ÃÂ£2.70m ,Premier League
19/6/2011,Jack Rodwell,28010312,765,3/11/1991,20,0,0,17,2,4750,6750,6750,165,135,3939874,188,80,DM/M C,2,1,1,2,1,1,1,6,3,3,3,4,9,12,12,14,4,14,12,3,13,14,10,13,14,12,12,12,14,11,11,13,12,5,14,8,13,14,14,14,12,14,14,14,15,14,20,15,13,9,7,12,5,10,6,15,13,14,13,11,15,5,1,1,20,13,7,7,20,DM/M C,421,1,1,1,13,1,1,1,1,1,18,20,7,7,1,1,33088.0,0,0,0,0,0,0,1,0,1,0,0,0,0,0,0,1,0,0,0,0,0,0,0,0,0,0,0,0,0,0,0,0,0,0,0,0,0,0,0,0,0,0,0,0,0,0,0,0,Jack Rodwell,Â£13.50m ,29.0,188.0,Midfielder - Defensive Midfield,right,Sheffield United,29.0,1.0,2.0,1754.0,19.0,2.0,2.0,1343.0,16.0,2.0,1.0,670.0,10.0,0.0,0.0,336.0,26.0,3.0,0.0,1663.0,24.0,3.0,2.0,1292.0,23.0,0.0,1.0,1763.0,9.0,1.0,0.0,669.0,23.0,1.0,0.0,1589.0,Premier League,2.0,0.0,0.0,73.0,nan,nan,nan,nan,29/6/2010,Jack Rodwell,28010312,765,3/11/1991,19,0,0,11,2,4556,7100,7100,172,135,15908261,188,80,D/DM/M C,3,1,2,2,3,2,1,1,1,2,1,4,9,10,9,14,4,14,11,3,13,14,10,14,14,13,12,13,14,11,12,13,12,5,14,8,14,14,14,14,12,14,14,10,15,14,20,16,13,9,7,12,5,10,7,15,13,14,13,11,15,5,Jack Rodwell,ÃÂ£12.60m ,Premier League
19/6/2011,HÃ¥vard Nordtveit,53000623,786,6/21/1990,20,1,0,15,1,4850,5849,6450,142,130,5376676,188,72,D/DM/M C,3,2,1,3,1,2,2,1,2,3,1,5,11,9,6,14,7,12,7,19,12,15,5,14,13,11,15,12,14,9,13,15,14,7,13,7,12,17,12,12,9,10,14,12,13,17,20,13,12,11,8,14,9,10,14,14,16,16,15,12,16,7,18,10,17,1,12,1,18,D/DM/M C,331,1,12,1,1,1,1,18,1,12,20,17,1,1,1,10,8796180000000.0,0,0,0,0,0,0,0,0,0,0,0,0,0,0,0,0,0,0,0,1,0,0,1,0,1,0,1,0,0,0,0,0,0,0,0,0,0,0,0,0,0,0,0,1,0,0,0,0,Havard Nordtveit,Â£4.95m ,30.0,188.0,Defender - Centre-Back,right,TSG 1899 Hoffenheim,25.0,2.0,1.0,2196.0,36.0,1.0,0.0,2872.0,42.0,2.0,6.0,3563.0,22.0,1.0,2.0,1285.0,30.0,3.0,1.0,1550.0,39.0,4.0,1.0,2996.0,22.0,0.0,1.0,1420.0,23.0,0.0,1.0,1502.0,16.0,1.0,1.0,1011.0,Bundesliga,12.0,0.0,1.0,818.0,nan,nan,nan,nan
19/6/2011,GueÃ¯da Fofana,34011543,769,5/16/1991,20,0,0,0,0,2623,5399,4121,160,120,654545,182,74,DM/M C,3,2,3,3,2,3,1,5,3,1,1,8,9,11,7,11,13,9,13,5,8,13,10,9,14,13,14,13,12,10,12,10,14,11,13,9,11,14,14,16,13,14,11,8,15,13,20,15,14,12,13,15,6,8,7,15,12,14,13,15,15,7,1,1,20,1,12,1,20,DM/M C,421,1,1,1,1,1,1,1,1,1,16,20,1,12,1,1,274878000000.0,0,0,1,0,0,1,0,0,0,0,0,0,0,0,0,0,0,0,0,0,0,0,0,0,0,0,0,0,0,0,0,0,0,0,0,0,0,0,1,0,0,0,0,0,0,0,0,0,GueÃ¯da Fofana,Â£3.15m ,29.0,182.0,Midfielder - Defensive Midfield,right,Retired,36.0,3.0,3.0,2593.0,25.0,0.0,0.0,1502.0,38.0,5.0,6.0,2658.0,39.0,4.0,1.0,3145.0,2.0,0.0,0.0,41.0,0.0,0.0,0.0,0.0,nan,nan,nan,nan,nan,nan,nan,nan,nan,nan,nan,nan,Ligue 1,nan,nan,nan,nan,nan,nan,nan,nan
19/6/2011,Franco Zuculini,14006042,1649,9/5/1990,20,1,0,9,0,3900,6750,6250,144,123,476360,176,70,DM/M RC,2,2,2,3,1,3,2,6,1,3,2,6,10,12,6,15,6,8,7,12,18,14,8,12,14,18,7,19,7,9,10,8,18,9,11,10,7,15,19,17,15,14,7,8,12,13,20,18,12,9,14,12,6,12,2,9,12,10,7,9,7,14,1,1,20,1,15,14,20,DM/M RC,423,1,1,1,1,1,1,1,1,1,18,20,14,15,1,1,137439000000.0,0,0,0,0,0,0,0,0,0,0,0,0,0,0,0,1,0,0,0,0,0,0,0,0,0,0,0,0,0,0,0,0,0,0,0,0,0,1,0,0,0,0,0,0,0,0,0,0,Franco Zuculini,Â£2.70m ,30.0,176.0,Midfielder - Central Midfield,right,Defensor Sporting Club,23.0,0.0,1.0,1145.0,23.0,0.0,3.0,1161.0,20.0,2.0,1.0,1190.0,19.0,0.0,1.0,857.0,28.0,3.0,6.0,1805.0,3.0,1.0,0.0,174.0,16.0,1.0,1.0,565.0,14.0,0.0,0.0,592.0,20.0,0.0,0.0,1117.0,LaLiga,21.0,1.0,2.0,1239.0,nan,nan,nan,nan,29/6/2010,Franco Zuculini,14006042,1649,9/5/1990,19,1,0,9,0,3600,6750,6250,164,125,9200000,176,70,DM/M RC,2,3,1,3,1,3,1,1,2,1,1,6,10,12,6,15,6,8,7,12,18,14,8,11,14,19,7,19,8,9,10,8,18,9,11,13,7,15,19,17,15,16,7,8,12,13,20,18,12,9,14,12,6,10,2,9,12,13,8,9,7,14,Franco Zuculini,ÃÂ£2.70m ,Serie A
19/6/2011,Francis Coquelin,34012022,769,5/13/1991,20,0,0,0,0,4400,5576,5576,164,123,2842045,178,73,DM/M C,1,3,1,1,1,1,3,4,3,1,1,5,8,11,5,13,6,9,7,5,8,14,8,12,13,12,13,15,12,12,12,13,16,8,11,9,12,14,16,15,13,12,8,12,14,12,20,15,11,13,12,15,11,15,13,16,14,13,13,15,15,5,12,12,16,12,12,1,16,DM/M C,311,1,1,1,10,1,12,1,1,12,20,16,1,12,1,12,0.0,0,0,0,0,0,0,0,0,0,0,0,0,0,0,0,0,0,0,0,0,0,0,0,0,0,0,0,0,0,0,0,0,0,0,0,0,0,0,0,0,0,0,0,0,0,0,0,0,Francis Coquelin,Â£2.70m ,29.0,177.0,Midfielder - Defensive Midfield,right,Villarreal CF,25.0,1.0,1.0,1296.0,18.0,0.0,1.0,1191.0,26.0,0.0,1.0,1293.0,24.0,1.0,0.0,1241.0,37.0,0.0,0.0,2770.0,36.0,0.0,0.0,2380.0,39.0,0.0,0.0,2338.0,26.0,1.0,1.0,1675.0,42.0,0.0,1.0,2810.0,Premier League,36.0,0.0,2.0,2579.0,6.0,0.0,0.0,371.0,29/6/2010,Francis Coquelin,34012022,769,5/13/1991,19,0,0,0,0,2025,3150,4250,149,90,-1,178,73,D/DM/M RC,1,2,2,2,2,1,3,1,1,2,1,5,5,8,5,10,4,9,5,5,10,11,3,13,12,12,11,15,9,10,8,9,16,8,13,10,10,14,15,12,10,12,8,12,14,10,20,15,12,14,5,10,10,15,13,16,14,10,13,15,14,5,Francis Coquelin,ÃÂ£1.17m ,Ligue 1
19/6/2011,Eric TiÃ©-Bi,34011692,24,7/20/1990,20,0,0,0,0,1250,2500,2500,135,100,60188,189,76,DM C,2,3,3,1,3,2,3,4,2,2,3,5,5,8,5,11,7,13,9,5,10,11,11,8,11,14,13,13,11,11,9,8,14,11,9,7,11,14,16,15,11,14,14,5,16,12,20,18,14,14,14,14,5,6,5,13,13,14,15,14,14,5,1,1,15,1,1,1,15,DM C,301,1,1,1,1,1,1,1,1,1,20,15,1,1,1,1,1073741824.0,0,0,0,0,0,0,0,0,0,0,0,0,0,0,0,0,0,0,0,0,0,0,0,0,0,0,0,0,0,0,1,0,0,0,0,0,0,0,0,0,0,0,0,0,0,0,0,0,Eric TiÃ© Bi,Â£900Th. ,30.0,181.0,Midfielder - Defensive Midfield,right,Unknown,25.0,0.0,0.0,1675.0,26.0,0.0,3.0,1398.0,24.0,0.0,2.0,1332.0,22.0,0.0,1.0,1732.0,19.0,0.0,0.0,1039.0,29.0,0.0,1.0,2096.0,14.0,0.0,0.0,1155.0,26.0,0.0,0.0,1358.0,nan,nan,nan,nan,Ligue 1,nan,nan,nan,nan,nan,nan,nan,nan
19/6/2011,Emmanuel Badu,12035987,21,12/2/1990,20,22,1,0,0,3500,6300,6050,149,129,789860,173,70,DM/M C,2,2,3,2,1,2,2,2,3,2,3,11,11,8,6,10,14,11,14,11,15,12,9,14,11,15,13,15,12,12,11,11,11,9,13,12,12,15,15,14,14,15,8,8,15,13,20,14,14,12,13,14,6,8,10,12,11,11,12,11,12,7,1,1,18,1,1,1,18,DM/M C,311,1,1,1,1,1,1,1,1,1,20,18,1,1,1,1,35184400000000.0,0,0,0,0,0,0,0,0,1,1,0,0,0,0,0,0,0,0,0,0,0,0,0,0,0,0,0,0,0,0,0,0,0,0,0,0,0,0,0,0,0,0,0,0,0,1,0,0,Emmanuel Badu,Â£1.62m ,29.0,173.0,Midfielder - Central Midfield,right,Hellas Verona,11.0,0.0,0.0,432.0,18.0,0.0,1.0,1265.0,32.0,0.0,2.0,1990.0,32.0,5.0,1.0,2054.0,27.0,1.0,1.0,1869.0,34.0,4.0,3.0,2745.0,30.0,0.0,3.0,2118.0,19.0,1.0,1.0,1512.0,4.0,0.0,0.0,161.0,Serie A,10.0,0.0,0.0,224.0,nan,nan,nan,nan,29/6/2010,Emmanuel Badu,12035987,21,12/2/1990,19,3,0,0,0,2800,5800,5300,143,115,4386257,173,70,DM/M C,2,2,3,3,2,1,2,2,3,2,1,11,11,8,6,9,14,11,14,11,14,12,9,12,11,15,13,14,12,11,11,10,11,9,13,13,11,14,14,14,13,15,8,5,15,13,20,14,14,12,13,14,6,8,10,10,11,9,12,11,12,7,Emmanuel Badu,ÃÂ£1.35m ,Serie A
19/6/2011,Eliaquim Mangala,18031822,769,2/13/1991,20,0,0,9,0,4000,6000,6000,132,123,2213439,187,84,D/DM/M C,3,1,3,2,2,2,1,5,3,2,2,7,7,9,10,10,8,15,8,12,15,7,10,13,10,14,14,15,8,14,8,7,14,10,7,8,10,15,17,14,14,18,17,8,15,14,20,10,17,11,12,7,12,10,13,14,14,11,9,10,8,5,20,14,18,1,14,14,20,D/DM/M C,121,1,1,1,1,1,1,20,14,14,19,18,12,14,14,14,0.0,0,0,0,0,0,0,0,0,0,0,0,0,0,0,0,0,0,0,0,0,0,0,0,0,0,0,0,0,0,0,0,0,0,0,0,0,0,0,0,0,0,0,0,0,0,0,0,0,Eliaquim Mangala,Â£4.50m ,29.0,187.0,Defender - Centre-Back,left,Valencia CF,41.0,2.0,2.0,3356.0,14.0,1.0,0.0,1160.0,40.0,7.0,2.0,3363.0,42.0,5.0,2.0,3725.0,31.0,0.0,2.0,2728.0,33.0,0.0,1.0,2848.0,33.0,2.0,0.0,2886.0,17.0,0.0,0.0,1178.0,5.0,0.0,0.0,251.0,Liga NOS,11.0,0.0,0.0,884.0,1.0,0.0,0.0,17.0
19/6/2011,Dias,55013002,788,2/25/1991,20,0,0,0,0,1250,4500,4500,110,90,182386,189,79,M C,2,2,2,3,3,3,2,4,2,2,1,10,11,11,9,11,10,14,12,10,11,10,10,10,11,12,12,12,10,10,10,9,13,8,15,10,13,13,11,10,11,14,15,10,12,11,20,11,13,12,12,10,9,11,9,15,13,15,13,11,10,8,5,1,20,8,1,1,20,M C,401,1,1,1,8,1,1,5,1,1,15,20,1,1,1,1,0.0,0,0,0,0,0,0,0,0,0,0,0,0,0,0,0,0,0,0,0,0,0,0,0,0,0,0,0,0,0,0,0,0,0,0,0,0,0,0,0,0,0,0,0,0,0,0,0,0,nan,nan,nan,nan,nan,nan,nan,nan,nan,nan,nan,nan,nan,nan,nan,nan,nan,nan,nan,nan,nan,nan,nan,nan,nan,nan,nan,nan,nan,nan,nan,nan,nan,nan,nan,nan,nan,nan,nan,nan,nan,nan,nan,nan,nan,nan,nan,nan,nan,nan,nan,nan
19/6/2011,Brice Dja DjÃ©djÃ©,34011670,24,12/23/1990,20,0,0,1,0,1301,4900,2647,125,98,95029,180,71,D/DM R,3,2,1,3,2,3,2,2,3,1,1,7,12,7,6,8,7,10,8,5,8,9,11,9,8,14,11,13,12,12,9,10,15,8,7,7,12,14,14,14,12,13,10,8,17,12,20,15,11,13,14,14,5,10,17,12,14,13,13,13,13,6,20,15,10,1,20,8,10,D/DM R,112,1,1,1,1,1,1,1,8,20,17,10,1,1,1,15,0.0,0,0,0,0,0,0,0,0,0,0,0,0,0,0,0,0,0,0,0,0,0,0,0,0,0,0,0,0,0,0,0,0,0,0,0,0,0,0,0,0,0,0,0,0,0,0,0,0,Brice Dja DjÃ©djÃ©,Â£2.70m ,29.0,176.0,Midfielder - Defensive Midfield,right,Without Club,20.0,1.0,2.0,1740.0,37.0,2.0,1.0,3247.0,31.0,2.0,2.0,2637.0,28.0,1.0,3.0,2202.0,35.0,0.0,5.0,2811.0,24.0,1.0,0.0,1764.0,2.0,0.0,0.0,99.0,14.0,0.0,0.0,1119.0,19.0,0.0,1.0,1511.0,Ligue 1,33.0,0.0,1.0,2771.0,nan,nan,nan,nan
19/6/2011,Andrea Bertolacci,43028376,776,1/11/1991,20,0,0,0,0,2500,5750,5750,166,125,247952,179,75,M C,3,2,2,3,2,2,3,1,1,1,2,9,11,13,12,12,9,8,12,9,12,15,8,13,13,12,13,13,13,12,14,11,15,12,13,15,12,14,15,13,13,10,9,20,13,13,5,14,11,13,11,12,8,13,11,14,14,13,14,13,14,5,1,1,20,15,1,1,20,M C,401,1,1,7,15,1,1,1,1,1,15,20,1,1,1,1,0.0,0,0,0,0,0,0,0,0,0,0,0,0,0,0,0,0,0,0,0,0,0,0,0,0,0,0,0,0,0,0,0,0,0,0,0,0,0,0,0,0,0,0,0,0,0,0,0,0,Andrea Bertolacci,Â£2.25m ,29.0,179.0,Midfielder - Central Midfield,left,Without Club,10.0,4.0,0.0,734.0,28.0,3.0,3.0,1273.0,29.0,4.0,5.0,2027.0,26.0,2.0,1.0,1996.0,35.0,6.0,8.0,2726.0,30.0,1.0,1.0,2025.0,18.0,1.0,1.0,1048.0,34.0,1.0,1.0,3018.0,4.0,0.0,0.0,139.0,Serie A,12.0,0.0,0.0,536.0,nan,nan,nan,nan,29/6/2010,Andrea Bertolacci,43028376,776,1/11/1991,19,0,0,0,0,350,5084,4650,142,113,426105,179,75,M C,1,2,1,3,3,3,1,4,1,1,1,9,11,13,10,12,9,8,12,9,10,13,8,13,13,12,11,13,13,12,14,11,14,12,13,14,11,14,13,13,11,10,9,20,13,12,5,12,13,12,11,12,8,13,11,13,12,13,14,13,14,5,Andrea Bertolacci,ÃÂ£1.35m ,Serie A
19/6/2011,Aleksandar Ignjovski,62013411,802,1/27/1991,20,0,0,1,0,3500,5939,6550,154,132,678486,175,68,DM/M C,3,1,1,3,1,3,2,3,3,1,3,8,10,11,7,13,6,8,7,8,17,13,10,17,12,18,12,17,8,8,11,13,18,6,10,10,9,15,19,15,17,11,8,15,14,12,20,16,8,11,12,11,4,19,14,15,13,14,17,14,13,5,14,14,19,12,14,14,19,DM/M C,311,1,1,1,12,1,1,1,14,14,20,19,13,13,14,14,137439000000.0,0,0,0,0,0,0,0,0,0,0,0,0,0,0,0,1,0,0,0,0,0,0,0,0,0,0,0,0,0,0,0,0,0,0,0,0,0,1,0,0,0,0,0,0,0,0,0,0,Aleksandar Ignjovski,Â£3.60m ,29.0,175.0,Midfielder - Defensive Midfield,right,Holstein Kiel,25.0,0.0,2.0,1953.0,26.0,0.0,1.0,1994.0,21.0,1.0,2.0,1667.0,14.0,0.0,0.0,811.0,22.0,0.0,1.0,1366.0,19.0,0.0,2.0,1239.0,21.0,0.0,0.0,1243.0,1.0,0.0,0.0,55.0,17.0,0.0,0.0,1059.0,Bundesliga,22.0,0.0,0.0,1261.0,5.0,0.0,0.0,224.0
19/6/2011,Abdoulaye Coulibaly,85074660,31,4/6/1991,20,0,0,0,0,1308,4850,2617,125,97,45289,186,73,DM/M C,3,2,2,2,3,1,1,2,3,1,2,5,6,8,7,11,6,12,9,6,9,11,6,11,11,12,13,13,12,12,9,13,15,5,6,9,9,14,14,12,12,14,13,20,14,10,8,13,13,12,12,13,8,8,8,13,13,11,14,14,14,6,1,1,16,1,1,12,16,DM/M C,311,1,1,1,1,1,1,1,1,1,20,16,12,1,1,1,64.0,0,0,0,0,0,0,1,0,0,0,0,0,0,0,0,0,0,0,0,0,0,0,0,0,0,0,0,0,0,0,0,0,0,0,0,0,0,0,0,0,0,0,0,0,0,0,0,0,Adama Coulibaly,Â£2.70m ,40.0,186.0,Defender - Centre-Back,right,Retired,50.0,1.0,1.0,4474.0,9.0,0.0,0.0,747.0,26.0,1.0,0.0,2257.0,43.0,3.0,1.0,3930.0,28.0,2.0,0.0,2403.0,nan,nan,nan,nan,nan,nan,nan,nan,nan,nan,nan,nan,nan,nan,nan,nan,Ligue 1,nan,nan,nan,nan,nan,nan,nan,nan
19/6/2011,Younousse SankharÃ©,34011678,769,9/10/1989,21,0,0,16,2,4250,5354,5350,150,119,1548788,184,76,DM/M C,1,2,2,1,2,1,2,6,1,3,3,10,10,13,7,13,12,13,10,6,8,14,9,9,15,12,13,12,11,11,13,11,12,13,10,11,10,11,12,15,13,15,13,20,15,13,5,16,15,13,12,14,5,12,13,15,15,7,11,11,13,11,8,8,20,14,1,12,20,DM/M C,421,1,1,1,14,12,1,5,8,1,17,20,12,1,8,1,34359739040.0,0,0,0,0,0,1,0,1,0,1,0,0,0,0,0,0,0,0,0,0,0,0,0,0,0,0,0,0,0,0,0,0,0,0,0,1,0,0,0,0,0,0,0,0,0,0,0,0,Younousse SankharÃ©,Â£1.80m ,31.0,184.0,Midfielder - Central Midfield,left,CSKA Sofia,27.0,6.0,0.0,2305.0,38.0,5.0,0.0,3140.0,20.0,0.0,2.0,1552.0,40.0,3.0,4.0,3372.0,41.0,0.0,5.0,3325.0,36.0,6.0,2.0,3251.0,41.0,7.0,4.0,3259.0,33.0,10.0,1.0,2234.0,33.0,4.0,5.0,2353.0,Ligue 1,nan,nan,nan,nan,12.0,2.0,2.0,780.0
19/6/2011,Tony Jantschke,29022529,771,4/7/1990,21,0,0,4,0,3800,6450,6450,143,129,1629569,177,72,D/WB/DM R,1,2,1,3,3,3,1,6,1,3,2,5,8,7,5,13,5,10,5,11,14,12,6,15,12,8,17,9,16,15,7,13,12,4,10,6,13,18,11,12,13,14,11,14,12,12,20,13,10,16,3,13,10,16,12,9,15,13,16,17,18,3,20,18,14,1,20,10,14,D/WB/DM R,122,1,1,1,1,1,1,8,10,20,17,14,1,1,1,18,4503890000000000.0,0,0,0,0,0,0,1,0,0,0,0,0,0,0,0,0,0,0,0,0,0,0,0,0,0,0,0,0,0,0,0,0,1,1,0,0,0,0,1,0,0,0,0,0,0,0,0,0,Tony Jantschke,Â£4.50m ,30.0,177.0,Defender - Centre-Back,right,Borussia MÃ¶nchengladbach,18.0,0.0,1.0,1365.0,36.0,1.0,1.0,3272.0,40.0,1.0,1.0,3472.0,31.0,1.0,1.0,2745.0,45.0,1.0,0.0,4023.0,15.0,0.0,0.0,1017.0,35.0,0.0,0.0,2533.0,14.0,0.0,1.0,804.0,15.0,0.0,2.0,1020.0,Bundesliga,19.0,0.0,0.0,1128.0,3.0,0.0,0.0,112.0
19/6/2011,Tongo Doumbia,85040297,769,8/6/1989,21,0,0,0,0,4400,5597,5571,150,124,452696,192,80,DM/M C,1,3,1,3,3,2,2,9,1,2,3,5,8,10,6,12,7,13,12,6,11,13,7,9,12,14,13,14,10,13,12,11,15,8,7,9,12,15,18,14,13,17,16,8,15,13,20,15,17,12,14,13,7,14,15,14,12,12,10,14,14,7,10,1,20,12,1,1,20,DM/M C,421,1,10,1,12,1,1,10,1,1,16,20,1,1,1,1,0.0,0,0,0,0,0,0,0,0,0,0,0,0,0,0,0,0,0,0,0,0,0,0,0,0,0,0,0,0,0,0,0,0,0,0,0,0,0,0,0,0,0,0,0,0,0,0,0,0,Tongo Doumbia,Â£1.80m ,31.0,191.0,Midfielder - Defensive Midfield,right,Ajman Club,20.0,0.0,0.0,1007.0,34.0,2.0,1.0,2376.0,35.0,2.0,3.0,2533.0,36.0,4.0,2.0,3004.0,26.0,3.0,2.0,2179.0,28.0,1.0,2.0,2170.0,12.0,0.0,0.0,668.0,32.0,1.0,1.0,2578.0,14.0,1.0,1.0,1042.0,Ligue 1,4.0,0.0,0.0,301.0,nan,nan,nan,nan
19/6/2011,Sidy Sagna,85017313,41,2/4/1990,21,0,0,0,0,1350,2750,2750,117,101,34356,180,75,DM ,3,1,1,2,1,2,2,2,2,3,3,5,9,8,6,8,7,11,10,6,10,11,6,13,11,14,14,14,11,11,11,9,9,9,7,7,11,16,14,12,13,13,10,5,14,11,20,16,13,13,14,10,7,10,13,13,9,6,15,9,18,16,1,1,10,1,1,1,10,DM ,300,1,1,1,1,1,1,1,1,1,20,10,1,1,1,1,0.0,0,0,0,0,0,0,0,0,0,0,0,0,0,0,0,0,0,0,0,0,0,0,0,0,0,0,0,0,0,0,0,0,0,0,0,0,0,0,0,0,0,0,0,0,0,0,0,0,nan,nan,nan,nan,nan,nan,nan,nan,nan,nan,nan,nan,nan,nan,nan,nan,nan,nan,nan,nan,nan,nan,nan,nan,nan,nan,nan,nan,nan,nan,nan,nan,nan,nan,nan,nan,nan,nan,nan,nan,nan,nan,nan,nan,nan,nan,nan,nan,nan,nan,nan,nan
19/6/2011,Siaka Bamba,55012778,24,8/24/1989,21,0,0,0,0,2000,3500,5250,132,105,95911,178,72,DM ,2,1,1,3,2,1,2,7,2,1,2,10,11,10,8,12,11,11,10,10,13,13,10,13,12,11,12,11,13,13,10,11,10,8,10,13,12,13,12,12,12,11,13,8,14,12,20,12,11,12,9,10,8,12,13,6,10,13,15,13,11,12,1,1,14,10,1,1,14,DM ,300,1,1,1,10,1,1,1,1,1,20,14,1,1,1,1,0.0,0,0,0,0,0,0,0,0,0,0,0,0,0,0,0,0,0,0,0,0,0,0,0,0,0,0,0,0,0,0,0,0,0,0,0,0,0,0,0,0,0,0,0,0,0,0,0,0,Siaka Bamba,Â£900Th. ,31.0,178.0,Midfielder - Defensive Midfield,right,CD FÃ¡tima,33.0,3.0,0.0,2936.0,20.0,2.0,1.0,1258.0,31.0,2.0,0.0,2273.0,28.0,2.0,0.0,1846.0,31.0,4.0,0.0,2383.0,19.0,1.0,0.0,456.0,35.0,1.0,0.0,2046.0,2.0,1.0,0.0,180.0,1.0,0.0,0.0,120.0,Liga NOS,1.0,0.0,0.0,90.0,nan,nan,nan,nan
19/6/2011,Sebastian Rudy,29022542,771,2/28/1990,21,0,0,12,2,6000,6750,6750,144,130,1247466,179,73,DM/M C,3,1,2,1,2,2,3,5,2,1,1,13,14,12,10,16,10,7,11,6,9,16,11,13,15,6,14,6,11,9,15,15,9,12,5,10,10,18,13,12,15,7,7,12,8,14,20,11,6,10,4,8,9,14,14,12,14,8,4,17,19,5,1,1,20,15,13,14,20,DM/M C,421,1,1,1,15,1,1,1,1,1,17,20,14,13,1,1,8813290000000.0,0,0,0,0,0,0,0,1,0,0,0,0,0,0,0,0,0,0,0,0,0,0,1,0,1,0,0,0,0,0,0,0,0,0,1,0,0,0,0,0,0,0,0,1,0,0,0,0,Sebastian Rudy,Â£4.95m ,30.0,180.0,Midfielder - Defensive Midfield,right,TSG 1899 Hoffenheim,38.0,2.0,7.0,2870.0,29.0,0.0,2.0,2457.0,26.0,0.0,2.0,1932.0,30.0,2.0,6.0,2511.0,33.0,4.0,7.0,2596.0,25.0,2.0,1.0,1874.0,34.0,3.0,10.0,2998.0,35.0,1.0,5.0,2133.0,28.0,0.0,0.0,1853.0,Bundesliga,35.0,1.0,4.0,2993.0,5.0,0.0,2.0,450.0,29/6/2010,Sebastian Rudy,29022542,771,2/28/1990,20,0,0,0,0,3250,6300,6300,146,122,8000000,179,73,DM/M C,2,3,2,1,2,3,3,3,3,2,2,13,14,12,10,16,10,7,12,6,7,16,11,9,15,6,12,6,14,9,17,10,10,12,5,10,9,18,12,12,15,6,7,12,8,14,20,9,6,10,4,10,9,14,14,13,10,12,20,14,14,5,Sebastian Rudy,ÃÂ£5.85m ,Bundesliga
19/6/2011,Rodney Strasser,43037061,43,3/30/1990,21,3,0,0,0,1500,5264,5400,141,117,96929,178,80,DM/M RC,2,3,2,3,1,2,2,3,2,3,1,4,6,7,8,9,5,12,9,15,14,11,8,14,11,17,12,14,13,12,12,12,16,4,6,9,15,14,14,13,13,15,10,7,15,14,20,13,15,13,16,7,8,12,17,14,15,12,14,15,16,4,1,1,20,1,15,12,20,DM/M RC,423,1,1,1,1,1,1,1,1,1,17,20,12,15,1,1,0.0,0,0,0,0,0,0,0,0,0,0,0,0,0,0,0,0,0,0,0,0,0,0,0,0,0,0,0,0,0,0,0,0,0,0,0,0,0,0,0,0,0,0,0,0,0,0,0,0,Rodney Strasser,Â£1.80m ,30.0,181.0,Midfielder - Defensive Midfield,right,Turun Palloseura,8.0,1.0,0.0,463.0,15.0,1.0,0.0,970.0,4.0,0.0,0.0,166.0,22.0,0.0,0.0,1684.0,2.0,0.0,0.0,61.0,28.0,1.0,1.0,2259.0,13.0,0.0,0.0,911.0,nan,nan,nan,nan,14.0,0.0,1.0,1106.0,Serie A,9.0,0.0,0.0,515.0,nan,nan,nan,nan
19/6/2011,Rene Krhin,64001295,795,5/21/1990,21,4,0,3,0,4000,5800,5650,149,120,265673,189,78,DM/M C,1,1,1,1,1,1,1,1,1,1,1,8,8,10,6,13,8,12,11,5,11,14,11,13,13,13,11,12,11,13,12,11,15,10,10,10,13,14,14,11,11,12,13,10,14,11,20,14,13,12,13,11,14,12,15,12,15,13,17,16,14,5,8,1,18,5,8,1,18,DM/M C,311,1,1,1,5,1,1,1,1,8,20,18,1,1,1,1,4294967488.0,0,0,0,0,0,0,1,1,0,0,0,0,0,0,0,0,0,0,0,0,0,0,0,0,0,0,0,0,0,0,0,0,1,0,0,0,0,0,0,0,0,0,0,0,0,0,0,0,Rene Krhin,Â£1.08m ,30.0,189.0,Midfielder - Central Midfield,right,Without Club,9.0,0.0,0.0,587.0,9.0,1.0,0.0,513.0,23.0,0.0,0.0,1476.0,28.0,0.0,0.0,2146.0,19.0,0.0,0.0,1328.0,25.0,0.0,0.0,1520.0,12.0,0.0,0.0,937.0,19.0,1.0,0.0,1328.0,21.0,1.0,0.0,1272.0,Serie A,10.0,0.0,0.0,341.0,nan,nan,nan,nan,29/6/2010,Rene Krhin,64001295,795,5/21/1990,20,4,0,0,0,3481,6100,6100,148,118,1948752,189,78,DM/M C,1,1,1,1,1,1,1,1,1,1,1,8,8,10,6,13,8,13,11,5,11,14,11,14,13,14,11,12,11,13,12,11,15,10,10,10,15,14,14,11,11,13,13,10,14,11,20,14,13,12,13,11,14,12,15,12,15,13,17,16,14,5,Rene Krhin,ÃÂ£1.80m ,Serie A
19/6/2011,Nicolas Nkoulou,12007662,11,3/27/1990,21,28,0,3,0,5450,6800,6100,165,136,1091533,180,77,D/DM C,3,1,3,1,2,3,3,7,2,3,2,5,7,11,6,13,6,13,9,8,16,12,7,13,13,12,14,15,14,13,11,11,15,9,13,7,15,15,14,15,13,16,11,5,15,14,20,15,16,13,14,16,7,12,9,15,14,13,17,9,15,7,20,12,10,1,12,1,20,D/DM C,111,5,1,7,1,1,1,20,1,12,16,10,1,1,1,12,274878000000.0,0,0,0,0,0,0,0,0,0,0,0,0,0,0,0,0,0,0,0,0,0,0,0,0,0,0,0,0,0,0,0,0,0,0,0,0,0,0,1,0,0,0,0,0,0,0,0,0,Nicolas N'Koulou,Â£7.20m ,30.0,184.0,Defender - Centre-Back,right,Torino FC,33.0,0.0,0.0,2737.0,46.0,0.0,0.0,4116.0,48.0,1.0,0.0,4297.0,46.0,2.0,0.0,4170.0,26.0,2.0,0.0,2322.0,41.0,0.0,0.0,3691.0,22.0,0.0,1.0,2040.0,39.0,2.0,0.0,3439.0,38.0,2.0,0.0,3370.0,Ligue 1,38.0,1.0,0.0,3275.0,4.0,0.0,0.0,286.0,29/6/2010,Nicolas Nkoulou,12007662,11,3/27/1990,20,20,0,4,0,4225,6500,5850,170,130,9285899,180,77,D/DM C,2,3,2,3,2,3,1,1,3,3,3,5,7,11,6,13,6,11,9,6,16,12,7,13,13,12,15,15,12,12,13,12,16,9,10,7,14,15,13,15,13,15,10,5,15,14,20,14,15,13,12,16,7,12,9,15,14,13,15,14,14,7,Nicolas N'Koulou,ÃÂ£4.50m ,Ligue 1
19/6/2011,Moussa Sissoko,8448722,769,8/16/1989,21,2,0,11,2,6600,6569,6550,165,146,5191698,187,83,DM/M C,3,3,1,3,1,1,1,4,2,2,1,6,9,13,11,14,11,13,15,5,12,14,8,11,14,11,15,14,14,14,14,12,17,11,10,12,12,12,16,16,13,16,14,8,15,13,20,17,16,13,11,15,7,8,11,15,14,11,13,14,14,6,1,1,20,14,14,12,20,DM/M C,421,1,1,5,10,12,14,1,1,1,16,20,12,14,1,1,292.0,0,0,1,0,0,1,0,0,1,0,0,0,0,0,0,0,0,0,0,0,0,0,0,0,0,0,0,0,0,0,0,0,0,0,0,0,0,0,0,0,0,0,0,0,0,0,0,0,Moussa Sissoko,Â£8.55m ,31.0,187.0,Midfielder - Central Midfield,right,Tottenham Hotspur,38.0,6.0,2.0,3167.0,37.0,2.0,3.0,3066.0,40.0,4.0,4.0,3461.0,38.0,3.0,6.0,3242.0,38.0,5.0,2.0,3275.0,39.0,1.0,8.0,3402.0,34.0,0.0,4.0,1307.0,47.0,2.0,5.0,2431.0,44.0,0.0,4.0,3403.0,Ligue 1,35.0,2.0,2.0,2873.0,7.0,0.0,0.0,430.0,29/6/2010,Moussa Sissoko,8448722,769,8/16/1989,20,2,0,11,2,5329,6569,6550,180,146,16779908,187,83,DM/M C,1,1,3,1,2,3,1,5,3,1,3,6,9,13,11,14,11,13,15,5,12,14,8,11,14,11,15,14,14,14,14,12,17,11,10,12,12,12,16,16,13,16,14,8,15,13,20,17,16,13,11,15,7,8,12,15,14,11,13,14,14,6,Moussa Sissoko,ÃÂ£9.90m ,Ligue 1
19/6/2011,Marco HÃ¶ger,92014217,771,9/16/1989,21,0,0,0,0,4500,6550,6550,146,131,535365,186,78,D/DM/M RC,3,3,3,2,3,1,1,1,2,2,1,9,16,8,9,14,11,12,15,5,9,14,16,10,14,11,13,12,15,11,13,15,16,9,12,10,10,15,12,10,11,12,13,17,9,11,20,13,12,12,8,11,12,12,5,15,12,12,15,9,14,8,18,14,20,12,18,1,20,D/DM/M RC,433,1,1,1,1,1,12,1,1,18,17,20,1,15,1,14,0.0,0,0,0,0,0,0,0,0,0,0,0,0,0,0,0,0,0,0,0,0,0,0,0,0,0,0,0,0,0,0,0,0,0,0,0,0,0,0,0,0,0,0,0,0,0,0,0,0,Marco HÃÂ¶ger,Â£3.60m ,31.0,182.0,Midfielder - Defensive Midfield,right,1. FC KÃÂ¶ln,37.0,10.0,9.0,3235.0,43.0,1.0,5.0,2983.0,30.0,3.0,2.0,1858.0,14.0,2.0,1.0,1039.0,34.0,1.0,3.0,2756.0,6.0,0.0,0.0,219.0,32.0,0.0,1.0,2124.0,26.0,0.0,0.0,1876.0,28.0,1.0,3.0,2155.0,Bundesliga,16.0,0.0,0.0,727.0,3.0,0.0,0.0,109.0
19/6/2011,Luca Marrone,43025940,776,3/28/1990,21,0,0,16,1,2000,5500,5500,154,119,224003,186,75,DM/M C,1,1,1,1,1,2,3,3,2,1,1,6,6,9,6,11,7,11,11,10,13,14,6,14,12,13,14,14,14,12,11,15,15,7,12,8,12,14,14,12,12,13,12,6,15,12,20,13,13,13,10,9,6,10,8,14,13,5,12,14,11,13,1,1,18,1,1,1,18,DM/M C,311,1,1,1,1,1,1,1,1,1,20,18,1,1,1,1,0.0,0,0,0,0,0,0,0,0,0,0,0,0,0,0,0,0,0,0,0,0,0,0,0,0,0,0,0,0,0,0,0,0,0,0,0,0,0,0,0,0,0,0,0,0,0,0,0,0,Luca Marrone,Â£2.25m ,30.0,186.0,Defender - Centre-Back,right,FC Crotone,19.0,1.0,3.0,1237.0,6.0,1.0,1.0,304.0,15.0,0.0,0.0,1172.0,15.0,0.0,3.0,1140.0,0.0,0.0,0.0,0.0,25.0,1.0,5.0,1992.0,28.0,1.0,0.0,1779.0,34.0,1.0,1.0,2930.0,25.0,0.0,0.0,2058.0,Serie A,31.0,3.0,0.0,2576.0,4.0,0.0,0.0,360.0
19/6/2011,Joe Allen,29007955,801,3/14/1990,21,2,0,13,1,4122,6234,5932,145,115,660965,168,81,DM/M C,3,3,1,2,2,3,2,1,2,2,3,2,9,12,10,13,2,4,11,4,6,14,6,11,12,9,10,13,10,12,12,10,15,11,2,11,12,13,10,14,14,13,5,15,11,13,20,6,10,13,6,15,7,11,6,9,14,16,14,14,15,2,1,1,20,14,10,1,20,DM/M C,311,1,1,1,14,1,10,1,1,1,20,20,1,10,1,1,17592200000000.0,0,0,0,0,0,0,1,0,0,1,0,0,0,0,0,0,0,0,0,0,0,0,0,0,0,0,0,0,0,0,0,0,0,0,0,0,0,0,0,0,0,0,0,0,1,0,0,0,Joe Allen,Â£3.60m ,30.0,168.0,Midfielder - Central Midfield,right,Stoke City,48.0,2.0,6.0,3500.0,39.0,4.0,4.0,3018.0,37.0,2.0,0.0,2640.0,26.0,1.0,1.0,1593.0,32.0,1.0,1.0,2409.0,37.0,3.0,3.0,1778.0,39.0,6.0,4.0,3155.0,38.0,4.0,7.0,3277.0,46.0,6.0,3.0,4132.0,Premier League,35.0,4.0,2.0,2940.0,nan,nan,nan,nan
19/6/2011,Ignacio Camacho,67015002,796,5/4/1990,21,0,0,3,0,4250,6500,6500,155,130,1585653,177,72,DM/M C,3,1,1,2,3,2,3,2,2,3,2,6,11,10,10,13,9,14,8,5,14,13,6,15,12,14,14,15,11,12,13,14,10,13,14,8,13,16,17,10,11,13,9,10,15,13,20,14,14,13,15,14,8,12,12,17,13,16,16,19,15,7,10,1,16,1,1,1,16,DM/M C,311,1,1,1,1,1,1,10,1,1,20,16,1,1,1,1,32832.0,0,0,0,0,0,0,1,0,0,0,0,0,0,0,0,1,0,0,0,0,0,0,0,0,0,0,0,0,0,0,0,0,0,0,0,0,0,0,0,0,0,0,0,0,0,0,0,0,Ignacio Camacho,Â£900Th. ,30.0,182.0,Midfielder - Defensive Midfield,right,Retired,21.0,0.0,1.0,1402.0,14.0,1.0,0.0,863.0,48.0,3.0,1.0,3726.0,34.0,5.0,2.0,2461.0,28.0,4.0,2.0,2479.0,24.0,2.0,1.0,2065.0,35.0,4.0,2.0,3146.0,15.0,1.0,0.0,1082.0,6.0,0.0,0.0,540.0,LaLiga,nan,nan,nan,nan,nan,nan,nan,nan
19/6/2011,Idrissa Gueye,85032335,41,6/20/1989,21,0,0,0,0,4350,5450,5450,145,121,149882,174,64,DM ,2,3,1,3,3,3,2,3,1,1,3,8,8,9,7,12,6,9,13,5,10,12,8,13,12,12,14,13,13,13,11,12,16,8,11,7,12,15,17,15,15,12,7,20,15,13,5,16,9,15,12,15,9,8,14,16,14,13,17,14,14,6,8,8,14,1,8,1,14,DM ,300,1,1,1,1,1,1,1,1,8,20,14,1,1,1,8,512.0,0,0,0,0,0,0,0,0,0,1,0,0,0,0,0,0,0,0,0,0,0,0,0,0,0,0,0,0,0,0,0,0,0,0,0,0,0,0,0,0,0,0,0,0,0,0,0,0,Idrissa Gueye,Â£2.25m ,31.0,174.0,Midfielder - Defensive Midfield,right,Paris Saint-Germain,18.0,1.0,0.0,917.0,34.0,0.0,0.0,1874.0,38.0,0.0,1.0,2544.0,41.0,1.0,1.0,3662.0,44.0,4.0,3.0,3824.0,38.0,1.0,1.0,3299.0,35.0,1.0,2.0,2866.0,38.0,3.0,1.0,3133.0,35.0,0.0,2.0,3005.0,Ligue 1,34.0,1.0,2.0,2645.0,7.0,1.0,0.0,448.0,29/6/2010,Idrissa Gueye,85032335,41,6/20/1989,21,0,0,0,0,1300,5350,2650,140,107,805396,174,64,DM C,1,2,2,2,1,1,1,4,1,3,2,8,8,9,7,12,6,8,8,5,7,11,8,12,12,12,14,13,12,12,11,11,16,8,12,8,11,14,17,14,14,12,7,20,15,13,5,16,7,15,12,13,6,8,14,16,14,13,15,14,14,6,Idrissa Gueye,ÃÂ£585Th. ,Ligue 1
19/6/2011,Grzegorz Krychowiak,34012402,787,1/29/1990,21,1,0,3,0,3400,5800,3800,140,116,140567,186,83,DM C,3,2,3,1,1,1,2,3,3,1,3,5,9,9,7,12,11,15,13,6,12,13,7,11,12,14,13,17,10,13,11,11,15,8,11,9,13,14,15,10,11,16,13,5,15,12,20,15,16,15,14,14,5,10,11,14,14,14,16,13,13,5,15,1,13,10,1,1,15,DM C,301,1,1,1,10,1,1,15,1,1,20,13,1,1,1,1,0.0,0,0,0,0,0,0,0,0,0,0,0,0,0,0,0,0,0,0,0,0,0,0,0,0,0,0,0,0,0,0,0,0,0,0,0,0,0,0,0,0,0,0,0,0,0,0,0,0,Grzegorz Krychowiak,Â£900Th. ,30.0,187.0,Midfielder - Defensive Midfield,right,Lokomotiv Moscow,40.0,2.0,1.0,3496.0,23.0,0.0,0.0,1958.0,36.0,4.0,1.0,3134.0,36.0,4.0,1.0,2914.0,48.0,4.0,1.0,4101.0,42.0,1.0,5.0,3655.0,19.0,0.0,0.0,1025.0,31.0,0.0,3.0,1989.0,39.0,2.0,4.0,3497.0,Ligue 1,33.0,10.0,5.0,2896.0,12.0,2.0,0.0,1012.0
19/6/2011,FÃ©lix Van Hulst,85054535,769,4/30/1990,21,0,0,0,0,1251,4184,2502,125,93,11501,178,71,DM C,3,2,2,3,2,2,2,4,2,3,1,8,10,9,7,12,13,7,13,6,6,11,7,8,12,10,11,11,13,13,13,12,13,11,7,7,8,12,12,12,12,12,9,5,15,11,20,15,11,14,10,10,5,8,7,13,13,13,13,15,15,6,1,1,15,1,1,1,15,DM C,301,1,1,1,1,1,1,1,1,1,20,15,1,1,1,1,4194304.0,0,0,0,0,0,0,0,0,0,0,0,0,0,0,0,0,0,0,0,0,0,0,1,0,0,0,0,0,0,0,0,0,0,0,0,0,0,0,0,0,0,0,0,0,0,0,0,0,nan,nan,nan,nan,nan,nan,nan,nan,nan,nan,nan,nan,nan,nan,nan,nan,nan,nan,nan,nan,nan,nan,nan,nan,nan,nan,nan,nan,nan,nan,nan,nan,nan,nan,nan,nan,nan,nan,nan,nan,nan,nan,nan,nan,nan,nan,nan,nan,nan,nan,nan,nan
19/6/2011,Dialo Guidileye,85013635,769,12/30/1989,21,0,0,0,0,2610,5264,4050,145,117,226036,181,76,DM ,1,2,2,2,3,2,3,1,3,2,3,5,7,10,6,11,7,12,11,6,11,11,6,12,11,12,16,14,10,13,12,11,14,9,9,7,14,14,16,14,12,14,10,5,15,12,20,16,14,13,12,13,7,8,14,15,13,11,13,13,13,7,8,8,12,1,1,8,12,DM ,300,1,1,1,1,1,1,1,8,1,20,12,1,1,8,1,512.0,0,0,0,0,0,0,0,0,0,1,0,0,0,0,0,0,0,0,0,0,0,0,0,0,0,0,0,0,0,0,0,0,0,0,0,0,0,0,0,0,0,0,0,0,0,0,0,0,Diallo Guidileye,Â£810Th. ,30.0,181.0,Midfielder - Defensive Midfield,right,Without Club,33.0,1.0,1.0,2729.0,6.0,0.0,0.0,421.0,10.0,1.0,2.0,781.0,27.0,0.0,0.0,2147.0,29.0,1.0,0.0,2120.0,31.0,0.0,2.0,2289.0,30.0,0.0,2.0,2050.0,20.0,1.0,2.0,1166.0,19.0,0.0,0.0,1451.0,Ligue 1,4.0,0.0,1.0,334.0,nan,nan,nan,nan
19/6/2011,David Timor,67067064,796,10/17/1989,21,0,0,0,0,2526,4776,4776,125,95,170140,185,77,DM/M C,1,3,3,3,3,1,1,1,3,2,2,7,5,6,5,11,8,13,6,5,13,13,8,13,9,13,11,9,11,13,9,11,10,6,8,8,13,13,14,11,10,11,14,5,12,10,20,13,14,12,9,12,6,7,7,10,12,6,9,14,9,7,1,1,18,1,1,1,18,DM/M C,311,1,1,1,1,1,1,1,1,1,20,18,1,1,1,1,0.0,0,0,0,0,0,0,0,0,0,0,0,0,0,0,0,0,0,0,0,0,0,0,0,0,0,0,0,0,0,0,0,0,0,0,0,0,0,0,0,0,0,0,0,0,0,0,0,0,David Timor,Â£720Th. ,31.0,185.0,Midfielder - Defensive Midfield,left,Getafe CF,31.0,7.0,0.0,2526.0,27.0,0.0,2.0,1053.0,19.0,1.0,3.0,1203.0,39.0,8.0,3.0,3410.0,38.0,6.0,2.0,2919.0,35.0,2.0,2.0,2754.0,25.0,2.0,1.0,1965.0,19.0,2.0,0.0,1101.0,37.0,1.0,4.0,3166.0,LaLiga,33.0,3.0,1.0,1590.0,6.0,0.0,0.0,85.0
19/6/2011,Dan Gosling,29007273,765,2/1/1990,21,0,0,2,0,3500,6250,6250,150,122,2565562,178,70,D/DM/M RC,1,3,1,2,2,3,1,5,1,3,3,7,9,13,11,12,8,10,8,8,10,13,9,10,12,9,11,12,14,14,13,12,14,7,14,14,13,13,14,12,12,10,9,12,15,11,20,14,12,15,4,14,11,14,12,12,8,15,15,13,14,2,16,10,20,13,18,1,20,D/DM/M RC,333,1,1,1,10,1,13,1,1,16,20,20,1,18,1,10,17592200000000.0,0,1,0,0,0,0,1,0,0,0,0,0,0,0,0,0,0,0,0,0,0,0,0,0,0,0,0,0,0,0,0,0,0,0,0,0,0,0,0,0,0,0,0,0,1,0,0,0,Dan Gosling,Â£1.35m ,30.0,180.0,Midfielder - Central Midfield,right,AFC Bournemouth,2.0,0.0,1.0,90.0,22.0,5.0,5.0,941.0,14.0,2.0,1.0,831.0,26.0,3.0,1.0,1799.0,24.0,5.0,2.0,814.0,37.0,4.0,2.0,2595.0,30.0,3.0,1.0,1600.0,32.0,3.0,1.0,2331.0,26.0,2.0,1.0,1827.0,Premier League,25.0,3.0,1.0,1350.0,8.0,2.0,0.0,509.0,29/6/2010,Dan Gosling,29007273,765,2/1/1990,20,0,0,2,0,3500,5750,5750,150,122,5648247,178,70,D/DM/M RC,2,1,1,3,1,2,3,3,1,2,1,7,9,13,11,12,8,10,8,2,10,13,9,10,12,9,11,12,14,14,13,12,14,7,14,14,13,13,14,12,12,10,9,12,15,11,20,14,10,15,4,14,7,14,12,12,8,15,15,13,14,2,Dan Gosling,ÃÂ£2.25m ,Premier League
19/6/2011,Christoph Moritz,91018390,771,1/27/1990,21,0,0,4,0,4650,6350,6350,142,127,478893,186,73,DM/M C,3,2,3,2,1,3,2,1,3,2,1,8,12,9,6,13,6,8,9,11,9,13,8,10,14,9,16,10,15,17,11,15,12,5,12,8,13,19,17,12,13,9,13,10,11,12,20,18,10,17,6,10,14,16,6,11,10,10,13,9,14,13,10,8,18,12,10,1,18,DM/M C,311,1,1,1,12,1,1,1,1,10,20,18,1,10,1,8,0.0,0,0,0,0,0,0,0,0,0,0,0,0,0,0,0,0,0,0,0,0,0,0,0,0,0,0,0,0,0,0,0,0,0,0,0,0,0,0,0,0,0,0,0,0,0,0,0,0,Christoph Moritz,Â£2.25m ,30.0,186.0,Midfielder - Central Midfield,right,SSV Jahn Regensburg,18.0,0.0,2.0,1046.0,17.0,0.0,0.0,947.0,11.0,0.0,0.0,606.0,27.0,2.0,2.0,1840.0,13.0,1.0,0.0,840.0,10.0,0.0,0.0,389.0,29.0,1.0,2.0,2439.0,32.0,5.0,1.0,2445.0,24.0,1.0,0.0,931.0,Bundesliga,10.0,0.0,2.0,458.0,5.0,0.0,0.0,279.0,29/6/2010,Christoph Moritz,91018390,771,1/27/1990,20,0,0,0,0,2250,6750,6750,142,129,16844798,186,73,DM/M C,1,2,2,3,3,3,1,1,1,2,3,8,12,9,7,13,6,8,9,11,9,13,8,10,14,9,16,10,15,17,12,15,12,5,12,8,13,19,17,12,13,9,13,10,18,12,20,18,10,17,6,8,5,16,4,13,16,5,14,14,9,9,Christoph Moritz,ÃÂ£2.70m ,Bundesliga
19/6/2011,Asier Illarramendi,67039257,796,3/8/1990,21,0,0,0,0,3668,6029,6029,149,126,324913,177,74,M C,2,1,3,2,1,1,3,1,1,1,1,13,10,11,10,13,14,7,10,3,11,14,7,11,13,7,11,12,13,13,13,13,12,12,13,12,13,18,15,12,12,12,9,12,11,13,20,14,10,12,7,10,5,10,11,13,15,12,15,14,13,18,1,1,20,14,1,1,20,M C,401,1,1,1,14,1,1,1,1,1,15,20,1,1,1,1,0.0,0,0,0,0,0,0,0,0,0,0,0,0,0,0,0,0,0,0,0,0,0,0,0,0,0,0,0,0,0,0,0,0,0,0,0,0,0,0,0,0,0,0,0,0,0,0,0,0,Asier Illarramendi,Â£1.08m ,30.0,179.0,Midfielder - Defensive Midfield,right,Real Sociedad,31.0,3.0,0.0,2348.0,18.0,0.0,1.0,1405.0,34.0,0.0,1.0,2836.0,49.0,3.0,1.0,2506.0,41.0,0.0,0.0,1721.0,35.0,1.0,2.0,2990.0,39.0,1.0,4.0,3454.0,44.0,7.0,6.0,3738.0,26.0,1.0,1.0,2017.0,LaLiga,3.0,0.0,0.0,217.0,nan,nan,nan,nan
19/6/2011,Armin Bacinovic,64001279,795,10/24/1989,21,6,0,11,4,4500,6261,6900,165,138,6491726,183,75,DM/M C,3,1,1,2,3,2,2,2,2,2,2,9,10,11,10,11,9,14,16,7,13,14,8,13,12,10,13,12,14,12,16,14,15,12,10,13,14,14,12,12,11,14,12,10,13,11,20,14,14,12,13,13,11,12,14,12,12,15,10,10,11,13,12,1,20,1,12,1,20,DM/M C,421,1,13,1,1,1,1,11,1,12,18,20,1,1,1,1,512.0,0,0,0,0,0,0,0,0,0,1,0,0,0,0,0,0,0,0,0,0,0,0,0,0,0,0,0,0,0,0,0,0,0,0,0,0,0,0,0,0,0,0,0,0,0,0,0,0,Armin Bacinovic,Â£3.15m ,31.0,183.0,Midfielder - Defensive Midfield,right,Without Club,44.0,2.0,2.0,3346.0,14.0,0.0,0.0,681.0,20.0,1.0,2.0,1519.0,9.0,0.0,0.0,640.0,30.0,1.0,1.0,2068.0,31.0,1.0,1.0,2351.0,28.0,2.0,1.0,1963.0,27.0,0.0,2.0,1471.0,nan,nan,nan,nan,Serie A,nan,nan,nan,nan,nan,nan,nan,nan,29/6/2010,Armin Bacinovic,64001279,795,10/24/1989,20,1,0,11,4,3250,6000,5500,148,117,5135258,183,75,DM/M C,3,2,3,3,1,1,2,1,1,3,1,10,11,12,11,11,8,15,13,8,14,13,9,12,13,10,14,12,15,13,11,11,15,12,9,14,10,13,13,13,12,13,12,20,13,12,7,13,12,12,13,13,11,12,14,12,12,15,10,10,11,13,Armin Bacinovic,ÃÂ£4.50m ,Serie A
19/6/2011,Andreu FontÃ s,67038644,796,11/14/1989,21,0,0,0,0,4000,6250,6250,145,128,475612,186,89,D/DM C,3,1,3,1,2,3,1,1,1,1,3,5,6,8,5,14,7,13,7,7,14,13,10,13,13,8,13,10,13,14,13,13,10,8,11,7,15,15,14,12,10,15,13,20,11,12,7,14,14,15,9,10,6,9,9,11,6,1,7,7,7,14,20,1,9,1,1,13,20,D/DM C,111,1,1,1,1,1,1,20,13,1,17,9,1,1,1,1,0.0,0,0,0,0,0,0,0,0,0,0,0,0,0,0,0,0,0,0,0,0,0,0,0,0,0,0,0,0,0,0,0,0,0,0,0,0,0,0,0,0,0,0,0,0,0,0,0,0,Andreu FontÃ s,Â£3.15m ,30.0,186.0,Defender - Centre-Back,left,Sporting Kansas City,33.0,2.0,1.0,2844.0,6.0,0.0,0.0,369.0,13.0,0.0,0.0,730.0,35.0,0.0,0.0,3092.0,36.0,0.0,0.0,3164.0,7.0,1.0,0.0,540.0,27.0,2.0,1.0,2220.0,18.0,0.0,1.0,1335.0,18.0,0.0,0.0,1381.0,LaLiga,2.0,1.0,0.0,180.0,nan,nan,nan,nan,29/6/2010,Andreu FontÃ s,67038644,796,11/14/1989,20,0,0,0,0,3906,6250,6250,160,125,5637399,186,84,D/DM C,3,3,1,3,3,3,2,1,1,1,1,5,6,7,5,13,7,13,7,7,13,13,10,12,11,8,13,11,12,14,12,13,10,8,12,7,15,15,14,12,9,15,13,20,11,13,7,14,14,15,9,10,6,9,14,11,8,14,13,8,10,9,Andreu FontÃÂ s,ÃÂ£2.25m ,LaLiga
19/6/2011,Abdou Sissoko,85022790,769,3/20/1990,21,0,0,3,0,2500,3750,3750,145,114,405426,180,68,DM/M LC,3,3,2,3,2,1,2,4,1,1,1,6,9,11,6,11,8,12,11,7,7,12,7,10,13,12,14,12,12,12,12,12,14,11,9,8,10,13,16,15,13,14,11,8,15,12,20,15,11,13,12,14,7,10,12,16,13,12,8,11,11,13,1,1,20,1,1,16,20,DM/M LC,424,1,1,1,1,1,1,1,1,1,18,20,16,1,1,1,0.0,0,0,0,0,0,0,0,0,0,0,0,0,0,0,0,0,0,0,0,0,0,0,0,0,0,0,0,0,0,0,0,0,0,0,0,0,0,0,0,0,0,0,0,0,0,0,0,0,Abdoul Sissoko,Â£900Th. ,30.0,183.0,Midfielder - Defensive Midfield,left,Al-Kuwait Sports Club,27.0,0.0,1.0,1899.0,12.0,1.0,0.0,645.0,39.0,0.0,0.0,3252.0,34.0,3.0,2.0,2836.0,13.0,0.0,0.0,856.0,35.0,3.0,6.0,2681.0,24.0,1.0,0.0,1722.0,38.0,2.0,0.0,3127.0,45.0,0.0,0.0,3855.0,Serie A,4.0,0.0,0.0,366.0,nan,nan,nan,nan
19/6/2011,Thierry DoubaÃ¯,69003609,24,7/1/1988,22,1,0,0,0,4520,5619,6027,147,124,838222,179,74,DM/M C,2,1,3,2,1,3,1,1,3,3,1,8,9,11,6,13,10,7,9,9,12,16,10,13,13,11,13,12,12,11,10,13,7,12,10,10,13,14,12,14,9,11,10,11,14,14,20,16,14,10,8,10,12,10,9,14,1,15,15,16,12,13,1,1,18,1,1,1,18,DM/M C,311,1,1,1,1,1,1,1,1,1,20,18,1,1,1,1,0.0,0,0,0,0,0,0,0,0,0,0,0,0,0,0,0,0,0,0,0,0,0,0,0,0,0,0,0,0,0,0,0,0,0,0,0,0,0,0,0,0,0,0,0,0,0,0,0,0,Thierry Doubai,Â£1.35m ,32.0,179.0,Midfielder - Defensive Midfield,right,AFAD DjÃ©kanou,50.0,1.0,6.0,4174.0,17.0,1.0,0.0,1051.0,14.0,2.0,1.0,1035.0,17.0,0.0,0.0,775.0,30.0,1.0,0.0,2146.0,21.0,1.0,0.0,1631.0,nan,nan,nan,nan,nan,nan,nan,nan,nan,nan,nan,nan,Serie A,nan,nan,nan,nan,nan,nan,nan,nan
19/6/2011,Tengarrinha,55009697,788,2/17/1989,22,0,0,4,0,1500,4500,4500,109,100,96882,184,77,D/DM C,2,1,2,3,3,3,2,3,3,2,3,15,15,13,12,14,13,11,12,9,9,15,12,9,14,6,14,10,15,13,15,12,11,13,10,13,10,11,11,11,11,11,10,8,14,11,20,11,11,10,7,10,9,10,14,12,12,12,14,14,14,6,20,1,10,1,10,5,20,D/DM C,111,1,1,1,1,1,1,20,1,1,20,10,5,10,1,1,0.0,0,0,0,0,0,0,0,0,0,0,0,0,0,0,0,0,0,0,0,0,0,0,0,0,0,0,0,0,0,0,0,0,0,0,0,0,0,0,0,0,0,0,0,0,0,0,0,0,Tengarrinha,Â£720Th. ,31.0,187.0,Midfielder - Defensive Midfield,right,Retired,17.0,0.0,0.0,813.0,18.0,0.0,0.0,1056.0,19.0,0.0,1.0,1294.0,22.0,0.0,0.0,1675.0,30.0,1.0,3.0,2353.0,18.0,1.0,0.0,1299.0,12.0,0.0,0.0,562.0,nan,nan,nan,nan,nan,nan,nan,nan,Liga NOS,nan,nan,nan,nan,nan,nan,nan,nan
19/6/2011,Sven Bender,35007386,771,4/27/1989,22,1,0,0,0,5778,7418,7400,157,145,3043723,185,72,DM/M C,1,2,3,2,1,3,2,7,3,2,1,8,9,8,6,13,9,13,9,13,18,13,9,18,12,14,18,18,14,17,7,15,15,7,13,8,16,19,16,12,13,15,12,11,11,12,20,18,12,17,8,11,13,8,12,13,15,12,18,13,16,4,1,1,18,1,1,1,18,DM/M C,311,1,1,1,1,1,1,1,1,1,20,18,1,1,1,1,137489000000.0,0,0,0,0,0,0,1,0,0,0,0,0,0,0,0,0,0,0,0,0,0,0,0,0,1,1,0,0,0,0,0,0,0,0,0,0,0,1,0,0,0,0,0,0,0,0,0,0,Sven Bender,Â£12.60m ,31.0,186.0,Defender - Centre-Back,right,Bayer 04 Leverkusen,39.0,1.0,1.0,2923.0,32.0,1.0,5.0,2105.0,33.0,1.0,0.0,2190.0,27.0,1.0,1.0,1938.0,32.0,0.0,0.0,1900.0,35.0,0.0,2.0,2259.0,8.0,0.0,1.0,404.0,34.0,2.0,0.0,2812.0,32.0,0.0,1.0,2435.0,Bundesliga,47.0,4.0,2.0,3881.0,6.0,0.0,1.0,499.0,29/6/2010,Sven Bender,35007386,771,4/27/1989,21,0,0,0,0,3250,6600,6600,158,129,4398472,185,72,DM/M C,2,3,1,2,2,1,1,1,3,2,1,8,8,9,7,12,9,12,10,13,15,12,10,16,12,10,17,15,13,15,8,14,14,7,13,9,16,17,13,12,13,13,12,10,11,12,20,15,11,14,8,11,13,10,14,13,14,12,15,13,14,8,Sven Bender,ÃÂ£8.10m ,Bundesliga
19/6/2011,Steven N'Zonzi,34011354,769,12/15/1988,22,0,0,6,0,5500,5950,6750,155,132,1449678,190,75,DM/M C,1,2,1,3,1,2,1,3,1,1,2,4,7,8,6,15,10,10,8,6,14,14,8,12,15,14,15,15,18,12,13,11,12,14,11,10,16,10,10,15,10,14,17,10,18,13,20,16,16,13,10,15,4,10,16,16,8,18,8,12,8,12,1,1,17,8,1,1,17,DM/M C,311,1,1,1,8,1,1,1,1,1,20,17,1,1,1,1,274878000000.0,0,0,0,0,0,0,1,0,0,0,0,0,0,0,0,0,0,0,0,1,0,0,0,0,0,0,0,0,0,0,0,0,0,0,0,0,0,0,1,0,0,0,0,0,0,0,0,0,Steven Nzonzi,Â£4.05m ,31.0,196.0,Midfielder - Defensive Midfield,right,Stade Rennais FC,26.0,1.0,0.0,1658.0,34.0,2.0,5.0,2972.0,38.0,1.0,1.0,3409.0,40.0,2.0,2.0,3356.0,42.0,4.0,1.0,3690.0,46.0,4.0,2.0,3228.0,46.0,3.0,3.0,4086.0,44.0,1.0,2.0,3693.0,39.0,1.0,2.0,3275.0,Premier League,22.0,0.0,1.0,1849.0,8.0,1.0,0.0,720.0,29/6/2010,Steven N'Zonzi,34011354,769,12/15/1988,21,0,0,6,0,4250,6074,6550,160,135,999999,194,75,DM/M C,1,1,3,2,1,2,3,7,1,1,1,5,7,10,8,13,11,16,12,6,13,12,8,13,13,16,14,15,12,11,11,9,15,11,11,10,15,17,16,14,10,17,18,10,18,14,20,16,17,18,15,15,4,10,20,14,12,18,15,13,18,6,Steven Nzonzi,ÃÂ£3.60m ,Premier League
19/6/2011,Stefan Reinartz,35008899,771,1/1/1989,22,1,0,6,0,4850,6900,6900,158,135,1390062,189,83,D/DM C,1,2,3,3,3,2,3,4,1,2,2,4,8,10,8,11,6,15,6,10,14,13,8,15,11,11,14,13,13,13,12,12,13,5,9,8,14,16,12,13,9,16,16,10,15,14,20,14,15,13,3,11,14,10,7,14,13,13,14,15,18,5,20,1,1,1,1,1,20,D/DM C,111,1,1,1,1,1,1,20,1,1,16,1,1,1,1,1,0.0,0,0,0,0,0,0,0,0,0,0,0,0,0,0,0,0,0,0,0,0,0,0,0,0,0,0,0,0,0,0,0,0,0,0,0,0,0,0,0,0,0,0,0,0,0,0,0,0,Stefan Reisinger,Â£900Th. ,39.0,185.0,Forward - Centre-Forward,right,Retired,23.0,4.0,5.0,751.0,26.0,4.0,0.0,879.0,26.0,8.0,0.0,1575.0,24.0,4.0,2.0,1458.0,9.0,6.0,0.0,734.0,nan,nan,nan,nan,nan,nan,nan,nan,nan,nan,nan,nan,nan,nan,nan,nan,Bundesliga,nan,nan,nan,nan,nan,nan,nan,nan,29/6/2010,Stefan Reinartz,35008899,771,1/1/1989,21,1,0,5,0,4000,6750,6750,158,135,8485056,189,84,D/DM C,3,3,1,1,2,3,3,2,1,1,2,4,8,10,8,11,6,15,6,10,14,13,8,14,11,11,14,13,13,13,12,12,13,5,9,8,14,16,12,13,12,16,16,10,15,14,20,14,15,13,3,11,9,10,6,14,13,13,14,15,18,5,Stefan Reinartz,ÃÂ£6.75m ,Bundesliga
19/6/2011,Souza,19060675,1651,2/11/1989,22,0,0,5,0,3250,6400,6650,150,133,1169499,186,77,M C,3,2,1,2,3,2,2,3,2,2,1,12,12,14,11,14,10,8,13,6,11,13,12,11,14,11,13,11,13,13,11,13,13,14,11,13,12,10,12,11,13,14,13,13,13,11,20,13,13,12,8,12,7,12,12,13,10,12,12,5,12,11,1,1,20,10,1,1,20,M C,401,1,1,1,10,1,1,1,1,1,15,20,1,1,1,1,0.0,0,0,0,0,0,0,0,0,0,0,0,0,0,0,0,0,0,0,0,0,0,0,0,0,0,0,0,0,0,0,0,0,0,0,0,0,0,0,0,0,0,0,0,0,0,0,0,0,nan,nan,nan,nan,nan,nan,nan,nan,nan,nan,nan,nan,nan,nan,nan,nan,nan,nan,nan,nan,nan,nan,nan,nan,nan,nan,nan,nan,nan,nan,nan,nan,nan,nan,nan,nan,nan,nan,nan,nan,nan,nan,nan,nan,nan,nan,nan,nan,nan,nan,nan,nan,29/6/2010,Souza,19060675,1651,2/11/1989,21,0,0,5,0,3250,6400,6400,156,129,20413701,186,77,M C,2,1,2,3,3,3,2,3,1,2,1,12,12,14,11,14,10,8,13,6,11,13,12,11,14,11,13,11,13,13,11,13,13,14,11,13,12,10,12,11,13,14,13,13,13,11,20,13,13,12,8,12,7,12,12,13,10,12,12,5,12,11,nan,nan,nan
19/6/2011,Sergio Busquets,1510566,796,7/16/1988,22,30,0,3,1,7500,8500,8500,172,167,7375960,189,73,DM/M C,2,3,2,2,2,2,1,4,1,3,3,9,12,13,9,17,9,13,11,8,16,15,10,14,13,14,18,13,18,14,14,17,12,8,9,12,19,18,17,13,13,15,14,10,14,14,20,17,13,13,16,15,8,13,11,13,13,14,13,6,7,8,13,1,18,10,1,1,18,DM/M C,311,1,1,1,10,1,1,13,1,1,20,18,1,1,1,1,196672.0,0,0,0,0,0,0,1,0,0,0,0,0,0,0,0,0,1,1,0,0,0,0,0,0,0,0,0,0,0,0,0,0,0,0,0,0,0,0,0,0,0,0,0,0,0,0,0,0,Sergio Busquets,Â£31.50m ,32.0,189.0,Midfielder - Defensive Midfield,right,FC Barcelona,46.0,1.0,6.0,3814.0,52.0,2.0,3.0,4067.0,45.0,1.0,2.0,3453.0,48.0,3.0,2.0,4074.0,47.0,1.0,3.0,3592.0,53.0,0.0,6.0,4422.0,48.0,0.0,3.0,3928.0,50.0,1.0,4.0,4164.0,54.0,0.0,2.0,4333.0,LaLiga,43.0,2.0,2.0,3265.0,6.0,0.0,0.0,444.0,29/6/2010,Sergio Busquets,1510566,796,7/16/1988,21,20,0,3,1,6806,8500,8500,169,165,42473514,189,73,DM/M C,1,3,2,3,3,1,1,1,1,3,1,9,12,13,9,17,9,13,13,8,14,17,10,14,13,14,17,16,15,14,16,16,11,8,9,12,19,17,16,13,13,15,14,9,13,14,20,16,12,15,7,13,8,14,9,6,12,7,9,6,12,9,Sergio Busquets,ÃÂ£27.00m ,LaLiga
19/6/2011,Sandro,19042321,1651,3/15/1989,22,7,0,13,2,6000,7800,7400,173,146,2755070,187,82,DM/M C,2,2,2,2,3,2,2,7,1,3,3,9,10,11,10,12,8,14,8,7,15,12,6,15,13,14,16,17,14,14,11,15,15,12,13,12,16,17,17,14,16,16,14,8,15,14,20,15,15,15,11,13,3,12,14,13,13,15,11,10,13,6,1,1,20,1,14,1,20,DM/M C,311,1,1,1,1,1,1,1,1,1,20,20,1,14,1,1,0.0,0,0,0,0,0,0,0,0,0,0,0,0,0,0,0,0,0,0,0,0,0,0,0,0,0,0,0,0,0,0,0,0,0,0,0,0,0,0,0,0,0,0,0,0,0,0,0,0,Sandro,Â£10.35m ,31.0,187.0,Midfielder - Defensive Midfield,right,GoiÃ¡s Esporte Clube,26.0,1.0,1.0,1566.0,27.0,0.0,1.0,1649.0,27.0,1.0,2.0,2141.0,27.0,1.0,0.0,1629.0,18.0,1.0,0.0,1298.0,24.0,0.0,0.0,1190.0,20.0,3.0,0.0,1227.0,18.0,1.0,0.0,1328.0,26.0,0.0,1.0,1316.0,Premier League,8.0,0.0,0.0,590.0,nan,nan,nan,nan
19/6/2011,Samba DiakitÃ©,85010614,769,1/24/1989,22,0,0,0,0,4300,5400,5400,135,120,339730,186,76,D/WB/DM R,3,3,1,1,2,3,1,3,3,1,1,5,7,8,6,11,6,12,7,9,13,9,6,13,11,15,14,14,13,12,8,10,16,7,8,7,11,15,17,16,12,15,13,5,15,13,20,17,14,14,15,14,5,10,11,12,10,14,13,12,12,7,16,16,12,1,16,1,12,D/WB/DM R,332,1,1,1,1,1,1,12,1,16,20,12,1,1,1,16,1073741824.0,0,0,0,0,0,0,0,0,0,0,0,0,0,0,0,0,0,0,0,0,0,0,0,0,0,0,0,0,0,0,1,0,0,0,0,0,0,0,0,0,0,0,0,0,0,0,0,0,Samba DiakitÃ©,Â£4.05m ,31.0,186.0,Midfielder - Defensive Midfield,right,Al-Tadamon SC,25.0,2.0,0.0,1745.0,25.0,2.0,0.0,1886.0,15.0,0.0,1.0,943.0,9.0,0.0,0.0,341.0,7.0,1.0,1.0,540.0,0.0,0.0,0.0,0.0,nan,nan,nan,nan,16.0,0.0,0.0,941.0,20.0,0.0,0.0,781.0,Premier League,nan,nan,nan,nan,nan,nan,nan,nan,29/6/2010,Samba DiakitÃ©,85010614,769,1/24/1989,21,0,0,0,0,3306,5174,5150,135,115,1124463,186,76,D/WB/DM RC,2,3,3,2,1,1,2,7,2,3,2,5,7,8,6,11,6,11,7,9,13,9,6,12,11,15,14,14,12,12,8,10,16,7,8,7,10,15,17,16,12,14,13,5,15,12,20,17,14,14,15,14,5,10,8,12,10,14,13,12,12,7,Samba DiakitÃÂ©,ÃÂ£1.62m ,Ligue 1
19/6/2011,RubÃ©n PÃ©rez,67037324,796,4/26/1989,22,0,0,0,0,4550,6550,6550,164,132,238098,178,72,DM/M C,2,3,2,3,1,2,3,5,2,2,2,11,12,13,11,14,13,7,12,11,12,14,11,12,14,14,11,14,14,14,13,14,15,13,13,15,12,15,14,13,11,11,8,10,12,13,20,14,12,15,12,8,7,13,13,14,13,14,15,11,13,7,1,1,20,13,1,1,20,DM/M C,421,1,1,1,13,1,1,1,1,1,16,20,1,1,1,1,256.0,0,0,0,0,0,0,0,0,1,0,0,0,0,0,0,0,0,0,0,0,0,0,0,0,0,0,0,0,0,0,0,0,0,0,0,0,0,0,0,0,0,0,0,0,0,0,0,0,RubÃ©n PÃ©rez,Â£2.52m ,31.0,178.0,Midfielder - Defensive Midfield,right,CD LeganÃ©s,37.0,0.0,2.0,3168.0,10.0,0.0,0.0,722.0,30.0,1.0,0.0,2058.0,32.0,0.0,0.0,2721.0,22.0,0.0,0.0,1300.0,32.0,0.0,2.0,2509.0,32.0,0.0,1.0,2495.0,36.0,0.0,0.0,2895.0,32.0,0.0,0.0,2561.0,LaLiga,28.0,1.0,1.0,2376.0,8.0,0.0,0.0,720.0,29/6/2010,RubÃ©n PÃ©rez,67037324,796,4/26/1989,21,0,0,0,0,1980,4200,4200,144,89,1378297,178,72,DM/M C,1,2,1,2,1,2,2,3,1,1,3,9,7,9,6,9,4,9,11,5,8,11,9,11,13,15,13,14,11,10,9,10,10,7,4,6,13,13,12,13,10,10,11,5,12,13,20,7,13,15,10,6,8,13,12,16,12,5,13,5,8,12,RubÃÂ©n PÃÂ©rez,ÃÂ£2.25m ,LaLiga
19/6/2011,RaÃºl Baena,1510564,796,3/2/1989,22,0,0,0,0,4400,6900,6900,145,140,822582,180,73,DM/M/AM C,3,1,2,3,2,3,1,7,1,1,3,9,9,11,8,14,10,10,12,6,12,14,11,13,13,9,13,14,14,15,12,14,11,10,11,12,14,15,16,14,13,12,10,12,11,13,20,14,12,13,7,10,12,12,12,7,5,12,9,5,8,18,1,1,19,16,1,1,19,DM/M/AM C,321,1,1,1,16,1,1,1,1,1,20,19,1,1,1,1,0.0,0,0,0,0,0,0,0,0,0,0,0,0,0,0,0,0,0,0,0,0,0,0,0,0,0,0,0,0,0,0,0,0,0,0,0,0,0,0,0,0,0,0,0,0,0,0,0,0,RaÃºl Baena,Â£2.16m ,31.0,181.0,Midfielder - Defensive Midfield,right,Without Club,18.0,0.0,0.0,1373.0,35.0,1.0,2.0,2325.0,20.0,1.0,1.0,1090.0,23.0,0.0,0.0,1475.0,30.0,2.0,0.0,2525.0,26.0,1.0,1.0,2023.0,19.0,1.0,0.0,1139.0,23.0,0.0,1.0,1284.0,24.0,1.0,1.0,1627.0,LaLiga,19.0,0.0,0.0,1100.0,nan,nan,nan,nan,29/6/2010,JosÃÂ© RaÃÂºl Baena,1510564,796,3/2/1989,21,0,0,0,0,3000,5759,5750,145,128,5944491,180,73,DM/M/AM C,2,3,1,1,2,3,2,6,1,3,1,8,9,9,7,14,10,9,11,6,8,14,11,8,14,9,13,11,12,14,13,13,10,11,9,12,14,15,14,14,13,12,10,11,12,13,20,14,11,14,7,7,7,12,10,2,6,6,8,12,10,8,RaÃÂºl Baena,ÃÂ£1.80m ,LaLiga
19/6/2011,Radosav Petrovic,5765125,802,3/8/1989,22,18,1,3,0,4900,7000,6250,154,132,886215,193,83,DM/M C,3,2,2,2,3,1,1,5,3,3,2,10,10,12,12,12,12,13,16,10,12,16,17,15,12,12,10,14,12,14,14,10,14,10,15,10,13,12,15,10,13,11,16,10,14,11,20,13,13,12,9,11,7,9,11,13,18,11,10,13,12,7,1,1,16,1,1,1,16,DM/M C,311,1,1,1,1,1,1,1,1,1,20,16,1,1,1,1,17867100000000.0,0,0,0,0,0,0,0,0,1,1,0,0,0,0,0,0,0,0,0,0,0,0,0,0,0,0,0,0,0,0,0,0,0,0,0,0,0,0,1,0,0,0,0,0,1,0,0,0,Radosav Petrovic,Â£1.80m ,31.0,193.0,Midfielder - Defensive Midfield,right,UD AlmerÃ­a,41.0,9.0,7.0,2787.0,24.0,0.0,0.0,1439.0,29.0,3.0,3.0,2146.0,22.0,2.0,3.0,1478.0,33.0,5.0,0.0,2451.0,12.0,1.0,0.0,1013.0,16.0,0.0,0.0,1308.0,13.0,0.0,0.0,728.0,23.0,0.0,0.0,998.0,Premier League,28.0,1.0,0.0,1820.0,4.0,0.0,0.0,133.0
19/6/2011,Philipp Bargfrede,92012217,771,3/3/1989,22,0,0,4,1,4500,6600,6600,155,129,805283,174,71,DM/M RC,2,3,3,2,2,3,1,5,1,1,2,11,13,12,7,11,8,10,9,11,14,9,11,14,13,14,17,14,12,15,8,8,13,7,11,8,16,18,17,15,15,14,8,12,12,12,20,16,10,13,7,9,11,15,8,10,12,8,14,12,13,7,1,1,20,10,15,8,20,DM/M RC,423,1,1,1,10,5,5,1,1,1,18,20,8,15,1,1,0.0,0,0,0,0,0,0,0,0,0,0,0,0,0,0,0,0,0,0,0,0,0,0,0,0,0,0,0,0,0,0,0,0,0,0,0,0,0,0,0,0,0,0,0,0,0,0,0,0,Philipp Bargfrede,Â£3.15m ,31.0,174.0,Midfielder - Defensive Midfield,right,SV Werder Bremen II,38.0,0.0,2.0,2676.0,24.0,0.0,1.0,1944.0,14.0,0.0,1.0,644.0,20.0,3.0,0.0,1579.0,16.0,1.0,0.0,1253.0,17.0,0.0,1.0,1455.0,11.0,1.0,1.0,449.0,30.0,2.0,1.0,2048.0,17.0,1.0,0.0,1238.0,Bundesliga,17.0,0.0,1.0,716.0,nan,nan,nan,nan,29/6/2010,Philipp Bargfrede,92012217,771,3/3/1989,21,0,0,0,0,1750,6950,6950,155,129,5826824,174,71,DM/M RC,1,2,3,2,1,1,3,1,3,2,3,11,13,12,7,11,8,10,9,11,14,9,11,14,13,14,17,14,12,15,8,8,13,7,11,8,16,18,17,15,15,14,8,12,12,12,20,16,10,13,7,9,11,15,8,10,12,8,14,12,13,7,Philipp Bargfrede,ÃÂ£3.60m ,Bundesliga
19/6/2011,Paul Lasne,8440938,769,1/16/1989,22,0,0,0,0,2400,3650,3650,130,110,309911,186,79,DM/M C,3,2,3,1,1,3,2,4,2,2,1,7,10,9,6,12,11,12,11,8,9,13,6,12,12,13,12,13,12,12,12,12,14,7,10,9,10,14,16,12,13,14,13,20,14,11,5,16,13,13,13,13,5,12,8,13,14,13,15,15,15,5,10,10,20,12,1,12,20,DM/M C,421,1,1,1,12,1,1,8,10,1,16,20,12,1,10,1,0.0,0,0,0,0,0,0,0,0,0,0,0,0,0,0,0,0,0,0,0,0,0,0,0,0,0,0,0,0,0,0,0,0,0,0,0,0,0,0,0,0,0,0,0,0,0,0,0,0,Paul Lasne,Â£630Th. ,31.0,186.0,Midfielder - Defensive Midfield,left,Stade Brest 29,34.0,1.0,0.0,2033.0,30.0,0.0,1.0,1542.0,29.0,1.0,1.0,1709.0,37.0,3.0,4.0,3039.0,33.0,2.0,1.0,1913.0,9.0,0.0,0.0,516.0,27.0,3.0,3.0,1741.0,42.0,1.0,2.0,3463.0,37.0,2.0,0.0,1942.0,Ligue 1,20.0,2.0,1.0,1319.0,3.0,0.0,0.0,112.0
19/6/2011,Nuri Sahin,8728250,799,9/5/1988,22,26,1,16,5,6500,7000,7600,169,152,0,180,72,DM/M C,3,2,1,3,2,2,1,6,1,2,3,16,17,12,8,18,15,7,13,10,10,18,12,12,17,12,16,10,15,16,19,19,14,13,14,10,13,15,12,10,13,12,10,20,14,12,10,14,11,16,8,12,8,9,12,18,14,13,17,10,10,8,1,1,20,14,10,12,20,DM/M C,421,1,1,1,14,9,9,1,1,1,18,20,12,10,1,1,140738000000000.0,0,0,0,0,0,0,0,1,0,0,0,0,0,0,0,0,0,0,0,1,0,0,1,0,1,0,0,0,0,0,0,0,0,0,0,0,0,0,0,0,0,0,0,0,0,0,0,1,Nuri Sahin,Â£16.20m ,32.0,180.0,Midfielder - Defensive Midfield,left,Antalyaspor,40.0,8.0,13.0,3500.0,10.0,1.0,1.0,641.0,30.0,6.0,6.0,1743.0,48.0,2.0,3.0,4091.0,9.0,1.0,1.0,724.0,12.0,0.0,2.0,650.0,9.0,1.0,1.0,459.0,25.0,2.0,3.0,1809.0,23.0,1.0,1.0,1742.0,LaLiga,17.0,0.0,4.0,1351.0,6.0,0.0,0.0,383.0,29/6/2010,Nuri Sahin,8728250,799,9/5/1988,21,22,1,16,5,5184,7200,7200,169,144,23610166,179,65,DM/M C,1,2,1,2,2,2,2,6,2,1,3,14,13,14,7,18,14,7,11,10,11,18,15,11,17,10,15,11,14,14,18,16,12,13,13,14,13,15,12,10,14,12,10,20,14,12,10,13,10,14,7,12,8,15,12,15,17,9,16,14,12,4,Nuri Sahin,ÃÂ£18.00m ,Bundesliga
19/6/2011,Nemanja Matic,62000307,802,8/1/1988,22,2,0,13,2,4520,6364,6027,140,125,1559332,194,86,DM ,3,1,3,1,1,3,1,2,2,1,2,9,11,12,13,11,9,16,11,11,14,12,12,14,13,8,16,9,15,16,13,10,16,8,7,11,13,15,13,10,12,11,16,20,14,11,10,8,13,14,10,10,7,11,10,14,13,12,13,11,11,5,7,1,10,1,1,7,10,DM ,300,1,1,1,1,1,1,7,1,1,20,10,7,1,1,1,0.0,0,0,0,0,0,0,0,0,0,0,0,0,0,0,0,0,0,0,0,0,0,0,0,0,0,0,0,0,0,0,0,0,0,0,0,0,0,0,0,0,0,0,0,0,0,0,0,0,Nemanja Matic,Â£3.60m ,32.0,194.0,Midfielder - Defensive Midfield,left,Manchester United,29.0,2.0,3.0,2409.0,30.0,1.0,0.0,1539.0,46.0,5.0,1.0,3988.0,41.0,3.0,4.0,3512.0,49.0,3.0,4.0,4148.0,43.0,2.0,3.0,3083.0,40.0,2.0,8.0,3147.0,49.0,2.0,3.0,4156.0,38.0,1.0,0.0,3337.0,Liga NOS,34.0,1.0,3.0,2560.0,4.0,0.0,0.0,225.0
19/6/2011,Maxime Gonalons,34001572,769,3/10/1989,22,0,0,6,0,4400,5550,5550,148,123,264989,187,76,DM ,2,1,3,2,2,1,3,4,2,2,2,5,10,11,6,13,7,13,12,6,12,13,7,12,13,14,13,15,12,12,12,11,18,6,9,11,13,16,14,14,12,15,13,8,12,11,20,16,13,11,14,15,8,10,5,14,16,12,15,13,13,6,12,1,14,1,1,1,14,DM ,300,1,1,1,1,1,1,12,1,1,20,14,1,1,1,1,8796090000000.0,0,0,0,0,0,1,0,0,0,0,0,0,0,0,0,0,0,0,0,0,0,0,0,0,0,0,0,0,0,0,0,0,0,0,0,0,0,0,0,0,0,0,0,1,0,0,0,0,Maxime Gonalons,Â£7.20m ,31.0,187.0,Midfielder - Defensive Midfield,right,Granada CF,28.0,0.0,3.0,1830.0,52.0,3.0,2.0,4663.0,43.0,4.0,0.0,3913.0,54.0,1.0,2.0,4753.0,42.0,2.0,2.0,3797.0,43.0,0.0,0.0,3747.0,45.0,1.0,3.0,3770.0,23.0,0.0,2.0,1492.0,13.0,1.0,0.0,762.0,Ligue 1,25.0,1.0,1.0,2011.0,8.0,0.0,0.0,573.0,29/6/2010,Maxime Gonalons,34001572,769,3/10/1989,21,0,0,2,0,3906,5624,5600,155,125,9734008,187,76,DM C,1,3,1,2,1,3,2,3,3,1,2,5,7,9,8,12,7,13,11,6,13,13,7,12,12,13,14,14,14,14,12,13,18,7,11,7,13,16,15,13,11,15,13,5,12,12,20,16,15,14,13,16,9,12,7,14,16,16,14,14,14,6,Maxime Gonalons,ÃÂ£4.50m ,Ligue 1
19/6/2011,Mats Hummels,35007944,771,12/16/1988,22,7,0,21,5,6600,7800,7800,172,156,7414823,192,90,D C,1,2,1,1,3,3,2,6,2,2,1,3,7,8,10,13,9,15,6,11,17,12,8,17,13,12,17,13,18,16,12,14,15,9,14,12,15,17,14,10,12,14,16,14,15,12,20,13,15,18,8,10,14,9,15,14,12,13,15,12,13,9,20,1,1,1,12,1,20,D C,101,1,1,1,1,1,1,20,1,12,15,1,1,1,1,1,8933530000000.0,0,0,0,0,0,0,0,0,0,0,0,0,0,0,0,0,0,0,0,0,0,0,0,0,0,0,0,0,0,0,0,0,0,0,0,0,0,1,0,0,0,0,0,1,0,0,0,0,Mats Hummels,Â£21.60m ,31.0,191.0,Defender - Centre-Back,right,Borussia Dortmund,42.0,6.0,1.0,3764.0,46.0,3.0,2.0,4210.0,42.0,3.0,4.0,3485.0,34.0,2.0,2.0,2967.0,32.0,2.0,0.0,2678.0,50.0,3.0,4.0,4210.0,42.0,3.0,3.0,3260.0,41.0,3.0,4.0,3491.0,33.0,2.0,2.0,2849.0,Bundesliga,41.0,1.0,3.0,3483.0,8.0,1.0,0.0,706.0,29/6/2010,Mats Hummels,35007944,771,12/16/1988,21,1,0,20,5,4500,7350,7350,172,147,24462238,192,88,D C,1,1,3,2,3,3,3,2,3,2,3,4,7,9,10,13,5,14,6,11,16,11,8,17,12,15,14,16,17,14,12,14,13,8,13,12,15,17,14,9,14,12,16,13,15,12,20,14,14,11,8,10,14,15,15,14,12,13,14,12,12,8,Mats Hummels,ÃÂ£16.20m ,Bundesliga
19/6/2011,Mario Paglialunga,14006616,1649,10/29/1988,22,0,0,0,0,4500,5309,5100,148,118,249493,182,81,DM C,3,3,2,1,1,1,3,6,2,2,1,5,9,12,8,11,7,12,10,6,14,14,9,11,12,9,14,15,7,11,12,12,13,6,13,12,14,14,14,11,12,14,12,20,13,13,8,15,13,8,8,12,5,10,12,12,15,8,12,13,9,9,10,1,15,1,1,1,15,DM C,301,1,1,1,1,1,1,10,1,1,20,15,1,1,1,1,17592200000000.0,0,0,0,0,0,0,1,0,0,0,0,0,0,0,0,0,0,0,0,0,0,0,0,0,0,0,0,0,0,0,0,0,0,0,0,0,0,0,0,0,0,0,0,0,1,0,0,0,Mario Paglialunga,Â£450Th. ,31.0,182.0,Midfielder - Defensive Midfield,left,Club AtlÃ©tico Central CÃ³rdoba (Cba),12.0,2.0,1.0,978.0,5.0,1.0,0.0,450.0,26.0,2.0,0.0,1874.0,25.0,0.0,0.0,2056.0,28.0,0.0,1.0,1388.0,6.0,0.0,0.0,246.0,nan,nan,nan,nan,nan,nan,nan,nan,nan,nan,nan,nan,Serie A,nan,nan,nan,nan,nan,nan,nan,nan
19/6/2011,Marcelo BenÃ­tez,14010074,1649,5/29/1989,22,0,0,11,1,2350,3350,3850,106,77,33099,177,72,DM C,3,3,3,2,2,2,2,1,1,2,3,7,8,6,5,10,6,4,9,5,8,12,7,10,10,14,10,12,7,10,8,10,10,8,9,6,10,13,12,12,8,10,7,8,14,9,20,13,8,14,9,10,7,10,9,15,8,8,12,9,13,9,1,1,15,8,1,1,15,DM C,301,1,1,1,8,1,1,1,1,1,20,15,1,1,1,1,140738000000000.0,0,0,0,0,0,0,0,0,0,0,0,0,0,0,0,0,0,0,0,0,0,0,0,0,0,0,1,0,0,0,0,0,0,0,0,0,0,0,0,0,0,0,0,0,0,0,0,1,nan,nan,nan,nan,nan,nan,nan,nan,nan,nan,nan,nan,nan,nan,nan,nan,nan,nan,nan,nan,nan,nan,nan,nan,nan,nan,nan,nan,nan,nan,nan,nan,nan,nan,nan,nan,nan,nan,nan,nan,nan,nan,nan,nan,nan,nan,nan,nan,nan,nan,nan,nan
19/6/2011,Manuel Schmiedebach,35008171,771,12/5/1988,22,0,0,0,0,4100,6700,6700,151,139,1030925,170,70,D/WB/DM/M RC,3,3,3,3,1,1,3,5,2,3,3,9,13,12,6,13,7,5,6,16,17,14,7,12,14,17,9,16,12,10,12,13,13,13,10,8,9,15,18,16,17,14,6,10,12,12,20,18,8,15,9,12,7,16,12,12,11,10,12,13,14,6,18,18,19,15,18,1,19,D/WB/DM/M RC,343,1,1,1,1,1,15,1,1,18,20,19,1,16,1,18,16809984.0,0,0,0,0,0,0,0,0,0,0,0,0,0,0,0,1,0,0,0,0,0,0,0,0,1,0,0,0,0,0,0,0,0,0,0,0,0,0,0,0,0,0,0,0,0,0,0,0,Manuel Schmiedebach,Â£4.95m ,31.0,171.0,Midfielder - Defensive Midfield,right,Without Club,33.0,0.0,6.0,2693.0,44.0,0.0,2.0,3344.0,36.0,1.0,1.0,2144.0,28.0,2.0,2.0,1936.0,28.0,0.0,1.0,2343.0,24.0,1.0,1.0,1967.0,28.0,0.0,2.0,2366.0,7.0,0.0,0.0,226.0,36.0,0.0,2.0,3032.0,Bundesliga,6.0,0.0,0.0,255.0,nan,nan,nan,nan,29/6/2010,Manuel Schmiedebach,35008171,771,12/5/1988,21,0,0,0,0,1000,5250,5250,122,105,5750333,174,68,D R,1,1,1,2,1,2,2,4,2,2,2,6,8,8,10,8,4,11,4,7,11,14,8,14,13,11,13,13,14,13,8,7,9,5,9,7,8,17,12,14,12,10,8,8,16,14,20,10,4,9,3,8,8,10,8,5,14,8,12,5,11,12,Manuel Schmiedebach,ÃÂ£4.50m ,Bundesliga
19/6/2011,LoÃ¯c Poujol,8442422,769,2/27/1989,22,0,0,4,0,4050,5129,5117,145,114,101575,188,86,D/DM C,1,2,3,1,3,2,2,1,2,2,1,5,6,8,5,11,7,14,13,6,12,9,10,11,12,13,12,13,13,13,9,11,13,8,11,7,12,12,16,14,9,17,14,8,14,10,20,14,17,14,13,11,8,11,17,12,14,14,15,15,15,6,16,1,10,1,1,1,16,D/DM C,321,1,1,1,1,1,1,16,1,1,20,10,1,1,1,1,512.0,0,0,0,0,0,0,0,0,0,1,0,0,0,0,0,0,0,0,0,0,0,0,0,0,0,0,0,0,0,0,0,0,0,0,0,0,0,0,0,0,0,0,0,0,0,0,0,0,LoÃ¯c Poujol,Â£1.13m ,31.0,187.0,Midfielder - Defensive Midfield,right,Rodez AF,9.0,0.0,0.0,172.0,20.0,1.0,1.0,1345.0,25.0,2.0,0.0,2050.0,5.0,0.0,0.0,291.0,30.0,0.0,0.0,2188.0,6.0,0.0,0.0,246.0,nan,nan,nan,nan,21.0,2.0,0.0,1734.0,24.0,2.0,0.0,1534.0,Ligue 1,15.0,0.0,0.0,1109.0,3.0,0.0,0.0,167.0,29/6/2010,LoÃ¯c Poujol,8442422,769,2/27/1989,21,0,0,4,0,1000,5129,5100,150,114,1529424,188,86,D/DM C,3,1,3,1,1,2,2,1,1,3,1,5,6,8,5,11,7,14,13,6,12,9,10,11,12,13,12,13,13,13,9,11,13,8,11,7,12,12,16,14,9,16,14,8,14,10,20,14,17,14,13,5,8,11,8,12,14,5,15,15,15,6,LoÃÂ¯c Poujol,ÃÂ£495Th. ,Ligue 1
19/6/2011,Lars Bender,35007385,771,4/27/1989,22,0,0,1,0,5400,6850,6850,160,137,871708,184,77,DM/M C,1,1,2,3,2,2,2,6,3,1,1,8,11,13,10,14,11,12,11,8,13,14,10,15,14,12,14,15,14,13,14,12,17,10,11,11,15,15,15,13,12,11,12,10,14,13,20,13,11,13,6,13,9,14,5,13,16,15,17,15,15,4,5,1,20,14,10,6,20,DM/M C,421,1,1,1,14,1,1,5,1,1,19,20,6,10,1,1,0.0,0,0,0,0,0,0,0,0,0,0,0,0,0,0,0,0,0,0,0,0,0,0,0,0,0,0,0,0,0,0,0,0,0,0,0,0,0,0,0,0,0,0,0,0,0,0,0,0,Lars Bender,Â£13.50m ,31.0,185.0,Defender - Right-Back,right,Bayer 04 Leverkusen,42.0,3.0,2.0,2202.0,37.0,5.0,5.0,3168.0,41.0,3.0,8.0,3469.0,39.0,4.0,2.0,3151.0,35.0,1.0,3.0,2806.0,17.0,2.0,0.0,1315.0,12.0,0.0,1.0,823.0,24.0,3.0,7.0,1792.0,27.0,1.0,5.0,1814.0,Bundesliga,28.0,2.0,1.0,2043.0,5.0,1.0,1.0,425.0,29/6/2010,Lars Bender,35007385,771,4/27/1989,21,0,0,0,0,3000,6550,6550,160,131,12586681,183,75,DM/M C,2,2,1,1,3,2,1,1,3,3,1,8,11,13,10,14,11,12,11,8,13,14,10,14,14,12,13,15,14,13,14,12,17,10,11,11,15,15,14,13,12,11,12,10,14,12,20,13,9,16,6,13,9,14,2,13,15,15,17,15,15,4,Lars Bender,ÃÂ£4.95m ,Bundesliga
19/6/2011,Kwadwo Asamoah,12012662,21,12/9/1988,22,29,1,0,0,5750,7450,7450,172,150,2431051,178,78,M C,3,1,2,1,2,1,1,9,2,1,2,6,11,15,12,14,8,8,14,3,14,13,12,15,14,14,13,16,15,13,12,13,13,11,8,14,14,12,14,16,15,17,9,20,17,15,8,16,16,14,13,14,6,14,14,15,12,15,12,14,16,4,1,1,20,15,1,12,20,M C,401,1,1,1,15,1,1,1,1,1,15,20,12,1,1,1,4.0,0,0,1,0,0,0,0,0,0,0,0,0,0,0,0,0,0,0,0,0,0,0,0,0,0,0,0,0,0,0,0,0,0,0,0,0,0,0,0,0,0,0,0,0,0,0,0,0,Kwadwo Asamoah,Â£13.50m ,31.0,173.0,Midfielder - Left Midfield,left,Without Club,39.0,2.0,3.0,3336.0,40.0,3.0,3.0,3385.0,36.0,3.0,9.0,2738.0,47.0,2.0,6.0,3847.0,10.0,0.0,1.0,884.0,13.0,0.0,2.0,770.0,24.0,0.0,2.0,1883.0,26.0,0.0,0.0,2029.0,42.0,0.0,2.0,3578.0,Serie A,11.0,0.0,1.0,899.0,nan,nan,nan,nan,29/6/2010,Kwadwo Asamoah,12012662,21,12/9/1988,21,19,1,0,0,4750,7100,7000,169,140,44424282,178,78,DM/M LC,2,2,2,2,2,1,3,5,2,2,2,4,10,15,13,13,8,9,14,3,14,13,12,15,14,14,12,17,14,13,11,11,14,11,8,14,14,12,14,15,14,17,9,20,17,15,7,15,16,15,14,14,6,14,14,15,10,15,12,15,15,4,Kwadwo Asamoah,ÃÂ£8.55m ,Serie A
19/6/2011,Kevin Pezzoni,28000488,771,3/22/1989,22,0,0,2,0,3850,6100,6100,135,120,292890,193,91,DM C,2,3,1,3,1,1,1,1,3,2,2,5,7,8,7,9,6,15,11,15,13,11,7,13,7,12,12,14,14,11,8,12,8,8,8,8,14,17,16,9,7,11,16,20,15,11,15,14,18,12,12,10,6,12,10,8,12,8,10,13,13,4,15,5,7,1,5,5,15,DM C,301,1,10,4,1,1,1,15,5,5,20,7,1,1,5,5,0.0,0,0,0,0,0,0,0,0,0,0,0,0,0,0,0,0,0,0,0,0,0,0,0,0,0,0,0,0,0,0,0,0,0,0,0,0,0,0,0,0,0,0,0,0,0,0,0,0,Kevin Pezzoni,Â£900Th. ,31.0,194.0,Defender - Centre-Back,left,SG Bad Soden,22.0,0.0,1.0,1585.0,18.0,1.0,1.0,887.0,16.0,1.0,0.0,1198.0,24.0,0.0,0.0,1974.0,32.0,2.0,2.0,2691.0,34.0,0.0,3.0,2783.0,37.0,4.0,2.0,3175.0,10.0,1.0,0.0,562.0,21.0,1.0,2.0,1692.0,Bundesliga,17.0,0.0,1.0,1466.0,7.0,1.0,0.0,630.0,29/6/2010,Kevin Pezzoni,28000488,771,3/22/1989,21,0,0,2,0,3250,6050,6050,135,121,944273,193,91,D/DM C,1,3,1,2,2,2,1,2,2,2,3,5,6,8,7,10,6,15,11,13,13,11,7,13,9,12,12,14,14,11,8,12,8,8,8,8,13,15,16,10,9,9,16,20,15,11,17,14,15,12,12,10,6,12,10,4,5,14,7,5,13,11,Kevin Pezzoni,ÃÂ£1.58m ,Bundesliga
19/6/2011,Joshua,67010757,796,1/28/1989,22,0,0,0,0,2050,4050,4050,108,81,82843,180,75,DM/M C,1,2,3,2,3,1,2,2,1,1,3,13,12,11,9,9,12,7,10,2,10,13,4,10,10,7,7,18,9,6,13,15,12,14,6,13,12,6,12,8,9,9,10,5,14,12,20,7,10,13,5,10,6,11,14,17,12,20,14,14,9,14,1,1,20,1,1,1,20,DM/M C,421,1,1,1,1,1,1,1,1,1,18,20,1,1,1,1,17592200000000.0,0,0,0,0,0,0,0,0,0,0,0,0,0,0,0,0,0,0,0,0,0,0,1,0,0,0,0,0,0,0,0,0,0,0,0,0,0,0,0,0,0,0,0,0,1,0,0,0,nan,nan,nan,nan,nan,nan,nan,nan,nan,nan,nan,nan,nan,nan,nan,nan,nan,nan,nan,nan,nan,nan,nan,nan,nan,nan,nan,nan,nan,nan,nan,nan,nan,nan,nan,nan,nan,nan,nan,nan,nan,nan,nan,nan,nan,nan,nan,nan,nan,nan,nan,nan
19/6/2011,JoÃ£o Victor,2114918,1651,11/7/1988,22,0,0,0,0,4750,5967,6400,142,132,531315,181,78,DM/M C,3,1,1,1,1,3,2,3,3,1,3,10,12,12,12,14,9,7,12,4,13,14,12,11,13,9,11,11,14,13,11,12,10,12,13,13,13,13,14,13,14,13,12,12,14,13,20,14,14,14,11,12,9,11,11,10,6,7,14,9,5,14,1,1,18,14,1,1,18,DM/M C,311,1,1,1,14,1,1,1,1,1,20,18,1,1,1,1,0.0,0,0,0,0,0,0,0,0,0,0,0,0,0,0,0,0,0,0,0,0,0,0,0,0,0,0,0,0,0,0,0,0,0,0,0,0,0,0,0,0,0,0,0,0,0,0,0,0,JoÃ£o Victor,Â£2.25m ,31.0,181.0,Midfielder - Defensive Midfield,right,Hyderabad FC,36.0,0.0,1.0,2462.0,17.0,0.0,1.0,1093.0,7.0,0.0,0.0,275.0,nan,nan,nan,nan,37.0,1.0,1.0,3144.0,25.0,3.0,0.0,2231.0,33.0,4.0,0.0,2919.0,35.0,7.0,2.0,3143.0,30.0,4.0,0.0,2700.0,LaLiga,22.0,0.0,0.0,1715.0,nan,nan,nan,nan,29/6/2010,JoÃÂ£o Victor,2114918,1651,11/7/1988,21,0,0,0,0,1750,4700,4700,134,94,2635050,181,78,M/AM C,3,2,1,2,3,2,2,5,1,1,3,10,9,12,12,11,10,7,14,3,7,12,10,7,12,7,7,5,11,11,11,8,10,8,8,14,10,9,13,14,13,14,13,1,5,13,20,9,12,10,11,10,13,10,7,14,9,10,11,6,1,7,JoÃÂ£o Victor,ÃÂ£1.80m ,LaLiga
19/6/2011,Ivan Radovanovic,62013021,802,8/29/1988,22,1,0,11,0,3600,6000,5550,138,114,108399,186,76,DM C,1,1,3,1,1,1,2,2,3,1,3,11,12,11,9,12,11,12,11,8,12,14,10,13,13,13,9,11,7,8,14,11,15,10,11,10,11,12,12,12,11,12,12,10,11,12,20,15,11,12,14,9,9,8,14,9,16,8,16,18,12,2,10,8,15,10,7,10,15,DM C,301,1,1,1,10,1,1,6,10,1,20,15,1,7,8,1,0.0,0,0,0,0,0,0,0,0,0,0,0,0,0,0,0,0,0,0,0,0,0,0,0,0,0,0,0,0,0,0,0,0,0,0,0,0,0,0,0,0,0,0,0,0,0,0,0,0,Ivan Radovanovic,Â£810Th. ,32.0,187.0,Midfielder - Defensive Midfield,right,Genoa CFC,16.0,1.0,0.0,635.0,30.0,2.0,0.0,1696.0,17.0,0.0,0.0,718.0,35.0,1.0,1.0,2519.0,31.0,1.0,0.0,2476.0,27.0,0.0,0.0,2148.0,37.0,0.0,0.0,3025.0,36.0,1.0,1.0,3261.0,36.0,0.0,0.0,3080.0,Serie A,22.0,0.0,1.0,1522.0,4.0,0.0,0.0,161.0,29/6/2010,Ivan Radovanovic,62013021,802,8/29/1988,21,0,0,10,0,3025,5500,5500,138,110,317367,186,76,DM/M C,1,2,3,3,2,3,2,4,2,2,1,11,12,11,9,12,11,12,11,8,12,14,10,12,13,13,9,11,7,8,14,11,15,10,11,9,11,12,12,12,11,12,12,10,11,12,20,15,11,12,14,9,9,7,14,9,16,8,16,18,12,2,Ivan Radovanovic,ÃÂ£720Th. ,Serie A
19/6/2011,Georges Mandjeck,35015134,11,12/9/1988,22,7,0,2,1,3250,6750,6350,140,127,577965,183,72,DM C,1,3,2,1,3,3,3,3,2,3,1,5,7,12,9,13,11,15,11,5,15,14,10,15,14,12,13,13,12,11,11,12,13,12,11,8,13,12,13,12,13,12,13,8,13,14,20,13,13,13,10,11,5,11,13,12,10,12,13,11,9,5,14,12,15,1,12,1,15,DM C,301,1,1,1,1,1,1,14,1,12,20,15,1,1,1,12,0.0,0,0,0,0,0,0,0,0,0,0,0,0,0,0,0,0,0,0,0,0,0,0,0,0,0,0,0,0,0,0,0,0,0,0,0,0,0,0,0,0,0,0,0,0,0,0,0,0,Georges Mandjeck,Â£1.58m ,31.0,185.0,Midfielder - Defensive Midfield,right,Waasland-Beveren,24.0,0.0,0.0,940.0,32.0,1.0,0.0,2629.0,31.0,1.0,0.0,2419.0,25.0,1.0,2.0,1771.0,12.0,0.0,0.0,633.0,27.0,0.0,1.0,2049.0,30.0,3.0,0.0,2459.0,27.0,0.0,0.0,1878.0,32.0,5.0,1.0,2545.0,Ligue 1,18.0,0.0,0.0,1049.0,1.0,0.0,0.0,73.0,29/6/2010,Georges Mandjeck,35015134,11,12/9/1988,21,7,0,2,1,3250,6750,6350,147,127,2638726,183,72,DM C,1,2,1,2,2,1,3,5,1,1,2,5,7,12,9,13,11,15,11,5,15,14,10,15,14,12,13,13,12,11,11,12,13,12,11,8,13,12,13,12,13,12,13,8,13,14,20,13,13,13,10,11,5,11,13,12,10,12,13,11,9,5,Georges Mandjeck,ÃÂ£1.44m ,Ligue 1
19/6/2011,Fabio Sciacca,43002359,776,5/16/1989,22,0,0,0,0,3000,5650,5650,140,113,211707,182,76,DM/M C,1,1,1,1,1,1,1,1,1,1,1,8,10,9,10,12,12,15,15,4,7,14,9,11,13,12,10,14,11,8,14,8,14,11,13,14,9,12,12,12,11,13,10,11,10,13,20,12,14,13,13,10,15,14,14,16,16,13,16,12,12,5,1,1,20,10,14,12,20,DM/M C,421,1,1,1,10,1,1,1,1,1,17,20,12,14,1,1,272.0,0,0,0,0,1,0,0,0,1,0,0,0,0,0,0,0,0,0,0,0,0,0,0,0,0,0,0,0,0,0,0,0,0,0,0,0,0,0,0,0,0,0,0,0,0,0,0,0,Fabio Sciacca,Â£540Th. ,31.0,184.0,Midfielder - Central Midfield,right,Calcio Biancavilla 1990,9.0,0.0,0.0,674.0,25.0,1.0,0.0,1466.0,4.0,0.0,0.0,129.0,5.0,0.0,0.0,309.0,16.0,0.0,2.0,864.0,nan,nan,nan,nan,3.0,0.0,0.0,111.0,21.0,0.0,0.0,884.0,nan,nan,nan,nan,Serie A,2.0,0.0,0.0,107.0,3.0,0.0,0.0,187.0,29/6/2010,Fabio Sciacca,43002359,776,5/16/1989,21,0,0,0,0,3000,5250,5250,149,113,1461963,182,76,M C,1,1,1,1,1,1,1,1,1,1,1,8,10,9,10,12,12,15,15,4,7,14,9,11,13,12,10,14,11,8,14,8,14,11,13,14,9,12,12,13,11,13,10,11,16,13,20,12,14,13,13,10,9,14,9,16,16,13,16,12,12,5,Fabio Sciacca,ÃÂ£540Th. ,Serie A
19/6/2011,Etienne Capoue,8448716,769,7/11/1988,22,0,0,13,0,5150,6450,6450,165,143,1712166,189,80,DM C,3,3,2,2,2,2,2,3,1,1,3,5,11,12,6,13,8,16,8,7,13,15,8,13,13,13,17,15,14,14,13,14,13,11,8,10,14,15,16,12,13,16,14,8,16,13,20,17,16,15,13,15,5,10,5,15,15,15,13,14,14,7,14,12,15,10,12,1,15,DM C,301,1,1,1,10,1,1,14,1,12,20,15,1,1,1,12,8796090000000.0,0,0,0,0,0,1,0,0,0,0,0,0,0,0,0,0,0,0,0,0,0,0,0,0,0,0,0,0,0,0,0,0,0,0,0,0,0,0,0,0,0,0,0,1,0,0,0,0,Ãtienne Capoue,Â£10.80m ,32.0,189.0,Midfielder - Defensive Midfield,right,Watford FC,39.0,2.0,0.0,3540.0,34.0,3.0,5.0,2909.0,38.0,7.0,1.0,3406.0,19.0,1.0,1.0,1284.0,19.0,1.0,2.0,1284.0,36.0,0.0,1.0,3017.0,39.0,7.0,1.0,3357.0,26.0,3.0,0.0,1755.0,39.0,4.0,3.0,3352.0,Ligue 1,30.0,0.0,3.0,2632.0,2.0,0.0,0.0,73.0,29/6/2010,Etienne Capoue,8448716,769,7/11/1988,21,0,0,12,0,1400,6074,6050,165,135,8421558,189,80,DM C,3,3,1,1,1,1,2,4,1,1,2,6,10,12,6,12,8,16,10,8,14,14,8,12,14,14,15,14,13,13,13,13,13,8,10,10,12,14,16,12,12,16,14,8,16,13,20,17,16,14,11,15,6,10,5,15,15,15,13,14,14,7,ÃÂtienne Capoue,ÃÂ£7.20m ,Ligue 1
19/6/2011,Elizeu,19097681,1651,5/28/1989,22,0,0,0,0,1772,5436,5400,126,109,95103,183,78,DM/M C,2,3,1,3,2,3,1,4,1,1,1,9,10,11,9,11,7,11,11,7,13,12,11,12,12,10,12,10,12,12,10,12,15,5,7,8,13,15,14,12,12,15,12,8,14,12,20,14,16,12,11,11,6,10,11,15,5,11,10,13,13,15,1,1,18,1,1,1,18,DM/M C,311,1,1,1,1,1,1,1,1,1,20,18,1,1,1,1,0.0,0,0,0,0,0,0,0,0,0,0,0,0,0,0,0,0,0,0,0,0,0,0,0,0,0,0,0,0,0,0,0,0,0,0,0,0,0,0,0,0,0,0,0,0,0,0,0,0,Elizeu,Â£720Th. ,31.0,184.0,Defender - Centre-Back,right,Petaling Jaya City FC,nan,nan,nan,nan,21.0,1.0,0.0,1352.0,13.0,0.0,0.0,657.0,nan,nan,nan,nan,nan,nan,nan,nan,nan,nan,nan,nan,19.0,3.0,1.0,1770.0,nan,nan,nan,nan,21.0,1.0,0.0,1855.0,Liga NOS,6.0,1.0,0.0,540.0,nan,nan,nan,nan
19/6/2011,Distel Zola,8432569,53,2/5/1989,22,0,0,0,0,2500,5084,3750,140,113,133196,182,76,DM/M C,2,3,2,2,1,3,1,3,1,2,2,6,8,11,6,11,7,13,9,6,8,12,9,11,13,12,14,14,12,12,14,12,15,9,11,7,13,14,16,11,13,13,11,6,13,12,20,15,15,14,10,14,10,8,11,14,16,14,14,14,14,6,1,1,16,12,1,1,16,DM/M C,311,1,1,1,12,1,1,1,1,1,20,16,1,1,1,1,0.0,0,0,0,0,0,0,0,0,0,0,0,0,0,0,0,0,0,0,0,0,0,0,0,0,0,0,0,0,0,0,0,0,0,0,0,0,0,0,0,0,0,0,0,0,0,0,0,0,Distel Zola,Â£360Th. ,31.0,189.0,Midfielder - Defensive Midfield,right,El Paso Locomotive FC,28.0,1.0,1.0,2170.0,17.0,1.0,1.0,1235.0,36.0,1.0,0.0,2520.0,33.0,0.0,0.0,2188.0,22.0,0.0,0.0,1491.0,3.0,0.0,0.0,138.0,16.0,0.0,1.0,939.0,nan,nan,nan,nan,27.0,0.0,0.0,2178.0,Ligue 1,11.0,0.0,0.0,460.0,nan,nan,nan,nan
19/6/2011,Daniel Williams,91003280,771,3/8/1989,22,0,0,0,0,3400,5500,5500,138,117,635854,182,79,D/DM RL,1,3,3,1,1,1,1,3,3,3,3,9,8,14,7,15,9,13,7,16,14,13,10,13,15,12,13,10,9,12,11,8,10,9,8,14,12,15,10,10,9,11,14,20,12,13,15,11,10,11,8,10,5,12,6,14,9,11,18,2,12,10,16,1,8,1,15,16,10,D/DM RL,325,1,1,1,1,1,1,10,16,15,20,8,1,1,1,1,8796090000000.0,0,0,0,0,0,0,0,0,0,0,0,0,0,0,0,0,0,0,0,0,0,0,0,0,0,0,0,0,0,0,0,0,0,0,0,0,0,0,0,0,0,0,0,1,0,0,0,0,Danny Williams,Â£1.80m ,31.0,182.0,Midfielder - Defensive Midfield,right,Without Club,15.0,0.0,1.0,796.0,28.0,0.0,1.0,1855.0,22.0,1.0,0.0,1622.0,32.0,3.0,2.0,2295.0,32.0,1.0,0.0,2493.0,46.0,6.0,3.0,3736.0,47.0,4.0,1.0,3865.0,24.0,1.0,0.0,1422.0,6.0,0.0,0.0,162.0,Bundesliga,11.0,0.0,0.0,733.0,nan,nan,nan,nan,29/6/2010,Daniel Williams,91003280,771,3/8/1989,21,0,0,0,0,2500,4500,4500,133,105,2239678,180,78,D/DM RLC,1,3,3,2,3,2,3,3,2,3,3,8,7,13,6,14,8,12,6,15,13,12,9,12,14,11,13,9,8,11,10,7,7,8,7,13,11,14,9,10,9,11,14,20,12,13,15,11,10,10,8,9,5,11,10,13,14,9,18,15,12,14,Danny Williams,ÃÂ£450Th. ,Bundesliga
19/6/2011,Damien Marcq,34005947,769,12/8/1988,22,0,0,5,0,4450,5550,5550,150,124,845682,183,72,DM ,3,3,3,3,1,1,1,1,3,2,3,5,8,9,6,11,7,13,12,6,12,11,7,14,12,14,15,16,14,13,11,12,16,8,12,9,14,17,17,13,12,13,11,7,15,11,20,17,13,12,13,14,6,10,15,14,18,13,16,13,13,6,12,8,14,1,12,8,14,DM ,300,1,1,1,1,1,1,12,8,8,20,14,1,12,8,8,137439000000.0,0,0,0,0,0,0,0,0,0,0,0,0,0,0,0,0,0,0,0,0,0,0,0,0,0,0,0,0,0,0,0,0,0,0,0,0,0,1,0,0,0,0,0,0,0,0,0,0,Damien Marcq,Â£1.13m ,31.0,181.0,Midfielder - Defensive Midfield,right,SV Zulte Waregem,29.0,0.0,0.0,2016.0,22.0,0.0,0.0,1164.0,28.0,0.0,2.0,2170.0,33.0,0.0,1.0,2321.0,33.0,0.0,1.0,2868.0,40.0,1.0,4.0,3299.0,36.0,2.0,2.0,3235.0,14.0,0.0,1.0,1026.0,16.0,1.0,0.0,1111.0,Ligue 1,20.0,1.0,1.0,1511.0,5.0,0.0,0.0,334.0,29/6/2010,Damien Marcq,34005947,769,12/8/1988,21,0,0,3,0,4160,5804,5800,150,129,5999998,183,72,D/DM C,3,1,2,2,3,2,2,5,2,1,3,5,8,9,6,11,7,13,12,6,12,12,7,15,11,13,15,16,14,15,11,14,16,6,14,7,13,18,17,13,12,13,11,5,15,11,20,17,13,16,13,14,6,10,8,14,18,15,16,13,13,6,Damien Marcq,ÃÂ£2.25m ,Ligue 1
19/6/2011,CauÃª,19029503,1651,5/24/1989,22,0,0,0,0,500,5400,5450,125,111,189597,186,81,DM/M C,3,1,1,3,1,1,1,1,2,2,1,9,9,8,8,10,8,13,10,11,11,10,8,13,11,13,12,12,13,12,9,11,12,7,10,11,12,16,14,12,11,16,15,7,14,11,20,14,16,12,10,10,7,10,10,7,8,10,11,12,13,15,1,1,18,1,1,1,18,DM/M C,311,1,1,1,1,1,1,1,1,1,20,18,1,1,1,1,0.0,0,0,0,0,0,0,0,0,0,0,0,0,0,0,0,0,0,0,0,0,0,0,0,0,0,0,0,0,0,0,0,0,0,0,0,0,0,0,0,0,0,0,0,0,0,0,0,0,CauÃª,Â£1.44m ,31.0,186.0,Midfielder - Defensive Midfield,right,Belenenses SAD,34.0,1.0,0.0,3064.0,35.0,5.0,0.0,3017.0,34.0,1.0,1.0,2379.0,19.0,2.0,0.0,1666.0,31.0,1.0,2.0,2397.0,26.0,0.0,1.0,1654.0,52.0,5.0,1.0,4341.0,15.0,3.0,1.0,1301.0,35.0,3.0,3.0,2780.0,Liga NOS,nan,nan,nan,nan,4.0,0.0,0.0,210.0
19/6/2011,AndrÃ© Santos,55009678,788,3/2/1989,22,1,0,14,1,5285,6672,6922,153,139,4743083,176,70,DM ,3,2,2,1,3,1,3,3,2,2,2,10,10,11,9,13,11,11,14,11,13,12,12,14,13,15,15,13,13,13,13,14,15,8,11,13,15,16,15,13,13,13,13,8,13,13,20,13,13,15,9,12,7,11,12,13,13,14,14,15,15,5,1,1,10,1,1,1,10,DM ,300,1,1,1,1,1,1,1,1,1,20,10,1,1,1,1,0.0,0,0,0,0,0,0,0,0,0,0,0,0,0,0,0,0,0,0,0,0,0,0,0,0,0,0,0,0,0,0,0,0,0,0,0,0,0,0,0,0,0,0,0,0,0,0,0,0,AndrÃ© Santos,Â£6.75m ,37.0,180.0,Midfielder - Attacking Midfield,left,Retired,33.0,6.0,0.0,2611.0,22.0,3.0,0.0,1487.0,42.0,4.0,3.0,3190.0,24.0,5.0,4.0,2045.0,nan,nan,nan,nan,27.0,12.0,6.0,1786.0,30.0,13.0,4.0,2300.0,36.0,3.0,3.0,1290.0,nan,nan,nan,nan,Premier League,nan,nan,nan,nan,nan,nan,nan,nan,29/6/2010,AndrÃ© Santos,55009678,788,3/2/1989,21,0,0,14,1,3000,6100,6100,142,122,7752417,176,70,DM C,1,3,3,2,3,1,3,6,2,3,2,9,9,10,8,12,10,10,10,10,12,11,11,13,12,15,14,13,12,12,12,13,15,8,11,12,14,15,14,12,12,12,11,8,13,12,20,12,12,15,9,12,7,11,12,13,13,14,14,15,15,5,AndrÃÂ© Santos,ÃÂ£4.05m ,Liga NOS
19/6/2011,Almog Cohen,42004287,775,9/1/1988,22,7,0,14,0,5200,6600,6400,144,128,568194,169,65,DM/M C,2,2,3,2,3,2,2,1,1,1,1,9,8,11,9,13,10,5,14,8,14,13,7,14,15,14,13,15,11,12,10,13,16,8,11,11,13,14,17,14,12,9,6,9,12,13,20,15,10,15,5,11,12,8,17,14,13,14,17,15,16,4,1,1,18,12,1,1,18,DM/M C,311,1,1,1,12,1,1,1,1,1,20,18,1,1,1,1,65536.0,0,0,0,0,0,0,0,0,0,0,0,0,0,0,0,0,1,0,0,0,0,0,0,0,0,0,0,0,0,0,0,0,0,0,0,0,0,0,0,0,0,0,0,0,0,0,0,0,Almog Cohen,Â£1.80m ,32.0,170.0,Midfielder - Central Midfield,right,Maccabi Netanya,27.0,2.0,0.0,1703.0,26.0,0.0,0.0,1236.0,22.0,1.0,1.0,1527.0,25.0,1.0,2.0,1983.0,5.0,0.0,0.0,141.0,20.0,0.0,2.0,825.0,33.0,7.0,2.0,2638.0,30.0,3.0,1.0,2359.0,22.0,1.0,0.0,1712.0,Bundesliga,25.0,0.0,1.0,1977.0,1.0,0.0,0.0,90.0,29/6/2010,Almog Cohen,42004287,775,9/1/1988,21,0,0,17,0,2500,6545,5950,130,119,923119,170,65,DM C,2,3,1,1,2,1,1,2,3,2,2,11,11,12,10,12,11,10,13,10,14,15,7,13,15,11,12,11,9,10,13,13,9,8,12,12,13,12,11,12,9,8,11,9,10,13,20,12,10,15,6,11,4,8,8,19,10,5,14,8,12,2,Almog Cohen,ÃÂ£2.70m ,Bundesliga
19/6/2011,Adrien,55001975,788,3/15/1989,22,0,0,14,1,3250,5750,6000,135,113,113253,175,75,DM/M C,3,2,2,2,2,3,3,4,1,2,1,13,13,12,12,14,11,9,12,8,8,14,11,11,13,12,14,12,15,15,16,14,14,11,10,13,15,14,13,10,12,11,8,8,14,10,20,12,9,16,8,13,7,13,14,14,16,13,15,16,17,5,1,1,20,10,5,5,20,DM/M C,421,1,1,1,10,1,1,1,1,1,17,20,5,5,1,1,16777280.0,0,0,0,0,0,0,1,0,0,0,0,0,0,0,0,0,0,0,0,0,0,0,0,0,1,0,0,0,0,0,0,0,0,0,0,0,0,0,0,0,0,0,0,0,0,0,0,0,AdriÃ¡n, ,33.0,190.0,Goalkeeper,right,Liverpool FC,9.0,6.0,4.0,810.0,11.0,12.0,5.0,990.0,32.0,46.0,11.0,2869.0,26.0,42.0,7.0,2340.0,42.0,54.0,10.0,3781.0,36.0,44.0,10.0,3300.0,19.0,36.0,6.0,1710.0,22.0,31.0,8.0,1980.0,5.0,8.0,2.0,450.0,LaLiga,18.0,24.0,3.0,1563.0,5.0,11.0,2.0,450.0
19/6/2011,Adam Matuszczyk,35014358,787,2/14/1989,22,10,1,4,0,3900,6500,6200,145,124,307212,183,73,DM C,1,1,1,3,3,2,2,5,1,1,2,10,9,11,10,10,13,10,15,10,12,12,11,11,13,11,13,12,14,13,12,12,13,9,13,9,13,14,13,12,12,13,11,15,14,11,20,12,11,13,13,12,6,12,12,13,15,13,14,11,12,8,8,7,15,7,10,7,15,DM C,301,1,1,1,7,1,3,8,5,5,20,15,5,10,7,7,0.0,0,0,0,0,0,0,0,0,0,0,0,0,0,0,0,0,0,0,0,0,0,0,0,0,0,0,0,0,0,0,0,0,0,0,0,0,0,0,0,0,0,0,0,0,0,0,0,0,Adam Matuschyk,Â£1.80m ,31.0,183.0,Midfielder - Defensive Midfield,both,1.FC DÃ¼ren,27.0,2.0,1.0,1766.0,20.0,1.0,0.0,629.0,30.0,1.0,1.0,2183.0,25.0,1.0,0.0,1462.0,13.0,0.0,0.0,615.0,32.0,1.0,3.0,2507.0,2.0,0.0,0.0,92.0,34.0,0.0,1.0,2678.0,27.0,0.0,1.0,2165.0,Bundesliga,25.0,1.0,0.0,1914.0,1.0,0.0,0.0,37.0,29/6/2010,Adam Matuszczyk,35014358,787,2/14/1989,21,3,0,1,0,3250,5500,5850,145,118,1503055,183,73,DM C,2,1,3,3,1,3,1,1,3,2,2,10,9,11,9,10,11,10,12,5,12,12,11,11,13,11,13,12,13,13,11,12,10,9,13,9,13,14,13,12,12,12,11,15,14,10,20,12,11,13,13,12,10,12,12,12,15,5,5,9,6,15,Adam Matuschyk,ÃÂ£2.70m ,Bundesliga
19/6/2011,Zdravko Kuzmanovic,5727648,802,9/22/1987,23,38,4,0,0,6500,7150,7050,159,141,3481159,186,72,DM/M C,3,1,2,2,3,1,2,4,3,2,1,9,14,8,13,14,13,12,15,10,9,16,15,11,14,9,14,12,17,17,14,16,9,8,13,10,12,18,12,8,8,17,14,13,16,13,20,15,14,14,12,11,3,12,16,15,8,15,12,5,14,9,1,1,20,8,12,10,20,DM/M C,421,1,1,1,8,1,1,1,1,1,18,20,10,12,1,1,35184400000000.0,0,0,0,0,0,0,0,0,0,0,0,0,0,0,0,0,0,0,0,0,0,0,1,0,0,0,0,0,0,0,0,0,0,0,0,0,0,0,0,0,0,0,0,0,0,1,0,0,Zdravko Kuzmanovic,Â£8.10m ,33.0,186.0,Midfielder - Central Midfield,right,Retired,47.0,11.0,6.0,3689.0,29.0,6.0,3.0,2001.0,31.0,0.0,4.0,2023.0,16.0,0.0,0.0,924.0,25.0,1.0,5.0,1482.0,34.0,0.0,0.0,2286.0,4.0,0.0,0.0,216.0,8.0,0.0,1.0,482.0,17.0,2.0,1.0,841.0,Bundesliga,5.0,0.0,1.0,158.0,nan,nan,nan,nan,29/6/2010,Zdravko Kuzmanovic,5727648,802,9/22/1987,22,31,4,0,0,4600,7100,7150,161,143,12497048,186,72,DM/M RC,3,3,2,1,2,1,1,6,1,3,1,9,13,8,12,14,11,12,13,8,11,16,12,12,14,13,15,16,14,14,14,16,11,8,12,11,13,18,16,9,8,17,13,13,16,12,20,17,14,14,12,11,3,12,16,15,11,15,12,12,10,12,Zdravko Kuzmanovic,ÃÂ£7.65m ,Bundesliga
19/6/2011,Wesley,19040469,1651,6/24/1987,23,2,0,0,0,5600,7000,7050,156,140,3503470,179,63,DM/M RC,3,1,2,3,1,3,3,3,1,1,1,12,14,13,9,15,7,8,10,10,13,15,11,12,15,17,10,15,8,10,10,8,15,14,10,13,9,14,18,17,16,8,9,14,14,15,20,17,7,12,7,11,12,17,14,13,13,12,11,8,12,5,14,12,20,15,15,1,20,DM/M RC,423,1,1,10,15,1,10,1,1,14,18,20,1,15,1,12,1074790484.0,0,0,1,0,1,0,1,0,0,0,0,0,0,0,0,0,0,0,0,0,1,0,0,0,0,0,0,0,0,0,1,0,0,0,0,0,0,0,0,0,0,0,0,0,0,0,0,0,Wesley,Â£4.05m ,33.0,179.0,Midfielder - Central Midfield,right,AvaÃ­ Futebol Clube (SC),25.0,1.0,3.0,1945.0,10.0,1.0,1.0,461.0,34.0,7.0,9.0,2823.0,26.0,2.0,2.0,2089.0,27.0,1.0,2.0,1530.0,30.0,1.0,1.0,1915.0,12.0,0.0,0.0,714.0,17.0,0.0,1.0,919.0,33.0,0.0,1.0,2859.0,Bundesliga,1.0,0.0,0.0,13.0,nan,nan,nan,nan,29/6/2010,Wesley,19040469,1651,6/24/1987,23,0,0,0,0,4000,7500,7050,160,141,17473182,179,63,DM/M C,1,1,2,3,1,3,2,2,1,2,2,12,14,13,9,16,7,8,11,10,13,16,11,9,15,17,15,16,8,9,14,9,15,14,10,13,11,12,18,17,15,8,9,14,14,15,20,12,9,12,7,11,12,17,14,13,13,12,11,8,12,5,Wesley,ÃÂ£7.20m ,Bundesliga
19/6/2011,Vincent Nogueira,8440962,769,1/16/1988,23,0,0,1,0,4700,5877,5877,149,130,456119,170,60,DM/M/AM RC,3,2,2,1,3,2,3,1,2,2,1,11,12,13,8,14,11,6,14,8,8,13,7,7,14,7,13,12,13,13,13,13,13,12,8,12,12,14,15,15,14,11,5,10,8,13,20,15,6,13,7,15,15,15,8,13,15,15,15,15,15,5,8,8,20,16,16,10,20,DM/M/AM RC,433,1,1,1,1,10,16,1,1,8,18,20,10,16,1,8,0.0,0,0,0,0,0,0,0,0,0,0,0,0,0,0,0,0,0,0,0,0,0,0,0,0,0,0,0,0,0,0,0,0,0,0,0,0,0,0,0,0,0,0,0,0,0,0,0,0,Vincent Nogueira,Â£1.80m ,32.0,170.0,Midfielder - Central Midfield,right,Retired,26.0,1.0,1.0,758.0,31.0,2.0,1.0,2315.0,32.0,2.0,3.0,2511.0,50.0,3.0,5.0,4056.0,31.0,5.0,2.0,2444.0,9.0,2.0,0.0,757.0,27.0,1.0,4.0,1854.0,7.0,0.0,0.0,400.0,2.0,0.0,0.0,47.0,Ligue 1,5.0,0.0,0.0,431.0,nan,nan,nan,nan,29/6/2010,Vincent Nogueira,8440962,769,1/16/1988,22,0,0,1,0,3782,5500,5500,145,123,3103978,170,60,DM/M/AM RC,1,2,3,1,3,1,1,1,3,3,3,8,12,13,6,14,7,5,10,8,5,13,7,7,14,7,13,12,13,13,13,12,13,12,8,11,10,14,15,15,14,11,5,10,8,13,20,15,6,13,7,15,15,15,15,13,15,15,15,15,15,5,Vincent Nogueira,ÃÂ£1.08m ,Ligue 1
19/6/2011,Vicente Iborra,67010183,796,1/16/1988,23,0,0,0,0,4100,6500,6250,145,127,592119,190,76,DM/M C,2,2,2,3,1,3,1,4,3,3,3,9,10,11,8,13,8,14,9,6,8,14,12,12,14,13,13,14,13,14,14,13,12,14,10,11,14,15,14,12,10,15,14,9,14,13,20,15,14,14,12,14,8,9,14,15,14,10,14,15,10,6,1,1,20,14,1,1,20,DM/M C,421,1,1,8,14,1,1,1,1,1,18,20,1,1,1,1,524320.0,0,0,0,0,0,1,0,0,0,0,0,0,0,0,0,0,0,0,0,1,0,0,0,0,0,0,0,0,0,0,0,0,0,0,0,0,0,0,0,0,0,0,0,0,0,0,0,0,Vicente Iborra,Â£2.25m ,32.0,190.0,Midfielder - Central Midfield,right,Villarreal CF,16.0,0.0,0.0,1261.0,38.0,1.0,1.0,2752.0,49.0,7.0,2.0,4275.0,40.0,4.0,4.0,2994.0,41.0,9.0,2.0,3001.0,47.0,9.0,3.0,2840.0,44.0,8.0,4.0,2373.0,27.0,4.0,2.0,2154.0,36.0,5.0,2.0,2420.0,LaLiga,37.0,1.0,3.0,2808.0,8.0,0.0,0.0,493.0,29/6/2010,Vicente Iborra,67010183,796,1/16/1988,22,0,0,0,0,3900,5750,5750,145,128,2613001,190,76,DM/M C,2,1,1,1,2,3,3,1,1,3,2,9,10,12,10,14,8,14,12,6,8,15,12,12,15,13,13,15,12,13,14,12,12,14,10,12,14,15,14,12,11,15,14,8,13,13,20,15,14,14,12,14,8,9,14,15,14,10,14,15,10,6,Vicente Iborra,ÃÂ£1.80m ,LaLiga
19/6/2011,TomÃ¡s RincÃ³n,86000589,1658,1/13/1988,23,38,0,6,0,5500,6600,6400,135,124,741109,175,71,DM/M C,1,1,2,2,1,3,1,5,2,1,1,5,9,10,5,12,5,9,8,15,19,11,7,17,12,19,8,18,9,14,7,7,18,5,11,8,9,17,19,14,15,16,11,10,13,13,20,17,13,10,10,8,11,14,12,10,14,15,17,10,8,6,14,10,18,1,14,1,18,DM/M C,311,1,1,1,1,1,1,1,1,14,20,18,1,10,1,10,138513000000.0,0,0,0,0,0,0,1,0,0,0,0,0,0,0,0,1,0,0,0,0,0,0,0,0,0,0,0,0,0,0,1,0,0,0,0,0,0,1,0,0,0,0,0,0,0,0,0,0,TomÃ¡s RincÃ³n,Â£3.60m ,32.0,177.0,Midfielder - Defensive Midfield,right,Torino FC,21.0,0.0,0.0,1268.0,29.0,0.0,1.0,2202.0,20.0,0.0,0.0,933.0,26.0,0.0,0.0,1775.0,31.0,0.0,2.0,2521.0,34.0,3.0,4.0,3050.0,36.0,0.0,4.0,2093.0,38.0,1.0,0.0,3110.0,37.0,4.0,0.0,2994.0,Bundesliga,39.0,1.0,4.0,3107.0,4.0,0.0,1.0,349.0,29/6/2010,TomÃ¡s RincÃ³n,86000589,1658,1/13/1988,22,19,0,8,1,2600,4949,4250,135,110,2048679,175,71,DM C,1,2,2,1,1,2,1,5,1,1,1,9,9,13,11,13,9,9,13,7,13,13,9,13,13,7,13,10,12,9,12,13,10,5,14,9,13,10,13,8,13,13,3,10,8,13,20,10,7,10,5,4,5,10,11,5,13,11,2,8,4,6,TomÃÂ¡s RincÃÂ³n,ÃÂ£1.80m ,Bundesliga
19/6/2011,Steven Defour,8163457,757,4/15/1988,23,29,1,0,0,6400,6750,6750,155,135,4263203,174,69,DM/M C,3,2,3,2,3,2,3,2,2,3,1,15,13,11,8,14,12,6,11,5,6,16,15,8,14,18,13,16,13,17,17,15,18,14,19,10,14,19,19,12,12,9,7,10,18,13,20,18,10,17,7,14,14,10,12,18,13,12,15,8,12,15,1,1,19,14,11,10,19,DM/M C,311,1,1,10,14,10,11,1,1,1,20,19,10,11,1,1,17956928.0,0,0,0,0,0,0,1,0,0,0,0,0,0,0,0,0,0,1,0,0,1,0,0,0,1,0,0,0,0,0,0,0,0,0,0,0,0,0,0,0,0,0,0,0,0,0,0,0,Steven Defour,Â£9.90m ,32.0,175.0,Midfielder - Central Midfield,right,KV Mechelen,32.0,3.0,10.0,2623.0,38.0,2.0,2.0,1789.0,40.0,4.0,2.0,2179.0,36.0,1.0,4.0,2508.0,39.0,7.0,9.0,3003.0,42.0,3.0,10.0,3616.0,28.0,3.0,5.0,1632.0,25.0,1.0,1.0,2009.0,9.0,0.0,0.0,681.0,Liga NOS,12.0,0.0,1.0,736.0,0.0,0.0,0.0,0.0
19/6/2011,StÃ©nio,55038353,12,5/6/1988,23,0,0,0,0,1020,4500,3500,104,93,33212,182,85,DM/M C,2,2,3,2,1,2,2,6,1,3,2,9,6,11,8,13,9,9,12,2,11,12,9,11,13,13,12,4,11,9,10,12,8,4,3,12,13,12,13,13,10,11,11,8,4,10,20,8,4,10,11,10,10,10,5,18,8,13,15,18,5,9,1,1,20,7,7,1,20,DM/M C,421,1,1,1,7,1,1,1,1,1,18,20,1,7,1,1,0.0,0,0,0,0,0,0,0,0,0,0,0,0,0,0,0,0,0,0,0,0,0,0,0,0,0,0,0,0,0,0,0,0,0,0,0,0,0,0,0,0,0,0,0,0,0,0,0,0,Stenio,Â£720Th. ,32.0,179.0,Midfielder - Central Midfield,right,UD SantarÃ©m,4.0,0.0,0.0,227.0,25.0,0.0,0.0,1620.0,33.0,3.0,1.0,2657.0,33.0,2.0,0.0,2206.0,34.0,6.0,1.0,2911.0,32.0,2.0,0.0,2384.0,30.0,1.0,0.0,2323.0,11.0,2.0,1.0,754.0,nan,nan,nan,nan,Liga NOS,nan,nan,nan,nan,nan,nan,nan,nan
19/6/2011,Roman NeustÃ¤dter,91002404,771,2/18/1988,23,0,0,2,1,3750,6300,6300,137,116,264449,190,83,D/DM/M C,1,3,3,3,2,3,3,4,2,3,3,5,8,11,6,7,5,13,6,14,16,8,5,17,9,15,13,17,7,10,10,7,13,5,12,8,15,16,18,8,13,14,17,10,11,14,20,18,15,11,5,11,5,14,13,1,11,9,11,11,10,8,16,1,18,1,1,1,18,D/DM/M C,331,1,1,1,1,1,1,16,1,1,20,18,1,1,1,1,0.0,0,0,0,0,0,0,0,0,0,0,0,0,0,0,0,0,0,0,0,0,0,0,0,0,0,0,0,0,0,0,0,0,0,0,0,0,0,0,0,0,0,0,0,0,0,0,0,0,Roman NeustÃ¤dter,Â£3.15m ,32.0,188.0,Midfielder - Defensive Midfield,right,Dynamo Moscow,28.0,1.0,1.0,2058.0,38.0,0.0,2.0,3429.0,41.0,4.0,2.0,3503.0,44.0,2.0,5.0,3553.0,38.0,2.0,0.0,3192.0,38.0,0.0,1.0,3034.0,33.0,0.0,1.0,2019.0,44.0,5.0,0.0,3884.0,31.0,2.0,0.0,2685.0,Bundesliga,21.0,0.0,1.0,1742.0,2.0,0.0,0.0,102.0,29/6/2010,Roman NeustÃ¤dter,91002404,771,2/18/1988,22,0,0,2,1,1650,5500,5500,135,107,2028538,190,83,D/DM C,3,1,3,3,2,2,3,3,1,2,3,5,4,6,11,6,4,15,7,12,13,11,5,13,12,8,11,12,10,12,5,13,10,4,14,5,13,10,9,12,12,14,17,5,11,11,20,13,14,11,5,11,5,7,9,17,18,6,12,17,13,8,Roman NeustÃÂ¤dter,ÃÂ£1.13m ,Bundesliga
19/6/2011,Radja Nainggolan,8169332,757,5/4/1988,23,1,0,10,1,5000,6461,7250,166,143,2516699,175,65,DM/M/AM C,2,2,3,2,2,2,3,2,1,2,3,8,10,12,12,12,11,9,14,10,13,14,10,16,14,18,15,18,13,15,11,14,20,11,14,13,13,16,15,13,14,15,7,9,15,13,20,17,16,16,15,15,9,20,16,14,16,16,17,15,12,14,1,1,20,18,14,14,20,DM/M/AM C,431,1,1,1,18,13,13,1,1,1,16,20,14,14,1,1,279173000000.0,0,0,0,0,0,0,0,0,0,0,0,0,0,0,0,1,0,0,0,0,0,0,0,0,0,0,0,0,0,0,0,0,1,0,0,0,0,0,1,0,0,0,0,0,0,0,0,0,Radja Nainggolan,Â£11.70m ,32.0,176.0,Midfielder - Attacking Midfield,right,Inter Milan,38.0,2.0,2.0,2981.0,39.0,1.0,2.0,3364.0,35.0,2.0,2.0,3064.0,38.0,4.0,3.0,3282.0,46.0,5.0,6.0,3714.0,42.0,6.0,2.0,3525.0,53.0,14.0,6.0,4229.0,42.0,6.0,11.0,3580.0,36.0,7.0,3.0,2443.0,Serie A,29.0,6.0,7.0,2279.0,2.0,0.0,0.0,26.0,29/6/2010,Radja Nainggolan,8169332,757,5/4/1988,22,1,0,8,1,3250,5579,5600,141,124,371958,175,65,M/AM RLC,3,3,2,3,3,3,1,7,1,1,2,4,11,13,10,12,12,8,12,8,11,14,11,14,14,15,13,13,11,12,10,13,9,12,10,11,10,12,14,14,14,14,7,5,15,13,20,15,14,15,15,11,11,20,7,14,7,10,11,11,10,13,Radja Nainggolan,ÃÂ£4.50m ,Serie A
19/6/2011,Pierre de Wit,8728369,771,9/26/1987,23,0,0,0,0,2360,6150,6150,137,123,508237,172,72,DM/M/AM C,1,1,3,2,1,3,1,2,3,1,2,13,14,12,11,14,12,6,12,4,4,15,12,7,15,11,14,13,9,12,13,12,14,13,9,12,4,12,12,13,13,8,7,16,12,13,20,12,9,12,6,11,15,14,11,15,12,12,15,13,11,8,1,1,20,17,13,13,20,DM/M/AM C,431,1,1,1,17,13,13,1,1,1,18,20,13,13,1,1,3072.0,0,0,0,0,0,0,0,0,0,0,1,1,0,0,0,0,0,0,0,0,0,0,0,0,0,0,0,0,0,0,0,0,0,0,0,0,0,0,0,0,0,0,0,0,0,0,0,0,Pierre De Wit,Â£1.35m ,33.0,171.0,Midfielder - Central Midfield,both,Retired,17.0,0.0,2.0,952.0,28.0,3.0,1.0,1981.0,8.0,0.0,0.0,587.0,39.0,4.0,11.0,3364.0,14.0,0.0,0.0,714.0,2.0,0.0,0.0,92.0,nan,nan,nan,nan,nan,nan,nan,nan,nan,nan,nan,nan,Bundesliga,nan,nan,nan,nan,nan,nan,nan,nan,29/6/2010,Pierre de Wit,8728369,771,9/26/1987,22,0,0,0,0,2300,6000,6000,137,120,1955347,172,70,DM/M C,1,2,2,3,2,3,2,3,3,1,3,13,14,12,11,15,12,6,13,4,4,15,12,7,15,11,14,14,9,12,13,10,14,13,9,12,4,12,12,14,13,8,8,16,12,13,20,12,9,13,6,11,17,15,11,15,12,12,15,13,11,8,Pierre De Wit,ÃÂ£675Th. ,Bundesliga
19/6/2011,Nuno Coelho,55002940,788,11/23/1987,23,0,0,3,1,1770,5533,5500,130,113,89707,181,73,DM ,3,2,1,1,2,2,1,3,1,1,2,10,10,10,10,12,6,13,10,10,13,12,10,12,11,12,14,11,15,15,12,12,14,8,11,10,15,16,14,12,12,11,12,7,12,12,20,12,12,12,9,10,7,14,6,12,16,13,16,16,16,5,1,1,9,1,1,1,9,DM ,300,1,1,1,1,1,1,1,1,1,20,9,1,1,1,1,0.0,0,0,0,0,0,0,0,0,0,0,0,0,0,0,0,0,0,0,0,0,0,0,0,0,0,0,0,0,0,0,0,0,0,0,0,0,0,0,0,0,0,0,0,0,0,0,0,0,Nuno Coelho,Â£1.35m ,32.0,183.0,Defender - Centre-Back,right,GD Chaves,20.0,0.0,0.0,1606.0,25.0,0.0,0.0,2203.0,27.0,2.0,0.0,2331.0,29.0,0.0,0.0,2384.0,35.0,1.0,1.0,2805.0,36.0,2.0,2.0,3177.0,35.0,1.0,0.0,2867.0,36.0,6.0,0.0,3194.0,28.0,1.0,1.0,2185.0,Liga NOS,35.0,0.0,0.0,3032.0,5.0,0.0,0.0,450.0,29/6/2010,Nuno Coelho,55002940,788,11/23/1987,22,0,0,3,1,1750,5500,5500,133,113,702972,181,73,DM C,2,3,1,1,3,1,1,4,1,1,1,10,10,10,10,12,9,13,10,10,13,12,10,12,11,12,14,11,15,15,12,12,14,8,11,10,15,16,14,12,12,11,12,7,12,12,20,12,12,12,9,10,7,14,6,12,16,13,16,16,16,5,Nuno Coelho,ÃÂ£1.35m ,Liga NOS
19/6/2011,Michael Bradley,980486,390,7/31/1987,23,59,9,25,5,6500,6550,6500,145,130,379447,185,82,DM/M C,1,1,1,1,1,1,1,1,1,1,1,6,9,7,15,11,10,12,13,9,17,11,13,14,10,17,17,18,9,9,10,8,17,6,13,16,11,18,19,8,10,14,14,12,16,16,20,19,13,10,14,17,12,13,15,18,8,12,19,9,7,4,1,1,20,14,8,8,20,DM/M C,421,1,1,1,14,1,1,1,1,1,17,20,8,8,1,1,139586000000.0,0,0,0,0,0,1,1,0,0,0,0,0,0,0,0,1,0,0,0,0,0,0,0,0,0,0,0,0,0,0,0,1,0,0,0,0,0,1,0,0,0,0,0,0,0,0,0,0,Michael Bradley,Â£3.15m ,33.0,189.0,Midfielder - Central Midfield,right,Toronto FC,27.0,4.0,3.0,2030.0,36.0,1.0,1.0,3043.0,35.0,1.0,2.0,2682.0,38.0,4.0,1.0,2963.0,28.0,5.0,3.0,2504.0,30.0,2.0,4.0,2760.0,38.0,0.0,3.0,3420.0,43.0,0.0,4.0,3847.0,35.0,3.0,1.0,3152.0,Serie A,10.0,0.0,0.0,880.0,nan,nan,nan,nan,29/6/2010,Michael Bradley,980486,390,7/31/1987,22,48,8,25,5,4422,6100,6650,154,133,6625405,186,84,DM/M C,1,1,1,1,1,1,1,1,1,1,1,6,8,7,15,10,11,12,14,8,17,11,12,14,10,17,17,18,9,9,12,8,17,6,12,16,13,18,19,8,10,14,14,12,16,16,20,19,13,10,14,14,12,13,15,17,9,12,18,10,7,4,Michael Bradley,ÃÂ£4.50m ,Premier League
19/6/2011,Mauricio Isla,75000523,1652,6/12/1988,23,24,1,1,0,4700,7450,7450,164,150,2330937,175,72,D/WB/DM/M RC,2,3,1,2,2,3,2,3,2,1,3,7,10,14,8,14,6,6,7,7,11,13,10,15,12,18,16,16,12,15,14,12,15,10,13,17,12,17,18,15,14,14,6,9,15,15,20,18,11,14,12,13,3,19,17,15,13,13,12,12,9,6,16,20,17,1,20,7,17,D/WB/DM/M RC,243,1,1,1,1,1,1,1,1,16,17,17,1,14,7,20,1048608.0,0,0,0,0,0,1,0,0,0,0,0,0,0,0,0,0,0,0,0,0,1,0,0,0,0,0,0,0,0,0,0,0,0,0,0,0,0,0,0,0,0,0,0,0,0,0,0,0,Mauricio Isla,Â£12.60m ,32.0,176.0,Defender - Right-Back,right,Clube de Regatas do Flamengo,35.0,3.0,7.0,2938.0,28.0,3.0,2.0,2239.0,21.0,0.0,3.0,1302.0,27.0,0.0,2.0,1582.0,27.0,0.0,2.0,2161.0,39.0,2.0,2.0,3125.0,35.0,1.0,8.0,2958.0,29.0,0.0,3.0,1942.0,37.0,0.0,7.0,3001.0,Serie A,37.0,0.0,7.0,2900.0,nan,nan,nan,nan,29/6/2010,Mauricio Isla,75000523,1652,6/12/1988,22,16,0,1,0,4500,6950,6950,167,139,36277081,175,72,D/WB/DM/M RC,3,2,3,1,3,3,3,8,2,3,3,7,8,14,8,12,6,6,7,7,10,11,10,14,13,18,16,15,9,14,13,12,15,10,14,15,11,16,18,15,14,14,6,9,15,15,20,18,9,14,12,13,3,20,17,15,11,12,12,12,9,6,Mauricio Isla,ÃÂ£9.00m ,Serie A
19/6/2011,Mato Jajalo,24004081,761,5/25/1988,23,0,0,28,5,4000,5759,6400,145,128,710790,182,77,M RC,1,2,2,1,2,3,3,1,3,1,2,11,11,13,10,13,10,12,15,11,10,13,10,12,14,12,12,13,10,13,15,11,12,12,10,12,10,14,14,12,14,14,12,8,16,13,20,14,14,14,4,14,3,12,13,12,12,12,13,14,12,6,5,9,20,10,15,12,20,M RC,403,1,1,3,10,6,6,5,3,3,15,20,12,15,7,9,0.0,0,0,0,0,0,0,0,0,0,0,0,0,0,0,0,0,0,0,0,0,0,0,0,0,0,0,0,0,0,0,0,0,0,0,0,0,0,0,0,0,0,0,0,0,0,0,0,0,Mato Jajalo,Â£2.03m ,32.0,182.0,Midfielder - Defensive Midfield,right,Udinese Calcio,33.0,2.0,4.0,2423.0,33.0,5.0,2.0,2420.0,26.0,0.0,3.0,1364.0,21.0,1.0,5.0,1523.0,48.0,3.0,9.0,3507.0,29.0,0.0,1.0,2124.0,26.0,1.0,1.0,1861.0,41.0,1.0,5.0,3368.0,35.0,3.0,3.0,3103.0,Bundesliga,28.0,0.0,0.0,1831.0,nan,nan,nan,nan,29/6/2010,Mato Jajalo,24004081,761,5/25/1988,22,0,0,25,3,3750,5579,6150,136,124,3199999,182,77,M C,2,1,1,1,3,3,3,2,1,2,2,11,11,14,9,12,8,12,13,7,8,13,10,11,13,12,12,13,10,13,14,12,9,11,10,12,10,14,14,12,14,14,12,8,16,13,20,14,14,14,4,14,3,10,11,13,10,8,3,7,14,14,Mato Jajalo,ÃÂ£2.25m ,Bundesliga
19/6/2011,Marouane Fellaini,8170873,757,11/22/1987,23,27,4,8,0,7000,7500,7500,172,160,3894595,194,85,DM/M C,1,1,3,3,3,2,2,1,1,1,3,9,9,13,13,15,8,19,10,12,12,15,12,13,15,16,16,18,16,16,12,13,17,10,5,14,16,18,18,9,13,18,17,14,16,12,20,17,19,17,15,14,5,12,12,15,9,13,14,6,5,9,1,1,18,10,1,1,18,DM/M C,311,1,1,1,10,1,1,1,1,1,20,18,1,1,1,1,274878000000.0,0,0,0,0,0,0,0,0,0,0,0,0,0,0,0,0,0,1,0,0,0,0,0,0,0,0,0,0,0,0,0,0,0,0,0,0,0,0,1,0,0,0,0,0,0,0,0,0,Marouane Fellaini,Â£18.00m ,32.0,194.0,Midfielder - Central Midfield,right,Shandong Luneng Taishan,25.0,3.0,3.0,2147.0,43.0,5.0,7.0,3726.0,36.0,12.0,8.0,3213.0,25.0,1.0,4.0,1725.0,31.0,7.0,1.0,2165.0,35.0,5.0,4.0,2301.0,47.0,4.0,2.0,2651.0,23.0,5.0,1.0,878.0,55.0,14.0,7.0,4108.0,Premier League,14.0,4.0,0.0,1034.0,nan,nan,nan,nan,29/6/2010,Marouane Fellaini,8170873,757,11/22/1987,22,21,3,8,0,5700,7100,7100,166,151,12414558,194,85,DM/M C,2,3,2,2,2,1,1,3,1,3,3,9,9,12,13,14,8,19,10,12,12,15,12,13,15,16,16,18,15,16,12,12,17,10,5,16,15,18,17,9,13,18,17,10,15,12,20,17,19,16,15,14,5,12,12,14,7,10,14,6,5,13,Marouane Fellaini,ÃÂ£17.10m ,Premier League
19/6/2011,Marcel Gecov,5653961,763,1/1/1988,23,0,0,13,1,2083,6000,6000,140,120,409091,180,70,DM C,2,3,3,1,3,1,3,3,2,1,3,8,8,14,10,13,10,9,8,5,10,15,12,8,14,7,10,9,9,12,15,11,8,13,16,13,11,8,14,15,11,9,9,11,6,15,20,16,11,12,10,12,12,10,14,8,10,6,10,10,10,2,1,1,15,10,1,1,15,DM C,301,1,1,1,10,1,1,1,1,1,20,15,1,1,1,1,4194304.0,0,0,0,0,0,0,0,0,0,0,0,0,0,0,0,0,0,0,0,0,0,0,1,0,0,0,0,0,0,0,0,0,0,0,0,0,0,0,0,0,0,0,0,0,0,0,0,0,Marcel Gecov,Â£450Th. ,32.0,183.0,Midfielder - Central Midfield,right,Retired,25.0,1.0,1.0,2089.0,12.0,0.0,0.0,845.0,21.0,2.0,1.0,1372.0,30.0,1.0,0.0,2435.0,25.0,3.0,1.0,1966.0,28.0,1.0,0.0,1928.0,nan,nan,nan,nan,nan,nan,nan,nan,nan,nan,nan,nan,Premier League,nan,nan,nan,nan,nan,nan,nan,nan
19/6/2011,Marc Wilson,5114764,789,8/17/1987,23,1,0,0,0,4417,6275,6650,146,130,1636364,188,80,DM/M RC,2,1,1,2,3,3,1,2,1,1,1,12,15,11,8,13,14,12,8,6,8,14,16,12,12,14,12,12,15,12,14,13,16,10,13,10,12,10,14,11,10,14,14,17,14,12,20,14,13,14,8,11,7,12,14,12,15,10,12,9,9,14,15,8,18,1,15,12,18,DM/M RC,313,1,1,1,1,1,1,15,12,15,20,18,8,8,8,8,149538000000000.0,0,0,0,0,0,0,0,0,0,0,0,0,0,0,0,0,0,0,0,0,0,0,1,0,0,0,0,0,0,0,0,0,1,0,0,0,0,0,0,0,0,0,0,1,0,0,0,1,Marc Wilson,Â£4.50m ,33.0,188.0,Defender - Centre-Back,both,Retired,41.0,1.0,2.0,2942.0,45.0,0.0,1.0,3801.0,20.0,0.0,0.0,1611.0,38.0,0.0,0.0,3121.0,30.0,0.0,1.0,2394.0,11.0,1.0,0.0,929.0,8.0,1.0,0.0,526.0,22.0,0.0,0.0,1779.0,17.0,0.0,0.0,1267.0,Premier League,nan,nan,nan,nan,nan,nan,nan,nan,29/6/2010,Marc Wilson,5114764,789,8/17/1987,22,0,0,0,0,3844,6000,6350,146,124,10350000,188,80,DM/M C,2,3,3,2,1,3,1,1,2,2,3,12,15,11,8,13,14,12,8,6,8,15,16,10,11,14,12,12,15,12,13,13,16,10,13,10,12,9,14,11,10,14,14,17,14,12,20,14,13,12,8,11,7,12,14,12,15,10,12,9,9,14,Marc Wilson,ÃÂ£2.70m ,Premier League
19/6/2011,Mamadou Bah,85000951,22,4/25/1988,23,18,3,0,0,3500,5850,5278,138,117,412196,183,75,DM/M C,2,2,2,1,1,2,3,1,2,1,2,5,7,10,8,12,8,13,12,7,12,13,7,10,12,12,15,13,11,11,12,10,14,11,8,11,11,12,15,14,12,15,11,8,13,12,20,14,15,12,12,14,7,10,9,15,12,12,9,12,12,7,12,1,18,12,1,10,18,DM/M C,311,1,1,1,12,10,1,12,1,1,20,18,10,1,1,1,260.0,0,0,1,0,0,0,0,0,1,0,0,0,0,0,0,0,0,0,0,0,0,0,0,0,0,0,0,0,0,0,0,0,0,0,0,0,0,0,0,0,0,0,0,0,0,0,0,0,Mamadou Bah,Â£450Th. ,32.0,181.0,Midfielder - Defensive Midfield,left,US Raon-l'Ãtape,9.0,0.0,0.0,706.0,3.0,0.0,0.0,11.0,1.0,0.0,0.0,21.0,17.0,1.0,0.0,1423.0,1.0,0.0,0.0,21.0,nan,nan,nan,nan,nan,nan,nan,nan,nan,nan,nan,nan,1.0,0.0,0.0,54.0,Bundesliga,1.0,0.0,0.0,90.0,nan,nan,nan,nan
19/6/2011,Luiz Gustavo,19016523,1651,7/23/1987,23,0,0,0,0,6500,7000,7750,162,148,36363636,187,80,DM/M C,2,2,3,1,3,1,3,6,1,1,3,8,11,9,5,12,5,8,10,12,18,13,6,18,13,16,17,18,8,10,9,12,16,8,10,8,13,17,18,14,13,16,12,20,14,17,12,17,13,11,15,12,7,18,12,14,8,5,13,6,7,10,14,14,18,1,1,14,18,DM/M C,311,1,1,1,1,1,1,12,14,1,20,18,1,1,14,1,33718592.0,0,0,0,0,0,0,1,0,1,0,0,0,0,0,0,1,0,1,0,0,0,0,0,0,0,1,0,0,0,0,0,0,0,0,0,0,0,0,0,0,0,0,0,0,0,0,0,0,Luiz Gustavo,Â£13.50m ,33.0,187.0,Midfielder - Defensive Midfield,left,Fenerbahce SK,38.0,3.0,5.0,3174.0,46.0,1.0,2.0,3112.0,36.0,4.0,1.0,2039.0,33.0,4.0,3.0,2903.0,47.0,7.0,1.0,4058.0,30.0,1.0,3.0,2529.0,32.0,0.0,0.0,2794.0,57.0,6.0,2.0,4961.0,38.0,4.0,0.0,3117.0,Bundesliga,35.0,3.0,1.0,3023.0,6.0,0.0,0.0,527.0,29/6/2010,Luiz Gustavo,19016523,1651,7/23/1987,22,0,0,0,0,3500,6389,7050,160,142,6018978,187,80,DM/M C,2,3,3,1,2,1,1,1,1,3,2,6,9,10,4,13,6,10,7,11,16,15,8,12,14,19,17,18,9,8,14,14,16,8,11,10,12,15,18,13,16,12,13,20,14,17,12,17,10,12,17,12,7,15,12,14,8,12,13,6,3,10,Luiz Gustavo,ÃÂ£13.50m ,Bundesliga
19/6/2011,Lee Cattermole,5123105,765,3/21/1988,23,0,0,16,3,4650,6800,6800,145,136,4052344,178,77,M C,2,1,1,1,2,3,1,10,3,2,1,7,10,12,8,14,12,13,10,10,15,14,6,13,13,20,15,20,13,10,14,12,16,6,17,10,12,18,17,12,10,13,9,12,10,11,20,15,14,11,20,9,15,5,5,14,12,9,9,9,4,15,1,1,20,1,5,1,20,M C,401,1,1,1,1,1,1,1,1,1,15,20,1,5,1,1,2336460000000.0,0,0,0,0,0,0,0,0,0,0,0,0,0,0,0,0,1,0,0,0,0,0,0,0,0,0,0,0,0,0,0,0,0,0,0,0,0,1,0,0,0,1,0,0,0,0,0,0,Lee Cattermole,Â£5.40m ,32.0,178.0,Midfielder - Defensive Midfield,right,Retired,24.0,0.0,0.0,2012.0,28.0,0.0,0.0,2292.0,14.0,0.0,0.0,878.0,33.0,1.0,1.0,2514.0,28.0,1.0,0.0,2358.0,34.0,0.0,0.0,2407.0,9.0,0.0,0.0,661.0,35.0,1.0,6.0,3032.0,36.0,7.0,1.0,3065.0,Premier League,13.0,0.0,0.0,898.0,nan,nan,nan,nan,29/6/2010,Lee Cattermole,5123105,765,3/21/1988,22,0,0,16,3,4650,7050,7050,160,140,21905811,178,77,M C,3,1,2,2,1,3,3,4,3,2,3,10,10,12,12,13,13,13,12,10,15,13,6,15,13,20,14,20,13,12,13,11,18,10,16,10,13,18,18,12,10,13,9,12,18,11,20,16,14,10,20,12,14,13,6,14,12,11,9,9,4,15,Lee Cattermole,ÃÂ£5.40m ,Premier League
19/6/2011,Julian Baumgartlinger,5607656,755,1/2/1988,23,13,0,17,1,3900,6000,6000,147,128,343053,183,80,DM/M C,3,1,3,2,2,1,1,2,3,3,2,5,6,10,6,12,8,14,9,8,14,11,5,16,11,12,10,16,11,10,9,9,16,9,17,16,13,17,18,13,13,13,12,16,14,13,20,14,14,14,8,10,13,13,13,15,6,10,15,16,11,4,1,1,20,1,1,1,20,DM/M C,311,1,1,1,1,1,1,1,1,1,20,20,1,1,1,1,1073741888.0,0,0,0,0,0,0,1,0,0,0,0,0,0,0,0,0,0,0,0,0,0,0,0,0,0,0,0,0,0,0,1,0,0,0,0,0,0,0,0,0,0,0,0,0,0,0,0,0,Julian Baumgartlinger,Â£2.25m ,32.0,184.0,Midfielder - Defensive Midfield,right,Bayer 04 Leverkusen,40.0,3.0,8.0,3219.0,30.0,0.0,5.0,1790.0,36.0,1.0,2.0,3167.0,12.0,1.0,1.0,760.0,28.0,0.0,0.0,2459.0,33.0,2.0,1.0,2897.0,30.0,0.0,2.0,2036.0,24.0,1.0,0.0,1577.0,27.0,0.0,1.0,1955.0,Bundesliga,40.0,2.0,2.0,2404.0,5.0,0.0,1.0,167.0
19/6/2011,Juan ForlÃ­n,962963,1649,1/10/1988,23,0,0,11,0,4800,6264,6750,150,136,1118009,180,72,D/DM C,2,1,2,1,2,1,1,4,2,3,3,4,9,8,8,13,8,14,9,10,14,13,12,15,14,17,12,16,14,13,12,11,17,8,12,8,15,14,14,15,14,14,12,6,8,14,20,15,13,13,15,13,13,12,14,15,14,16,14,14,13,11,20,1,11,1,1,1,20,D/DM C,111,1,14,1,1,1,1,20,1,1,18,11,1,1,1,1,0.0,0,0,0,0,0,0,0,0,0,0,0,0,0,0,0,0,0,0,0,0,0,0,0,0,0,0,0,0,0,0,0,0,0,0,0,0,0,0,0,0,0,0,0,0,0,0,0,0,Juan ForlÃ­n,Â£3.60m ,32.0,180.0,Defender - Centre-Back,right,JÃºbilo Iwata,25.0,0.0,0.0,2055.0,33.0,0.0,1.0,2691.0,35.0,0.0,1.0,2947.0,31.0,1.0,0.0,2741.0,5.0,0.0,0.0,404.0,24.0,1.0,0.0,2011.0,25.0,1.0,1.0,2225.0,34.0,2.0,1.0,2828.0,14.0,0.0,1.0,1147.0,LaLiga,0.0,0.0,0.0,0.0,nan,nan,nan,nan,29/6/2010,Juan ForlÃ­n,962963,1649,1/10/1988,22,0,0,11,0,4500,6250,6750,160,136,8000000,180,72,D/DM C,3,3,2,1,3,2,1,6,3,3,2,4,9,8,8,12,8,14,9,10,14,13,12,15,14,14,12,15,14,13,12,11,17,8,12,8,15,14,14,15,14,13,12,6,12,14,20,16,13,13,10,13,12,11,14,15,14,16,14,14,13,11,Juan ForlÃÂ­n,ÃÂ£3.15m ,LaLiga
19/6/2011,Johannes Flum,35007722,771,12/14/1987,23,0,0,0,0,3900,6250,6250,150,128,541185,190,78,DM/M C,1,3,2,3,1,1,1,5,2,1,2,8,7,10,11,11,12,13,12,9,13,13,9,14,12,10,13,12,12,13,12,11,12,7,8,10,13,14,14,12,10,14,13,14,15,13,20,15,13,8,5,13,9,11,11,11,13,9,12,13,10,9,9,1,20,14,1,1,20,DM/M C,421,1,1,1,14,1,1,9,1,1,17,20,1,1,1,1,524352.0,0,0,0,0,0,0,1,0,0,0,0,0,0,0,0,0,0,0,0,1,0,0,0,0,0,0,0,0,0,0,0,0,0,0,0,0,0,0,0,0,0,0,0,0,0,0,0,0,Johannes Flum,Â£3.60m ,32.0,190.0,Midfielder - Central Midfield,right,SC Freiburg II,14.0,3.0,0.0,1024.0,30.0,3.0,5.0,2488.0,30.0,2.0,0.0,1341.0,40.0,3.0,2.0,3087.0,8.0,0.0,0.0,157.0,6.0,0.0,2.0,167.0,11.0,0.0,0.0,640.0,30.0,4.0,2.0,1869.0,22.0,1.0,1.0,1630.0,Bundesliga,18.0,0.0,0.0,821.0,9.0,2.0,1.0,702.0,29/6/2010,Johannes Flum,35007722,771,12/14/1987,22,0,0,0,0,3850,6250,6250,150,129,3530450,188,78,DM/M C,1,2,2,2,2,3,3,3,3,1,1,8,7,10,11,11,12,13,12,9,13,14,9,14,12,10,13,12,12,13,12,11,12,7,8,10,13,14,14,12,10,14,13,14,15,13,20,15,13,8,5,13,9,11,11,11,13,9,12,13,10,9,Johannes Flum,ÃÂ£1.80m ,Bundesliga
19/6/2011,Jens Hegeler,92001113,771,1/21/1988,23,0,0,4,0,4700,6450,6200,146,129,332726,193,85,DM/M/AM RLC,2,1,3,3,3,1,2,4,1,3,3,4,12,12,9,11,7,14,9,6,13,12,8,14,11,12,13,12,11,14,11,14,14,8,9,11,14,14,15,13,10,14,16,9,13,13,20,15,14,16,4,13,4,15,10,12,13,12,14,15,18,2,1,1,20,18,19,15,20,DM/M/AM RLC,436,1,1,1,14,14,18,1,1,1,18,20,15,19,1,1,0.0,0,0,0,0,0,0,0,0,0,0,0,0,0,0,0,0,0,0,0,0,0,0,0,0,0,0,0,0,0,0,0,0,0,0,0,0,0,0,0,0,0,0,0,0,0,0,0,0,Jens Hegeler,Â£1.80m ,32.0,193.0,Midfielder - Central Midfield,right,Career break,38.0,3.0,5.0,2745.0,35.0,1.0,2.0,2033.0,37.0,5.0,0.0,1534.0,26.0,1.0,3.0,878.0,27.0,1.0,1.0,1572.0,21.0,0.0,0.0,749.0,21.0,0.0,0.0,1162.0,7.0,1.0,0.0,478.0,0.0,0.0,0.0,0.0,Bundesliga,nan,nan,nan,nan,nan,nan,nan,nan,29/6/2010,Jens Hegeler,92001113,771,1/21/1988,22,0,0,0,0,2100,5900,5900,150,118,1231891,193,85,D/DM/M C,1,2,1,3,3,1,3,1,2,1,3,4,6,10,8,10,7,13,11,6,12,12,8,14,11,12,13,12,9,14,11,13,12,8,9,10,14,14,13,12,10,14,15,9,13,13,20,14,13,12,4,10,4,14,8,10,13,10,12,15,18,2,Jens Hegeler,ÃÂ£2.25m ,Bundesliga
19/6/2011,Gary Medel,75000560,1652,8/3/1987,23,31,3,0,0,5800,7250,7000,160,144,1441490,172,71,D/WB/DM/M RC,2,3,1,2,2,2,3,5,3,1,1,8,10,9,13,10,6,15,13,13,16,12,4,17,11,17,16,19,6,14,11,12,14,12,13,10,15,14,19,13,14,14,8,9,17,13,20,18,11,14,12,16,4,18,13,15,16,12,12,9,7,14,17,16,17,1,17,1,17,D/WB/DM/M RC,343,1,1,1,1,1,1,17,1,16,20,16,1,17,1,16,33088.0,0,0,0,0,0,0,1,0,1,0,0,0,0,0,0,1,0,0,0,0,0,0,0,0,0,0,0,0,0,0,0,0,0,0,0,0,0,0,0,0,0,0,0,0,0,0,0,0,Gary Medel,Â£5.40m ,33.0,171.0,Midfielder - Defensive Midfield,right,Bologna FC 1909,35.0,0.0,0.0,2866.0,37.0,2.0,0.0,3071.0,39.0,7.0,3.0,3226.0,35.0,0.0,1.0,2918.0,44.0,0.0,3.0,3739.0,34.0,1.0,3.0,2790.0,31.0,0.0,0.0,2576.0,40.0,1.0,2.0,3043.0,35.0,0.0,0.0,2826.0,LaLiga,26.0,0.0,0.0,2015.0,2.0,0.0,1.0,45.0
19/6/2011,Fran Rico,1511811,796,8/3/1987,23,0,0,0,0,3500,5500,5500,129,117,311866,178,71,M C,3,3,1,3,1,1,3,4,3,2,1,12,10,12,6,16,10,6,10,4,5,15,10,8,16,12,14,9,14,13,16,15,10,12,16,12,8,14,12,12,12,10,8,9,12,12,20,13,8,15,13,15,15,10,15,6,8,11,6,17,8,6,1,1,20,9,1,1,20,M C,401,1,1,1,9,1,1,1,1,1,15,20,1,1,1,1,4194304.0,0,0,0,0,0,0,0,0,0,0,0,0,0,0,0,0,0,0,0,0,0,0,1,0,0,0,0,0,0,0,0,0,0,0,0,0,0,0,0,0,0,0,0,0,0,0,0,0,Fran Rico,Â£900Th. ,33.0,178.0,Midfielder - Central Midfield,right,Retired,31.0,6.0,1.0,2641.0,20.0,2.0,1.0,1290.0,nan,nan,nan,nan,33.0,2.0,6.0,2561.0,32.0,3.0,1.0,2639.0,31.0,4.0,0.0,1638.0,22.0,2.0,1.0,1447.0,nan,nan,nan,nan,1.0,0.0,0.0,56.0,LaLiga,nan,nan,nan,nan,nan,nan,nan,nan
19/6/2011,Fernando,2115577,1651,7/25/1987,23,0,0,0,0,4000,6681,7400,167,148,3530222,182,71,DM ,1,3,2,2,1,3,3,4,3,2,3,10,11,9,7,11,9,13,10,12,13,10,10,16,11,17,17,16,11,14,11,11,17,6,14,12,14,17,18,16,16,13,14,7,16,15,20,16,13,16,13,11,7,10,14,13,16,14,16,13,13,5,10,1,12,1,10,1,12,DM ,300,1,1,1,1,1,1,3,1,10,20,12,1,1,1,1,64.0,0,0,0,0,0,0,1,0,0,0,0,0,0,0,0,0,0,0,0,0,0,0,0,0,0,0,0,0,0,0,0,0,0,0,0,0,0,0,0,0,0,0,0,0,0,0,0,0,Fernando Gago,Â£5.85m ,34.0,177.0,Midfielder - Defensive Midfield,right,Club AtlÃ©tico VÃ©lez Sarsfield,7.0,0.0,0.0,193.0,32.0,1.0,3.0,2403.0,25.0,1.0,1.0,1747.0,26.0,0.0,5.0,2194.0,30.0,3.0,4.0,2297.0,18.0,1.0,0.0,1396.0,16.0,2.0,1.0,1434.0,11.0,0.0,0.0,660.0,8.0,0.0,0.0,720.0,Serie A,13.0,0.0,0.0,1034.0,nan,nan,nan,nan,29/6/2010,Fernando,2115577,1651,7/25/1987,22,0,0,0,0,4000,6524,7250,167,145,42061916,182,71,DM C,3,1,1,2,1,2,2,8,2,3,1,10,11,10,7,11,10,13,10,12,13,10,10,16,12,17,15,16,11,13,11,12,17,6,12,11,14,16,18,16,15,13,14,7,16,15,20,15,13,14,13,11,7,13,14,13,16,14,16,13,13,5,Fernando,ÃÂ£1.80m ,LaLiga
19/6/2011,Felipe Seymour,75003077,1652,7/23/1987,23,1,0,0,0,4000,6500,6500,140,130,546023,174,67,DM/M C,1,3,2,1,2,2,2,3,3,2,1,9,10,11,10,11,7,12,14,8,14,11,6,14,11,12,14,12,14,15,12,12,11,8,10,9,13,15,16,13,13,11,12,8,16,13,20,17,15,13,7,15,4,11,13,15,14,14,13,8,6,17,1,1,20,10,14,12,20,DM/M C,421,1,1,1,10,6,8,1,1,1,19,20,12,14,1,1,4294967296.0,0,0,0,0,0,0,0,0,0,0,0,0,0,0,0,0,0,0,0,0,0,0,0,0,0,0,0,0,0,0,0,0,1,0,0,0,0,0,0,0,0,0,0,0,0,0,0,0,Felipe Seymour,Â£1.17m ,33.0,174.0,Midfielder - Defensive Midfield,right,UniÃ³n La Calera,20.0,0.0,0.0,1673.0,28.0,1.0,0.0,1338.0,23.0,0.0,1.0,1244.0,33.0,1.0,2.0,2374.0,2.0,0.0,0.0,49.0,nan,nan,nan,nan,27.0,1.0,0.0,1845.0,21.0,1.0,0.0,1460.0,18.0,0.0,0.0,1319.0,Serie A,5.0,0.0,0.0,379.0,nan,nan,nan,nan
19/6/2011,Fabrice Muamba,5111919,765,4/6/1988,23,0,0,33,0,4750,6500,6600,140,130,834025,188,78,DM/M C,3,3,2,1,3,1,1,2,2,1,3,9,9,9,6,11,7,9,7,7,14,11,7,14,9,16,15,17,10,12,9,13,16,9,9,11,15,16,17,15,13,13,13,12,17,14,20,17,16,13,9,11,2,10,10,9,16,12,14,13,12,7,1,1,20,1,1,1,20,DM/M C,311,1,1,1,1,1,1,1,1,1,20,20,1,1,1,1,159049000000.0,0,0,0,0,0,0,0,0,0,0,0,0,0,0,0,0,0,0,0,1,0,0,0,0,0,0,0,1,0,0,0,0,1,0,1,0,0,1,0,0,0,0,0,0,0,0,0,0,Fabrice Muamba,Â£4.50m ,32.0,188.0,Midfielder - Central Midfield,right,Retired,41.0,1.0,2.0,2981.0,24.0,2.0,1.0,1605.0,nan,nan,nan,nan,nan,nan,nan,nan,nan,nan,nan,nan,nan,nan,nan,nan,nan,nan,nan,nan,nan,nan,nan,nan,nan,nan,nan,nan,Premier League,nan,nan,nan,nan,nan,nan,nan,nan,29/6/2010,Fabrice Muamba,5111919,765,4/6/1988,22,0,0,25,0,4096,6600,6600,140,128,4714915,188,75,DM/M C,1,3,3,2,2,1,3,1,1,3,2,9,9,9,6,10,7,9,7,7,14,11,7,14,9,16,15,17,9,12,9,12,16,9,9,11,15,16,17,15,13,13,13,12,17,14,20,17,16,13,9,11,2,10,10,9,16,12,14,13,12,7,Fabrice Muamba,ÃÂ£6.30m ,Premier League
19/6/2011,Fabian Lustenberger,69003477,798,5/2/1988,23,0,0,25,2,4250,6250,6250,147,126,519231,180,70,DM/M C,2,2,1,1,1,1,2,2,3,1,1,6,9,10,6,14,8,13,8,7,10,15,6,12,14,14,16,14,13,10,13,15,16,6,6,10,12,17,16,14,15,10,9,8,2,14,20,14,6,11,7,10,17,16,12,15,11,13,16,16,11,4,1,1,18,13,14,1,18,DM/M C,311,1,1,1,12,1,13,1,1,1,20,18,1,14,1,1,20971520.0,0,0,0,0,0,0,0,0,0,0,0,0,0,0,0,0,0,0,0,0,0,0,1,0,1,0,0,0,0,0,0,0,0,0,0,0,0,0,0,0,0,0,0,0,0,0,0,0,Fabian Lustenberger,Â£1.80m ,32.0,180.0,Defender - Centre-Back,right,BSC Young Boys,22.0,1.0,2.0,1633.0,19.0,1.0,1.0,1017.0,34.0,0.0,2.0,3021.0,21.0,0.0,0.0,1920.0,30.0,1.0,0.0,2489.0,34.0,1.0,0.0,2927.0,22.0,0.0,1.0,1717.0,29.0,0.0,0.0,2076.0,30.0,0.0,1.0,2185.0,Bundesliga,41.0,1.0,0.0,3293.0,9.0,0.0,0.0,810.0
19/6/2011,EfraÃ­n JuÃ¡rez,51000041,379,2/22/1988,23,35,1,4,1,4500,7150,6500,145,130,880925,178,68,WB/DM/M RC,1,2,3,1,2,3,3,1,3,2,2,5,9,10,6,11,5,6,9,5,13,12,11,13,14,13,12,12,13,12,11,13,14,13,13,12,8,14,13,17,13,13,9,10,14,15,20,15,12,15,11,16,4,18,14,16,12,15,10,12,12,6,15,19,16,1,19,1,16,WB/DM/M RC,333,1,1,1,1,1,1,1,1,15,20,16,1,14,1,19,32.0,0,0,0,0,0,1,0,0,0,0,0,0,0,0,0,0,0,0,0,0,0,0,0,0,0,0,0,0,0,0,0,0,0,0,0,0,0,0,0,0,0,0,0,0,0,0,0,0,EfraÃ­n JuÃ¡rez,Â£1.35m ,32.0,178.0,Defender - Right-Back,right,Retired,20.0,2.0,1.0,1144.0,16.0,1.0,1.0,1394.0,16.0,0.0,0.0,974.0,26.0,1.0,0.0,2138.0,30.0,0.0,1.0,2495.0,33.0,2.0,2.0,2820.0,28.0,1.0,0.0,1475.0,34.0,1.0,1.0,2406.0,21.0,0.0,4.0,1661.0,LaLiga,nan,nan,nan,nan,nan,nan,nan,nan
19/6/2011,Delvin Ndinga,85009997,49,3/14/1988,23,8,0,9,1,5500,6800,6100,150,136,1094171,181,70,DM ,1,3,3,1,3,2,1,7,3,2,2,6,8,11,6,13,6,15,10,6,13,12,7,14,13,12,16,14,13,15,12,11,14,7,7,11,15,16,17,14,14,15,11,8,15,12,20,16,15,13,13,16,5,8,14,16,14,14,15,15,15,6,1,1,14,10,8,1,14,DM ,300,1,1,1,10,1,1,1,1,1,20,14,1,8,1,1,4.0,0,0,1,0,0,0,0,0,0,0,0,0,0,0,0,0,0,0,0,0,0,0,0,0,0,0,0,0,0,0,0,0,0,0,0,0,0,0,0,0,0,0,0,0,0,0,0,0,Delvin N'Dinga,Â£4.50m ,32.0,181.0,Midfielder - Defensive Midfield,right,Without Club,35.0,0.0,2.0,2937.0,24.0,1.0,0.0,1953.0,27.0,0.0,0.0,1137.0,35.0,1.0,1.0,2036.0,28.0,2.0,1.0,1980.0,33.0,0.0,2.0,1948.0,11.0,0.0,1.0,756.0,29.0,2.0,0.0,2470.0,22.0,1.0,1.0,1749.0,Ligue 1,8.0,0.0,0.0,519.0,nan,nan,nan,nan,29/6/2010,Delvin Ndinga,85009997,49,3/14/1988,22,5,0,9,1,3100,5759,5750,150,128,4013460,181,70,DM C,1,3,1,1,3,2,3,1,3,3,1,6,8,9,6,12,6,15,8,6,9,11,7,14,13,12,16,14,13,15,12,10,14,7,7,11,15,16,17,14,15,14,10,8,15,12,20,16,16,13,13,16,5,8,14,16,14,14,15,15,15,6,Delvin N'Dinga,ÃÂ£4.05m ,Ligue 1
19/6/2011,Christian TrÃ¤sch,35003512,771,8/1/1987,23,7,0,0,0,6300,7450,7450,151,148,9172104,180,74,D/WB/DM/M RLC,1,3,1,1,2,2,3,1,2,2,3,9,14,11,6,7,9,6,15,15,18,9,9,17,7,16,15,17,9,17,7,12,13,5,14,7,13,19,18,15,10,10,11,16,17,13,20,19,11,18,4,15,6,18,9,7,12,5,15,11,13,9,18,17,19,1,18,16,19,D/WB/DM/M RLC,346,1,1,1,1,1,1,10,16,18,20,19,12,14,15,17,154619000000.0,0,0,0,0,0,0,1,0,0,1,0,0,0,0,0,1,0,0,0,0,0,0,0,0,0,0,0,0,0,0,0,0,0,0,1,0,0,1,0,0,0,0,0,0,0,0,0,0,Christian TrÃ¤sch,Â£6.30m ,33.0,180.0,Midfielder - Defensive Midfield,right,Retired,45.0,1.0,3.0,4005.0,34.0,0.0,5.0,2716.0,21.0,1.0,0.0,1079.0,26.0,0.0,2.0,2184.0,22.0,1.0,2.0,1376.0,38.0,0.0,3.0,2720.0,14.0,0.0,1.0,891.0,26.0,1.0,0.0,2166.0,11.0,0.0,0.0,758.0,Bundesliga,1.0,0.0,0.0,75.0,nan,nan,nan,nan,29/6/2010,Christian TrÃ¤sch,35003512,771,8/1/1987,22,1,0,0,0,2750,6850,6850,151,148,19298213,180,74,D/WB/DM/M RLC,3,2,2,3,1,3,3,1,3,1,2,9,12,8,6,7,9,6,15,15,17,10,9,17,7,16,15,17,9,17,8,12,13,5,12,9,13,19,18,15,10,10,11,16,17,13,20,18,11,18,4,15,6,18,10,17,10,10,12,14,2,2,Christian TrÃÂ¤sch,ÃÂ£9.00m ,Bundesliga
19/6/2011,Charles KaborÃ©,34013978,9,2/9/1988,23,26,2,0,0,5550,6900,6200,160,138,704117,181,75,DM/M RC,3,1,2,3,2,1,2,5,3,3,2,7,8,12,6,12,6,13,13,10,11,12,10,13,13,15,16,15,13,12,10,13,16,8,13,9,14,14,17,14,13,14,10,8,17,14,20,17,15,13,14,14,5,11,15,15,15,16,13,14,16,7,15,15,20,1,15,1,20,DM/M RC,423,1,1,1,1,1,1,8,1,15,17,20,1,10,1,15,320.0,0,0,0,0,0,0,1,0,1,0,0,0,0,0,0,0,0,0,0,0,0,0,0,0,0,0,0,0,0,0,0,0,0,0,0,0,0,0,0,0,0,0,0,0,0,0,0,0,Charles KaborÃ©,Â£4.50m ,32.0,183.0,Midfielder - Defensive Midfield,right,Dynamo Moscow,44.0,0.0,3.0,2857.0,38.0,0.0,1.0,2061.0,39.0,0.0,5.0,3178.0,35.0,1.0,7.0,2999.0,31.0,0.0,4.0,2649.0,32.0,0.0,1.0,2770.0,33.0,1.0,2.0,2765.0,22.0,0.0,0.0,1657.0,37.0,1.0,2.0,3073.0,Ligue 1,21.0,0.0,0.0,1368.0,11.0,0.0,0.0,732.0,29/6/2010,Charles KaborÃ©,34013978,9,2/9/1988,22,20,1,0,0,4830,6950,6250,165,139,12766689,181,75,DM/M RC,2,3,2,2,1,1,3,1,1,1,3,8,10,12,6,13,6,13,13,8,12,12,11,14,12,16,15,15,13,13,11,13,16,8,14,9,13,14,17,14,12,14,10,8,17,14,20,17,15,13,12,15,5,11,15,15,14,16,13,14,16,7,Charles KaborÃÂ©,ÃÂ£5.85m ,Ligue 1
19/6/2011,Alex Song,8428095,11,9/9/1987,23,24,0,0,0,6264,7867,7717,167,157,20148243,185,74,D/DM/M C,1,1,1,1,1,2,3,4,1,1,2,5,9,12,9,13,5,15,7,10,14,13,10,16,13,14,16,16,17,16,12,14,17,9,9,13,15,16,18,12,14,16,13,13,16,11,20,18,17,16,11,13,5,15,14,14,15,12,15,13,16,8,17,1,18,1,1,1,18,D/DM/M C,331,1,1,1,1,1,1,17,1,1,20,18,1,1,1,1,4.0,0,0,1,0,0,0,0,0,0,0,0,0,0,0,0,0,0,0,0,0,0,0,0,0,0,0,0,0,0,0,0,0,0,0,0,0,0,0,0,0,0,0,0,0,0,0,0,0,Alex Song,Â£25.65m ,33.0,185.0,Midfielder - Defensive Midfield,right,Without Club,42.0,5.0,4.0,3390.0,46.0,1.0,14.0,4079.0,34.0,1.0,1.0,2394.0,31.0,0.0,1.0,1720.0,31.0,0.0,3.0,2434.0,16.0,0.0,1.0,938.0,16.0,0.0,2.0,1075.0,7.0,1.0,0.0,319.0,16.0,0.0,0.0,1064.0,Premier League,12.0,1.0,0.0,584.0,nan,nan,nan,nan,29/6/2010,Alex Song,8428095,11,9/9/1987,22,24,0,0,0,6162,7850,7750,167,157,-1,185,74,D/DM/M C,1,3,2,3,1,3,1,6,2,3,3,5,9,12,6,13,5,14,8,10,14,13,10,16,13,12,16,15,17,16,12,14,17,9,9,13,15,16,17,12,14,16,13,13,16,11,20,18,17,16,11,13,7,15,14,14,15,12,15,13,16,8,Alex Song,ÃÂ£15.30m ,Premier League
19/6/2011,ÃdÃ¡m PintÃ©r,38001863,773,6/12/1988,23,5,0,7,0,3717,5726,5726,129,115,374240,190,76,D/DM C,2,1,2,3,1,2,1,7,1,2,2,7,10,9,8,11,12,16,8,10,14,11,8,13,10,12,11,14,9,13,8,10,10,6,10,7,12,16,14,8,10,14,16,13,12,12,20,13,13,14,10,11,10,11,8,12,9,13,6,15,7,8,20,1,15,1,1,1,20,D/DM C,111,1,9,1,1,1,1,20,1,1,19,15,1,1,1,1,0.0,0,0,0,0,0,0,0,0,0,0,0,0,0,0,0,0,0,0,0,0,0,0,0,0,0,0,0,0,0,0,0,0,0,0,0,0,0,0,0,0,0,0,0,0,0,0,0,0,ÃdÃ¡m PintÃ©r,Â£900Th. ,32.0,190.0,Defender - Centre-Back,right,MTK Budapest,15.0,1.0,0.0,847.0,17.0,0.0,0.0,1259.0,20.0,0.0,0.0,1466.0,13.0,0.0,0.0,548.0,17.0,0.0,0.0,1151.0,26.0,3.0,0.0,1698.0,29.0,0.0,0.0,1982.0,10.0,0.0,0.0,518.0,25.0,0.0,0.0,2059.0,LaLiga,24.0,0.0,1.0,2108.0,nan,nan,nan,nan,29/6/2010,ÃdÃ¡m PintÃ©r,38001863,773,6/12/1988,22,0,0,6,0,1000,5000,5000,133,110,933155,190,76,D/DM C,3,1,1,2,3,2,2,1,2,2,2,6,7,7,8,12,11,16,7,9,13,9,9,14,8,12,11,14,11,11,8,9,10,9,10,8,10,13,14,9,14,9,13,11,12,8,20,13,15,14,10,11,10,11,15,5,16,8,15,9,10,19,nan,nan,nan
19/6/2011,Youssuf Mulumbu,8440126,53,1/25/1987,24,12,0,0,0,5900,7500,7400,157,144,2742073,177,69,DM/M C,3,3,1,1,2,3,2,5,2,3,1,3,7,12,9,14,5,10,9,7,12,14,4,14,14,13,16,16,13,12,13,13,17,9,14,13,16,16,18,13,13,13,9,12,17,12,20,18,15,17,8,14,6,13,15,14,15,14,13,13,11,7,8,8,20,1,8,1,20,DM/M C,311,1,1,1,1,1,1,3,1,8,20,20,1,5,1,8,557120.0,0,0,0,0,0,0,1,0,0,0,0,0,0,0,0,1,0,0,0,1,0,0,0,0,0,0,0,0,0,0,0,0,0,0,0,0,0,0,0,0,0,0,0,0,0,0,0,0,Youssouf Mulumbu,Â£3.15m ,33.0,177.0,Midfielder - Defensive Midfield,right,Kilmarnock FC,34.0,6.0,1.0,2862.0,36.0,1.0,4.0,2900.0,30.0,2.0,2.0,2620.0,38.0,2.0,2.0,3169.0,22.0,0.0,0.0,1191.0,10.0,0.0,0.0,600.0,16.0,0.0,1.0,846.0,20.0,1.0,4.0,1602.0,15.0,1.0,2.0,1120.0,Premier League,nan,nan,nan,nan,3.0,0.0,0.0,19.0,29/6/2010,Youssuf Mulumbu,8440126,53,1/25/1987,23,8,0,0,0,4250,6750,6600,146,133,5877712,177,69,DM/M C,3,1,1,2,2,1,2,8,1,2,3,5,7,12,7,12,6,11,11,7,10,13,5,15,13,15,15,17,12,13,12,13,17,9,10,11,16,16,17,12,13,14,9,13,16,12,20,18,15,15,13,13,6,10,15,14,15,14,13,13,11,7,Youssouf Mulumbu,ÃÂ£3.15m ,Premier League
19/6/2011,Xavi Torres,1508014,796,11/21/1986,24,0,0,0,0,4000,6500,6500,142,130,261167,182,78,DM/M C,1,3,2,2,3,1,2,6,1,2,1,10,8,8,8,13,12,13,12,8,14,14,10,14,12,13,13,14,12,13,12,13,13,6,12,9,14,15,16,13,11,13,12,8,15,13,20,15,12,14,10,10,5,10,15,13,15,14,15,16,13,7,14,1,17,1,1,5,17,DM/M C,311,1,1,1,1,1,1,14,5,1,20,17,1,1,1,1,4294967296.0,0,0,0,0,0,0,0,0,0,0,0,0,0,0,0,0,0,0,0,0,0,0,0,0,0,0,0,0,0,0,0,0,1,0,0,0,0,0,0,0,0,0,0,0,0,0,0,0,Xavi Torres,Â£2.70m ,33.0,182.0,Midfielder - Central Midfield,right,CD Lugo,38.0,0.0,3.0,3262.0,37.0,5.0,1.0,2848.0,37.0,0.0,2.0,2925.0,17.0,1.0,0.0,1187.0,28.0,2.0,2.0,2200.0,14.0,0.0,0.0,814.0,19.0,0.0,0.0,1038.0,24.0,4.0,0.0,1888.0,29.0,6.0,1.0,1711.0,LaLiga,nan,nan,nan,nan,5.0,1.0,0.0,363.0,29/6/2010,Xavi Torres,1508014,796,11/21/1986,23,0,0,0,0,3844,5750,5750,140,124,1720377,182,79,D/DM C,2,2,1,1,2,1,1,7,2,1,3,5,5,8,6,14,6,14,11,9,15,14,7,14,10,14,13,12,14,13,9,13,10,7,13,10,16,16,14,12,11,14,13,7,14,12,20,15,13,11,10,11,5,10,14,16,14,17,6,13,5,19,Xavi Torres,ÃÂ£1.80m ,LaLiga
19/6/2011,Vasco Fernandes,727458,788,11/12/1986,24,0,0,1,0,4000,5250,5250,120,106,117520,181,74,D RC,3,1,3,1,2,3,3,1,3,2,1,6,9,8,6,11,9,9,9,7,9,12,9,12,11,12,13,11,13,9,8,13,8,12,11,9,11,14,12,12,12,10,9,11,13,14,20,10,12,9,16,8,6,12,7,5,15,16,11,14,15,14,20,9,1,1,20,10,16,D RC,103,1,10,1,1,1,1,16,10,20,15,1,1,1,1,9,34.0,0,1,0,0,0,1,0,0,0,0,0,0,0,0,0,0,0,0,0,0,0,0,0,0,0,0,0,0,0,0,0,0,0,0,0,0,0,0,0,0,0,0,0,0,0,0,0,0,Gelson Fernandes,Â£3.15m ,34.0,180.0,Midfielder - Defensive Midfield,right,Retired,30.0,2.0,2.0,2365.0,35.0,2.0,3.0,2240.0,28.0,0.0,0.0,2211.0,38.0,1.0,2.0,2906.0,36.0,0.0,0.0,3002.0,37.0,1.0,1.0,3203.0,28.0,0.0,0.0,1881.0,22.0,0.0,0.0,1168.0,37.0,1.0,0.0,3056.0,Serie A,22.0,0.0,0.0,1356.0,nan,nan,nan,nan
19/6/2011,Vadim Demidov,53010227,786,10/10/1986,24,1,0,13,2,4700,6500,6500,148,136,645204,185,73,D/DM/M C,2,3,1,2,2,3,2,5,1,1,1,4,8,10,8,14,5,14,10,5,14,11,8,16,13,14,16,17,13,13,11,13,15,5,16,10,15,14,13,13,11,12,14,10,15,13,20,13,14,14,12,18,8,16,15,17,12,15,15,12,8,18,20,1,17,1,1,1,20,D/DM/M C,121,1,1,1,1,1,1,20,1,1,18,17,1,1,1,1,137439000000.0,0,0,1,0,0,0,0,0,0,0,0,0,0,0,0,0,0,0,0,0,0,0,0,0,0,0,0,0,0,0,0,0,0,0,0,0,0,1,0,0,0,0,0,0,0,0,0,0,Vadim Demidov,Â£3.15m ,34.0,186.0,Defender - Centre-Back,right,Retired,25.0,1.0,1.0,2173.0,27.0,0.0,1.0,2194.0,19.0,0.0,0.0,1504.0,8.0,0.0,0.0,641.0,26.0,1.0,0.0,2070.0,26.0,1.0,1.0,2291.0,3.0,0.0,0.0,270.0,28.0,1.0,0.0,2397.0,15.0,0.0,2.0,1303.0,LaLiga,nan,nan,nan,nan,nan,nan,nan,nan
19/6/2011,Tomoaki Makino,784465,116,5/11/1987,24,5,0,9,1,3700,5709,5900,140,119,759236,182,76,D RLC,3,1,2,1,1,2,2,4,2,1,3,8,9,10,7,10,13,12,12,13,10,11,9,13,11,11,10,16,12,10,12,10,12,15,8,9,10,12,13,13,14,13,11,16,11,12,20,12,12,10,7,11,7,14,6,12,11,10,13,9,7,8,20,10,8,1,17,17,20,D RLC,106,1,10,1,1,1,1,20,17,17,15,8,4,4,10,10,32.0,0,0,0,0,0,1,0,0,0,0,0,0,0,0,0,0,0,0,0,0,0,0,0,0,0,0,0,0,0,0,0,0,0,0,0,0,0,0,0,0,0,0,0,0,0,0,0,0,Tomoaki Makino,Â£900Th. ,33.0,182.0,Defender - Centre-Back,right,Urawa Red Diamonds,5.0,0.0,0.0,133.0,44.0,6.0,1.0,3541.0,45.0,6.0,4.0,3900.0,39.0,6.0,0.0,3384.0,43.0,4.0,3.0,3930.0,39.0,3.0,1.0,3502.0,48.0,3.0,0.0,4202.0,42.0,5.0,1.0,3780.0,49.0,3.0,0.0,4365.0,Bundesliga,20.0,1.0,0.0,1665.0,nan,nan,nan,nan
19/6/2011,Tom Huddlestone,5113183,765,12/28/1986,24,3,0,33,3,5500,7017,7400,165,148,2638047,192,98,DM/M C,3,1,1,2,1,1,1,4,3,3,2,13,11,12,9,16,13,12,13,5,11,18,12,13,17,14,12,14,15,14,16,15,12,8,13,14,15,16,16,9,8,12,15,14,16,9,20,15,18,14,14,9,5,15,6,16,16,17,11,11,10,8,14,4,20,1,8,8,20,DM/M C,311,1,10,1,1,1,1,14,8,8,20,20,8,8,4,4,9070970000000.0,0,0,0,0,0,0,0,1,1,1,0,0,0,0,0,0,0,0,0,1,0,0,0,0,0,0,0,0,0,0,0,0,0,0,0,0,0,0,1,0,0,0,0,1,0,0,0,0,Tom Huddlestone,Â£5.40m ,33.0,188.0,Midfielder - Defensive Midfield,right,Without Club,21.0,2.0,2.0,1729.0,4.0,0.0,1.0,181.0,30.0,0.0,6.0,1783.0,40.0,3.0,7.0,3535.0,35.0,0.0,2.0,2830.0,47.0,2.0,5.0,3068.0,39.0,2.0,1.0,2559.0,47.0,2.0,0.0,4196.0,31.0,0.0,1.0,2330.0,Premier League,12.0,1.0,0.0,1020.0,nan,nan,nan,nan,29/6/2010,Tom Huddlestone,5113183,765,12/28/1986,23,3,0,33,3,5329,7400,7400,165,146,16236174,192,98,DM/M C,3,1,3,2,2,1,1,3,2,3,1,13,11,12,9,16,13,12,13,3,11,16,12,13,17,14,12,14,15,14,16,15,12,8,12,12,13,16,16,9,8,12,15,14,16,9,20,15,18,14,14,9,5,15,6,16,16,17,11,11,10,8,Tom Huddlestone,ÃÂ£10.80m ,Premier League
19/6/2011,Thomas Mangani,919962,769,4/29/1987,24,0,0,0,0,4500,5600,5600,140,125,101703,183,78,D/DM C,1,2,2,2,1,3,2,1,1,2,3,6,8,9,6,12,6,13,10,12,11,12,8,13,12,12,15,13,13,13,11,13,15,6,12,7,13,16,18,12,11,14,12,20,14,11,8,16,14,14,12,14,6,12,12,12,9,17,15,15,15,5,17,14,12,5,1,14,17,D/DM C,321,1,1,1,5,1,1,17,14,1,20,8,12,1,14,1,137439000000.0,0,0,0,0,0,0,0,0,0,0,0,0,0,0,0,0,0,0,0,0,0,0,0,0,0,0,0,0,0,0,0,0,0,0,0,0,0,1,0,0,0,0,0,0,0,0,0,0,Thomas Mangani,Â£1.35m ,33.0,183.0,Midfielder - Central Midfield,left,SCO Angers,25.0,1.0,1.0,1794.0,29.0,1.0,3.0,1606.0,36.0,0.0,4.0,2766.0,37.0,1.0,5.0,3093.0,17.0,2.0,2.0,1364.0,33.0,5.0,4.0,2501.0,40.0,6.0,9.0,3394.0,38.0,2.0,6.0,3230.0,31.0,3.0,0.0,1735.0,Ligue 1,27.0,2.0,2.0,2128.0,8.0,1.0,0.0,537.0,29/6/2010,Thomas Mangani,919962,769,4/29/1987,23,0,0,0,0,3906,5600,5600,140,125,1902707,183,78,D/DM C,1,3,2,2,1,1,2,3,1,1,2,6,8,9,6,12,6,13,10,12,11,12,8,13,12,12,15,13,13,13,11,13,15,6,12,7,13,16,18,12,11,14,12,20,14,11,8,16,14,14,12,14,6,12,10,12,14,11,15,15,15,5,Thomas Mangani,ÃÂ£1.80m ,Ligue 1
19/6/2011,Sami Khedira,8723858,771,4/4/1987,24,20,1,14,5,7000,8200,7700,162,154,0,189,85,DM/M C,3,1,2,2,1,3,2,6,3,2,3,6,10,9,14,12,8,15,11,12,15,12,9,14,11,13,17,16,18,18,13,17,17,6,14,16,17,20,19,9,8,14,16,12,18,15,20,19,16,12,10,15,14,16,14,18,9,15,18,16,18,3,1,1,20,14,10,10,20,DM/M C,421,1,1,1,14,8,8,1,1,1,19,20,10,10,1,1,2147484256.0,0,0,0,0,0,1,1,0,0,1,0,0,0,0,0,0,0,0,0,0,0,0,0,0,0,0,0,0,0,0,0,1,0,0,0,0,0,0,0,0,0,0,0,0,0,0,0,0,Sami Khedira,Â£18.00m ,33.0,189.0,Midfielder - Central Midfield,right,Juventus FC,40.0,0.0,3.0,3076.0,42.0,4.0,3.0,2974.0,44.0,4.0,6.0,3249.0,18.0,1.0,1.0,1376.0,17.0,0.0,0.0,621.0,25.0,5.0,3.0,1952.0,46.0,5.0,3.0,3836.0,39.0,9.0,6.0,2877.0,17.0,2.0,0.0,977.0,LaLiga,18.0,0.0,1.0,978.0,nan,nan,nan,nan,29/6/2010,Sami Khedira,8723858,771,4/4/1987,23,12,1,14,5,5476,7400,7400,169,148,41999998,189,81,DM/M C,2,1,2,2,2,1,3,8,1,1,3,6,10,9,14,11,8,15,12,12,14,10,9,14,11,13,17,16,15,17,13,17,17,6,14,16,15,19,19,9,8,10,16,12,18,15,20,19,16,12,6,15,14,16,14,18,9,15,18,16,18,3,Sami Khedira,ÃÂ£18.00m ,LaLiga
19/6/2011,Robert Tesche,35006190,771,5/27/1987,24,0,0,0,0,4500,5750,6250,140,115,105191,180,73,DM/M RC,2,3,2,2,1,1,3,5,1,2,1,10,11,13,10,14,10,10,13,7,11,12,10,14,14,13,14,5,14,13,11,14,10,4,12,14,14,15,15,14,14,14,9,5,17,14,20,12,4,10,8,10,5,10,14,9,5,7,12,9,14,12,1,11,20,11,16,1,20,DM/M RC,423,1,1,1,10,1,11,1,1,1,18,20,1,16,1,11,0.0,0,0,0,0,0,0,0,0,0,0,0,0,0,0,0,0,0,0,0,0,0,0,0,0,0,0,0,0,0,0,0,0,0,0,0,0,0,0,0,0,0,0,0,0,0,0,0,0,Robert Tesche,Â£1.13m ,33.0,182.0,Midfielder - Central Midfield,right,VfL Bochum,12.0,0.0,0.0,537.0,26.0,2.0,1.0,1245.0,18.0,0.0,1.0,1112.0,21.0,2.0,1.0,1330.0,37.0,4.0,5.0,2903.0,25.0,1.0,1.0,1615.0,26.0,0.0,0.0,1852.0,19.0,2.0,0.0,1188.0,31.0,3.0,2.0,2440.0,Bundesliga,26.0,1.0,1.0,1891.0,6.0,0.0,0.0,451.0,29/6/2010,Robert Tesche,35006190,771,5/27/1987,23,0,0,0,0,1500,5750,5750,140,115,1693695,180,73,DM/M RC,2,2,1,2,1,2,3,1,2,1,1,11,13,14,12,14,10,10,14,6,10,14,10,14,14,8,14,10,14,12,12,13,10,5,15,8,11,17,14,14,14,14,17,5,14,14,20,9,8,10,8,10,4,10,7,13,20,8,9,11,11,20,Robert Tesche,ÃÂ£1.58m ,Bundesliga
19/6/2011,RaÃºl GarcÃ­a,1502117,796,7/11/1986,24,0,0,1,0,4750,6750,6750,149,137,572181,183,81,M C,2,3,2,1,1,2,1,3,2,1,3,15,12,11,12,15,13,13,15,10,12,13,13,12,13,14,13,15,13,13,12,14,14,13,12,11,13,14,14,11,12,14,12,12,16,13,20,14,14,13,14,12,11,13,15,16,15,10,14,15,13,9,1,1,20,15,1,1,20,M C,401,1,1,4,15,1,1,1,1,1,15,20,1,1,1,1,2147484160.0,0,0,0,0,0,0,0,0,0,1,0,0,0,0,0,0,0,0,0,0,0,0,0,0,0,0,0,0,0,0,0,1,0,0,0,0,0,0,0,0,0,0,0,0,0,0,0,0,RaÃºl GarcÃ­a,Â£4.50m ,34.0,184.0,Forward - Centre-Forward,right,Athletic Bilbao,41.0,1.0,6.0,2214.0,37.0,11.0,7.0,2643.0,47.0,9.0,4.0,2360.0,53.0,17.0,6.0,3111.0,47.0,10.0,3.0,2763.0,42.0,11.0,9.0,3211.0,46.0,14.0,9.0,3738.0,48.0,14.0,8.0,3564.0,34.0,9.0,4.0,2466.0,LaLiga,42.0,15.0,2.0,3494.0,6.0,0.0,0.0,523.0,29/6/2010,RaÃÂºl GarcÃÂ­a,1502117,796,7/11/1986,23,0,0,1,0,4830,6400,6400,145,139,7979960,183,81,DM/M/AM C,3,3,3,2,3,2,1,8,1,1,3,15,12,12,12,15,13,13,15,10,11,14,13,12,14,14,13,15,13,13,11,15,14,15,12,11,13,14,14,11,12,13,11,13,16,13,20,14,14,13,14,12,11,13,15,16,15,10,14,15,13,9,RaÃÂºl GarcÃÂ­a,ÃÂ£5.40m ,LaLiga
19/6/2011,Piermario Morosini,7990133,776,7/5/1986,24,0,0,22,0,2281,5250,5250,115,105,185441,182,75,DM/M C,1,1,1,1,1,1,1,1,1,1,1,6,7,11,7,8,3,8,9,4,11,14,5,10,12,11,12,10,10,12,12,13,14,8,9,11,13,16,16,11,10,12,10,8,12,13,20,14,12,10,7,11,7,11,9,13,13,13,20,10,14,12,1,8,20,1,14,1,20,DM/M C,421,1,1,1,1,1,1,1,1,1,18,20,1,14,1,8,140737000000000.0,0,0,0,0,0,0,0,0,0,0,0,0,0,0,0,0,0,0,0,0,0,0,0,0,0,0,0,0,0,0,0,0,0,0,0,0,0,0,0,0,0,0,0,0,0,0,0,1,nan,nan,nan,nan,nan,nan,nan,nan,nan,nan,nan,nan,nan,nan,nan,nan,nan,nan,nan,nan,nan,nan,nan,nan,nan,nan,nan,nan,nan,nan,nan,nan,nan,nan,nan,nan,nan,nan,nan,nan,nan,nan,nan,nan,nan,nan,nan,nan,nan,nan,nan,nan
19/6/2011,Mohamed DiamÃ©,8434183,41,6/14/1987,24,3,0,0,0,4750,7000,6750,153,140,1537029,181,71,DM/M C,2,3,3,2,3,3,3,1,3,2,1,4,11,13,6,14,4,13,11,5,12,14,4,17,12,14,15,16,15,8,13,7,15,6,8,6,18,15,18,14,12,17,11,9,15,15,20,18,19,11,12,10,12,8,15,12,12,11,15,10,8,10,10,1,20,1,1,1,20,DM/M C,311,1,1,1,1,1,1,10,1,1,20,20,1,1,1,1,9075270000000.0,0,0,0,0,0,0,0,0,0,0,0,0,0,0,0,0,0,0,0,0,0,0,0,0,0,0,0,0,0,0,0,0,1,0,0,0,0,0,1,0,0,0,0,1,0,0,0,0,Mohamed DiamÃ©,Â£4.50m ,33.0,184.0,Midfielder - Central Midfield,right,Al-Ahli SC,40.0,3.0,3.0,2997.0,26.0,3.0,0.0,1595.0,34.0,3.0,0.0,2670.0,41.0,4.0,4.0,2816.0,16.0,4.0,0.0,1053.0,45.0,10.0,4.0,3143.0,41.0,6.0,3.0,2773.0,33.0,2.0,0.0,2181.0,29.0,0.0,0.0,2165.0,Premier League,22.0,0.0,2.0,1980.0,4.0,0.0,0.0,350.0,29/6/2010,Mohamed DiamÃ©,8434183,769,6/14/1987,23,0,0,0,0,4750,6209,6500,153,138,8172646,181,71,DM/M C,3,1,2,1,1,2,2,1,1,3,2,4,11,13,6,12,4,13,11,5,12,14,4,17,12,15,15,16,14,8,8,7,15,6,8,6,18,15,18,14,12,17,11,9,15,15,20,18,19,11,12,10,12,8,15,12,12,11,15,10,8,7,Mohamed DiamÃÂ©,ÃÂ£3.15m ,Premier League
19/6/2011,Miguel PallardÃ³,67004759,796,9/5/1986,24,0,0,0,0,4264,6271,6271,142,126,187929,173,73,DM/M C,2,2,1,3,2,2,1,2,3,2,3,7,8,10,7,13,10,8,8,5,13,13,12,15,11,12,15,15,12,16,11,15,13,11,8,11,15,15,16,12,13,14,8,5,14,13,20,16,13,15,12,14,6,11,12,12,12,14,16,15,12,8,1,1,19,1,5,1,19,DM/M C,311,1,1,1,1,1,1,1,1,1,20,19,1,5,1,1,4294967360.0,0,0,0,0,0,0,1,0,0,0,0,0,0,0,0,0,0,0,0,0,0,0,0,0,0,0,0,0,0,0,0,0,1,0,0,0,0,0,0,0,0,0,0,0,0,0,0,0,Miguel PallardÃ³,Â£1.35m ,34.0,174.0,Midfielder - Central Midfield,right,Without Club,29.0,0.0,0.0,1996.0,14.0,1.0,1.0,590.0,24.0,0.0,0.0,725.0,4.0,0.0,0.0,145.0,24.0,1.0,3.0,1792.0,19.0,0.0,0.0,1091.0,4.0,0.0,0.0,160.0,6.0,0.0,0.0,203.0,nan,nan,nan,nan,LaLiga,nan,nan,nan,nan,nan,nan,nan,nan,29/6/2010,Miguel PallardÃ³,67004759,796,9/5/1986,23,0,0,0,0,4225,6000,6000,146,130,2862162,173,73,DM/M C,2,2,3,3,3,2,3,2,3,2,3,7,8,11,7,13,10,8,8,5,13,14,12,15,13,12,15,15,12,16,11,15,13,11,8,11,15,15,16,12,13,14,8,5,14,13,20,16,13,15,12,14,6,11,12,12,12,14,16,15,12,8,Miguel PallardÃÂ³,ÃÂ£1.80m ,LaLiga
19/6/2011,McDonald Mariga,8117342,25,4/4/1987,24,27,3,0,0,5000,6500,6750,150,135,162458,188,86,DM/M C,2,3,3,3,1,1,1,2,3,1,2,9,10,10,12,10,6,14,13,10,13,13,7,17,11,16,13,15,13,12,10,12,14,10,8,13,13,15,15,12,10,16,14,10,16,14,20,17,18,14,14,14,13,8,15,14,15,13,15,14,12,4,1,1,20,5,10,1,20,DM/M C,421,1,1,1,5,1,5,1,1,1,16,20,1,10,1,1,137440000000.0,0,0,0,0,0,0,0,0,1,0,0,0,0,0,0,0,0,0,0,0,1,0,0,0,0,0,0,0,0,0,0,0,0,0,0,0,0,1,0,0,0,0,0,0,0,0,0,0,McDonald Mariga,Â£5.40m ,33.0,183.0,Midfielder - Defensive Midfield,right,Retired,21.0,1.0,0.0,684.0,29.0,1.0,1.0,2080.0,5.0,0.0,0.0,159.0,1.0,0.0,0.0,45.0,11.0,0.0,0.0,569.0,13.0,2.0,2.0,985.0,29.0,0.0,0.0,2102.0,15.0,0.0,1.0,909.0,nan,nan,nan,nan,Serie A,nan,nan,nan,nan,nan,nan,nan,nan,29/6/2010,McDonald Mariga,8117342,25,4/4/1987,23,27,3,0,0,4900,7250,6800,165,140,10272022,188,86,DM/M C,2,2,3,2,1,1,3,8,1,1,3,9,10,10,13,12,6,15,15,10,12,14,7,17,11,16,13,17,11,12,11,12,14,12,9,13,13,15,15,13,11,16,14,10,16,14,20,17,18,15,14,14,13,8,15,14,15,13,15,14,12,4,McDonald Mariga,ÃÂ£6.30m ,Serie A
19/6/2011,Mario SuÃ¡rez,7458309,796,2/24/1987,24,0,0,5,0,4869,6763,6763,151,139,19180069,185,77,DM/M C,3,2,2,3,3,2,2,5,3,2,1,9,8,12,12,13,9,13,14,7,11,14,2,12,13,15,13,16,14,15,12,13,12,11,8,12,14,16,15,12,13,16,13,11,17,13,20,16,14,12,15,14,5,13,5,13,14,10,13,12,11,8,5,1,18,8,10,7,18,DM/M C,311,1,1,1,8,1,1,5,1,1,20,18,7,10,1,1,64.0,0,0,0,0,0,0,1,0,0,0,0,0,0,0,0,0,0,0,0,0,0,0,0,0,0,0,0,0,0,0,0,0,0,0,0,0,0,0,0,0,0,0,0,0,0,0,0,0,Mario SuÃ¡rez,Â£4.50m ,33.0,189.0,Midfielder - Defensive Midfield,right,Rayo Vallecano,35.0,2.0,2.0,2125.0,42.0,0.0,0.0,3131.0,43.0,1.0,2.0,3190.0,25.0,0.0,0.0,2100.0,35.0,2.0,1.0,2353.0,30.0,1.0,0.0,1600.0,36.0,3.0,5.0,2796.0,18.0,2.0,2.0,1569.0,14.0,2.0,0.0,1026.0,LaLiga,37.0,7.0,2.0,2708.0,3.0,0.0,0.0,141.0,29/6/2010,Mario SuÃ¡rez,7458309,796,2/24/1987,23,0,0,5,0,4761,6750,6750,153,138,10099603,185,77,DM/M C,1,2,3,1,2,3,2,6,3,1,2,9,8,12,11,13,9,13,14,7,11,13,2,12,13,16,12,16,13,15,11,13,11,11,8,11,14,17,15,12,13,16,13,12,17,13,20,16,13,12,15,14,5,13,12,15,10,6,15,12,14,9,Mario SuÃÂ¡rez,ÃÂ£3.60m ,LaLiga
19/6/2011,Manuel Curto,744632,788,7/9/1986,24,0,0,0,0,1500,5100,6000,112,108,607189,187,78,DM/M C,2,1,3,2,2,3,1,3,3,2,1,11,11,11,12,10,10,13,11,9,8,12,12,9,11,11,12,11,10,10,12,11,10,12,10,12,10,11,10,10,11,13,14,14,12,9,20,12,14,10,8,10,12,10,7,14,14,3,3,8,7,6,1,1,17,7,1,1,17,DM/M C,311,1,1,7,7,1,1,1,1,1,20,17,1,1,1,1,0.0,0,0,0,0,0,0,0,0,0,0,0,0,0,0,0,0,0,0,0,0,0,0,0,0,0,0,0,0,0,0,0,0,0,0,0,0,0,0,0,0,0,0,0,0,0,0,0,0,Manuel Curto,Â£720Th. ,34.0,187.0,Midfielder - Defensive Midfield,right,Retired,19.0,2.0,1.0,1519.0,22.0,1.0,1.0,1522.0,13.0,4.0,3.0,1025.0,17.0,1.0,1.0,1309.0,6.0,0.0,0.0,377.0,13.0,2.0,0.0,874.0,nan,nan,nan,nan,nan,nan,nan,nan,nan,nan,nan,nan,Liga NOS,nan,nan,nan,nan,nan,nan,nan,nan,29/6/2010,Manuel Curto,744632,788,7/9/1986,23,0,0,0,0,1250,5000,5000,110,98,97605,187,78,M/AM C,2,1,2,3,1,3,2,3,1,1,1,10,10,10,11,9,9,12,10,8,7,11,11,8,10,11,11,11,9,9,11,10,10,12,10,11,9,10,9,10,10,12,13,14,12,10,20,11,13,10,8,10,12,10,13,14,14,9,9,5,11,6,Manuel Curto,ÃÂ£135Th. ,Liga NOS
19/6/2011,Lucas Leiva,8833577,1651,1/9/1987,24,16,0,9,4,7000,8200,7750,162,155,4840741,179,74,DM/M C,1,2,2,3,3,3,2,7,1,1,3,11,13,13,8,14,10,8,8,5,15,14,7,16,15,11,15,13,15,15,14,14,15,11,9,14,16,16,17,13,15,13,12,12,15,14,20,17,14,16,8,15,3,14,15,16,15,16,14,10,12,10,1,1,20,14,10,1,20,DM/M C,311,1,1,1,14,1,1,1,1,1,20,20,1,10,1,1,17592200000000.0,0,0,0,0,1,0,0,0,0,0,0,0,0,0,0,0,0,0,0,1,0,0,1,0,0,0,0,0,0,0,0,0,0,0,0,0,0,0,0,0,0,0,0,0,1,0,0,0,Lucas Leiva,Â£13.50m ,33.0,179.0,Midfielder - Defensive Midfield,right,SS Lazio,47.0,1.0,2.0,3882.0,15.0,0.0,1.0,1295.0,32.0,0.0,1.0,2315.0,30.0,0.0,0.0,2100.0,32.0,0.0,0.0,2281.0,40.0,0.0,1.0,2850.0,32.0,1.0,3.0,1778.0,50.0,4.0,5.0,4031.0,36.0,0.0,4.0,2711.0,Premier League,30.0,0.0,1.0,2143.0,6.0,0.0,0.0,400.0,29/6/2010,Lucas,8833577,1651,1/9/1987,23,5,0,9,4,5625,8200,7400,162,150,21591301,179,74,DM/M C,3,3,2,3,1,3,3,4,1,1,3,11,13,13,8,14,10,8,8,5,15,14,7,16,15,11,14,15,15,14,14,13,15,11,8,15,15,13,17,13,15,13,12,10,15,14,20,17,14,14,8,12,7,12,15,16,15,16,14,10,12,10,nan,nan,nan
19/6/2011,Luca Cigarini,7990880,776,6/20/1986,24,0,0,29,1,5250,6515,6950,153,137,334967,175,72,M C,1,2,3,3,2,1,1,4,3,1,3,15,13,13,9,12,16,10,14,13,12,18,16,13,15,14,12,11,12,12,16,12,9,14,10,14,12,15,13,13,14,10,8,10,14,13,20,14,9,13,6,12,8,10,15,12,12,9,15,13,15,8,1,1,20,5,1,1,20,M C,401,1,1,1,5,1,1,1,1,1,15,20,1,1,1,1,0.0,0,0,0,0,0,0,0,0,0,0,0,0,0,0,0,0,0,0,0,0,0,0,0,0,0,0,0,0,0,0,0,0,0,0,0,0,0,0,0,0,0,0,0,0,0,0,0,0,Luca Cigarini,Â£4.95m ,34.0,175.0,Midfielder - Defensive Midfield,right,FC Crotone,18.0,3.0,2.0,893.0,32.0,1.0,2.0,2547.0,30.0,2.0,5.0,2491.0,36.0,2.0,8.0,2618.0,34.0,1.0,3.0,2774.0,26.0,2.0,2.0,1902.0,7.0,0.0,0.0,471.0,27.0,2.0,3.0,2153.0,28.0,0.0,1.0,1933.0,Serie A,22.0,0.0,4.0,1604.0,5.0,0.0,1.0,391.0,29/6/2010,Luca Cigarini,7990880,776,6/20/1986,24,0,0,29,1,4830,7100,7100,161,139,7701911,175,72,M C,1,1,1,3,3,3,2,5,2,3,2,15,13,13,9,12,16,10,14,13,12,18,16,13,15,11,12,10,12,12,16,12,9,12,10,14,12,15,13,13,14,10,10,10,14,13,20,14,9,13,6,12,8,10,15,12,12,9,15,16,18,6,Luca Cigarini,ÃÂ£4.05m ,LaLiga
19/6/2011,Lorenzo Davids,859350,784,9/4/1986,24,0,0,0,0,5020,5923,6100,137,122,158103,180,69,DM/M LC,2,1,1,1,3,3,3,5,2,1,3,7,9,12,6,14,7,11,7,10,14,13,10,13,15,15,14,13,11,11,13,12,14,13,10,16,14,13,16,11,11,12,11,20,14,11,10,15,12,14,6,15,3,12,14,15,9,15,17,10,12,12,11,13,20,12,9,17,20,DM/M LC,424,1,1,1,8,12,6,10,11,1,17,20,17,9,13,5,0.0,0,0,0,0,0,0,0,0,0,0,0,0,0,0,0,0,0,0,0,0,0,0,0,0,0,0,0,0,0,0,0,0,0,0,0,0,0,0,0,0,0,0,0,0,0,0,0,0,Lorenzo Davids,Â£900Th. ,34.0,180.0,Midfielder - Defensive Midfield,left,SV Nijmegen,30.0,2.0,3.0,2238.0,23.0,0.0,0.0,1760.0,10.0,0.0,0.0,684.0,7.0,0.0,0.0,185.0,nan,nan,nan,nan,nan,nan,nan,nan,nan,nan,nan,nan,1.0,0.0,0.0,90.0,8.0,0.0,0.0,750.0,Bundesliga,nan,nan,nan,nan,nan,nan,nan,nan
19/6/2011,Lamine SanÃ©,85032367,41,3/22/1987,24,3,0,0,0,5050,6250,5600,145,125,505280,192,77,D/DM RC,3,3,2,1,2,3,3,8,2,2,1,5,7,8,6,8,5,15,10,11,14,7,7,13,9,14,14,15,12,10,9,11,16,6,9,7,12,13,16,15,11,16,17,5,14,14,20,15,16,13,14,14,7,8,15,14,11,13,12,14,14,7,20,10,10,1,15,1,20,D/DM RC,113,1,1,1,1,1,1,20,1,15,17,10,1,1,1,10,4503870000000000.0,0,0,0,0,0,0,0,0,0,0,0,0,0,0,0,0,0,0,0,0,0,0,0,0,0,0,0,0,0,0,0,0,0,0,0,0,0,0,1,0,0,0,0,0,0,0,0,0,Lamine SanÃ©,Â£4.05m ,33.0,192.0,Defender - Centre-Back,right,Without Club,37.0,2.0,2.0,3278.0,34.0,2.0,2.0,2933.0,48.0,2.0,0.0,4324.0,45.0,2.0,0.0,4080.0,25.0,1.0,1.0,2140.0,21.0,0.0,1.0,1562.0,28.0,1.0,1.0,2454.0,29.0,2.0,0.0,2368.0,30.0,0.0,0.0,2694.0,Ligue 1,1.0,0.0,0.0,1.0,nan,nan,nan,nan,29/6/2010,Ludovic SanÃ©,85032367,769,3/22/1987,23,0,0,0,0,4096,5759,5750,150,128,4353438,192,77,D RC,1,3,1,2,1,2,3,6,1,1,3,6,8,8,7,9,5,15,10,5,14,8,7,14,9,14,14,15,13,14,7,11,15,5,9,8,14,12,15,15,10,16,16,5,14,13,20,15,15,14,13,14,7,6,6,14,11,14,13,14,14,7,nan,nan,nan
19/6/2011,KÃ©vin Anin,34000860,769,7/5/1986,24,0,0,0,0,4900,6150,6150,148,135,623733,189,80,DM ,2,2,2,3,1,1,2,2,3,2,1,6,11,11,6,13,7,15,11,9,12,14,6,14,13,14,16,15,9,14,11,12,14,8,8,9,15,15,17,15,13,17,15,5,10,13,20,16,18,13,14,14,12,14,14,16,11,10,10,11,11,13,1,1,14,12,12,1,14,DM ,300,1,1,7,10,1,12,1,1,1,20,14,1,12,1,1,0.0,0,0,0,0,0,0,0,0,0,0,0,0,0,0,0,0,0,0,0,0,0,0,0,0,0,0,0,0,0,0,0,0,0,0,0,0,0,0,0,0,0,0,0,0,0,0,0,0,KÃ©vin Anin,Â£3.15m ,34.0,189.0,Midfielder - Central Midfield,right,Retired,27.0,0.0,0.0,2141.0,32.0,0.0,0.0,2560.0,15.0,1.0,0.0,1033.0,nan,nan,nan,nan,nan,nan,nan,nan,nan,nan,nan,nan,nan,nan,nan,nan,nan,nan,nan,nan,nan,nan,nan,nan,Ligue 1,nan,nan,nan,nan,nan,nan,nan,nan,29/6/2010,KÃ©vin Anin,34000860,769,7/5/1986,23,0,0,0,0,3481,5300,5300,140,118,3999999,189,80,DM/M/AM RC,3,2,1,2,2,2,1,3,2,2,3,6,11,11,6,12,7,13,9,8,10,14,6,11,12,13,13,14,10,10,11,11,14,8,7,9,8,12,14,15,12,17,14,5,10,13,20,14,17,13,13,14,12,14,7,16,14,10,7,12,12,11,KÃÂ©vin Anin,ÃÂ£2.70m ,Ligue 1
19/6/2011,Kamil Vacek,5653968,763,5/18/1987,24,0,0,2,0,3250,6250,6250,135,120,1169960,183,81,AM RC,3,3,3,1,2,3,1,1,1,1,1,12,10,12,10,14,14,5,4,5,8,16,12,7,14,9,14,8,3,9,15,10,12,16,5,15,14,8,14,12,12,8,9,16,5,15,20,14,9,14,10,4,14,8,2,12,6,6,12,18,10,10,1,1,15,20,15,1,20,AM RC,503,1,1,1,20,1,15,1,1,1,15,15,1,15,1,1,0.0,0,0,0,0,0,0,0,0,0,0,0,0,0,0,0,0,0,0,0,0,0,0,0,0,0,0,0,0,0,0,0,0,0,0,0,0,0,0,0,0,0,0,0,0,0,0,0,0,Kamil Vacek,Â£1.35m ,33.0,184.0,Midfielder - Central Midfield,right,FC Bohemians Prag 1905,34.0,2.0,1.0,2887.0,31.0,4.0,2.0,1773.0,12.0,0.0,0.0,750.0,25.0,2.0,2.0,819.0,38.0,0.0,2.0,2175.0,33.0,5.0,8.0,2870.0,28.0,0.0,1.0,2186.0,25.0,0.0,1.0,1399.0,25.0,2.0,1.0,1760.0,Serie A,23.0,4.0,2.0,1395.0,6.0,0.0,0.0,464.0
19/6/2011,Juri Judt,8718376,771,7/24/1986,24,0,0,4,0,4500,6350,6107,139,127,445881,173,67,D/WB/DM R,3,1,2,1,1,3,1,7,3,2,1,10,13,11,6,11,8,12,9,9,13,11,8,14,11,14,12,16,12,14,8,13,14,10,9,9,13,14,15,12,12,14,8,7,15,13,20,15,13,14,13,13,12,15,13,14,11,14,16,15,14,6,20,19,13,4,20,14,12,D/WB/DM R,122,1,1,1,4,1,1,1,14,20,18,12,1,13,13,19,140884000000000.0,0,0,0,0,0,0,0,0,0,0,0,0,0,0,0,0,0,0,0,0,0,0,0,0,0,1,0,0,0,0,0,0,0,1,0,0,0,1,0,0,0,0,0,0,0,0,0,1,Juri Judt,Â£315Th. ,34.0,176.0,Midfielder - Defensive Midfield,both,SV Burggrafenhof,28.0,0.0,1.0,2367.0,16.0,1.0,0.0,1311.0,20.0,1.0,2.0,1693.0,14.0,0.0,0.0,1054.0,28.0,0.0,0.0,2113.0,31.0,0.0,1.0,1899.0,3.0,0.0,0.0,270.0,nan,nan,nan,nan,nan,nan,nan,nan,Bundesliga,nan,nan,nan,nan,nan,nan,nan,nan,29/6/2010,Juri Judt,8718376,771,7/24/1986,23,0,0,4,0,2500,5900,5900,129,117,4563354,173,67,D/DM/M RC,2,3,2,3,1,1,3,8,2,3,2,10,12,10,6,11,8,12,9,9,13,11,8,14,10,14,11,16,12,14,8,13,14,10,9,9,11,14,16,12,12,15,9,7,15,12,20,15,13,14,13,13,13,15,13,14,11,14,16,15,14,6,Juri Judt,ÃÂ£1.13m ,Bundesliga
19/6/2011,Juraj Kucka,63001138,794,2/26/1987,24,16,0,11,0,5500,6750,7000,155,142,1247466,186,87,M C,3,1,2,1,3,1,2,4,2,2,2,10,10,12,8,10,11,9,15,5,11,15,12,13,13,12,14,15,12,16,12,12,14,14,11,9,13,11,14,12,11,14,11,11,16,12,20,16,16,14,15,10,12,13,13,11,18,16,14,12,10,2,1,1,20,5,1,1,20,M C,401,1,1,1,5,1,1,1,1,1,15,20,1,1,1,1,4194824.0,0,0,0,1,0,0,0,0,0,1,0,0,0,0,0,0,0,0,0,0,0,0,1,0,0,0,0,0,0,0,0,0,0,0,0,0,0,0,0,0,0,0,0,0,0,0,0,0,Juraj Kucka,Â£4.32m ,33.0,186.0,Midfielder - Central Midfield,right,Parma Calcio 1913,42.0,5.0,1.0,3417.0,29.0,2.0,1.0,2019.0,33.0,3.0,3.0,2819.0,12.0,2.0,0.0,853.0,34.0,2.0,2.0,1861.0,35.0,1.0,4.0,2495.0,33.0,4.0,2.0,2369.0,28.0,3.0,6.0,2213.0,28.0,4.0,3.0,1964.0,Serie A,28.0,6.0,4.0,2049.0,5.0,1.0,0.0,441.0
19/6/2011,John Obi Mikel,5116933,38,4/22/1987,24,34,2,6,1,7500,7519,8000,170,159,36363636,188,86,DM/M C,3,3,1,2,3,2,3,5,2,2,1,10,12,11,6,18,10,8,4,3,14,17,13,14,16,14,17,14,19,13,16,15,18,10,10,13,17,14,15,9,13,16,12,15,17,10,20,18,20,14,11,16,8,12,18,19,10,16,10,8,12,15,1,1,18,10,1,1,18,DM/M C,311,1,1,1,10,1,1,1,1,1,20,18,1,1,1,1,17593300000000.0,0,0,0,0,0,0,0,0,0,0,0,0,0,0,0,0,0,1,0,1,0,0,1,0,0,0,0,0,0,0,1,0,0,0,0,0,0,0,0,0,0,0,0,0,1,0,0,0,nan,nan,nan,nan,nan,nan,nan,nan,nan,nan,nan,nan,nan,nan,nan,nan,nan,nan,nan,nan,nan,nan,nan,nan,nan,nan,nan,nan,nan,nan,nan,nan,nan,nan,nan,nan,nan,nan,nan,nan,nan,nan,nan,nan,nan,nan,nan,nan,nan,nan,nan,nan,29/6/2010,John Obi Mikel,5116933,38,4/22/1987,23,29,2,6,1,6084,7500,8000,175,156,105617647,188,86,DM/M C,2,3,2,3,1,1,2,6,3,3,1,10,12,11,6,18,10,8,4,3,14,15,13,14,16,14,16,14,18,13,16,15,18,10,10,13,17,14,15,9,13,16,12,15,17,10,20,18,20,14,11,16,8,12,18,19,10,16,10,8,12,15,nan,nan,nan
19/6/2011,Javi GarcÃ­a,7458324,796,2/8/1987,24,0,0,9,0,5750,7050,7050,152,141,4743083,186,82,DM ,3,3,1,3,2,2,1,4,2,2,2,8,8,7,11,11,11,17,14,9,15,11,10,15,11,17,16,14,12,16,11,13,15,5,13,8,17,18,15,10,11,17,15,8,15,11,20,15,15,15,14,13,10,11,11,14,13,14,15,9,15,8,13,1,12,7,5,2,13,DM ,300,1,7,1,7,1,1,13,2,2,20,12,1,5,1,1,256.0,0,0,0,0,0,0,0,0,1,0,0,0,0,0,0,0,0,0,0,0,0,0,0,0,0,0,0,0,0,0,0,0,0,0,0,0,0,0,0,0,0,0,0,0,0,0,0,0,Javi GarcÃ­a,Â£9.45m ,33.0,187.0,Midfielder - Defensive Midfield,right,Boavista FC,45.0,8.0,2.0,3919.0,39.0,2.0,1.0,3219.0,35.0,2.0,0.0,2184.0,43.0,0.0,0.0,2630.0,36.0,3.0,0.0,2958.0,38.0,3.0,0.0,3053.0,31.0,1.0,0.0,2593.0,36.0,1.0,0.0,2760.0,22.0,0.0,0.0,1172.0,Liga NOS,9.0,0.0,0.0,464.0,5.0,1.0,1.0,439.0,29/6/2010,Javi GarcÃ­a,7458324,796,2/8/1987,23,0,0,9,0,4830,7000,7000,152,139,28129942,186,82,DM C,2,2,3,1,2,2,2,1,3,3,1,9,9,9,12,12,12,17,15,10,16,12,11,14,12,17,15,14,13,16,12,12,15,5,9,11,17,19,16,11,12,18,16,8,15,12,20,16,16,14,13,13,10,11,11,14,13,12,13,13,15,8,Javi GarcÃÂ­a,ÃÂ£8.46m ,Liga NOS
19/6/2011,Jamel Saihi,8445738,51,1/21/1987,24,4,1,0,0,4550,6350,5700,140,127,483015,181,73,DM C,3,2,1,3,1,2,2,1,2,1,1,9,9,11,6,13,11,11,14,8,11,13,8,12,13,12,14,15,13,13,13,12,15,9,9,8,13,16,16,12,13,14,10,8,13,11,20,16,12,13,12,14,11,8,16,13,17,13,14,14,14,6,1,1,15,1,1,1,15,DM C,301,1,1,1,1,1,1,1,1,1,20,15,1,1,1,1,0.0,0,0,0,0,0,0,0,0,0,0,0,0,0,0,0,0,0,0,0,0,0,0,0,0,0,0,0,0,0,0,0,0,0,0,0,0,0,0,0,0,0,0,0,0,0,0,0,0,Jamel Saihi,Â£3.15m ,33.0,182.0,Midfielder - Defensive Midfield,right,Retired,18.0,1.0,0.0,848.0,33.0,0.0,1.0,2610.0,15.0,0.0,0.0,1262.0,14.0,0.0,0.0,793.0,21.0,0.0,0.0,1468.0,15.0,0.0,0.0,707.0,9.0,0.0,0.0,473.0,nan,nan,nan,nan,nan,nan,nan,nan,Ligue 1,nan,nan,nan,nan,nan,nan,nan,nan,29/6/2010,Jamel Saihi,8445738,51,1/21/1987,23,4,1,0,0,3300,5900,5300,140,118,2933132,181,73,DM C,3,2,2,2,1,1,1,1,1,3,2,8,8,11,7,11,11,11,14,8,10,14,8,12,14,12,14,14,13,13,13,12,14,8,11,8,12,16,14,10,12,14,10,5,14,12,20,16,12,13,12,14,10,10,9,13,16,13,14,14,14,6,Jamel Saihi,ÃÂ£900Th. ,Ligue 1
19/6/2011,Issam El Adoua,12006148,34,9/12/1986,24,1,0,4,0,4150,5800,5750,135,122,429636,189,74,D/DM C,1,1,2,3,2,3,2,2,3,3,3,5,8,8,6,10,5,15,9,10,13,11,5,13,10,12,14,13,13,14,8,12,14,6,10,9,15,15,15,12,10,16,15,8,13,10,20,15,13,12,12,14,8,5,11,15,13,11,14,14,15,6,20,1,7,1,10,1,20,D/DM C,111,1,1,1,1,1,1,20,1,10,17,7,1,1,1,1,0.0,0,0,0,0,0,0,0,0,0,0,0,0,0,0,0,0,0,0,0,0,0,0,0,0,0,0,0,0,0,0,0,0,0,0,0,0,0,0,0,0,0,0,0,0,0,0,0,0,Issam El Adoua,Â£900Th. ,33.0,190.0,Midfielder - Defensive Midfield,right,Al-Dhafra SCC,nan,nan,nan,nan,34.0,0.0,0.0,2878.0,31.0,1.0,2.0,2462.0,23.0,0.0,0.0,1455.0,37.0,2.0,3.0,3255.0,12.0,0.0,0.0,1080.0,21.0,0.0,0.0,1890.0,20.0,2.0,0.0,1744.0,26.0,0.0,0.0,2285.0,Liga NOS,17.0,1.0,1.0,1530.0,1.0,0.0,0.0,90.0
19/6/2011,Gonzalo Castro,8723487,771,6/11/1987,24,5,0,21,3,5500,6850,6850,160,142,3194925,171,74,D/WB/DM/M/AM RLC,1,1,2,2,3,3,2,4,3,2,2,13,13,14,8,14,13,8,11,11,12,15,12,11,14,12,13,12,11,11,13,11,12,13,7,12,9,13,13,15,16,13,6,15,12,13,20,12,10,8,8,12,4,19,10,11,17,11,12,12,14,4,20,16,20,16,20,16,20,D/WB/DM/M/AM RLC,146,1,1,1,10,16,10,1,16,20,16,20,16,12,12,16,1048584.0,0,0,0,1,0,0,0,0,0,0,0,0,0,0,0,0,0,0,0,0,1,0,0,0,0,0,0,0,0,0,0,0,0,0,0,0,0,0,0,0,0,0,0,0,0,0,0,0,Gonzalo Castro,Â£8.10m ,33.0,172.0,Midfielder - Central Midfield,right,VfB Stuttgart,32.0,6.0,9.0,2262.0,40.0,2.0,8.0,3474.0,40.0,8.0,9.0,3140.0,39.0,5.0,12.0,3176.0,32.0,2.0,11.0,2772.0,41.0,7.0,11.0,2679.0,42.0,4.0,8.0,2885.0,28.0,1.0,3.0,1840.0,28.0,2.0,4.0,1892.0,Bundesliga,31.0,3.0,7.0,2321.0,6.0,1.0,1.0,466.0,29/6/2010,Gonzalo Castro,8723487,771,6/11/1987,23,5,0,21,3,4500,6900,6900,168,138,13523993,171,72,D/WB/DM/M RC,1,3,1,2,2,2,2,1,2,2,3,13,13,14,8,13,13,8,11,11,12,15,12,11,14,12,13,11,11,11,13,11,12,12,7,12,10,13,13,16,16,13,6,15,12,13,20,12,10,12,8,12,4,16,10,11,17,11,12,12,14,4,Gonzalo Castro,ÃÂ£8.10m ,Bundesliga
19/6/2011,Gojko Kacar,5779401,802,1/26/1987,24,22,0,15,8,6250,6808,6628,157,142,8304880,183,77,D/DM/M C,3,2,3,1,2,2,3,1,1,2,3,7,10,14,15,10,9,17,13,12,17,10,9,17,14,18,14,18,12,8,14,16,18,10,13,17,9,12,19,10,13,17,15,11,6,15,20,10,13,11,9,15,12,20,16,17,8,12,9,10,7,6,16,11,20,12,14,1,20,D/DM/M C,431,1,1,10,12,1,1,16,1,10,19,20,1,14,1,11,8933530000000.0,0,0,1,0,0,1,0,0,0,1,0,0,0,0,0,0,0,0,0,0,0,0,0,0,0,0,0,0,0,0,0,0,0,0,0,0,0,1,0,0,0,0,0,1,0,0,0,0,Gojko Kacar,Â£3.60m ,33.0,185.0,Midfielder - Defensive Midfield,right,Without Club,23.0,2.0,1.0,1592.0,23.0,1.0,1.0,1319.0,7.0,0.0,0.0,356.0,26.0,3.0,1.0,2114.0,15.0,3.0,0.0,829.0,19.0,1.0,0.0,1117.0,23.0,0.0,1.0,1184.0,6.0,1.0,0.0,225.0,6.0,0.0,0.0,275.0,Bundesliga,nan,nan,nan,nan,nan,nan,nan,nan,29/6/2010,Gojko Kacar,5779401,802,1/26/1987,23,18,0,15,8,5041,6900,6750,163,142,12432500,183,77,DM/M C,1,2,3,1,2,2,2,4,3,2,1,7,10,14,16,9,9,17,13,12,17,10,9,17,14,18,14,18,12,8,15,16,18,10,13,17,9,12,19,10,13,17,16,11,6,15,20,10,13,11,9,15,12,20,16,17,8,12,9,10,7,6,Gojko Kacar,ÃÂ£6.75m ,Bundesliga
19/6/2011,Fernando Tissone,1408776,1649,7/24/1986,24,0,0,0,0,4000,6017,6900,141,127,551474,180,77,DM/M C,2,3,3,1,3,2,2,2,2,1,2,11,12,12,12,13,12,8,14,6,10,13,10,11,13,11,14,14,13,13,13,14,15,11,10,9,14,13,13,12,12,10,7,10,16,11,20,14,10,15,9,16,7,15,15,15,13,16,15,14,15,5,1,1,20,12,10,10,20,DM/M C,311,1,1,1,12,1,1,1,1,1,20,20,10,10,1,1,4194304.0,0,0,0,0,0,0,0,0,0,0,0,0,0,0,0,0,0,0,0,0,0,0,1,0,0,0,0,0,0,0,0,0,0,0,0,0,0,0,0,0,0,0,0,0,0,0,0,0,Fernando Tissone,Â£2.25m ,34.0,182.0,Midfielder - Central Midfield,right,Without Club,27.0,1.0,1.0,1705.0,29.0,0.0,0.0,1961.0,27.0,0.0,2.0,1693.0,28.0,1.0,2.0,2287.0,8.0,0.0,0.0,348.0,13.0,0.0,0.0,1087.0,nan,nan,nan,nan,27.0,1.0,0.0,2191.0,12.0,1.0,0.0,844.0,LaLiga,nan,nan,nan,nan,nan,nan,nan,nan,29/6/2010,Fernando Tissone,1408776,1649,7/24/1986,23,0,0,0,0,4900,7000,7000,159,140,8630562,180,77,DM/M C,1,1,3,2,1,1,2,8,3,1,1,12,13,13,13,14,13,9,15,7,11,14,11,12,14,11,15,14,14,14,14,15,15,11,10,10,15,14,14,13,13,11,8,10,16,12,20,15,11,15,9,16,7,15,15,15,13,16,15,14,15,5,Fernando Tissone,ÃÂ£2.16m ,Serie A
19/6/2011,Federico Fazio,964847,1649,3/17/1987,24,2,0,16,1,5500,6709,6900,158,140,1084767,195,85,D/DM C,1,3,1,1,2,1,1,2,2,1,1,4,6,8,7,10,8,16,8,13,14,13,10,15,11,14,15,14,12,10,9,13,13,6,9,8,14,13,15,12,11,18,17,12,9,12,20,16,19,13,14,9,13,14,13,12,12,12,14,14,11,11,20,1,1,1,1,1,20,D/DM C,111,1,12,1,1,1,1,20,1,1,19,1,1,1,1,1,64.0,0,0,0,0,0,0,1,0,0,0,0,0,0,0,0,0,0,0,0,0,0,0,0,0,0,0,0,0,0,0,0,0,0,0,0,0,0,0,0,0,0,0,0,0,0,0,0,0,Federico Fazio,Â£3.60m ,33.0,195.0,Defender - Centre-Back,right,AS Roma,25.0,1.0,0.0,1954.0,33.0,1.0,0.0,2538.0,33.0,4.0,0.0,2743.0,41.0,3.0,2.0,3628.0,32.0,0.0,1.0,2856.0,7.0,0.0,0.0,553.0,48.0,4.0,1.0,3946.0,45.0,2.0,2.0,3842.0,42.0,5.0,0.0,3524.0,LaLiga,23.0,2.0,0.0,1765.0,1.0,0.0,0.0,90.0,29/6/2010,Federico Fazio,964847,1649,3/17/1987,23,0,0,16,1,4422,6500,6650,157,133,636645,195,85,D/DM C,2,2,2,2,1,1,1,1,2,3,3,4,6,7,6,10,8,16,8,13,13,12,10,15,11,14,13,13,10,11,8,12,13,4,9,8,13,13,15,12,10,18,17,12,16,12,20,16,19,12,14,9,7,13,13,12,12,12,14,14,11,11,Federico Fazio,ÃÂ£2.70m ,LaLiga
19/6/2011,Fabien Lemoine,8431727,769,3/16/1987,24,0,0,1,0,4650,5800,5800,140,129,474308,175,67,DM/M C,2,1,3,3,2,2,2,3,3,1,3,12,11,9,6,12,12,9,11,6,12,13,7,13,12,13,14,15,12,13,12,13,15,7,12,7,12,16,17,14,12,13,8,10,13,13,20,16,11,14,13,15,10,8,10,13,16,14,16,13,13,7,5,5,16,10,10,1,16,DM/M C,311,1,1,1,1,1,10,1,1,5,20,16,1,10,1,5,0.0,0,0,0,0,0,0,0,0,0,0,0,0,0,0,0,0,0,0,0,0,0,0,0,0,0,0,0,0,0,0,0,0,0,0,0,0,0,0,0,0,0,0,0,0,0,0,0,0,Fabien Lemoine,Â£4.05m ,33.0,175.0,Midfielder - Defensive Midfield,right,FC Lorient,20.0,0.0,2.0,805.0,30.0,0.0,5.0,2288.0,41.0,1.0,3.0,3032.0,40.0,2.0,3.0,3319.0,48.0,2.0,4.0,3963.0,43.0,0.0,1.0,3294.0,24.0,1.0,0.0,1422.0,35.0,2.0,3.0,3055.0,33.0,1.0,2.0,2796.0,Ligue 1,26.0,0.0,0.0,2260.0,7.0,0.0,0.0,451.0
19/6/2011,FabiÃ¡n Rinaudo,965125,1649,5/8/1987,24,1,0,0,0,3150,6017,6017,134,127,748480,176,75,DM ,1,2,1,2,3,1,2,3,2,2,2,5,9,10,8,12,5,9,11,8,15,11,8,16,10,17,13,16,9,14,14,9,14,5,13,7,14,15,15,13,11,13,7,7,13,14,20,15,13,15,15,13,9,6,12,13,14,15,14,11,11,8,1,1,10,1,1,1,10,DM ,300,1,1,1,1,1,1,1,1,1,20,10,1,1,1,1,8933530000000.0,0,0,0,0,0,0,0,0,0,0,0,0,0,0,0,0,0,0,0,0,0,0,0,0,0,0,0,0,0,0,0,0,0,0,0,0,0,1,0,0,0,0,0,1,0,0,0,0,FabiÃ¡n Rinaudo,Â£5.67m ,33.0,175.0,Midfielder - Defensive Midfield,right,Club AtlÃ©tico Rosario Central,35.0,0.0,0.0,3068.0,18.0,1.0,1.0,1309.0,30.0,1.0,0.0,2612.0,23.0,0.0,0.0,1730.0,45.0,3.0,1.0,3763.0,11.0,0.0,0.0,990.0,17.0,3.0,0.0,1530.0,24.0,0.0,0.0,2160.0,31.0,0.0,1.0,2655.0,Liga NOS,23.0,2.0,2.0,2070.0,nan,nan,nan,nan
19/6/2011,DjikinÃ©,55012455,31,5/16/1987,24,0,0,0,0,2000,4049,4000,109,90,60967,188,82,DM C,2,1,3,2,2,3,2,3,1,3,3,7,7,8,8,10,10,13,9,10,11,10,10,12,10,12,10,13,11,10,10,8,13,7,11,11,11,14,12,12,12,15,14,20,15,12,5,13,15,10,10,10,7,12,14,14,13,13,14,14,14,5,15,1,10,1,1,1,15,DM C,301,1,1,1,1,1,1,15,1,1,20,10,1,1,1,1,0.0,0,0,0,0,0,0,0,0,0,0,0,0,0,0,0,0,0,0,0,0,0,0,0,0,0,0,0,0,0,0,0,0,0,0,0,0,0,0,0,0,0,0,0,0,0,0,0,0,nan,nan,nan,nan,nan,nan,nan,nan,nan,nan,nan,nan,nan,nan,nan,nan,nan,nan,nan,nan,nan,nan,nan,nan,nan,nan,nan,nan,nan,nan,nan,nan,nan,nan,nan,nan,nan,nan,nan,nan,nan,nan,nan,nan,nan,nan,nan,nan,nan,nan,nan,nan,29/6/2010,DjikinÃ©,55012455,31,5/16/1987,23,0,0,0,0,2000,4049,4000,116,90,226015,188,82,DM C,2,2,3,1,1,1,1,1,1,2,1,7,7,8,8,10,10,13,9,10,11,10,10,12,10,12,10,13,11,10,10,8,13,7,11,11,11,14,12,12,12,15,14,20,15,12,5,13,15,10,10,10,7,12,14,14,13,13,14,14,14,5,nan,nan,nan
19/6/2011,Didier Digard,917372,769,7/12/1986,24,0,0,10,0,4850,6095,6095,145,134,584355,184,81,DM C,1,2,2,3,3,3,2,1,2,2,3,12,10,9,6,11,8,13,12,7,12,13,8,14,11,15,14,16,13,13,12,14,15,6,13,9,14,14,16,14,13,15,11,8,12,13,20,15,15,13,15,15,13,15,8,15,13,14,15,13,11,9,12,10,15,8,10,1,15,DM C,301,1,1,1,8,1,1,12,1,10,20,15,1,1,1,10,8796090000000.0,0,0,1,0,0,0,0,0,0,1,0,0,0,0,0,0,0,0,0,0,0,0,0,0,0,0,0,0,0,0,0,0,0,0,0,0,0,0,0,0,0,0,0,1,0,0,0,0,Didier Digard,Â£2.70m ,34.0,183.0,Midfielder - Defensive Midfield,right,Retired,28.0,0.0,3.0,2300.0,33.0,0.0,3.0,2704.0,40.0,2.0,2.0,3428.0,35.0,2.0,1.0,2908.0,16.0,1.0,1.0,964.0,10.0,0.0,0.0,444.0,3.0,0.0,0.0,194.0,6.0,0.0,0.0,363.0,nan,nan,nan,nan,Ligue 1,nan,nan,nan,nan,nan,nan,nan,nan,29/6/2010,Didier Digard,917372,769,7/12/1986,23,0,0,10,0,4489,6000,6000,150,134,5746809,184,81,DM/M C,1,1,1,2,3,3,1,3,3,3,2,13,11,10,7,12,9,14,13,8,13,14,9,15,12,14,15,14,14,14,13,15,14,6,13,10,15,15,16,13,14,16,12,8,13,14,20,16,14,13,14,15,12,15,8,15,13,14,15,13,11,9,Didier Digard,ÃÂ£2.07m ,Ligue 1
19/6/2011,Cheick TiotÃ©,8170194,24,6/21/1986,24,14,0,0,0,5250,7000,7000,163,148,4688422,180,76,DM/M C,2,1,2,2,3,3,3,8,2,2,2,8,13,13,7,14,10,13,11,7,14,13,4,13,14,17,15,16,16,10,12,13,18,12,10,12,16,16,18,14,14,18,10,12,14,12,20,13,15,15,13,10,6,10,14,15,9,12,5,8,8,5,14,14,20,1,14,1,20,DM/M C,311,1,1,1,1,1,1,14,1,14,20,20,1,1,1,14,21743271936.0,0,0,0,0,0,0,0,0,0,0,0,0,0,0,0,0,0,0,0,0,0,0,0,0,0,0,0,0,1,0,0,0,1,0,1,0,0,0,0,0,0,0,0,0,0,0,0,0,Cheik TiotÃ©,Â£11.25m ,nan,180.0,Midfielder - Defensive Midfield,right,---,31.0,1.0,1.0,2612.0,24.0,0.0,3.0,2044.0,31.0,0.0,1.0,2255.0,36.0,0.0,2.0,3064.0,12.0,0.0,2.0,987.0,22.0,0.0,0.0,1397.0,14.0,0.0,0.0,1105.0,nan,nan,nan,nan,nan,nan,nan,nan,Premier League,nan,nan,nan,nan,nan,nan,nan,nan,29/6/2010,Cheick TiotÃ©,8170194,24,6/21/1986,24,14,0,0,0,4225,6150,6350,145,130,8000040,180,76,DM/M C,1,2,3,3,3,1,2,7,2,2,2,10,11,13,7,12,10,13,11,6,12,12,10,11,14,17,13,16,15,14,12,13,15,12,10,12,10,12,16,12,14,13,10,12,14,12,20,13,15,10,17,1,5,10,13,9,5,10,9,5,5,12,Cheik TiotÃÂ©,ÃÂ£4.50m ,Premier League
19/6/2011,CÃ©dric Cambon,8428619,769,9/20/1986,24,0,0,2,0,3700,4650,4650,120,104,93913,183,76,D/DM C,1,2,2,1,3,3,3,1,1,1,3,5,8,8,6,10,6,13,7,7,10,11,6,13,10,13,13,13,12,12,9,12,12,6,9,6,13,15,15,12,10,13,11,20,15,8,8,16,13,13,13,14,5,10,10,14,14,10,14,14,14,7,20,1,10,1,1,10,20,D/DM C,111,1,12,1,1,1,1,20,10,1,17,10,1,1,1,1,0.0,0,0,0,0,0,0,0,0,0,0,0,0,0,0,0,0,0,0,0,0,0,0,0,0,0,0,0,0,0,0,0,0,0,0,0,0,0,0,0,0,0,0,0,0,0,0,0,0,CÃ©dric Cambon,Â£1.35m ,34.0,184.0,Defender - Centre-Back,right,Retired,30.0,3.0,0.0,2528.0,37.0,4.0,0.0,3250.0,25.0,1.0,0.0,2007.0,29.0,2.0,1.0,1859.0,28.0,1.0,0.0,2319.0,36.0,1.0,1.0,3073.0,31.0,0.0,0.0,2440.0,34.0,4.0,2.0,3019.0,33.0,0.0,0.0,2514.0,Ligue 1,20.0,0.0,0.0,1658.0,nan,nan,nan,nan
19/6/2011,Carlos Carmona,8835439,1652,2/21/1987,24,23,0,0,0,5000,7040,6450,145,128,141350,178,76,DM/M C,1,1,3,3,1,2,2,8,2,3,2,9,10,9,8,12,9,10,12,10,13,14,8,15,11,15,12,12,8,14,12,14,14,9,14,8,14,15,15,13,13,12,11,9,16,13,20,16,14,15,15,15,6,10,18,13,15,12,13,15,13,8,1,1,20,1,5,5,20,DM/M C,421,1,1,1,1,1,1,1,1,1,19,20,5,5,1,1,137443000000.0,0,0,0,0,0,0,1,0,0,0,0,0,0,0,0,0,0,0,0,0,0,0,1,0,0,0,0,0,0,0,0,0,0,0,0,0,0,1,0,0,0,0,0,0,0,0,0,0,Carlos Carmona,Â£1.80m ,33.0,178.0,Midfielder - Defensive Midfield,right,CSD Colo Colo,32.0,0.0,3.0,2606.0,29.0,1.0,0.0,2045.0,23.0,2.0,2.0,1705.0,33.0,2.0,0.0,2636.0,34.0,0.0,0.0,2898.0,9.0,0.0,0.0,558.0,35.0,2.0,1.0,2996.0,29.0,1.0,3.0,2421.0,2.0,0.0,0.0,177.0,Serie A,10.0,0.0,0.0,655.0,nan,nan,nan,nan
19/6/2011,Blaise Matuidi,8442483,769,4/9/1987,24,3,0,25,0,6513,7314,6614,160,146,5842302,175,70,DM/M C,2,2,3,1,2,1,3,4,3,2,1,6,11,12,6,12,8,7,10,8,10,13,9,17,13,12,16,14,15,13,12,14,15,8,13,8,15,16,18,15,16,13,7,20,15,13,10,18,12,16,12,14,7,14,9,14,14,14,16,16,16,5,10,10,17,1,1,10,17,DM/M C,311,1,1,1,1,1,1,10,10,1,20,17,1,1,10,1,137439000000.0,0,0,0,0,0,0,0,0,0,0,0,0,0,0,0,0,0,0,0,0,0,0,0,0,0,0,0,0,0,0,0,0,0,0,0,0,0,1,0,0,0,0,0,0,0,0,0,0,Blaise Matuidi,Â£9.00m ,33.0,175.0,Midfielder - Central Midfield,left,Inter Miami CF,37.0,0.0,2.0,3322.0,35.0,1.0,1.0,2499.0,52.0,8.0,1.0,4464.0,52.0,7.0,7.0,3769.0,53.0,5.0,5.0,3637.0,48.0,5.0,9.0,3353.0,52.0,7.0,5.0,3720.0,49.0,4.0,2.0,3257.0,42.0,3.0,3.0,3290.0,Ligue 1,57.0,1.0,2.0,3888.0,nan,nan,nan,nan,29/6/2010,Blaise Matuidi,8442483,769,4/9/1987,23,0,0,21,0,1450,6300,6300,165,140,8042850,175,70,DM/M C,1,2,3,2,1,2,3,5,3,1,1,7,11,10,7,12,8,8,11,8,10,14,9,14,12,12,17,14,14,17,12,14,14,8,12,8,15,15,18,15,15,12,7,20,15,12,10,17,12,15,8,14,7,12,14,14,14,14,16,16,16,5,Blaise Matuidi,ÃÂ£7.20m ,Ligue 1
19/6/2011,Benjamin Corgnet,85063843,769,4/6/1987,24,0,0,0,0,2631,5282,4070,140,117,284156,180,74,DM/M C,3,1,3,1,1,2,1,2,1,3,1,10,13,9,6,12,10,14,11,4,9,12,10,12,13,13,13,12,12,12,14,12,10,10,9,9,13,13,12,14,12,12,11,10,14,12,20,13,10,14,12,8,3,10,9,11,12,14,17,13,13,4,12,12,20,13,12,1,20,DM/M C,421,1,1,1,13,1,1,1,1,12,18,20,1,1,1,12,0.0,0,0,0,0,0,0,0,0,0,0,0,0,0,0,0,0,0,0,0,0,0,0,0,0,0,0,0,0,0,0,0,0,0,0,0,0,0,0,0,0,0,0,0,0,0,0,0,0,Benjamin Corgnet,Â£4.05m ,33.0,179.0,Midfielder - Attacking Midfield,right,Without Club,33.0,1.0,2.0,2508.0,40.0,9.0,3.0,3207.0,34.0,8.0,5.0,2576.0,33.0,7.0,2.0,2081.0,32.0,1.0,4.0,1542.0,25.0,3.0,2.0,1022.0,11.0,1.0,0.0,397.0,18.0,0.0,2.0,1380.0,20.0,1.0,3.0,917.0,Ligue 1,11.0,2.0,0.0,593.0,nan,nan,nan,nan
19/6/2011,Benjamin Angoua,38001740,24,11/28/1986,24,7,0,4,0,4917,6121,5469,140,122,378141,183,72,D/DM RC,1,3,1,2,1,3,3,1,2,1,1,5,9,6,6,7,5,14,7,10,13,8,6,14,7,13,15,14,15,13,9,12,13,9,6,8,13,15,13,11,12,14,12,10,13,14,20,15,13,14,13,12,8,10,14,12,13,13,14,11,11,7,20,15,10,1,15,12,20,D/DM RC,113,1,1,1,1,1,1,20,12,15,18,10,1,1,12,15,0.0,0,0,0,0,0,0,0,0,0,0,0,0,0,0,0,0,0,0,0,0,0,0,0,0,0,0,0,0,0,0,0,0,0,0,0,0,0,0,0,0,0,0,0,0,0,0,0,0,Benjamin Angoua,Â£2.25m ,33.0,183.0,Defender - Centre-Back,right,Stade Briochin,34.0,1.0,0.0,3010.0,22.0,0.0,0.0,1908.0,25.0,0.0,1.0,2228.0,17.0,1.0,0.0,1485.0,30.0,0.0,0.0,2326.0,20.0,1.0,0.0,1477.0,39.0,1.0,2.0,3434.0,nan,nan,nan,nan,7.0,0.0,0.0,532.0,Ligue 1,17.0,1.0,0.0,1487.0,9.0,1.0,0.0,810.0,29/6/2010,Benjamin Angoua,38001740,24,11/28/1986,23,7,1,4,1,3481,5900,5300,140,118,2686252,183,72,D/DM RC,2,2,3,2,2,1,3,8,2,1,1,5,9,6,6,7,5,14,7,10,13,8,6,13,7,13,15,14,15,13,10,12,13,9,6,8,13,15,13,10,12,14,12,10,13,14,20,15,13,15,13,13,8,10,14,12,13,13,14,11,11,7,Benjamin Angoua,ÃÂ£1.98m ,Ligue 1
19/6/2011,BeÃ±at,7458307,796,2/19/1987,24,0,0,0,0,4565,6561,6561,145,131,678325,175,67,DM/M C,2,3,2,3,3,1,1,8,3,1,3,16,12,12,12,13,17,12,16,8,12,15,10,13,14,12,13,12,13,13,14,13,13,13,13,13,12,13,13,11,13,12,9,10,10,12,20,12,11,15,6,15,8,10,11,15,13,14,14,10,13,5,5,1,20,5,1,1,20,DM/M C,421,1,1,1,5,1,1,5,1,1,17,20,1,1,1,1,67109120.0,0,0,0,0,0,0,0,0,1,0,0,0,0,0,0,0,0,0,0,0,0,0,0,0,0,0,1,0,0,0,0,0,0,0,0,0,0,0,0,0,0,0,0,0,0,0,0,0,nan,nan,nan,nan,nan,nan,nan,nan,nan,nan,nan,nan,nan,nan,nan,nan,nan,nan,nan,nan,nan,nan,nan,nan,nan,nan,nan,nan,nan,nan,nan,nan,nan,nan,nan,nan,nan,nan,nan,nan,nan,nan,nan,nan,nan,nan,nan,nan,nan,nan,nan,nan
19/6/2011,Arturo Vidal,75000273,1652,5/22/1987,24,35,3,6,2,6000,7350,7850,171,157,3647694,180,74,DM/M C,3,3,2,2,1,2,2,10,3,2,1,12,14,13,9,16,9,15,12,11,17,16,19,17,16,19,15,17,18,7,14,9,17,17,13,9,10,5,19,13,17,16,12,14,18,13,20,18,11,13,17,15,4,18,9,19,5,18,10,3,6,14,13,13,20,14,13,13,20,DM/M C,421,1,7,1,14,1,1,10,13,13,19,20,12,12,13,13,176098000000.0,0,0,0,0,0,0,0,0,0,0,0,0,0,0,0,0,0,0,0,1,0,0,1,0,0,0,0,0,0,0,0,0,1,0,0,1,0,1,0,0,0,0,0,0,0,0,0,0,Arturo Vidal,Â£21.60m ,33.0,180.0,Midfielder - Central Midfield,right,Inter Milan,44.0,13.0,10.0,3505.0,35.0,7.0,4.0,2845.0,45.0,15.0,12.0,3753.0,46.0,18.0,5.0,3601.0,45.0,8.0,4.0,3625.0,48.0,7.0,12.0,3234.0,41.0,9.0,4.0,2946.0,35.0,6.0,2.0,2309.0,53.0,3.0,7.0,2744.0,Serie A,43.0,8.0,3.0,2245.0,6.0,0.0,0.0,393.0,29/6/2010,Arturo Vidal,75000273,1652,5/22/1987,23,27,1,0,0,5500,7350,7700,174,152,10532183,180,74,DM/M C,3,3,1,1,1,2,2,8,1,3,3,8,13,14,7,15,11,12,13,8,14,15,18,16,16,19,15,18,12,14,14,12,18,14,12,8,14,14,18,13,16,12,11,10,15,14,20,14,12,18,17,15,4,18,13,18,11,17,15,4,5,12,Arturo Vidal,ÃÂ£18.00m ,Bundesliga
19/6/2011,Alejandro Faurlin,956670,1649,8/9/1986,24,0,0,10,2,3250,5250,6550,152,138,841690,185,79,DM/M C,2,2,1,1,2,1,1,2,2,2,2,14,13,15,10,16,12,9,13,5,11,18,15,12,15,9,13,12,15,12,13,16,14,15,10,11,12,14,13,14,12,13,12,20,16,12,6,12,14,12,7,14,4,9,12,11,13,12,13,13,15,6,1,1,20,14,1,1,20,DM/M C,421,1,1,1,14,1,1,1,1,1,17,20,1,1,1,1,17196646400.0,0,0,0,0,0,0,0,0,0,0,0,0,0,0,0,0,0,0,0,0,0,0,0,0,1,0,0,0,0,0,0,0,0,0,1,0,0,0,0,0,0,0,0,0,0,0,0,0,Alejandro FaurlÃ­n,Â£4.05m ,34.0,185.0,Midfielder - Central Midfield,left,Without Club,41.0,3.0,3.0,3553.0,21.0,1.0,2.0,1890.0,21.0,0.0,3.0,1442.0,9.0,0.0,1.0,582.0,3.0,0.0,0.0,150.0,30.0,0.0,6.0,2469.0,31.0,5.0,1.0,2300.0,17.0,0.0,0.0,851.0,20.0,0.0,0.0,1480.0,Premier League,13.0,0.0,1.0,882.0,nan,nan,nan,nan
19/6/2011,Yohan Cabaye,919628,769,1/14/1986,25,4,0,16,3,6650,7400,6913,160,148,4796050,175,72,DM/M C,1,3,2,1,2,1,2,4,1,3,1,14,14,13,10,14,15,9,16,7,8,17,15,12,14,12,15,14,14,14,14,14,16,9,14,10,13,16,15,14,14,13,8,10,15,12,20,16,12,15,12,14,8,8,14,17,13,15,11,12,12,10,1,1,20,12,1,1,20,DM/M C,311,1,1,1,12,1,1,1,1,1,20,20,1,1,1,1,8813270000000.0,0,0,0,0,0,0,0,0,1,0,0,0,0,0,0,0,0,0,0,0,0,0,0,0,0,0,0,0,0,0,0,0,0,0,1,0,0,0,0,0,0,0,0,1,0,0,0,0,Yohan Cabaye,Â£14.85m ,34.0,173.0,Midfielder - Central Midfield,right,Without Club,50.0,5.0,11.0,3975.0,38.0,5.0,9.0,3254.0,35.0,6.0,2.0,2689.0,41.0,8.0,6.0,2577.0,36.0,2.0,1.0,1634.0,40.0,6.0,2.0,3178.0,35.0,4.0,3.0,2339.0,34.0,0.0,1.0,2577.0,12.0,1.0,2.0,1070.0,Premier League,21.0,1.0,1.0,1173.0,nan,nan,nan,nan,29/6/2010,Yohan Cabaye,919628,769,1/14/1986,24,0,0,15,3,5150,6479,6450,160,144,4709342,175,72,DM/M C,2,2,2,3,2,3,1,6,2,1,3,14,14,12,10,13,15,9,16,7,7,15,17,13,14,14,15,14,13,13,14,13,16,9,14,10,14,15,15,14,14,13,7,10,15,12,20,16,13,14,11,14,6,8,9,17,11,15,11,12,12,10,Yohan Cabaye,ÃÂ£9.90m ,Ligue 1
19/6/2011,Vincent Kompany,8152558,757,4/10/1986,25,39,1,0,0,7000,8250,8250,175,164,18181818,191,91,D/DM C,1,2,1,1,1,3,1,6,3,3,3,5,5,9,7,14,12,18,10,12,16,12,10,17,13,14,15,18,16,15,12,14,17,11,16,9,17,14,15,15,15,16,16,10,12,13,20,15,16,17,8,15,10,14,15,18,16,18,16,17,16,15,20,1,15,1,12,1,20,D/DM C,111,1,1,1,1,1,1,20,1,12,17,15,1,1,1,1,0.0,0,0,0,0,0,0,0,0,0,0,0,0,0,0,0,0,0,0,0,0,0,0,0,0,0,0,0,0,0,0,0,0,0,0,0,0,0,0,0,0,0,0,0,0,0,0,0,0,Vincent Kompany,Â£31.50m ,34.0,190.0,Defender - Centre-Back,right,Retired,50.0,0.0,2.0,4279.0,42.0,3.0,2.0,3608.0,37.0,1.0,0.0,3179.0,37.0,5.0,1.0,3129.0,33.0,0.0,0.0,2753.0,22.0,2.0,0.0,1661.0,15.0,3.0,0.0,1167.0,21.0,2.0,1.0,1756.0,26.0,1.0,1.0,1782.0,Premier League,18.0,1.0,1.0,1484.0,nan,nan,nan,nan,29/6/2010,Vincent Kompany,8152558,757,4/10/1986,24,31,1,0,0,5476,7750,7400,156,148,14692290,191,91,D/DM C,3,2,1,2,2,1,3,1,2,1,2,5,5,9,7,14,12,15,10,12,14,12,10,16,12,14,15,14,14,12,12,12,15,11,14,9,15,14,14,15,15,16,16,10,6,13,20,15,16,11,8,15,17,14,14,13,11,18,8,17,14,12,Vincent Kompany,ÃÂ£18.00m ,Premier League
19/6/2011,Tiberio Guarente,7990140,776,11/1/1985,25,0,0,3,0,4900,6800,6500,152,136,4743083,182,74,DM/M C,1,2,1,1,2,1,1,4,2,3,1,12,14,10,8,14,13,6,13,10,12,14,11,13,14,15,15,14,10,11,14,14,16,13,14,12,12,15,13,13,12,14,10,20,6,14,12,13,13,12,13,15,18,9,13,15,14,13,14,13,10,16,1,1,20,8,1,1,20,DM/M C,421,1,1,1,8,1,1,1,1,1,19,20,1,1,1,1,68719476864.0,0,0,0,0,0,0,0,1,0,0,0,0,0,0,0,0,0,0,0,0,0,0,0,0,0,0,0,0,0,0,0,0,0,0,0,0,1,0,0,0,0,0,0,0,0,0,0,0,Tiberio Guarente,Â£2.70m ,34.0,182.0,Midfielder - Central Midfield,left,Retired,10.0,0.0,1.0,522.0,3.0,0.0,0.0,32.0,23.0,2.0,1.0,1263.0,24.0,0.0,2.0,1415.0,1.0,0.0,0.0,7.0,nan,nan,nan,nan,nan,nan,nan,nan,nan,nan,nan,nan,nan,nan,nan,nan,LaLiga,nan,nan,nan,nan,nan,nan,nan,nan,29/6/2010,Tiberio Guarente,7990140,776,11/1/1985,24,0,0,3,0,4692,6800,6700,152,137,17627999,182,74,DM/M C,1,2,1,2,3,3,3,7,1,2,1,12,14,10,8,14,13,6,13,10,12,16,11,13,14,15,15,13,10,11,14,14,16,14,14,12,12,15,13,13,12,14,10,20,16,14,10,13,13,12,13,15,10,9,13,15,14,13,14,13,10,16,Tiberio Guarente,ÃÂ£4.95m ,LaLiga
19/6/2011,StÃ©phane Mbia,8440903,11,5/20/1986,25,38,3,4,1,5960,7362,6649,165,147,1459951,189,82,D/DM C,2,3,2,2,3,2,2,3,3,1,3,6,10,11,7,11,10,17,12,8,15,12,8,13,12,15,17,16,14,11,8,12,16,9,11,10,16,14,14,16,11,18,14,8,15,14,20,17,17,15,15,16,10,14,14,20,8,13,6,8,8,16,20,12,12,1,12,1,20,D/DM C,111,1,1,1,1,1,1,20,1,12,16,12,1,1,1,12,279173000000.0,0,0,0,0,0,0,0,0,1,0,0,0,0,0,0,0,0,0,0,0,0,0,0,0,0,0,0,0,0,0,0,0,1,0,0,0,0,0,1,0,0,0,0,0,0,0,0,0,StÃ©phane Mbia,Â£9.90m ,34.0,189.0,Midfielder - Defensive Midfield,right,Shanghai Greenland Shenhua,37.0,1.0,2.0,2921.0,24.0,2.0,0.0,1888.0,36.0,0.0,4.0,2960.0,30.0,5.0,4.0,2387.0,36.0,7.0,2.0,2447.0,45.0,9.0,1.0,3848.0,14.0,3.0,0.0,1250.0,nan,nan,nan,nan,29.0,0.0,2.0,2475.0,Ligue 1,12.0,0.0,0.0,932.0,nan,nan,nan,nan,29/6/2010,StÃ©phane Mbia,8440903,11,5/20/1986,24,34,3,4,1,5476,7400,6650,165,148,28514819,189,82,D/DM C,1,3,3,2,2,1,1,2,3,1,2,7,10,12,7,11,11,16,12,8,14,12,8,15,12,15,16,16,15,12,8,12,16,9,11,10,16,14,17,15,10,18,14,8,15,14,20,17,17,14,16,16,10,14,14,20,8,13,6,8,8,16,StÃÂ©phane Mbia,ÃÂ£13.50m ,Ligue 1
19/6/2011,Pape Sow,8429994,41,12/2/1985,25,0,0,0,0,1510,4650,4766,110,103,76477,180,76,D/DM C,2,1,2,2,3,3,3,4,2,1,1,5,8,8,6,10,10,14,13,6,13,9,7,10,11,16,8,16,10,10,6,9,12,10,9,10,8,14,16,12,9,17,14,16,14,9,20,16,17,8,15,13,6,15,14,12,10,9,13,13,9,7,17,1,10,1,1,1,17,D/DM C,321,1,10,1,1,1,1,17,1,1,20,10,1,1,1,1,35184400000000.0,0,0,0,0,0,0,0,0,0,0,0,0,0,0,0,0,0,0,0,0,0,0,0,0,0,0,0,0,0,0,0,0,0,0,0,0,0,0,0,0,0,0,0,0,0,1,0,0,Pape Sow,Â£900Th. ,34.0,181.0,Defender - Centre-Back,right,Retired,20.0,0.0,0.0,1376.0,28.0,1.0,0.0,2340.0,20.0,4.0,1.0,1421.0,18.0,0.0,1.0,1539.0,8.0,0.0,0.0,527.0,12.0,0.0,0.0,1080.0,nan,nan,nan,nan,nan,nan,nan,nan,nan,nan,nan,nan,Liga NOS,nan,nan,nan,nan,nan,nan,nan,nan,29/6/2010,Pape Sow,8429994,41,12/2/1985,24,0,0,0,0,750,4229,4200,120,94,1185410,180,76,D/DM C,3,1,2,2,2,3,2,1,2,2,1,5,8,6,6,8,11,13,13,6,13,9,7,10,8,16,13,15,10,10,6,9,12,7,12,7,11,12,14,12,9,15,10,5,12,9,20,15,15,12,16,13,13,10,11,12,10,9,13,13,13,7,Pape Sow,ÃÂ£270Th. ,Liga NOS
19/6/2011,Pape Diop,8440901,41,3/19/1986,25,1,0,0,0,4264,6271,6271,133,127,454545,180,73,DM C,2,1,3,2,3,1,1,2,2,2,3,10,11,8,11,10,6,13,12,10,12,11,8,14,9,18,14,18,5,15,9,10,15,8,8,8,12,16,19,15,15,15,11,7,17,14,20,17,14,12,16,13,11,8,14,12,13,10,16,7,4,8,1,1,15,1,1,1,15,DM C,301,1,1,1,1,1,1,1,1,1,20,15,1,1,1,1,32.0,0,0,0,0,0,1,0,0,0,0,0,0,0,0,0,0,0,0,0,0,0,0,0,0,0,0,0,0,0,0,0,0,0,0,0,0,0,0,0,0,0,0,0,0,0,0,0,0,Pape Diop,Â£2.70m ,34.0,180.0,Midfielder - Defensive Midfield,right,SD Eibar,20.0,0.0,2.0,1149.0,36.0,1.0,4.0,3046.0,41.0,1.0,0.0,3280.0,36.0,4.0,1.0,2772.0,19.0,0.0,1.0,1544.0,32.0,3.0,1.0,2652.0,19.0,0.0,0.0,981.0,22.0,0.0,0.0,1351.0,29.0,1.0,1.0,2401.0,LaLiga,30.0,1.0,0.0,2256.0,4.0,0.0,1.0,340.0,29/6/2010,Pape Diop,8440901,41,3/19/1986,24,0,0,0,0,4225,6500,6250,140,130,3681118,180,73,DM C,2,3,1,3,3,2,3,1,1,2,3,10,11,8,12,10,6,13,12,10,12,11,8,15,9,16,14,18,6,15,9,10,15,8,8,8,12,18,18,15,15,15,11,7,17,14,20,18,15,15,11,13,11,8,14,12,13,10,16,11,8,6,Pape Diop,ÃÂ£2.70m ,LaLiga
19/6/2011,Moustapha Bayal,34010587,41,11/30/1985,25,16,1,0,0,5450,6700,6081,145,134,1054318,191,90,D/DM C,2,2,3,3,1,2,2,6,2,2,1,6,8,8,6,10,12,17,16,7,14,11,7,13,10,15,15,16,13,12,11,12,15,6,13,7,13,16,16,13,10,18,17,8,15,9,20,15,18,13,12,14,7,10,14,14,13,13,13,13,13,9,20,1,10,1,1,1,20,D/DM C,111,1,1,1,1,1,1,20,1,1,18,10,1,1,1,1,35184400000000.0,0,0,0,0,0,0,0,0,0,0,0,0,0,0,0,1,0,0,0,0,0,0,0,0,0,0,0,0,0,0,0,0,0,0,0,0,0,0,0,0,0,0,0,0,0,1,0,0,Moustapha Sall,Â£720Th. ,34.0,193.0,Defender - Centre-Back,right,Without Club,21.0,0.0,0.0,1883.0,2.0,0.0,0.0,103.0,30.0,0.0,0.0,2629.0,37.0,1.0,1.0,3324.0,33.0,2.0,0.0,2939.0,38.0,6.0,0.0,3187.0,13.0,0.0,1.0,1096.0,11.0,0.0,0.0,965.0,nan,nan,nan,nan,Ligue 1,24.0,4.0,0.0,2160.0,nan,nan,nan,nan,29/6/2010,Moustapha Bayal,34010587,41,11/30/1985,24,6,1,0,0,3600,6750,6050,158,135,4764847,191,90,D/DM C,3,1,2,2,1,1,1,1,2,2,2,6,8,8,6,10,12,17,16,7,14,11,7,13,10,15,15,16,13,12,11,12,15,6,13,7,13,16,16,13,10,18,17,8,15,9,20,15,18,13,12,14,13,10,14,14,13,13,13,13,13,9,Moustapha Sall,ÃÂ£1.80m ,Ligue 1
19/6/2011,Miguel Veloso,744536,788,5/11/1986,25,14,1,12,3,6250,7500,6900,155,139,1895157,180,79,DM/M C,1,1,1,2,2,2,2,7,3,1,1,15,12,11,10,15,17,10,14,7,11,15,13,13,17,11,16,11,15,15,15,13,10,10,12,11,16,14,14,11,12,15,11,20,11,11,8,13,13,14,9,13,6,13,14,15,12,17,11,14,12,8,10,9,18,1,1,10,18,DM/M C,311,1,8,1,1,1,1,10,10,1,20,18,10,1,9,1,73018638848.0,0,0,0,0,0,0,0,0,0,1,0,0,0,0,0,0,0,0,0,0,0,0,1,0,0,0,0,0,0,0,0,0,1,0,0,0,1,0,0,0,0,0,0,0,0,0,0,0,Miguel Veloso,Â£9.00m ,34.0,180.0,Midfielder - Defensive Midfield,left,Hellas Verona,23.0,0.0,5.0,1433.0,31.0,2.0,1.0,2273.0,37.0,3.0,8.0,3223.0,32.0,2.0,5.0,2678.0,28.0,6.0,1.0,1714.0,30.0,3.0,6.0,2282.0,25.0,1.0,5.0,1993.0,23.0,1.0,0.0,1861.0,22.0,0.0,1.0,1294.0,Serie A,35.0,3.0,6.0,2936.0,2.0,0.0,0.0,180.0,29/6/2010,Miguel Veloso,744536,788,5/11/1986,24,14,1,12,3,5625,7500,7500,175,150,31380133,180,79,DM/M C,1,2,1,1,2,1,1,7,1,2,1,13,14,13,10,16,15,13,14,12,14,16,13,13,17,11,16,11,15,15,15,14,12,10,13,11,16,14,14,11,12,15,11,20,11,11,8,13,14,14,9,13,6,13,15,19,12,17,12,14,14,8,Miguel Veloso,ÃÂ£8.55m ,Serie A
19/6/2011,Michael Kammermeyer,35021010,771,1/14/1986,25,0,0,0,0,1500,4500,4500,110,100,29108,180,77,D/DM C,2,3,2,1,2,3,1,1,2,3,2,4,2,8,7,7,6,13,2,4,12,8,3,12,9,11,10,13,12,11,10,11,8,7,14,12,12,14,12,11,7,10,12,16,12,13,20,13,13,10,8,8,9,3,11,15,16,9,14,11,9,5,20,1,1,1,1,1,20,D/DM C,111,1,1,1,1,1,1,20,1,1,17,1,1,1,1,1,0.0,0,0,0,0,0,0,0,0,0,0,0,0,0,0,0,0,0,0,0,0,0,0,0,0,0,0,0,0,0,0,0,0,0,0,0,0,0,0,0,0,0,0,0,0,0,0,0,0,nan,nan,nan,nan,nan,nan,nan,nan,nan,nan,nan,nan,nan,nan,nan,nan,nan,nan,nan,nan,nan,nan,nan,nan,nan,nan,nan,nan,nan,nan,nan,nan,nan,nan,nan,nan,nan,nan,nan,nan,nan,nan,nan,nan,nan,nan,nan,nan,nan,nan,nan,nan,29/6/2010,Michael Kammermeyer,35021010,771,1/14/1986,24,0,0,0,0,1000,4900,4900,120,103,151993,180,77,D C,2,2,1,3,3,1,3,6,2,1,1,3,3,2,3,8,2,9,7,5,13,9,5,13,9,8,11,14,10,13,6,13,10,7,13,3,13,10,13,13,11,10,11,6,14,13,20,13,9,10,13,10,6,10,13,20,6,9,8,16,13,6,nan,nan,nan
19/6/2011,Mehmet Topal,470897,799,3/3/1986,25,18,0,13,1,5500,6550,7000,155,142,440496,187,76,DM C,1,2,3,1,1,3,2,3,2,2,3,3,10,10,5,12,7,10,13,6,12,14,10,16,12,14,13,14,11,13,7,11,12,8,7,6,16,17,14,11,13,16,15,18,13,15,20,17,14,14,9,17,15,13,4,16,15,10,14,14,15,4,15,1,12,1,10,1,15,DM C,301,1,1,1,1,1,1,15,1,1,20,12,1,10,1,1,140737000000000.0,0,0,0,0,0,0,0,0,1,1,0,0,0,0,0,0,0,0,0,0,0,0,0,0,0,0,0,0,0,0,0,0,0,0,0,0,0,0,0,0,0,0,0,0,0,0,0,1,Mehmet Topal,Â£7.20m ,34.0,187.0,Midfielder - Defensive Midfield,right,Istanbul Basaksehir FK,29.0,1.0,2.0,2221.0,30.0,2.0,0.0,2105.0,51.0,4.0,3.0,3923.0,31.0,3.0,1.0,2631.0,41.0,4.0,4.0,3619.0,53.0,3.0,4.0,4234.0,45.0,4.0,5.0,3948.0,41.0,3.0,5.0,3314.0,36.0,3.0,3.0,2626.0,LaLiga,32.0,0.0,1.0,1764.0,5.0,0.0,0.0,275.0,29/6/2010,Mehmet Topal,470897,799,3/3/1986,24,16,0,13,1,4900,6900,6900,155,140,20699998,187,76,DM C,3,3,3,2,1,1,3,2,2,3,2,3,10,10,5,12,7,10,13,6,12,14,10,16,12,13,13,12,10,13,7,11,12,9,7,6,14,17,14,11,13,15,15,18,13,15,20,17,13,14,9,17,15,12,9,16,15,10,14,14,15,4,Mehmet Topal,ÃÂ£6.75m ,LaLiga
19/6/2011,Markel,7458284,796,5/5/1986,25,0,0,0,0,4300,6050,6050,135,126,634342,180,74,DM/M C,3,2,2,1,2,2,1,2,3,2,1,4,6,11,9,12,5,11,7,5,13,12,9,16,11,13,14,13,12,11,10,12,10,7,10,8,14,15,17,13,12,12,10,11,13,13,20,17,14,11,9,10,11,9,13,13,15,12,9,7,11,5,1,1,17,1,1,1,17,DM/M C,311,1,1,1,1,1,1,1,1,1,20,17,1,1,1,1,0.0,0,0,0,0,0,0,0,0,0,0,0,0,0,0,0,0,0,0,0,0,0,0,0,0,0,0,0,0,0,0,0,0,0,0,0,0,0,0,0,0,0,0,0,0,0,0,0,0,Marcelo,Â£22.50m ,32.0,174.0,Defender - Left-Back,left,Real Madrid,50.0,5.0,10.0,4239.0,44.0,3.0,10.0,3540.0,19.0,1.0,1.0,1386.0,39.0,2.0,8.0,2998.0,53.0,4.0,10.0,4168.0,41.0,2.0,4.0,3383.0,47.0,3.0,13.0,3878.0,44.0,5.0,11.0,3671.0,34.0,3.0,6.0,2858.0,LaLiga,23.0,2.0,7.0,1884.0,3.0,0.0,1.0,270.0,29/6/2010,Markel,7458284,796,5/5/1986,24,0,0,0,0,3600,5650,5650,133,120,3134936,180,74,DM/M C,2,3,3,1,3,1,1,1,2,3,1,5,6,11,9,11,6,12,7,5,12,12,9,13,12,13,14,13,12,12,11,12,10,7,10,8,14,15,16,13,12,12,10,11,13,13,20,15,14,11,9,10,11,9,13,13,15,12,6,11,11,5,Marcelo,ÃÂ£18.00m ,LaLiga
19/6/2011,Marco Russ,8718185,771,8/4/1985,25,0,0,0,0,4500,6650,6650,137,133,5436934,190,75,D C,3,2,1,1,3,2,2,3,3,2,2,6,6,7,11,11,8,15,13,11,14,10,7,15,9,8,12,14,8,12,8,11,10,3,10,9,13,12,14,15,13,10,16,9,10,14,20,16,15,12,7,7,4,8,6,10,15,10,11,9,9,8,20,1,1,1,1,1,20,D C,101,1,1,1,1,1,1,20,1,1,15,1,1,1,1,1,512.0,0,0,0,0,0,0,0,0,0,1,0,0,0,0,0,0,0,0,0,0,0,0,0,0,0,0,0,0,0,0,0,0,0,0,0,0,0,0,0,0,0,0,0,0,0,0,0,0,Marco Russ,Â£3.15m ,35.0,190.0,Defender - Centre-Back,right,Retired,33.0,1.0,1.0,2970.0,26.0,1.0,0.0,2153.0,10.0,1.0,0.0,618.0,40.0,4.0,3.0,3284.0,28.0,2.0,3.0,2404.0,31.0,3.0,2.0,2619.0,6.0,0.0,0.0,259.0,25.0,1.0,0.0,1638.0,9.0,0.0,0.0,670.0,Bundesliga,1.0,0.0,0.0,37.0,nan,nan,nan,nan,29/6/2010,Marco Russ,8718185,771,8/4/1985,24,0,0,0,0,3250,6500,6500,142,130,5820498,190,75,D C,2,3,1,2,1,1,2,6,2,3,3,6,6,7,10,10,8,15,12,11,14,9,7,15,9,8,12,14,8,12,8,11,9,3,10,9,13,12,14,15,13,10,16,8,10,14,20,16,15,12,5,7,7,8,6,13,13,6,8,11,14,11,Marco Russ,ÃÂ£2.48m ,Bundesliga
19/6/2011,LoÃ¯c Perrin,8433507,769,8/7/1985,25,0,0,4,0,2050,5900,5900,150,132,482172,180,76,D/WB/DM R,3,1,3,2,2,2,1,8,1,1,1,6,12,10,6,12,7,14,13,9,11,13,7,13,12,11,14,15,14,14,11,14,14,7,14,8,14,14,17,13,11,13,10,8,9,12,20,13,13,15,11,14,16,15,12,13,17,13,16,15,15,5,20,18,14,10,20,2,12,D/WB/DM R,122,1,1,1,1,1,10,12,2,20,16,12,1,14,1,18,256.0,0,0,0,0,0,0,0,0,1,0,0,0,0,0,0,0,0,0,0,0,0,0,0,0,0,0,0,0,0,0,0,0,0,0,0,0,0,0,0,0,0,0,0,0,0,0,0,0,LoÃ¯c Perrin,Â£2.70m ,35.0,181.0,Defender - Centre-Back,right,Retired,28.0,4.0,1.0,2442.0,12.0,0.0,1.0,870.0,41.0,2.0,0.0,3695.0,38.0,7.0,2.0,3370.0,42.0,1.0,0.0,3743.0,34.0,3.0,1.0,3003.0,40.0,4.0,2.0,3446.0,28.0,0.0,1.0,2465.0,32.0,2.0,1.0,2790.0,Ligue 1,30.0,0.0,0.0,2464.0,nan,nan,nan,nan,29/6/2010,LoÃ¯c Perrin,8433507,769,8/7/1985,24,0,0,4,0,1400,5900,5900,150,132,2605077,180,76,D/WB/DM RC,3,3,2,1,2,3,3,4,3,3,2,6,12,10,6,12,7,14,13,9,11,13,7,13,12,11,14,15,14,14,11,14,14,7,14,8,14,14,17,13,11,13,10,8,9,12,20,13,13,15,11,14,16,15,5,13,17,13,16,15,15,5,LoÃÂ¯c Perrin,ÃÂ£3.15m ,Ligue 1
19/6/2011,Leyti N'Diaye,8434552,41,8/19/1985,25,0,0,0,0,4150,5229,5212,130,116,66206,188,84,D/DM C,3,2,3,2,1,1,2,4,2,3,1,5,6,7,7,9,7,16,12,6,13,9,6,11,9,14,15,15,13,12,8,12,14,5,11,7,13,13,14,13,7,17,14,8,12,10,20,15,16,13,14,13,12,6,7,13,13,12,14,13,13,6,20,8,10,1,8,1,20,D/DM C,111,1,1,1,1,1,1,20,1,8,16,10,1,1,1,8,32768.0,0,0,0,0,0,0,0,0,0,0,0,0,0,0,0,1,0,0,0,0,0,0,0,0,0,0,0,0,0,0,0,0,0,0,0,0,0,0,0,0,0,0,0,0,0,0,0,0,Leyti N'Diaye,Â£630Th. ,35.0,188.0,Defender - Centre-Back,left,Retired,7.0,0.0,1.0,554.0,9.0,0.0,0.0,674.0,3.0,0.0,0.0,222.0,nan,nan,nan,nan,14.0,0.0,0.0,1024.0,nan,nan,nan,nan,nan,nan,nan,nan,nan,nan,nan,nan,nan,nan,nan,nan,Ligue 1,nan,nan,nan,nan,nan,nan,nan,nan,29/6/2010,Leyti N'Diaye,8434552,41,8/19/1985,24,0,0,0,0,3364,5219,5200,132,116,5546543,188,84,D C,2,2,3,2,2,2,2,6,3,1,2,5,6,7,7,9,7,16,12,6,13,9,6,11,9,14,15,15,13,12,8,12,15,5,11,7,13,13,14,13,7,17,14,5,12,11,20,14,16,14,14,14,11,6,7,13,13,12,14,13,13,6,Leyti N'Diaye,ÃÂ£900Th. ,Ligue 1
19/6/2011,Landry N'Guemo,8434325,11,11/28/1985,25,21,2,0,0,5350,6600,5982,145,132,653805,173,70,DM/M C,2,3,2,2,1,3,3,1,1,1,1,10,11,11,6,12,8,12,11,6,8,13,13,13,12,12,16,15,11,13,12,11,12,9,10,9,13,15,17,16,13,13,6,8,15,14,20,17,13,14,12,14,7,8,15,15,13,14,12,15,15,5,1,1,16,12,1,1,16,DM/M C,311,1,1,1,12,1,1,1,1,1,20,16,1,1,1,1,8797170000000.0,0,0,0,0,0,0,0,0,0,0,0,0,0,0,0,0,0,0,0,0,0,0,0,0,0,0,0,0,0,0,1,0,0,0,0,0,0,0,0,0,0,0,0,1,0,0,0,0,Landry N'GuÃ©mo,Â£3.60m ,34.0,174.0,Midfielder - Defensive Midfield,right,Retired,37.0,2.0,2.0,2992.0,35.0,1.0,1.0,2993.0,19.0,0.0,0.0,1180.0,29.0,1.0,2.0,2261.0,17.0,1.0,0.0,1100.0,37.0,2.0,4.0,2980.0,27.0,0.0,2.0,1470.0,nan,nan,nan,nan,21.0,0.0,1.0,1570.0,Ligue 1,nan,nan,nan,nan,nan,nan,nan,nan,29/6/2010,Landry N'Guemo,8434325,11,11/28/1985,24,21,2,0,0,4096,6400,5750,145,128,2561529,173,70,DM/M C,3,1,2,2,3,2,1,2,1,3,3,11,11,11,6,12,8,12,11,6,8,13,12,12,12,12,16,14,11,11,12,10,12,9,10,9,13,15,16,15,13,13,6,10,13,14,20,17,13,12,13,13,7,8,15,15,13,14,12,15,15,5,Landry N'GuÃÂ©mo,ÃÂ£3.60m ,Ligue 1
19/6/2011,Kafoumba Coulibaly,23033772,24,10/26/1985,25,1,0,3,0,4950,6200,5584,138,124,491422,179,74,DM ,3,2,3,2,2,3,3,5,3,1,1,6,10,12,6,12,8,9,12,8,9,13,7,13,12,15,13,14,12,12,12,12,15,9,8,9,12,14,16,14,12,13,9,12,12,11,20,15,13,14,15,15,13,10,12,16,13,14,11,11,13,7,10,10,14,1,12,12,14,DM ,300,1,1,1,1,1,1,1,1,10,20,14,12,12,1,10,0.0,0,0,0,0,0,0,0,0,0,0,0,0,0,0,0,0,0,0,0,0,0,0,0,0,0,0,0,0,0,0,0,0,0,0,0,0,0,0,0,0,0,0,0,0,0,0,0,0,Kafoumba Coulibaly,Â£2.48m ,35.0,179.0,Midfielder - Defensive Midfield,right,Retired,38.0,1.0,2.0,3388.0,29.0,1.0,3.0,2507.0,2.0,0.0,0.0,95.0,5.0,0.0,0.0,128.0,nan,nan,nan,nan,nan,nan,nan,nan,1.0,0.0,0.0,58.0,nan,nan,nan,nan,nan,nan,nan,nan,Ligue 1,nan,nan,nan,nan,nan,nan,nan,nan,29/6/2010,Kafoumba Coulibaly,23033772,24,10/26/1985,24,1,0,3,0,3844,6200,5550,138,124,3060373,179,74,DM C,3,1,2,1,3,2,1,4,2,1,3,6,10,12,6,12,8,9,12,8,9,13,7,13,12,15,13,14,12,12,12,12,15,9,8,9,12,14,16,14,12,13,9,12,12,11,20,15,13,14,15,15,13,10,12,16,13,14,11,11,13,7,Kafoumba Coulibaly,ÃÂ£2.16m ,Ligue 1
19/6/2011,JoÃ£o Luiz,19035988,1651,6/24/1985,25,0,0,0,0,1154,4814,5250,120,107,43017,182,79,DM/M C,1,3,3,1,2,3,2,4,3,3,1,8,10,11,10,12,11,12,12,10,10,12,11,12,13,12,11,13,13,12,12,11,14,10,10,12,11,13,14,11,13,13,14,8,14,11,20,12,13,11,9,10,7,12,14,13,14,6,14,14,14,5,1,1,17,7,10,5,17,DM/M C,311,1,1,1,7,1,1,1,1,1,20,17,5,10,1,1,0.0,0,0,0,0,0,0,0,0,0,0,0,0,0,0,0,0,0,0,0,0,0,0,0,0,0,0,0,0,0,0,0,0,0,0,0,0,0,0,0,0,0,0,0,0,0,0,0,0,JoÃ£o Luiz,Â£450Th. ,35.0,182.0,Midfielder - Defensive Midfield,right,Al-Hala,28.0,0.0,0.0,2044.0,11.0,0.0,0.0,408.0,18.0,0.0,0.0,1432.0,23.0,0.0,0.0,1584.0,17.0,1.0,0.0,936.0,nan,nan,nan,nan,nan,nan,nan,nan,nan,nan,nan,nan,nan,nan,nan,nan,Liga NOS,nan,nan,nan,nan,nan,nan,nan,nan,29/6/2010,JoÃ£o Luiz,19035988,1651,6/24/1985,25,0,0,0,0,1000,2000,5250,120,107,103648,182,79,DM/M C,2,2,1,2,3,2,2,6,2,2,3,8,10,11,10,12,11,12,12,10,10,12,11,12,13,12,11,13,13,12,12,11,14,10,10,12,11,13,14,11,13,13,14,8,14,11,20,12,13,11,9,10,7,12,14,13,14,7,14,14,14,5,JoÃÂ£o Luiz,ÃÂ£450Th. ,Liga NOS
19/6/2011,JoÃ£o Guilherme,317299,1651,4/21/1986,25,0,0,0,0,3250,5489,5950,139,122,332714,185,77,D C,2,1,1,3,2,2,3,2,3,2,2,9,9,11,11,11,15,15,15,11,13,11,11,13,13,12,12,9,12,9,10,11,14,12,10,11,13,11,10,14,13,15,16,6,17,13,20,16,15,11,9,11,7,7,13,18,12,10,9,13,15,12,20,1,1,1,4,3,20,D C,101,1,7,1,1,1,1,20,3,4,15,1,1,1,1,1,35184400000000.0,0,0,0,0,0,0,0,0,0,0,0,0,0,0,0,0,0,0,0,0,0,0,0,0,0,0,0,0,0,0,0,0,0,0,0,0,0,0,0,0,0,0,0,0,0,1,0,0,JoÃ£o Guilherme,Â£1.17m ,34.0,184.0,Defender - Centre-Back,right,Without Club,21.0,1.0,0.0,1508.0,31.0,2.0,2.0,2581.0,24.0,2.0,0.0,1960.0,36.0,3.0,1.0,3159.0,35.0,0.0,0.0,2992.0,26.0,1.0,0.0,1792.0,7.0,0.0,0.0,660.0,nan,nan,nan,nan,nan,nan,nan,nan,Liga NOS,nan,nan,nan,nan,nan,nan,nan,nan,29/6/2010,JoÃ£o Guilherme,317299,1651,4/21/1986,24,0,0,0,0,3250,5150,5950,139,119,1030690,185,77,D C,2,2,3,2,3,2,2,2,3,1,3,9,9,11,11,11,15,15,15,11,13,11,11,13,13,7,12,9,12,9,10,11,14,12,10,11,13,11,10,14,13,15,16,6,17,13,20,16,15,11,9,11,7,7,13,18,12,10,9,13,15,12,JoÃÂ£o Guilherme,ÃÂ£1.53m ,Liga NOS
19/6/2011,JÃ©ferson Baiano,2114080,1651,1/20/1986,25,0,0,0,0,1034,4950,4950,106,99,41510,184,78,D/DM C,2,1,2,2,3,1,3,1,1,3,1,2,7,8,8,9,2,11,10,6,13,9,9,12,8,15,12,14,8,10,8,10,14,7,10,10,11,13,12,10,12,12,11,8,14,11,20,14,12,12,11,11,8,14,10,11,14,11,14,12,13,10,20,1,13,1,1,1,20,D/DM C,111,1,12,1,1,1,1,20,1,1,17,13,1,1,1,1,1073741824.0,0,0,0,0,0,0,0,0,0,0,0,0,0,0,0,0,0,0,0,0,0,0,0,0,0,0,0,0,0,0,1,0,0,0,0,0,0,0,0,0,0,0,0,0,0,0,0,0,nan,nan,nan,nan,nan,nan,nan,nan,nan,nan,nan,nan,nan,nan,nan,nan,nan,nan,nan,nan,nan,nan,nan,nan,nan,nan,nan,nan,nan,nan,nan,nan,nan,nan,nan,nan,nan,nan,nan,nan,nan,nan,nan,nan,nan,nan,nan,nan,nan,nan,nan,nan
19/6/2011,Javi MÃ¡rquez,1509534,796,5/11/1986,25,0,0,0,0,4750,7000,7000,150,140,1099884,174,71,DM/M LC,2,2,1,3,3,2,2,1,1,1,3,11,12,12,9,14,12,9,13,9,10,14,9,12,14,12,14,12,14,14,14,15,12,12,9,14,13,15,17,14,13,11,8,20,12,14,8,14,12,12,9,9,9,13,9,12,15,14,10,8,7,19,1,1,20,14,1,17,20,DM/M LC,424,1,1,1,14,13,1,1,1,1,17,20,17,1,1,1,0.0,0,0,0,0,0,0,0,0,0,0,0,0,0,0,0,0,0,0,0,0,0,0,0,0,0,0,0,0,0,0,0,0,0,0,0,0,0,0,0,0,0,0,0,0,0,0,0,0,Javi MÃ¡rquez,Â£5.40m ,34.0,179.0,Midfielder - Central Midfield,left,Without Club,33.0,2.0,1.0,2470.0,9.0,0.0,0.0,594.0,26.0,3.0,2.0,1597.0,30.0,2.0,1.0,2157.0,26.0,0.0,0.0,1487.0,21.0,0.0,1.0,1443.0,39.0,6.0,6.0,2998.0,13.0,0.0,0.0,572.0,25.0,1.0,3.0,1508.0,LaLiga,11.0,2.0,0.0,796.0,nan,nan,nan,nan,29/6/2010,Javi MÃ¡rquez,1509534,796,5/11/1986,24,0,0,0,0,3500,6500,6500,150,135,5070032,174,71,DM/M LC,3,1,2,3,1,1,1,2,3,3,3,11,11,9,9,13,10,9,11,9,9,14,10,10,13,11,14,12,12,12,14,13,12,12,9,13,13,15,17,14,13,10,8,20,12,14,8,14,11,12,9,9,9,13,5,17,6,13,17,1,12,12,Javi MÃÂ¡rquez,ÃÂ£3.60m ,LaLiga
19/6/2011,Javi LÃ³pez,67006184,796,1/21/1986,25,0,0,0,0,2500,5750,5750,130,120,240418,179,74,D/WB/DM/M RC,1,2,3,3,1,1,3,1,1,3,3,9,12,12,11,10,9,7,11,9,12,13,5,11,12,13,12,11,12,10,11,11,10,7,8,13,12,12,14,14,13,8,8,12,14,12,20,12,10,14,8,10,7,17,8,7,12,14,8,18,10,6,18,20,19,14,20,10,15,D/WB/DM/M RC,243,1,1,1,1,8,14,1,5,18,16,15,10,19,8,20,0.0,0,0,0,0,0,0,0,0,0,0,0,0,0,0,0,0,0,0,0,0,0,0,0,0,0,0,0,0,0,0,0,0,0,0,0,0,0,0,0,0,0,0,0,0,0,0,0,0,Javi LÃ³pez,Â£2.25m ,34.0,180.0,Defender - Right-Back,right,Without Club,27.0,0.0,0.0,1752.0,32.0,1.0,2.0,2412.0,33.0,1.0,0.0,2577.0,35.0,0.0,1.0,3105.0,33.0,0.0,1.0,2621.0,33.0,0.0,1.0,2613.0,20.0,0.0,1.0,1614.0,15.0,0.0,0.0,1039.0,25.0,0.0,0.0,2159.0,LaLiga,28.0,1.0,1.0,2375.0,nan,nan,nan,nan,29/6/2010,Javi LÃ³pez,67006184,796,1/21/1986,24,0,0,0,0,1250,4000,4000,110,85,67355,179,74,M/AM R,3,2,3,1,3,1,3,1,1,1,1,9,13,10,11,8,9,2,9,8,7,10,9,6,5,5,9,9,5,9,12,5,10,6,9,12,8,15,14,12,11,12,13,10,12,12,20,9,2,7,15,10,12,10,14,5,13,9,14,18,7,14,Javi LÃÂ³pez,ÃÂ£900Th. ,LaLiga
19/6/2011,Henning Hauger,760385,786,7/17/1985,25,21,0,14,0,4750,6500,6400,138,130,142292,179,71,DM/M C,3,3,1,3,1,1,3,2,2,2,1,11,12,13,10,16,13,4,11,7,13,15,5,14,15,13,13,12,13,13,13,14,13,13,12,12,10,18,15,11,12,14,8,9,11,10,20,16,10,15,7,16,11,9,11,14,20,14,17,15,6,3,1,1,20,12,10,10,20,DM/M C,421,1,1,1,12,1,1,1,1,1,16,20,10,10,1,1,0.0,0,0,0,0,0,0,0,0,0,0,0,0,0,0,0,0,0,0,0,0,0,0,0,0,0,0,0,0,0,0,0,0,0,0,0,0,0,0,0,0,0,0,0,0,0,0,0,0,Henning Hauger,Â£900Th. ,35.0,179.0,Midfielder - Defensive Midfield,right,Without Club,16.0,0.0,2.0,1424.0,23.0,0.0,0.0,1547.0,21.0,2.0,2.0,1763.0,34.0,0.0,1.0,2922.0,33.0,1.0,0.0,2694.0,31.0,0.0,0.0,2343.0,28.0,0.0,1.0,2360.0,31.0,0.0,0.0,2506.0,15.0,0.0,1.0,756.0,Bundesliga,nan,nan,nan,nan,nan,nan,nan,nan
19/6/2011,Hajime Hosogai,781280,116,6/10/1986,25,6,1,9,1,4650,5750,6000,137,120,111849,176,68,DM/M C,2,2,3,3,3,2,1,1,3,2,1,10,9,12,8,13,10,12,12,4,11,12,10,11,11,11,12,11,10,11,12,11,7,11,8,11,13,14,12,11,12,11,8,18,13,13,20,13,11,10,17,10,11,10,13,12,14,7,13,15,12,14,1,1,20,11,12,1,20,DM/M C,311,1,1,1,11,1,1,1,1,1,20,20,1,12,1,1,0.0,0,0,0,0,0,0,0,0,0,0,0,0,0,0,0,0,0,0,0,0,0,0,0,0,0,0,0,0,0,0,0,0,0,0,0,0,0,0,0,0,0,0,0,0,0,0,0,0,Hajime Hosogai,Â£2.70m ,34.0,177.0,Midfielder - Defensive Midfield,right,True Bangkok United,7.0,0.0,0.0,491.0,33.0,3.0,1.0,2829.0,23.0,0.0,0.0,1395.0,34.0,0.0,1.0,2889.0,22.0,0.0,1.0,1637.0,25.0,0.0,1.0,2001.0,32.0,0.0,0.0,1347.0,10.0,0.0,0.0,493.0,16.0,0.0,0.0,1204.0,Bundesliga,10.0,1.0,0.0,734.0,nan,nan,nan,nan
19/6/2011,Guillaume Loriot,8441954,769,5/21/1986,25,0,0,0,0,4300,5400,5400,135,120,167902,188,79,DM/M C,2,3,2,2,2,2,2,4,2,2,3,6,13,12,8,12,6,12,11,8,10,13,11,13,14,12,13,14,13,12,12,12,14,9,12,11,13,14,15,13,12,15,14,20,11,12,5,13,15,13,12,11,14,11,11,12,17,13,15,15,15,6,10,10,20,10,1,12,20,DM/M C,421,1,1,1,10,1,1,1,10,1,16,20,12,1,10,1,0.0,0,0,0,0,0,0,0,0,0,0,0,0,0,0,0,0,0,0,0,0,0,0,0,0,0,0,0,0,0,0,0,0,0,0,0,0,0,0,0,0,0,0,0,0,0,0,0,0,Guillaume Loriot,Â£360Th. ,34.0,188.0,Midfielder - Central Midfield,left,Retired,9.0,0.0,1.0,628.0,16.0,0.0,0.0,948.0,31.0,2.0,0.0,2656.0,17.0,3.0,0.0,1449.0,30.0,2.0,1.0,2382.0,11.0,1.0,0.0,815.0,17.0,0.0,0.0,945.0,7.0,0.0,0.0,431.0,nan,nan,nan,nan,Ligue 1,nan,nan,nan,nan,nan,nan,nan,nan,29/6/2010,Guillaume Loriot,8441954,769,5/21/1986,24,0,0,0,0,3721,5500,5500,135,122,2764325,188,79,DM/M C,2,1,3,3,2,3,2,8,2,3,2,6,13,12,11,12,6,12,11,8,11,13,11,13,13,12,13,13,13,12,12,12,13,10,11,11,14,14,15,13,12,15,13,20,13,13,5,14,13,14,12,11,9,11,16,12,17,13,15,15,15,6,Guillaume Loriot,ÃÂ£675Th. ,Ligue 1
19/6/2011,Gonzalo Jara,5250132,1652,8/23/1985,25,38,3,0,0,5400,7000,6400,145,133,803432,178,76,D/DM R,3,1,2,2,2,2,2,1,2,1,2,5,10,10,8,13,7,13,10,10,14,13,5,15,13,16,13,15,11,11,12,12,15,11,13,11,16,15,16,10,13,13,12,14,14,11,20,14,14,12,16,13,8,17,14,14,13,12,13,12,7,6,20,15,13,1,20,11,14,D/DM R,112,1,15,1,1,1,1,14,11,20,16,13,1,10,10,15,16810048.0,0,0,0,0,0,0,1,0,0,0,0,0,0,0,0,1,0,0,0,0,0,0,0,0,1,0,0,0,0,0,0,0,0,0,0,0,0,0,0,0,0,0,0,0,0,0,0,0,Gonzalo Jara,Â£1.58m ,35.0,178.0,Defender - Centre-Back,right,MazatlÃ¡n FC,32.0,1.0,1.0,2225.0,22.0,0.0,1.0,1629.0,19.0,0.0,2.0,1489.0,39.0,0.0,0.0,3176.0,20.0,0.0,0.0,1203.0,18.0,0.0,0.0,1443.0,34.0,0.0,0.0,2735.0,19.0,0.0,1.0,1673.0,16.0,0.0,1.0,1408.0,Premier League,14.0,0.0,0.0,1220.0,7.0,0.0,0.0,514.0,29/6/2010,Gonzalo Jara,5250132,1652,8/23/1985,24,38,3,0,0,4624,7000,6750,145,136,6550116,178,76,D/DM/M RLC,3,1,1,1,2,2,1,4,3,2,2,5,8,10,8,12,8,14,10,10,14,13,5,15,11,15,13,14,11,12,12,12,15,10,13,10,16,15,15,10,13,13,11,14,14,11,20,14,13,14,15,13,8,17,11,14,13,12,13,12,7,6,Gonzalo Jara,ÃÂ£2.70m ,Premier League
19/6/2011,Fernando Gago,961083,1649,4/10/1986,25,28,0,15,0,6361,7513,7262,156,146,0,178,73,DM C,3,1,3,2,1,2,1,3,3,2,2,7,10,11,6,17,8,7,10,8,11,16,12,13,15,15,15,14,16,16,13,15,17,6,11,9,16,16,15,13,15,13,8,11,15,12,20,16,11,14,14,12,10,6,18,13,15,14,14,14,16,7,1,1,15,8,1,1,15,DM C,301,1,1,1,8,1,1,1,1,1,20,15,1,1,1,1,64.0,0,0,0,0,0,0,1,0,0,0,0,0,0,0,0,0,0,0,0,0,0,0,0,0,0,0,0,0,0,0,0,0,0,0,0,0,0,0,0,0,0,0,0,0,0,0,0,0,Fernando Gago,Â£5.85m ,34.0,177.0,Midfielder - Defensive Midfield,right,Club AtlÃ©tico VÃ©lez Sarsfield,7.0,0.0,0.0,193.0,32.0,1.0,3.0,2403.0,25.0,1.0,1.0,1747.0,26.0,0.0,5.0,2194.0,30.0,3.0,4.0,2297.0,18.0,1.0,0.0,1396.0,16.0,2.0,1.0,1434.0,11.0,0.0,0.0,660.0,8.0,0.0,0.0,720.0,Serie A,13.0,0.0,0.0,1034.0,nan,nan,nan,nan,29/6/2010,Fernando Gago,961083,1649,4/10/1986,24,28,0,15,0,5329,7750,7250,161,146,13423761,176,72,DM/M C,1,2,2,1,1,3,1,5,3,2,1,7,10,11,6,17,8,7,10,8,11,16,12,13,15,15,15,14,16,16,13,15,17,6,11,9,16,16,15,13,15,13,8,11,15,12,20,16,11,14,14,12,10,6,18,18,15,19,14,14,16,7,Fernando Gago,ÃÂ£8.10m ,LaLiga
19/6/2011,Fernando Alexandre,745269,788,8/2/1985,25,0,0,0,0,2750,5750,5750,118,112,593123,183,82,DM/M C,2,2,2,3,3,3,3,4,1,2,1,11,11,10,10,13,11,13,11,11,14,11,11,12,13,13,14,12,14,15,11,12,12,6,11,11,15,14,13,11,12,14,13,8,12,11,20,14,14,13,10,12,8,12,12,12,11,11,11,13,14,7,1,1,20,10,5,5,20,DM/M C,311,1,1,1,10,1,1,1,1,1,20,20,5,5,1,1,0.0,0,0,0,0,0,0,0,0,0,0,0,0,0,0,0,0,0,0,0,0,0,0,0,0,0,0,0,0,0,0,0,0,0,0,0,0,0,0,0,0,0,0,0,0,0,0,0,0,Fernando Alexandre,Â£900Th. ,35.0,184.0,Midfielder - Defensive Midfield,right,Retired,31.0,1.0,0.0,2666.0,29.0,0.0,0.0,2404.0,25.0,1.0,1.0,2159.0,29.0,3.0,0.0,2591.0,25.0,0.0,0.0,1930.0,29.0,3.0,0.0,2520.0,23.0,0.0,1.0,1982.0,10.0,1.0,0.0,378.0,16.0,1.0,0.0,959.0,Liga NOS,nan,nan,nan,nan,nan,nan,nan,nan,29/6/2010,Fernando Alexandre,745269,788,8/2/1985,24,0,0,0,0,2750,5750,5750,125,114,323592,183,82,DM/M C,3,2,2,3,1,3,3,4,2,3,1,11,11,10,10,13,11,13,11,11,14,11,11,12,13,13,14,12,14,15,11,12,12,6,11,11,15,14,13,11,12,14,13,8,12,11,20,14,14,13,10,12,8,12,8,12,2,11,11,13,14,7,Fernando Alexandre,ÃÂ£630Th. ,Liga NOS
19/6/2011,Eugen Polanski,894132,787,3/17/1986,25,0,0,0,0,5268,6511,6750,146,135,917928,183,73,DM/M C,3,1,2,3,1,2,3,1,3,2,2,10,8,10,8,12,11,11,14,8,15,12,12,14,11,18,12,17,8,16,11,14,17,7,16,12,9,14,18,13,13,13,11,10,16,14,20,17,17,13,12,10,7,13,10,18,9,12,14,11,13,11,1,1,20,12,12,12,20,DM/M C,421,1,1,1,12,1,1,1,1,1,18,20,12,12,1,1,1073742336.0,0,0,0,0,0,0,0,0,0,1,0,0,0,0,0,0,0,0,0,0,0,0,0,0,0,0,0,0,0,0,1,0,0,0,0,0,0,0,0,0,0,0,0,0,0,0,0,0,Eugen Polanski,Â£3.60m ,34.0,183.0,Midfielder - Defensive Midfield,right,Retired,29.0,0.0,4.0,2255.0,29.0,3.0,2.0,2245.0,26.0,0.0,3.0,1726.0,36.0,3.0,5.0,3053.0,33.0,6.0,0.0,2840.0,27.0,1.0,3.0,1758.0,14.0,0.0,0.0,631.0,14.0,0.0,1.0,579.0,nan,nan,nan,nan,Bundesliga,nan,nan,nan,nan,nan,nan,nan,nan,29/6/2010,Eugen Polanski,894132,771,3/17/1986,24,0,0,19,1,4000,6350,6650,142,133,1216095,183,73,DM/M C,1,1,1,2,3,1,2,3,3,2,1,10,8,10,8,12,11,11,16,8,15,12,12,15,11,18,8,17,8,16,11,15,17,7,16,12,9,15,18,13,12,10,11,10,16,14,20,17,16,13,12,10,7,13,10,18,9,12,14,11,13,11,Eugen Polanski,ÃÂ£3.60m ,Bundesliga
19/6/2011,Ãder Sciola,19008536,1651,9/25/1985,25,0,0,0,0,3250,5500,5500,125,110,532522,181,80,D/WB/DM R,3,2,3,1,1,1,3,1,3,1,2,10,11,11,9,10,9,9,9,15,12,10,10,12,11,15,11,14,13,13,12,12,13,10,11,13,11,12,10,14,12,13,9,9,11,14,20,13,13,11,11,12,6,12,12,11,12,11,3,8,12,12,18,20,15,1,20,1,13,D/WB/DM R,232,1,1,1,1,1,1,1,1,18,16,13,1,15,1,20,0.0,0,0,0,0,0,0,0,0,0,0,0,0,0,0,0,0,0,0,0,0,0,0,0,0,0,0,0,0,0,0,0,0,0,0,0,0,0,0,0,0,0,0,0,0,0,0,0,0,Ãder Sciola,Â£450Th. ,35.0,183.0,Defender - Right-Back,right,Oeste Futebol Clube (SP),nan,nan,nan,nan,15.0,0.0,0.0,1009.0,19.0,0.0,0.0,1179.0,2.0,0.0,0.0,210.0,32.0,0.0,7.0,2630.0,31.0,0.0,1.0,2679.0,25.0,2.0,1.0,2204.0,34.0,6.0,2.0,2941.0,34.0,1.0,5.0,2925.0,Liga NOS,19.0,1.0,0.0,1538.0,nan,nan,nan,nan
19/6/2011,Daniel Brinkmann,8719018,771,1/29/1986,25,0,0,1,0,4000,5750,5750,122,115,420854,193,89,DM/M RC,3,3,1,3,1,2,1,2,2,2,3,14,12,13,9,14,10,9,11,10,9,12,10,13,14,13,13,12,12,9,12,13,10,13,12,13,14,13,13,11,10,15,16,7,12,12,20,12,13,12,7,12,11,9,6,11,12,11,7,10,8,7,10,12,20,13,15,1,20,DM/M RC,313,1,1,1,1,1,13,1,1,10,20,20,1,15,1,12,0.0,0,0,0,0,0,0,0,0,0,0,0,0,0,0,0,0,0,0,0,0,0,0,0,0,0,0,0,0,0,0,0,0,0,0,0,0,0,0,0,0,0,0,0,0,0,0,0,0,Daniel Brinkmann,Â£450Th. ,34.0,193.0,Midfielder - Central Midfield,right,Retired,25.0,0.0,4.0,1524.0,17.0,2.0,2.0,977.0,4.0,1.0,0.0,95.0,5.0,2.0,0.0,307.0,35.0,0.0,1.0,1821.0,7.0,0.0,0.0,630.0,15.0,0.0,0.0,800.0,26.0,3.0,5.0,1648.0,32.0,7.0,4.0,2264.0,Bundesliga,16.0,1.0,1.0,937.0,nan,nan,nan,nan
19/6/2011,Claudio Marchisio,1400716,776,1/19/1986,25,13,0,19,1,6500,7500,7350,155,147,2857735,180,71,DM/M C,3,2,1,2,2,1,2,7,1,1,3,10,13,14,14,14,6,8,14,9,9,14,15,14,14,13,15,11,14,10,14,16,12,13,15,16,14,15,13,14,14,14,10,9,13,13,20,15,13,12,6,17,7,14,7,15,12,15,12,14,14,8,1,1,20,9,11,11,20,DM/M C,421,1,1,1,8,9,1,1,1,1,18,20,11,11,1,1,549760000000.0,0,0,0,0,0,0,0,0,0,0,0,0,0,0,0,0,0,0,0,0,0,0,1,0,0,0,0,0,0,0,0,0,0,0,0,0,0,0,0,1,0,0,0,0,0,0,0,0,Claudio Marchisio,Â£20.70m ,34.0,180.0,Midfielder - Central Midfield,right,Retired,41.0,4.0,4.0,3517.0,39.0,10.0,4.0,3230.0,40.0,8.0,9.0,3401.0,43.0,4.0,2.0,2996.0,52.0,3.0,10.0,4340.0,32.0,0.0,2.0,2692.0,29.0,2.0,2.0,2043.0,20.0,0.0,1.0,1055.0,15.0,2.0,0.0,743.0,Serie A,nan,nan,nan,nan,nan,nan,nan,nan,29/6/2010,Claudio Marchisio,1400716,776,1/19/1986,24,6,0,19,1,5852,7650,7650,170,153,19866260,180,71,DM/M C,3,1,3,3,2,1,2,6,2,1,3,13,12,13,11,15,10,8,12,9,14,15,15,14,14,13,15,15,14,14,14,16,15,13,15,13,14,16,14,14,14,14,10,11,13,13,20,15,13,14,6,14,7,13,10,16,12,15,14,14,14,8,Claudio Marchisio,ÃÂ£16.20m ,Serie A
19/6/2011,Carlos SÃ¡nchez,78011012,1653,2/6/1986,25,8,1,0,0,5000,6750,6500,145,125,650180,182,82,DM/M C,3,3,1,1,1,1,3,1,2,2,1,8,11,11,8,13,9,13,10,6,13,12,11,12,13,14,15,14,12,11,10,13,13,8,13,9,12,16,14,13,11,15,11,10,15,12,20,16,15,13,12,14,6,10,12,13,10,13,15,15,12,10,10,1,20,5,10,1,20,DM/M C,421,1,1,1,5,1,1,10,1,1,18,20,1,10,1,1,33554688.0,0,0,0,0,0,0,0,0,1,0,0,0,0,0,0,0,0,0,0,0,0,0,0,0,0,1,0,0,0,0,0,0,0,0,0,0,0,0,0,0,0,0,0,0,0,0,0,0,Carlos SÃ¡nchez,Â£2.70m ,34.0,182.0,Midfielder - Defensive Midfield,left,Without Club,31.0,2.0,1.0,2613.0,23.0,0.0,1.0,1772.0,31.0,2.0,1.0,2320.0,31.0,0.0,1.0,2216.0,34.0,1.0,1.0,2345.0,23.0,0.0,0.0,1623.0,41.0,1.0,1.0,2714.0,25.0,1.0,0.0,1664.0,9.0,0.0,0.0,313.0,Ligue 1,10.0,0.0,1.0,428.0,nan,nan,nan,nan,29/6/2010,Carlos SÃ¡nchez,78011012,1653,2/6/1986,24,8,1,0,0,4096,5759,5750,145,128,3141362,182,82,DM/M C,1,3,2,3,1,2,1,2,2,1,2,8,11,11,8,13,9,13,10,6,13,13,11,12,13,14,15,14,13,12,12,13,13,8,13,9,12,16,14,13,11,14,11,10,15,12,20,16,14,13,12,14,6,10,12,13,10,13,15,15,12,10,Carlos SÃÂ¡nchez,ÃÂ£3.33m ,Ligue 1
19/6/2011,CarlÃ£o,2102133,1651,1/19/1986,25,0,0,0,0,4400,5524,5524,135,121,337676,182,73,D/DM C,3,1,1,2,2,2,3,1,1,3,3,10,12,9,6,11,12,14,11,9,13,10,10,14,11,15,14,16,10,12,9,11,13,11,7,7,11,14,15,14,12,14,11,20,13,12,8,15,14,11,15,13,13,15,7,14,13,15,14,10,10,8,20,14,10,1,1,14,20,D/DM C,111,1,1,1,1,1,1,20,14,1,17,10,1,1,14,1,0.0,0,0,0,0,0,0,0,0,0,0,0,0,0,0,0,0,0,0,0,0,0,0,0,0,0,0,0,0,0,0,0,0,0,0,0,0,0,0,0,0,0,0,0,0,0,0,0,0,CarlÃ£o,Â£1.80m ,34.0,183.0,Defender - Centre-Back,left,Paysandu Sport Club,27.0,1.0,0.0,1945.0,23.0,0.0,0.0,1603.0,17.0,0.0,0.0,1114.0,29.0,1.0,2.0,2420.0,30.0,0.0,0.0,2433.0,36.0,3.0,0.0,2994.0,31.0,0.0,1.0,2636.0,28.0,1.0,1.0,2205.0,30.0,1.0,0.0,2549.0,Ligue 1,1.0,0.0,0.0,90.0,nan,nan,nan,nan,29/6/2010,CarlÃ£o,2102133,1651,1/19/1986,24,0,0,0,0,1050,5500,5500,140,123,2513011,182,73,DM C,1,2,3,1,1,1,2,4,1,1,3,10,12,9,6,11,12,14,11,9,13,10,10,14,11,15,14,16,12,12,9,12,13,11,7,7,11,14,17,14,12,14,11,20,13,12,8,15,14,13,15,13,11,15,7,14,13,15,14,10,10,8,Carlao,ÃÂ£1.44m ,Liga NOS
19/6/2011,Blerim Dzemaili,5725580,798,4/12/1986,25,13,0,0,0,3500,7500,7100,155,142,826226,179,73,DM/M C,1,2,3,1,2,3,2,4,2,1,2,8,11,12,11,15,11,10,14,12,13,16,12,15,16,11,13,13,10,12,13,13,10,8,15,15,13,16,15,13,12,14,9,8,7,12,20,16,12,13,10,14,14,16,10,6,6,6,8,13,12,17,10,1,20,1,10,10,20,DM/M C,421,1,1,1,1,1,1,10,1,1,18,20,10,10,1,1,137439000000.0,0,0,0,0,0,0,0,0,0,0,0,0,0,0,0,0,0,0,0,0,0,0,0,0,0,0,0,0,0,0,0,0,0,0,0,0,0,1,0,0,0,0,0,0,0,0,0,0,Blerim Dzemaili,Â£6.30m ,34.0,180.0,Midfielder - Central Midfield,right,Without Club,31.0,1.0,1.0,2337.0,39.0,3.0,3.0,2458.0,41.0,9.0,3.0,2512.0,29.0,6.0,4.0,1882.0,20.0,1.0,2.0,1229.0,27.0,3.0,1.0,1786.0,58.0,17.0,15.0,4885.0,15.0,1.0,1.0,1195.0,30.0,2.0,1.0,1860.0,Serie A,14.0,1.0,1.0,695.0,nan,nan,nan,nan,29/6/2010,Blerim Dzemaili,5725580,798,4/12/1986,24,10,0,0,0,3500,6250,6400,145,132,6999999,179,73,DM/M C,3,3,3,1,2,3,1,3,1,3,3,8,11,12,11,15,10,10,14,4,12,15,8,13,15,11,12,13,10,12,12,13,10,8,15,15,12,16,15,13,12,14,9,8,7,12,20,14,11,13,14,10,14,13,9,6,14,8,11,13,13,5,Blerim Dzemaili,ÃÂ£4.50m ,Serie A
19/6/2011,AurÃ©lien Chedjou,8439083,11,6/20/1985,25,17,0,4,0,5900,7250,6583,150,145,887870,184,86,D/DM C,1,1,3,1,3,2,1,3,2,3,2,10,9,11,6,13,10,15,13,6,15,12,10,14,13,14,17,14,13,14,11,13,15,8,12,8,16,13,15,15,12,17,12,8,14,13,20,15,16,15,14,14,7,14,11,14,13,14,15,14,14,5,20,1,14,12,1,10,20,D/DM C,111,1,1,1,12,10,1,20,1,1,16,14,10,1,1,1,512.0,0,0,0,0,0,0,0,0,0,1,0,0,0,0,0,0,0,0,0,0,0,0,0,0,0,0,0,0,0,0,0,0,0,0,0,0,0,0,0,0,0,0,0,0,0,0,0,0,Aurelien Chedjou,Â£9.00m ,35.0,184.0,Defender - Centre-Back,right,Adana Demirspor,49.0,4.0,0.0,3862.0,36.0,4.0,1.0,3184.0,46.0,4.0,1.0,4155.0,33.0,4.0,0.0,2828.0,35.0,4.0,2.0,3149.0,31.0,3.0,3.0,2482.0,20.0,1.0,1.0,1707.0,1.0,0.0,0.0,53.0,26.0,1.0,0.0,2324.0,Ligue 1,28.0,0.0,0.0,2354.0,2.0,0.0,0.0,180.0,29/6/2010,AurÃ©lien Chedjou,8439083,11,6/20/1985,25,10,0,4,0,4970,7050,6350,150,141,5142818,184,84,D/DM C,2,3,1,3,2,3,3,4,2,1,3,10,9,11,7,13,10,15,13,6,15,13,10,13,13,14,16,14,13,13,12,12,15,8,12,8,15,13,15,15,12,16,12,8,14,13,20,14,16,15,14,14,7,14,11,14,13,14,15,14,14,5,Aurelien Chedjou,ÃÂ£7.20m ,Ligue 1
19/6/2011,Alexander Tettey,762026,786,4/4/1986,25,7,0,12,0,3650,5804,5800,145,129,312603,180,75,DM/M C,1,1,3,2,2,2,3,4,2,3,1,5,11,7,10,11,6,10,12,3,12,11,7,13,11,15,16,12,8,11,8,11,15,8,14,14,14,17,19,13,11,12,12,12,17,14,20,18,15,14,10,15,5,9,11,15,14,12,16,14,15,5,12,1,18,1,1,8,18,DM/M C,311,1,1,1,1,1,1,12,1,1,20,18,8,1,1,1,616.0,0,0,0,1,0,1,1,0,0,1,0,0,0,0,0,0,0,0,0,0,0,0,0,0,0,0,0,0,0,0,0,0,0,0,0,0,0,0,0,0,0,0,0,0,0,0,0,0,Alexander Tettey,Â£2.03m ,34.0,181.0,Midfielder - Defensive Midfield,right,Norwich City,20.0,4.0,2.0,1603.0,32.0,1.0,0.0,1716.0,31.0,1.0,2.0,2163.0,22.0,1.0,0.0,1608.0,39.0,1.0,1.0,3223.0,23.0,2.0,0.0,1952.0,37.0,0.0,0.0,3050.0,27.0,0.0,1.0,2125.0,32.0,1.0,0.0,2558.0,Ligue 1,32.0,1.0,1.0,2502.0,1.0,0.0,0.0,90.0,29/6/2010,Alexander Tettey,762026,786,4/4/1986,24,5,0,12,0,3300,5804,5800,145,129,8715086,180,75,DM/M C,3,3,3,1,2,1,3,8,2,2,3,5,11,7,10,11,6,10,12,3,12,11,7,13,11,15,16,12,8,11,8,11,15,8,14,14,14,17,19,13,11,12,12,12,17,14,20,18,15,14,10,15,5,9,12,15,14,12,16,14,15,5,Alexander Tettey,ÃÂ£2.70m ,Ligue 1
