GameDate,Name,UID,NationID,Born,Age,IntCaps,IntGoals,U21Caps,U21Goals,WorldReputation,HomeReputation,CurrentReputation,PA,CA,Price,Height,Weight,PositionsString,GK/AerialAbility,GK/CommandOfArea,GK/Communication,GK/Eccentricity,GK/Handling,GK/Kicking,GK/OneOnOnes,GK/Reflexes,GK/RushingOut,GK/TendencyToPunch,GK/Throwing,Tech/Corners,Tech/Crossing,Tech/Dribbling,Tech/Finishing,Tech/FirstTouch,Tech/Freekicks,Tech/Heading,Tech/LongShots,Tech/Longthrows,Tech/Marking,Tech/Passing,Tech/PenaltyTaking,Tech/Tackling,Tech/Technique,Mental/Aggression,Mental/Anticipation,Mental/Bravery,Mental/Composure,Mental/Concentration,Mental/Vision,Mental/Decisions,Mental/Determination,Mental/Flair,Mental/Leadership,Mental/OffTheBall,Mental/Positioning,Mental/Teamwork,Mental/Workrate,Phy/Acceleration,Phy/Agility,Phy/Balance,Phy/Jumping,Phy/LeftFoot,Phy/NaturalFitness,Phy/Pace,Phy/RightFoot,Phy/Stamina,Phy/Strength,Hidden/Consistency,Hidden/Dirtiness,Hidden/ImportantMatches,Hidden/InjuryProness,Hidden/Versatility,Personality/Adaptability,Personality/Ambition,Personality/Loyalty,Personality/Pressure,Personality/Professional,Personality/Sportsmanship,Personality/Temperament,Personality/Controversy,Positions/PositionsDesc,Positions/PositionsDescVal,Positions/Striker,Positions/AttackingMidfielder,Positions/Centre,Positions/Defender,Positions/DefensiveMidfielder,Positions/Goalkeeper,Positions/Left,Positions/Midfielder,Positions/Right,Positions/Sweeper,Positions/WingBack,Positions/AttackingMidCentral,Positions/AttackingMidLeft,Positions/AttackingMidRight,Positions/DefenderCentral,Positions/DefenderLeft,Positions/DefenderRight,Positions/MidfielderCentral,Positions/MidfielderLeft,Positions/MidfielderRight,Positions/WingBackLeft,Positions/WingBackRight,PPMVal,PPM0,PPM1,PPM2,PPM3,PPM4,PPM5,PPM6,PPM7,PPM8,PPM9,PPM10,PPM11,PPM12,PPM13,PPM14,PPM15,PPM16,PPM17,PPM18,PPM19,PPM20,PPM21,PPM22,PPM23,PPM24,PPM25,PPM26,PPM27,PPM28,PPM29,PPM30,PPM31,PPM32,PPM33,PPM34,PPM35,PPM36,PPM37,PPM38,PPM39,PPM40,PPM41,PPM42,PPM43,PPM44,PPM45,PPM46,PPM47,name,Market Value,current league
29/6/2010,Mattia Perin,43044345,776,11/10/1992,17,0,0,0,0,2000,4679,3750,159,104,6039093,188,81,GK ,13,10,10,14,13,10,11,11,12,14,12,7,3,3,2,6,9,3,3,1,2,10,2,2,11,8,11,15,10,12,2,10,12,1,10,1,11,3,7,12,12,12,14,8,15,12,20,7,5,10,8,10,5,10,8,13,14,14,13,12,13,6,GK ,0,1,1,1,1,1,20,1,1,1,1,1,1,1,1,1,1,1,1,1,1,1,1,0,0,0,0,0,0,0,0,0,0,0,0,0,0,0,0,0,0,0,0,0,0,0,0,0,0,0,0,0,0,0,0,0,0,0,0,0,0,0,0,0,0,0,0,0,0,0,0,0,Mattia Perin,Â£720Th. ,Serie A
29/6/2010,Jan Oblak,64016316,795,1/7/1993,17,0,0,4,0,2500,5150,4750,144,108,1726178,185,77,GK ,15,8,15,6,12,12,12,15,5,15,13,8,1,3,2,5,10,3,3,3,2,4,2,3,6,6,11,13,10,8,2,11,9,2,12,3,15,2,4,6,16,16,13,11,17,5,20,5,9,10,3,10,11,10,6,3,12,14,10,1,12,19,GK ,0,1,1,1,1,1,20,1,1,1,1,1,1,1,1,1,1,1,1,1,1,1,1,0,0,0,0,0,0,0,0,0,0,0,0,0,0,0,0,0,0,0,0,0,0,0,0,0,0,0,0,0,0,0,0,0,0,0,0,0,0,0,0,0,0,0,0,0,0,0,0,0,Jan Oblak,Â£675Th. ,Liga NOS
29/6/2010,Ettore Lagomarsini,43077091,776,1/22/1993,17,0,0,0,0,150,2800,2800,80,56,45154,186,82,GK ,13,7,9,6,7,10,13,7,8,11,8,7,2,1,2,5,10,1,3,1,3,1,1,3,1,7,8,10,8,9,0,9,9,2,10,2,10,2,3,8,13,13,14,7,14,8,20,3,5,7,9,10,3,8,8,18,3,10,13,11,8,7,GK ,0,1,1,1,1,1,20,1,1,1,1,1,1,1,1,1,1,1,1,1,1,1,1,0,0,0,0,0,0,0,0,0,0,0,0,0,0,0,0,0,0,0,0,0,0,0,0,0,0,0,0,0,0,0,0,0,0,0,0,0,0,0,0,0,0,0,0,0,0,0,0,0,,,
29/6/2010,Andrea Tozzo,43050222,776,9/30/1992,17,0,0,0,0,50,2500,2500,135,50,189698,192,75,GK ,10,5,7,6,11,7,8,11,5,4,7,6,3,2,1,7,10,8,2,3,2,5,2,1,7,10,8,7,5,15,8,7,18,1,11,4,9,9,7,9,7,8,14,4,12,6,20,10,11,10,9,13,4,7,10,18,6,10,18,14,18,7,GK ,0,1,1,1,1,1,20,1,1,1,1,1,1,1,1,1,1,1,1,1,1,1,1,0,0,0,0,0,0,0,0,0,0,0,0,0,0,0,0,0,0,0,0,0,0,0,0,0,0,0,0,0,0,0,0,0,0,0,0,0,0,0,0,0,0,0,0,0,0,0,0,0,Andrea Tozzo,Â£90Th. ,Serie A
29/6/2010,Alphonse Areola,85027976,769,2/27/1993,17,0,0,0,0,1250,4634,2550,186,103,7202216,192,85,GK ,14,10,10,11,14,9,12,12,10,8,6,5,2,2,3,6,10,2,11,3,1,8,2,3,6,12,12,11,13,13,6,11,14,8,9,2,9,11,5,13,12,16,16,1,13,9,20,13,16,14,7,10,9,1,5,14,14,15,15,17,17,5,GK ,0,1,1,1,5,1,20,5,1,1,1,5,1,1,1,1,5,1,1,1,1,5,1,0,0,0,0,0,0,0,0,0,0,0,0,0,0,0,0,0,0,0,0,0,0,0,0,0,0,0,0,0,0,0,0,0,0,0,0,0,0,0,0,0,0,0,0,0,0,0,0,0,Alphonse Areola,Â£225Th. ,Ligue 1
29/6/2010,Thomas Lebon,34007222,769,9/16/1991,18,0,0,0,0,1100,4049,2250,122,90,2394774,190,89,GK ,13,14,11,7,11,9,12,12,8,14,6,1,2,1,2,6,6,3,3,1,1,5,3,1,6,10,9,13,11,11,5,8,17,7,8,2,10,8,6,8,10,15,15,1,15,6,20,13,16,14,8,10,5,1,14,15,14,14,14,14,14,6,GK ,0,1,1,1,1,1,20,1,1,1,1,1,1,1,1,1,1,1,1,1,1,1,1,0,0,0,0,0,0,0,0,0,0,0,0,0,0,0,0,0,0,0,0,0,0,0,0,0,0,0,0,0,0,0,0,0,0,0,0,0,0,0,0,0,0,0,0,0,0,0,0,0,,,
29/6/2010,Paredes,67107572,796,7/11/1991,18,0,0,0,0,50,600,600,133,65,23041,183,71,GK ,4,12,12,9,12,12,8,12,8,4,8,6,3,2,1,2,9,0,2,3,2,0,3,2,0,10,5,13,5,10,1,12,9,1,8,1,8,0,2,4,11,8,5,8,12,4,20,6,3,10,12,10,13,7,12,12,12,12,10,17,8,3,GK ,0,1,1,1,1,1,20,1,1,1,1,1,1,1,1,1,1,1,1,1,1,1,1,0,0,0,0,0,0,0,0,0,0,0,0,0,0,0,0,0,0,0,0,0,0,0,0,0,0,0,0,0,0,0,0,0,0,0,0,0,0,0,0,0,0,0,0,0,0,0,0,0,,,
29/6/2010,Marc-André ter Stegen,35017428,771,4/30/1992,18,0,0,0,0,250,3500,3500,133,75,1899403,185,84,GK ,9,10,10,7,9,13,10,12,11,12,8,5,3,3,3,9,10,2,3,3,3,9,1,2,9,4,9,11,9,8,8,9,6,2,9,2,9,9,8,12,12,11,12,6,12,11,20,7,9,10,10,10,6,9,12,10,20,14,7,5,8,12,GK ,0,1,1,1,1,1,20,1,1,1,1,1,1,1,1,1,1,1,1,1,1,1,1,0,0,0,0,0,0,0,0,0,0,0,0,0,0,0,0,0,0,0,0,0,0,0,0,0,0,0,0,0,0,0,0,0,0,0,0,0,0,0,0,0,0,0,0,0,0,0,0,0,Marc-AndrÃ© ter Stegen,Â£2.25m ,Bundesliga
29/6/2010,Gervais Sanou,85071174,9,5/26/1992,18,0,0,0,0,950,3900,1950,122,78,4583847,187,88,GK ,12,5,10,14,12,12,11,12,10,9,10,5,3,1,1,1,9,0,2,2,2,0,3,3,1,12,2,11,8,12,1,12,9,2,8,2,9,0,2,7,10,12,11,1,12,6,20,4,12,9,6,10,9,1,12,7,7,7,5,7,8,6,GK ,0,1,1,1,1,1,20,1,1,1,1,1,1,1,1,1,1,1,1,1,1,1,1,0,0,0,0,0,0,0,0,0,0,0,0,0,0,0,0,0,0,0,0,0,0,0,0,0,0,0,0,0,0,0,0,0,0,0,0,0,0,0,0,0,0,0,0,0,0,0,0,0,,,
29/6/2010,Antonio Santurro,43075231,776,2/29/1992,18,0,0,0,0,50,3750,3750,128,75,551193,176,74,GK ,12,12,10,6,10,11,13,13,8,12,7,3,2,1,1,3,7,0,3,2,1,2,1,1,2,8,8,14,6,12,0,7,9,2,2,3,9,2,3,8,11,13,14,8,16,11,20,5,4,10,14,10,7,7,7,1,10,7,13,12,12,5,GK ,0,1,1,1,1,1,20,1,1,1,1,1,1,1,1,1,1,1,1,1,1,1,1,0,0,0,0,0,0,0,0,0,0,0,0,0,0,0,0,0,0,0,0,0,0,0,0,0,0,0,0,0,0,0,0,0,0,0,0,0,0,0,0,0,0,0,0,0,0,0,0,0,Antonio Santurro,Â£45Th. ,Serie A
29/6/2010,Anthony Loustalot,85057578,769,3/30/1992,18,0,0,0,0,50,3959,3950,126,88,1634789,183,77,GK ,14,8,8,6,10,10,12,12,9,9,7,1,1,1,3,8,6,1,3,1,1,8,1,1,8,14,13,14,12,12,11,10,14,6,6,2,9,1,9,11,11,13,11,1,17,7,20,4,13,14,5,14,11,9,15,14,14,14,16,16,16,5,GK ,0,1,1,1,1,1,20,1,1,1,1,1,1,1,1,1,1,1,1,1,1,1,1,0,0,0,0,0,0,0,0,0,0,0,0,0,0,0,0,0,0,0,0,0,0,0,0,0,0,0,0,0,0,0,0,0,0,0,0,0,0,0,0,0,0,0,0,0,0,0,0,0,,,
29/6/2010,Aniello Ambrosio,43077010,776,1/5/1992,18,0,0,0,0,150,2700,2700,91,54,74512,187,86,GK ,11,5,8,12,11,12,11,13,16,9,9,3,2,1,1,4,7,2,1,3,3,2,3,3,2,11,4,5,5,13,0,12,8,1,2,3,5,2,3,8,9,9,12,7,8,12,20,5,5,10,12,10,3,8,18,1,11,5,13,11,9,15,GK ,0,1,1,1,1,1,20,1,1,1,1,1,1,1,1,1,1,1,1,1,1,1,1,0,0,0,0,0,0,0,0,0,0,0,0,0,0,0,0,0,0,0,0,0,0,0,0,0,0,0,0,0,0,0,0,0,0,0,0,0,0,0,0,0,0,0,0,0,0,0,0,0,Aniello Ambrosio,Â£68Th. ,Serie A
29/6/2010,Abdoulaye Diallo,85058785,769,3/30/1992,18,0,0,0,0,50,4544,2500,134,101,1723422,189,87,GK ,11,14,12,7,10,13,13,15,11,11,13,5,1,3,3,7,9,2,2,2,3,3,2,1,7,13,12,14,12,12,1,9,9,2,8,2,7,3,2,11,11,14,14,1,15,8,20,6,14,14,9,8,5,1,11,7,12,7,10,12,20,9,GK ,0,1,1,1,1,1,20,1,1,1,1,1,1,1,1,1,1,1,1,1,1,1,1,0,0,0,0,0,0,0,0,0,0,0,0,0,0,0,0,0,0,0,0,0,0,0,0,0,0,0,0,0,0,0,0,0,0,0,0,0,0,0,0,0,0,0,0,0,0,0,0,0,Abdoulaye Diallo,Â£540Th. ,Ligue 1
29/6/2010,Rémi Pillot,85028013,769,7/27/1990,19,0,0,0,0,1350,2700,2700,145,108,1723604,187,80,GK ,15,10,11,6,12,9,13,12,9,10,11,2,2,2,3,8,7,3,1,2,3,8,1,2,8,8,14,13,13,13,11,12,15,6,11,2,11,9,7,11,10,15,13,1,14,9,20,14,13,14,8,10,6,1,11,15,13,13,14,14,14,6,GK ,0,1,1,1,1,1,20,1,1,1,1,1,1,1,1,1,1,1,1,1,1,1,1,0,0,0,0,0,0,0,0,0,0,0,0,0,0,0,0,0,0,0,0,0,0,0,0,0,0,0,0,0,0,0,0,0,0,0,0,0,0,0,0,0,0,0,0,0,0,0,0,0,RÃ©mi Pillot,Â£315Th. ,Ligue 1
29/6/2010,Pierrick Cros,85056628,769,6/23/1991,19,0,0,0,0,50,2300,2300,111,92,4150111,185,75,GK ,8,12,10,11,14,12,13,13,11,7,14,5,2,1,1,5,10,1,1,2,3,1,3,3,2,5,8,12,11,11,2,11,8,2,7,3,9,1,4,12,12,13,12,1,8,11,20,6,13,10,11,10,12,10,12,14,6,7,7,10,5,7,GK ,0,1,1,1,1,1,20,1,1,1,1,1,1,1,1,1,1,1,1,1,1,1,1,0,0,0,0,0,0,0,0,0,0,0,0,0,0,0,0,0,0,0,0,0,0,0,0,0,0,0,0,0,0,0,0,0,0,0,0,0,0,0,0,0,0,0,0,0,0,0,0,0,Pierrick Cros, ,Ligue 1
29/6/2010,Ole Söderberg,8119984,797,7/20/1990,19,0,0,0,0,1500,4000,3750,103,80,1251155,191,85,GK ,10,8,10,8,12,12,10,14,10,8,14,2,3,3,2,6,4,5,1,1,2,9,1,2,9,9,9,8,8,10,8,8,13,3,8,3,10,10,11,9,11,13,14,20,13,8,5,11,8,9,3,10,8,9,11,15,11,11,7,8,6,7,GK ,0,1,1,1,1,1,20,1,1,1,1,1,1,1,1,1,1,1,1,1,1,1,1,0,0,0,0,0,0,0,0,0,0,0,0,0,0,0,0,0,0,0,0,0,0,0,0,0,0,0,0,0,0,0,0,0,0,0,0,0,0,0,0,0,0,0,0,0,0,0,0,0,Ole SÃ¶derberg,Â£45Th. ,Premier League
29/6/2010,Mika,55024519,798,3/8/1991,19,0,0,0,0,250,1000,3500,120,75,2339374,187,82,GK ,14,12,13,8,14,7,11,8,14,14,11,6,1,1,1,4,9,3,2,1,2,1,3,3,4,5,7,11,8,7,3,9,8,3,2,3,13,1,4,12,7,7,14,8,17,11,20,4,5,10,6,10,15,9,14,7,6,14,11,13,6,16,GK ,0,1,1,1,1,1,20,1,1,1,1,1,1,1,1,1,1,1,1,1,1,1,1,0,0,0,0,0,0,0,0,0,0,0,0,0,0,0,0,0,0,0,0,0,0,0,0,0,0,0,0,0,0,0,0,0,0,0,0,0,0,0,0,0,0,0,0,0,0,0,0,0,Mika,Â£90Th. ,Liga NOS
29/6/2010,Mathieu Gorgelin,34000464,769,8/5/1990,19,0,0,0,0,50,2200,2200,124,88,453390,187,83,GK ,14,13,13,8,11,9,12,11,7,10,6,2,3,2,3,6,7,3,2,2,1,6,3,1,6,14,11,13,11,11,6,9,17,5,10,1,9,3,12,7,8,14,13,20,13,6,1,7,14,13,6,10,9,1,15,14,15,11,14,14,14,6,GK ,0,1,1,1,1,1,20,1,1,1,1,1,1,1,1,1,1,1,1,1,1,1,1,0,0,0,0,0,0,0,0,0,0,0,0,0,0,0,0,0,0,0,0,0,0,0,0,0,0,0,0,0,0,0,0,0,0,0,0,0,0,0,0,0,0,0,0,0,0,0,0,0,Mathieu Gorgelin,Â£180Th. ,Ligue 1
29/6/2010,Marco Silvestri,43041142,776,3/2/1991,19,0,0,0,0,50,2450,2450,109,70,140874,191,80,GK ,12,6,10,12,9,11,13,10,13,6,11,3,3,1,3,8,5,0,3,2,3,2,3,2,4,9,8,9,8,13,2,9,8,2,4,2,8,2,3,13,10,10,15,8,12,10,20,7,6,9,11,10,15,10,8,20,18,8,10,5,14,12,GK ,0,1,1,1,1,1,20,1,1,1,1,1,1,1,1,1,1,1,1,1,1,1,1,0,0,0,0,0,0,0,0,0,0,0,0,0,0,0,0,0,0,0,0,0,0,0,0,0,0,0,0,0,0,0,0,0,0,0,0,0,0,0,0,0,0,0,0,0,0,0,0,0,Marco Silvestri,Â£180Th. ,Serie A
29/6/2010,Marc Vidal,85057582,769,6/3/1991,19,0,0,0,0,2000,4050,4050,131,90,752481,180,80,GK ,12,6,6,7,13,9,13,13,11,10,9,7,3,1,2,1,10,1,2,1,2,2,3,2,4,7,7,13,9,14,2,13,9,1,5,2,11,2,4,10,10,13,13,8,13,7,20,7,13,10,8,10,8,1,11,3,5,11,7,11,9,14,GK ,0,1,1,1,1,1,20,1,1,1,1,1,1,1,1,1,1,1,1,1,1,1,1,0,0,0,0,0,0,0,0,0,0,0,0,0,0,0,0,0,0,0,0,0,0,0,0,0,0,0,0,0,0,0,0,0,0,0,0,0,0,0,0,0,0,0,0,0,0,0,0,0,Marc Vidal,Â£270Th. ,Ligue 1
29/6/2010,Kevin Trapp,35018013,771,7/8/1990,19,0,0,0,0,1000,5500,5500,155,110,3234238,189,85,GK ,12,13,12,12,12,11,14,14,11,10,11,8,1,1,2,3,10,3,2,1,1,2,2,1,4,7,9,10,8,13,8,9,9,2,5,1,14,13,12,12,14,14,14,5,14,12,20,13,13,12,1,11,4,10,14,13,12,11,11,12,8,8,GK ,0,1,1,1,1,1,20,1,1,1,1,1,1,1,1,1,1,1,1,1,1,1,1,0,0,0,0,0,0,0,0,0,0,0,0,0,0,0,0,0,0,0,0,0,0,0,0,0,0,0,0,0,0,0,0,0,0,0,0,0,0,0,0,0,0,0,0,0,0,0,0,0,Kevin Trapp,Â£2.70m ,Bundesliga
29/6/2010,Jonathan Ligali,29046742,769,5/28/1991,19,0,0,0,0,100,3650,3650,122,86,2900025,183,82,GK ,14,9,9,5,11,8,11,11,11,8,6,6,2,1,3,7,9,1,2,1,1,6,3,1,7,11,12,12,13,13,7,11,14,5,7,2,10,11,9,10,9,14,11,1,15,8,20,12,14,14,10,15,5,1,13,15,14,14,14,14,14,6,GK ,0,1,1,1,1,1,20,1,1,1,1,1,1,1,1,1,1,1,1,1,1,1,1,0,0,0,0,0,0,0,0,0,0,0,0,0,0,0,0,0,0,0,0,0,0,0,0,0,0,0,0,0,0,0,0,0,0,0,0,0,0,0,0,0,0,0,0,0,0,0,0,0,Jonathan Ligali,Â£45Th. ,Ligue 1
29/6/2010,David De Gea,67030171,796,11/7/1990,19,0,0,1,0,5250,6569,6250,175,146,91453172,188,71,GK ,17,16,11,4,16,15,13,15,4,8,12,7,2,1,3,15,10,6,2,1,1,12,1,2,9,7,12,9,9,12,10,14,10,5,10,10,16,11,9,11,17,12,16,5,10,14,20,12,12,16,5,15,5,10,17,11,8,19,7,11,12,14,GK ,0,1,1,1,1,1,20,1,1,1,1,1,1,1,1,1,1,1,1,1,1,1,1,0,0,0,0,0,0,0,0,0,0,0,0,0,0,0,0,0,0,0,0,0,0,0,0,0,0,0,0,0,0,0,0,0,0,0,0,0,0,0,0,0,0,0,0,0,0,0,0,0,David de Gea,Â£10.80m ,LaLiga
29/6/2010,Abdoulaye Keita,34011754,769,8/19/1990,19,0,0,0,0,2400,4859,4850,140,108,6794211,188,83,GK ,13,10,10,8,12,14,13,14,12,10,6,3,2,1,3,9,8,2,3,2,2,7,3,1,9,7,12,13,11,11,8,10,10,6,8,1,10,11,8,12,13,15,14,1,13,7,20,13,15,14,7,13,10,1,8,14,14,6,15,14,9,12,GK ,0,1,1,1,1,1,20,1,1,1,1,1,1,1,1,1,1,1,1,1,1,1,1,0,0,0,0,0,0,0,0,0,0,0,0,0,0,0,0,0,0,0,0,0,0,0,0,0,0,0,0,0,0,0,0,0,0,0,0,0,0,0,0,0,0,0,0,0,0,0,0,0,Abdoulaye Keita,Â£270Th. ,Ligue 1
29/6/2010,Vlado Giljen,5790256,62002127,12/9/1989,20,0,0,7,0,2250,5500,5000,129,108,988586,188,85,GK ,11,10,11,4,13,10,10,13,8,8,11,6,11,11,1,12,8,10,2,12,1,2,12,11,14,15,12,13,12,12,12,12,12,12,12,13,11,12,12,10,10,12,11,11,14,10,20,11,10,15,7,11,9,9,14,15,13,14,11,13,13,5,GK ,0,1,1,1,1,1,20,1,1,1,1,1,1,1,1,1,1,1,1,1,1,1,1,0,0,0,0,0,0,0,0,0,0,0,0,0,0,0,0,0,0,0,0,0,0,0,0,0,0,0,0,0,0,0,0,0,0,0,0,0,0,0,0,0,0,0,0,0,0,0,0,0,Vladan Giljen,Â£90Th. ,Liga NOS
29/6/2010,Vincenzo Fiorillo,43009042,776,1/13/1990,20,0,0,3,0,2500,5150,5150,149,103,1931658,190,74,GK ,10,12,10,6,14,12,11,16,6,11,10,6,1,1,1,4,10,4,2,1,1,4,1,1,4,5,11,10,10,9,9,11,7,3,12,2,10,11,12,12,11,12,13,20,8,11,5,7,11,10,6,10,12,10,6,16,10,11,6,10,18,14,GK ,0,1,1,1,1,1,20,1,1,1,1,1,1,1,1,1,1,1,1,1,1,1,1,0,0,0,0,0,0,0,0,0,0,0,0,0,0,0,0,0,0,0,0,0,0,0,0,0,0,0,0,0,0,0,0,0,0,0,0,0,0,0,0,0,0,0,0,0,0,0,0,0,Vincenzo Fiorillo,Â£315Th. ,Serie A
29/6/2010,Sebastian Mielitz,92002690,771,7/18/1989,20,0,0,0,0,1250,5250,5250,120,105,5825190,188,73,GK ,14,14,13,6,13,12,14,14,13,12,11,5,1,2,1,6,8,1,1,2,2,3,2,3,5,8,9,14,13,13,2,11,12,1,11,1,10,2,7,14,10,9,12,8,11,13,20,3,4,9,11,10,12,10,12,14,10,8,12,14,14,7,GK ,0,1,1,1,1,1,20,1,1,1,1,1,1,1,1,1,1,1,1,1,1,1,1,0,0,0,0,0,0,0,0,0,0,0,0,0,0,0,0,0,0,0,0,0,0,0,0,0,0,0,0,0,0,0,0,0,0,0,0,0,0,0,0,0,0,0,0,0,0,0,0,0,Sebastian Mielitz,Â£720Th. ,Bundesliga
29/6/2010,Samuel Atrous,34000462,769,2/15/1990,20,0,0,0,0,50,2300,2300,130,92,1935133,190,85,GK ,14,14,10,7,10,5,11,12,7,8,10,7,3,3,1,6,10,2,3,2,2,5,3,2,6,10,13,13,12,12,1,12,8,5,10,3,8,6,11,9,9,15,15,1,12,6,20,6,15,10,13,10,10,1,13,14,16,5,11,5,12,5,GK ,0,1,1,1,1,1,20,1,1,1,1,1,1,1,1,1,1,1,1,1,1,1,1,0,0,0,0,0,0,0,0,0,0,0,0,0,0,0,0,0,0,0,0,0,0,0,0,0,0,0,0,0,0,0,0,0,0,0,0,0,0,0,0,0,0,0,0,0,0,0,0,0,Samuel Atrous,Â£225Th. ,Ligue 1
29/6/2010,Samir Kouakbi,8449658,769,2/27/1990,20,0,0,0,0,1250,2500,2500,135,100,611711,183,70,GK ,9,8,10,11,10,13,13,15,14,11,7,6,2,2,2,13,8,3,2,2,1,8,3,1,13,11,13,12,8,8,11,10,16,3,10,1,11,3,11,13,15,13,11,8,8,12,20,5,10,13,7,14,11,1,13,17,7,16,12,6,5,6,GK ,0,1,1,8,8,1,20,1,1,1,1,1,1,1,1,8,1,1,1,1,1,1,1,0,0,0,0,0,0,0,0,0,0,0,0,0,0,0,0,0,0,0,0,0,0,0,0,0,0,0,0,0,0,0,0,0,0,0,0,0,0,0,0,0,0,0,0,0,0,0,0,0,,,
29/6/2010,Rob Lainton,28011689,765,10/12/1989,20,0,0,0,0,1681,3500,3500,139,82,312627,183,70,GK ,8,5,10,13,14,7,12,14,4,12,8,3,1,2,3,4,2,1,2,2,2,2,3,1,1,11,10,14,9,11,1,13,9,1,2,3,14,3,4,6,12,8,12,10,12,5,20,5,5,8,4,7,12,10,9,19,7,9,13,10,14,20,GK ,0,1,1,1,1,1,20,1,1,1,1,1,1,1,1,1,1,1,1,1,1,1,1,0,0,0,0,0,0,0,0,0,0,0,0,0,0,0,0,0,0,0,0,0,0,0,0,0,0,0,0,0,0,0,0,0,0,0,0,0,0,0,0,0,0,0,0,0,0,0,0,0,Rob Lainton,- ,Premier League
29/6/2010,Rafael Romo,86005935,1658,2/25/1990,20,3,0,18,0,2500,5750,5400,142,114,7176942,197,85,GK ,11,10,8,9,11,13,16,16,7,8,8,5,2,1,1,11,10,9,2,3,1,12,2,1,12,13,12,13,11,12,6,11,17,5,11,3,12,8,9,11,17,8,16,6,14,9,20,8,10,13,13,13,6,10,16,16,11,16,12,10,10,8,GK ,0,1,1,1,1,1,20,1,1,1,1,1,1,1,1,1,1,1,1,1,1,1,1,0,0,0,0,0,0,0,0,0,0,0,0,0,0,0,0,0,0,0,0,0,0,0,0,0,0,0,0,0,0,0,0,0,0,0,0,0,0,0,0,0,0,0,0,0,0,0,0,0,Rafael Romo,Â£90Th. ,Serie A
29/6/2010,Oliver Baumann,35017377,771,6/2/1990,20,0,0,0,0,2809,5000,5000,140,106,2159098,176,78,GK ,12,9,10,15,13,11,12,14,9,8,7,5,3,3,1,5,10,3,1,2,3,1,3,1,8,12,11,11,9,13,3,12,8,3,8,1,10,12,7,12,12,11,16,10,5,11,20,10,11,10,6,5,7,9,10,18,13,10,6,7,13,4,GK ,0,1,1,1,1,1,20,1,1,1,1,1,1,1,1,1,1,1,1,1,1,1,1,0,0,0,0,0,0,0,0,0,0,0,0,0,0,0,0,0,0,0,0,0,0,0,0,0,0,0,0,0,0,0,0,0,0,0,0,0,0,0,0,0,0,0,0,0,0,0,0,0,Oliver Baumann,Â£3.60m ,Bundesliga
29/6/2010,Maxime Montay,85054554,769,2/21/1990,20,0,0,0,0,50,2100,2100,116,85,318008,180,75,GK ,13,6,9,14,13,12,12,12,9,12,10,2,2,2,2,9,6,2,3,3,3,6,2,2,9,11,11,13,9,12,8,11,8,1,10,2,10,0,1,9,11,12,9,1,6,6,20,4,11,10,8,6,9,10,13,2,8,14,5,6,6,20,GK ,0,1,1,1,1,1,20,1,1,1,1,1,1,1,1,1,1,1,1,1,1,1,1,0,0,0,0,0,0,0,0,0,0,0,0,0,0,0,0,0,0,0,0,0,0,0,0,0,0,0,0,0,0,0,0,0,0,0,0,0,0,0,0,0,0,0,0,0,0,0,0,0,,,
29/6/2010,Mario Kirev,22007016,760,8/15/1989,20,0,0,4,0,100,4634,4750,140,103,2525146,192,85,GK ,13,12,11,8,13,11,12,14,9,9,9,7,1,2,1,8,10,12,1,1,3,13,1,2,5,9,9,8,11,12,8,8,10,5,9,9,11,12,8,10,12,8,14,5,6,13,20,12,15,10,15,6,8,10,14,14,10,11,14,10,14,12,GK ,0,1,1,1,1,1,20,1,1,1,1,1,1,1,1,1,1,1,1,1,1,1,1,0,0,0,0,0,0,0,0,0,0,0,0,0,0,0,0,0,0,0,0,0,0,0,0,0,0,0,0,0,0,0,0,0,0,0,0,0,0,0,0,0,0,0,0,0,0,0,0,0,Mario Kirev,Â£45Th. ,Serie A
29/6/2010,Johannes Focher,35011181,771,1/20/1990,20,0,0,0,0,250,4250,4250,133,85,780715,199,94,GK ,13,13,10,3,13,13,12,13,8,9,12,7,3,2,1,5,10,1,3,2,1,1,2,1,6,9,10,11,7,7,1,4,8,2,14,1,11,2,3,4,6,6,17,8,17,9,20,6,8,10,8,8,9,10,9,17,11,6,14,6,11,9,GK ,0,1,1,1,1,1,20,1,1,1,1,1,1,1,1,1,1,1,1,1,1,1,1,0,0,0,0,0,0,0,0,0,0,0,0,0,0,0,0,0,0,0,0,0,0,0,0,0,0,0,0,0,0,0,0,0,0,0,0,0,0,0,0,0,0,0,0,0,0,0,0,0,Johannes Focher,Â£135Th. ,Bundesliga
29/6/2010,Joel Robles,67037306,796,6/17/1990,20,0,0,0,0,2250,5039,4850,155,112,5763245,195,85,GK ,16,12,12,6,15,10,12,11,8,10,13,15,2,1,3,4,17,2,1,1,3,3,1,1,9,5,7,11,6,11,8,9,6,2,10,1,12,8,7,9,13,16,17,5,12,7,20,10,16,14,5,12,8,10,12,17,11,7,16,15,13,10,GK ,0,1,1,1,1,1,20,1,1,1,1,1,1,1,1,1,1,1,1,1,1,1,1,0,0,0,0,0,0,0,0,0,0,0,0,0,0,0,0,0,0,0,0,0,0,0,0,0,0,0,0,0,0,0,0,0,0,0,0,0,0,0,0,0,0,0,0,0,0,0,0,0,Joel Robles,Â£900Th. ,LaLiga
29/6/2010,Franck L'Hostis,85022969,769,4/3/1990,20,0,0,0,0,1300,2600,2600,136,104,4570617,186,77,GK ,12,10,12,12,12,13,13,13,10,14,11,3,2,2,1,5,7,0,3,2,2,0,1,3,5,9,10,13,7,13,1,11,9,2,7,3,13,2,3,10,14,13,12,1,16,13,20,4,13,10,4,10,5,1,10,14,11,13,19,10,6,5,GK ,0,1,1,1,1,1,20,1,1,1,1,1,1,1,1,1,1,1,1,1,1,1,1,0,0,0,0,0,0,0,0,0,0,0,0,0,0,0,0,0,0,0,0,0,0,0,0,0,0,0,0,0,0,0,0,0,0,0,0,0,0,0,0,0,0,0,0,0,0,0,0,0,Franck L'Hostis,Â£135Th. ,Ligue 1
29/6/2010,Fabian Giefer,29022522,771,5/17/1990,20,0,0,0,0,2000,5500,5500,145,115,2573855,196,86,GK ,13,13,9,6,12,14,12,14,12,10,9,5,1,2,3,8,10,6,2,2,2,7,1,1,7,8,12,13,9,12,6,11,12,4,6,3,14,13,12,8,12,13,18,8,12,9,20,13,14,12,3,10,4,10,7,12,14,13,13,14,16,3,GK ,0,1,1,1,1,1,20,1,1,1,1,1,1,1,1,1,1,1,1,1,1,1,1,0,0,0,0,0,0,0,0,0,0,0,0,0,0,0,0,0,0,0,0,0,0,0,0,0,0,0,0,0,0,0,0,0,0,0,0,0,0,0,0,0,0,0,0,0,0,0,0,0,Fabian Giefer,Â£450Th. ,Bundesliga
29/6/2010,Daniel Schwabke,35014362,771,7/19/1989,20,0,0,0,0,1500,4000,4000,110,90,621972,192,75,GK ,12,9,11,8,12,11,12,13,11,13,11,6,2,2,2,6,9,9,2,1,3,7,2,3,5,8,11,8,9,15,2,10,8,2,8,2,10,3,5,12,10,11,17,20,13,13,5,4,10,9,11,10,10,9,9,15,1,12,9,10,8,18,GK ,0,1,1,1,1,1,20,1,1,1,1,1,1,1,1,1,1,1,1,1,1,1,1,0,0,0,0,0,0,0,0,0,0,0,0,0,0,0,0,0,0,0,0,0,0,0,0,0,0,0,0,0,0,0,0,0,0,0,0,0,0,0,0,0,0,0,0,0,0,0,0,0,Daniel Schwabke,Â£68Th. ,Bundesliga
29/6/2010,Ben Amos,28000902,765,4/10/1990,20,0,0,0,0,2450,4950,4950,151,99,4069826,191,79,GK ,14,13,12,3,14,9,11,14,10,7,10,3,1,1,3,7,4,3,1,3,2,8,2,2,8,4,10,10,6,9,5,10,12,1,5,1,10,10,7,7,13,11,14,8,15,7,20,8,8,15,4,10,8,1,14,11,12,14,16,15,14,3,GK ,0,1,1,1,1,1,20,1,1,1,1,1,1,1,1,1,1,1,1,1,1,1,1,0,0,0,0,0,0,0,0,0,0,0,0,0,0,0,0,0,0,0,0,0,0,0,0,0,0,0,0,0,0,0,0,0,0,0,0,0,0,0,0,0,0,0,0,0,0,0,0,0,Ben Amos,- ,Premier League
29/6/2010,Aurélien-Emmanuel Hérisson,8449425,769,2/17/1990,20,0,0,0,0,50,2000,2000,104,80,110011,187,84,GK ,14,6,14,10,10,7,12,13,11,13,12,5,3,1,2,8,7,1,3,3,2,6,1,2,8,13,9,12,8,12,1,11,8,2,6,1,7,2,3,10,12,15,13,1,15,9,20,6,15,10,13,6,12,1,14,19,8,6,12,12,11,7,GK ,0,1,1,1,1,1,20,1,1,1,1,1,1,1,1,1,1,1,1,1,1,1,1,0,0,0,0,0,0,0,0,0,0,0,0,0,0,0,0,0,0,0,0,0,0,0,0,0,0,0,0,0,0,0,0,0,0,0,0,0,0,0,0,0,0,0,0,0,0,0,0,0,,,
29/6/2010,Willy Maeyens,8447685,769,6/5/1989,21,0,0,0,0,1350,2750,2750,140,110,3419472,199,93,GK ,16,13,12,8,11,7,14,14,7,7,7,2,1,3,3,5,6,1,1,3,2,6,2,1,5,8,9,14,12,12,6,10,16,6,10,3,12,3,11,6,9,18,18,8,14,5,20,9,18,14,8,10,6,1,13,14,14,13,14,14,14,7,GK ,0,1,1,1,1,1,20,1,1,1,1,1,1,1,1,1,1,1,1,1,1,1,1,0,0,0,0,0,0,0,0,0,0,0,0,0,0,0,0,0,0,0,0,0,0,0,0,0,0,0,0,0,0,0,0,0,0,0,0,0,0,0,0,0,0,0,0,0,0,0,0,0,Willy Maeyens,Â£270Th. ,Ligue 1
29/6/2010,Tomeu Nadal,67018559,796,2/8/1989,21,0,0,0,0,2162,4000,4000,119,93,2821921,190,77,GK ,13,10,7,4,13,9,13,11,6,6,8,5,1,3,3,7,7,2,2,3,3,0,2,3,3,8,12,13,8,11,0,13,9,3,11,2,13,0,2,8,12,11,11,9,6,9,20,6,8,10,7,10,6,10,8,17,13,7,14,5,14,16,GK ,0,1,1,1,1,1,20,1,1,1,1,1,1,1,1,1,1,1,1,1,1,1,1,0,0,0,0,0,0,0,0,0,0,0,0,0,0,0,0,0,0,0,0,0,0,0,0,0,0,0,0,0,0,0,0,0,0,0,0,0,0,0,0,0,0,0,0,0,0,0,0,0,Tomeu Nadal,- ,LaLiga
29/6/2010,Tom Mickel,35011447,771,4/19/1989,21,0,0,0,0,1500,1500,1500,122,85,104244,186,77,GK ,12,12,11,1,9,9,10,12,11,10,8,4,2,2,3,9,6,1,2,1,3,8,2,2,7,10,9,12,9,10,8,11,11,7,13,10,11,9,11,8,10,10,15,10,12,6,20,8,9,14,9,14,9,10,9,14,12,10,12,13,8,10,GK ,0,1,1,1,1,1,20,1,1,1,1,1,1,1,1,1,1,1,1,1,1,1,1,0,0,0,0,0,0,0,0,0,0,0,0,0,0,0,0,0,0,0,0,0,0,0,0,0,0,0,0,0,0,0,0,0,0,0,0,0,0,0,0,0,0,0,0,0,0,0,0,0,Tom Mickel,Â£135Th. ,Bundesliga
29/6/2010,Thomas Kraft,35007943,771,7/22/1988,21,0,0,0,0,1500,6000,6000,145,117,3621032,185,83,GK ,9,10,9,4,14,14,16,17,5,9,12,8,3,1,1,8,10,2,1,2,2,8,1,1,8,11,12,11,14,11,6,13,6,14,4,2,11,8,6,12,17,11,14,5,14,10,20,9,7,10,10,10,14,10,11,19,7,11,12,10,14,19,GK ,0,1,1,1,1,1,20,1,1,1,1,1,1,1,1,1,1,1,1,1,1,1,1,0,0,0,0,0,0,0,0,0,0,0,0,0,0,0,0,0,0,0,0,0,0,0,0,0,0,0,0,0,0,0,0,0,0,0,0,0,0,0,0,0,0,0,0,0,0,0,0,0,Thomas Kraft,Â£2.25m ,Bundesliga
29/6/2010,Sven Ulreich,35008097,771,8/3/1988,21,0,0,3,0,3500,6250,6250,145,125,17616003,192,84,GK ,13,11,12,3,10,12,15,16,9,11,15,6,1,2,2,9,10,1,2,2,3,10,1,3,8,12,13,14,14,10,8,11,10,1,6,3,12,13,10,13,13,15,16,6,9,10,20,12,14,6,3,10,10,10,10,12,12,5,10,10,7,5,GK ,0,1,1,1,1,1,20,1,1,1,1,1,1,1,1,1,1,1,1,1,1,1,1,0,0,0,0,0,0,0,0,0,0,0,0,0,0,0,0,0,0,0,0,0,0,0,0,0,0,0,0,0,0,0,0,0,0,0,0,0,0,0,0,0,0,0,0,0,0,0,0,0,Sven Ulreich,Â£3.15m ,Bundesliga
29/6/2010,Simon Mignolet,8167246,757,8/6/1988,21,0,0,7,0,4225,5849,6400,158,130,11531493,193,88,GK ,14,14,12,5,14,15,17,15,14,10,14,7,3,1,3,11,9,8,2,2,2,16,1,2,12,14,12,8,13,11,10,12,11,2,14,3,12,12,14,12,12,12,16,6,14,12,20,12,12,16,7,10,8,10,12,4,17,13,12,9,13,8,GK ,0,1,1,1,1,1,20,1,1,1,1,1,1,1,1,1,1,1,1,1,1,1,1,0,0,0,0,0,0,0,0,0,0,0,0,0,0,0,0,0,0,0,0,0,0,0,0,0,0,0,0,0,0,0,0,0,0,0,0,0,0,0,0,0,0,0,0,0,0,0,0,0,Simon Mignolet,Â£3.60m ,Premier League
29/6/2010,Sergio Garabato,67067061,796,5/16/1989,21,0,0,0,0,1000,3500,3500,121,65,95375,187,98,GK ,12,10,8,12,9,11,7,8,10,6,5,4,3,2,2,1,7,0,3,3,1,0,2,2,2,8,5,13,5,11,0,6,12,2,2,2,10,0,4,9,10,7,11,8,15,8,20,6,15,10,9,6,14,10,1,13,5,7,14,12,14,13,GK ,0,1,1,1,1,1,20,1,1,1,1,1,1,1,1,1,1,1,1,1,1,1,1,0,0,0,0,0,0,0,0,0,0,0,0,0,0,0,0,0,0,0,0,0,0,0,0,0,0,0,0,0,0,0,0,0,0,0,0,0,0,0,0,0,0,0,0,0,0,0,0,0,Sergio Garabato, ,LaLiga
29/6/2010,Sergio Asenjo,67006488,796,6/28/1989,21,0,0,10,0,4900,7000,7000,165,140,23000628,184,85,GK ,13,15,12,7,12,15,14,17,13,7,11,5,3,2,2,4,8,2,3,1,3,2,2,3,9,10,16,13,6,12,5,11,13,15,10,6,13,12,12,13,17,13,13,4,17,14,20,16,17,13,8,14,10,10,13,15,13,15,17,15,18,9,GK ,0,1,1,1,1,1,20,1,1,1,1,1,1,1,1,1,1,1,1,1,1,1,1,0,0,0,0,0,0,0,0,0,0,0,0,0,0,0,0,0,0,0,0,0,0,0,0,0,0,0,0,0,0,0,0,0,0,0,0,0,0,0,0,0,0,0,0,0,0,0,0,0,Sergio Asenjo,Â£4.50m ,LaLiga
29/6/2010,Rubén Miño,67018886,796,1/18/1989,21,0,0,1,0,2450,4950,4950,125,99,4857672,190,87,GK ,10,9,10,5,13,10,12,13,13,8,11,3,2,2,2,3,7,6,3,2,1,8,3,2,6,7,11,10,11,10,8,10,6,3,7,3,11,12,11,10,13,12,15,6,12,9,20,11,11,11,3,10,9,10,11,8,8,5,6,14,16,14,GK ,0,1,1,1,1,1,20,1,1,1,1,1,1,1,1,1,1,1,1,1,1,1,1,0,0,0,0,0,0,0,0,0,0,0,0,0,0,0,0,0,0,0,0,0,0,0,0,0,0,0,0,0,0,0,0,0,0,0,0,0,0,0,0,0,0,0,0,0,0,0,0,0,,,
29/6/2010,Ron-Robert Zieler,5127684,771,2/12/1989,21,0,0,0,0,1849,4250,4250,120,86,2397401,189,83,GK ,12,11,10,9,14,12,12,13,13,12,9,5,3,2,2,8,9,1,3,2,3,9,2,1,6,8,9,7,10,8,6,8,12,1,2,2,10,8,9,10,13,10,11,8,10,8,20,8,8,13,12,10,3,1,12,16,13,11,14,14,15,2,GK ,0,1,1,1,1,1,20,1,1,1,1,1,1,1,1,1,1,1,1,1,1,1,1,0,0,0,0,0,0,0,0,0,0,0,0,0,0,0,0,0,0,0,0,0,0,0,0,0,0,0,0,0,0,0,0,0,0,0,0,0,0,0,0,0,0,0,0,0,0,0,0,0,Ron-Robert Zieler,Â£3.15m ,Bundesliga
29/6/2010,Ralf Fährmann,35016396,771,9/27/1988,21,0,0,1,0,2000,6250,6250,137,125,3271005,194,89,GK ,14,13,9,6,13,12,16,15,12,5,13,3,3,2,2,10,6,2,2,3,3,10,2,2,11,10,11,13,10,12,8,12,8,3,5,13,12,9,12,10,12,12,15,5,16,12,20,10,16,11,8,4,12,10,9,5,9,9,7,8,19,14,GK ,0,1,1,1,1,1,20,1,1,1,1,1,1,1,1,1,1,1,1,1,1,1,1,0,0,0,0,0,0,0,0,0,0,0,0,0,0,0,0,0,0,0,0,0,0,0,0,0,0,0,0,0,0,0,0,0,0,0,0,0,0,0,0,0,0,0,0,0,0,0,0,0,Ralf FÃ¤hrmann,Â£1.35m ,Bundesliga
29/6/2010,Pablo Alcolea,67063854,796,3/26/1989,21,0,0,0,0,1156,3100,3100,103,68,298316,185,82,GK ,9,10,8,4,12,8,10,13,12,7,9,1,3,2,2,5,4,2,3,1,3,6,3,1,5,6,7,9,8,12,4,8,10,4,5,2,10,8,8,8,13,8,10,5,13,9,20,11,10,13,4,11,12,10,20,5,11,9,15,14,8,6,GK ,0,1,1,1,1,1,20,1,1,1,1,1,1,1,1,1,1,1,1,1,1,1,1,0,0,0,0,0,0,0,0,0,0,0,0,0,0,0,0,0,0,0,0,0,0,0,0,0,0,0,0,0,0,0,0,0,0,0,0,0,0,0,0,0,0,0,0,0,0,0,0,0,Pablo Alcolea, ,LaLiga
29/6/2010,Mitchell Langerak,15004041,1435,8/22/1988,21,0,0,5,0,2000,5500,5500,155,108,1872984,191,77,GK ,16,12,11,6,12,10,11,16,10,10,10,3,3,3,2,4,6,6,2,2,1,7,2,2,8,8,12,7,7,9,7,8,15,3,4,1,11,12,12,11,15,11,15,5,11,10,20,12,9,10,8,10,4,10,10,15,8,9,8,10,12,6,GK ,0,1,1,1,1,1,20,1,1,1,1,1,1,1,1,1,1,1,1,1,1,1,1,0,0,0,0,0,0,0,0,0,0,0,0,0,0,0,0,0,0,0,0,0,0,0,0,0,0,0,0,0,0,0,0,0,0,0,0,0,0,0,0,0,0,0,0,0,0,0,0,0,Mitchell Langerak,Â£630Th. ,Bundesliga
29/6/2010,Miro Varvodic,662889,761,5/15/1989,21,0,0,0,0,2500,3500,5400,140,108,3280087,191,71,GK ,12,9,8,12,15,11,13,13,8,5,12,2,3,3,1,7,7,1,1,1,3,1,1,3,3,5,12,11,7,9,1,10,9,3,7,3,11,3,4,13,15,12,15,5,12,14,20,8,11,10,9,10,9,10,9,20,12,13,6,6,7,19,GK ,0,1,1,1,1,1,20,1,1,1,1,1,1,1,1,1,1,1,1,1,1,1,1,0,0,0,0,0,0,0,0,0,0,0,0,0,0,0,0,0,0,0,0,0,0,0,0,0,0,0,0,0,0,0,0,0,0,0,0,0,0,0,0,0,0,0,0,0,0,0,0,0,Miro Varvodic,Â£450Th. ,Bundesliga
29/6/2010,Matthieu Dreyer,8442413,769,3/20/1989,21,0,0,1,0,3422,5264,5250,145,117,3600796,188,81,GK ,12,10,10,6,13,9,14,15,11,12,9,8,2,1,3,8,10,1,2,2,2,8,3,3,8,8,13,13,13,13,8,11,15,6,11,3,13,11,11,12,13,16,14,1,15,9,20,14,14,14,8,15,5,1,5,13,15,9,14,14,14,6,GK ,0,1,1,1,1,1,20,1,1,1,1,1,1,1,1,1,1,1,1,1,1,1,1,0,0,0,0,0,0,0,0,0,0,0,0,0,0,0,0,0,0,0,0,0,0,0,0,0,0,0,0,0,0,0,0,0,0,0,0,0,0,0,0,0,0,0,0,0,0,0,0,0,Matthieu Dreyer,Â£630Th. ,Ligue 1
29/6/2010,Magnusson Lopes,8449997,769,5/12/1989,21,0,0,0,0,50,2000,2000,92,81,52497,180,82,GK ,10,13,9,12,10,12,11,13,7,11,9,8,2,2,3,4,10,0,1,3,2,2,2,3,3,3,8,10,9,13,0,8,9,3,8,2,9,0,3,9,9,13,9,1,11,7,20,6,13,10,8,10,11,10,9,18,14,6,12,11,12,5,GK ,0,1,1,1,1,1,20,1,1,1,1,1,1,1,1,1,1,1,1,1,1,1,1,0,0,0,0,0,0,0,0,0,0,0,0,0,0,0,0,0,0,0,0,0,0,0,0,0,0,0,0,0,0,0,0,0,0,0,0,0,0,0,0,0,0,0,0,0,0,0,0,0,,,
29/6/2010,Ludovic Guimera,8449320,769,2/24/1989,21,0,0,0,0,50,1900,1900,92,78,73533,185,77,GK ,13,14,10,8,10,7,9,13,15,13,6,1,1,2,1,6,4,2,3,3,2,6,3,3,6,8,11,11,8,10,8,12,7,6,9,3,9,3,1,11,11,14,12,1,11,10,20,4,12,10,17,10,9,1,12,15,5,11,12,12,11,15,GK ,0,1,1,1,1,1,20,1,1,1,1,1,1,1,1,1,1,1,1,1,1,1,1,0,0,0,0,0,0,0,0,0,0,0,0,0,0,0,0,0,0,0,0,0,0,0,0,0,0,0,0,0,0,0,0,0,0,0,0,0,0,0,0,0,0,0,0,0,0,0,0,0,,,
29/6/2010,Jordan Fernand,85042901,769,6/16/1989,21,0,0,0,0,1100,2200,2200,110,88,151441,180,76,GK ,13,11,9,8,12,6,11,11,9,11,12,5,2,2,2,6,10,5,2,3,3,5,11,3,6,8,11,12,9,12,4,11,14,1,7,3,9,6,12,12,11,12,10,1,13,14,20,10,13,14,6,10,12,10,8,13,16,14,15,14,14,5,GK ,0,1,1,1,1,1,20,1,1,1,1,1,1,1,1,1,1,1,1,1,1,1,1,0,0,0,0,0,0,0,0,0,0,0,0,0,0,0,0,0,0,0,0,0,0,0,0,0,0,0,0,0,0,0,0,0,0,0,0,0,0,0,0,0,0,0,0,0,0,0,0,0,,,
29/6/2010,David Ospina,8835677,1653,8/31/1988,21,10,0,12,0,4200,6800,6100,165,136,10550255,183,79,GK ,15,14,14,9,13,14,14,16,12,9,9,7,1,2,3,10,10,3,2,2,1,7,1,3,10,8,13,14,12,12,9,13,14,3,11,1,11,12,12,8,15,14,11,1,13,11,20,12,14,15,14,15,7,1,13,12,14,14,14,12,12,12,GK ,0,1,1,1,1,1,20,1,1,1,1,1,1,1,1,1,1,1,1,1,1,1,1,0,0,0,0,0,0,0,0,0,0,0,0,0,0,0,0,0,0,0,0,0,0,0,0,0,0,0,0,0,0,0,0,0,0,0,0,0,0,0,0,0,0,0,0,0,0,0,0,0,David Ospina,Â£5.85m ,Ligue 1
29/6/2010,Álvaro,67108179,796,8/16/1988,21,0,0,0,0,1640,4000,4000,105,81,244257,177,78,GK ,13,7,10,7,11,11,9,13,6,13,10,3,2,3,2,5,4,1,1,2,2,2,3,3,4,12,11,12,10,10,2,9,8,2,12,2,12,1,2,6,11,11,5,9,11,7,20,3,3,10,11,8,8,10,8,13,8,6,13,9,11,12,GK ,0,1,1,1,1,1,20,1,1,1,1,1,1,1,1,1,1,1,1,1,1,1,1,0,0,0,0,0,0,0,0,0,0,0,0,0,0,0,0,0,0,0,0,0,0,0,0,0,0,0,0,0,0,0,0,0,0,0,0,0,0,0,0,0,0,0,0,0,0,0,0,0,,,
29/6/2010,Alexandre Oukidja,8443045,769,7/19/1988,21,0,0,0,0,2500,3800,3800,140,116,1640711,186,78,GK ,13,13,11,13,12,11,14,14,12,15,8,2,3,3,2,10,7,1,10,3,3,8,1,3,10,10,12,15,8,10,9,11,14,6,9,1,9,12,10,15,14,13,13,1,15,13,20,14,13,13,10,14,6,1,11,14,13,12,13,14,11,7,GK ,0,1,1,1,1,1,20,1,1,1,1,1,1,1,1,1,1,1,1,1,1,1,1,0,0,0,0,0,0,0,0,0,0,0,0,0,0,0,0,0,0,0,0,0,0,0,0,0,0,0,0,0,0,0,0,0,0,0,0,0,0,0,0,0,0,0,0,0,0,0,0,0,Alexandre Oukidja,Â£180Th. ,Ligue 1
29/6/2010,Urtzi Iturrioz,67039259,796,1/12/1988,22,0,0,0,0,1600,3500,3500,112,80,803617,178,78,GK ,10,7,12,5,12,5,11,10,7,7,7,3,3,1,2,2,3,0,1,1,2,0,2,3,1,9,10,12,11,12,0,12,9,3,12,2,8,0,2,7,16,12,7,9,12,9,20,4,3,10,12,10,17,10,9,13,6,11,15,6,9,10,GK ,0,1,1,1,1,1,20,1,1,1,1,1,1,1,1,1,1,1,1,1,1,1,1,0,0,0,0,0,0,0,0,0,0,0,0,0,0,0,0,0,0,0,0,0,0,0,0,0,0,0,0,0,0,0,0,0,0,0,0,0,0,0,0,0,0,0,0,0,0,0,0,0,,,
29/6/2010,Tobias Sippel,35006814,771,3/22/1988,22,0,0,8,0,2000,6750,6750,160,135,4802103,180,79,GK ,10,12,14,11,14,16,15,16,12,14,10,5,3,3,1,6,10,5,2,2,3,6,2,2,6,10,10,12,10,12,10,9,14,8,13,2,13,13,11,11,13,11,13,3,14,11,20,9,13,14,2,13,8,10,11,14,15,13,13,14,10,11,GK ,0,1,1,1,1,1,20,1,1,1,1,1,1,1,1,1,1,1,1,1,1,1,1,0,0,0,0,0,0,0,0,0,0,0,0,0,0,0,0,0,0,0,0,0,0,0,0,0,0,0,0,0,0,0,0,0,0,0,0,0,0,0,0,0,0,0,0,0,0,0,0,0,Tobias Sippel,Â£1.80m ,Bundesliga
29/6/2010,Tim Krul,859596,784,4/3/1988,22,0,0,3,0,2750,6000,6000,150,120,5257258,188,74,GK ,14,13,11,12,12,13,14,16,14,11,13,5,2,1,3,11,10,5,1,2,1,8,8,1,8,11,12,15,9,13,5,7,15,3,8,1,12,10,12,11,15,12,14,20,12,8,10,15,10,10,8,15,8,10,16,15,10,14,12,10,8,3,GK ,0,1,1,1,1,1,20,1,1,1,1,1,1,1,1,1,1,1,1,1,1,1,1,196608,0,0,0,0,0,0,0,0,0,0,0,0,0,0,0,0,1,1,0,0,0,0,0,0,0,0,0,0,0,0,0,0,0,0,0,0,0,0,0,0,0,0,0,0,0,0,0,0,Tim Krul,Â£1.80m ,Premier League
29/6/2010,Simon Pontdemé,34001205,769,5/4/1988,22,0,0,0,0,2300,3500,3500,135,107,1658893,186,81,GK ,14,11,11,7,12,10,13,13,13,7,8,6,2,2,3,7,10,1,2,3,2,7,3,3,7,7,12,13,12,12,9,12,14,5,11,2,10,11,7,10,12,14,13,1,14,9,20,12,14,14,7,13,7,1,10,13,14,12,15,15,15,5,GK ,0,1,1,1,1,1,20,1,1,1,1,1,1,1,1,1,1,1,1,1,1,1,1,0,0,0,0,0,0,0,0,0,0,0,0,0,0,0,0,0,0,0,0,0,0,0,0,0,0,0,0,0,0,0,0,0,0,0,0,0,0,0,0,0,0,0,0,0,0,0,0,0,Simon PontdemÃ©,Â£225Th. ,Ligue 1
29/6/2010,Ruud Boffin,8161348,757,11/5/1987,22,0,0,0,0,2862,4814,5250,130,107,4442344,196,86,GK ,14,12,13,5,14,12,13,15,7,8,12,6,1,1,2,6,10,4,2,3,1,3,3,2,11,7,12,7,12,11,4,13,9,2,10,1,15,2,5,10,10,13,17,8,13,12,20,9,7,10,12,4,9,10,9,9,9,11,14,8,13,5,GK ,0,1,1,1,1,1,20,1,1,1,1,1,1,1,1,1,1,1,1,1,1,1,1,0,0,0,0,0,0,0,0,0,0,0,0,0,0,0,0,0,0,0,0,0,0,0,0,0,0,0,0,0,0,0,0,0,0,0,0,0,0,0,0,0,0,0,0,0,0,0,0,0,Ruud Boffin,Â£450Th. ,Premier League
29/6/2010,Rui Patrício,55000929,788,2/15/1988,22,0,0,10,0,4500,6750,6750,156,135,9105912,188,84,GK ,12,12,12,5,13,13,13,16,11,13,13,6,1,3,1,9,10,1,1,12,2,10,3,1,8,12,9,12,14,13,1,10,14,1,10,2,14,9,14,12,14,15,15,20,15,14,5,13,14,12,14,13,9,10,12,12,16,12,16,16,16,4,GK ,0,1,1,1,1,1,20,1,1,1,1,1,1,1,1,1,1,1,1,1,1,1,1,0,0,0,0,0,0,0,0,0,0,0,0,0,0,0,0,0,0,0,0,0,0,0,0,0,0,0,0,0,0,0,0,0,0,0,0,0,0,0,0,0,0,0,0,0,0,0,0,0,Rui PatrÃ­cio,Â£8.73m ,Liga NOS
29/6/2010,Rémy Riou,8435072,769,8/6/1987,22,0,0,7,0,1300,5550,5550,145,124,1156527,191,81,GK ,10,10,11,7,14,12,13,17,11,8,10,3,2,3,1,9,6,2,10,2,2,7,2,2,9,9,12,13,12,11,8,11,12,6,9,2,14,11,11,13,14,16,15,1,14,11,20,15,14,12,9,14,7,1,7,15,13,11,15,15,13,8,GK ,0,1,1,1,1,1,20,1,1,1,1,1,1,1,1,1,1,1,1,1,1,1,1,0,0,0,0,0,0,0,0,0,0,0,0,0,0,0,0,0,0,0,0,0,0,0,0,0,0,0,0,0,0,0,0,0,0,0,0,0,0,0,0,0,0,0,0,0,0,0,0,0,RÃ©my Riou,Â£720Th. ,Ligue 1
29/6/2010,Raúl Fernández,67018270,796,3/13/1988,22,0,0,0,0,3025,4900,4900,134,110,3460612,193,88,GK ,15,10,8,6,13,13,11,14,9,6,10,4,1,3,3,6,9,2,2,3,3,2,1,3,3,4,12,12,13,13,3,12,8,1,3,3,13,2,4,9,14,13,17,1,17,10,20,5,15,10,10,9,13,10,8,13,16,6,16,13,5,9,GK ,0,1,1,1,1,1,20,1,1,1,1,1,1,1,1,1,1,1,1,1,1,1,1,0,0,0,0,0,0,0,0,0,0,0,0,0,0,0,0,0,0,0,0,0,0,0,0,0,0,0,0,0,0,0,0,0,0,0,0,0,0,0,0,0,0,0,0,0,0,0,0,0,RaÃºl FernÃ¡ndez,Â£540Th. ,LaLiga
29/6/2010,Pedro Trigueira,744217,788,1/4/1988,22,0,0,0,0,500,1500,1500,84,80,3199,190,91,GK ,11,11,9,10,11,8,8,10,8,7,10,5,3,3,2,5,8,4,2,2,1,2,1,2,6,8,11,11,15,9,4,8,7,3,14,2,14,4,4,6,12,15,16,1,14,11,20,5,8,10,11,9,4,10,16,15,5,12,15,13,5,11,GK ,0,1,1,1,1,1,20,1,1,1,1,1,1,1,1,1,1,1,1,1,1,1,1,0,0,0,0,0,0,0,0,0,0,0,0,0,0,0,0,0,0,0,0,0,0,0,0,0,0,0,0,0,0,0,0,0,0,0,0,0,0,0,0,0,0,0,0,0,0,0,0,0,Pedro Trigueira,Â£270Th. ,Liga NOS
29/6/2010,Papa Coulibaly,34009802,41,3/2/1988,22,0,0,0,0,2800,5129,5100,140,114,1640039,194,92,GK ,16,13,12,7,10,11,14,13,12,14,13,3,1,3,2,6,7,2,3,3,3,6,1,2,6,10,12,14,10,10,6,7,13,5,8,1,10,10,12,14,12,18,17,1,15,11,20,13,18,13,8,10,6,1,11,13,14,11,11,15,15,6,GK ,0,1,1,1,1,1,20,1,1,1,1,1,1,1,1,1,1,1,1,1,1,1,1,0,0,0,0,0,0,0,0,0,0,0,0,0,0,0,0,0,0,0,0,0,0,0,0,0,0,0,0,0,0,0,0,0,0,0,0,0,0,0,0,0,0,0,0,0,0,0,0,0,Pape Coulibaly,Â£270Th. ,Ligue 1
29/6/2010,Mario,67009720,796,4/30/1988,22,0,0,0,0,3000,5000,5000,151,112,2259803,184,74,GK ,13,12,13,7,11,6,13,14,10,13,10,8,1,2,2,7,10,8,3,2,1,7,3,3,7,7,12,12,11,12,10,12,11,9,7,10,12,13,13,12,15,13,13,5,13,12,20,13,11,9,5,11,10,10,14,13,11,11,14,14,14,8,GK ,0,1,1,1,1,1,20,1,1,1,1,1,1,1,1,1,1,1,1,1,1,1,1,0,0,0,0,0,0,0,0,0,0,0,0,0,0,0,0,0,0,0,0,0,0,0,0,0,0,0,0,0,0,0,0,0,0,0,0,0,0,0,0,0,0,0,0,0,0,0,0,0,Marinho,Â£1.17m ,Liga NOS
29/6/2010,Kévin Olimpa,8440946,769,3/10/1988,22,0,0,6,0,3364,5200,5200,142,116,4870465,186,81,GK ,14,11,13,9,12,6,15,14,11,8,6,4,1,3,1,7,6,3,2,3,2,7,2,3,7,9,12,15,14,13,7,12,15,5,10,3,12,11,13,13,12,14,13,1,13,9,20,13,14,13,9,14,8,1,5,17,14,11,10,12,12,13,GK ,0,1,1,1,1,1,20,1,1,1,1,1,1,1,1,1,1,1,1,1,1,1,1,0,0,0,0,0,0,0,0,0,0,0,0,0,0,0,0,0,0,0,0,0,0,0,0,0,0,0,0,0,0,0,0,0,0,0,0,0,0,0,0,0,0,0,0,0,0,0,0,0,KÃ©vin Olimpa,Â£855Th. ,Ligue 1
29/6/2010,Juan Carlos,1503797,796,7/27/1987,22,0,0,0,0,3422,5850,5850,137,117,3188177,180,78,GK ,9,11,10,12,12,11,17,15,13,10,12,3,3,1,2,8,6,6,1,1,3,10,3,2,8,8,12,11,12,10,6,11,7,4,10,2,13,13,12,12,15,11,10,9,13,13,20,12,11,14,7,14,4,10,10,12,1,10,10,9,13,14,GK ,0,1,1,1,1,1,20,1,1,1,1,1,1,1,1,1,1,1,1,1,1,1,1,0,0,0,0,0,0,0,0,0,0,0,0,0,0,0,0,0,0,0,0,0,0,0,0,0,0,0,0,0,0,0,0,0,0,0,0,0,0,0,0,0,0,0,0,0,0,0,0,0,Juan Carlos,Â£900Th. ,LaLiga
29/6/2010,Johann Carrasso,34008686,769,5/7/1988,22,0,0,3,0,4032,5700,5700,155,127,3365097,188,82,GK ,14,14,13,5,14,8,13,15,11,12,8,3,2,1,2,7,7,1,2,1,3,7,3,2,7,11,14,14,14,14,7,13,14,6,11,3,12,11,8,11,13,14,14,1,15,9,20,12,14,14,11,15,7,1,10,15,13,12,14,14,14,6,GK ,0,1,1,1,1,1,20,1,1,1,1,1,1,1,1,1,1,1,1,1,1,1,1,0,0,0,0,0,0,0,0,0,0,0,0,0,0,0,0,0,0,0,0,0,0,0,0,0,0,0,0,0,0,0,0,0,0,0,0,0,0,0,0,0,0,0,0,0,0,0,0,0,Johann Carrasso,Â£900Th. ,Ligue 1
29/6/2010,Hugo Ventura,55004190,788,1/14/1988,22,0,0,14,0,1500,5000,5000,133,104,215839,185,79,GK ,13,12,13,5,13,11,12,13,13,10,13,5,1,3,3,5,10,1,2,1,3,1,1,1,9,11,11,13,11,10,1,14,14,3,1,2,13,3,9,11,13,13,11,8,10,10,20,3,4,10,7,9,8,10,12,11,15,13,14,14,15,5,GK ,0,1,1,1,1,1,20,1,1,1,1,1,1,1,1,1,1,1,1,1,1,1,1,0,0,0,0,0,0,0,0,0,0,0,0,0,0,0,0,0,0,0,0,0,0,0,0,0,0,0,0,0,0,0,0,0,0,0,0,0,0,0,0,0,0,0,0,0,0,0,0,0,Hugo Ventura,Â£810Th. ,Liga NOS
29/6/2010,Gonzalo,67030694,796,1/10/1988,22,0,0,0,0,1122,3100,3100,102,67,100810,187,81,GK ,11,12,2,6,12,11,6,12,11,4,10,1,3,2,2,0,4,1,3,2,3,1,1,2,4,7,6,15,7,12,1,9,16,1,12,1,10,0,9,11,11,12,10,5,12,7,20,0,5,10,9,10,14,10,8,14,13,9,6,15,12,10,GK ,0,1,1,1,1,1,20,1,1,1,1,1,1,1,1,1,1,1,1,1,1,1,1,0,0,0,0,0,0,0,0,0,0,0,0,0,0,0,0,0,0,0,0,0,0,0,0,0,0,0,0,0,0,0,0,0,0,0,0,0,0,0,0,0,0,0,0,0,0,0,0,0,Gonzalo, ,LaLiga
29/6/2010,Felipe,67011244,796,1/10/1988,22,0,0,0,0,1806,4250,4250,128,85,1154913,187,86,GK ,14,8,6,5,11,7,14,16,10,9,8,2,3,3,2,3,5,2,3,3,1,2,2,1,6,14,10,14,6,7,6,7,10,13,11,10,7,8,9,13,16,6,13,6,13,10,20,9,14,6,5,10,7,10,11,4,11,6,8,5,13,11,GK ,0,1,1,1,1,1,20,1,1,1,1,1,1,1,1,1,1,1,1,1,1,1,1,0,0,0,0,0,0,0,0,0,0,0,0,0,0,0,0,0,0,0,0,0,0,0,0,0,0,0,0,0,0,0,0,0,0,0,0,0,0,0,0,0,0,0,0,0,0,0,0,0,Felipe,Â£3.33m ,Serie A
29/6/2010,Andreas Rössl,92019046,771,2/20/1988,22,0,0,0,0,750,4450,4450,116,99,907511,190,84,GK ,11,11,9,10,13,10,12,13,13,9,11,7,3,1,1,6,10,1,3,3,3,2,3,2,7,8,11,11,10,11,8,11,10,2,7,2,13,13,11,10,11,10,12,3,15,10,20,11,11,7,6,10,3,10,13,11,13,5,12,7,3,9,GK ,0,1,1,1,1,1,20,1,1,1,1,1,1,1,1,1,1,1,1,1,1,1,1,0,0,0,0,0,0,0,0,0,0,0,0,0,0,0,0,0,0,0,0,0,0,0,0,0,0,0,0,0,0,0,0,0,0,0,0,0,0,0,0,0,0,0,0,0,0,0,0,0,Andreas RÃ¶ssl,Â£113Th. ,Bundesliga
29/6/2010,Wayne Hennessey,5006568,801,1/24/1987,23,25,0,6,0,3750,6750,6150,155,128,8442415,196,73,GK ,15,11,12,4,15,16,12,15,13,15,12,4,3,1,3,7,8,1,2,3,2,3,3,3,6,12,13,12,9,14,7,12,12,1,8,6,11,10,9,10,13,10,14,17,13,8,20,11,15,13,8,13,7,10,10,12,15,14,14,11,15,6,GK ,0,1,1,1,1,1,20,1,1,1,1,1,1,1,1,1,1,1,1,1,1,1,1,0,0,0,0,0,0,0,0,0,0,0,0,0,0,0,0,0,0,0,0,0,0,0,0,0,0,0,0,0,0,0,0,0,0,0,0,0,0,0,0,0,0,0,0,0,0,0,0,0,Wayne Hennessey,Â£1.80m ,Premier League
29/6/2010,Vicente Guaita,1510602,796,1/10/1987,23,0,0,0,0,3900,5900,5900,140,125,5914039,190,80,GK ,15,14,13,5,14,13,12,15,15,9,14,3,3,3,3,6,8,8,2,2,3,8,1,2,7,6,10,12,7,13,2,11,10,3,7,2,14,11,9,6,13,12,15,8,13,7,20,13,12,13,4,11,6,10,14,14,12,13,9,14,11,9,GK ,0,1,1,1,1,1,20,1,1,1,1,1,1,1,1,1,1,1,1,1,1,1,1,0,0,0,0,0,0,0,0,0,0,0,0,0,0,0,0,0,0,0,0,0,0,0,0,0,0,0,0,0,0,0,0,0,0,0,0,0,0,0,0,0,0,0,0,0,0,0,0,0,Vicente Guaita,Â£2.25m ,LaLiga
29/6/2010,Stéphane Ruffier,8428608,769,9/27/1986,23,0,0,4,0,2900,6524,6500,160,145,15209170,187,89,GK ,14,15,13,9,14,9,15,17,13,12,8,6,2,1,2,7,10,3,3,1,2,6,1,3,7,9,14,17,13,13,8,13,16,6,12,1,12,12,13,14,14,16,13,1,16,12,20,8,16,14,9,16,5,1,12,16,14,14,15,15,12,9,GK ,0,5,1,5,1,1,20,1,1,1,1,1,1,1,1,1,1,1,1,1,1,1,1,0,0,0,0,0,0,0,0,0,0,0,0,0,0,0,0,0,0,0,0,0,0,0,0,0,0,0,0,0,0,0,0,0,0,0,0,0,0,0,0,0,0,0,0,0,0,0,0,0,StÃ©phane Ruffier,Â£7.20m ,Ligue 1
29/6/2010,Salvatore Sirigu,1401013,776,1/12/1987,23,0,0,4,0,4500,7250,7250,170,150,27902234,190,80,GK ,14,14,13,2,17,12,12,16,9,11,12,1,1,6,1,5,5,4,5,6,8,8,5,7,13,10,12,15,13,15,11,14,15,11,13,3,13,16,17,11,14,12,15,5,13,12,20,14,14,17,8,15,7,5,15,18,15,14,16,16,13,2,GK ,0,1,1,1,1,1,20,1,1,1,1,1,1,1,1,1,1,1,1,1,1,1,1,0,0,0,0,0,0,0,0,0,0,0,0,0,0,0,0,0,0,0,0,0,0,0,0,0,0,0,0,0,0,0,0,0,0,0,0,0,0,0,0,0,0,0,0,0,0,0,0,0,Salvatore Sirigu,Â£9.00m ,Serie A
29/6/2010,Ricardo Batista,744635,788,11/19/1986,23,0,0,10,0,2756,5000,5000,125,105,132625,193,79,GK ,11,12,8,10,12,14,12,14,15,11,10,3,1,2,2,4,4,1,18,2,3,3,1,2,5,6,12,12,11,14,2,14,13,2,7,3,14,2,8,11,14,14,16,20,15,12,5,6,7,10,12,10,8,10,12,12,15,13,15,12,10,5,GK ,0,1,1,1,1,1,20,1,1,1,1,1,1,1,1,1,1,1,1,1,1,1,1,0,0,0,0,0,0,0,0,0,0,0,0,0,0,0,0,0,0,0,0,0,0,0,0,0,0,0,0,0,0,0,0,0,0,0,0,0,0,0,0,0,0,0,0,0,0,0,0,0,Ricardo Batista,Â£450Th. ,Liga NOS
29/6/2010,Raúl,67062728,796,11/1/1986,23,0,0,0,0,1806,3500,3500,110,85,164058,179,74,GK ,12,8,12,5,12,11,12,12,6,4,6,1,2,2,2,1,5,1,1,1,2,0,3,2,1,9,7,11,8,12,1,12,8,3,7,1,12,1,1,12,12,8,8,10,10,8,20,2,9,9,7,10,8,10,13,17,13,9,15,15,11,7,GK ,0,1,1,1,1,1,20,1,1,1,1,1,1,1,1,1,1,1,1,1,1,1,1,0,0,0,0,0,0,0,0,0,0,0,0,0,0,0,0,0,0,0,0,0,0,0,0,0,0,0,0,0,0,0,0,0,0,0,0,0,0,0,0,0,0,0,0,0,0,0,0,0,,,
29/6/2010,Piet Velthuizen,859867,784,11/3/1986,23,1,0,0,0,4422,6500,6500,157,133,4979314,189,86,GK ,10,12,13,12,13,13,13,16,13,10,14,5,3,1,1,12,10,5,2,1,3,7,3,3,10,14,12,14,14,13,2,14,19,3,12,2,14,12,12,9,13,14,11,1,14,11,20,13,15,7,8,10,14,10,11,18,7,7,6,12,6,12,GK ,0,1,1,1,1,1,20,1,1,1,1,1,1,1,1,1,1,1,1,1,1,1,1,0,0,0,0,0,0,0,0,0,0,0,0,0,0,0,0,0,0,0,0,0,0,0,0,0,0,0,0,0,0,0,0,0,0,0,0,0,0,0,0,0,0,0,0,0,0,0,0,0,Piet Velthuizen,Â£1.80m ,LaLiga
29/6/2010,Oscar Ustari,956657,1649,7/3/1986,23,1,0,0,0,4422,6500,6500,160,133,4499998,184,82,GK ,12,14,13,8,11,10,15,15,13,4,15,2,2,2,1,7,1,3,1,9,4,8,13,4,6,13,15,14,15,11,13,11,14,6,12,1,12,13,14,15,16,12,14,4,15,14,20,13,13,9,4,14,10,1,14,15,15,14,16,18,15,9,GK ,0,1,1,1,1,1,20,1,1,1,1,1,1,1,1,1,1,1,1,1,1,1,1,0,0,0,0,0,0,0,0,0,0,0,0,0,0,0,0,0,0,0,0,0,0,0,0,0,0,0,0,0,0,0,0,0,0,0,0,0,0,0,0,0,0,0,0,0,0,0,0,0,Ãscar Ustari,Â£1.62m ,LaLiga
29/6/2010,Mário Felgueiras,744542,788,12/12/1986,23,0,0,1,0,500,5000,5000,128,100,51185,184,78,GK ,13,13,12,6,12,12,14,15,12,8,12,1,2,3,2,3,5,1,2,3,2,0,2,1,6,3,9,13,9,13,1,13,9,2,14,2,9,0,3,12,9,11,11,8,5,8,20,2,3,10,7,10,14,10,12,10,15,13,9,11,6,7,GK ,0,1,1,1,1,1,20,1,1,1,1,1,1,1,1,1,1,1,1,1,1,1,1,0,0,0,0,0,0,0,0,0,0,0,0,0,0,0,0,0,0,0,0,0,0,0,0,0,0,0,0,0,0,0,0,0,0,0,0,0,0,0,0,0,0,0,0,0,0,0,0,0,MÃ¡rio Felgueiras,Â£810Th. ,Liga NOS
29/6/2010,Marco Knaller,5607306,755,3/26/1987,23,0,0,4,0,1100,5400,5400,132,108,3485483,192,88,GK ,10,12,11,11,13,10,13,14,11,12,8,4,1,1,3,7,7,0,3,1,3,1,1,3,2,7,10,14,11,13,1,13,12,2,11,3,13,0,6,13,14,12,12,5,17,10,20,2,3,10,3,9,6,10,12,12,10,12,13,11,10,10,GK ,0,1,1,1,1,1,20,1,1,1,1,1,1,1,1,1,1,1,1,1,1,1,1,0,0,0,0,0,0,0,0,0,0,0,0,0,0,0,0,0,0,0,0,0,0,0,0,0,0,0,0,0,0,0,0,0,0,0,0,0,0,0,0,0,0,0,0,0,0,0,0,0,Marco Knaller,Â£135Th. ,Bundesliga
29/6/2010,Marafona,55002111,788,5/8/1987,23,0,0,0,0,1000,4500,4500,122,97,704001,188,80,GK ,11,11,13,7,12,14,12,13,12,13,12,7,1,1,2,5,10,3,3,3,3,2,1,3,9,9,11,14,14,8,3,12,9,3,12,1,14,3,4,8,10,11,16,20,12,8,5,3,8,10,12,10,11,10,14,13,13,11,14,14,14,7,GK ,0,1,1,1,1,1,20,1,1,1,1,1,1,1,1,1,1,1,1,1,1,1,1,0,0,0,0,0,0,0,0,0,0,0,0,0,0,0,0,0,0,0,0,0,0,0,0,0,0,0,0,0,0,0,0,0,0,0,0,0,0,0,0,0,0,0,0,0,0,0,0,0,Marafona,Â£360Th. ,Liga NOS
29/6/2010,Júlio César,2107808,1651,9/2/1986,23,0,0,0,0,2500,6500,6500,145,129,3005678,192,85,GK ,14,14,14,4,14,14,13,17,15,10,14,1,3,2,3,3,3,2,2,1,3,1,1,3,5,6,12,12,14,14,1,14,17,2,15,3,10,10,15,9,12,9,16,12,12,10,20,10,8,15,9,13,10,10,15,13,14,11,14,14,12,11,GK ,0,1,1,1,1,1,20,1,1,1,1,1,1,1,1,1,1,1,1,1,1,1,1,0,0,0,0,0,0,0,0,0,0,0,0,0,0,0,0,0,0,0,0,0,0,0,0,0,0,0,0,0,0,0,0,0,0,0,0,0,0,0,0,0,0,0,0,0,0,0,0,0,JÃºlio CÃ©sar,Â£17.10m ,Serie A
29/6/2010,Joe Hart,5119142,765,4/19/1987,23,3,0,21,0,5476,7900,7900,170,148,22146495,191,81,GK ,16,15,15,14,15,14,15,17,15,18,13,5,2,1,3,10,8,7,3,3,2,8,13,2,7,10,10,13,9,13,3,13,16,4,8,2,12,12,11,10,15,12,16,10,13,7,20,15,12,14,4,13,7,10,5,14,12,18,12,7,15,5,GK ,0,1,1,1,1,1,20,1,1,1,1,1,1,1,1,1,1,1,1,1,1,1,1,65536,0,0,0,0,0,0,0,0,0,0,0,0,0,0,0,0,1,0,0,0,0,0,0,0,0,0,0,0,0,0,0,0,0,0,0,0,0,0,0,0,0,0,0,0,0,0,0,0,Joe Hart,Â£13.50m ,Premier League
29/6/2010,Ignacio Zabal,1512304,796,2/14/1987,23,0,0,0,0,2025,4500,4500,115,90,413235,194,89,GK ,14,10,10,9,11,10,11,13,12,9,10,6,2,1,2,8,10,1,3,2,3,2,2,2,9,14,10,9,10,8,10,8,10,6,8,10,9,15,15,10,13,10,17,5,13,8,20,14,13,12,6,12,7,10,18,12,9,10,14,9,14,9,GK ,0,1,1,1,1,1,20,1,1,1,1,1,1,1,1,1,1,1,1,1,1,1,1,0,0,0,0,0,0,0,0,0,0,0,0,0,0,0,0,0,0,0,0,0,0,0,0,0,0,0,0,0,0,0,0,0,0,0,0,0,0,0,0,0,0,0,0,0,0,0,0,0,Nacho Zabal,Â£90Th. ,LaLiga
29/6/2010,Hugo Lloris,8428653,769,12/26/1986,23,14,0,9,0,6850,7650,7650,185,170,34293111,188,78,GK ,16,15,12,7,17,12,14,18,16,12,12,5,3,3,2,8,10,2,10,1,3,8,1,8,8,10,14,17,15,15,11,14,15,6,12,1,15,14,12,14,16,15,14,20,15,13,8,15,13,17,10,15,6,1,12,15,15,18,17,18,18,4,GK ,0,1,1,1,1,1,20,1,1,1,1,1,1,1,1,1,1,1,1,1,1,1,1,0,0,0,0,0,0,0,0,0,0,0,0,0,0,0,0,0,0,0,0,0,0,0,0,0,0,0,0,0,0,0,0,0,0,0,0,0,0,0,0,0,0,0,0,0,0,0,0,0,Hugo Lloris,Â£15.30m ,Ligue 1
29/6/2010,Gerardo,1510984,796,5/17/1987,23,0,0,0,0,1200,3700,3700,101,80,576893,192,90,GK ,14,11,9,9,11,8,8,10,9,7,9,6,2,1,1,5,9,2,2,2,2,2,3,2,4,9,8,11,9,9,2,11,9,11,8,3,14,3,4,11,9,8,12,10,18,7,20,5,8,10,14,12,17,9,13,15,14,7,15,7,5,12,GK ,0,1,1,1,1,1,20,1,1,1,1,1,1,1,1,1,1,1,1,1,1,1,1,0,0,0,0,0,0,0,0,0,0,0,0,0,0,0,0,0,0,0,0,0,0,0,0,0,0,0,0,0,0,0,0,0,0,0,0,0,0,0,0,0,0,0,0,0,0,0,0,0,,,
29/6/2010,Florian Fromlowitz,894121,771,7/2/1986,23,0,0,12,0,2750,6400,6400,150,128,1542027,187,77,GK ,11,11,11,10,14,12,15,16,11,6,12,6,2,3,3,7,10,6,2,2,1,7,2,1,7,11,10,14,12,13,8,11,13,5,12,2,12,13,12,9,14,12,13,7,14,9,20,12,15,15,2,12,9,10,11,15,15,11,14,12,11,12,GK ,0,1,1,1,1,1,20,1,1,1,1,1,1,1,1,1,1,1,1,1,1,1,1,0,0,0,0,0,0,0,0,0,0,0,0,0,0,0,0,0,0,0,0,0,0,0,0,0,0,0,0,0,0,0,0,0,0,0,0,0,0,0,0,0,0,0,0,0,0,0,0,0,Florian Fromlowitz,Â£1.58m ,Bundesliga
29/6/2010,Elisson,2111964,1651,3/26/1987,23,0,0,0,0,750,4350,4350,130,107,20050,186,88,GK ,11,12,10,1,11,11,12,11,13,1,11,8,3,1,1,4,10,0,1,1,2,9,2,3,9,6,10,12,10,11,4,10,7,2,11,2,11,9,9,10,12,13,14,11,12,10,20,11,13,10,10,10,12,10,7,5,8,10,13,1,11,12,GK ,0,1,1,1,1,1,20,1,1,1,1,1,1,1,1,1,1,1,1,1,1,1,1,0,0,0,0,0,0,0,0,0,0,0,0,0,0,0,0,0,0,0,0,0,0,0,0,0,0,0,0,0,0,0,0,0,0,0,0,0,0,0,0,0,0,0,0,0,0,0,0,0,Elisson,Â£270Th. ,Liga NOS
29/6/2010,Dominik Poremba,35007207,771,2/14/1987,23,0,0,0,0,500,3750,3750,100,80,234881,188,85,GK ,12,12,12,12,9,12,8,12,14,13,8,7,1,1,2,1,10,0,2,2,1,1,2,1,4,11,7,12,6,12,0,9,9,1,13,2,12,0,1,12,10,9,13,3,13,8,20,4,4,10,10,9,10,10,8,13,8,12,16,16,7,14,GK ,0,1,1,1,1,1,20,1,1,1,1,1,1,1,1,1,1,1,1,1,1,1,1,0,0,0,0,0,0,0,0,0,0,0,0,0,0,0,0,0,0,0,0,0,0,0,0,0,0,0,0,0,0,0,0,0,0,0,0,0,0,0,0,0,0,0,0,0,0,0,0,0,,,
29/6/2010,Davide Petrachi,7990028,776,8/14/1986,23,0,0,0,0,100,4900,4900,130,105,1687493,184,83,GK ,10,8,9,5,13,8,10,15,7,13,10,6,3,1,1,3,8,1,1,3,3,2,3,1,5,8,9,11,13,12,1,13,13,2,7,3,13,10,13,11,14,13,13,7,12,12,20,8,9,10,10,11,13,10,11,13,16,14,15,14,14,4,GK ,0,1,1,1,1,1,20,1,1,1,1,1,1,1,1,1,1,1,1,1,1,1,1,0,0,0,0,0,0,0,0,0,0,0,0,0,0,0,0,0,0,0,0,0,0,0,0,0,0,0,0,0,0,0,0,0,0,0,0,0,0,0,0,0,0,0,0,0,0,0,0,0,Davide Petrachi,Â£45Th. ,Serie A
29/6/2010,Barroca,55014453,788,7/29/1986,23,0,0,0,0,750,1500,1500,93,85,2201,186,82,GK ,13,8,13,7,13,8,12,13,9,13,8,2,1,2,3,3,6,0,1,3,1,2,3,2,2,10,9,9,9,13,2,13,8,3,1,3,9,0,3,4,10,12,12,5,13,7,20,3,5,10,9,10,10,10,13,1,13,12,15,11,5,11,GK ,0,1,1,1,1,1,20,1,1,1,1,1,1,1,1,1,1,1,1,1,1,1,1,0,0,0,0,0,0,0,0,0,0,0,0,0,0,0,0,0,0,0,0,0,0,0,0,0,0,0,0,0,0,0,0,0,0,0,0,0,0,0,0,0,0,0,0,0,0,0,0,0,,,
29/6/2010,Asmir Begovic,5123112,759,6/20/1987,23,3,0,0,0,4422,6200,6500,177,133,12537953,196,84,GK ,15,13,14,10,14,14,13,16,13,8,11,5,3,3,3,11,10,1,1,2,2,14,12,1,9,12,10,14,11,11,13,11,14,7,12,2,11,10,9,10,12,8,20,7,15,10,20,12,14,12,8,14,3,10,12,11,8,8,8,9,10,12,GK ,0,1,1,1,1,1,20,1,1,1,1,1,1,1,1,1,1,1,1,1,1,1,1,0,0,0,0,0,0,0,0,0,0,0,0,0,0,0,0,0,0,0,0,0,0,0,0,0,0,0,0,0,0,0,0,0,0,0,0,0,0,0,0,0,0,0,0,0,0,0,0,0,Asmir Begovic,Â£3.15m ,Premier League
29/6/2010,Antonio Adán,7458290,796,5/13/1987,23,0,0,1,0,3422,5750,5750,144,117,5638032,191,88,GK ,11,12,13,6,13,11,12,17,10,10,11,2,1,1,1,7,6,4,1,1,1,9,2,3,6,10,10,13,10,10,3,10,13,4,8,2,13,7,8,9,13,14,15,20,13,10,7,13,16,16,6,12,12,10,10,13,15,8,13,11,12,5,GK ,0,1,1,1,1,1,20,1,1,1,1,1,1,1,1,1,1,1,1,1,1,1,1,0,0,0,0,0,0,0,0,0,0,0,0,0,0,0,0,0,0,0,0,0,0,0,0,0,0,0,0,0,0,0,0,0,0,0,0,0,0,0,0,0,0,0,0,0,0,0,0,0,Antonio AdÃ¡n,Â£450Th. ,LaLiga
29/6/2010,Alexander Stephan,8707687,771,9/15/1986,23,0,0,0,0,1250,5000,5000,125,105,3891342,189,77,GK ,10,9,12,13,12,13,11,11,11,10,13,2,1,1,1,12,6,10,2,3,1,11,3,3,10,5,10,10,9,14,3,14,5,3,11,1,14,1,3,13,13,14,16,6,9,12,20,3,7,10,10,10,13,10,9,18,9,3,13,8,10,9,GK ,0,1,1,1,1,1,20,1,1,1,1,1,1,1,1,1,1,1,1,1,1,1,1,0,0,0,0,0,0,0,0,0,0,0,0,0,0,0,0,0,0,0,0,0,0,0,0,0,0,0,0,0,0,0,0,0,0,0,0,0,0,0,0,0,0,0,0,0,0,0,0,0,Alexander Stephan,Â£360Th. ,Bundesliga
29/6/2010,Tomas Kosicky,7563766,794,3/11/1986,24,0,0,3,0,2000,5000,5000,128,108,1986546,197,93,GK ,8,12,11,8,12,14,11,15,8,11,14,1,1,1,1,5,1,5,1,1,1,5,1,1,5,5,12,10,10,11,10,12,11,5,11,5,13,10,7,9,11,13,19,5,14,8,20,12,14,11,5,10,5,1,12,11,13,10,14,14,14,4,GK ,0,1,1,1,1,1,20,1,1,1,1,1,1,1,1,1,1,1,1,1,1,1,1,0,0,0,0,0,0,0,0,0,0,0,0,0,0,0,0,0,0,0,0,0,0,0,0,0,0,0,0,0,0,0,0,0,0,0,0,0,0,0,0,0,0,0,0,0,0,0,0,0,Tomas Kosicky,Â£270Th. ,Serie A
29/6/2010,Thomas Kessler,894120,771,1/20/1986,24,0,0,0,0,2500,5850,5850,130,117,2482513,197,92,GK ,14,9,12,4,13,14,15,15,7,12,14,3,1,2,2,5,6,3,2,1,3,6,2,1,10,7,12,12,10,12,4,11,10,3,8,1,13,14,10,10,10,14,16,6,15,12,20,13,16,8,5,10,13,10,7,7,14,11,7,5,14,4,GK ,0,1,1,1,1,1,20,1,1,1,1,1,1,1,1,1,1,1,1,1,1,1,1,0,0,0,0,0,0,0,0,0,0,0,0,0,0,0,0,0,0,0,0,0,0,0,0,0,0,0,0,0,0,0,0,0,0,0,0,0,0,0,0,0,0,0,0,0,0,0,0,0,Thomas Kessler,Â£1.80m ,Bundesliga
29/6/2010,Scott Carson,5109668,765,9/3/1985,24,3,0,29,0,4356,6600,6600,135,132,10060587,183,86,GK ,12,9,9,3,12,14,14,15,10,12,14,6,3,3,1,11,10,2,1,2,2,8,1,3,12,10,12,13,11,15,8,12,14,2,14,1,13,12,14,9,15,14,12,10,14,10,20,16,17,15,5,18,4,10,13,15,15,8,15,12,10,6,GK ,0,1,1,1,1,1,20,1,1,1,1,1,1,1,1,1,1,1,1,1,1,1,1,0,0,0,0,0,0,0,0,0,0,0,0,0,0,0,0,0,0,0,0,0,0,0,0,0,0,0,0,0,0,0,0,0,0,0,0,0,0,0,0,0,0,0,0,0,0,0,0,0,Scott Carson,Â£3.15m ,Premier League
29/6/2010,Roberto,1510293,796,2/10/1986,24,0,0,6,0,4000,5650,5650,146,131,29316093,191,76,GK ,11,10,11,4,12,12,13,16,9,13,14,6,2,3,2,5,10,5,1,3,2,6,3,1,3,8,11,13,12,15,5,10,14,4,9,2,13,11,10,7,15,14,16,5,12,8,20,12,14,13,6,12,5,10,10,14,8,9,16,16,14,6,GK ,0,1,1,1,1,1,20,1,1,1,1,1,1,1,1,1,1,1,1,1,1,1,1,0,0,0,0,0,0,0,0,0,0,0,0,0,0,0,0,0,0,0,0,0,0,0,0,0,0,0,0,0,0,0,0,0,0,0,0,0,0,0,0,0,0,0,0,0,0,0,0,0,Roberto,Â£5.04m ,Liga NOS
29/6/2010,Maximilian Sachse,35023603,771,5/28/1986,24,0,0,0,0,250,3250,3250,75,65,146853,186,85,GK ,12,7,11,11,12,11,10,12,13,13,5,3,1,2,1,0,5,0,1,1,2,1,2,1,2,12,10,9,5,10,0,12,9,1,12,1,9,1,2,10,10,8,12,9,15,7,20,5,7,10,14,10,7,9,12,18,17,5,9,13,9,9,GK ,0,1,1,1,1,1,20,1,1,1,1,1,1,1,1,1,1,1,1,1,1,1,1,0,0,0,0,0,0,0,0,0,0,0,0,0,0,0,0,0,0,0,0,0,0,0,0,0,0,0,0,0,0,0,0,0,0,0,0,0,0,0,0,0,0,0,0,0,0,0,0,0,Maximilian Nicu,Â£900Th. ,Bundesliga
29/6/2010,Manuel Salz,8721529,771,8/6/1985,24,0,0,0,0,750,4500,4500,123,103,930716,185,78,GK ,10,9,5,6,12,10,8,13,12,8,14,5,3,2,1,11,9,13,3,1,3,14,2,3,13,10,9,14,10,11,8,11,10,8,9,11,12,12,11,12,14,11,13,12,11,12,20,11,13,9,6,10,15,10,10,13,9,8,8,12,11,6,GK ,0,1,1,1,1,1,20,1,1,1,1,1,1,1,1,1,1,1,1,1,1,1,1,0,0,0,0,0,0,0,0,0,0,0,0,0,0,0,0,0,0,0,0,0,0,0,0,0,0,0,0,0,0,0,0,0,0,0,0,0,0,0,0,0,0,0,0,0,0,0,0,0,Manuel Salz,Â£180Th. ,Bundesliga
29/6/2010,Manuel Neuer,8718372,771,3/27/1986,24,11,0,20,0,6150,8200,8200,183,165,30751691,192,90,GK ,15,18,9,9,10,19,17,16,18,8,20,7,3,3,2,12,10,8,2,2,2,12,1,2,11,10,18,16,13,10,10,10,15,8,12,2,16,17,12,15,14,16,18,14,12,10,20,12,16,14,9,17,8,10,6,10,18,15,13,9,14,12,GK ,0,1,1,1,1,1,20,1,1,1,1,1,1,1,1,1,1,1,1,1,1,1,1,0,0,0,0,0,0,0,0,0,0,0,0,0,0,0,0,0,0,0,0,0,0,0,0,0,0,0,0,0,0,0,0,0,0,0,0,0,0,0,0,0,0,0,0,0,0,0,0,0,Manuel Neuer,Â£25.20m ,Bundesliga
29/6/2010,Manu,7458356,796,5/9/1986,24,0,0,0,0,3600,6000,6000,132,120,1205543,182,72,GK ,8,15,8,4,15,15,13,15,4,17,11,2,3,1,3,4,5,4,2,1,3,4,2,2,8,6,11,14,13,13,2,14,9,3,6,3,15,2,5,15,12,12,13,12,12,14,20,9,10,10,12,10,11,10,6,17,6,11,9,12,11,8,GK ,0,1,1,1,1,1,20,1,1,1,1,1,1,1,1,1,1,1,1,1,1,1,1,0,0,0,0,0,0,0,0,0,0,0,0,0,0,0,0,0,0,0,0,0,0,0,0,0,0,0,0,0,0,0,0,0,0,0,0,0,0,0,0,0,0,0,0,0,0,0,0,0,Kanu,Â£1.80m ,Liga NOS
29/6/2010,Logan Bailly,537851,757,12/27/1985,24,3,0,8,0,3900,6500,6950,159,139,14474096,190,85,GK ,10,18,9,17,12,18,14,17,11,7,18,5,1,1,2,14,9,12,3,3,2,12,2,2,13,13,10,17,7,8,7,7,10,18,10,1,8,10,10,15,16,12,16,20,15,12,10,10,18,12,13,20,13,10,14,18,12,19,3,12,7,12,GK ,0,1,1,1,1,1,20,1,1,1,1,1,1,1,1,1,1,1,1,1,1,1,1,2.19902E+12,0,0,0,0,0,0,0,0,0,0,0,0,0,0,0,0,0,0,0,0,0,0,0,0,0,0,0,0,0,0,0,0,0,0,0,0,0,0,0,0,0,1,0,0,0,0,0,0,Logan Bailly,Â£900Th. ,Bundesliga
29/6/2010,Jessy Moulin,919617,769,1/13/1986,24,0,0,0,0,1350,3250,3250,135,110,3778149,184,80,GK ,14,12,14,9,12,13,11,15,11,10,8,7,1,1,2,7,9,1,1,2,1,6,3,1,7,11,9,13,13,13,6,11,8,6,12,2,10,11,11,7,9,14,12,1,14,8,20,8,14,15,11,15,5,10,19,12,5,10,13,15,15,6,GK ,0,1,1,1,1,1,20,1,1,1,1,1,1,1,1,1,1,1,1,1,1,1,1,0,0,0,0,0,0,0,0,0,0,0,0,0,0,0,0,0,0,0,0,0,0,0,0,0,0,0,0,0,0,0,0,0,0,0,0,0,0,0,0,0,0,0,0,0,0,0,0,0,Jessy Moulin,Â£135Th. ,Ligue 1
29/6/2010,Jean-Louis Leca,8431708,769,9/21/1985,24,0,0,0,0,3306,5150,5150,125,115,905214,180,75,GK ,10,13,13,9,12,9,12,14,15,14,7,3,2,3,2,7,8,2,1,3,1,7,1,3,7,8,12,14,13,12,7,12,14,5,12,1,13,13,13,13,14,13,10,1,14,11,20,12,12,13,8,14,6,1,8,13,14,13,16,14,14,5,GK ,0,1,1,1,1,1,20,1,1,1,1,1,1,1,1,1,1,1,1,1,1,1,1,0,0,0,0,0,0,0,0,0,0,0,0,0,0,0,0,0,0,0,0,0,0,0,0,0,0,0,0,0,0,0,0,0,0,0,0,0,0,0,0,0,0,0,0,0,0,0,0,0,Jean-Louis Leca,Â£270Th. ,Ligue 1
29/6/2010,Gianluca Curci,7982788,776,7/12/1985,24,0,0,21,0,4500,6550,6550,159,138,3881111,191,90,GK ,16,11,9,8,15,12,17,17,12,15,14,1,1,1,1,1,1,3,8,1,1,12,1,9,14,7,14,14,12,10,12,10,12,5,6,1,15,12,14,10,15,14,16,5,14,10,20,13,14,12,1,12,4,1,7,10,15,12,16,15,18,2,GK ,0,1,1,1,1,1,20,1,1,1,1,1,1,1,1,1,1,1,1,1,1,1,1,0,0,0,0,0,0,0,0,0,0,0,0,0,0,0,0,0,0,0,0,0,0,0,0,0,0,0,0,0,0,0,0,0,0,0,0,0,0,0,0,0,0,0,0,0,0,0,0,0,Gianluca Curci,Â£6.75m ,Serie A
29/6/2010,Geoffrey Jourdren,918869,769,2/4/1986,24,0,0,8,0,1400,6050,6050,148,135,7459709,181,73,GK ,12,12,12,9,13,12,14,17,14,13,8,7,1,1,1,9,10,2,2,2,1,7,1,1,9,9,14,15,11,14,7,12,16,7,10,3,13,12,11,15,16,13,10,1,16,12,20,15,12,14,9,16,7,1,14,14,15,17,13,13,13,5,GK ,0,1,1,1,1,1,20,1,1,1,1,1,1,1,1,1,1,1,1,1,1,1,1,0,0,0,0,0,0,0,0,0,0,0,0,0,0,0,0,0,0,0,0,0,0,0,0,0,0,0,0,0,0,0,0,0,0,0,0,0,0,0,0,0,0,0,0,0,0,0,0,0,Geoffrey Jourdren,Â£3.24m ,Ligue 1
29/6/2010,Fernando Muslera,78001113,1657,6/16/1986,24,13,0,10,0,5402,7000,6800,162,147,13029832,190,77,GK ,13,14,13,4,15,12,14,15,12,16,14,5,1,1,2,8,10,8,1,2,2,7,1,3,13,8,13,13,13,11,8,13,16,5,12,3,12,12,12,14,15,14,16,10,14,12,20,15,13,11,4,13,7,10,10,13,12,11,14,14,12,4,GK ,0,1,1,1,1,1,20,1,1,1,1,1,1,1,1,1,1,1,1,1,1,1,1,0,0,0,0,0,0,0,0,0,0,0,0,0,0,0,0,0,0,0,0,0,0,0,0,0,0,0,0,0,0,0,0,0,0,0,0,0,0,0,0,0,0,0,0,0,0,0,0,0,Fernando Muslera,Â£7.65m ,Serie A
29/6/2010,Emiliano Viviano,7989257,776,12/1/1985,24,0,0,11,0,3150,7000,7000,161,141,6862188,195,88,GK ,16,14,11,10,15,14,14,18,15,8,13,1,1,1,1,12,1,10,13,1,1,11,1,1,10,8,12,14,13,13,8,10,14,8,11,14,12,11,14,7,14,10,15,4,14,13,20,7,7,13,2,16,3,1,15,12,14,9,11,15,11,5,GK ,0,1,1,1,1,1,20,1,1,1,1,1,1,1,1,1,1,1,1,1,1,1,1,0,0,0,0,0,0,0,0,0,0,0,0,0,0,0,0,0,0,0,0,0,0,0,0,0,0,0,0,0,0,0,0,0,0,0,0,0,0,0,0,0,0,0,0,0,0,0,0,0,Emiliano Viviano,Â£10.80m ,Serie A
29/6/2010,Eduardo Gottardi,8833674,1651,10/18/1985,24,0,0,0,0,1750,4700,4700,127,118,517194,193,80,GK ,15,13,12,12,13,9,14,16,15,14,9,8,1,1,2,5,10,3,1,1,2,3,2,2,9,13,12,13,7,8,1,14,11,2,10,1,14,1,6,7,12,12,16,9,12,5,20,4,13,12,10,10,13,10,11,11,16,14,15,12,14,10,GK ,0,1,1,1,1,1,20,1,1,1,1,1,1,1,1,1,1,1,1,1,1,1,1,0,0,0,0,0,0,0,0,0,0,0,0,0,0,0,0,0,0,0,0,0,0,0,0,0,0,0,0,0,0,0,0,0,0,0,0,0,0,0,0,0,0,0,0,0,0,0,0,0,,,
29/6/2010,David Stockdale,5113004,765,9/20/1985,24,0,0,0,0,3000,6150,6150,132,120,5568603,194,84,GK ,15,12,11,9,12,16,12,15,15,13,12,8,2,1,2,8,10,3,2,3,3,7,2,2,8,7,13,12,14,9,6,10,9,5,9,5,11,12,15,11,12,9,14,9,13,15,20,12,11,12,3,10,7,10,6,13,10,13,11,11,9,12,GK ,0,1,1,1,1,1,20,1,1,1,1,1,1,1,1,1,1,1,1,1,1,1,1,0,0,0,0,0,0,0,0,0,0,0,0,0,0,0,0,0,0,0,0,0,0,0,0,0,0,0,0,0,0,0,0,0,0,0,0,0,0,0,0,0,0,0,0,0,0,0,0,0,David Stockdale,Â£1.35m ,Premier League
29/6/2010,Damien Perquis,8439216,769,3/8/1986,24,0,0,0,0,50,2600,2600,125,105,244947,184,82,GK ,13,11,11,7,15,8,13,13,10,9,7,6,2,3,3,7,10,2,3,3,1,6,1,1,7,14,13,12,13,13,6,13,13,4,12,3,9,1,8,9,9,14,12,1,14,8,20,5,14,15,7,15,7,1,5,12,10,12,14,14,14,6,GK ,0,1,1,1,1,1,20,1,1,1,1,1,1,1,1,1,1,1,1,1,1,1,1,0,0,0,0,0,0,0,0,0,0,0,0,0,0,0,0,0,0,0,0,0,0,0,0,0,0,0,0,0,0,0,0,0,0,0,0,0,0,0,0,0,0,0,0,0,0,0,0,0,Damien Perquis,Â£3.33m ,Ligue 1
29/6/2010,Cristian Alvarez,955103,1649,11/13/1985,24,0,0,0,0,3500,6000,6000,140,125,2843484,187,88,GK ,13,12,12,11,14,10,12,14,12,7,11,7,2,1,2,3,10,2,2,1,1,3,3,3,8,14,8,15,9,12,9,9,15,7,9,11,12,15,17,15,15,11,14,7,15,13,20,11,11,12,7,8,9,10,14,11,12,15,13,12,10,13,GK ,0,1,1,1,1,1,20,1,1,1,1,1,1,1,1,1,1,1,1,1,1,1,1,0,0,0,0,0,0,0,0,0,0,0,0,0,0,0,0,0,0,0,0,0,0,0,0,0,0,0,0,0,0,0,0,0,0,0,0,0,0,0,0,0,0,0,0,0,0,0,0,0,Cristian Ãlvarez,Â£1.80m ,LaLiga
29/6/2010,Carl Ikeme,5113496,38,6/8/1986,24,0,0,0,0,2500,5000,5000,130,110,2579998,188,87,GK ,13,12,12,5,12,11,13,13,11,3,9,3,2,1,3,10,8,2,1,10,2,1,2,2,8,10,10,12,7,10,1,11,10,3,5,1,12,10,8,8,14,12,15,14,10,7,20,12,15,10,2,6,15,10,8,10,12,10,10,10,8,5,GK ,0,1,1,1,1,1,20,1,1,1,1,1,1,1,1,1,1,1,1,1,1,1,1,0,0,0,0,0,0,0,0,0,0,0,0,0,0,0,0,0,0,0,0,0,0,0,0,0,0,0,0,0,0,0,0,0,0,0,0,0,0,0,0,0,0,0,0,0,0,0,0,0,Carl Ikeme,Â£675Th. ,Premier League
29/6/2010,Apoula Edel,18003730,754,6/17/1986,24,6,0,0,0,3600,5400,5400,130,120,1424004,184,80,GK ,16,12,12,10,12,6,14,15,13,13,9,8,1,3,3,5,10,1,11,2,2,6,1,3,5,8,13,15,12,11,6,11,15,9,12,2,11,10,11,12,14,15,12,1,14,11,20,14,16,12,8,15,8,1,12,13,13,12,12,14,14,7,GK ,0,5,1,5,1,1,20,1,1,1,1,1,1,1,1,1,1,1,1,1,1,1,1,0,0,0,0,0,0,0,0,0,0,0,0,0,0,0,0,0,0,0,0,0,0,0,0,0,0,0,0,0,0,0,0,0,0,0,0,0,0,0,0,0,0,0,0,0,0,0,0,0,Apoula Edel,Â£1.80m ,Ligue 1
29/6/2010,Steve Mandanda,8428461,769,3/28/1985,25,13,0,17,0,6241,7109,7100,170,158,30788328,185,82,GK ,13,12,14,7,16,11,15,18,14,8,11,7,3,8,5,8,9,8,12,1,3,8,2,3,8,5,13,15,16,15,6,14,15,8,14,1,14,13,14,15,17,14,12,1,15,13,20,14,14,15,5,14,5,1,6,16,14,17,16,16,16,7,GK ,0,1,1,1,1,1,20,1,1,1,1,1,1,1,1,1,1,1,1,1,1,1,1,0,0,0,0,0,0,0,0,0,0,0,0,0,0,0,0,0,0,0,0,0,0,0,0,0,0,0,0,0,0,0,0,0,0,0,0,0,0,0,0,0,0,0,0,0,0,0,0,0,Steve Mandanda,Â£13.95m ,Ligue 1
29/6/2010,Simon Pouplin,8428683,769,5/28/1985,25,0,0,1,0,4556,6350,6750,152,135,5622721,185,78,GK ,11,11,15,4,14,12,15,17,12,7,13,7,1,3,1,8,10,14,2,2,3,7,3,3,8,8,14,14,14,12,7,13,15,7,12,13,13,12,12,10,12,14,13,20,14,9,1,13,14,13,8,10,5,1,13,12,15,12,15,15,15,6,GK ,0,1,1,1,1,1,20,1,1,1,1,1,1,1,1,1,1,1,1,1,1,1,1,2.19902E+12,0,0,0,0,0,0,0,0,0,0,0,0,0,0,0,0,0,0,0,0,0,0,0,0,0,0,0,0,0,0,0,0,0,0,0,0,0,0,0,0,0,1,0,0,0,0,0,0,Simon Pouplin,Â£2.70m ,Bundesliga
29/6/2010,Samir Handanovic,7582392,795,7/14/1984,25,42,0,7,0,4950,7750,7150,160,142,38034022,193,82,GK ,16,10,10,8,16,12,14,18,13,14,7,7,1,2,3,7,10,8,1,2,2,5,3,2,6,14,15,16,12,9,10,15,13,9,10,7,14,7,9,13,18,15,15,6,15,10,20,10,15,15,8,17,4,10,11,13,14,20,15,11,12,9,GK ,0,1,1,1,1,1,20,1,1,1,1,1,1,1,1,1,1,1,1,1,1,1,1,0,0,0,0,0,0,0,0,0,0,0,0,0,0,0,0,0,0,0,0,0,0,0,0,0,0,0,0,0,0,0,0,0,0,0,0,0,0,0,0,0,0,0,0,0,0,0,0,0,Samir Handanovic,Â£9.90m ,Serie A
29/6/2010,Ross Turnbull,5113381,765,1/4/1985,25,0,0,0,0,2750,5500,5500,145,126,7378458,193,93,GK ,14,12,13,5,14,13,14,14,12,7,11,6,3,1,3,4,10,3,2,3,2,7,3,1,3,3,10,13,12,12,4,11,15,1,12,2,11,13,14,7,11,11,17,10,8,9,20,10,17,12,1,10,5,10,6,14,10,11,16,15,10,5,GK ,0,1,1,1,1,1,20,1,1,1,1,1,1,1,1,1,1,1,1,1,1,1,1,0,0,0,0,0,0,0,0,0,0,0,0,0,0,0,0,0,0,0,0,0,0,0,0,0,0,0,0,0,0,0,0,0,0,0,0,0,0,0,0,0,0,0,0,0,0,0,0,0,Ross Turnbull,Â£1.35m ,Premier League
29/6/2010,Romain Salin,8428670,769,7/29/1984,25,0,0,0,0,1500,3450,4500,120,109,715240,185,70,GK ,14,10,13,6,9,7,11,14,10,8,8,4,2,1,2,7,7,1,3,3,2,6,2,1,7,10,11,14,12,12,6,10,13,7,12,3,12,14,8,11,13,14,12,20,14,8,10,13,11,12,10,14,6,1,10,11,11,11,14,14,14,5,GK ,0,1,1,1,1,1,20,1,1,1,1,1,1,1,1,1,1,1,1,1,1,1,1,0,0,0,0,0,0,0,0,0,0,0,0,0,0,0,0,0,0,0,0,0,0,0,0,0,0,0,0,0,0,0,0,0,0,0,0,0,0,0,0,0,0,0,0,0,0,0,0,0,Romain Salin,Â£540Th. ,Liga NOS
29/6/2010,René Adler,890482,771,1/15/1985,25,9,0,4,0,5900,8500,8500,185,165,25787356,190,85,GK ,10,10,14,5,15,9,17,17,16,12,10,8,2,1,3,12,10,7,2,2,1,11,1,1,11,12,15,17,16,17,6,14,18,7,15,3,17,16,15,15,18,12,15,14,18,12,20,16,13,17,3,15,7,10,14,17,18,16,18,17,15,4,GK ,0,1,1,1,1,1,20,1,1,1,1,1,1,1,1,1,1,1,1,1,1,1,1,0,0,0,0,0,0,0,0,0,0,0,0,0,0,0,0,0,0,0,0,0,0,0,0,0,0,0,0,0,0,0,0,0,0,0,0,0,0,0,0,0,0,0,0,0,0,0,0,0,RenÃ© Adler,Â£10.80m ,Bundesliga
29/6/2010,Michael Agazzi,836913,776,7/3/1984,25,0,0,0,0,500,5750,5750,159,136,2662203,189,80,GK ,13,13,11,8,16,11,13,14,12,10,14,6,3,3,1,9,9,4,1,3,1,2,1,1,8,9,11,11,14,13,9,13,12,7,11,9,14,14,11,12,14,14,15,6,13,13,20,13,14,13,5,12,7,10,8,14,16,12,12,19,12,14,GK ,0,1,1,1,1,1,20,1,1,1,1,1,1,1,1,1,1,1,1,1,1,1,1,17179869184,0,0,0,0,0,0,0,0,0,0,0,0,0,0,0,0,0,0,0,0,0,0,0,0,0,0,0,0,0,0,0,0,0,0,1,0,0,0,0,0,0,0,0,0,0,0,0,0,Michael Agazzi,Â£4.05m ,Serie A
29/6/2010,Mark Bunn,5108797,765,11/16/1984,25,0,0,0,0,3150,5750,5750,146,119,3435555,183,78,GK ,13,12,15,5,14,14,12,16,12,7,8,2,3,1,3,7,7,2,1,3,3,1,1,1,3,8,10,11,9,9,3,10,14,6,7,1,14,12,15,11,12,12,10,7,12,8,20,13,10,15,5,12,3,10,12,12,12,13,14,11,9,13,GK ,0,1,1,1,1,1,20,1,1,1,1,1,1,1,1,1,1,1,1,1,1,1,1,17179869184,0,0,0,0,0,0,0,0,0,0,0,0,0,0,0,0,0,0,0,0,0,0,0,0,0,0,0,0,0,0,0,0,0,0,1,0,0,0,0,0,0,0,0,0,0,0,0,0,Mark Bunn,Â£450Th. ,Premier League
29/6/2010,Marcelo Boeck,311045,1651,11/28/1984,25,0,0,0,0,2500,5850,5000,130,110,118933,191,85,GK ,13,13,9,8,12,10,12,12,9,11,11,8,2,1,3,6,10,2,2,1,2,2,1,1,11,9,12,15,10,12,0,10,17,3,9,3,12,8,13,7,12,11,15,10,14,8,20,8,12,11,10,10,14,10,11,17,16,13,18,14,15,10,GK ,0,1,1,1,1,1,20,1,1,1,1,1,1,1,1,1,1,1,1,1,1,1,1,0,0,0,0,0,0,0,0,0,0,0,0,0,0,0,0,0,0,0,0,0,0,0,0,0,0,0,0,0,0,0,0,0,0,0,0,0,0,0,0,0,0,0,0,0,0,0,0,0,Marcelo Boeck,Â£270Th. ,Liga NOS
29/6/2010,Manolo Reina,1509742,796,4/1/1985,25,0,0,0,0,3750,5500,5500,142,125,1938584,185,80,GK ,13,13,11,6,12,12,14,15,14,11,10,6,3,3,1,5,10,6,3,3,1,6,3,2,4,13,8,15,11,11,6,11,12,8,13,8,13,12,12,9,14,13,12,5,12,8,20,12,14,14,10,14,4,1,13,12,13,11,12,13,13,9,GK ,0,1,1,1,1,1,20,1,1,1,1,1,1,1,1,1,1,1,1,1,1,1,1,0,0,0,0,0,0,0,0,0,0,0,0,0,0,0,0,0,0,0,0,0,0,0,0,0,0,0,0,0,0,0,0,0,0,0,0,0,0,0,0,0,0,0,0,0,0,0,0,0,Manolo Reina,Â£1.80m ,LaLiga
29/6/2010,Lukasz Fabianski,718272,787,4/18/1985,25,14,0,2,0,4225,6650,6000,157,130,-1,190,84,GK ,14,12,12,10,14,12,12,15,17,12,15,6,3,1,3,10,10,11,1,2,1,7,1,13,10,8,10,13,8,10,12,11,16,1,12,3,12,15,13,14,15,12,15,5,12,13,20,11,12,12,10,8,7,10,15,16,15,7,15,18,12,6,GK ,0,1,1,1,1,1,20,1,1,1,1,1,1,1,1,1,1,1,1,1,1,1,1,0,0,0,0,0,0,0,0,0,0,0,0,0,0,0,0,0,0,0,0,0,0,0,0,0,0,0,0,0,0,0,0,0,0,0,0,0,0,0,0,0,0,0,0,0,0,0,0,0,Lukasz Fabianski,Â£3.60m ,Premier League
29/6/2010,Gaëtan Deneuve,8443092,769,5/3/1985,25,0,0,0,0,2300,3550,3550,120,109,1597149,183,78,GK ,11,11,13,7,12,12,11,14,11,11,7,7,1,2,2,8,10,3,2,1,3,7,3,1,8,11,14,14,12,12,7,11,15,6,9,1,10,11,9,11,13,14,11,1,14,9,20,14,13,14,11,10,7,1,7,15,12,12,14,14,11,8,GK ,0,1,1,1,1,1,20,1,1,1,1,1,1,1,1,1,1,1,1,1,1,1,1,0,0,0,0,0,0,0,0,0,0,0,0,0,0,0,0,0,0,0,0,0,0,0,0,0,0,0,0,0,0,0,0,0,0,0,0,0,0,0,0,0,0,0,0,0,0,0,0,0,GaÃ«tan Deneuve,Â£315Th. ,Ligue 1
29/6/2010,Diego Alves,2100185,1651,6/24/1985,25,0,0,3,0,5256,7250,7000,165,145,13859213,188,83,GK ,15,13,13,5,14,13,14,15,14,10,14,7,1,1,3,9,10,1,1,1,3,2,15,2,14,8,12,12,14,12,3,13,16,3,12,3,13,9,14,14,15,13,14,20,16,12,7,9,10,16,8,13,10,10,11,13,15,8,15,9,13,14,GK ,0,1,1,1,1,1,20,1,1,1,1,1,1,1,1,1,1,1,1,1,1,1,1,0,0,0,0,0,0,0,0,0,0,0,0,0,0,0,0,0,0,0,0,0,0,0,0,0,0,0,0,0,0,0,0,0,0,0,0,0,0,0,0,0,0,0,0,0,0,0,0,0,Diego Alves,Â£10.80m ,LaLiga
29/6/2010,Colin Doyle,5119852,789,6/12/1985,25,1,0,4,0,2500,5500,6000,136,119,1707227,196,92,GK ,13,15,12,6,14,11,12,13,12,10,12,7,1,1,3,4,10,2,3,1,1,2,3,1,4,11,7,13,8,10,7,10,8,2,11,10,14,12,13,9,11,11,16,11,13,7,20,6,13,15,8,5,8,10,12,7,10,12,10,11,12,4,GK ,0,1,1,1,1,1,20,1,1,1,1,1,1,1,1,1,1,1,1,1,1,1,1,0,0,0,0,0,0,0,0,0,0,0,0,0,0,0,0,0,0,0,0,0,0,0,0,0,0,0,0,0,0,0,0,0,0,0,0,0,0,0,0,0,0,0,0,0,0,0,0,0,Colin Doyle,Â£225Th. ,Premier League
29/6/2010,Coelho,744670,788,7/18/1984,25,0,0,0,0,250,3500,3500,94,90,370162,178,73,GK ,13,13,11,7,13,10,11,13,14,8,11,6,3,1,2,7,10,2,1,1,1,1,3,2,3,10,9,7,11,12,1,11,7,3,14,2,13,1,2,11,16,14,5,1,17,8,20,3,6,10,8,10,5,10,7,9,15,5,9,12,6,8,GK ,0,1,1,1,1,1,20,1,1,1,1,1,1,1,1,1,1,1,1,1,1,1,1,0,0,0,0,0,0,0,0,0,0,0,0,0,0,0,0,0,0,0,0,0,0,0,0,0,0,0,0,0,0,0,0,0,0,0,0,0,0,0,0,0,0,0,0,0,0,0,0,0,,,
29/6/2010,Brad Guzan,980785,390,9/9/1984,25,17,0,5,0,3750,6350,6150,150,130,2744674,193,95,GK ,10,10,11,8,15,12,14,15,12,10,10,5,2,3,2,9,9,8,3,3,1,10,3,1,9,11,17,12,12,13,9,11,17,2,14,2,14,14,12,14,13,12,15,20,8,8,12,13,16,10,7,10,8,10,16,17,14,11,17,18,13,3,GK ,0,1,1,1,1,1,20,1,1,1,1,1,1,1,1,1,1,1,1,1,1,1,1,0,0,0,0,0,0,0,0,0,0,0,0,0,0,0,0,0,0,0,0,0,0,0,0,0,0,0,0,0,0,0,0,0,0,0,0,0,0,0,0,0,0,0,0,0,0,0,0,0,Brad Guzan,Â£900Th. ,Premier League
29/6/2010,Benedikt Pliquett,8708026,771,12/20/1984,25,0,0,0,0,1750,5500,5500,115,108,770313,199,90,GK ,14,11,14,8,14,11,13,14,15,9,11,7,2,1,3,1,10,3,1,1,2,2,2,1,4,17,11,11,11,14,1,12,9,1,1,2,12,1,4,10,15,13,16,5,17,9,20,8,6,10,9,7,8,10,14,12,9,7,4,11,9,11,GK ,0,1,1,1,1,1,20,1,1,1,1,1,1,1,1,1,1,1,1,1,1,1,1,0,0,0,0,0,0,0,0,0,0,0,0,0,0,0,0,0,0,0,0,0,0,0,0,0,0,0,0,0,0,0,0,0,0,0,0,0,0,0,0,0,0,0,0,0,0,0,0,0,Benedikt Pliquett,Â£270Th. ,Bundesliga
29/6/2010,Benedikt Fernandez,8728358,771,1/8/1985,25,0,0,0,0,2000,5500,5500,128,115,1111904,184,80,GK ,12,13,14,3,13,12,13,14,8,12,10,6,1,1,1,6,10,4,3,2,1,6,3,1,6,8,10,13,12,13,4,11,12,4,3,2,13,13,10,8,13,12,13,3,13,10,20,13,10,13,2,12,8,10,8,10,18,12,13,15,18,3,GK ,0,1,1,1,1,1,20,1,1,1,1,1,1,1,1,1,1,1,1,1,1,1,1,0,0,0,0,0,0,0,0,0,0,0,0,0,0,0,0,0,0,0,0,0,0,0,0,0,0,0,0,0,0,0,0,0,0,0,0,0,0,0,0,0,0,0,0,0,0,0,0,0,Benedikt Fernandez,Â£180Th. ,Bundesliga
29/6/2010,António Filipe,8871521,788,4/14/1985,25,0,0,0,0,500,3000,3000,93,90,197800,190,82,GK ,13,11,12,12,13,11,11,13,9,11,9,5,3,1,2,3,9,2,3,1,3,0,2,2,5,7,11,14,8,5,0,13,9,2,3,3,13,0,4,10,13,12,14,3,8,9,20,7,7,5,8,5,12,10,14,13,13,6,13,9,1,10,GK ,0,1,1,1,1,1,20,1,1,1,1,1,1,1,1,1,1,1,1,1,1,1,1,0,0,0,0,0,0,0,0,0,0,0,0,0,0,0,0,0,0,0,0,0,0,0,0,0,0,0,0,0,0,0,0,0,0,0,0,0,0,0,0,0,0,0,0,0,0,0,0,0,AntÃ³nio Filipe,Â£90Th. ,Liga NOS
29/6/2010,Alexis Thébaux,918781,769,3/17/1985,25,0,0,2,0,3750,5700,5700,136,127,5128096,185,81,GK ,12,13,14,7,13,15,11,16,12,14,8,4,1,1,2,8,7,1,12,2,3,7,2,2,8,8,12,14,12,12,6,12,14,6,11,2,11,11,11,13,11,14,12,5,15,10,20,13,14,14,8,14,6,1,7,13,12,11,15,15,15,7,GK ,0,1,1,1,1,1,20,1,1,1,1,1,1,1,1,1,1,1,1,1,1,1,1,0,0,0,0,0,0,0,0,0,0,0,0,0,0,0,0,0,0,0,0,0,0,0,0,0,0,0,0,0,0,0,0,0,0,0,0,0,0,0,0,0,0,0,0,0,0,0,0,0,Alexis ThÃ©baux,Â£1.98m ,Ligue 1
